team,n,rank,w,d,l,gf,ga,gd,pts
Sydney FC,0,1,21,4,3,66,23,43,67
N'castle Jet,0,2,15,6,7,59,39,20,51
Melbourne C,0,3,14,5,10,45,35,10,47
Melbourne V,0,4,13,5,11,46,40,6,44
Adelaide Utd,0,5,11,6,11,37,40,-3,39
Brisbane,0,6,10,5,13,33,42,-9,35
Western Sydn,0,7,8,9,10,38,47,-9,33
Perth Glory,0,8,10,2,15,37,50,-13,32
Wellington P,0,9,5,6,16,31,55,-24,21
CC Mariners,0,10,4,8,15,28,49,-21,20
Sydney FC,1,1,21,4,3,66,23,43,67
N'castle Jet,1,2,16,5,7,59,37,22,53
Melbourne C,1,3,14,4,11,43,35,8,46
Melbourne V,1,4,13,5,11,46,40,6,44
Adelaide Utd,1,5,11,6,11,37,40,-3,39
Brisbane,1,6,10,5,13,33,42,-9,35
Western Sydn,1,7,8,9,10,38,47,-9,33
Perth Glory,1,8,10,2,15,37,50,-13,32
Wellington P,1,9,5,6,16,31,55,-24,21
CC Mariners,1,10,4,8,15,28,49,-21,20
Sydney FC,2,1,21,4,3,66,22,44,67
N'castle Jet,2,2,15,6,7,59,39,20,51
Melbourne C,2,3,14,5,10,45,35,10,47
Melbourne V,2,4,13,5,11,45,40,5,44
Adelaide Utd,2,5,11,6,11,37,40,-3,39
Brisbane,2,6,10,5,13,33,42,-9,35
Western Sydn,2,7,8,9,10,38,47,-9,33
Perth Glory,2,8,10,2,15,37,50,-13,32
Wellington P,2,9,5,6,16,31,55,-24,21
CC Mariners,2,10,4,8,15,28,49,-21,20
Sydney FC,3,1,20,4,4,65,24,41,64
N'castle Jet,3,2,15,5,8,58,41,17,50
Melbourne C,3,3,15,4,10,47,34,13,49
Melbourne V,3,4,14,5,10,47,39,8,47
Adelaide Utd,3,5,11,6,11,37,40,-3,39
Brisbane,3,6,10,5,13,33,42,-9,35
Western Sydn,3,7,8,9,10,38,47,-9,33
Perth Glory,3,8,10,2,15,37,50,-13,32
Wellington P,3,9,5,6,16,31,55,-24,21
CC Mariners,3,10,4,8,15,28,49,-21,20
Sydney FC,4,1,21,4,3,67,22,45,67
N'castle Jet,4,2,15,5,8,58,39,19,50
Melbourne C,4,3,15,4,10,45,34,11,49
Melbourne V,4,4,13,5,11,45,41,4,44
Adelaide Utd,4,5,11,6,11,37,40,-3,39
Brisbane,4,6,10,5,13,33,42,-9,35
Western Sydn,4,7,8,9,10,38,47,-9,33
Perth Glory,4,8,10,2,15,37,50,-13,32
Wellington P,4,9,5,6,16,31,55,-24,21
CC Mariners,4,10,4,8,15,28,49,-21,20
Sydney FC,5,1,21,4,3,67,23,44,67
N'castle Jet,5,2,16,5,7,63,37,26,53
Melbourne C,5,3,14,4,11,43,39,4,46
Melbourne V,5,4,13,5,11,46,41,5,44
Adelaide Utd,5,5,11,6,11,37,40,-3,39
Brisbane,5,6,10,5,13,33,42,-9,35
Western Sydn,5,7,8,9,10,38,47,-9,33
Perth Glory,5,8,10,2,15,37,50,-13,32
Wellington P,5,9,5,6,16,31,55,-24,21
CC Mariners,5,10,4,8,15,28,49,-21,20
Sydney FC,6,1,21,4,3,65,22,43,67
N'castle Jet,6,2,16,5,7,58,37,21,53
Melbourne C,6,3,14,4,11,43,34,9,46
Melbourne V,6,4,13,5,11,45,39,6,44
Adelaide Utd,6,5,11,6,11,37,40,-3,39
Brisbane,6,6,10,5,13,33,42,-9,35
Western Sydn,6,7,8,9,10,38,47,-9,33
Perth Glory,6,8,10,2,15,37,50,-13,32
Wellington P,6,9,5,6,16,31,55,-24,21
CC Mariners,6,10,4,8,15,28,49,-21,20
Sydney FC,7,1,20,4,4,65,24,41,64
N'castle Jet,7,2,15,5,8,57,38,19,50
Melbourne C,7,3,15,4,10,44,33,11,49
Melbourne V,7,4,14,5,10,47,39,8,47
Adelaide Utd,7,5,11,6,11,37,40,-3,39
Brisbane,7,6,10,5,13,33,42,-9,35
Western Sydn,7,7,8,9,10,38,47,-9,33
Perth Glory,7,8,10,2,15,37,50,-13,32
Wellington P,7,9,5,6,16,31,55,-24,21
CC Mariners,7,10,4,8,15,28,49,-21,20
Sydney FC,8,1,21,4,3,66,23,43,67
N'castle Jet,8,2,16,5,7,60,39,21,53
Melbourne C,8,3,14,4,11,45,36,9,46
Melbourne V,8,4,13,5,11,46,40,6,44
Adelaide Utd,8,5,11,6,11,37,40,-3,39
Brisbane,8,6,10,5,13,33,42,-9,35
Western Sydn,8,7,8,9,10,38,47,-9,33
Perth Glory,8,8,10,2,15,37,50,-13,32
Wellington P,8,9,5,6,16,31,55,-24,21
CC Mariners,8,10,4,8,15,28,49,-21,20
Sydney FC,9,1,21,4,3,68,25,43,67
N'castle Jet,9,2,15,6,7,58,38,20,51
Melbourne C,9,3,14,5,10,44,34,10,47
Melbourne V,9,4,13,5,11,48,42,6,44
Adelaide Utd,9,5,11,6,11,37,40,-3,39
Brisbane,9,6,10,5,13,33,42,-9,35
Western Sydn,9,7,8,9,10,38,47,-9,33
Perth Glory,9,8,10,2,15,37,50,-13,32
Wellington P,9,9,5,6,16,31,55,-24,21
CC Mariners,9,10,4,8,15,28,49,-21,20
Sydney FC,10,1,20,4,4,64,24,40,64
N'castle Jet,10,2,16,5,7,59,38,21,53
Melbourne V,10,3,14,5,10,47,38,9,47
Melbourne C,10,4,14,4,11,44,35,9,46
Adelaide Utd,10,5,11,6,11,37,40,-3,39
Brisbane,10,6,10,5,13,33,42,-9,35
Western Sydn,10,7,8,9,10,38,47,-9,33
Perth Glory,10,8,10,2,15,37,50,-13,32
Wellington P,10,9,5,6,16,31,55,-24,21
CC Mariners,10,10,4,8,15,28,49,-21,20
Sydney FC,11,1,21,4,3,66,22,44,67
N'castle Jet,11,2,16,5,7,59,38,21,53
Melbourne C,11,3,14,4,11,44,35,9,46
Melbourne V,11,4,13,5,11,45,40,5,44
Adelaide Utd,11,5,11,6,11,37,40,-3,39
Brisbane,11,6,10,5,13,33,42,-9,35
Western Sydn,11,7,8,9,10,38,47,-9,33
Perth Glory,11,8,10,2,15,37,50,-13,32
Wellington P,11,9,5,6,16,31,55,-24,21
CC Mariners,11,10,4,8,15,28,49,-21,20
Sydney FC,12,1,21,4,3,69,23,46,67
N'castle Jet,12,2,16,5,7,62,37,25,53
Melbourne C,12,3,14,4,11,43,38,5,46
Melbourne V,12,4,13,5,11,46,43,3,44
Adelaide Utd,12,5,11,6,11,37,40,-3,39
Brisbane,12,6,10,5,13,33,42,-9,35
Western Sydn,12,7,8,9,10,38,47,-9,33
Perth Glory,12,8,10,2,15,37,50,-13,32
Wellington P,12,9,5,6,16,31,55,-24,21
CC Mariners,12,10,4,8,15,28,49,-21,20
Sydney FC,13,1,21,4,3,68,24,44,67
N'castle Jet,13,2,15,6,7,58,38,20,51
Melbourne C,13,3,14,5,10,44,34,10,47
Melbourne V,13,4,13,5,11,47,42,5,44
Adelaide Utd,13,5,11,6,11,37,40,-3,39
Brisbane,13,6,10,5,13,33,42,-9,35
Western Sydn,13,7,8,9,10,38,47,-9,33
Perth Glory,13,8,10,2,15,37,50,-13,32
Wellington P,13,9,5,6,16,31,55,-24,21
CC Mariners,13,10,4,8,15,28,49,-21,20
Sydney FC,14,1,20,5,3,64,22,42,65
N'castle Jet,14,2,16,5,7,60,38,22,53
Melbourne C,14,3,14,4,11,44,36,8,46
Melbourne V,14,4,13,6,10,45,38,7,45
Adelaide Utd,14,5,11,6,11,37,40,-3,39
Brisbane,14,6,10,5,13,33,42,-9,35
Western Sydn,14,7,8,9,10,38,47,-9,33
Perth Glory,14,8,10,2,15,37,50,-13,32
Wellington P,14,9,5,6,16,31,55,-24,21
CC Mariners,14,10,4,8,15,28,49,-21,20
Sydney FC,15,1,21,4,3,65,22,43,67
N'castle Jet,15,2,16,5,7,60,38,22,53
Melbourne C,15,3,14,4,11,44,36,8,46
Melbourne V,15,4,13,5,11,45,39,6,44
Adelaide Utd,15,5,11,6,11,37,40,-3,39
Brisbane,15,6,10,5,13,33,42,-9,35
Western Sydn,15,7,8,9,10,38,47,-9,33
Perth Glory,15,8,10,2,15,37,50,-13,32
Wellington P,15,9,5,6,16,31,55,-24,21
CC Mariners,15,10,4,8,15,28,49,-21,20
Sydney FC,16,1,20,4,4,64,24,40,64
N'castle Jet,16,2,16,5,7,59,38,21,53
Melbourne V,16,3,14,5,10,47,38,9,47
Melbourne C,16,4,14,4,11,44,35,9,46
Adelaide Utd,16,5,11,6,11,37,40,-3,39
Brisbane,16,6,10,5,13,33,42,-9,35
Western Sydn,16,7,8,9,10,38,47,-9,33
Perth Glory,16,8,10,2,15,37,50,-13,32
Wellington P,16,9,5,6,16,31,55,-24,21
CC Mariners,16,10,4,8,15,28,49,-21,20
Sydney FC,17,1,20,5,3,65,23,42,65
N'castle Jet,17,2,16,5,7,59,37,22,53
Melbourne C,17,3,14,4,11,43,35,8,46
Melbourne V,17,4,13,6,10,46,39,7,45
Adelaide Utd,17,5,11,6,11,37,40,-3,39
Brisbane,17,6,10,5,13,33,42,-9,35
Western Sydn,17,7,8,9,10,38,47,-9,33
Perth Glory,17,8,10,2,15,37,50,-13,32
Wellington P,17,9,5,6,16,31,55,-24,21
CC Mariners,17,10,4,8,15,28,49,-21,20
Sydney FC,18,1,21,4,3,66,23,43,67
N'castle Jet,18,2,15,5,8,58,39,19,50
Melbourne C,18,3,15,4,10,45,34,11,49
Melbourne V,18,4,13,5,11,46,40,6,44
Adelaide Utd,18,5,11,6,11,37,40,-3,39
Brisbane,18,6,10,5,13,33,42,-9,35
Western Sydn,18,7,8,9,10,38,47,-9,33
Perth Glory,18,8,10,2,15,37,50,-13,32
Wellington P,18,9,5,6,16,31,55,-24,21
CC Mariners,18,10,4,8,15,28,49,-21,20
Sydney FC,19,1,20,5,3,66,24,42,65
N'castle Jet,19,2,16,5,7,61,38,23,53
Melbourne C,19,3,14,4,11,44,37,7,46
Melbourne V,19,4,13,6,10,47,40,7,45
Adelaide Utd,19,5,11,6,11,37,40,-3,39
Brisbane,19,6,10,5,13,33,42,-9,35
Western Sydn,19,7,8,9,10,38,47,-9,33
Perth Glory,19,8,10,2,15,37,50,-13,32
Wellington P,19,9,5,6,16,31,55,-24,21
CC Mariners,19,10,4,8,15,28,49,-21,20
Sydney FC,20,1,21,4,3,68,23,45,67
N'castle Jet,20,2,16,5,7,58,37,21,53
Melbourne C,20,3,14,4,11,43,34,9,46
Melbourne V,20,4,13,5,11,46,42,4,44
Adelaide Utd,20,5,11,6,11,37,40,-3,39
Brisbane,20,6,10,5,13,33,42,-9,35
Western Sydn,20,7,8,9,10,38,47,-9,33
Perth Glory,20,8,10,2,15,37,50,-13,32
Wellington P,20,9,5,6,16,31,55,-24,21
CC Mariners,20,10,4,8,15,28,49,-21,20
Sydney FC,21,1,21,4,3,67,23,44,67
N'castle Jet,21,2,16,5,7,60,37,23,53
Melbourne C,21,3,14,4,11,43,36,7,46
Melbourne V,21,4,13,5,11,46,41,5,44
Adelaide Utd,21,5,11,6,11,37,40,-3,39
Brisbane,21,6,10,5,13,33,42,-9,35
Western Sydn,21,7,8,9,10,38,47,-9,33
Perth Glory,21,8,10,2,15,37,50,-13,32
Wellington P,21,9,5,6,16,31,55,-24,21
CC Mariners,21,10,4,8,15,28,49,-21,20
Sydney FC,22,1,21,4,3,67,23,44,67
N'castle Jet,22,2,16,5,7,63,38,25,53
Melbourne C,22,3,14,4,11,44,39,5,46
Melbourne V,22,4,13,5,11,46,41,5,44
Adelaide Utd,22,5,11,6,11,37,40,-3,39
Brisbane,22,6,10,5,13,33,42,-9,35
Western Sydn,22,7,8,9,10,38,47,-9,33
Perth Glory,22,8,10,2,15,37,50,-13,32
Wellington P,22,9,5,6,16,31,55,-24,21
CC Mariners,22,10,4,8,15,28,49,-21,20
Sydney FC,23,1,21,4,3,68,23,45,67
N'castle Jet,23,2,15,6,7,58,38,20,51
Melbourne C,23,3,14,5,10,44,34,10,47
Melbourne V,23,4,13,5,11,46,42,4,44
Adelaide Utd,23,5,11,6,11,37,40,-3,39
Brisbane,23,6,10,5,13,33,42,-9,35
Western Sydn,23,7,8,9,10,38,47,-9,33
Perth Glory,23,8,10,2,15,37,50,-13,32
Wellington P,23,9,5,6,16,31,55,-24,21
CC Mariners,23,10,4,8,15,28,49,-21,20
Sydney FC,24,1,20,4,4,64,23,41,64
N'castle Jet,24,2,16,5,7,59,38,21,53
Melbourne V,24,3,14,5,10,46,38,8,47
Melbourne C,24,4,14,4,11,44,35,9,46
Adelaide Utd,24,5,11,6,11,37,40,-3,39
Brisbane,24,6,10,5,13,33,42,-9,35
Western Sydn,24,7,8,9,10,38,47,-9,33
Perth Glory,24,8,10,2,15,37,50,-13,32
Wellington P,24,9,5,6,16,31,55,-24,21
CC Mariners,24,10,4,8,15,28,49,-21,20
Sydney FC,25,1,21,4,3,66,23,43,67
N'castle Jet,25,2,16,5,7,60,39,21,53
Melbourne C,25,3,14,4,11,45,36,9,46
Melbourne V,25,4,13,5,11,46,40,6,44
Adelaide Utd,25,5,11,6,11,37,40,-3,39
Brisbane,25,6,10,5,13,33,42,-9,35
Western Sydn,25,7,8,9,10,38,47,-9,33
Perth Glory,25,8,10,2,15,37,50,-13,32
Wellington P,25,9,5,6,16,31,55,-24,21
CC Mariners,25,10,4,8,15,28,49,-21,20
Sydney FC,26,1,21,4,3,67,23,44,67
N'castle Jet,26,2,15,6,7,58,38,20,51
Melbourne C,26,3,14,5,10,44,34,10,47
Melbourne V,26,4,13,5,11,46,41,5,44
Adelaide Utd,26,5,11,6,11,37,40,-3,39
Brisbane,26,6,10,5,13,33,42,-9,35
Western Sydn,26,7,8,9,10,38,47,-9,33
Perth Glory,26,8,10,2,15,37,50,-13,32
Wellington P,26,9,5,6,16,31,55,-24,21
CC Mariners,26,10,4,8,15,28,49,-21,20
Sydney FC,27,1,21,4,3,67,22,45,67
N'castle Jet,27,2,16,5,7,60,37,23,53
Melbourne C,27,3,14,4,11,43,36,7,46
Melbourne V,27,4,13,5,11,45,41,4,44
Adelaide Utd,27,5,11,6,11,37,40,-3,39
Brisbane,27,6,10,5,13,33,42,-9,35
Western Sydn,27,7,8,9,10,38,47,-9,33
Perth Glory,27,8,10,2,15,37,50,-13,32
Wellington P,27,9,5,6,16,31,55,-24,21
CC Mariners,27,10,4,8,15,28,49,-21,20
Sydney FC,28,1,20,5,3,65,23,42,65
N'castle Jet,28,2,16,5,7,60,39,21,53
Melbourne C,28,3,14,4,11,45,36,9,46
Melbourne V,28,4,13,6,10,46,39,7,45
Adelaide Utd,28,5,11,6,11,37,40,-3,39
Brisbane,28,6,10,5,13,33,42,-9,35
Western Sydn,28,7,8,9,10,38,47,-9,33
Perth Glory,28,8,10,2,15,37,50,-13,32
Wellington P,28,9,5,6,16,31,55,-24,21
CC Mariners,28,10,4,8,15,28,49,-21,20
Sydney FC,29,1,20,4,4,65,25,40,64
N'castle Jet,29,2,16,5,7,58,37,21,53
Melbourne V,29,3,14,5,10,48,39,9,47
Melbourne C,29,4,14,4,11,43,34,9,46
Adelaide Utd,29,5,11,6,11,37,40,-3,39
Brisbane,29,6,10,5,13,33,42,-9,35
Western Sydn,29,7,8,9,10,38,47,-9,33
Perth Glory,29,8,10,2,15,37,50,-13,32
Wellington P,29,9,5,6,16,31,55,-24,21
CC Mariners,29,10,4,8,15,28,49,-21,20
Sydney FC,30,1,20,5,3,64,22,42,65
N'castle Jet,30,2,15,5,8,57,38,19,50
Melbourne C,30,3,15,4,10,44,33,11,49
Melbourne V,30,4,13,6,10,45,38,7,45
Adelaide Utd,30,5,11,6,11,37,40,-3,39
Brisbane,30,6,10,5,13,33,42,-9,35
Western Sydn,30,7,8,9,10,38,47,-9,33
Perth Glory,30,8,10,2,15,37,50,-13,32
Wellington P,30,9,5,6,16,31,55,-24,21
CC Mariners,30,10,4,8,15,28,49,-21,20
Sydney FC,31,1,21,4,3,65,22,43,67
N'castle Jet,31,2,15,5,8,57,38,19,50
Melbourne C,31,3,15,4,10,44,33,11,49
Melbourne V,31,4,13,5,11,45,39,6,44
Adelaide Utd,31,5,11,6,11,37,40,-3,39
Brisbane,31,6,10,5,13,33,42,-9,35
Western Sydn,31,7,8,9,10,38,47,-9,33
Perth Glory,31,8,10,2,15,37,50,-13,32
Wellington P,31,9,5,6,16,31,55,-24,21
CC Mariners,31,10,4,8,15,28,49,-21,20
Sydney FC,32,1,21,4,3,66,22,44,67
N'castle Jet,32,2,15,5,8,59,40,19,50
Melbourne C,32,3,15,4,10,46,35,11,49
Melbourne V,32,4,13,5,11,45,40,5,44
Adelaide Utd,32,5,11,6,11,37,40,-3,39
Brisbane,32,6,10,5,13,33,42,-9,35
Western Sydn,32,7,8,9,10,38,47,-9,33
Perth Glory,32,8,10,2,15,37,50,-13,32
Wellington P,32,9,5,6,16,31,55,-24,21
CC Mariners,32,10,4,8,15,28,49,-21,20
Sydney FC,33,1,21,4,3,71,24,47,67
N'castle Jet,33,2,16,5,7,62,38,24,53
Melbourne C,33,3,14,4,11,44,38,6,46
Melbourne V,33,4,13,5,11,47,45,2,44
Adelaide Utd,33,5,11,6,11,37,40,-3,39
Brisbane,33,6,10,5,13,33,42,-9,35
Western Sydn,33,7,8,9,10,38,47,-9,33
Perth Glory,33,8,10,2,15,37,50,-13,32
Wellington P,33,9,5,6,16,31,55,-24,21
CC Mariners,33,10,4,8,15,28,49,-21,20
Sydney FC,34,1,21,4,3,68,24,44,67
N'castle Jet,34,2,15,6,7,60,40,20,51
Melbourne C,34,3,14,5,10,46,36,10,47
Melbourne V,34,4,13,5,11,47,42,5,44
Adelaide Utd,34,5,11,6,11,37,40,-3,39
Brisbane,34,6,10,5,13,33,42,-9,35
Western Sydn,34,7,8,9,10,38,47,-9,33
Perth Glory,34,8,10,2,15,37,50,-13,32
Wellington P,34,9,5,6,16,31,55,-24,21
CC Mariners,34,10,4,8,15,28,49,-21,20
Sydney FC,35,1,21,4,3,66,23,43,67
N'castle Jet,35,2,16,5,7,59,38,21,53
Melbourne C,35,3,14,4,11,44,35,9,46
Melbourne V,35,4,13,5,11,46,40,6,44
Adelaide Utd,35,5,11,6,11,37,40,-3,39
Brisbane,35,6,10,5,13,33,42,-9,35
Western Sydn,35,7,8,9,10,38,47,-9,33
Perth Glory,35,8,10,2,15,37,50,-13,32
Wellington P,35,9,5,6,16,31,55,-24,21
CC Mariners,35,10,4,8,15,28,49,-21,20
Sydney FC,36,1,20,4,4,65,25,40,64
N'castle Jet,36,2,15,5,8,61,42,19,50
Melbourne C,36,3,15,4,10,48,37,11,49
Melbourne V,36,4,14,5,10,48,39,9,47
Adelaide Utd,36,5,11,6,11,37,40,-3,39
Brisbane,36,6,10,5,13,33,42,-9,35
Western Sydn,36,7,8,9,10,38,47,-9,33
Perth Glory,36,8,10,2,15,37,50,-13,32
Wellington P,36,9,5,6,16,31,55,-24,21
CC Mariners,36,10,4,8,15,28,49,-21,20
Sydney FC,37,1,21,4,3,66,23,43,67
N'castle Jet,37,2,16,5,7,62,40,22,53
Melbourne C,37,3,14,4,11,46,38,8,46
Melbourne V,37,4,13,5,11,46,40,6,44
Adelaide Utd,37,5,11,6,11,37,40,-3,39
Brisbane,37,6,10,5,13,33,42,-9,35
Western Sydn,37,7,8,9,10,38,47,-9,33
Perth Glory,37,8,10,2,15,37,50,-13,32
Wellington P,37,9,5,6,16,31,55,-24,21
CC Mariners,37,10,4,8,15,28,49,-21,20
Sydney FC,38,1,20,4,4,64,23,41,64
N'castle Jet,38,2,16,5,7,59,37,22,53
Melbourne V,38,3,14,5,10,46,38,8,47
Melbourne C,38,4,14,4,11,43,35,8,46
Adelaide Utd,38,5,11,6,11,37,40,-3,39
Brisbane,38,6,10,5,13,33,42,-9,35
Western Sydn,38,7,8,9,10,38,47,-9,33
Perth Glory,38,8,10,2,15,37,50,-13,32
Wellington P,38,9,5,6,16,31,55,-24,21
CC Mariners,38,10,4,8,15,28,49,-21,20
Sydney FC,39,1,21,4,3,67,23,44,67
N'castle Jet,39,2,15,6,7,58,38,20,51
Melbourne C,39,3,14,5,10,44,34,10,47
Melbourne V,39,4,13,5,11,46,41,5,44
Adelaide Utd,39,5,11,6,11,37,40,-3,39
Brisbane,39,6,10,5,13,33,42,-9,35
Western Sydn,39,7,8,9,10,38,47,-9,33
Perth Glory,39,8,10,2,15,37,50,-13,32
Wellington P,39,9,5,6,16,31,55,-24,21
CC Mariners,39,10,4,8,15,28,49,-21,20
Sydney FC,40,1,21,4,3,66,23,43,67
N'castle Jet,40,2,15,6,7,59,39,20,51
Melbourne C,40,3,14,5,10,45,35,10,47
Melbourne V,40,4,13,5,11,46,40,6,44
Adelaide Utd,40,5,11,6,11,37,40,-3,39
Brisbane,40,6,10,5,13,33,42,-9,35
Western Sydn,40,7,8,9,10,38,47,-9,33
Perth Glory,40,8,10,2,15,37,50,-13,32
Wellington P,40,9,5,6,16,31,55,-24,21
CC Mariners,40,10,4,8,15,28,49,-21,20
Sydney FC,41,1,21,4,3,66,23,43,67
N'castle Jet,41,2,16,5,7,59,38,21,53
Melbourne C,41,3,14,4,11,44,35,9,46
Melbourne V,41,4,13,5,11,46,40,6,44
Adelaide Utd,41,5,11,6,11,37,40,-3,39
Brisbane,41,6,10,5,13,33,42,-9,35
Western Sydn,41,7,8,9,10,38,47,-9,33
Perth Glory,41,8,10,2,15,37,50,-13,32
Wellington P,41,9,5,6,16,31,55,-24,21
CC Mariners,41,10,4,8,15,28,49,-21,20
Sydney FC,42,1,21,4,3,67,24,43,67
N'castle Jet,42,2,16,5,7,58,37,21,53
Melbourne C,42,3,14,4,11,43,34,9,46
Melbourne V,42,4,13,5,11,47,41,6,44
Adelaide Utd,42,5,11,6,11,37,40,-3,39
Brisbane,42,6,10,5,13,33,42,-9,35
Western Sydn,42,7,8,9,10,38,47,-9,33
Perth Glory,42,8,10,2,15,37,50,-13,32
Wellington P,42,9,5,6,16,31,55,-24,21
CC Mariners,42,10,4,8,15,28,49,-21,20
Sydney FC,43,1,21,4,3,67,23,44,67
N'castle Jet,43,2,16,5,7,58,37,21,53
Melbourne C,43,3,14,4,11,43,34,9,46
Melbourne V,43,4,13,5,11,46,41,5,44
Adelaide Utd,43,5,11,6,11,37,40,-3,39
Brisbane,43,6,10,5,13,33,42,-9,35
Western Sydn,43,7,8,9,10,38,47,-9,33
Perth Glory,43,8,10,2,15,37,50,-13,32
Wellington P,43,9,5,6,16,31,55,-24,21
CC Mariners,43,10,4,8,15,28,49,-21,20
Sydney FC,44,1,21,4,3,66,23,43,67
N'castle Jet,44,2,16,5,7,62,37,25,53
Melbourne C,44,3,14,4,11,43,38,5,46
Melbourne V,44,4,13,5,11,46,40,6,44
Adelaide Utd,44,5,11,6,11,37,40,-3,39
Brisbane,44,6,10,5,13,33,42,-9,35
Western Sydn,44,7,8,9,10,38,47,-9,33
Perth Glory,44,8,10,2,15,37,50,-13,32
Wellington P,44,9,5,6,16,31,55,-24,21
CC Mariners,44,10,4,8,15,28,49,-21,20
Sydney FC,45,1,21,4,3,65,22,43,67
N'castle Jet,45,2,16,5,7,59,37,22,53
Melbourne C,45,3,14,4,11,43,35,8,46
Melbourne V,45,4,13,5,11,45,39,6,44
Adelaide Utd,45,5,11,6,11,37,40,-3,39
Brisbane,45,6,10,5,13,33,42,-9,35
Western Sydn,45,7,8,9,10,38,47,-9,33
Perth Glory,45,8,10,2,15,37,50,-13,32
Wellington P,45,9,5,6,16,31,55,-24,21
CC Mariners,45,10,4,8,15,28,49,-21,20
Sydney FC,46,1,21,4,3,67,22,45,67
N'castle Jet,46,2,16,5,7,59,38,21,53
Melbourne C,46,3,14,4,11,44,35,9,46
Melbourne V,46,4,13,5,11,45,41,4,44
Adelaide Utd,46,5,11,6,11,37,40,-3,39
Brisbane,46,6,10,5,13,33,42,-9,35
Western Sydn,46,7,8,9,10,38,47,-9,33
Perth Glory,46,8,10,2,15,37,50,-13,32
Wellington P,46,9,5,6,16,31,55,-24,21
CC Mariners,46,10,4,8,15,28,49,-21,20
Sydney FC,47,1,21,4,3,66,23,43,67
N'castle Jet,47,2,15,5,8,57,38,19,50
Melbourne C,47,3,15,4,10,44,33,11,49
Melbourne V,47,4,13,5,11,46,40,6,44
Adelaide Utd,47,5,11,6,11,37,40,-3,39
Brisbane,47,6,10,5,13,33,42,-9,35
Western Sydn,47,7,8,9,10,38,47,-9,33
Perth Glory,47,8,10,2,15,37,50,-13,32
Wellington P,47,9,5,6,16,31,55,-24,21
CC Mariners,47,10,4,8,15,28,49,-21,20
Sydney FC,48,1,20,5,3,66,24,42,65
N'castle Jet,48,2,15,6,7,59,39,20,51
Melbourne C,48,3,14,5,10,45,35,10,47
Melbourne V,48,4,13,6,10,47,40,7,45
Adelaide Utd,48,5,11,6,11,37,40,-3,39
Brisbane,48,6,10,5,13,33,42,-9,35
Western Sydn,48,7,8,9,10,38,47,-9,33
Perth Glory,48,8,10,2,15,37,50,-13,32
Wellington P,48,9,5,6,16,31,55,-24,21
CC Mariners,48,10,4,8,15,28,49,-21,20
Sydney FC,49,1,21,4,3,67,23,44,67
N'castle Jet,49,2,16,5,7,58,37,21,53
Melbourne C,49,3,14,4,11,43,34,9,46
Melbourne V,49,4,13,5,11,46,41,5,44
Adelaide Utd,49,5,11,6,11,37,40,-3,39
Brisbane,49,6,10,5,13,33,42,-9,35
Western Sydn,49,7,8,9,10,38,47,-9,33
Perth Glory,49,8,10,2,15,37,50,-13,32
Wellington P,49,9,5,6,16,31,55,-24,21
CC Mariners,49,10,4,8,15,28,49,-21,20
Sydney FC,50,1,20,4,4,65,25,40,64
N'castle Jet,50,2,16,5,7,58,37,21,53
Melbourne V,50,3,14,5,10,48,39,9,47
Melbourne C,50,4,14,4,11,43,34,9,46
Adelaide Utd,50,5,11,6,11,37,40,-3,39
Brisbane,50,6,10,5,13,33,42,-9,35
Western Sydn,50,7,8,9,10,38,47,-9,33
Perth Glory,50,8,10,2,15,37,50,-13,32
Wellington P,50,9,5,6,16,31,55,-24,21
CC Mariners,50,10,4,8,15,28,49,-21,20
Sydney FC,51,1,21,4,3,66,23,43,67
N'castle Jet,51,2,16,5,7,59,37,22,53
Melbourne C,51,3,14,4,11,43,35,8,46
Melbourne V,51,4,13,5,11,46,40,6,44
Adelaide Utd,51,5,11,6,11,37,40,-3,39
Brisbane,51,6,10,5,13,33,42,-9,35
Western Sydn,51,7,8,9,10,38,47,-9,33
Perth Glory,51,8,10,2,15,37,50,-13,32
Wellington P,51,9,5,6,16,31,55,-24,21
CC Mariners,51,10,4,8,15,28,49,-21,20
Sydney FC,52,1,21,4,3,67,24,43,67
N'castle Jet,52,2,15,6,7,58,38,20,51
Melbourne C,52,3,14,5,10,44,34,10,47
Melbourne V,52,4,13,5,11,47,41,6,44
Adelaide Utd,52,5,11,6,11,37,40,-3,39
Brisbane,52,6,10,5,13,33,42,-9,35
Western Sydn,52,7,8,9,10,38,47,-9,33
Perth Glory,52,8,10,2,15,37,50,-13,32
Wellington P,52,9,5,6,16,31,55,-24,21
CC Mariners,52,10,4,8,15,28,49,-21,20
Sydney FC,53,1,21,4,3,65,22,43,67
N'castle Jet,53,2,15,6,7,58,38,20,51
Melbourne C,53,3,14,5,10,44,34,10,47
Melbourne V,53,4,13,5,11,45,39,6,44
Adelaide Utd,53,5,11,6,11,37,40,-3,39
Brisbane,53,6,10,5,13,33,42,-9,35
Western Sydn,53,7,8,9,10,38,47,-9,33
Perth Glory,53,8,10,2,15,37,50,-13,32
Wellington P,53,9,5,6,16,31,55,-24,21
CC Mariners,53,10,4,8,15,28,49,-21,20
Sydney FC,54,1,21,4,3,66,22,44,67
N'castle Jet,54,2,15,6,7,58,38,20,51
Melbourne C,54,3,14,5,10,44,34,10,47
Melbourne V,54,4,13,5,11,45,40,5,44
Adelaide Utd,54,5,11,6,11,37,40,-3,39
Brisbane,54,6,10,5,13,33,42,-9,35
Western Sydn,54,7,8,9,10,38,47,-9,33
Perth Glory,54,8,10,2,15,37,50,-13,32
Wellington P,54,9,5,6,16,31,55,-24,21
CC Mariners,54,10,4,8,15,28,49,-21,20
Sydney FC,55,1,20,5,3,64,22,42,65
N'castle Jet,55,2,16,5,7,60,38,22,53
Melbourne C,55,3,14,4,11,44,36,8,46
Melbourne V,55,4,13,6,10,45,38,7,45
Adelaide Utd,55,5,11,6,11,37,40,-3,39
Brisbane,55,6,10,5,13,33,42,-9,35
Western Sydn,55,7,8,9,10,38,47,-9,33
Perth Glory,55,8,10,2,15,37,50,-13,32
Wellington P,55,9,5,6,16,31,55,-24,21
CC Mariners,55,10,4,8,15,28,49,-21,20
Sydney FC,56,1,21,4,3,68,24,44,67
N'castle Jet,56,2,15,5,8,58,41,17,50
Melbourne C,56,3,15,4,10,47,34,13,49
Melbourne V,56,4,13,5,11,47,42,5,44
Adelaide Utd,56,5,11,6,11,37,40,-3,39
Brisbane,56,6,10,5,13,33,42,-9,35
Western Sydn,56,7,8,9,10,38,47,-9,33
Perth Glory,56,8,10,2,15,37,50,-13,32
Wellington P,56,9,5,6,16,31,55,-24,21
CC Mariners,56,10,4,8,15,28,49,-21,20
Sydney FC,57,1,21,4,3,68,22,46,67
N'castle Jet,57,2,15,5,8,57,39,18,50
Melbourne C,57,3,15,4,10,45,33,12,49
Melbourne V,57,4,13,5,11,45,42,3,44
Adelaide Utd,57,5,11,6,11,37,40,-3,39
Brisbane,57,6,10,5,13,33,42,-9,35
Western Sydn,57,7,8,9,10,38,47,-9,33
Perth Glory,57,8,10,2,15,37,50,-13,32
Wellington P,57,9,5,6,16,31,55,-24,21
CC Mariners,57,10,4,8,15,28,49,-21,20
Sydney FC,58,1,21,4,3,66,23,43,67
N'castle Jet,58,2,15,6,7,58,38,20,51
Melbourne C,58,3,14,5,10,44,34,10,47
Melbourne V,58,4,13,5,11,46,40,6,44
Adelaide Utd,58,5,11,6,11,37,40,-3,39
Brisbane,58,6,10,5,13,33,42,-9,35
Western Sydn,58,7,8,9,10,38,47,-9,33
Perth Glory,58,8,10,2,15,37,50,-13,32
Wellington P,58,9,5,6,16,31,55,-24,21
CC Mariners,58,10,4,8,15,28,49,-21,20
Sydney FC,59,1,20,4,4,65,24,41,64
N'castle Jet,59,2,15,5,8,57,39,18,50
Melbourne C,59,3,15,4,10,45,33,12,49
Melbourne V,59,4,14,5,10,47,39,8,47
Adelaide Utd,59,5,11,6,11,37,40,-3,39
Brisbane,59,6,10,5,13,33,42,-9,35
Western Sydn,59,7,8,9,10,38,47,-9,33
Perth Glory,59,8,10,2,15,37,50,-13,32
Wellington P,59,9,5,6,16,31,55,-24,21
CC Mariners,59,10,4,8,15,28,49,-21,20
Sydney FC,60,1,20,4,4,65,26,39,64
N'castle Jet,60,2,16,5,7,60,39,21,53
Melbourne V,60,3,14,5,10,49,39,10,47
Melbourne C,60,4,14,4,11,45,36,9,46
Adelaide Utd,60,5,11,6,11,37,40,-3,39
Brisbane,60,6,10,5,13,33,42,-9,35
Western Sydn,60,7,8,9,10,38,47,-9,33
Perth Glory,60,8,10,2,15,37,50,-13,32
Wellington P,60,9,5,6,16,31,55,-24,21
CC Mariners,60,10,4,8,15,28,49,-21,20
Sydney FC,61,1,20,4,4,65,24,41,64
N'castle Jet,61,2,16,5,7,59,37,22,53
Melbourne V,61,3,14,5,10,47,39,8,47
Melbourne C,61,4,14,4,11,43,35,8,46
Adelaide Utd,61,5,11,6,11,37,40,-3,39
Brisbane,61,6,10,5,13,33,42,-9,35
Western Sydn,61,7,8,9,10,38,47,-9,33
Perth Glory,61,8,10,2,15,37,50,-13,32
Wellington P,61,9,5,6,16,31,55,-24,21
CC Mariners,61,10,4,8,15,28,49,-21,20
Sydney FC,62,1,20,5,3,65,23,42,65
N'castle Jet,62,2,15,5,8,57,40,17,50
Melbourne C,62,3,15,4,10,46,33,13,49
Melbourne V,62,4,13,6,10,46,39,7,45
Adelaide Utd,62,5,11,6,11,37,40,-3,39
Brisbane,62,6,10,5,13,33,42,-9,35
Western Sydn,62,7,8,9,10,38,47,-9,33
Perth Glory,62,8,10,2,15,37,50,-13,32
Wellington P,62,9,5,6,16,31,55,-24,21
CC Mariners,62,10,4,8,15,28,49,-21,20
Sydney FC,63,1,20,4,4,65,25,40,64
N'castle Jet,63,2,16,5,7,59,37,22,53
Melbourne V,63,3,14,5,10,48,39,9,47
Melbourne C,63,4,14,4,11,43,35,8,46
Adelaide Utd,63,5,11,6,11,37,40,-3,39
Brisbane,63,6,10,5,13,33,42,-9,35
Western Sydn,63,7,8,9,10,38,47,-9,33
Perth Glory,63,8,10,2,15,37,50,-13,32
Wellington P,63,9,5,6,16,31,55,-24,21
CC Mariners,63,10,4,8,15,28,49,-21,20
Sydney FC,64,1,21,4,3,66,22,44,67
N'castle Jet,64,2,15,5,8,57,39,18,50
Melbourne C,64,3,15,4,10,45,33,12,49
Melbourne V,64,4,13,5,11,45,40,5,44
Adelaide Utd,64,5,11,6,11,37,40,-3,39
Brisbane,64,6,10,5,13,33,42,-9,35
Western Sydn,64,7,8,9,10,38,47,-9,33
Perth Glory,64,8,10,2,15,37,50,-13,32
Wellington P,64,9,5,6,16,31,55,-24,21
CC Mariners,64,10,4,8,15,28,49,-21,20
Sydney FC,65,1,21,4,3,66,22,44,67
N'castle Jet,65,2,15,5,8,58,39,19,50
Melbourne C,65,3,15,4,10,45,34,11,49
Melbourne V,65,4,13,5,11,45,40,5,44
Adelaide Utd,65,5,11,6,11,37,40,-3,39
Brisbane,65,6,10,5,13,33,42,-9,35
Western Sydn,65,7,8,9,10,38,47,-9,33
Perth Glory,65,8,10,2,15,37,50,-13,32
Wellington P,65,9,5,6,16,31,55,-24,21
CC Mariners,65,10,4,8,15,28,49,-21,20
Sydney FC,66,1,20,5,3,65,23,42,65
N'castle Jet,66,2,16,5,7,61,37,24,53
Melbourne C,66,3,14,4,11,43,37,6,46
Melbourne V,66,4,13,6,10,46,39,7,45
Adelaide Utd,66,5,11,6,11,37,40,-3,39
Brisbane,66,6,10,5,13,33,42,-9,35
Western Sydn,66,7,8,9,10,38,47,-9,33
Perth Glory,66,8,10,2,15,37,50,-13,32
Wellington P,66,9,5,6,16,31,55,-24,21
CC Mariners,66,10,4,8,15,28,49,-21,20
Sydney FC,67,1,20,4,4,65,25,40,64
N'castle Jet,67,2,16,5,7,59,37,22,53
Melbourne V,67,3,14,5,10,48,39,9,47
Melbourne C,67,4,14,4,11,43,35,8,46
Adelaide Utd,67,5,11,6,11,37,40,-3,39
Brisbane,67,6,10,5,13,33,42,-9,35
Western Sydn,67,7,8,9,10,38,47,-9,33
Perth Glory,67,8,10,2,15,37,50,-13,32
Wellington P,67,9,5,6,16,31,55,-24,21
CC Mariners,67,10,4,8,15,28,49,-21,20
Sydney FC,68,1,21,4,3,67,22,45,67
N'castle Jet,68,2,15,6,7,60,40,20,51
Melbourne C,68,3,14,5,10,46,36,10,47
Melbourne V,68,4,13,5,11,45,41,4,44
Adelaide Utd,68,5,11,6,11,37,40,-3,39
Brisbane,68,6,10,5,13,33,42,-9,35
Western Sydn,68,7,8,9,10,38,47,-9,33
Perth Glory,68,8,10,2,15,37,50,-13,32
Wellington P,68,9,5,6,16,31,55,-24,21
CC Mariners,68,10,4,8,15,28,49,-21,20
Sydney FC,69,1,21,4,3,68,23,45,67
N'castle Jet,69,2,16,5,7,59,37,22,53
Melbourne C,69,3,14,4,11,43,35,8,46
Melbourne V,69,4,13,5,11,46,42,4,44
Adelaide Utd,69,5,11,6,11,37,40,-3,39
Brisbane,69,6,10,5,13,33,42,-9,35
Western Sydn,69,7,8,9,10,38,47,-9,33
Perth Glory,69,8,10,2,15,37,50,-13,32
Wellington P,69,9,5,6,16,31,55,-24,21
CC Mariners,69,10,4,8,15,28,49,-21,20
Sydney FC,70,1,20,4,4,64,23,41,64
N'castle Jet,70,2,15,6,7,57,37,20,51
Melbourne C,70,3,14,5,10,43,33,10,47
Melbourne V,70,4,14,5,10,46,38,8,47
Adelaide Utd,70,5,11,6,11,37,40,-3,39
Brisbane,70,6,10,5,13,33,42,-9,35
Western Sydn,70,7,8,9,10,38,47,-9,33
Perth Glory,70,8,10,2,15,37,50,-13,32
Wellington P,70,9,5,6,16,31,55,-24,21
CC Mariners,70,10,4,8,15,28,49,-21,20
Sydney FC,71,1,21,4,3,65,22,43,67
N'castle Jet,71,2,15,5,8,58,41,17,50
Melbourne C,71,3,15,4,10,47,34,13,49
Melbourne V,71,4,13,5,11,45,39,6,44
Adelaide Utd,71,5,11,6,11,37,40,-3,39
Brisbane,71,6,10,5,13,33,42,-9,35
Western Sydn,71,7,8,9,10,38,47,-9,33
Perth Glory,71,8,10,2,15,37,50,-13,32
Wellington P,71,9,5,6,16,31,55,-24,21
CC Mariners,71,10,4,8,15,28,49,-21,20
Sydney FC,72,1,21,4,3,67,23,44,67
N'castle Jet,72,2,15,6,7,57,37,20,51
Melbourne C,72,3,14,5,10,43,33,10,47
Melbourne V,72,4,13,5,11,46,41,5,44
Adelaide Utd,72,5,11,6,11,37,40,-3,39
Brisbane,72,6,10,5,13,33,42,-9,35
Western Sydn,72,7,8,9,10,38,47,-9,33
Perth Glory,72,8,10,2,15,37,50,-13,32
Wellington P,72,9,5,6,16,31,55,-24,21
CC Mariners,72,10,4,8,15,28,49,-21,20
Sydney FC,73,1,21,4,3,66,23,43,67
N'castle Jet,73,2,15,5,8,58,39,19,50
Melbourne C,73,3,15,4,10,45,34,11,49
Melbourne V,73,4,13,5,11,46,40,6,44
Adelaide Utd,73,5,11,6,11,37,40,-3,39
Brisbane,73,6,10,5,13,33,42,-9,35
Western Sydn,73,7,8,9,10,38,47,-9,33
Perth Glory,73,8,10,2,15,37,50,-13,32
Wellington P,73,9,5,6,16,31,55,-24,21
CC Mariners,73,10,4,8,15,28,49,-21,20
Sydney FC,74,1,20,5,3,66,24,42,65
N'castle Jet,74,2,15,5,8,58,39,19,50
Melbourne C,74,3,15,4,10,45,34,11,49
Melbourne V,74,4,13,6,10,47,40,7,45
Adelaide Utd,74,5,11,6,11,37,40,-3,39
Brisbane,74,6,10,5,13,33,42,-9,35
Western Sydn,74,7,8,9,10,38,47,-9,33
Perth Glory,74,8,10,2,15,37,50,-13,32
Wellington P,74,9,5,6,16,31,55,-24,21
CC Mariners,74,10,4,8,15,28,49,-21,20
Sydney FC,75,1,21,4,3,67,22,45,67
N'castle Jet,75,2,15,6,7,58,38,20,51
Melbourne C,75,3,14,5,10,44,34,10,47
Melbourne V,75,4,13,5,11,45,41,4,44
Adelaide Utd,75,5,11,6,11,37,40,-3,39
Brisbane,75,6,10,5,13,33,42,-9,35
Western Sydn,75,7,8,9,10,38,47,-9,33
Perth Glory,75,8,10,2,15,37,50,-13,32
Wellington P,75,9,5,6,16,31,55,-24,21
CC Mariners,75,10,4,8,15,28,49,-21,20
Sydney FC,76,1,21,4,3,66,23,43,67
N'castle Jet,76,2,15,6,7,60,40,20,51
Melbourne C,76,3,14,5,10,46,36,10,47
Melbourne V,76,4,13,5,11,46,40,6,44
Adelaide Utd,76,5,11,6,11,37,40,-3,39
Brisbane,76,6,10,5,13,33,42,-9,35
Western Sydn,76,7,8,9,10,38,47,-9,33
Perth Glory,76,8,10,2,15,37,50,-13,32
Wellington P,76,9,5,6,16,31,55,-24,21
CC Mariners,76,10,4,8,15,28,49,-21,20
Sydney FC,77,1,20,4,4,65,24,41,64
N'castle Jet,77,2,16,5,7,60,37,23,53
Melbourne V,77,3,14,5,10,47,39,8,47
Melbourne C,77,4,14,4,11,43,36,7,46
Adelaide Utd,77,5,11,6,11,37,40,-3,39
Brisbane,77,6,10,5,13,33,42,-9,35
Western Sydn,77,7,8,9,10,38,47,-9,33
Perth Glory,77,8,10,2,15,37,50,-13,32
Wellington P,77,9,5,6,16,31,55,-24,21
CC Mariners,77,10,4,8,15,28,49,-21,20
Sydney FC,78,1,21,4,3,66,23,43,67
N'castle Jet,78,2,16,5,7,58,37,21,53
Melbourne C,78,3,14,4,11,43,34,9,46
Melbourne V,78,4,13,5,11,46,40,6,44
Adelaide Utd,78,5,11,6,11,37,40,-3,39
Brisbane,78,6,10,5,13,33,42,-9,35
Western Sydn,78,7,8,9,10,38,47,-9,33
Perth Glory,78,8,10,2,15,37,50,-13,32
Wellington P,78,9,5,6,16,31,55,-24,21
CC Mariners,78,10,4,8,15,28,49,-21,20
Sydney FC,79,1,21,4,3,66,23,43,67
N'castle Jet,79,2,16,5,7,59,37,22,53
Melbourne C,79,3,14,4,11,43,35,8,46
Melbourne V,79,4,13,5,11,46,40,6,44
Adelaide Utd,79,5,11,6,11,37,40,-3,39
Brisbane,79,6,10,5,13,33,42,-9,35
Western Sydn,79,7,8,9,10,38,47,-9,33
Perth Glory,79,8,10,2,15,37,50,-13,32
Wellington P,79,9,5,6,16,31,55,-24,21
CC Mariners,79,10,4,8,15,28,49,-21,20
Sydney FC,80,1,20,5,3,64,22,42,65
N'castle Jet,80,2,15,5,8,57,38,19,50
Melbourne C,80,3,15,4,10,44,33,11,49
Melbourne V,80,4,13,6,10,45,38,7,45
Adelaide Utd,80,5,11,6,11,37,40,-3,39
Brisbane,80,6,10,5,13,33,42,-9,35
Western Sydn,80,7,8,9,10,38,47,-9,33
Perth Glory,80,8,10,2,15,37,50,-13,32
Wellington P,80,9,5,6,16,31,55,-24,21
CC Mariners,80,10,4,8,15,28,49,-21,20
Sydney FC,81,1,20,4,4,64,23,41,64
N'castle Jet,81,2,16,5,7,59,37,22,53
Melbourne V,81,3,14,5,10,46,38,8,47
Melbourne C,81,4,14,4,11,43,35,8,46
Adelaide Utd,81,5,11,6,11,37,40,-3,39
Brisbane,81,6,10,5,13,33,42,-9,35
Western Sydn,81,7,8,9,10,38,47,-9,33
Perth Glory,81,8,10,2,15,37,50,-13,32
Wellington P,81,9,5,6,16,31,55,-24,21
CC Mariners,81,10,4,8,15,28,49,-21,20
Sydney FC,82,1,20,5,3,66,24,42,65
N'castle Jet,82,2,15,5,8,58,39,19,50
Melbourne C,82,3,15,4,10,45,34,11,49
Melbourne V,82,4,13,6,10,47,40,7,45
Adelaide Utd,82,5,11,6,11,37,40,-3,39
Brisbane,82,6,10,5,13,33,42,-9,35
Western Sydn,82,7,8,9,10,38,47,-9,33
Perth Glory,82,8,10,2,15,37,50,-13,32
Wellington P,82,9,5,6,16,31,55,-24,21
CC Mariners,82,10,4,8,15,28,49,-21,20
Sydney FC,83,1,21,4,3,68,22,46,67
N'castle Jet,83,2,15,6,7,57,37,20,51
Melbourne C,83,3,14,5,10,43,33,10,47
Melbourne V,83,4,13,5,11,45,42,3,44
Adelaide Utd,83,5,11,6,11,37,40,-3,39
Brisbane,83,6,10,5,13,33,42,-9,35
Western Sydn,83,7,8,9,10,38,47,-9,33
Perth Glory,83,8,10,2,15,37,50,-13,32
Wellington P,83,9,5,6,16,31,55,-24,21
CC Mariners,83,10,4,8,15,28,49,-21,20
Sydney FC,84,1,21,4,3,67,24,43,67
N'castle Jet,84,2,16,5,7,61,39,22,53
Melbourne C,84,3,14,4,11,45,37,8,46
Melbourne V,84,4,13,5,11,47,41,6,44
Adelaide Utd,84,5,11,6,11,37,40,-3,39
Brisbane,84,6,10,5,13,33,42,-9,35
Western Sydn,84,7,8,9,10,38,47,-9,33
Perth Glory,84,8,10,2,15,37,50,-13,32
Wellington P,84,9,5,6,16,31,55,-24,21
CC Mariners,84,10,4,8,15,28,49,-21,20
Sydney FC,85,1,20,4,4,64,23,41,64
N'castle Jet,85,2,15,6,7,58,38,20,51
Melbourne C,85,3,14,5,10,44,34,10,47
Melbourne V,85,4,14,5,10,46,38,8,47
Adelaide Utd,85,5,11,6,11,37,40,-3,39
Brisbane,85,6,10,5,13,33,42,-9,35
Western Sydn,85,7,8,9,10,38,47,-9,33
Perth Glory,85,8,10,2,15,37,50,-13,32
Wellington P,85,9,5,6,16,31,55,-24,21
CC Mariners,85,10,4,8,15,28,49,-21,20
Sydney FC,86,1,20,5,3,65,23,42,65
N'castle Jet,86,2,15,5,8,57,38,19,50
Melbourne C,86,3,15,4,10,44,33,11,49
Melbourne V,86,4,13,6,10,46,39,7,45
Adelaide Utd,86,5,11,6,11,37,40,-3,39
Brisbane,86,6,10,5,13,33,42,-9,35
Western Sydn,86,7,8,9,10,38,47,-9,33
Perth Glory,86,8,10,2,15,37,50,-13,32
Wellington P,86,9,5,6,16,31,55,-24,21
CC Mariners,86,10,4,8,15,28,49,-21,20
Sydney FC,87,1,20,4,4,64,27,37,64
N'castle Jet,87,2,15,5,8,58,39,19,50
Melbourne C,87,3,15,4,10,45,34,11,49
Melbourne V,87,4,14,5,10,50,38,12,47
Adelaide Utd,87,5,11,6,11,37,40,-3,39
Brisbane,87,6,10,5,13,33,42,-9,35
Western Sydn,87,7,8,9,10,38,47,-9,33
Perth Glory,87,8,10,2,15,37,50,-13,32
Wellington P,87,9,5,6,16,31,55,-24,21
CC Mariners,87,10,4,8,15,28,49,-21,20
Sydney FC,88,1,20,5,3,67,25,42,65
N'castle Jet,88,2,16,5,7,60,39,21,53
Melbourne C,88,3,14,4,11,45,36,9,46
Melbourne V,88,4,13,6,10,48,41,7,45
Adelaide Utd,88,5,11,6,11,37,40,-3,39
Brisbane,88,6,10,5,13,33,42,-9,35
Western Sydn,88,7,8,9,10,38,47,-9,33
Perth Glory,88,8,10,2,15,37,50,-13,32
Wellington P,88,9,5,6,16,31,55,-24,21
CC Mariners,88,10,4,8,15,28,49,-21,20
Sydney FC,89,1,21,4,3,66,23,43,67
N'castle Jet,89,2,16,5,7,62,37,25,53
Melbourne C,89,3,14,4,11,43,38,5,46
Melbourne V,89,4,13,5,11,46,40,6,44
Adelaide Utd,89,5,11,6,11,37,40,-3,39
Brisbane,89,6,10,5,13,33,42,-9,35
Western Sydn,89,7,8,9,10,38,47,-9,33
Perth Glory,89,8,10,2,15,37,50,-13,32
Wellington P,89,9,5,6,16,31,55,-24,21
CC Mariners,89,10,4,8,15,28,49,-21,20
Sydney FC,90,1,21,4,3,66,23,43,67
N'castle Jet,90,2,16,5,7,59,37,22,53
Melbourne C,90,3,14,4,11,43,35,8,46
Melbourne V,90,4,13,5,11,46,40,6,44
Adelaide Utd,90,5,11,6,11,37,40,-3,39
Brisbane,90,6,10,5,13,33,42,-9,35
Western Sydn,90,7,8,9,10,38,47,-9,33
Perth Glory,90,8,10,2,15,37,50,-13,32
Wellington P,90,9,5,6,16,31,55,-24,21
CC Mariners,90,10,4,8,15,28,49,-21,20
Sydney FC,91,1,21,4,3,67,24,43,67
N'castle Jet,91,2,15,5,8,57,40,17,50
Melbourne C,91,3,15,4,10,46,33,13,49
Melbourne V,91,4,13,5,11,47,41,6,44
Adelaide Utd,91,5,11,6,11,37,40,-3,39
Brisbane,91,6,10,5,13,33,42,-9,35
Western Sydn,91,7,8,9,10,38,47,-9,33
Perth Glory,91,8,10,2,15,37,50,-13,32
Wellington P,91,9,5,6,16,31,55,-24,21
CC Mariners,91,10,4,8,15,28,49,-21,20
Sydney FC,92,1,20,5,3,64,22,42,65
N'castle Jet,92,2,16,5,7,59,37,22,53
Melbourne C,92,3,14,4,11,43,35,8,46
Melbourne V,92,4,13,6,10,45,38,7,45
Adelaide Utd,92,5,11,6,11,37,40,-3,39
Brisbane,92,6,10,5,13,33,42,-9,35
Western Sydn,92,7,8,9,10,38,47,-9,33
Perth Glory,92,8,10,2,15,37,50,-13,32
Wellington P,92,9,5,6,16,31,55,-24,21
CC Mariners,92,10,4,8,15,28,49,-21,20
Sydney FC,93,1,21,4,3,66,22,44,67
N'castle Jet,93,2,16,5,7,60,37,23,53
Melbourne C,93,3,14,4,11,43,36,7,46
Melbourne V,93,4,13,5,11,45,40,5,44
Adelaide Utd,93,5,11,6,11,37,40,-3,39
Brisbane,93,6,10,5,13,33,42,-9,35
Western Sydn,93,7,8,9,10,38,47,-9,33
Perth Glory,93,8,10,2,15,37,50,-13,32
Wellington P,93,9,5,6,16,31,55,-24,21
CC Mariners,93,10,4,8,15,28,49,-21,20
Sydney FC,94,1,20,5,3,65,23,42,65
N'castle Jet,94,2,15,5,8,57,39,18,50
Melbourne C,94,3,15,4,10,45,33,12,49
Melbourne V,94,4,13,6,10,46,39,7,45
Adelaide Utd,94,5,11,6,11,37,40,-3,39
Brisbane,94,6,10,5,13,33,42,-9,35
Western Sydn,94,7,8,9,10,38,47,-9,33
Perth Glory,94,8,10,2,15,37,50,-13,32
Wellington P,94,9,5,6,16,31,55,-24,21
CC Mariners,94,10,4,8,15,28,49,-21,20
Sydney FC,95,1,21,4,3,70,23,47,67
N'castle Jet,95,2,16,5,7,59,38,21,53
Melbourne C,95,3,14,4,11,44,35,9,46
Melbourne V,95,4,13,5,11,46,44,2,44
Adelaide Utd,95,5,11,6,11,37,40,-3,39
Brisbane,95,6,10,5,13,33,42,-9,35
Western Sydn,95,7,8,9,10,38,47,-9,33
Perth Glory,95,8,10,2,15,37,50,-13,32
Wellington P,95,9,5,6,16,31,55,-24,21
CC Mariners,95,10,4,8,15,28,49,-21,20
Sydney FC,96,1,20,4,4,64,23,41,64
N'castle Jet,96,2,16,5,7,60,37,23,53
Melbourne V,96,3,14,5,10,46,38,8,47
Melbourne C,96,4,14,4,11,43,36,7,46
Adelaide Utd,96,5,11,6,11,37,40,-3,39
Brisbane,96,6,10,5,13,33,42,-9,35
Western Sydn,96,7,8,9,10,38,47,-9,33
Perth Glory,96,8,10,2,15,37,50,-13,32
Wellington P,96,9,5,6,16,31,55,-24,21
CC Mariners,96,10,4,8,15,28,49,-21,20
Sydney FC,97,1,21,4,3,69,23,46,67
N'castle Jet,97,2,16,5,7,60,37,23,53
Melbourne C,97,3,14,4,11,43,36,7,46
Melbourne V,97,4,13,5,11,46,43,3,44
Adelaide Utd,97,5,11,6,11,37,40,-3,39
Brisbane,97,6,10,5,13,33,42,-9,35
Western Sydn,97,7,8,9,10,38,47,-9,33
Perth Glory,97,8,10,2,15,37,50,-13,32
Wellington P,97,9,5,6,16,31,55,-24,21
CC Mariners,97,10,4,8,15,28,49,-21,20
Sydney FC,98,1,21,4,3,65,22,43,67
N'castle Jet,98,2,15,5,8,57,40,17,50
Melbourne C,98,3,15,4,10,46,33,13,49
Melbourne V,98,4,13,5,11,45,39,6,44
Adelaide Utd,98,5,11,6,11,37,40,-3,39
Brisbane,98,6,10,5,13,33,42,-9,35
Western Sydn,98,7,8,9,10,38,47,-9,33
Perth Glory,98,8,10,2,15,37,50,-13,32
Wellington P,98,9,5,6,16,31,55,-24,21
CC Mariners,98,10,4,8,15,28,49,-21,20
Sydney FC,99,1,20,5,3,65,23,42,65
N'castle Jet,99,2,15,6,7,58,38,20,51
Melbourne C,99,3,14,5,10,44,34,10,47
Melbourne V,99,4,13,6,10,46,39,7,45
Adelaide Utd,99,5,11,6,11,37,40,-3,39
Brisbane,99,6,10,5,13,33,42,-9,35
Western Sydn,99,7,8,9,10,38,47,-9,33
Perth Glory,99,8,10,2,15,37,50,-13,32
Wellington P,99,9,5,6,16,31,55,-24,21
CC Mariners,99,10,4,8,15,28,49,-21,20
Sydney FC,100,1,21,4,3,65,22,43,67
N'castle Jet,100,2,16,5,7,59,38,21,53
Melbourne C,100,3,14,4,11,44,35,9,46
Melbourne V,100,4,13,5,11,45,39,6,44
Adelaide Utd,100,5,11,6,11,37,40,-3,39
Brisbane,100,6,10,5,13,33,42,-9,35
Western Sydn,100,7,8,9,10,38,47,-9,33
Perth Glory,100,8,10,2,15,37,50,-13,32
Wellington P,100,9,5,6,16,31,55,-24,21
CC Mariners,100,10,4,8,15,28,49,-21,20
Sydney FC,101,1,21,4,3,67,23,44,67
N'castle Jet,101,2,16,5,7,61,37,24,53
Melbourne C,101,3,14,4,11,43,37,6,46
Melbourne V,101,4,13,5,11,46,41,5,44
Adelaide Utd,101,5,11,6,11,37,40,-3,39
Brisbane,101,6,10,5,13,33,42,-9,35
Western Sydn,101,7,8,9,10,38,47,-9,33
Perth Glory,101,8,10,2,15,37,50,-13,32
Wellington P,101,9,5,6,16,31,55,-24,21
CC Mariners,101,10,4,8,15,28,49,-21,20
Sydney FC,102,1,21,4,3,66,22,44,67
N'castle Jet,102,2,16,5,7,60,38,22,53
Melbourne C,102,3,14,4,11,44,36,8,46
Melbourne V,102,4,13,5,11,45,40,5,44
Adelaide Utd,102,5,11,6,11,37,40,-3,39
Brisbane,102,6,10,5,13,33,42,-9,35
Western Sydn,102,7,8,9,10,38,47,-9,33
Perth Glory,102,8,10,2,15,37,50,-13,32
Wellington P,102,9,5,6,16,31,55,-24,21
CC Mariners,102,10,4,8,15,28,49,-21,20
Sydney FC,103,1,21,4,3,66,22,44,67
N'castle Jet,103,2,16,5,7,58,37,21,53
Melbourne C,103,3,14,4,11,43,34,9,46
Melbourne V,103,4,13,5,11,45,40,5,44
Adelaide Utd,103,5,11,6,11,37,40,-3,39
Brisbane,103,6,10,5,13,33,42,-9,35
Western Sydn,103,7,8,9,10,38,47,-9,33
Perth Glory,103,8,10,2,15,37,50,-13,32
Wellington P,103,9,5,6,16,31,55,-24,21
CC Mariners,103,10,4,8,15,28,49,-21,20
Sydney FC,104,1,21,4,3,67,22,45,67
N'castle Jet,104,2,16,5,7,64,39,25,53
Melbourne C,104,3,14,4,11,45,40,5,46
Melbourne V,104,4,13,5,11,45,41,4,44
Adelaide Utd,104,5,11,6,11,37,40,-3,39
Brisbane,104,6,10,5,13,33,42,-9,35
Western Sydn,104,7,8,9,10,38,47,-9,33
Perth Glory,104,8,10,2,15,37,50,-13,32
Wellington P,104,9,5,6,16,31,55,-24,21
CC Mariners,104,10,4,8,15,28,49,-21,20
Sydney FC,105,1,21,4,3,67,22,45,67
N'castle Jet,105,2,16,5,7,62,37,25,53
Melbourne C,105,3,14,4,11,43,38,5,46
Melbourne V,105,4,13,5,11,45,41,4,44
Adelaide Utd,105,5,11,6,11,37,40,-3,39
Brisbane,105,6,10,5,13,33,42,-9,35
Western Sydn,105,7,8,9,10,38,47,-9,33
Perth Glory,105,8,10,2,15,37,50,-13,32
Wellington P,105,9,5,6,16,31,55,-24,21
CC Mariners,105,10,4,8,15,28,49,-21,20
Sydney FC,106,1,21,4,3,66,22,44,67
N'castle Jet,106,2,16,5,7,59,38,21,53
Melbourne C,106,3,14,4,11,44,35,9,46
Melbourne V,106,4,13,5,11,45,40,5,44
Adelaide Utd,106,5,11,6,11,37,40,-3,39
Brisbane,106,6,10,5,13,33,42,-9,35
Western Sydn,106,7,8,9,10,38,47,-9,33
Perth Glory,106,8,10,2,15,37,50,-13,32
Wellington P,106,9,5,6,16,31,55,-24,21
CC Mariners,106,10,4,8,15,28,49,-21,20
Sydney FC,107,1,20,5,3,65,23,42,65
N'castle Jet,107,2,15,6,7,57,37,20,51
Melbourne C,107,3,14,5,10,43,33,10,47
Melbourne V,107,4,13,6,10,46,39,7,45
Adelaide Utd,107,5,11,6,11,37,40,-3,39
Brisbane,107,6,10,5,13,33,42,-9,35
Western Sydn,107,7,8,9,10,38,47,-9,33
Perth Glory,107,8,10,2,15,37,50,-13,32
Wellington P,107,9,5,6,16,31,55,-24,21
CC Mariners,107,10,4,8,15,28,49,-21,20
Sydney FC,108,1,20,4,4,64,23,41,64
N'castle Jet,108,2,15,6,7,57,37,20,51
Melbourne C,108,3,14,5,10,43,33,10,47
Melbourne V,108,4,14,5,10,46,38,8,47
Adelaide Utd,108,5,11,6,11,37,40,-3,39
Brisbane,108,6,10,5,13,33,42,-9,35
Western Sydn,108,7,8,9,10,38,47,-9,33
Perth Glory,108,8,10,2,15,37,50,-13,32
Wellington P,108,9,5,6,16,31,55,-24,21
CC Mariners,108,10,4,8,15,28,49,-21,20
Sydney FC,109,1,21,4,3,66,22,44,67
N'castle Jet,109,2,15,5,8,57,38,19,50
Melbourne C,109,3,15,4,10,44,33,11,49
Melbourne V,109,4,13,5,11,45,40,5,44
Adelaide Utd,109,5,11,6,11,37,40,-3,39
Brisbane,109,6,10,5,13,33,42,-9,35
Western Sydn,109,7,8,9,10,38,47,-9,33
Perth Glory,109,8,10,2,15,37,50,-13,32
Wellington P,109,9,5,6,16,31,55,-24,21
CC Mariners,109,10,4,8,15,28,49,-21,20
Sydney FC,110,1,20,4,4,64,23,41,64
N'castle Jet,110,2,16,5,7,62,38,24,53
Melbourne V,110,3,14,5,10,46,38,8,47
Melbourne C,110,4,14,4,11,44,38,6,46
Adelaide Utd,110,5,11,6,11,37,40,-3,39
Brisbane,110,6,10,5,13,33,42,-9,35
Western Sydn,110,7,8,9,10,38,47,-9,33
Perth Glory,110,8,10,2,15,37,50,-13,32
Wellington P,110,9,5,6,16,31,55,-24,21
CC Mariners,110,10,4,8,15,28,49,-21,20
Sydney FC,111,1,20,5,3,65,23,42,65
N'castle Jet,111,2,15,5,8,59,40,19,50
Melbourne C,111,3,15,4,10,46,35,11,49
Melbourne V,111,4,13,6,10,46,39,7,45
Adelaide Utd,111,5,11,6,11,37,40,-3,39
Brisbane,111,6,10,5,13,33,42,-9,35
Western Sydn,111,7,8,9,10,38,47,-9,33
Perth Glory,111,8,10,2,15,37,50,-13,32
Wellington P,111,9,5,6,16,31,55,-24,21
CC Mariners,111,10,4,8,15,28,49,-21,20
Sydney FC,112,1,20,5,3,65,23,42,65
N'castle Jet,112,2,15,5,8,57,39,18,50
Melbourne C,112,3,15,4,10,45,33,12,49
Melbourne V,112,4,13,6,10,46,39,7,45
Adelaide Utd,112,5,11,6,11,37,40,-3,39
Brisbane,112,6,10,5,13,33,42,-9,35
Western Sydn,112,7,8,9,10,38,47,-9,33
Perth Glory,112,8,10,2,15,37,50,-13,32
Wellington P,112,9,5,6,16,31,55,-24,21
CC Mariners,112,10,4,8,15,28,49,-21,20
Sydney FC,113,1,21,4,3,67,24,43,67
N'castle Jet,113,2,16,5,7,63,38,25,53
Melbourne C,113,3,14,4,11,44,39,5,46
Melbourne V,113,4,13,5,11,47,41,6,44
Adelaide Utd,113,5,11,6,11,37,40,-3,39
Brisbane,113,6,10,5,13,33,42,-9,35
Western Sydn,113,7,8,9,10,38,47,-9,33
Perth Glory,113,8,10,2,15,37,50,-13,32
Wellington P,113,9,5,6,16,31,55,-24,21
CC Mariners,113,10,4,8,15,28,49,-21,20
Sydney FC,114,1,20,4,4,64,23,41,64
N'castle Jet,114,2,15,6,7,59,39,20,51
Melbourne C,114,3,14,5,10,45,35,10,47
Melbourne V,114,4,14,5,10,46,38,8,47
Adelaide Utd,114,5,11,6,11,37,40,-3,39
Brisbane,114,6,10,5,13,33,42,-9,35
Western Sydn,114,7,8,9,10,38,47,-9,33
Perth Glory,114,8,10,2,15,37,50,-13,32
Wellington P,114,9,5,6,16,31,55,-24,21
CC Mariners,114,10,4,8,15,28,49,-21,20
Sydney FC,115,1,21,4,3,66,22,44,67
N'castle Jet,115,2,15,6,7,57,37,20,51
Melbourne C,115,3,14,5,10,43,33,10,47
Melbourne V,115,4,13,5,11,45,40,5,44
Adelaide Utd,115,5,11,6,11,37,40,-3,39
Brisbane,115,6,10,5,13,33,42,-9,35
Western Sydn,115,7,8,9,10,38,47,-9,33
Perth Glory,115,8,10,2,15,37,50,-13,32
Wellington P,115,9,5,6,16,31,55,-24,21
CC Mariners,115,10,4,8,15,28,49,-21,20
Sydney FC,116,1,20,4,4,64,24,40,64
N'castle Jet,116,2,16,5,7,59,38,21,53
Melbourne V,116,3,14,5,10,47,38,9,47
Melbourne C,116,4,14,4,11,44,35,9,46
Adelaide Utd,116,5,11,6,11,37,40,-3,39
Brisbane,116,6,10,5,13,33,42,-9,35
Western Sydn,116,7,8,9,10,38,47,-9,33
Perth Glory,116,8,10,2,15,37,50,-13,32
Wellington P,116,9,5,6,16,31,55,-24,21
CC Mariners,116,10,4,8,15,28,49,-21,20
Sydney FC,117,1,21,4,3,66,23,43,67
N'castle Jet,117,2,15,5,8,58,39,19,50
Melbourne C,117,3,15,4,10,45,34,11,49
Melbourne V,117,4,13,5,11,46,40,6,44
Adelaide Utd,117,5,11,6,11,37,40,-3,39
Brisbane,117,6,10,5,13,33,42,-9,35
Western Sydn,117,7,8,9,10,38,47,-9,33
Perth Glory,117,8,10,2,15,37,50,-13,32
Wellington P,117,9,5,6,16,31,55,-24,21
CC Mariners,117,10,4,8,15,28,49,-21,20
Sydney FC,118,1,21,4,3,67,22,45,67
N'castle Jet,118,2,15,5,8,58,40,18,50
Melbourne C,118,3,15,4,10,46,34,12,49
Melbourne V,118,4,13,5,11,45,41,4,44
Adelaide Utd,118,5,11,6,11,37,40,-3,39
Brisbane,118,6,10,5,13,33,42,-9,35
Western Sydn,118,7,8,9,10,38,47,-9,33
Perth Glory,118,8,10,2,15,37,50,-13,32
Wellington P,118,9,5,6,16,31,55,-24,21
CC Mariners,118,10,4,8,15,28,49,-21,20
Sydney FC,119,1,21,4,3,65,22,43,67
N'castle Jet,119,2,16,5,7,59,37,22,53
Melbourne C,119,3,14,4,11,43,35,8,46
Melbourne V,119,4,13,5,11,45,39,6,44
Adelaide Utd,119,5,11,6,11,37,40,-3,39
Brisbane,119,6,10,5,13,33,42,-9,35
Western Sydn,119,7,8,9,10,38,47,-9,33
Perth Glory,119,8,10,2,15,37,50,-13,32
Wellington P,119,9,5,6,16,31,55,-24,21
CC Mariners,119,10,4,8,15,28,49,-21,20
Sydney FC,120,1,21,4,3,69,23,46,67
N'castle Jet,120,2,15,6,7,58,38,20,51
Melbourne C,120,3,14,5,10,44,34,10,47
Melbourne V,120,4,13,5,11,46,43,3,44
Adelaide Utd,120,5,11,6,11,37,40,-3,39
Brisbane,120,6,10,5,13,33,42,-9,35
Western Sydn,120,7,8,9,10,38,47,-9,33
Perth Glory,120,8,10,2,15,37,50,-13,32
Wellington P,120,9,5,6,16,31,55,-24,21
CC Mariners,120,10,4,8,15,28,49,-21,20
Sydney FC,121,1,21,4,3,66,23,43,67
N'castle Jet,121,2,15,6,7,58,38,20,51
Melbourne C,121,3,14,5,10,44,34,10,47
Melbourne V,121,4,13,5,11,46,40,6,44
Adelaide Utd,121,5,11,6,11,37,40,-3,39
Brisbane,121,6,10,5,13,33,42,-9,35
Western Sydn,121,7,8,9,10,38,47,-9,33
Perth Glory,121,8,10,2,15,37,50,-13,32
Wellington P,121,9,5,6,16,31,55,-24,21
CC Mariners,121,10,4,8,15,28,49,-21,20
Sydney FC,122,1,20,5,3,66,24,42,65
N'castle Jet,122,2,16,5,7,59,37,22,53
Melbourne C,122,3,14,4,11,43,35,8,46
Melbourne V,122,4,13,6,10,47,40,7,45
Adelaide Utd,122,5,11,6,11,37,40,-3,39
Brisbane,122,6,10,5,13,33,42,-9,35
Western Sydn,122,7,8,9,10,38,47,-9,33
Perth Glory,122,8,10,2,15,37,50,-13,32
Wellington P,122,9,5,6,16,31,55,-24,21
CC Mariners,122,10,4,8,15,28,49,-21,20
Sydney FC,123,1,21,4,3,68,22,46,67
N'castle Jet,123,2,16,5,7,60,39,21,53
Melbourne C,123,3,14,4,11,45,36,9,46
Melbourne V,123,4,13,5,11,45,42,3,44
Adelaide Utd,123,5,11,6,11,37,40,-3,39
Brisbane,123,6,10,5,13,33,42,-9,35
Western Sydn,123,7,8,9,10,38,47,-9,33
Perth Glory,123,8,10,2,15,37,50,-13,32
Wellington P,123,9,5,6,16,31,55,-24,21
CC Mariners,123,10,4,8,15,28,49,-21,20
Sydney FC,124,1,21,4,3,65,22,43,67
N'castle Jet,124,2,16,5,7,60,37,23,53
Melbourne C,124,3,14,4,11,43,36,7,46
Melbourne V,124,4,13,5,11,45,39,6,44
Adelaide Utd,124,5,11,6,11,37,40,-3,39
Brisbane,124,6,10,5,13,33,42,-9,35
Western Sydn,124,7,8,9,10,38,47,-9,33
Perth Glory,124,8,10,2,15,37,50,-13,32
Wellington P,124,9,5,6,16,31,55,-24,21
CC Mariners,124,10,4,8,15,28,49,-21,20
Sydney FC,125,1,21,4,3,68,24,44,67
N'castle Jet,125,2,15,6,7,59,39,20,51
Melbourne C,125,3,14,5,10,45,35,10,47
Melbourne V,125,4,13,5,11,47,42,5,44
Adelaide Utd,125,5,11,6,11,37,40,-3,39
Brisbane,125,6,10,5,13,33,42,-9,35
Western Sydn,125,7,8,9,10,38,47,-9,33
Perth Glory,125,8,10,2,15,37,50,-13,32
Wellington P,125,9,5,6,16,31,55,-24,21
CC Mariners,125,10,4,8,15,28,49,-21,20
Sydney FC,126,1,20,4,4,64,23,41,64
N'castle Jet,126,2,16,5,7,60,37,23,53
Melbourne V,126,3,14,5,10,46,38,8,47
Melbourne C,126,4,14,4,11,43,36,7,46
Adelaide Utd,126,5,11,6,11,37,40,-3,39
Brisbane,126,6,10,5,13,33,42,-9,35
Western Sydn,126,7,8,9,10,38,47,-9,33
Perth Glory,126,8,10,2,15,37,50,-13,32
Wellington P,126,9,5,6,16,31,55,-24,21
CC Mariners,126,10,4,8,15,28,49,-21,20
Sydney FC,127,1,20,4,4,64,23,41,64
N'castle Jet,127,2,15,6,7,58,38,20,51
Melbourne C,127,3,14,5,10,44,34,10,47
Melbourne V,127,4,14,5,10,46,38,8,47
Adelaide Utd,127,5,11,6,11,37,40,-3,39
Brisbane,127,6,10,5,13,33,42,-9,35
Western Sydn,127,7,8,9,10,38,47,-9,33
Perth Glory,127,8,10,2,15,37,50,-13,32
Wellington P,127,9,5,6,16,31,55,-24,21
CC Mariners,127,10,4,8,15,28,49,-21,20
Sydney FC,128,1,20,5,3,64,22,42,65
N'castle Jet,128,2,15,5,8,57,38,19,50
Melbourne C,128,3,15,4,10,44,33,11,49
Melbourne V,128,4,13,6,10,45,38,7,45
Adelaide Utd,128,5,11,6,11,37,40,-3,39
Brisbane,128,6,10,5,13,33,42,-9,35
Western Sydn,128,7,8,9,10,38,47,-9,33
Perth Glory,128,8,10,2,15,37,50,-13,32
Wellington P,128,9,5,6,16,31,55,-24,21
CC Mariners,128,10,4,8,15,28,49,-21,20
Sydney FC,129,1,21,4,3,66,23,43,67
N'castle Jet,129,2,15,6,7,58,38,20,51
Melbourne C,129,3,14,5,10,44,34,10,47
Melbourne V,129,4,13,5,11,46,40,6,44
Adelaide Utd,129,5,11,6,11,37,40,-3,39
Brisbane,129,6,10,5,13,33,42,-9,35
Western Sydn,129,7,8,9,10,38,47,-9,33
Perth Glory,129,8,10,2,15,37,50,-13,32
Wellington P,129,9,5,6,16,31,55,-24,21
CC Mariners,129,10,4,8,15,28,49,-21,20
Sydney FC,130,1,21,4,3,65,22,43,67
N'castle Jet,130,2,16,5,7,61,37,24,53
Melbourne C,130,3,14,4,11,43,37,6,46
Melbourne V,130,4,13,5,11,45,39,6,44
Adelaide Utd,130,5,11,6,11,37,40,-3,39
Brisbane,130,6,10,5,13,33,42,-9,35
Western Sydn,130,7,8,9,10,38,47,-9,33
Perth Glory,130,8,10,2,15,37,50,-13,32
Wellington P,130,9,5,6,16,31,55,-24,21
CC Mariners,130,10,4,8,15,28,49,-21,20
Sydney FC,131,1,21,4,3,65,22,43,67
N'castle Jet,131,2,16,5,7,60,37,23,53
Melbourne C,131,3,14,4,11,43,36,7,46
Melbourne V,131,4,13,5,11,45,39,6,44
Adelaide Utd,131,5,11,6,11,37,40,-3,39
Brisbane,131,6,10,5,13,33,42,-9,35
Western Sydn,131,7,8,9,10,38,47,-9,33
Perth Glory,131,8,10,2,15,37,50,-13,32
Wellington P,131,9,5,6,16,31,55,-24,21
CC Mariners,131,10,4,8,15,28,49,-21,20
Sydney FC,132,1,21,4,3,67,23,44,67
N'castle Jet,132,2,16,5,7,60,38,22,53
Melbourne C,132,3,14,4,11,44,36,8,46
Melbourne V,132,4,13,5,11,46,41,5,44
Adelaide Utd,132,5,11,6,11,37,40,-3,39
Brisbane,132,6,10,5,13,33,42,-9,35
Western Sydn,132,7,8,9,10,38,47,-9,33
Perth Glory,132,8,10,2,15,37,50,-13,32
Wellington P,132,9,5,6,16,31,55,-24,21
CC Mariners,132,10,4,8,15,28,49,-21,20
Sydney FC,133,1,21,4,3,67,23,44,67
N'castle Jet,133,2,15,5,8,58,39,19,50
Melbourne C,133,3,15,4,10,45,34,11,49
Melbourne V,133,4,13,5,11,46,41,5,44
Adelaide Utd,133,5,11,6,11,37,40,-3,39
Brisbane,133,6,10,5,13,33,42,-9,35
Western Sydn,133,7,8,9,10,38,47,-9,33
Perth Glory,133,8,10,2,15,37,50,-13,32
Wellington P,133,9,5,6,16,31,55,-24,21
CC Mariners,133,10,4,8,15,28,49,-21,20
Sydney FC,134,1,21,4,3,65,22,43,67
N'castle Jet,134,2,15,6,7,59,39,20,51
Melbourne C,134,3,14,5,10,45,35,10,47
Melbourne V,134,4,13,5,11,45,39,6,44
Adelaide Utd,134,5,11,6,11,37,40,-3,39
Brisbane,134,6,10,5,13,33,42,-9,35
Western Sydn,134,7,8,9,10,38,47,-9,33
Perth Glory,134,8,10,2,15,37,50,-13,32
Wellington P,134,9,5,6,16,31,55,-24,21
CC Mariners,134,10,4,8,15,28,49,-21,20
Sydney FC,135,1,20,4,4,66,26,40,64
N'castle Jet,135,2,16,5,7,61,37,24,53
Melbourne V,135,3,14,5,10,49,40,9,47
Melbourne C,135,4,14,4,11,43,37,6,46
Adelaide Utd,135,5,11,6,11,37,40,-3,39
Brisbane,135,6,10,5,13,33,42,-9,35
Western Sydn,135,7,8,9,10,38,47,-9,33
Perth Glory,135,8,10,2,15,37,50,-13,32
Wellington P,135,9,5,6,16,31,55,-24,21
CC Mariners,135,10,4,8,15,28,49,-21,20
Sydney FC,136,1,21,4,3,68,23,45,67
N'castle Jet,136,2,16,5,7,60,38,22,53
Melbourne C,136,3,14,4,11,44,36,8,46
Melbourne V,136,4,13,5,11,46,42,4,44
Adelaide Utd,136,5,11,6,11,37,40,-3,39
Brisbane,136,6,10,5,13,33,42,-9,35
Western Sydn,136,7,8,9,10,38,47,-9,33
Perth Glory,136,8,10,2,15,37,50,-13,32
Wellington P,136,9,5,6,16,31,55,-24,21
CC Mariners,136,10,4,8,15,28,49,-21,20
Sydney FC,137,1,21,4,3,68,23,45,67
N'castle Jet,137,2,16,5,7,59,38,21,53
Melbourne C,137,3,14,4,11,44,35,9,46
Melbourne V,137,4,13,5,11,46,42,4,44
Adelaide Utd,137,5,11,6,11,37,40,-3,39
Brisbane,137,6,10,5,13,33,42,-9,35
Western Sydn,137,7,8,9,10,38,47,-9,33
Perth Glory,137,8,10,2,15,37,50,-13,32
Wellington P,137,9,5,6,16,31,55,-24,21
CC Mariners,137,10,4,8,15,28,49,-21,20
Sydney FC,138,1,20,4,4,65,24,41,64
N'castle Jet,138,2,15,5,8,58,40,18,50
Melbourne C,138,3,15,4,10,46,34,12,49
Melbourne V,138,4,14,5,10,47,39,8,47
Adelaide Utd,138,5,11,6,11,37,40,-3,39
Brisbane,138,6,10,5,13,33,42,-9,35
Western Sydn,138,7,8,9,10,38,47,-9,33
Perth Glory,138,8,10,2,15,37,50,-13,32
Wellington P,138,9,5,6,16,31,55,-24,21
CC Mariners,138,10,4,8,15,28,49,-21,20
Sydney FC,139,1,20,5,3,64,22,42,65
N'castle Jet,139,2,15,6,7,57,37,20,51
Melbourne C,139,3,14,5,10,43,33,10,47
Melbourne V,139,4,13,6,10,45,38,7,45
Adelaide Utd,139,5,11,6,11,37,40,-3,39
Brisbane,139,6,10,5,13,33,42,-9,35
Western Sydn,139,7,8,9,10,38,47,-9,33
Perth Glory,139,8,10,2,15,37,50,-13,32
Wellington P,139,9,5,6,16,31,55,-24,21
CC Mariners,139,10,4,8,15,28,49,-21,20
Sydney FC,140,1,20,5,3,66,24,42,65
N'castle Jet,140,2,15,5,8,57,40,17,50
Melbourne C,140,3,15,4,10,46,33,13,49
Melbourne V,140,4,13,6,10,47,40,7,45
Adelaide Utd,140,5,11,6,11,37,40,-3,39
Brisbane,140,6,10,5,13,33,42,-9,35
Western Sydn,140,7,8,9,10,38,47,-9,33
Perth Glory,140,8,10,2,15,37,50,-13,32
Wellington P,140,9,5,6,16,31,55,-24,21
CC Mariners,140,10,4,8,15,28,49,-21,20
Sydney FC,141,1,20,4,4,66,25,41,64
N'castle Jet,141,2,16,5,7,60,39,21,53
Melbourne V,141,3,14,5,10,48,40,8,47
Melbourne C,141,4,14,4,11,45,36,9,46
Adelaide Utd,141,5,11,6,11,37,40,-3,39
Brisbane,141,6,10,5,13,33,42,-9,35
Western Sydn,141,7,8,9,10,38,47,-9,33
Perth Glory,141,8,10,2,15,37,50,-13,32
Wellington P,141,9,5,6,16,31,55,-24,21
CC Mariners,141,10,4,8,15,28,49,-21,20
Sydney FC,142,1,21,4,3,66,22,44,67
N'castle Jet,142,2,15,5,8,58,39,19,50
Melbourne C,142,3,15,4,10,45,34,11,49
Melbourne V,142,4,13,5,11,45,40,5,44
Adelaide Utd,142,5,11,6,11,37,40,-3,39
Brisbane,142,6,10,5,13,33,42,-9,35
Western Sydn,142,7,8,9,10,38,47,-9,33
Perth Glory,142,8,10,2,15,37,50,-13,32
Wellington P,142,9,5,6,16,31,55,-24,21
CC Mariners,142,10,4,8,15,28,49,-21,20
Sydney FC,143,1,21,4,3,66,23,43,67
N'castle Jet,143,2,15,5,8,57,40,17,50
Melbourne C,143,3,15,4,10,46,33,13,49
Melbourne V,143,4,13,5,11,46,40,6,44
Adelaide Utd,143,5,11,6,11,37,40,-3,39
Brisbane,143,6,10,5,13,33,42,-9,35
Western Sydn,143,7,8,9,10,38,47,-9,33
Perth Glory,143,8,10,2,15,37,50,-13,32
Wellington P,143,9,5,6,16,31,55,-24,21
CC Mariners,143,10,4,8,15,28,49,-21,20
Sydney FC,144,1,21,4,3,65,22,43,67
N'castle Jet,144,2,16,5,7,59,37,22,53
Melbourne C,144,3,14,4,11,43,35,8,46
Melbourne V,144,4,13,5,11,45,39,6,44
Adelaide Utd,144,5,11,6,11,37,40,-3,39
Brisbane,144,6,10,5,13,33,42,-9,35
Western Sydn,144,7,8,9,10,38,47,-9,33
Perth Glory,144,8,10,2,15,37,50,-13,32
Wellington P,144,9,5,6,16,31,55,-24,21
CC Mariners,144,10,4,8,15,28,49,-21,20
Sydney FC,145,1,20,4,4,65,25,40,64
N'castle Jet,145,2,16,5,7,60,37,23,53
Melbourne V,145,3,14,5,10,48,39,9,47
Melbourne C,145,4,14,4,11,43,36,7,46
Adelaide Utd,145,5,11,6,11,37,40,-3,39
Brisbane,145,6,10,5,13,33,42,-9,35
Western Sydn,145,7,8,9,10,38,47,-9,33
Perth Glory,145,8,10,2,15,37,50,-13,32
Wellington P,145,9,5,6,16,31,55,-24,21
CC Mariners,145,10,4,8,15,28,49,-21,20
Sydney FC,146,1,21,4,3,66,23,43,67
N'castle Jet,146,2,16,5,7,59,37,22,53
Melbourne C,146,3,14,4,11,43,35,8,46
Melbourne V,146,4,13,5,11,46,40,6,44
Adelaide Utd,146,5,11,6,11,37,40,-3,39
Brisbane,146,6,10,5,13,33,42,-9,35
Western Sydn,146,7,8,9,10,38,47,-9,33
Perth Glory,146,8,10,2,15,37,50,-13,32
Wellington P,146,9,5,6,16,31,55,-24,21
CC Mariners,146,10,4,8,15,28,49,-21,20
Sydney FC,147,1,20,5,3,65,23,42,65
N'castle Jet,147,2,15,6,7,57,37,20,51
Melbourne C,147,3,14,5,10,43,33,10,47
Melbourne V,147,4,13,6,10,46,39,7,45
Adelaide Utd,147,5,11,6,11,37,40,-3,39
Brisbane,147,6,10,5,13,33,42,-9,35
Western Sydn,147,7,8,9,10,38,47,-9,33
Perth Glory,147,8,10,2,15,37,50,-13,32
Wellington P,147,9,5,6,16,31,55,-24,21
CC Mariners,147,10,4,8,15,28,49,-21,20
Sydney FC,148,1,21,4,3,65,22,43,67
N'castle Jet,148,2,15,6,7,59,39,20,51
Melbourne C,148,3,14,5,10,45,35,10,47
Melbourne V,148,4,13,5,11,45,39,6,44
Adelaide Utd,148,5,11,6,11,37,40,-3,39
Brisbane,148,6,10,5,13,33,42,-9,35
Western Sydn,148,7,8,9,10,38,47,-9,33
Perth Glory,148,8,10,2,15,37,50,-13,32
Wellington P,148,9,5,6,16,31,55,-24,21
CC Mariners,148,10,4,8,15,28,49,-21,20
Sydney FC,149,1,20,5,3,65,23,42,65
N'castle Jet,149,2,15,6,7,59,39,20,51
Melbourne C,149,3,14,5,10,45,35,10,47
Melbourne V,149,4,13,6,10,46,39,7,45
Adelaide Utd,149,5,11,6,11,37,40,-3,39
Brisbane,149,6,10,5,13,33,42,-9,35
Western Sydn,149,7,8,9,10,38,47,-9,33
Perth Glory,149,8,10,2,15,37,50,-13,32
Wellington P,149,9,5,6,16,31,55,-24,21
CC Mariners,149,10,4,8,15,28,49,-21,20
Sydney FC,150,1,20,4,4,64,23,41,64
N'castle Jet,150,2,16,5,7,59,38,21,53
Melbourne V,150,3,14,5,10,46,38,8,47
Melbourne C,150,4,14,4,11,44,35,9,46
Adelaide Utd,150,5,11,6,11,37,40,-3,39
Brisbane,150,6,10,5,13,33,42,-9,35
Western Sydn,150,7,8,9,10,38,47,-9,33
Perth Glory,150,8,10,2,15,37,50,-13,32
Wellington P,150,9,5,6,16,31,55,-24,21
CC Mariners,150,10,4,8,15,28,49,-21,20
Sydney FC,151,1,20,4,4,65,25,40,64
N'castle Jet,151,2,15,5,8,59,41,18,50
Melbourne C,151,3,15,4,10,47,35,12,49
Melbourne V,151,4,14,5,10,48,39,9,47
Adelaide Utd,151,5,11,6,11,37,40,-3,39
Brisbane,151,6,10,5,13,33,42,-9,35
Western Sydn,151,7,8,9,10,38,47,-9,33
Perth Glory,151,8,10,2,15,37,50,-13,32
Wellington P,151,9,5,6,16,31,55,-24,21
CC Mariners,151,10,4,8,15,28,49,-21,20
Sydney FC,152,1,21,4,3,66,23,43,67
N'castle Jet,152,2,15,6,7,58,38,20,51
Melbourne C,152,3,14,5,10,44,34,10,47
Melbourne V,152,4,13,5,11,46,40,6,44
Adelaide Utd,152,5,11,6,11,37,40,-3,39
Brisbane,152,6,10,5,13,33,42,-9,35
Western Sydn,152,7,8,9,10,38,47,-9,33
Perth Glory,152,8,10,2,15,37,50,-13,32
Wellington P,152,9,5,6,16,31,55,-24,21
CC Mariners,152,10,4,8,15,28,49,-21,20
Sydney FC,153,1,21,4,3,66,23,43,67
N'castle Jet,153,2,16,5,7,58,37,21,53
Melbourne C,153,3,14,4,11,43,34,9,46
Melbourne V,153,4,13,5,11,46,40,6,44
Adelaide Utd,153,5,11,6,11,37,40,-3,39
Brisbane,153,6,10,5,13,33,42,-9,35
Western Sydn,153,7,8,9,10,38,47,-9,33
Perth Glory,153,8,10,2,15,37,50,-13,32
Wellington P,153,9,5,6,16,31,55,-24,21
CC Mariners,153,10,4,8,15,28,49,-21,20
Sydney FC,154,1,21,4,3,66,22,44,67
N'castle Jet,154,2,15,5,8,58,39,19,50
Melbourne C,154,3,15,4,10,45,34,11,49
Melbourne V,154,4,13,5,11,45,40,5,44
Adelaide Utd,154,5,11,6,11,37,40,-3,39
Brisbane,154,6,10,5,13,33,42,-9,35
Western Sydn,154,7,8,9,10,38,47,-9,33
Perth Glory,154,8,10,2,15,37,50,-13,32
Wellington P,154,9,5,6,16,31,55,-24,21
CC Mariners,154,10,4,8,15,28,49,-21,20
Sydney FC,155,1,21,4,3,67,24,43,67
N'castle Jet,155,2,16,5,7,59,38,21,53
Melbourne C,155,3,14,4,11,44,35,9,46
Melbourne V,155,4,13,5,11,47,41,6,44
Adelaide Utd,155,5,11,6,11,37,40,-3,39
Brisbane,155,6,10,5,13,33,42,-9,35
Western Sydn,155,7,8,9,10,38,47,-9,33
Perth Glory,155,8,10,2,15,37,50,-13,32
Wellington P,155,9,5,6,16,31,55,-24,21
CC Mariners,155,10,4,8,15,28,49,-21,20
Sydney FC,156,1,20,4,4,65,24,41,64
N'castle Jet,156,2,16,5,7,60,37,23,53
Melbourne V,156,3,14,5,10,47,39,8,47
Melbourne C,156,4,14,4,11,43,36,7,46
Adelaide Utd,156,5,11,6,11,37,40,-3,39
Brisbane,156,6,10,5,13,33,42,-9,35
Western Sydn,156,7,8,9,10,38,47,-9,33
Perth Glory,156,8,10,2,15,37,50,-13,32
Wellington P,156,9,5,6,16,31,55,-24,21
CC Mariners,156,10,4,8,15,28,49,-21,20
Sydney FC,157,1,21,4,3,67,22,45,67
N'castle Jet,157,2,16,5,7,61,38,23,53
Melbourne C,157,3,14,4,11,44,37,7,46
Melbourne V,157,4,13,5,11,45,41,4,44
Adelaide Utd,157,5,11,6,11,37,40,-3,39
Brisbane,157,6,10,5,13,33,42,-9,35
Western Sydn,157,7,8,9,10,38,47,-9,33
Perth Glory,157,8,10,2,15,37,50,-13,32
Wellington P,157,9,5,6,16,31,55,-24,21
CC Mariners,157,10,4,8,15,28,49,-21,20
Sydney FC,158,1,21,4,3,67,23,44,67
N'castle Jet,158,2,15,6,7,58,38,20,51
Melbourne C,158,3,14,5,10,44,34,10,47
Melbourne V,158,4,13,5,11,46,41,5,44
Adelaide Utd,158,5,11,6,11,37,40,-3,39
Brisbane,158,6,10,5,13,33,42,-9,35
Western Sydn,158,7,8,9,10,38,47,-9,33
Perth Glory,158,8,10,2,15,37,50,-13,32
Wellington P,158,9,5,6,16,31,55,-24,21
CC Mariners,158,10,4,8,15,28,49,-21,20
Sydney FC,159,1,21,4,3,66,22,44,67
N'castle Jet,159,2,16,5,7,59,37,22,53
Melbourne C,159,3,14,4,11,43,35,8,46
Melbourne V,159,4,13,5,11,45,40,5,44
Adelaide Utd,159,5,11,6,11,37,40,-3,39
Brisbane,159,6,10,5,13,33,42,-9,35
Western Sydn,159,7,8,9,10,38,47,-9,33
Perth Glory,159,8,10,2,15,37,50,-13,32
Wellington P,159,9,5,6,16,31,55,-24,21
CC Mariners,159,10,4,8,15,28,49,-21,20
Sydney FC,160,1,20,4,4,65,25,40,64
N'castle Jet,160,2,16,5,7,60,37,23,53
Melbourne V,160,3,14,5,10,48,39,9,47
Melbourne C,160,4,14,4,11,43,36,7,46
Adelaide Utd,160,5,11,6,11,37,40,-3,39
Brisbane,160,6,10,5,13,33,42,-9,35
Western Sydn,160,7,8,9,10,38,47,-9,33
Perth Glory,160,8,10,2,15,37,50,-13,32
Wellington P,160,9,5,6,16,31,55,-24,21
CC Mariners,160,10,4,8,15,28,49,-21,20
Sydney FC,161,1,20,4,4,64,23,41,64
N'castle Jet,161,2,15,5,8,57,39,18,50
Melbourne C,161,3,15,4,10,45,33,12,49
Melbourne V,161,4,14,5,10,46,38,8,47
Adelaide Utd,161,5,11,6,11,37,40,-3,39
Brisbane,161,6,10,5,13,33,42,-9,35
Western Sydn,161,7,8,9,10,38,47,-9,33
Perth Glory,161,8,10,2,15,37,50,-13,32
Wellington P,161,9,5,6,16,31,55,-24,21
CC Mariners,161,10,4,8,15,28,49,-21,20
Sydney FC,162,1,21,4,3,67,23,44,67
N'castle Jet,162,2,16,5,7,60,39,21,53
Melbourne C,162,3,14,4,11,45,36,9,46
Melbourne V,162,4,13,5,11,46,41,5,44
Adelaide Utd,162,5,11,6,11,37,40,-3,39
Brisbane,162,6,10,5,13,33,42,-9,35
Western Sydn,162,7,8,9,10,38,47,-9,33
Perth Glory,162,8,10,2,15,37,50,-13,32
Wellington P,162,9,5,6,16,31,55,-24,21
CC Mariners,162,10,4,8,15,28,49,-21,20
Sydney FC,163,1,21,4,3,66,23,43,67
N'castle Jet,163,2,16,5,7,58,37,21,53
Melbourne C,163,3,14,4,11,43,34,9,46
Melbourne V,163,4,13,5,11,46,40,6,44
Adelaide Utd,163,5,11,6,11,37,40,-3,39
Brisbane,163,6,10,5,13,33,42,-9,35
Western Sydn,163,7,8,9,10,38,47,-9,33
Perth Glory,163,8,10,2,15,37,50,-13,32
Wellington P,163,9,5,6,16,31,55,-24,21
CC Mariners,163,10,4,8,15,28,49,-21,20
Sydney FC,164,1,21,4,3,66,23,43,67
N'castle Jet,164,2,16,5,7,59,38,21,53
Melbourne C,164,3,14,4,11,44,35,9,46
Melbourne V,164,4,13,5,11,46,40,6,44
Adelaide Utd,164,5,11,6,11,37,40,-3,39
Brisbane,164,6,10,5,13,33,42,-9,35
Western Sydn,164,7,8,9,10,38,47,-9,33
Perth Glory,164,8,10,2,15,37,50,-13,32
Wellington P,164,9,5,6,16,31,55,-24,21
CC Mariners,164,10,4,8,15,28,49,-21,20
Sydney FC,165,1,21,4,3,66,23,43,67
N'castle Jet,165,2,16,5,7,59,37,22,53
Melbourne C,165,3,14,4,11,43,35,8,46
Melbourne V,165,4,13,5,11,46,40,6,44
Adelaide Utd,165,5,11,6,11,37,40,-3,39
Brisbane,165,6,10,5,13,33,42,-9,35
Western Sydn,165,7,8,9,10,38,47,-9,33
Perth Glory,165,8,10,2,15,37,50,-13,32
Wellington P,165,9,5,6,16,31,55,-24,21
CC Mariners,165,10,4,8,15,28,49,-21,20
Sydney FC,166,1,21,4,3,65,22,43,67
N'castle Jet,166,2,15,6,7,59,39,20,51
Melbourne C,166,3,14,5,10,45,35,10,47
Melbourne V,166,4,13,5,11,45,39,6,44
Adelaide Utd,166,5,11,6,11,37,40,-3,39
Brisbane,166,6,10,5,13,33,42,-9,35
Western Sydn,166,7,8,9,10,38,47,-9,33
Perth Glory,166,8,10,2,15,37,50,-13,32
Wellington P,166,9,5,6,16,31,55,-24,21
CC Mariners,166,10,4,8,15,28,49,-21,20
Sydney FC,167,1,21,4,3,66,22,44,67
N'castle Jet,167,2,15,5,8,57,38,19,50
Melbourne C,167,3,15,4,10,44,33,11,49
Melbourne V,167,4,13,5,11,45,40,5,44
Adelaide Utd,167,5,11,6,11,37,40,-3,39
Brisbane,167,6,10,5,13,33,42,-9,35
Western Sydn,167,7,8,9,10,38,47,-9,33
Perth Glory,167,8,10,2,15,37,50,-13,32
Wellington P,167,9,5,6,16,31,55,-24,21
CC Mariners,167,10,4,8,15,28,49,-21,20
Sydney FC,168,1,21,4,3,66,22,44,67
N'castle Jet,168,2,16,5,7,60,38,22,53
Melbourne C,168,3,14,4,11,44,36,8,46
Melbourne V,168,4,13,5,11,45,40,5,44
Adelaide Utd,168,5,11,6,11,37,40,-3,39
Brisbane,168,6,10,5,13,33,42,-9,35
Western Sydn,168,7,8,9,10,38,47,-9,33
Perth Glory,168,8,10,2,15,37,50,-13,32
Wellington P,168,9,5,6,16,31,55,-24,21
CC Mariners,168,10,4,8,15,28,49,-21,20
Sydney FC,169,1,21,4,3,65,22,43,67
N'castle Jet,169,2,16,5,7,61,39,22,53
Melbourne C,169,3,14,4,11,45,37,8,46
Melbourne V,169,4,13,5,11,45,39,6,44
Adelaide Utd,169,5,11,6,11,37,40,-3,39
Brisbane,169,6,10,5,13,33,42,-9,35
Western Sydn,169,7,8,9,10,38,47,-9,33
Perth Glory,169,8,10,2,15,37,50,-13,32
Wellington P,169,9,5,6,16,31,55,-24,21
CC Mariners,169,10,4,8,15,28,49,-21,20
Sydney FC,170,1,21,4,3,68,23,45,67
N'castle Jet,170,2,16,5,7,58,37,21,53
Melbourne C,170,3,14,4,11,43,34,9,46
Melbourne V,170,4,13,5,11,46,42,4,44
Adelaide Utd,170,5,11,6,11,37,40,-3,39
Brisbane,170,6,10,5,13,33,42,-9,35
Western Sydn,170,7,8,9,10,38,47,-9,33
Perth Glory,170,8,10,2,15,37,50,-13,32
Wellington P,170,9,5,6,16,31,55,-24,21
CC Mariners,170,10,4,8,15,28,49,-21,20
Sydney FC,171,1,21,4,3,65,22,43,67
N'castle Jet,171,2,16,5,7,58,37,21,53
Melbourne C,171,3,14,4,11,43,34,9,46
Melbourne V,171,4,13,5,11,45,39,6,44
Adelaide Utd,171,5,11,6,11,37,40,-3,39
Brisbane,171,6,10,5,13,33,42,-9,35
Western Sydn,171,7,8,9,10,38,47,-9,33
Perth Glory,171,8,10,2,15,37,50,-13,32
Wellington P,171,9,5,6,16,31,55,-24,21
CC Mariners,171,10,4,8,15,28,49,-21,20
Sydney FC,172,1,20,4,4,66,25,41,64
N'castle Jet,172,2,16,5,7,58,37,21,53
Melbourne V,172,3,14,5,10,48,40,8,47
Melbourne C,172,4,14,4,11,43,34,9,46
Adelaide Utd,172,5,11,6,11,37,40,-3,39
Brisbane,172,6,10,5,13,33,42,-9,35
Western Sydn,172,7,8,9,10,38,47,-9,33
Perth Glory,172,8,10,2,15,37,50,-13,32
Wellington P,172,9,5,6,16,31,55,-24,21
CC Mariners,172,10,4,8,15,28,49,-21,20
Sydney FC,173,1,20,5,3,66,24,42,65
N'castle Jet,173,2,15,5,8,58,41,17,50
Melbourne C,173,3,15,4,10,47,34,13,49
Melbourne V,173,4,13,6,10,47,40,7,45
Adelaide Utd,173,5,11,6,11,37,40,-3,39
Brisbane,173,6,10,5,13,33,42,-9,35
Western Sydn,173,7,8,9,10,38,47,-9,33
Perth Glory,173,8,10,2,15,37,50,-13,32
Wellington P,173,9,5,6,16,31,55,-24,21
CC Mariners,173,10,4,8,15,28,49,-21,20
Sydney FC,174,1,21,4,3,65,22,43,67
N'castle Jet,174,2,15,6,7,57,37,20,51
Melbourne C,174,3,14,5,10,43,33,10,47
Melbourne V,174,4,13,5,11,45,39,6,44
Adelaide Utd,174,5,11,6,11,37,40,-3,39
Brisbane,174,6,10,5,13,33,42,-9,35
Western Sydn,174,7,8,9,10,38,47,-9,33
Perth Glory,174,8,10,2,15,37,50,-13,32
Wellington P,174,9,5,6,16,31,55,-24,21
CC Mariners,174,10,4,8,15,28,49,-21,20
Sydney FC,175,1,21,4,3,67,22,45,67
N'castle Jet,175,2,16,5,7,60,38,22,53
Melbourne C,175,3,14,4,11,44,36,8,46
Melbourne V,175,4,13,5,11,45,41,4,44
Adelaide Utd,175,5,11,6,11,37,40,-3,39
Brisbane,175,6,10,5,13,33,42,-9,35
Western Sydn,175,7,8,9,10,38,47,-9,33
Perth Glory,175,8,10,2,15,37,50,-13,32
Wellington P,175,9,5,6,16,31,55,-24,21
CC Mariners,175,10,4,8,15,28,49,-21,20
Sydney FC,176,1,21,4,3,66,22,44,67
N'castle Jet,176,2,15,5,8,57,39,18,50
Melbourne C,176,3,15,4,10,45,33,12,49
Melbourne V,176,4,13,5,11,45,40,5,44
Adelaide Utd,176,5,11,6,11,37,40,-3,39
Brisbane,176,6,10,5,13,33,42,-9,35
Western Sydn,176,7,8,9,10,38,47,-9,33
Perth Glory,176,8,10,2,15,37,50,-13,32
Wellington P,176,9,5,6,16,31,55,-24,21
CC Mariners,176,10,4,8,15,28,49,-21,20
Sydney FC,177,1,21,4,3,66,23,43,67
N'castle Jet,177,2,16,5,7,61,38,23,53
Melbourne C,177,3,14,4,11,44,37,7,46
Melbourne V,177,4,13,5,11,46,40,6,44
Adelaide Utd,177,5,11,6,11,37,40,-3,39
Brisbane,177,6,10,5,13,33,42,-9,35
Western Sydn,177,7,8,9,10,38,47,-9,33
Perth Glory,177,8,10,2,15,37,50,-13,32
Wellington P,177,9,5,6,16,31,55,-24,21
CC Mariners,177,10,4,8,15,28,49,-21,20
Sydney FC,178,1,21,4,3,68,25,43,67
N'castle Jet,178,2,15,6,7,57,37,20,51
Melbourne C,178,3,14,5,10,43,33,10,47
Melbourne V,178,4,13,5,11,48,42,6,44
Adelaide Utd,178,5,11,6,11,37,40,-3,39
Brisbane,178,6,10,5,13,33,42,-9,35
Western Sydn,178,7,8,9,10,38,47,-9,33
Perth Glory,178,8,10,2,15,37,50,-13,32
Wellington P,178,9,5,6,16,31,55,-24,21
CC Mariners,178,10,4,8,15,28,49,-21,20
Sydney FC,179,1,20,5,3,66,24,42,65
N'castle Jet,179,2,15,6,7,60,40,20,51
Melbourne C,179,3,14,5,10,46,36,10,47
Melbourne V,179,4,13,6,10,47,40,7,45
Adelaide Utd,179,5,11,6,11,37,40,-3,39
Brisbane,179,6,10,5,13,33,42,-9,35
Western Sydn,179,7,8,9,10,38,47,-9,33
Perth Glory,179,8,10,2,15,37,50,-13,32
Wellington P,179,9,5,6,16,31,55,-24,21
CC Mariners,179,10,4,8,15,28,49,-21,20
Sydney FC,180,1,21,4,3,65,22,43,67
N'castle Jet,180,2,15,5,8,57,39,18,50
Melbourne C,180,3,15,4,10,45,33,12,49
Melbourne V,180,4,13,5,11,45,39,6,44
Adelaide Utd,180,5,11,6,11,37,40,-3,39
Brisbane,180,6,10,5,13,33,42,-9,35
Western Sydn,180,7,8,9,10,38,47,-9,33
Perth Glory,180,8,10,2,15,37,50,-13,32
Wellington P,180,9,5,6,16,31,55,-24,21
CC Mariners,180,10,4,8,15,28,49,-21,20
Sydney FC,181,1,21,4,3,66,23,43,67
N'castle Jet,181,2,16,5,7,58,37,21,53
Melbourne C,181,3,14,4,11,43,34,9,46
Melbourne V,181,4,13,5,11,46,40,6,44
Adelaide Utd,181,5,11,6,11,37,40,-3,39
Brisbane,181,6,10,5,13,33,42,-9,35
Western Sydn,181,7,8,9,10,38,47,-9,33
Perth Glory,181,8,10,2,15,37,50,-13,32
Wellington P,181,9,5,6,16,31,55,-24,21
CC Mariners,181,10,4,8,15,28,49,-21,20
Sydney FC,182,1,21,4,3,67,23,44,67
N'castle Jet,182,2,15,6,7,57,37,20,51
Melbourne C,182,3,14,5,10,43,33,10,47
Melbourne V,182,4,13,5,11,46,41,5,44
Adelaide Utd,182,5,11,6,11,37,40,-3,39
Brisbane,182,6,10,5,13,33,42,-9,35
Western Sydn,182,7,8,9,10,38,47,-9,33
Perth Glory,182,8,10,2,15,37,50,-13,32
Wellington P,182,9,5,6,16,31,55,-24,21
CC Mariners,182,10,4,8,15,28,49,-21,20
Sydney FC,183,1,21,4,3,66,22,44,67
N'castle Jet,183,2,16,5,7,61,37,24,53
Melbourne C,183,3,14,4,11,43,37,6,46
Melbourne V,183,4,13,5,11,45,40,5,44
Adelaide Utd,183,5,11,6,11,37,40,-3,39
Brisbane,183,6,10,5,13,33,42,-9,35
Western Sydn,183,7,8,9,10,38,47,-9,33
Perth Glory,183,8,10,2,15,37,50,-13,32
Wellington P,183,9,5,6,16,31,55,-24,21
CC Mariners,183,10,4,8,15,28,49,-21,20
Sydney FC,184,1,21,4,3,67,22,45,67
N'castle Jet,184,2,15,5,8,59,41,18,50
Melbourne C,184,3,15,4,10,47,35,12,49
Melbourne V,184,4,13,5,11,45,41,4,44
Adelaide Utd,184,5,11,6,11,37,40,-3,39
Brisbane,184,6,10,5,13,33,42,-9,35
Western Sydn,184,7,8,9,10,38,47,-9,33
Perth Glory,184,8,10,2,15,37,50,-13,32
Wellington P,184,9,5,6,16,31,55,-24,21
CC Mariners,184,10,4,8,15,28,49,-21,20
Sydney FC,185,1,21,4,3,66,23,43,67
N'castle Jet,185,2,15,5,8,58,39,19,50
Melbourne C,185,3,15,4,10,45,34,11,49
Melbourne V,185,4,13,5,11,46,40,6,44
Adelaide Utd,185,5,11,6,11,37,40,-3,39
Brisbane,185,6,10,5,13,33,42,-9,35
Western Sydn,185,7,8,9,10,38,47,-9,33
Perth Glory,185,8,10,2,15,37,50,-13,32
Wellington P,185,9,5,6,16,31,55,-24,21
CC Mariners,185,10,4,8,15,28,49,-21,20
Sydney FC,186,1,20,4,4,65,25,40,64
N'castle Jet,186,2,16,5,7,60,37,23,53
Melbourne V,186,3,14,5,10,48,39,9,47
Melbourne C,186,4,14,4,11,43,36,7,46
Adelaide Utd,186,5,11,6,11,37,40,-3,39
Brisbane,186,6,10,5,13,33,42,-9,35
Western Sydn,186,7,8,9,10,38,47,-9,33
Perth Glory,186,8,10,2,15,37,50,-13,32
Wellington P,186,9,5,6,16,31,55,-24,21
CC Mariners,186,10,4,8,15,28,49,-21,20
Sydney FC,187,1,20,4,4,65,24,41,64
N'castle Jet,187,2,16,5,7,61,37,24,53
Melbourne V,187,3,14,5,10,47,39,8,47
Melbourne C,187,4,14,4,11,43,37,6,46
Adelaide Utd,187,5,11,6,11,37,40,-3,39
Brisbane,187,6,10,5,13,33,42,-9,35
Western Sydn,187,7,8,9,10,38,47,-9,33
Perth Glory,187,8,10,2,15,37,50,-13,32
Wellington P,187,9,5,6,16,31,55,-24,21
CC Mariners,187,10,4,8,15,28,49,-21,20
Sydney FC,188,1,20,4,4,64,24,40,64
N'castle Jet,188,2,15,5,8,58,39,19,50
Melbourne C,188,3,15,4,10,45,34,11,49
Melbourne V,188,4,14,5,10,47,38,9,47
Adelaide Utd,188,5,11,6,11,37,40,-3,39
Brisbane,188,6,10,5,13,33,42,-9,35
Western Sydn,188,7,8,9,10,38,47,-9,33
Perth Glory,188,8,10,2,15,37,50,-13,32
Wellington P,188,9,5,6,16,31,55,-24,21
CC Mariners,188,10,4,8,15,28,49,-21,20
Sydney FC,189,1,21,4,3,67,23,44,67
N'castle Jet,189,2,15,5,8,57,38,19,50
Melbourne C,189,3,15,4,10,44,33,11,49
Melbourne V,189,4,13,5,11,46,41,5,44
Adelaide Utd,189,5,11,6,11,37,40,-3,39
Brisbane,189,6,10,5,13,33,42,-9,35
Western Sydn,189,7,8,9,10,38,47,-9,33
Perth Glory,189,8,10,2,15,37,50,-13,32
Wellington P,189,9,5,6,16,31,55,-24,21
CC Mariners,189,10,4,8,15,28,49,-21,20
Sydney FC,190,1,21,4,3,65,22,43,67
N'castle Jet,190,2,16,5,7,61,38,23,53
Melbourne C,190,3,14,4,11,44,37,7,46
Melbourne V,190,4,13,5,11,45,39,6,44
Adelaide Utd,190,5,11,6,11,37,40,-3,39
Brisbane,190,6,10,5,13,33,42,-9,35
Western Sydn,190,7,8,9,10,38,47,-9,33
Perth Glory,190,8,10,2,15,37,50,-13,32
Wellington P,190,9,5,6,16,31,55,-24,21
CC Mariners,190,10,4,8,15,28,49,-21,20
Sydney FC,191,1,21,4,3,67,23,44,67
N'castle Jet,191,2,15,5,8,58,39,19,50
Melbourne C,191,3,15,4,10,45,34,11,49
Melbourne V,191,4,13,5,11,46,41,5,44
Adelaide Utd,191,5,11,6,11,37,40,-3,39
Brisbane,191,6,10,5,13,33,42,-9,35
Western Sydn,191,7,8,9,10,38,47,-9,33
Perth Glory,191,8,10,2,15,37,50,-13,32
Wellington P,191,9,5,6,16,31,55,-24,21
CC Mariners,191,10,4,8,15,28,49,-21,20
Sydney FC,192,1,20,5,3,65,23,42,65
N'castle Jet,192,2,15,5,8,57,38,19,50
Melbourne C,192,3,15,4,10,44,33,11,49
Melbourne V,192,4,13,6,10,46,39,7,45
Adelaide Utd,192,5,11,6,11,37,40,-3,39
Brisbane,192,6,10,5,13,33,42,-9,35
Western Sydn,192,7,8,9,10,38,47,-9,33
Perth Glory,192,8,10,2,15,37,50,-13,32
Wellington P,192,9,5,6,16,31,55,-24,21
CC Mariners,192,10,4,8,15,28,49,-21,20
Sydney FC,193,1,21,4,3,65,22,43,67
N'castle Jet,193,2,16,5,7,59,37,22,53
Melbourne C,193,3,14,4,11,43,35,8,46
Melbourne V,193,4,13,5,11,45,39,6,44
Adelaide Utd,193,5,11,6,11,37,40,-3,39
Brisbane,193,6,10,5,13,33,42,-9,35
Western Sydn,193,7,8,9,10,38,47,-9,33
Perth Glory,193,8,10,2,15,37,50,-13,32
Wellington P,193,9,5,6,16,31,55,-24,21
CC Mariners,193,10,4,8,15,28,49,-21,20
Sydney FC,194,1,21,4,3,66,23,43,67
N'castle Jet,194,2,16,5,7,61,38,23,53
Melbourne C,194,3,14,4,11,44,37,7,46
Melbourne V,194,4,13,5,11,46,40,6,44
Adelaide Utd,194,5,11,6,11,37,40,-3,39
Brisbane,194,6,10,5,13,33,42,-9,35
Western Sydn,194,7,8,9,10,38,47,-9,33
Perth Glory,194,8,10,2,15,37,50,-13,32
Wellington P,194,9,5,6,16,31,55,-24,21
CC Mariners,194,10,4,8,15,28,49,-21,20
Sydney FC,195,1,21,4,3,67,23,44,67
N'castle Jet,195,2,15,5,8,57,38,19,50
Melbourne C,195,3,15,4,10,44,33,11,49
Melbourne V,195,4,13,5,11,46,41,5,44
Adelaide Utd,195,5,11,6,11,37,40,-3,39
Brisbane,195,6,10,5,13,33,42,-9,35
Western Sydn,195,7,8,9,10,38,47,-9,33
Perth Glory,195,8,10,2,15,37,50,-13,32
Wellington P,195,9,5,6,16,31,55,-24,21
CC Mariners,195,10,4,8,15,28,49,-21,20
Sydney FC,196,1,21,4,3,67,22,45,67
N'castle Jet,196,2,16,5,7,60,37,23,53
Melbourne C,196,3,14,4,11,43,36,7,46
Melbourne V,196,4,13,5,11,45,41,4,44
Adelaide Utd,196,5,11,6,11,37,40,-3,39
Brisbane,196,6,10,5,13,33,42,-9,35
Western Sydn,196,7,8,9,10,38,47,-9,33
Perth Glory,196,8,10,2,15,37,50,-13,32
Wellington P,196,9,5,6,16,31,55,-24,21
CC Mariners,196,10,4,8,15,28,49,-21,20
Sydney FC,197,1,21,4,3,67,22,45,67
N'castle Jet,197,2,16,5,7,59,38,21,53
Melbourne C,197,3,14,4,11,44,35,9,46
Melbourne V,197,4,13,5,11,45,41,4,44
Adelaide Utd,197,5,11,6,11,37,40,-3,39
Brisbane,197,6,10,5,13,33,42,-9,35
Western Sydn,197,7,8,9,10,38,47,-9,33
Perth Glory,197,8,10,2,15,37,50,-13,32
Wellington P,197,9,5,6,16,31,55,-24,21
CC Mariners,197,10,4,8,15,28,49,-21,20
Sydney FC,198,1,21,4,3,68,24,44,67
N'castle Jet,198,2,15,6,7,58,38,20,51
Melbourne C,198,3,14,5,10,44,34,10,47
Melbourne V,198,4,13,5,11,47,42,5,44
Adelaide Utd,198,5,11,6,11,37,40,-3,39
Brisbane,198,6,10,5,13,33,42,-9,35
Western Sydn,198,7,8,9,10,38,47,-9,33
Perth Glory,198,8,10,2,15,37,50,-13,32
Wellington P,198,9,5,6,16,31,55,-24,21
CC Mariners,198,10,4,8,15,28,49,-21,20
Sydney FC,199,1,21,4,3,65,22,43,67
N'castle Jet,199,2,16,5,7,58,37,21,53
Melbourne C,199,3,14,4,11,43,34,9,46
Melbourne V,199,4,13,5,11,45,39,6,44
Adelaide Utd,199,5,11,6,11,37,40,-3,39
Brisbane,199,6,10,5,13,33,42,-9,35
Western Sydn,199,7,8,9,10,38,47,-9,33
Perth Glory,199,8,10,2,15,37,50,-13,32
Wellington P,199,9,5,6,16,31,55,-24,21
CC Mariners,199,10,4,8,15,28,49,-21,20
Sydney FC,200,1,20,5,3,65,23,42,65
N'castle Jet,200,2,15,6,7,59,39,20,51
Melbourne C,200,3,14,5,10,45,35,10,47
Melbourne V,200,4,13,6,10,46,39,7,45
Adelaide Utd,200,5,11,6,11,37,40,-3,39
Brisbane,200,6,10,5,13,33,42,-9,35
Western Sydn,200,7,8,9,10,38,47,-9,33
Perth Glory,200,8,10,2,15,37,50,-13,32
Wellington P,200,9,5,6,16,31,55,-24,21
CC Mariners,200,10,4,8,15,28,49,-21,20
Sydney FC,201,1,21,4,3,66,23,43,67
N'castle Jet,201,2,15,5,8,58,39,19,50
Melbourne C,201,3,15,4,10,45,34,11,49
Melbourne V,201,4,13,5,11,46,40,6,44
Adelaide Utd,201,5,11,6,11,37,40,-3,39
Brisbane,201,6,10,5,13,33,42,-9,35
Western Sydn,201,7,8,9,10,38,47,-9,33
Perth Glory,201,8,10,2,15,37,50,-13,32
Wellington P,201,9,5,6,16,31,55,-24,21
CC Mariners,201,10,4,8,15,28,49,-21,20
Sydney FC,202,1,20,4,4,66,26,40,64
N'castle Jet,202,2,16,5,7,58,37,21,53
Melbourne V,202,3,14,5,10,49,40,9,47
Melbourne C,202,4,14,4,11,43,34,9,46
Adelaide Utd,202,5,11,6,11,37,40,-3,39
Brisbane,202,6,10,5,13,33,42,-9,35
Western Sydn,202,7,8,9,10,38,47,-9,33
Perth Glory,202,8,10,2,15,37,50,-13,32
Wellington P,202,9,5,6,16,31,55,-24,21
CC Mariners,202,10,4,8,15,28,49,-21,20
Sydney FC,203,1,21,4,3,69,24,45,67
N'castle Jet,203,2,16,5,7,61,37,24,53
Melbourne C,203,3,14,4,11,43,37,6,46
Melbourne V,203,4,13,5,11,47,43,4,44
Adelaide Utd,203,5,11,6,11,37,40,-3,39
Brisbane,203,6,10,5,13,33,42,-9,35
Western Sydn,203,7,8,9,10,38,47,-9,33
Perth Glory,203,8,10,2,15,37,50,-13,32
Wellington P,203,9,5,6,16,31,55,-24,21
CC Mariners,203,10,4,8,15,28,49,-21,20
Sydney FC,204,1,20,4,4,64,24,40,64
N'castle Jet,204,2,16,5,7,59,38,21,53
Melbourne V,204,3,14,5,10,47,38,9,47
Melbourne C,204,4,14,4,11,44,35,9,46
Adelaide Utd,204,5,11,6,11,37,40,-3,39
Brisbane,204,6,10,5,13,33,42,-9,35
Western Sydn,204,7,8,9,10,38,47,-9,33
Perth Glory,204,8,10,2,15,37,50,-13,32
Wellington P,204,9,5,6,16,31,55,-24,21
CC Mariners,204,10,4,8,15,28,49,-21,20
Sydney FC,205,1,20,4,4,64,23,41,64
N'castle Jet,205,2,16,5,7,62,37,25,53
Melbourne V,205,3,14,5,10,46,38,8,47
Melbourne C,205,4,14,4,11,43,38,5,46
Adelaide Utd,205,5,11,6,11,37,40,-3,39
Brisbane,205,6,10,5,13,33,42,-9,35
Western Sydn,205,7,8,9,10,38,47,-9,33
Perth Glory,205,8,10,2,15,37,50,-13,32
Wellington P,205,9,5,6,16,31,55,-24,21
CC Mariners,205,10,4,8,15,28,49,-21,20
Sydney FC,206,1,21,4,3,67,22,45,67
N'castle Jet,206,2,15,5,8,59,40,19,50
Melbourne C,206,3,15,4,10,46,35,11,49
Melbourne V,206,4,13,5,11,45,41,4,44
Adelaide Utd,206,5,11,6,11,37,40,-3,39
Brisbane,206,6,10,5,13,33,42,-9,35
Western Sydn,206,7,8,9,10,38,47,-9,33
Perth Glory,206,8,10,2,15,37,50,-13,32
Wellington P,206,9,5,6,16,31,55,-24,21
CC Mariners,206,10,4,8,15,28,49,-21,20
Sydney FC,207,1,20,5,3,66,24,42,65
N'castle Jet,207,2,15,6,7,59,39,20,51
Melbourne C,207,3,14,5,10,45,35,10,47
Melbourne V,207,4,13,6,10,47,40,7,45
Adelaide Utd,207,5,11,6,11,37,40,-3,39
Brisbane,207,6,10,5,13,33,42,-9,35
Western Sydn,207,7,8,9,10,38,47,-9,33
Perth Glory,207,8,10,2,15,37,50,-13,32
Wellington P,207,9,5,6,16,31,55,-24,21
CC Mariners,207,10,4,8,15,28,49,-21,20
Sydney FC,208,1,21,4,3,65,22,43,67
N'castle Jet,208,2,16,5,7,58,37,21,53
Melbourne C,208,3,14,4,11,43,34,9,46
Melbourne V,208,4,13,5,11,45,39,6,44
Adelaide Utd,208,5,11,6,11,37,40,-3,39
Brisbane,208,6,10,5,13,33,42,-9,35
Western Sydn,208,7,8,9,10,38,47,-9,33
Perth Glory,208,8,10,2,15,37,50,-13,32
Wellington P,208,9,5,6,16,31,55,-24,21
CC Mariners,208,10,4,8,15,28,49,-21,20
Sydney FC,209,1,21,4,3,67,23,44,67
N'castle Jet,209,2,16,5,7,60,37,23,53
Melbourne C,209,3,14,4,11,43,36,7,46
Melbourne V,209,4,13,5,11,46,41,5,44
Adelaide Utd,209,5,11,6,11,37,40,-3,39
Brisbane,209,6,10,5,13,33,42,-9,35
Western Sydn,209,7,8,9,10,38,47,-9,33
Perth Glory,209,8,10,2,15,37,50,-13,32
Wellington P,209,9,5,6,16,31,55,-24,21
CC Mariners,209,10,4,8,15,28,49,-21,20
Sydney FC,210,1,20,5,3,65,23,42,65
N'castle Jet,210,2,15,5,8,60,42,18,50
Melbourne C,210,3,15,4,10,48,36,12,49
Melbourne V,210,4,13,6,10,46,39,7,45
Adelaide Utd,210,5,11,6,11,37,40,-3,39
Brisbane,210,6,10,5,13,33,42,-9,35
Western Sydn,210,7,8,9,10,38,47,-9,33
Perth Glory,210,8,10,2,15,37,50,-13,32
Wellington P,210,9,5,6,16,31,55,-24,21
CC Mariners,210,10,4,8,15,28,49,-21,20
Sydney FC,211,1,20,5,3,64,22,42,65
N'castle Jet,211,2,16,5,7,58,37,21,53
Melbourne C,211,3,14,4,11,43,34,9,46
Melbourne V,211,4,13,6,10,45,38,7,45
Adelaide Utd,211,5,11,6,11,37,40,-3,39
Brisbane,211,6,10,5,13,33,42,-9,35
Western Sydn,211,7,8,9,10,38,47,-9,33
Perth Glory,211,8,10,2,15,37,50,-13,32
Wellington P,211,9,5,6,16,31,55,-24,21
CC Mariners,211,10,4,8,15,28,49,-21,20
Sydney FC,212,1,21,4,3,66,22,44,67
N'castle Jet,212,2,16,5,7,60,37,23,53
Melbourne C,212,3,14,4,11,43,36,7,46
Melbourne V,212,4,13,5,11,45,40,5,44
Adelaide Utd,212,5,11,6,11,37,40,-3,39
Brisbane,212,6,10,5,13,33,42,-9,35
Western Sydn,212,7,8,9,10,38,47,-9,33
Perth Glory,212,8,10,2,15,37,50,-13,32
Wellington P,212,9,5,6,16,31,55,-24,21
CC Mariners,212,10,4,8,15,28,49,-21,20
Sydney FC,213,1,21,4,3,66,22,44,67
N'castle Jet,213,2,15,6,7,58,38,20,51
Melbourne C,213,3,14,5,10,44,34,10,47
Melbourne V,213,4,13,5,11,45,40,5,44
Adelaide Utd,213,5,11,6,11,37,40,-3,39
Brisbane,213,6,10,5,13,33,42,-9,35
Western Sydn,213,7,8,9,10,38,47,-9,33
Perth Glory,213,8,10,2,15,37,50,-13,32
Wellington P,213,9,5,6,16,31,55,-24,21
CC Mariners,213,10,4,8,15,28,49,-21,20
Sydney FC,214,1,21,4,3,65,22,43,67
N'castle Jet,214,2,15,6,7,58,38,20,51
Melbourne C,214,3,14,5,10,44,34,10,47
Melbourne V,214,4,13,5,11,45,39,6,44
Adelaide Utd,214,5,11,6,11,37,40,-3,39
Brisbane,214,6,10,5,13,33,42,-9,35
Western Sydn,214,7,8,9,10,38,47,-9,33
Perth Glory,214,8,10,2,15,37,50,-13,32
Wellington P,214,9,5,6,16,31,55,-24,21
CC Mariners,214,10,4,8,15,28,49,-21,20
Sydney FC,215,1,21,4,3,65,22,43,67
N'castle Jet,215,2,16,5,7,60,37,23,53
Melbourne C,215,3,14,4,11,43,36,7,46
Melbourne V,215,4,13,5,11,45,39,6,44
Adelaide Utd,215,5,11,6,11,37,40,-3,39
Brisbane,215,6,10,5,13,33,42,-9,35
Western Sydn,215,7,8,9,10,38,47,-9,33
Perth Glory,215,8,10,2,15,37,50,-13,32
Wellington P,215,9,5,6,16,31,55,-24,21
CC Mariners,215,10,4,8,15,28,49,-21,20
Sydney FC,216,1,21,4,3,67,22,45,67
N'castle Jet,216,2,15,5,8,59,41,18,50
Melbourne C,216,3,15,4,10,47,35,12,49
Melbourne V,216,4,13,5,11,45,41,4,44
Adelaide Utd,216,5,11,6,11,37,40,-3,39
Brisbane,216,6,10,5,13,33,42,-9,35
Western Sydn,216,7,8,9,10,38,47,-9,33
Perth Glory,216,8,10,2,15,37,50,-13,32
Wellington P,216,9,5,6,16,31,55,-24,21
CC Mariners,216,10,4,8,15,28,49,-21,20
Sydney FC,217,1,21,4,3,65,22,43,67
N'castle Jet,217,2,15,5,8,58,39,19,50
Melbourne C,217,3,15,4,10,45,34,11,49
Melbourne V,217,4,13,5,11,45,39,6,44
Adelaide Utd,217,5,11,6,11,37,40,-3,39
Brisbane,217,6,10,5,13,33,42,-9,35
Western Sydn,217,7,8,9,10,38,47,-9,33
Perth Glory,217,8,10,2,15,37,50,-13,32
Wellington P,217,9,5,6,16,31,55,-24,21
CC Mariners,217,10,4,8,15,28,49,-21,20
Sydney FC,218,1,21,4,3,66,22,44,67
N'castle Jet,218,2,15,6,7,59,39,20,51
Melbourne C,218,3,14,5,10,45,35,10,47
Melbourne V,218,4,13,5,11,45,40,5,44
Adelaide Utd,218,5,11,6,11,37,40,-3,39
Brisbane,218,6,10,5,13,33,42,-9,35
Western Sydn,218,7,8,9,10,38,47,-9,33
Perth Glory,218,8,10,2,15,37,50,-13,32
Wellington P,218,9,5,6,16,31,55,-24,21
CC Mariners,218,10,4,8,15,28,49,-21,20
Sydney FC,219,1,20,5,3,67,25,42,65
N'castle Jet,219,2,16,5,7,61,38,23,53
Melbourne C,219,3,14,4,11,44,37,7,46
Melbourne V,219,4,13,6,10,48,41,7,45
Adelaide Utd,219,5,11,6,11,37,40,-3,39
Brisbane,219,6,10,5,13,33,42,-9,35
Western Sydn,219,7,8,9,10,38,47,-9,33
Perth Glory,219,8,10,2,15,37,50,-13,32
Wellington P,219,9,5,6,16,31,55,-24,21
CC Mariners,219,10,4,8,15,28,49,-21,20
Sydney FC,220,1,20,4,4,65,24,41,64
N'castle Jet,220,2,16,5,7,58,37,21,53
Melbourne V,220,3,14,5,10,47,39,8,47
Melbourne C,220,4,14,4,11,43,34,9,46
Adelaide Utd,220,5,11,6,11,37,40,-3,39
Brisbane,220,6,10,5,13,33,42,-9,35
Western Sydn,220,7,8,9,10,38,47,-9,33
Perth Glory,220,8,10,2,15,37,50,-13,32
Wellington P,220,9,5,6,16,31,55,-24,21
CC Mariners,220,10,4,8,15,28,49,-21,20
Sydney FC,221,1,20,5,3,65,23,42,65
N'castle Jet,221,2,15,5,8,58,39,19,50
Melbourne C,221,3,15,4,10,45,34,11,49
Melbourne V,221,4,13,6,10,46,39,7,45
Adelaide Utd,221,5,11,6,11,37,40,-3,39
Brisbane,221,6,10,5,13,33,42,-9,35
Western Sydn,221,7,8,9,10,38,47,-9,33
Perth Glory,221,8,10,2,15,37,50,-13,32
Wellington P,221,9,5,6,16,31,55,-24,21
CC Mariners,221,10,4,8,15,28,49,-21,20
Sydney FC,222,1,20,5,3,66,24,42,65
N'castle Jet,222,2,15,6,7,59,39,20,51
Melbourne C,222,3,14,5,10,45,35,10,47
Melbourne V,222,4,13,6,10,47,40,7,45
Adelaide Utd,222,5,11,6,11,37,40,-3,39
Brisbane,222,6,10,5,13,33,42,-9,35
Western Sydn,222,7,8,9,10,38,47,-9,33
Perth Glory,222,8,10,2,15,37,50,-13,32
Wellington P,222,9,5,6,16,31,55,-24,21
CC Mariners,222,10,4,8,15,28,49,-21,20
Sydney FC,223,1,21,4,3,66,23,43,67
N'castle Jet,223,2,16,5,7,59,37,22,53
Melbourne C,223,3,14,4,11,43,35,8,46
Melbourne V,223,4,13,5,11,46,40,6,44
Adelaide Utd,223,5,11,6,11,37,40,-3,39
Brisbane,223,6,10,5,13,33,42,-9,35
Western Sydn,223,7,8,9,10,38,47,-9,33
Perth Glory,223,8,10,2,15,37,50,-13,32
Wellington P,223,9,5,6,16,31,55,-24,21
CC Mariners,223,10,4,8,15,28,49,-21,20
Sydney FC,224,1,21,4,3,68,24,44,67
N'castle Jet,224,2,16,5,7,58,37,21,53
Melbourne C,224,3,14,4,11,43,34,9,46
Melbourne V,224,4,13,5,11,47,42,5,44
Adelaide Utd,224,5,11,6,11,37,40,-3,39
Brisbane,224,6,10,5,13,33,42,-9,35
Western Sydn,224,7,8,9,10,38,47,-9,33
Perth Glory,224,8,10,2,15,37,50,-13,32
Wellington P,224,9,5,6,16,31,55,-24,21
CC Mariners,224,10,4,8,15,28,49,-21,20
Sydney FC,225,1,20,5,3,64,22,42,65
N'castle Jet,225,2,16,5,7,59,38,21,53
Melbourne C,225,3,14,4,11,44,35,9,46
Melbourne V,225,4,13,6,10,45,38,7,45
Adelaide Utd,225,5,11,6,11,37,40,-3,39
Brisbane,225,6,10,5,13,33,42,-9,35
Western Sydn,225,7,8,9,10,38,47,-9,33
Perth Glory,225,8,10,2,15,37,50,-13,32
Wellington P,225,9,5,6,16,31,55,-24,21
CC Mariners,225,10,4,8,15,28,49,-21,20
Sydney FC,226,1,21,4,3,66,22,44,67
N'castle Jet,226,2,15,5,8,57,39,18,50
Melbourne C,226,3,15,4,10,45,33,12,49
Melbourne V,226,4,13,5,11,45,40,5,44
Adelaide Utd,226,5,11,6,11,37,40,-3,39
Brisbane,226,6,10,5,13,33,42,-9,35
Western Sydn,226,7,8,9,10,38,47,-9,33
Perth Glory,226,8,10,2,15,37,50,-13,32
Wellington P,226,9,5,6,16,31,55,-24,21
CC Mariners,226,10,4,8,15,28,49,-21,20
Sydney FC,227,1,21,4,3,67,22,45,67
N'castle Jet,227,2,16,5,7,59,37,22,53
Melbourne C,227,3,14,4,11,43,35,8,46
Melbourne V,227,4,13,5,11,45,41,4,44
Adelaide Utd,227,5,11,6,11,37,40,-3,39
Brisbane,227,6,10,5,13,33,42,-9,35
Western Sydn,227,7,8,9,10,38,47,-9,33
Perth Glory,227,8,10,2,15,37,50,-13,32
Wellington P,227,9,5,6,16,31,55,-24,21
CC Mariners,227,10,4,8,15,28,49,-21,20
Sydney FC,228,1,21,4,3,65,22,43,67
N'castle Jet,228,2,15,5,8,57,38,19,50
Melbourne C,228,3,15,4,10,44,33,11,49
Melbourne V,228,4,13,5,11,45,39,6,44
Adelaide Utd,228,5,11,6,11,37,40,-3,39
Brisbane,228,6,10,5,13,33,42,-9,35
Western Sydn,228,7,8,9,10,38,47,-9,33
Perth Glory,228,8,10,2,15,37,50,-13,32
Wellington P,228,9,5,6,16,31,55,-24,21
CC Mariners,228,10,4,8,15,28,49,-21,20
Sydney FC,229,1,21,4,3,66,22,44,67
N'castle Jet,229,2,15,5,8,59,40,19,50
Melbourne C,229,3,15,4,10,46,35,11,49
Melbourne V,229,4,13,5,11,45,40,5,44
Adelaide Utd,229,5,11,6,11,37,40,-3,39
Brisbane,229,6,10,5,13,33,42,-9,35
Western Sydn,229,7,8,9,10,38,47,-9,33
Perth Glory,229,8,10,2,15,37,50,-13,32
Wellington P,229,9,5,6,16,31,55,-24,21
CC Mariners,229,10,4,8,15,28,49,-21,20
Sydney FC,230,1,21,4,3,65,22,43,67
N'castle Jet,230,2,15,5,8,58,39,19,50
Melbourne C,230,3,15,4,10,45,34,11,49
Melbourne V,230,4,13,5,11,45,39,6,44
Adelaide Utd,230,5,11,6,11,37,40,-3,39
Brisbane,230,6,10,5,13,33,42,-9,35
Western Sydn,230,7,8,9,10,38,47,-9,33
Perth Glory,230,8,10,2,15,37,50,-13,32
Wellington P,230,9,5,6,16,31,55,-24,21
CC Mariners,230,10,4,8,15,28,49,-21,20
Sydney FC,231,1,21,4,3,65,22,43,67
N'castle Jet,231,2,15,5,8,58,40,18,50
Melbourne C,231,3,15,4,10,46,34,12,49
Melbourne V,231,4,13,5,11,45,39,6,44
Adelaide Utd,231,5,11,6,11,37,40,-3,39
Brisbane,231,6,10,5,13,33,42,-9,35
Western Sydn,231,7,8,9,10,38,47,-9,33
Perth Glory,231,8,10,2,15,37,50,-13,32
Wellington P,231,9,5,6,16,31,55,-24,21
CC Mariners,231,10,4,8,15,28,49,-21,20
Sydney FC,232,1,21,4,3,69,24,45,67
N'castle Jet,232,2,15,6,7,57,37,20,51
Melbourne C,232,3,14,5,10,43,33,10,47
Melbourne V,232,4,13,5,11,47,43,4,44
Adelaide Utd,232,5,11,6,11,37,40,-3,39
Brisbane,232,6,10,5,13,33,42,-9,35
Western Sydn,232,7,8,9,10,38,47,-9,33
Perth Glory,232,8,10,2,15,37,50,-13,32
Wellington P,232,9,5,6,16,31,55,-24,21
CC Mariners,232,10,4,8,15,28,49,-21,20
Sydney FC,233,1,21,4,3,68,23,45,67
N'castle Jet,233,2,16,5,7,61,40,21,53
Melbourne C,233,3,14,4,11,46,37,9,46
Melbourne V,233,4,13,5,11,46,42,4,44
Adelaide Utd,233,5,11,6,11,37,40,-3,39
Brisbane,233,6,10,5,13,33,42,-9,35
Western Sydn,233,7,8,9,10,38,47,-9,33
Perth Glory,233,8,10,2,15,37,50,-13,32
Wellington P,233,9,5,6,16,31,55,-24,21
CC Mariners,233,10,4,8,15,28,49,-21,20
Sydney FC,234,1,21,4,3,67,22,45,67
N'castle Jet,234,2,15,5,8,58,39,19,50
Melbourne C,234,3,15,4,10,45,34,11,49
Melbourne V,234,4,13,5,11,45,41,4,44
Adelaide Utd,234,5,11,6,11,37,40,-3,39
Brisbane,234,6,10,5,13,33,42,-9,35
Western Sydn,234,7,8,9,10,38,47,-9,33
Perth Glory,234,8,10,2,15,37,50,-13,32
Wellington P,234,9,5,6,16,31,55,-24,21
CC Mariners,234,10,4,8,15,28,49,-21,20
Sydney FC,235,1,21,4,3,68,23,45,67
N'castle Jet,235,2,16,5,7,59,38,21,53
Melbourne C,235,3,14,4,11,44,35,9,46
Melbourne V,235,4,13,5,11,46,42,4,44
Adelaide Utd,235,5,11,6,11,37,40,-3,39
Brisbane,235,6,10,5,13,33,42,-9,35
Western Sydn,235,7,8,9,10,38,47,-9,33
Perth Glory,235,8,10,2,15,37,50,-13,32
Wellington P,235,9,5,6,16,31,55,-24,21
CC Mariners,235,10,4,8,15,28,49,-21,20
Sydney FC,236,1,21,4,3,67,22,45,67
N'castle Jet,236,2,15,5,8,57,39,18,50
Melbourne C,236,3,15,4,10,45,33,12,49
Melbourne V,236,4,13,5,11,45,41,4,44
Adelaide Utd,236,5,11,6,11,37,40,-3,39
Brisbane,236,6,10,5,13,33,42,-9,35
Western Sydn,236,7,8,9,10,38,47,-9,33
Perth Glory,236,8,10,2,15,37,50,-13,32
Wellington P,236,9,5,6,16,31,55,-24,21
CC Mariners,236,10,4,8,15,28,49,-21,20
Sydney FC,237,1,21,4,3,68,23,45,67
N'castle Jet,237,2,15,5,8,57,38,19,50
Melbourne C,237,3,15,4,10,44,33,11,49
Melbourne V,237,4,13,5,11,46,42,4,44
Adelaide Utd,237,5,11,6,11,37,40,-3,39
Brisbane,237,6,10,5,13,33,42,-9,35
Western Sydn,237,7,8,9,10,38,47,-9,33
Perth Glory,237,8,10,2,15,37,50,-13,32
Wellington P,237,9,5,6,16,31,55,-24,21
CC Mariners,237,10,4,8,15,28,49,-21,20
Sydney FC,238,1,21,4,3,66,23,43,67
N'castle Jet,238,2,15,6,7,62,42,20,51
Melbourne C,238,3,14,5,10,48,38,10,47
Melbourne V,238,4,13,5,11,46,40,6,44
Adelaide Utd,238,5,11,6,11,37,40,-3,39
Brisbane,238,6,10,5,13,33,42,-9,35
Western Sydn,238,7,8,9,10,38,47,-9,33
Perth Glory,238,8,10,2,15,37,50,-13,32
Wellington P,238,9,5,6,16,31,55,-24,21
CC Mariners,238,10,4,8,15,28,49,-21,20
Sydney FC,239,1,21,4,3,68,23,45,67
N'castle Jet,239,2,16,5,7,60,37,23,53
Melbourne C,239,3,14,4,11,43,36,7,46
Melbourne V,239,4,13,5,11,46,42,4,44
Adelaide Utd,239,5,11,6,11,37,40,-3,39
Brisbane,239,6,10,5,13,33,42,-9,35
Western Sydn,239,7,8,9,10,38,47,-9,33
Perth Glory,239,8,10,2,15,37,50,-13,32
Wellington P,239,9,5,6,16,31,55,-24,21
CC Mariners,239,10,4,8,15,28,49,-21,20
Sydney FC,240,1,21,4,3,67,23,44,67
N'castle Jet,240,2,16,5,7,61,38,23,53
Melbourne C,240,3,14,4,11,44,37,7,46
Melbourne V,240,4,13,5,11,46,41,5,44
Adelaide Utd,240,5,11,6,11,37,40,-3,39
Brisbane,240,6,10,5,13,33,42,-9,35
Western Sydn,240,7,8,9,10,38,47,-9,33
Perth Glory,240,8,10,2,15,37,50,-13,32
Wellington P,240,9,5,6,16,31,55,-24,21
CC Mariners,240,10,4,8,15,28,49,-21,20
Sydney FC,241,1,21,4,3,66,22,44,67
N'castle Jet,241,2,16,5,7,59,38,21,53
Melbourne C,241,3,14,4,11,44,35,9,46
Melbourne V,241,4,13,5,11,45,40,5,44
Adelaide Utd,241,5,11,6,11,37,40,-3,39
Brisbane,241,6,10,5,13,33,42,-9,35
Western Sydn,241,7,8,9,10,38,47,-9,33
Perth Glory,241,8,10,2,15,37,50,-13,32
Wellington P,241,9,5,6,16,31,55,-24,21
CC Mariners,241,10,4,8,15,28,49,-21,20
Sydney FC,242,1,21,4,3,68,23,45,67
N'castle Jet,242,2,15,5,8,57,41,16,50
Melbourne C,242,3,15,4,10,47,33,14,49
Melbourne V,242,4,13,5,11,46,42,4,44
Adelaide Utd,242,5,11,6,11,37,40,-3,39
Brisbane,242,6,10,5,13,33,42,-9,35
Western Sydn,242,7,8,9,10,38,47,-9,33
Perth Glory,242,8,10,2,15,37,50,-13,32
Wellington P,242,9,5,6,16,31,55,-24,21
CC Mariners,242,10,4,8,15,28,49,-21,20
Sydney FC,243,1,21,4,3,65,22,43,67
N'castle Jet,243,2,16,5,7,59,37,22,53
Melbourne C,243,3,14,4,11,43,35,8,46
Melbourne V,243,4,13,5,11,45,39,6,44
Adelaide Utd,243,5,11,6,11,37,40,-3,39
Brisbane,243,6,10,5,13,33,42,-9,35
Western Sydn,243,7,8,9,10,38,47,-9,33
Perth Glory,243,8,10,2,15,37,50,-13,32
Wellington P,243,9,5,6,16,31,55,-24,21
CC Mariners,243,10,4,8,15,28,49,-21,20
Sydney FC,244,1,21,4,3,66,22,44,67
N'castle Jet,244,2,16,5,7,62,38,24,53
Melbourne C,244,3,14,4,11,44,38,6,46
Melbourne V,244,4,13,5,11,45,40,5,44
Adelaide Utd,244,5,11,6,11,37,40,-3,39
Brisbane,244,6,10,5,13,33,42,-9,35
Western Sydn,244,7,8,9,10,38,47,-9,33
Perth Glory,244,8,10,2,15,37,50,-13,32
Wellington P,244,9,5,6,16,31,55,-24,21
CC Mariners,244,10,4,8,15,28,49,-21,20
Sydney FC,245,1,21,4,3,67,22,45,67
N'castle Jet,245,2,16,5,7,60,37,23,53
Melbourne C,245,3,14,4,11,43,36,7,46
Melbourne V,245,4,13,5,11,45,41,4,44
Adelaide Utd,245,5,11,6,11,37,40,-3,39
Brisbane,245,6,10,5,13,33,42,-9,35
Western Sydn,245,7,8,9,10,38,47,-9,33
Perth Glory,245,8,10,2,15,37,50,-13,32
Wellington P,245,9,5,6,16,31,55,-24,21
CC Mariners,245,10,4,8,15,28,49,-21,20
Sydney FC,246,1,21,4,3,66,22,44,67
N'castle Jet,246,2,15,5,8,58,40,18,50
Melbourne C,246,3,15,4,10,46,34,12,49
Melbourne V,246,4,13,5,11,45,40,5,44
Adelaide Utd,246,5,11,6,11,37,40,-3,39
Brisbane,246,6,10,5,13,33,42,-9,35
Western Sydn,246,7,8,9,10,38,47,-9,33
Perth Glory,246,8,10,2,15,37,50,-13,32
Wellington P,246,9,5,6,16,31,55,-24,21
CC Mariners,246,10,4,8,15,28,49,-21,20
Sydney FC,247,1,20,4,4,66,25,41,64
N'castle Jet,247,2,15,6,7,59,39,20,51
Melbourne C,247,3,14,5,10,45,35,10,47
Melbourne V,247,4,14,5,10,48,40,8,47
Adelaide Utd,247,5,11,6,11,37,40,-3,39
Brisbane,247,6,10,5,13,33,42,-9,35
Western Sydn,247,7,8,9,10,38,47,-9,33
Perth Glory,247,8,10,2,15,37,50,-13,32
Wellington P,247,9,5,6,16,31,55,-24,21
CC Mariners,247,10,4,8,15,28,49,-21,20
Sydney FC,248,1,21,4,3,66,22,44,67
N'castle Jet,248,2,15,5,8,58,39,19,50
Melbourne C,248,3,15,4,10,45,34,11,49
Melbourne V,248,4,13,5,11,45,40,5,44
Adelaide Utd,248,5,11,6,11,37,40,-3,39
Brisbane,248,6,10,5,13,33,42,-9,35
Western Sydn,248,7,8,9,10,38,47,-9,33
Perth Glory,248,8,10,2,15,37,50,-13,32
Wellington P,248,9,5,6,16,31,55,-24,21
CC Mariners,248,10,4,8,15,28,49,-21,20
Sydney FC,249,1,20,4,4,64,23,41,64
N'castle Jet,249,2,16,5,7,60,37,23,53
Melbourne V,249,3,14,5,10,46,38,8,47
Melbourne C,249,4,14,4,11,43,36,7,46
Adelaide Utd,249,5,11,6,11,37,40,-3,39
Brisbane,249,6,10,5,13,33,42,-9,35
Western Sydn,249,7,8,9,10,38,47,-9,33
Perth Glory,249,8,10,2,15,37,50,-13,32
Wellington P,249,9,5,6,16,31,55,-24,21
CC Mariners,249,10,4,8,15,28,49,-21,20
Sydney FC,250,1,20,4,4,64,23,41,64
N'castle Jet,250,2,15,5,8,58,41,17,50
Melbourne C,250,3,15,4,10,47,34,13,49
Melbourne V,250,4,14,5,10,46,38,8,47
Adelaide Utd,250,5,11,6,11,37,40,-3,39
Brisbane,250,6,10,5,13,33,42,-9,35
Western Sydn,250,7,8,9,10,38,47,-9,33
Perth Glory,250,8,10,2,15,37,50,-13,32
Wellington P,250,9,5,6,16,31,55,-24,21
CC Mariners,250,10,4,8,15,28,49,-21,20
Sydney FC,251,1,21,4,3,67,22,45,67
N'castle Jet,251,2,16,5,7,59,37,22,53
Melbourne C,251,3,14,4,11,43,35,8,46
Melbourne V,251,4,13,5,11,45,41,4,44
Adelaide Utd,251,5,11,6,11,37,40,-3,39
Brisbane,251,6,10,5,13,33,42,-9,35
Western Sydn,251,7,8,9,10,38,47,-9,33
Perth Glory,251,8,10,2,15,37,50,-13,32
Wellington P,251,9,5,6,16,31,55,-24,21
CC Mariners,251,10,4,8,15,28,49,-21,20
Sydney FC,252,1,20,5,3,65,23,42,65
N'castle Jet,252,2,16,5,7,60,39,21,53
Melbourne C,252,3,14,4,11,45,36,9,46
Melbourne V,252,4,13,6,10,46,39,7,45
Adelaide Utd,252,5,11,6,11,37,40,-3,39
Brisbane,252,6,10,5,13,33,42,-9,35
Western Sydn,252,7,8,9,10,38,47,-9,33
Perth Glory,252,8,10,2,15,37,50,-13,32
Wellington P,252,9,5,6,16,31,55,-24,21
CC Mariners,252,10,4,8,15,28,49,-21,20
Sydney FC,253,1,20,5,3,64,22,42,65
N'castle Jet,253,2,15,5,8,57,41,16,50
Melbourne C,253,3,15,4,10,47,33,14,49
Melbourne V,253,4,13,6,10,45,38,7,45
Adelaide Utd,253,5,11,6,11,37,40,-3,39
Brisbane,253,6,10,5,13,33,42,-9,35
Western Sydn,253,7,8,9,10,38,47,-9,33
Perth Glory,253,8,10,2,15,37,50,-13,32
Wellington P,253,9,5,6,16,31,55,-24,21
CC Mariners,253,10,4,8,15,28,49,-21,20
Sydney FC,254,1,21,4,3,65,22,43,67
N'castle Jet,254,2,15,6,7,59,39,20,51
Melbourne C,254,3,14,5,10,45,35,10,47
Melbourne V,254,4,13,5,11,45,39,6,44
Adelaide Utd,254,5,11,6,11,37,40,-3,39
Brisbane,254,6,10,5,13,33,42,-9,35
Western Sydn,254,7,8,9,10,38,47,-9,33
Perth Glory,254,8,10,2,15,37,50,-13,32
Wellington P,254,9,5,6,16,31,55,-24,21
CC Mariners,254,10,4,8,15,28,49,-21,20
Sydney FC,255,1,20,5,3,65,23,42,65
N'castle Jet,255,2,15,5,8,58,39,19,50
Melbourne C,255,3,15,4,10,45,34,11,49
Melbourne V,255,4,13,6,10,46,39,7,45
Adelaide Utd,255,5,11,6,11,37,40,-3,39
Brisbane,255,6,10,5,13,33,42,-9,35
Western Sydn,255,7,8,9,10,38,47,-9,33
Perth Glory,255,8,10,2,15,37,50,-13,32
Wellington P,255,9,5,6,16,31,55,-24,21
CC Mariners,255,10,4,8,15,28,49,-21,20
Sydney FC,256,1,21,4,3,66,23,43,67
N'castle Jet,256,2,15,6,7,57,37,20,51
Melbourne C,256,3,14,5,10,43,33,10,47
Melbourne V,256,4,13,5,11,46,40,6,44
Adelaide Utd,256,5,11,6,11,37,40,-3,39
Brisbane,256,6,10,5,13,33,42,-9,35
Western Sydn,256,7,8,9,10,38,47,-9,33
Perth Glory,256,8,10,2,15,37,50,-13,32
Wellington P,256,9,5,6,16,31,55,-24,21
CC Mariners,256,10,4,8,15,28,49,-21,20
Sydney FC,257,1,21,4,3,67,22,45,67
N'castle Jet,257,2,15,6,7,58,38,20,51
Melbourne C,257,3,14,5,10,44,34,10,47
Melbourne V,257,4,13,5,11,45,41,4,44
Adelaide Utd,257,5,11,6,11,37,40,-3,39
Brisbane,257,6,10,5,13,33,42,-9,35
Western Sydn,257,7,8,9,10,38,47,-9,33
Perth Glory,257,8,10,2,15,37,50,-13,32
Wellington P,257,9,5,6,16,31,55,-24,21
CC Mariners,257,10,4,8,15,28,49,-21,20
Sydney FC,258,1,21,4,3,67,23,44,67
N'castle Jet,258,2,15,6,7,57,37,20,51
Melbourne C,258,3,14,5,10,43,33,10,47
Melbourne V,258,4,13,5,11,46,41,5,44
Adelaide Utd,258,5,11,6,11,37,40,-3,39
Brisbane,258,6,10,5,13,33,42,-9,35
Western Sydn,258,7,8,9,10,38,47,-9,33
Perth Glory,258,8,10,2,15,37,50,-13,32
Wellington P,258,9,5,6,16,31,55,-24,21
CC Mariners,258,10,4,8,15,28,49,-21,20
Sydney FC,259,1,21,4,3,65,22,43,67
N'castle Jet,259,2,16,5,7,59,38,21,53
Melbourne C,259,3,14,4,11,44,35,9,46
Melbourne V,259,4,13,5,11,45,39,6,44
Adelaide Utd,259,5,11,6,11,37,40,-3,39
Brisbane,259,6,10,5,13,33,42,-9,35
Western Sydn,259,7,8,9,10,38,47,-9,33
Perth Glory,259,8,10,2,15,37,50,-13,32
Wellington P,259,9,5,6,16,31,55,-24,21
CC Mariners,259,10,4,8,15,28,49,-21,20
Sydney FC,260,1,21,4,3,68,22,46,67
N'castle Jet,260,2,15,6,7,58,38,20,51
Melbourne C,260,3,14,5,10,44,34,10,47
Melbourne V,260,4,13,5,11,45,42,3,44
Adelaide Utd,260,5,11,6,11,37,40,-3,39
Brisbane,260,6,10,5,13,33,42,-9,35
Western Sydn,260,7,8,9,10,38,47,-9,33
Perth Glory,260,8,10,2,15,37,50,-13,32
Wellington P,260,9,5,6,16,31,55,-24,21
CC Mariners,260,10,4,8,15,28,49,-21,20
Sydney FC,261,1,21,4,3,69,23,46,67
N'castle Jet,261,2,15,5,8,57,38,19,50
Melbourne C,261,3,15,4,10,44,33,11,49
Melbourne V,261,4,13,5,11,46,43,3,44
Adelaide Utd,261,5,11,6,11,37,40,-3,39
Brisbane,261,6,10,5,13,33,42,-9,35
Western Sydn,261,7,8,9,10,38,47,-9,33
Perth Glory,261,8,10,2,15,37,50,-13,32
Wellington P,261,9,5,6,16,31,55,-24,21
CC Mariners,261,10,4,8,15,28,49,-21,20
Sydney FC,262,1,21,4,3,68,23,45,67
N'castle Jet,262,2,15,5,8,58,39,19,50
Melbourne C,262,3,15,4,10,45,34,11,49
Melbourne V,262,4,13,5,11,46,42,4,44
Adelaide Utd,262,5,11,6,11,37,40,-3,39
Brisbane,262,6,10,5,13,33,42,-9,35
Western Sydn,262,7,8,9,10,38,47,-9,33
Perth Glory,262,8,10,2,15,37,50,-13,32
Wellington P,262,9,5,6,16,31,55,-24,21
CC Mariners,262,10,4,8,15,28,49,-21,20
Sydney FC,263,1,21,4,3,67,23,44,67
N'castle Jet,263,2,16,5,7,60,38,22,53
Melbourne C,263,3,14,4,11,44,36,8,46
Melbourne V,263,4,13,5,11,46,41,5,44
Adelaide Utd,263,5,11,6,11,37,40,-3,39
Brisbane,263,6,10,5,13,33,42,-9,35
Western Sydn,263,7,8,9,10,38,47,-9,33
Perth Glory,263,8,10,2,15,37,50,-13,32
Wellington P,263,9,5,6,16,31,55,-24,21
CC Mariners,263,10,4,8,15,28,49,-21,20
Sydney FC,264,1,21,4,3,68,23,45,67
N'castle Jet,264,2,16,5,7,58,37,21,53
Melbourne C,264,3,14,4,11,43,34,9,46
Melbourne V,264,4,13,5,11,46,42,4,44
Adelaide Utd,264,5,11,6,11,37,40,-3,39
Brisbane,264,6,10,5,13,33,42,-9,35
Western Sydn,264,7,8,9,10,38,47,-9,33
Perth Glory,264,8,10,2,15,37,50,-13,32
Wellington P,264,9,5,6,16,31,55,-24,21
CC Mariners,264,10,4,8,15,28,49,-21,20
Sydney FC,265,1,21,4,3,65,22,43,67
N'castle Jet,265,2,15,5,8,58,40,18,50
Melbourne C,265,3,15,4,10,46,34,12,49
Melbourne V,265,4,13,5,11,45,39,6,44
Adelaide Utd,265,5,11,6,11,37,40,-3,39
Brisbane,265,6,10,5,13,33,42,-9,35
Western Sydn,265,7,8,9,10,38,47,-9,33
Perth Glory,265,8,10,2,15,37,50,-13,32
Wellington P,265,9,5,6,16,31,55,-24,21
CC Mariners,265,10,4,8,15,28,49,-21,20
Sydney FC,266,1,20,5,3,65,23,42,65
N'castle Jet,266,2,16,5,7,60,38,22,53
Melbourne C,266,3,14,4,11,44,36,8,46
Melbourne V,266,4,13,6,10,46,39,7,45
Adelaide Utd,266,5,11,6,11,37,40,-3,39
Brisbane,266,6,10,5,13,33,42,-9,35
Western Sydn,266,7,8,9,10,38,47,-9,33
Perth Glory,266,8,10,2,15,37,50,-13,32
Wellington P,266,9,5,6,16,31,55,-24,21
CC Mariners,266,10,4,8,15,28,49,-21,20
Sydney FC,267,1,21,4,3,66,22,44,67
N'castle Jet,267,2,16,5,7,61,37,24,53
Melbourne C,267,3,14,4,11,43,37,6,46
Melbourne V,267,4,13,5,11,45,40,5,44
Adelaide Utd,267,5,11,6,11,37,40,-3,39
Brisbane,267,6,10,5,13,33,42,-9,35
Western Sydn,267,7,8,9,10,38,47,-9,33
Perth Glory,267,8,10,2,15,37,50,-13,32
Wellington P,267,9,5,6,16,31,55,-24,21
CC Mariners,267,10,4,8,15,28,49,-21,20
Sydney FC,268,1,21,4,3,65,22,43,67
N'castle Jet,268,2,15,6,7,59,39,20,51
Melbourne C,268,3,14,5,10,45,35,10,47
Melbourne V,268,4,13,5,11,45,39,6,44
Adelaide Utd,268,5,11,6,11,37,40,-3,39
Brisbane,268,6,10,5,13,33,42,-9,35
Western Sydn,268,7,8,9,10,38,47,-9,33
Perth Glory,268,8,10,2,15,37,50,-13,32
Wellington P,268,9,5,6,16,31,55,-24,21
CC Mariners,268,10,4,8,15,28,49,-21,20
Sydney FC,269,1,20,5,3,64,22,42,65
N'castle Jet,269,2,15,6,7,58,38,20,51
Melbourne C,269,3,14,5,10,44,34,10,47
Melbourne V,269,4,13,6,10,45,38,7,45
Adelaide Utd,269,5,11,6,11,37,40,-3,39
Brisbane,269,6,10,5,13,33,42,-9,35
Western Sydn,269,7,8,9,10,38,47,-9,33
Perth Glory,269,8,10,2,15,37,50,-13,32
Wellington P,269,9,5,6,16,31,55,-24,21
CC Mariners,269,10,4,8,15,28,49,-21,20
Sydney FC,270,1,21,4,3,67,24,43,67
N'castle Jet,270,2,15,5,8,58,41,17,50
Melbourne C,270,3,15,4,10,47,34,13,49
Melbourne V,270,4,13,5,11,47,41,6,44
Adelaide Utd,270,5,11,6,11,37,40,-3,39
Brisbane,270,6,10,5,13,33,42,-9,35
Western Sydn,270,7,8,9,10,38,47,-9,33
Perth Glory,270,8,10,2,15,37,50,-13,32
Wellington P,270,9,5,6,16,31,55,-24,21
CC Mariners,270,10,4,8,15,28,49,-21,20
Sydney FC,271,1,21,4,3,67,23,44,67
N'castle Jet,271,2,16,5,7,59,37,22,53
Melbourne C,271,3,14,4,11,43,35,8,46
Melbourne V,271,4,13,5,11,46,41,5,44
Adelaide Utd,271,5,11,6,11,37,40,-3,39
Brisbane,271,6,10,5,13,33,42,-9,35
Western Sydn,271,7,8,9,10,38,47,-9,33
Perth Glory,271,8,10,2,15,37,50,-13,32
Wellington P,271,9,5,6,16,31,55,-24,21
CC Mariners,271,10,4,8,15,28,49,-21,20
Sydney FC,272,1,20,4,4,65,24,41,64
N'castle Jet,272,2,15,6,7,61,41,20,51
Melbourne C,272,3,14,5,10,47,37,10,47
Melbourne V,272,4,14,5,10,47,39,8,47
Adelaide Utd,272,5,11,6,11,37,40,-3,39
Brisbane,272,6,10,5,13,33,42,-9,35
Western Sydn,272,7,8,9,10,38,47,-9,33
Perth Glory,272,8,10,2,15,37,50,-13,32
Wellington P,272,9,5,6,16,31,55,-24,21
CC Mariners,272,10,4,8,15,28,49,-21,20
Sydney FC,273,1,21,4,3,66,22,44,67
N'castle Jet,273,2,16,5,7,58,37,21,53
Melbourne C,273,3,14,4,11,43,34,9,46
Melbourne V,273,4,13,5,11,45,40,5,44
Adelaide Utd,273,5,11,6,11,37,40,-3,39
Brisbane,273,6,10,5,13,33,42,-9,35
Western Sydn,273,7,8,9,10,38,47,-9,33
Perth Glory,273,8,10,2,15,37,50,-13,32
Wellington P,273,9,5,6,16,31,55,-24,21
CC Mariners,273,10,4,8,15,28,49,-21,20
Sydney FC,274,1,21,4,3,67,24,43,67
N'castle Jet,274,2,16,5,7,60,39,21,53
Melbourne C,274,3,14,4,11,45,36,9,46
Melbourne V,274,4,13,5,11,47,41,6,44
Adelaide Utd,274,5,11,6,11,37,40,-3,39
Brisbane,274,6,10,5,13,33,42,-9,35
Western Sydn,274,7,8,9,10,38,47,-9,33
Perth Glory,274,8,10,2,15,37,50,-13,32
Wellington P,274,9,5,6,16,31,55,-24,21
CC Mariners,274,10,4,8,15,28,49,-21,20
Sydney FC,275,1,20,4,4,64,23,41,64
N'castle Jet,275,2,15,6,7,58,38,20,51
Melbourne C,275,3,14,5,10,44,34,10,47
Melbourne V,275,4,14,5,10,46,38,8,47
Adelaide Utd,275,5,11,6,11,37,40,-3,39
Brisbane,275,6,10,5,13,33,42,-9,35
Western Sydn,275,7,8,9,10,38,47,-9,33
Perth Glory,275,8,10,2,15,37,50,-13,32
Wellington P,275,9,5,6,16,31,55,-24,21
CC Mariners,275,10,4,8,15,28,49,-21,20
Sydney FC,276,1,20,5,3,66,24,42,65
N'castle Jet,276,2,15,6,7,57,37,20,51
Melbourne C,276,3,14,5,10,43,33,10,47
Melbourne V,276,4,13,6,10,47,40,7,45
Adelaide Utd,276,5,11,6,11,37,40,-3,39
Brisbane,276,6,10,5,13,33,42,-9,35
Western Sydn,276,7,8,9,10,38,47,-9,33
Perth Glory,276,8,10,2,15,37,50,-13,32
Wellington P,276,9,5,6,16,31,55,-24,21
CC Mariners,276,10,4,8,15,28,49,-21,20
Sydney FC,277,1,21,4,3,67,24,43,67
N'castle Jet,277,2,15,5,8,57,38,19,50
Melbourne C,277,3,15,4,10,44,33,11,49
Melbourne V,277,4,13,5,11,47,41,6,44
Adelaide Utd,277,5,11,6,11,37,40,-3,39
Brisbane,277,6,10,5,13,33,42,-9,35
Western Sydn,277,7,8,9,10,38,47,-9,33
Perth Glory,277,8,10,2,15,37,50,-13,32
Wellington P,277,9,5,6,16,31,55,-24,21
CC Mariners,277,10,4,8,15,28,49,-21,20
Sydney FC,278,1,21,4,3,67,23,44,67
N'castle Jet,278,2,16,5,7,59,37,22,53
Melbourne C,278,3,14,4,11,43,35,8,46
Melbourne V,278,4,13,5,11,46,41,5,44
Adelaide Utd,278,5,11,6,11,37,40,-3,39
Brisbane,278,6,10,5,13,33,42,-9,35
Western Sydn,278,7,8,9,10,38,47,-9,33
Perth Glory,278,8,10,2,15,37,50,-13,32
Wellington P,278,9,5,6,16,31,55,-24,21
CC Mariners,278,10,4,8,15,28,49,-21,20
Sydney FC,279,1,21,4,3,67,24,43,67
N'castle Jet,279,2,16,5,7,61,38,23,53
Melbourne C,279,3,14,4,11,44,37,7,46
Melbourne V,279,4,13,5,11,47,41,6,44
Adelaide Utd,279,5,11,6,11,37,40,-3,39
Brisbane,279,6,10,5,13,33,42,-9,35
Western Sydn,279,7,8,9,10,38,47,-9,33
Perth Glory,279,8,10,2,15,37,50,-13,32
Wellington P,279,9,5,6,16,31,55,-24,21
CC Mariners,279,10,4,8,15,28,49,-21,20
Sydney FC,280,1,20,5,3,66,24,42,65
N'castle Jet,280,2,15,6,7,58,38,20,51
Melbourne C,280,3,14,5,10,44,34,10,47
Melbourne V,280,4,13,6,10,47,40,7,45
Adelaide Utd,280,5,11,6,11,37,40,-3,39
Brisbane,280,6,10,5,13,33,42,-9,35
Western Sydn,280,7,8,9,10,38,47,-9,33
Perth Glory,280,8,10,2,15,37,50,-13,32
Wellington P,280,9,5,6,16,31,55,-24,21
CC Mariners,280,10,4,8,15,28,49,-21,20
Sydney FC,281,1,21,4,3,65,22,43,67
N'castle Jet,281,2,16,5,7,59,38,21,53
Melbourne C,281,3,14,4,11,44,35,9,46
Melbourne V,281,4,13,5,11,45,39,6,44
Adelaide Utd,281,5,11,6,11,37,40,-3,39
Brisbane,281,6,10,5,13,33,42,-9,35
Western Sydn,281,7,8,9,10,38,47,-9,33
Perth Glory,281,8,10,2,15,37,50,-13,32
Wellington P,281,9,5,6,16,31,55,-24,21
CC Mariners,281,10,4,8,15,28,49,-21,20
Sydney FC,282,1,21,4,3,68,23,45,67
N'castle Jet,282,2,15,5,8,57,38,19,50
Melbourne C,282,3,15,4,10,44,33,11,49
Melbourne V,282,4,13,5,11,46,42,4,44
Adelaide Utd,282,5,11,6,11,37,40,-3,39
Brisbane,282,6,10,5,13,33,42,-9,35
Western Sydn,282,7,8,9,10,38,47,-9,33
Perth Glory,282,8,10,2,15,37,50,-13,32
Wellington P,282,9,5,6,16,31,55,-24,21
CC Mariners,282,10,4,8,15,28,49,-21,20
Sydney FC,283,1,21,4,3,68,24,44,67
N'castle Jet,283,2,16,5,7,58,37,21,53
Melbourne C,283,3,14,4,11,43,34,9,46
Melbourne V,283,4,13,5,11,47,42,5,44
Adelaide Utd,283,5,11,6,11,37,40,-3,39
Brisbane,283,6,10,5,13,33,42,-9,35
Western Sydn,283,7,8,9,10,38,47,-9,33
Perth Glory,283,8,10,2,15,37,50,-13,32
Wellington P,283,9,5,6,16,31,55,-24,21
CC Mariners,283,10,4,8,15,28,49,-21,20
Sydney FC,284,1,21,4,3,66,23,43,67
N'castle Jet,284,2,15,6,7,59,39,20,51
Melbourne C,284,3,14,5,10,45,35,10,47
Melbourne V,284,4,13,5,11,46,40,6,44
Adelaide Utd,284,5,11,6,11,37,40,-3,39
Brisbane,284,6,10,5,13,33,42,-9,35
Western Sydn,284,7,8,9,10,38,47,-9,33
Perth Glory,284,8,10,2,15,37,50,-13,32
Wellington P,284,9,5,6,16,31,55,-24,21
CC Mariners,284,10,4,8,15,28,49,-21,20
Sydney FC,285,1,21,4,3,66,23,43,67
N'castle Jet,285,2,16,5,7,58,37,21,53
Melbourne C,285,3,14,4,11,43,34,9,46
Melbourne V,285,4,13,5,11,46,40,6,44
Adelaide Utd,285,5,11,6,11,37,40,-3,39
Brisbane,285,6,10,5,13,33,42,-9,35
Western Sydn,285,7,8,9,10,38,47,-9,33
Perth Glory,285,8,10,2,15,37,50,-13,32
Wellington P,285,9,5,6,16,31,55,-24,21
CC Mariners,285,10,4,8,15,28,49,-21,20
Sydney FC,286,1,21,4,3,67,24,43,67
N'castle Jet,286,2,16,5,7,60,37,23,53
Melbourne C,286,3,14,4,11,43,36,7,46
Melbourne V,286,4,13,5,11,47,41,6,44
Adelaide Utd,286,5,11,6,11,37,40,-3,39
Brisbane,286,6,10,5,13,33,42,-9,35
Western Sydn,286,7,8,9,10,38,47,-9,33
Perth Glory,286,8,10,2,15,37,50,-13,32
Wellington P,286,9,5,6,16,31,55,-24,21
CC Mariners,286,10,4,8,15,28,49,-21,20
Sydney FC,287,1,21,4,3,65,22,43,67
N'castle Jet,287,2,16,5,7,60,39,21,53
Melbourne C,287,3,14,4,11,45,36,9,46
Melbourne V,287,4,13,5,11,45,39,6,44
Adelaide Utd,287,5,11,6,11,37,40,-3,39
Brisbane,287,6,10,5,13,33,42,-9,35
Western Sydn,287,7,8,9,10,38,47,-9,33
Perth Glory,287,8,10,2,15,37,50,-13,32
Wellington P,287,9,5,6,16,31,55,-24,21
CC Mariners,287,10,4,8,15,28,49,-21,20
Sydney FC,288,1,20,4,4,65,25,40,64
N'castle Jet,288,2,15,6,7,58,38,20,51
Melbourne C,288,3,14,5,10,44,34,10,47
Melbourne V,288,4,14,5,10,48,39,9,47
Adelaide Utd,288,5,11,6,11,37,40,-3,39
Brisbane,288,6,10,5,13,33,42,-9,35
Western Sydn,288,7,8,9,10,38,47,-9,33
Perth Glory,288,8,10,2,15,37,50,-13,32
Wellington P,288,9,5,6,16,31,55,-24,21
CC Mariners,288,10,4,8,15,28,49,-21,20
Sydney FC,289,1,21,4,3,65,22,43,67
N'castle Jet,289,2,15,6,7,57,37,20,51
Melbourne C,289,3,14,5,10,43,33,10,47
Melbourne V,289,4,13,5,11,45,39,6,44
Adelaide Utd,289,5,11,6,11,37,40,-3,39
Brisbane,289,6,10,5,13,33,42,-9,35
Western Sydn,289,7,8,9,10,38,47,-9,33
Perth Glory,289,8,10,2,15,37,50,-13,32
Wellington P,289,9,5,6,16,31,55,-24,21
CC Mariners,289,10,4,8,15,28,49,-21,20
Sydney FC,290,1,20,5,3,66,24,42,65
N'castle Jet,290,2,15,6,7,59,39,20,51
Melbourne C,290,3,14,5,10,45,35,10,47
Melbourne V,290,4,13,6,10,47,40,7,45
Adelaide Utd,290,5,11,6,11,37,40,-3,39
Brisbane,290,6,10,5,13,33,42,-9,35
Western Sydn,290,7,8,9,10,38,47,-9,33
Perth Glory,290,8,10,2,15,37,50,-13,32
Wellington P,290,9,5,6,16,31,55,-24,21
CC Mariners,290,10,4,8,15,28,49,-21,20
Sydney FC,291,1,21,4,3,66,23,43,67
N'castle Jet,291,2,15,5,8,58,39,19,50
Melbourne C,291,3,15,4,10,45,34,11,49
Melbourne V,291,4,13,5,11,46,40,6,44
Adelaide Utd,291,5,11,6,11,37,40,-3,39
Brisbane,291,6,10,5,13,33,42,-9,35
Western Sydn,291,7,8,9,10,38,47,-9,33
Perth Glory,291,8,10,2,15,37,50,-13,32
Wellington P,291,9,5,6,16,31,55,-24,21
CC Mariners,291,10,4,8,15,28,49,-21,20
Sydney FC,292,1,20,5,3,64,22,42,65
N'castle Jet,292,2,16,5,7,59,38,21,53
Melbourne C,292,3,14,4,11,44,35,9,46
Melbourne V,292,4,13,6,10,45,38,7,45
Adelaide Utd,292,5,11,6,11,37,40,-3,39
Brisbane,292,6,10,5,13,33,42,-9,35
Western Sydn,292,7,8,9,10,38,47,-9,33
Perth Glory,292,8,10,2,15,37,50,-13,32
Wellington P,292,9,5,6,16,31,55,-24,21
CC Mariners,292,10,4,8,15,28,49,-21,20
Sydney FC,293,1,20,5,3,66,24,42,65
N'castle Jet,293,2,15,6,7,57,37,20,51
Melbourne C,293,3,14,5,10,43,33,10,47
Melbourne V,293,4,13,6,10,47,40,7,45
Adelaide Utd,293,5,11,6,11,37,40,-3,39
Brisbane,293,6,10,5,13,33,42,-9,35
Western Sydn,293,7,8,9,10,38,47,-9,33
Perth Glory,293,8,10,2,15,37,50,-13,32
Wellington P,293,9,5,6,16,31,55,-24,21
CC Mariners,293,10,4,8,15,28,49,-21,20
Sydney FC,294,1,21,4,3,68,23,45,67
N'castle Jet,294,2,15,6,7,58,38,20,51
Melbourne C,294,3,14,5,10,44,34,10,47
Melbourne V,294,4,13,5,11,46,42,4,44
Adelaide Utd,294,5,11,6,11,37,40,-3,39
Brisbane,294,6,10,5,13,33,42,-9,35
Western Sydn,294,7,8,9,10,38,47,-9,33
Perth Glory,294,8,10,2,15,37,50,-13,32
Wellington P,294,9,5,6,16,31,55,-24,21
CC Mariners,294,10,4,8,15,28,49,-21,20
Sydney FC,295,1,21,4,3,66,23,43,67
N'castle Jet,295,2,16,5,7,60,38,22,53
Melbourne C,295,3,14,4,11,44,36,8,46
Melbourne V,295,4,13,5,11,46,40,6,44
Adelaide Utd,295,5,11,6,11,37,40,-3,39
Brisbane,295,6,10,5,13,33,42,-9,35
Western Sydn,295,7,8,9,10,38,47,-9,33
Perth Glory,295,8,10,2,15,37,50,-13,32
Wellington P,295,9,5,6,16,31,55,-24,21
CC Mariners,295,10,4,8,15,28,49,-21,20
Sydney FC,296,1,21,4,3,65,22,43,67
N'castle Jet,296,2,16,5,7,59,38,21,53
Melbourne C,296,3,14,4,11,44,35,9,46
Melbourne V,296,4,13,5,11,45,39,6,44
Adelaide Utd,296,5,11,6,11,37,40,-3,39
Brisbane,296,6,10,5,13,33,42,-9,35
Western Sydn,296,7,8,9,10,38,47,-9,33
Perth Glory,296,8,10,2,15,37,50,-13,32
Wellington P,296,9,5,6,16,31,55,-24,21
CC Mariners,296,10,4,8,15,28,49,-21,20
Sydney FC,297,1,20,4,4,65,25,40,64
N'castle Jet,297,2,16,5,7,60,38,22,53
Melbourne V,297,3,14,5,10,48,39,9,47
Melbourne C,297,4,14,4,11,44,36,8,46
Adelaide Utd,297,5,11,6,11,37,40,-3,39
Brisbane,297,6,10,5,13,33,42,-9,35
Western Sydn,297,7,8,9,10,38,47,-9,33
Perth Glory,297,8,10,2,15,37,50,-13,32
Wellington P,297,9,5,6,16,31,55,-24,21
CC Mariners,297,10,4,8,15,28,49,-21,20
Sydney FC,298,1,21,4,3,67,23,44,67
N'castle Jet,298,2,15,5,8,58,40,18,50
Melbourne C,298,3,15,4,10,46,34,12,49
Melbourne V,298,4,13,5,11,46,41,5,44
Adelaide Utd,298,5,11,6,11,37,40,-3,39
Brisbane,298,6,10,5,13,33,42,-9,35
Western Sydn,298,7,8,9,10,38,47,-9,33
Perth Glory,298,8,10,2,15,37,50,-13,32
Wellington P,298,9,5,6,16,31,55,-24,21
CC Mariners,298,10,4,8,15,28,49,-21,20
Sydney FC,299,1,21,4,3,67,24,43,67
N'castle Jet,299,2,16,5,7,58,37,21,53
Melbourne C,299,3,14,4,11,43,34,9,46
Melbourne V,299,4,13,5,11,47,41,6,44
Adelaide Utd,299,5,11,6,11,37,40,-3,39
Brisbane,299,6,10,5,13,33,42,-9,35
Western Sydn,299,7,8,9,10,38,47,-9,33
Perth Glory,299,8,10,2,15,37,50,-13,32
Wellington P,299,9,5,6,16,31,55,-24,21
CC Mariners,299,10,4,8,15,28,49,-21,20
Sydney FC,300,1,21,4,3,65,22,43,67
N'castle Jet,300,2,16,5,7,59,37,22,53
Melbourne C,300,3,14,4,11,43,35,8,46
Melbourne V,300,4,13,5,11,45,39,6,44
Adelaide Utd,300,5,11,6,11,37,40,-3,39
Brisbane,300,6,10,5,13,33,42,-9,35
Western Sydn,300,7,8,9,10,38,47,-9,33
Perth Glory,300,8,10,2,15,37,50,-13,32
Wellington P,300,9,5,6,16,31,55,-24,21
CC Mariners,300,10,4,8,15,28,49,-21,20
Sydney FC,301,1,21,4,3,67,22,45,67
N'castle Jet,301,2,15,6,7,60,40,20,51
Melbourne C,301,3,14,5,10,46,36,10,47
Melbourne V,301,4,13,5,11,45,41,4,44
Adelaide Utd,301,5,11,6,11,37,40,-3,39
Brisbane,301,6,10,5,13,33,42,-9,35
Western Sydn,301,7,8,9,10,38,47,-9,33
Perth Glory,301,8,10,2,15,37,50,-13,32
Wellington P,301,9,5,6,16,31,55,-24,21
CC Mariners,301,10,4,8,15,28,49,-21,20
Sydney FC,302,1,20,4,4,66,25,41,64
N'castle Jet,302,2,16,5,7,61,38,23,53
Melbourne V,302,3,14,5,10,48,40,8,47
Melbourne C,302,4,14,4,11,44,37,7,46
Adelaide Utd,302,5,11,6,11,37,40,-3,39
Brisbane,302,6,10,5,13,33,42,-9,35
Western Sydn,302,7,8,9,10,38,47,-9,33
Perth Glory,302,8,10,2,15,37,50,-13,32
Wellington P,302,9,5,6,16,31,55,-24,21
CC Mariners,302,10,4,8,15,28,49,-21,20
Sydney FC,303,1,20,5,3,64,22,42,65
N'castle Jet,303,2,15,5,8,59,40,19,50
Melbourne C,303,3,15,4,10,46,35,11,49
Melbourne V,303,4,13,6,10,45,38,7,45
Adelaide Utd,303,5,11,6,11,37,40,-3,39
Brisbane,303,6,10,5,13,33,42,-9,35
Western Sydn,303,7,8,9,10,38,47,-9,33
Perth Glory,303,8,10,2,15,37,50,-13,32
Wellington P,303,9,5,6,16,31,55,-24,21
CC Mariners,303,10,4,8,15,28,49,-21,20
Sydney FC,304,1,21,4,3,65,22,43,67
N'castle Jet,304,2,15,6,7,57,37,20,51
Melbourne C,304,3,14,5,10,43,33,10,47
Melbourne V,304,4,13,5,11,45,39,6,44
Adelaide Utd,304,5,11,6,11,37,40,-3,39
Brisbane,304,6,10,5,13,33,42,-9,35
Western Sydn,304,7,8,9,10,38,47,-9,33
Perth Glory,304,8,10,2,15,37,50,-13,32
Wellington P,304,9,5,6,16,31,55,-24,21
CC Mariners,304,10,4,8,15,28,49,-21,20
Sydney FC,305,1,21,4,3,66,23,43,67
N'castle Jet,305,2,15,5,8,57,39,18,50
Melbourne C,305,3,15,4,10,45,33,12,49
Melbourne V,305,4,13,5,11,46,40,6,44
Adelaide Utd,305,5,11,6,11,37,40,-3,39
Brisbane,305,6,10,5,13,33,42,-9,35
Western Sydn,305,7,8,9,10,38,47,-9,33
Perth Glory,305,8,10,2,15,37,50,-13,32
Wellington P,305,9,5,6,16,31,55,-24,21
CC Mariners,305,10,4,8,15,28,49,-21,20
Sydney FC,306,1,20,5,3,65,23,42,65
N'castle Jet,306,2,16,5,7,60,38,22,53
Melbourne C,306,3,14,4,11,44,36,8,46
Melbourne V,306,4,13,6,10,46,39,7,45
Adelaide Utd,306,5,11,6,11,37,40,-3,39
Brisbane,306,6,10,5,13,33,42,-9,35
Western Sydn,306,7,8,9,10,38,47,-9,33
Perth Glory,306,8,10,2,15,37,50,-13,32
Wellington P,306,9,5,6,16,31,55,-24,21
CC Mariners,306,10,4,8,15,28,49,-21,20
Sydney FC,307,1,20,5,3,65,23,42,65
N'castle Jet,307,2,16,5,7,58,37,21,53
Melbourne C,307,3,14,4,11,43,34,9,46
Melbourne V,307,4,13,6,10,46,39,7,45
Adelaide Utd,307,5,11,6,11,37,40,-3,39
Brisbane,307,6,10,5,13,33,42,-9,35
Western Sydn,307,7,8,9,10,38,47,-9,33
Perth Glory,307,8,10,2,15,37,50,-13,32
Wellington P,307,9,5,6,16,31,55,-24,21
CC Mariners,307,10,4,8,15,28,49,-21,20
Sydney FC,308,1,21,4,3,69,23,46,67
N'castle Jet,308,2,15,6,7,58,38,20,51
Melbourne C,308,3,14,5,10,44,34,10,47
Melbourne V,308,4,13,5,11,46,43,3,44
Adelaide Utd,308,5,11,6,11,37,40,-3,39
Brisbane,308,6,10,5,13,33,42,-9,35
Western Sydn,308,7,8,9,10,38,47,-9,33
Perth Glory,308,8,10,2,15,37,50,-13,32
Wellington P,308,9,5,6,16,31,55,-24,21
CC Mariners,308,10,4,8,15,28,49,-21,20
Sydney FC,309,1,21,4,3,66,22,44,67
N'castle Jet,309,2,16,5,7,62,39,23,53
Melbourne C,309,3,14,4,11,45,38,7,46
Melbourne V,309,4,13,5,11,45,40,5,44
Adelaide Utd,309,5,11,6,11,37,40,-3,39
Brisbane,309,6,10,5,13,33,42,-9,35
Western Sydn,309,7,8,9,10,38,47,-9,33
Perth Glory,309,8,10,2,15,37,50,-13,32
Wellington P,309,9,5,6,16,31,55,-24,21
CC Mariners,309,10,4,8,15,28,49,-21,20
Sydney FC,310,1,21,4,3,67,22,45,67
N'castle Jet,310,2,16,5,7,58,37,21,53
Melbourne C,310,3,14,4,11,43,34,9,46
Melbourne V,310,4,13,5,11,45,41,4,44
Adelaide Utd,310,5,11,6,11,37,40,-3,39
Brisbane,310,6,10,5,13,33,42,-9,35
Western Sydn,310,7,8,9,10,38,47,-9,33
Perth Glory,310,8,10,2,15,37,50,-13,32
Wellington P,310,9,5,6,16,31,55,-24,21
CC Mariners,310,10,4,8,15,28,49,-21,20
Sydney FC,311,1,21,4,3,68,23,45,67
N'castle Jet,311,2,15,6,7,58,38,20,51
Melbourne C,311,3,14,5,10,44,34,10,47
Melbourne V,311,4,13,5,11,46,42,4,44
Adelaide Utd,311,5,11,6,11,37,40,-3,39
Brisbane,311,6,10,5,13,33,42,-9,35
Western Sydn,311,7,8,9,10,38,47,-9,33
Perth Glory,311,8,10,2,15,37,50,-13,32
Wellington P,311,9,5,6,16,31,55,-24,21
CC Mariners,311,10,4,8,15,28,49,-21,20
Sydney FC,312,1,21,4,3,65,22,43,67
N'castle Jet,312,2,15,6,7,58,38,20,51
Melbourne C,312,3,14,5,10,44,34,10,47
Melbourne V,312,4,13,5,11,45,39,6,44
Adelaide Utd,312,5,11,6,11,37,40,-3,39
Brisbane,312,6,10,5,13,33,42,-9,35
Western Sydn,312,7,8,9,10,38,47,-9,33
Perth Glory,312,8,10,2,15,37,50,-13,32
Wellington P,312,9,5,6,16,31,55,-24,21
CC Mariners,312,10,4,8,15,28,49,-21,20
Sydney FC,313,1,20,4,4,64,23,41,64
N'castle Jet,313,2,15,6,7,58,38,20,51
Melbourne C,313,3,14,5,10,44,34,10,47
Melbourne V,313,4,14,5,10,46,38,8,47
Adelaide Utd,313,5,11,6,11,37,40,-3,39
Brisbane,313,6,10,5,13,33,42,-9,35
Western Sydn,313,7,8,9,10,38,47,-9,33
Perth Glory,313,8,10,2,15,37,50,-13,32
Wellington P,313,9,5,6,16,31,55,-24,21
CC Mariners,313,10,4,8,15,28,49,-21,20
Sydney FC,314,1,20,5,3,64,22,42,65
N'castle Jet,314,2,16,5,7,61,37,24,53
Melbourne C,314,3,14,4,11,43,37,6,46
Melbourne V,314,4,13,6,10,45,38,7,45
Adelaide Utd,314,5,11,6,11,37,40,-3,39
Brisbane,314,6,10,5,13,33,42,-9,35
Western Sydn,314,7,8,9,10,38,47,-9,33
Perth Glory,314,8,10,2,15,37,50,-13,32
Wellington P,314,9,5,6,16,31,55,-24,21
CC Mariners,314,10,4,8,15,28,49,-21,20
Sydney FC,315,1,21,4,3,66,22,44,67
N'castle Jet,315,2,16,5,7,60,37,23,53
Melbourne C,315,3,14,4,11,43,36,7,46
Melbourne V,315,4,13,5,11,45,40,5,44
Adelaide Utd,315,5,11,6,11,37,40,-3,39
Brisbane,315,6,10,5,13,33,42,-9,35
Western Sydn,315,7,8,9,10,38,47,-9,33
Perth Glory,315,8,10,2,15,37,50,-13,32
Wellington P,315,9,5,6,16,31,55,-24,21
CC Mariners,315,10,4,8,15,28,49,-21,20
Sydney FC,316,1,21,4,3,66,23,43,67
N'castle Jet,316,2,16,5,7,59,38,21,53
Melbourne C,316,3,14,4,11,44,35,9,46
Melbourne V,316,4,13,5,11,46,40,6,44
Adelaide Utd,316,5,11,6,11,37,40,-3,39
Brisbane,316,6,10,5,13,33,42,-9,35
Western Sydn,316,7,8,9,10,38,47,-9,33
Perth Glory,316,8,10,2,15,37,50,-13,32
Wellington P,316,9,5,6,16,31,55,-24,21
CC Mariners,316,10,4,8,15,28,49,-21,20
Sydney FC,317,1,20,4,4,65,26,39,64
N'castle Jet,317,2,15,6,7,59,39,20,51
Melbourne V,317,3,14,5,10,49,39,10,47
Melbourne C,317,4,14,5,10,45,35,10,47
Adelaide Utd,317,5,11,6,11,37,40,-3,39
Brisbane,317,6,10,5,13,33,42,-9,35
Western Sydn,317,7,8,9,10,38,47,-9,33
Perth Glory,317,8,10,2,15,37,50,-13,32
Wellington P,317,9,5,6,16,31,55,-24,21
CC Mariners,317,10,4,8,15,28,49,-21,20
Sydney FC,318,1,21,4,3,66,22,44,67
N'castle Jet,318,2,16,5,7,60,39,21,53
Melbourne C,318,3,14,4,11,45,36,9,46
Melbourne V,318,4,13,5,11,45,40,5,44
Adelaide Utd,318,5,11,6,11,37,40,-3,39
Brisbane,318,6,10,5,13,33,42,-9,35
Western Sydn,318,7,8,9,10,38,47,-9,33
Perth Glory,318,8,10,2,15,37,50,-13,32
Wellington P,318,9,5,6,16,31,55,-24,21
CC Mariners,318,10,4,8,15,28,49,-21,20
Sydney FC,319,1,20,5,3,66,24,42,65
N'castle Jet,319,2,16,5,7,62,38,24,53
Melbourne C,319,3,14,4,11,44,38,6,46
Melbourne V,319,4,13,6,10,47,40,7,45
Adelaide Utd,319,5,11,6,11,37,40,-3,39
Brisbane,319,6,10,5,13,33,42,-9,35
Western Sydn,319,7,8,9,10,38,47,-9,33
Perth Glory,319,8,10,2,15,37,50,-13,32
Wellington P,319,9,5,6,16,31,55,-24,21
CC Mariners,319,10,4,8,15,28,49,-21,20
Sydney FC,320,1,20,5,3,65,23,42,65
N'castle Jet,320,2,16,5,7,61,39,22,53
Melbourne C,320,3,14,4,11,45,37,8,46
Melbourne V,320,4,13,6,10,46,39,7,45
Adelaide Utd,320,5,11,6,11,37,40,-3,39
Brisbane,320,6,10,5,13,33,42,-9,35
Western Sydn,320,7,8,9,10,38,47,-9,33
Perth Glory,320,8,10,2,15,37,50,-13,32
Wellington P,320,9,5,6,16,31,55,-24,21
CC Mariners,320,10,4,8,15,28,49,-21,20
Sydney FC,321,1,20,5,3,64,22,42,65
N'castle Jet,321,2,16,5,7,61,38,23,53
Melbourne C,321,3,14,4,11,44,37,7,46
Melbourne V,321,4,13,6,10,45,38,7,45
Adelaide Utd,321,5,11,6,11,37,40,-3,39
Brisbane,321,6,10,5,13,33,42,-9,35
Western Sydn,321,7,8,9,10,38,47,-9,33
Perth Glory,321,8,10,2,15,37,50,-13,32
Wellington P,321,9,5,6,16,31,55,-24,21
CC Mariners,321,10,4,8,15,28,49,-21,20
Sydney FC,322,1,21,4,3,66,22,44,67
N'castle Jet,322,2,15,6,7,58,38,20,51
Melbourne C,322,3,14,5,10,44,34,10,47
Melbourne V,322,4,13,5,11,45,40,5,44
Adelaide Utd,322,5,11,6,11,37,40,-3,39
Brisbane,322,6,10,5,13,33,42,-9,35
Western Sydn,322,7,8,9,10,38,47,-9,33
Perth Glory,322,8,10,2,15,37,50,-13,32
Wellington P,322,9,5,6,16,31,55,-24,21
CC Mariners,322,10,4,8,15,28,49,-21,20
Sydney FC,323,1,20,5,3,64,22,42,65
N'castle Jet,323,2,15,6,7,57,37,20,51
Melbourne C,323,3,14,5,10,43,33,10,47
Melbourne V,323,4,13,6,10,45,38,7,45
Adelaide Utd,323,5,11,6,11,37,40,-3,39
Brisbane,323,6,10,5,13,33,42,-9,35
Western Sydn,323,7,8,9,10,38,47,-9,33
Perth Glory,323,8,10,2,15,37,50,-13,32
Wellington P,323,9,5,6,16,31,55,-24,21
CC Mariners,323,10,4,8,15,28,49,-21,20
Sydney FC,324,1,21,4,3,70,23,47,67
N'castle Jet,324,2,15,5,8,58,39,19,50
Melbourne C,324,3,15,4,10,45,34,11,49
Melbourne V,324,4,13,5,11,46,44,2,44
Adelaide Utd,324,5,11,6,11,37,40,-3,39
Brisbane,324,6,10,5,13,33,42,-9,35
Western Sydn,324,7,8,9,10,38,47,-9,33
Perth Glory,324,8,10,2,15,37,50,-13,32
Wellington P,324,9,5,6,16,31,55,-24,21
CC Mariners,324,10,4,8,15,28,49,-21,20
Sydney FC,325,1,21,4,3,68,23,45,67
N'castle Jet,325,2,15,5,8,57,39,18,50
Melbourne C,325,3,15,4,10,45,33,12,49
Melbourne V,325,4,13,5,11,46,42,4,44
Adelaide Utd,325,5,11,6,11,37,40,-3,39
Brisbane,325,6,10,5,13,33,42,-9,35
Western Sydn,325,7,8,9,10,38,47,-9,33
Perth Glory,325,8,10,2,15,37,50,-13,32
Wellington P,325,9,5,6,16,31,55,-24,21
CC Mariners,325,10,4,8,15,28,49,-21,20
Sydney FC,326,1,21,4,3,66,22,44,67
N'castle Jet,326,2,15,6,7,58,38,20,51
Melbourne C,326,3,14,5,10,44,34,10,47
Melbourne V,326,4,13,5,11,45,40,5,44
Adelaide Utd,326,5,11,6,11,37,40,-3,39
Brisbane,326,6,10,5,13,33,42,-9,35
Western Sydn,326,7,8,9,10,38,47,-9,33
Perth Glory,326,8,10,2,15,37,50,-13,32
Wellington P,326,9,5,6,16,31,55,-24,21
CC Mariners,326,10,4,8,15,28,49,-21,20
Sydney FC,327,1,21,4,3,68,25,43,67
N'castle Jet,327,2,16,5,7,59,38,21,53
Melbourne C,327,3,14,4,11,44,35,9,46
Melbourne V,327,4,13,5,11,48,42,6,44
Adelaide Utd,327,5,11,6,11,37,40,-3,39
Brisbane,327,6,10,5,13,33,42,-9,35
Western Sydn,327,7,8,9,10,38,47,-9,33
Perth Glory,327,8,10,2,15,37,50,-13,32
Wellington P,327,9,5,6,16,31,55,-24,21
CC Mariners,327,10,4,8,15,28,49,-21,20
Sydney FC,328,1,21,4,3,67,23,44,67
N'castle Jet,328,2,15,5,8,57,39,18,50
Melbourne C,328,3,15,4,10,45,33,12,49
Melbourne V,328,4,13,5,11,46,41,5,44
Adelaide Utd,328,5,11,6,11,37,40,-3,39
Brisbane,328,6,10,5,13,33,42,-9,35
Western Sydn,328,7,8,9,10,38,47,-9,33
Perth Glory,328,8,10,2,15,37,50,-13,32
Wellington P,328,9,5,6,16,31,55,-24,21
CC Mariners,328,10,4,8,15,28,49,-21,20
Sydney FC,329,1,21,4,3,65,22,43,67
N'castle Jet,329,2,15,5,8,57,39,18,50
Melbourne C,329,3,15,4,10,45,33,12,49
Melbourne V,329,4,13,5,11,45,39,6,44
Adelaide Utd,329,5,11,6,11,37,40,-3,39
Brisbane,329,6,10,5,13,33,42,-9,35
Western Sydn,329,7,8,9,10,38,47,-9,33
Perth Glory,329,8,10,2,15,37,50,-13,32
Wellington P,329,9,5,6,16,31,55,-24,21
CC Mariners,329,10,4,8,15,28,49,-21,20
Sydney FC,330,1,21,4,3,66,22,44,67
N'castle Jet,330,2,16,5,7,61,39,22,53
Melbourne C,330,3,14,4,11,45,37,8,46
Melbourne V,330,4,13,5,11,45,40,5,44
Adelaide Utd,330,5,11,6,11,37,40,-3,39
Brisbane,330,6,10,5,13,33,42,-9,35
Western Sydn,330,7,8,9,10,38,47,-9,33
Perth Glory,330,8,10,2,15,37,50,-13,32
Wellington P,330,9,5,6,16,31,55,-24,21
CC Mariners,330,10,4,8,15,28,49,-21,20
Sydney FC,331,1,21,4,3,66,23,43,67
N'castle Jet,331,2,15,5,8,57,40,17,50
Melbourne C,331,3,15,4,10,46,33,13,49
Melbourne V,331,4,13,5,11,46,40,6,44
Adelaide Utd,331,5,11,6,11,37,40,-3,39
Brisbane,331,6,10,5,13,33,42,-9,35
Western Sydn,331,7,8,9,10,38,47,-9,33
Perth Glory,331,8,10,2,15,37,50,-13,32
Wellington P,331,9,5,6,16,31,55,-24,21
CC Mariners,331,10,4,8,15,28,49,-21,20
Sydney FC,332,1,21,4,3,65,22,43,67
N'castle Jet,332,2,15,5,8,58,40,18,50
Melbourne C,332,3,15,4,10,46,34,12,49
Melbourne V,332,4,13,5,11,45,39,6,44
Adelaide Utd,332,5,11,6,11,37,40,-3,39
Brisbane,332,6,10,5,13,33,42,-9,35
Western Sydn,332,7,8,9,10,38,47,-9,33
Perth Glory,332,8,10,2,15,37,50,-13,32
Wellington P,332,9,5,6,16,31,55,-24,21
CC Mariners,332,10,4,8,15,28,49,-21,20
Sydney FC,333,1,21,4,3,67,24,43,67
N'castle Jet,333,2,16,5,7,59,38,21,53
Melbourne C,333,3,14,4,11,44,35,9,46
Melbourne V,333,4,13,5,11,47,41,6,44
Adelaide Utd,333,5,11,6,11,37,40,-3,39
Brisbane,333,6,10,5,13,33,42,-9,35
Western Sydn,333,7,8,9,10,38,47,-9,33
Perth Glory,333,8,10,2,15,37,50,-13,32
Wellington P,333,9,5,6,16,31,55,-24,21
CC Mariners,333,10,4,8,15,28,49,-21,20
Sydney FC,334,1,20,5,3,65,23,42,65
N'castle Jet,334,2,15,6,7,57,37,20,51
Melbourne C,334,3,14,5,10,43,33,10,47
Melbourne V,334,4,13,6,10,46,39,7,45
Adelaide Utd,334,5,11,6,11,37,40,-3,39
Brisbane,334,6,10,5,13,33,42,-9,35
Western Sydn,334,7,8,9,10,38,47,-9,33
Perth Glory,334,8,10,2,15,37,50,-13,32
Wellington P,334,9,5,6,16,31,55,-24,21
CC Mariners,334,10,4,8,15,28,49,-21,20
Sydney FC,335,1,21,4,3,68,24,44,67
N'castle Jet,335,2,16,5,7,59,37,22,53
Melbourne C,335,3,14,4,11,43,35,8,46
Melbourne V,335,4,13,5,11,47,42,5,44
Adelaide Utd,335,5,11,6,11,37,40,-3,39
Brisbane,335,6,10,5,13,33,42,-9,35
Western Sydn,335,7,8,9,10,38,47,-9,33
Perth Glory,335,8,10,2,15,37,50,-13,32
Wellington P,335,9,5,6,16,31,55,-24,21
CC Mariners,335,10,4,8,15,28,49,-21,20
Sydney FC,336,1,20,4,4,64,23,41,64
N'castle Jet,336,2,16,5,7,60,38,22,53
Melbourne V,336,3,14,5,10,46,38,8,47
Melbourne C,336,4,14,4,11,44,36,8,46
Adelaide Utd,336,5,11,6,11,37,40,-3,39
Brisbane,336,6,10,5,13,33,42,-9,35
Western Sydn,336,7,8,9,10,38,47,-9,33
Perth Glory,336,8,10,2,15,37,50,-13,32
Wellington P,336,9,5,6,16,31,55,-24,21
CC Mariners,336,10,4,8,15,28,49,-21,20
Sydney FC,337,1,21,4,3,65,22,43,67
N'castle Jet,337,2,16,5,7,62,39,23,53
Melbourne C,337,3,14,4,11,45,38,7,46
Melbourne V,337,4,13,5,11,45,39,6,44
Adelaide Utd,337,5,11,6,11,37,40,-3,39
Brisbane,337,6,10,5,13,33,42,-9,35
Western Sydn,337,7,8,9,10,38,47,-9,33
Perth Glory,337,8,10,2,15,37,50,-13,32
Wellington P,337,9,5,6,16,31,55,-24,21
CC Mariners,337,10,4,8,15,28,49,-21,20
Sydney FC,338,1,21,4,3,66,22,44,67
N'castle Jet,338,2,15,6,7,58,38,20,51
Melbourne C,338,3,14,5,10,44,34,10,47
Melbourne V,338,4,13,5,11,45,40,5,44
Adelaide Utd,338,5,11,6,11,37,40,-3,39
Brisbane,338,6,10,5,13,33,42,-9,35
Western Sydn,338,7,8,9,10,38,47,-9,33
Perth Glory,338,8,10,2,15,37,50,-13,32
Wellington P,338,9,5,6,16,31,55,-24,21
CC Mariners,338,10,4,8,15,28,49,-21,20
Sydney FC,339,1,21,4,3,67,23,44,67
N'castle Jet,339,2,15,5,8,59,42,17,50
Melbourne C,339,3,15,4,10,48,35,13,49
Melbourne V,339,4,13,5,11,46,41,5,44
Adelaide Utd,339,5,11,6,11,37,40,-3,39
Brisbane,339,6,10,5,13,33,42,-9,35
Western Sydn,339,7,8,9,10,38,47,-9,33
Perth Glory,339,8,10,2,15,37,50,-13,32
Wellington P,339,9,5,6,16,31,55,-24,21
CC Mariners,339,10,4,8,15,28,49,-21,20
Sydney FC,340,1,21,4,3,68,23,45,67
N'castle Jet,340,2,15,5,8,58,39,19,50
Melbourne C,340,3,15,4,10,45,34,11,49
Melbourne V,340,4,13,5,11,46,42,4,44
Adelaide Utd,340,5,11,6,11,37,40,-3,39
Brisbane,340,6,10,5,13,33,42,-9,35
Western Sydn,340,7,8,9,10,38,47,-9,33
Perth Glory,340,8,10,2,15,37,50,-13,32
Wellington P,340,9,5,6,16,31,55,-24,21
CC Mariners,340,10,4,8,15,28,49,-21,20
Sydney FC,341,1,20,4,4,66,25,41,64
N'castle Jet,341,2,15,6,7,58,38,20,51
Melbourne C,341,3,14,5,10,44,34,10,47
Melbourne V,341,4,14,5,10,48,40,8,47
Adelaide Utd,341,5,11,6,11,37,40,-3,39
Brisbane,341,6,10,5,13,33,42,-9,35
Western Sydn,341,7,8,9,10,38,47,-9,33
Perth Glory,341,8,10,2,15,37,50,-13,32
Wellington P,341,9,5,6,16,31,55,-24,21
CC Mariners,341,10,4,8,15,28,49,-21,20
Sydney FC,342,1,20,5,3,65,23,42,65
N'castle Jet,342,2,16,5,7,59,38,21,53
Melbourne C,342,3,14,4,11,44,35,9,46
Melbourne V,342,4,13,6,10,46,39,7,45
Adelaide Utd,342,5,11,6,11,37,40,-3,39
Brisbane,342,6,10,5,13,33,42,-9,35
Western Sydn,342,7,8,9,10,38,47,-9,33
Perth Glory,342,8,10,2,15,37,50,-13,32
Wellington P,342,9,5,6,16,31,55,-24,21
CC Mariners,342,10,4,8,15,28,49,-21,20
Sydney FC,343,1,21,4,3,66,23,43,67
N'castle Jet,343,2,16,5,7,59,37,22,53
Melbourne C,343,3,14,4,11,43,35,8,46
Melbourne V,343,4,13,5,11,46,40,6,44
Adelaide Utd,343,5,11,6,11,37,40,-3,39
Brisbane,343,6,10,5,13,33,42,-9,35
Western Sydn,343,7,8,9,10,38,47,-9,33
Perth Glory,343,8,10,2,15,37,50,-13,32
Wellington P,343,9,5,6,16,31,55,-24,21
CC Mariners,343,10,4,8,15,28,49,-21,20
Sydney FC,344,1,21,4,3,69,22,47,67
N'castle Jet,344,2,16,5,7,59,37,22,53
Melbourne C,344,3,14,4,11,43,35,8,46
Melbourne V,344,4,13,5,11,45,43,2,44
Adelaide Utd,344,5,11,6,11,37,40,-3,39
Brisbane,344,6,10,5,13,33,42,-9,35
Western Sydn,344,7,8,9,10,38,47,-9,33
Perth Glory,344,8,10,2,15,37,50,-13,32
Wellington P,344,9,5,6,16,31,55,-24,21
CC Mariners,344,10,4,8,15,28,49,-21,20
Sydney FC,345,1,21,4,3,66,23,43,67
N'castle Jet,345,2,15,6,7,58,38,20,51
Melbourne C,345,3,14,5,10,44,34,10,47
Melbourne V,345,4,13,5,11,46,40,6,44
Adelaide Utd,345,5,11,6,11,37,40,-3,39
Brisbane,345,6,10,5,13,33,42,-9,35
Western Sydn,345,7,8,9,10,38,47,-9,33
Perth Glory,345,8,10,2,15,37,50,-13,32
Wellington P,345,9,5,6,16,31,55,-24,21
CC Mariners,345,10,4,8,15,28,49,-21,20
Sydney FC,346,1,20,4,4,65,26,39,64
N'castle Jet,346,2,15,6,7,58,38,20,51
Melbourne V,346,3,14,5,10,49,39,10,47
Melbourne C,346,4,14,5,10,44,34,10,47
Adelaide Utd,346,5,11,6,11,37,40,-3,39
Brisbane,346,6,10,5,13,33,42,-9,35
Western Sydn,346,7,8,9,10,38,47,-9,33
Perth Glory,346,8,10,2,15,37,50,-13,32
Wellington P,346,9,5,6,16,31,55,-24,21
CC Mariners,346,10,4,8,15,28,49,-21,20
Sydney FC,347,1,20,5,3,65,23,42,65
N'castle Jet,347,2,15,6,7,57,37,20,51
Melbourne C,347,3,14,5,10,43,33,10,47
Melbourne V,347,4,13,6,10,46,39,7,45
Adelaide Utd,347,5,11,6,11,37,40,-3,39
Brisbane,347,6,10,5,13,33,42,-9,35
Western Sydn,347,7,8,9,10,38,47,-9,33
Perth Glory,347,8,10,2,15,37,50,-13,32
Wellington P,347,9,5,6,16,31,55,-24,21
CC Mariners,347,10,4,8,15,28,49,-21,20
Sydney FC,348,1,21,4,3,66,23,43,67
N'castle Jet,348,2,16,5,7,58,37,21,53
Melbourne C,348,3,14,4,11,43,34,9,46
Melbourne V,348,4,13,5,11,46,40,6,44
Adelaide Utd,348,5,11,6,11,37,40,-3,39
Brisbane,348,6,10,5,13,33,42,-9,35
Western Sydn,348,7,8,9,10,38,47,-9,33
Perth Glory,348,8,10,2,15,37,50,-13,32
Wellington P,348,9,5,6,16,31,55,-24,21
CC Mariners,348,10,4,8,15,28,49,-21,20
Sydney FC,349,1,21,4,3,68,25,43,67
N'castle Jet,349,2,15,6,7,58,38,20,51
Melbourne C,349,3,14,5,10,44,34,10,47
Melbourne V,349,4,13,5,11,48,42,6,44
Adelaide Utd,349,5,11,6,11,37,40,-3,39
Brisbane,349,6,10,5,13,33,42,-9,35
Western Sydn,349,7,8,9,10,38,47,-9,33
Perth Glory,349,8,10,2,15,37,50,-13,32
Wellington P,349,9,5,6,16,31,55,-24,21
CC Mariners,349,10,4,8,15,28,49,-21,20
Sydney FC,350,1,21,4,3,65,22,43,67
N'castle Jet,350,2,16,5,7,59,38,21,53
Melbourne C,350,3,14,4,11,44,35,9,46
Melbourne V,350,4,13,5,11,45,39,6,44
Adelaide Utd,350,5,11,6,11,37,40,-3,39
Brisbane,350,6,10,5,13,33,42,-9,35
Western Sydn,350,7,8,9,10,38,47,-9,33
Perth Glory,350,8,10,2,15,37,50,-13,32
Wellington P,350,9,5,6,16,31,55,-24,21
CC Mariners,350,10,4,8,15,28,49,-21,20
Sydney FC,351,1,21,4,3,67,23,44,67
N'castle Jet,351,2,16,5,7,58,37,21,53
Melbourne C,351,3,14,4,11,43,34,9,46
Melbourne V,351,4,13,5,11,46,41,5,44
Adelaide Utd,351,5,11,6,11,37,40,-3,39
Brisbane,351,6,10,5,13,33,42,-9,35
Western Sydn,351,7,8,9,10,38,47,-9,33
Perth Glory,351,8,10,2,15,37,50,-13,32
Wellington P,351,9,5,6,16,31,55,-24,21
CC Mariners,351,10,4,8,15,28,49,-21,20
Sydney FC,352,1,21,4,3,66,23,43,67
N'castle Jet,352,2,15,6,7,57,37,20,51
Melbourne C,352,3,14,5,10,43,33,10,47
Melbourne V,352,4,13,5,11,46,40,6,44
Adelaide Utd,352,5,11,6,11,37,40,-3,39
Brisbane,352,6,10,5,13,33,42,-9,35
Western Sydn,352,7,8,9,10,38,47,-9,33
Perth Glory,352,8,10,2,15,37,50,-13,32
Wellington P,352,9,5,6,16,31,55,-24,21
CC Mariners,352,10,4,8,15,28,49,-21,20
Sydney FC,353,1,21,4,3,66,23,43,67
N'castle Jet,353,2,15,6,7,58,38,20,51
Melbourne C,353,3,14,5,10,44,34,10,47
Melbourne V,353,4,13,5,11,46,40,6,44
Adelaide Utd,353,5,11,6,11,37,40,-3,39
Brisbane,353,6,10,5,13,33,42,-9,35
Western Sydn,353,7,8,9,10,38,47,-9,33
Perth Glory,353,8,10,2,15,37,50,-13,32
Wellington P,353,9,5,6,16,31,55,-24,21
CC Mariners,353,10,4,8,15,28,49,-21,20
Sydney FC,354,1,21,4,3,67,23,44,67
N'castle Jet,354,2,15,6,7,58,38,20,51
Melbourne C,354,3,14,5,10,44,34,10,47
Melbourne V,354,4,13,5,11,46,41,5,44
Adelaide Utd,354,5,11,6,11,37,40,-3,39
Brisbane,354,6,10,5,13,33,42,-9,35
Western Sydn,354,7,8,9,10,38,47,-9,33
Perth Glory,354,8,10,2,15,37,50,-13,32
Wellington P,354,9,5,6,16,31,55,-24,21
CC Mariners,354,10,4,8,15,28,49,-21,20
Sydney FC,355,1,21,4,3,66,22,44,67
N'castle Jet,355,2,15,5,8,57,38,19,50
Melbourne C,355,3,15,4,10,44,33,11,49
Melbourne V,355,4,13,5,11,45,40,5,44
Adelaide Utd,355,5,11,6,11,37,40,-3,39
Brisbane,355,6,10,5,13,33,42,-9,35
Western Sydn,355,7,8,9,10,38,47,-9,33
Perth Glory,355,8,10,2,15,37,50,-13,32
Wellington P,355,9,5,6,16,31,55,-24,21
CC Mariners,355,10,4,8,15,28,49,-21,20
Sydney FC,356,1,20,4,4,65,24,41,64
N'castle Jet,356,2,16,5,7,60,37,23,53
Melbourne V,356,3,14,5,10,47,39,8,47
Melbourne C,356,4,14,4,11,43,36,7,46
Adelaide Utd,356,5,11,6,11,37,40,-3,39
Brisbane,356,6,10,5,13,33,42,-9,35
Western Sydn,356,7,8,9,10,38,47,-9,33
Perth Glory,356,8,10,2,15,37,50,-13,32
Wellington P,356,9,5,6,16,31,55,-24,21
CC Mariners,356,10,4,8,15,28,49,-21,20
Sydney FC,357,1,20,5,3,65,23,42,65
N'castle Jet,357,2,15,6,7,58,38,20,51
Melbourne C,357,3,14,5,10,44,34,10,47
Melbourne V,357,4,13,6,10,46,39,7,45
Adelaide Utd,357,5,11,6,11,37,40,-3,39
Brisbane,357,6,10,5,13,33,42,-9,35
Western Sydn,357,7,8,9,10,38,47,-9,33
Perth Glory,357,8,10,2,15,37,50,-13,32
Wellington P,357,9,5,6,16,31,55,-24,21
CC Mariners,357,10,4,8,15,28,49,-21,20
Sydney FC,358,1,21,4,3,68,23,45,67
N'castle Jet,358,2,16,5,7,62,37,25,53
Melbourne C,358,3,14,4,11,43,38,5,46
Melbourne V,358,4,13,5,11,46,42,4,44
Adelaide Utd,358,5,11,6,11,37,40,-3,39
Brisbane,358,6,10,5,13,33,42,-9,35
Western Sydn,358,7,8,9,10,38,47,-9,33
Perth Glory,358,8,10,2,15,37,50,-13,32
Wellington P,358,9,5,6,16,31,55,-24,21
CC Mariners,358,10,4,8,15,28,49,-21,20
Sydney FC,359,1,21,4,3,68,24,44,67
N'castle Jet,359,2,16,5,7,60,39,21,53
Melbourne C,359,3,14,4,11,45,36,9,46
Melbourne V,359,4,13,5,11,47,42,5,44
Adelaide Utd,359,5,11,6,11,37,40,-3,39
Brisbane,359,6,10,5,13,33,42,-9,35
Western Sydn,359,7,8,9,10,38,47,-9,33
Perth Glory,359,8,10,2,15,37,50,-13,32
Wellington P,359,9,5,6,16,31,55,-24,21
CC Mariners,359,10,4,8,15,28,49,-21,20
Sydney FC,360,1,21,4,3,66,22,44,67
N'castle Jet,360,2,15,5,8,59,40,19,50
Melbourne C,360,3,15,4,10,46,35,11,49
Melbourne V,360,4,13,5,11,45,40,5,44
Adelaide Utd,360,5,11,6,11,37,40,-3,39
Brisbane,360,6,10,5,13,33,42,-9,35
Western Sydn,360,7,8,9,10,38,47,-9,33
Perth Glory,360,8,10,2,15,37,50,-13,32
Wellington P,360,9,5,6,16,31,55,-24,21
CC Mariners,360,10,4,8,15,28,49,-21,20
Sydney FC,361,1,20,5,3,65,23,42,65
N'castle Jet,361,2,16,5,7,59,37,22,53
Melbourne C,361,3,14,4,11,43,35,8,46
Melbourne V,361,4,13,6,10,46,39,7,45
Adelaide Utd,361,5,11,6,11,37,40,-3,39
Brisbane,361,6,10,5,13,33,42,-9,35
Western Sydn,361,7,8,9,10,38,47,-9,33
Perth Glory,361,8,10,2,15,37,50,-13,32
Wellington P,361,9,5,6,16,31,55,-24,21
CC Mariners,361,10,4,8,15,28,49,-21,20
Sydney FC,362,1,21,4,3,68,22,46,67
N'castle Jet,362,2,16,5,7,61,39,22,53
Melbourne C,362,3,14,4,11,45,37,8,46
Melbourne V,362,4,13,5,11,45,42,3,44
Adelaide Utd,362,5,11,6,11,37,40,-3,39
Brisbane,362,6,10,5,13,33,42,-9,35
Western Sydn,362,7,8,9,10,38,47,-9,33
Perth Glory,362,8,10,2,15,37,50,-13,32
Wellington P,362,9,5,6,16,31,55,-24,21
CC Mariners,362,10,4,8,15,28,49,-21,20
Sydney FC,363,1,20,4,4,65,25,40,64
N'castle Jet,363,2,15,5,8,58,39,19,50
Melbourne C,363,3,15,4,10,45,34,11,49
Melbourne V,363,4,14,5,10,48,39,9,47
Adelaide Utd,363,5,11,6,11,37,40,-3,39
Brisbane,363,6,10,5,13,33,42,-9,35
Western Sydn,363,7,8,9,10,38,47,-9,33
Perth Glory,363,8,10,2,15,37,50,-13,32
Wellington P,363,9,5,6,16,31,55,-24,21
CC Mariners,363,10,4,8,15,28,49,-21,20
Sydney FC,364,1,20,5,3,65,23,42,65
N'castle Jet,364,2,15,5,8,59,40,19,50
Melbourne C,364,3,15,4,10,46,35,11,49
Melbourne V,364,4,13,6,10,46,39,7,45
Adelaide Utd,364,5,11,6,11,37,40,-3,39
Brisbane,364,6,10,5,13,33,42,-9,35
Western Sydn,364,7,8,9,10,38,47,-9,33
Perth Glory,364,8,10,2,15,37,50,-13,32
Wellington P,364,9,5,6,16,31,55,-24,21
CC Mariners,364,10,4,8,15,28,49,-21,20
Sydney FC,365,1,21,4,3,67,24,43,67
N'castle Jet,365,2,16,5,7,59,38,21,53
Melbourne C,365,3,14,4,11,44,35,9,46
Melbourne V,365,4,13,5,11,47,41,6,44
Adelaide Utd,365,5,11,6,11,37,40,-3,39
Brisbane,365,6,10,5,13,33,42,-9,35
Western Sydn,365,7,8,9,10,38,47,-9,33
Perth Glory,365,8,10,2,15,37,50,-13,32
Wellington P,365,9,5,6,16,31,55,-24,21
CC Mariners,365,10,4,8,15,28,49,-21,20
Sydney FC,366,1,21,4,3,65,22,43,67
N'castle Jet,366,2,16,5,7,58,37,21,53
Melbourne C,366,3,14,4,11,43,34,9,46
Melbourne V,366,4,13,5,11,45,39,6,44
Adelaide Utd,366,5,11,6,11,37,40,-3,39
Brisbane,366,6,10,5,13,33,42,-9,35
Western Sydn,366,7,8,9,10,38,47,-9,33
Perth Glory,366,8,10,2,15,37,50,-13,32
Wellington P,366,9,5,6,16,31,55,-24,21
CC Mariners,366,10,4,8,15,28,49,-21,20
Sydney FC,367,1,21,4,3,67,24,43,67
N'castle Jet,367,2,15,5,8,58,40,18,50
Melbourne C,367,3,15,4,10,46,34,12,49
Melbourne V,367,4,13,5,11,47,41,6,44
Adelaide Utd,367,5,11,6,11,37,40,-3,39
Brisbane,367,6,10,5,13,33,42,-9,35
Western Sydn,367,7,8,9,10,38,47,-9,33
Perth Glory,367,8,10,2,15,37,50,-13,32
Wellington P,367,9,5,6,16,31,55,-24,21
CC Mariners,367,10,4,8,15,28,49,-21,20
Sydney FC,368,1,21,4,3,66,22,44,67
N'castle Jet,368,2,16,5,7,59,38,21,53
Melbourne C,368,3,14,4,11,44,35,9,46
Melbourne V,368,4,13,5,11,45,40,5,44
Adelaide Utd,368,5,11,6,11,37,40,-3,39
Brisbane,368,6,10,5,13,33,42,-9,35
Western Sydn,368,7,8,9,10,38,47,-9,33
Perth Glory,368,8,10,2,15,37,50,-13,32
Wellington P,368,9,5,6,16,31,55,-24,21
CC Mariners,368,10,4,8,15,28,49,-21,20
Sydney FC,369,1,21,4,3,65,22,43,67
N'castle Jet,369,2,15,5,8,57,38,19,50
Melbourne C,369,3,15,4,10,44,33,11,49
Melbourne V,369,4,13,5,11,45,39,6,44
Adelaide Utd,369,5,11,6,11,37,40,-3,39
Brisbane,369,6,10,5,13,33,42,-9,35
Western Sydn,369,7,8,9,10,38,47,-9,33
Perth Glory,369,8,10,2,15,37,50,-13,32
Wellington P,369,9,5,6,16,31,55,-24,21
CC Mariners,369,10,4,8,15,28,49,-21,20
Sydney FC,370,1,21,4,3,66,23,43,67
N'castle Jet,370,2,15,5,8,59,40,19,50
Melbourne C,370,3,15,4,10,46,35,11,49
Melbourne V,370,4,13,5,11,46,40,6,44
Adelaide Utd,370,5,11,6,11,37,40,-3,39
Brisbane,370,6,10,5,13,33,42,-9,35
Western Sydn,370,7,8,9,10,38,47,-9,33
Perth Glory,370,8,10,2,15,37,50,-13,32
Wellington P,370,9,5,6,16,31,55,-24,21
CC Mariners,370,10,4,8,15,28,49,-21,20
Sydney FC,371,1,20,5,3,65,23,42,65
N'castle Jet,371,2,15,6,7,58,38,20,51
Melbourne C,371,3,14,5,10,44,34,10,47
Melbourne V,371,4,13,6,10,46,39,7,45
Adelaide Utd,371,5,11,6,11,37,40,-3,39
Brisbane,371,6,10,5,13,33,42,-9,35
Western Sydn,371,7,8,9,10,38,47,-9,33
Perth Glory,371,8,10,2,15,37,50,-13,32
Wellington P,371,9,5,6,16,31,55,-24,21
CC Mariners,371,10,4,8,15,28,49,-21,20
Sydney FC,372,1,21,4,3,66,23,43,67
N'castle Jet,372,2,15,5,8,57,39,18,50
Melbourne C,372,3,15,4,10,45,33,12,49
Melbourne V,372,4,13,5,11,46,40,6,44
Adelaide Utd,372,5,11,6,11,37,40,-3,39
Brisbane,372,6,10,5,13,33,42,-9,35
Western Sydn,372,7,8,9,10,38,47,-9,33
Perth Glory,372,8,10,2,15,37,50,-13,32
Wellington P,372,9,5,6,16,31,55,-24,21
CC Mariners,372,10,4,8,15,28,49,-21,20
Sydney FC,373,1,21,4,3,66,23,43,67
N'castle Jet,373,2,15,5,8,59,40,19,50
Melbourne C,373,3,15,4,10,46,35,11,49
Melbourne V,373,4,13,5,11,46,40,6,44
Adelaide Utd,373,5,11,6,11,37,40,-3,39
Brisbane,373,6,10,5,13,33,42,-9,35
Western Sydn,373,7,8,9,10,38,47,-9,33
Perth Glory,373,8,10,2,15,37,50,-13,32
Wellington P,373,9,5,6,16,31,55,-24,21
CC Mariners,373,10,4,8,15,28,49,-21,20
Sydney FC,374,1,21,4,3,68,22,46,67
N'castle Jet,374,2,15,5,8,57,38,19,50
Melbourne C,374,3,15,4,10,44,33,11,49
Melbourne V,374,4,13,5,11,45,42,3,44
Adelaide Utd,374,5,11,6,11,37,40,-3,39
Brisbane,374,6,10,5,13,33,42,-9,35
Western Sydn,374,7,8,9,10,38,47,-9,33
Perth Glory,374,8,10,2,15,37,50,-13,32
Wellington P,374,9,5,6,16,31,55,-24,21
CC Mariners,374,10,4,8,15,28,49,-21,20
Sydney FC,375,1,20,5,3,66,24,42,65
N'castle Jet,375,2,16,5,7,59,37,22,53
Melbourne C,375,3,14,4,11,43,35,8,46
Melbourne V,375,4,13,6,10,47,40,7,45
Adelaide Utd,375,5,11,6,11,37,40,-3,39
Brisbane,375,6,10,5,13,33,42,-9,35
Western Sydn,375,7,8,9,10,38,47,-9,33
Perth Glory,375,8,10,2,15,37,50,-13,32
Wellington P,375,9,5,6,16,31,55,-24,21
CC Mariners,375,10,4,8,15,28,49,-21,20
Sydney FC,376,1,21,4,3,67,22,45,67
N'castle Jet,376,2,15,6,7,58,38,20,51
Melbourne C,376,3,14,5,10,44,34,10,47
Melbourne V,376,4,13,5,11,45,41,4,44
Adelaide Utd,376,5,11,6,11,37,40,-3,39
Brisbane,376,6,10,5,13,33,42,-9,35
Western Sydn,376,7,8,9,10,38,47,-9,33
Perth Glory,376,8,10,2,15,37,50,-13,32
Wellington P,376,9,5,6,16,31,55,-24,21
CC Mariners,376,10,4,8,15,28,49,-21,20
Sydney FC,377,1,20,4,4,65,24,41,64
N'castle Jet,377,2,15,6,7,59,39,20,51
Melbourne C,377,3,14,5,10,45,35,10,47
Melbourne V,377,4,14,5,10,47,39,8,47
Adelaide Utd,377,5,11,6,11,37,40,-3,39
Brisbane,377,6,10,5,13,33,42,-9,35
Western Sydn,377,7,8,9,10,38,47,-9,33
Perth Glory,377,8,10,2,15,37,50,-13,32
Wellington P,377,9,5,6,16,31,55,-24,21
CC Mariners,377,10,4,8,15,28,49,-21,20
Sydney FC,378,1,21,4,3,66,22,44,67
N'castle Jet,378,2,15,6,7,59,39,20,51
Melbourne C,378,3,14,5,10,45,35,10,47
Melbourne V,378,4,13,5,11,45,40,5,44
Adelaide Utd,378,5,11,6,11,37,40,-3,39
Brisbane,378,6,10,5,13,33,42,-9,35
Western Sydn,378,7,8,9,10,38,47,-9,33
Perth Glory,378,8,10,2,15,37,50,-13,32
Wellington P,378,9,5,6,16,31,55,-24,21
CC Mariners,378,10,4,8,15,28,49,-21,20
Sydney FC,379,1,21,4,3,67,24,43,67
N'castle Jet,379,2,16,5,7,58,37,21,53
Melbourne C,379,3,14,4,11,43,34,9,46
Melbourne V,379,4,13,5,11,47,41,6,44
Adelaide Utd,379,5,11,6,11,37,40,-3,39
Brisbane,379,6,10,5,13,33,42,-9,35
Western Sydn,379,7,8,9,10,38,47,-9,33
Perth Glory,379,8,10,2,15,37,50,-13,32
Wellington P,379,9,5,6,16,31,55,-24,21
CC Mariners,379,10,4,8,15,28,49,-21,20
Sydney FC,380,1,20,4,4,64,23,41,64
N'castle Jet,380,2,16,5,7,59,38,21,53
Melbourne V,380,3,14,5,10,46,38,8,47
Melbourne C,380,4,14,4,11,44,35,9,46
Adelaide Utd,380,5,11,6,11,37,40,-3,39
Brisbane,380,6,10,5,13,33,42,-9,35
Western Sydn,380,7,8,9,10,38,47,-9,33
Perth Glory,380,8,10,2,15,37,50,-13,32
Wellington P,380,9,5,6,16,31,55,-24,21
CC Mariners,380,10,4,8,15,28,49,-21,20
Sydney FC,381,1,20,5,3,65,23,42,65
N'castle Jet,381,2,16,5,7,59,37,22,53
Melbourne C,381,3,14,4,11,43,35,8,46
Melbourne V,381,4,13,6,10,46,39,7,45
Adelaide Utd,381,5,11,6,11,37,40,-3,39
Brisbane,381,6,10,5,13,33,42,-9,35
Western Sydn,381,7,8,9,10,38,47,-9,33
Perth Glory,381,8,10,2,15,37,50,-13,32
Wellington P,381,9,5,6,16,31,55,-24,21
CC Mariners,381,10,4,8,15,28,49,-21,20
Sydney FC,382,1,20,5,3,64,22,42,65
N'castle Jet,382,2,16,5,7,62,38,24,53
Melbourne C,382,3,14,4,11,44,38,6,46
Melbourne V,382,4,13,6,10,45,38,7,45
Adelaide Utd,382,5,11,6,11,37,40,-3,39
Brisbane,382,6,10,5,13,33,42,-9,35
Western Sydn,382,7,8,9,10,38,47,-9,33
Perth Glory,382,8,10,2,15,37,50,-13,32
Wellington P,382,9,5,6,16,31,55,-24,21
CC Mariners,382,10,4,8,15,28,49,-21,20
Sydney FC,383,1,21,4,3,66,22,44,67
N'castle Jet,383,2,15,5,8,58,39,19,50
Melbourne C,383,3,15,4,10,45,34,11,49
Melbourne V,383,4,13,5,11,45,40,5,44
Adelaide Utd,383,5,11,6,11,37,40,-3,39
Brisbane,383,6,10,5,13,33,42,-9,35
Western Sydn,383,7,8,9,10,38,47,-9,33
Perth Glory,383,8,10,2,15,37,50,-13,32
Wellington P,383,9,5,6,16,31,55,-24,21
CC Mariners,383,10,4,8,15,28,49,-21,20
Sydney FC,384,1,21,4,3,68,25,43,67
N'castle Jet,384,2,15,6,7,58,38,20,51
Melbourne C,384,3,14,5,10,44,34,10,47
Melbourne V,384,4,13,5,11,48,42,6,44
Adelaide Utd,384,5,11,6,11,37,40,-3,39
Brisbane,384,6,10,5,13,33,42,-9,35
Western Sydn,384,7,8,9,10,38,47,-9,33
Perth Glory,384,8,10,2,15,37,50,-13,32
Wellington P,384,9,5,6,16,31,55,-24,21
CC Mariners,384,10,4,8,15,28,49,-21,20
Sydney FC,385,1,21,4,3,68,23,45,67
N'castle Jet,385,2,15,6,7,59,39,20,51
Melbourne C,385,3,14,5,10,45,35,10,47
Melbourne V,385,4,13,5,11,46,42,4,44
Adelaide Utd,385,5,11,6,11,37,40,-3,39
Brisbane,385,6,10,5,13,33,42,-9,35
Western Sydn,385,7,8,9,10,38,47,-9,33
Perth Glory,385,8,10,2,15,37,50,-13,32
Wellington P,385,9,5,6,16,31,55,-24,21
CC Mariners,385,10,4,8,15,28,49,-21,20
Sydney FC,386,1,21,4,3,67,23,44,67
N'castle Jet,386,2,16,5,7,59,37,22,53
Melbourne C,386,3,14,4,11,43,35,8,46
Melbourne V,386,4,13,5,11,46,41,5,44
Adelaide Utd,386,5,11,6,11,37,40,-3,39
Brisbane,386,6,10,5,13,33,42,-9,35
Western Sydn,386,7,8,9,10,38,47,-9,33
Perth Glory,386,8,10,2,15,37,50,-13,32
Wellington P,386,9,5,6,16,31,55,-24,21
CC Mariners,386,10,4,8,15,28,49,-21,20
Sydney FC,387,1,21,4,3,70,22,48,67
N'castle Jet,387,2,16,5,7,61,39,22,53
Melbourne C,387,3,14,4,11,45,37,8,46
Melbourne V,387,4,13,5,11,45,44,1,44
Adelaide Utd,387,5,11,6,11,37,40,-3,39
Brisbane,387,6,10,5,13,33,42,-9,35
Western Sydn,387,7,8,9,10,38,47,-9,33
Perth Glory,387,8,10,2,15,37,50,-13,32
Wellington P,387,9,5,6,16,31,55,-24,21
CC Mariners,387,10,4,8,15,28,49,-21,20
Sydney FC,388,1,20,5,3,66,24,42,65
N'castle Jet,388,2,15,5,8,59,40,19,50
Melbourne C,388,3,15,4,10,46,35,11,49
Melbourne V,388,4,13,6,10,47,40,7,45
Adelaide Utd,388,5,11,6,11,37,40,-3,39
Brisbane,388,6,10,5,13,33,42,-9,35
Western Sydn,388,7,8,9,10,38,47,-9,33
Perth Glory,388,8,10,2,15,37,50,-13,32
Wellington P,388,9,5,6,16,31,55,-24,21
CC Mariners,388,10,4,8,15,28,49,-21,20
Sydney FC,389,1,20,5,3,66,24,42,65
N'castle Jet,389,2,16,5,7,59,38,21,53
Melbourne C,389,3,14,4,11,44,35,9,46
Melbourne V,389,4,13,6,10,47,40,7,45
Adelaide Utd,389,5,11,6,11,37,40,-3,39
Brisbane,389,6,10,5,13,33,42,-9,35
Western Sydn,389,7,8,9,10,38,47,-9,33
Perth Glory,389,8,10,2,15,37,50,-13,32
Wellington P,389,9,5,6,16,31,55,-24,21
CC Mariners,389,10,4,8,15,28,49,-21,20
Sydney FC,390,1,21,4,3,68,22,46,67
N'castle Jet,390,2,15,5,8,57,38,19,50
Melbourne C,390,3,15,4,10,44,33,11,49
Melbourne V,390,4,13,5,11,45,42,3,44
Adelaide Utd,390,5,11,6,11,37,40,-3,39
Brisbane,390,6,10,5,13,33,42,-9,35
Western Sydn,390,7,8,9,10,38,47,-9,33
Perth Glory,390,8,10,2,15,37,50,-13,32
Wellington P,390,9,5,6,16,31,55,-24,21
CC Mariners,390,10,4,8,15,28,49,-21,20
Sydney FC,391,1,21,4,3,66,22,44,67
N'castle Jet,391,2,15,5,8,58,40,18,50
Melbourne C,391,3,15,4,10,46,34,12,49
Melbourne V,391,4,13,5,11,45,40,5,44
Adelaide Utd,391,5,11,6,11,37,40,-3,39
Brisbane,391,6,10,5,13,33,42,-9,35
Western Sydn,391,7,8,9,10,38,47,-9,33
Perth Glory,391,8,10,2,15,37,50,-13,32
Wellington P,391,9,5,6,16,31,55,-24,21
CC Mariners,391,10,4,8,15,28,49,-21,20
Sydney FC,392,1,20,4,4,65,26,39,64
N'castle Jet,392,2,15,5,8,58,39,19,50
Melbourne C,392,3,15,4,10,45,34,11,49
Melbourne V,392,4,14,5,10,49,39,10,47
Adelaide Utd,392,5,11,6,11,37,40,-3,39
Brisbane,392,6,10,5,13,33,42,-9,35
Western Sydn,392,7,8,9,10,38,47,-9,33
Perth Glory,392,8,10,2,15,37,50,-13,32
Wellington P,392,9,5,6,16,31,55,-24,21
CC Mariners,392,10,4,8,15,28,49,-21,20
Sydney FC,393,1,21,4,3,68,22,46,67
N'castle Jet,393,2,16,5,7,60,38,22,53
Melbourne C,393,3,14,4,11,44,36,8,46
Melbourne V,393,4,13,5,11,45,42,3,44
Adelaide Utd,393,5,11,6,11,37,40,-3,39
Brisbane,393,6,10,5,13,33,42,-9,35
Western Sydn,393,7,8,9,10,38,47,-9,33
Perth Glory,393,8,10,2,15,37,50,-13,32
Wellington P,393,9,5,6,16,31,55,-24,21
CC Mariners,393,10,4,8,15,28,49,-21,20
Sydney FC,394,1,21,4,3,67,22,45,67
N'castle Jet,394,2,16,5,7,58,37,21,53
Melbourne C,394,3,14,4,11,43,34,9,46
Melbourne V,394,4,13,5,11,45,41,4,44
Adelaide Utd,394,5,11,6,11,37,40,-3,39
Brisbane,394,6,10,5,13,33,42,-9,35
Western Sydn,394,7,8,9,10,38,47,-9,33
Perth Glory,394,8,10,2,15,37,50,-13,32
Wellington P,394,9,5,6,16,31,55,-24,21
CC Mariners,394,10,4,8,15,28,49,-21,20
Sydney FC,395,1,20,5,3,66,24,42,65
N'castle Jet,395,2,16,5,7,60,39,21,53
Melbourne C,395,3,14,4,11,45,36,9,46
Melbourne V,395,4,13,6,10,47,40,7,45
Adelaide Utd,395,5,11,6,11,37,40,-3,39
Brisbane,395,6,10,5,13,33,42,-9,35
Western Sydn,395,7,8,9,10,38,47,-9,33
Perth Glory,395,8,10,2,15,37,50,-13,32
Wellington P,395,9,5,6,16,31,55,-24,21
CC Mariners,395,10,4,8,15,28,49,-21,20
Sydney FC,396,1,21,4,3,67,24,43,67
N'castle Jet,396,2,16,5,7,58,37,21,53
Melbourne C,396,3,14,4,11,43,34,9,46
Melbourne V,396,4,13,5,11,47,41,6,44
Adelaide Utd,396,5,11,6,11,37,40,-3,39
Brisbane,396,6,10,5,13,33,42,-9,35
Western Sydn,396,7,8,9,10,38,47,-9,33
Perth Glory,396,8,10,2,15,37,50,-13,32
Wellington P,396,9,5,6,16,31,55,-24,21
CC Mariners,396,10,4,8,15,28,49,-21,20
Sydney FC,397,1,21,4,3,67,22,45,67
N'castle Jet,397,2,16,5,7,59,38,21,53
Melbourne C,397,3,14,4,11,44,35,9,46
Melbourne V,397,4,13,5,11,45,41,4,44
Adelaide Utd,397,5,11,6,11,37,40,-3,39
Brisbane,397,6,10,5,13,33,42,-9,35
Western Sydn,397,7,8,9,10,38,47,-9,33
Perth Glory,397,8,10,2,15,37,50,-13,32
Wellington P,397,9,5,6,16,31,55,-24,21
CC Mariners,397,10,4,8,15,28,49,-21,20
Sydney FC,398,1,20,4,4,65,24,41,64
N'castle Jet,398,2,16,5,7,60,37,23,53
Melbourne V,398,3,14,5,10,47,39,8,47
Melbourne C,398,4,14,4,11,43,36,7,46
Adelaide Utd,398,5,11,6,11,37,40,-3,39
Brisbane,398,6,10,5,13,33,42,-9,35
Western Sydn,398,7,8,9,10,38,47,-9,33
Perth Glory,398,8,10,2,15,37,50,-13,32
Wellington P,398,9,5,6,16,31,55,-24,21
CC Mariners,398,10,4,8,15,28,49,-21,20
Sydney FC,399,1,21,4,3,67,24,43,67
N'castle Jet,399,2,16,5,7,61,37,24,53
Melbourne C,399,3,14,4,11,43,37,6,46
Melbourne V,399,4,13,5,11,47,41,6,44
Adelaide Utd,399,5,11,6,11,37,40,-3,39
Brisbane,399,6,10,5,13,33,42,-9,35
Western Sydn,399,7,8,9,10,38,47,-9,33
Perth Glory,399,8,10,2,15,37,50,-13,32
Wellington P,399,9,5,6,16,31,55,-24,21
CC Mariners,399,10,4,8,15,28,49,-21,20
Sydney FC,400,1,20,5,3,66,24,42,65
N'castle Jet,400,2,16,5,7,58,37,21,53
Melbourne C,400,3,14,4,11,43,34,9,46
Melbourne V,400,4,13,6,10,47,40,7,45
Adelaide Utd,400,5,11,6,11,37,40,-3,39
Brisbane,400,6,10,5,13,33,42,-9,35
Western Sydn,400,7,8,9,10,38,47,-9,33
Perth Glory,400,8,10,2,15,37,50,-13,32
Wellington P,400,9,5,6,16,31,55,-24,21
CC Mariners,400,10,4,8,15,28,49,-21,20
Sydney FC,401,1,21,4,3,66,22,44,67
N'castle Jet,401,2,15,6,7,59,39,20,51
Melbourne C,401,3,14,5,10,45,35,10,47
Melbourne V,401,4,13,5,11,45,40,5,44
Adelaide Utd,401,5,11,6,11,37,40,-3,39
Brisbane,401,6,10,5,13,33,42,-9,35
Western Sydn,401,7,8,9,10,38,47,-9,33
Perth Glory,401,8,10,2,15,37,50,-13,32
Wellington P,401,9,5,6,16,31,55,-24,21
CC Mariners,401,10,4,8,15,28,49,-21,20
Sydney FC,402,1,20,5,3,66,24,42,65
N'castle Jet,402,2,16,5,7,61,38,23,53
Melbourne C,402,3,14,4,11,44,37,7,46
Melbourne V,402,4,13,6,10,47,40,7,45
Adelaide Utd,402,5,11,6,11,37,40,-3,39
Brisbane,402,6,10,5,13,33,42,-9,35
Western Sydn,402,7,8,9,10,38,47,-9,33
Perth Glory,402,8,10,2,15,37,50,-13,32
Wellington P,402,9,5,6,16,31,55,-24,21
CC Mariners,402,10,4,8,15,28,49,-21,20
Sydney FC,403,1,21,4,3,67,24,43,67
N'castle Jet,403,2,16,5,7,59,38,21,53
Melbourne C,403,3,14,4,11,44,35,9,46
Melbourne V,403,4,13,5,11,47,41,6,44
Adelaide Utd,403,5,11,6,11,37,40,-3,39
Brisbane,403,6,10,5,13,33,42,-9,35
Western Sydn,403,7,8,9,10,38,47,-9,33
Perth Glory,403,8,10,2,15,37,50,-13,32
Wellington P,403,9,5,6,16,31,55,-24,21
CC Mariners,403,10,4,8,15,28,49,-21,20
Sydney FC,404,1,21,4,3,67,23,44,67
N'castle Jet,404,2,15,5,8,58,40,18,50
Melbourne C,404,3,15,4,10,46,34,12,49
Melbourne V,404,4,13,5,11,46,41,5,44
Adelaide Utd,404,5,11,6,11,37,40,-3,39
Brisbane,404,6,10,5,13,33,42,-9,35
Western Sydn,404,7,8,9,10,38,47,-9,33
Perth Glory,404,8,10,2,15,37,50,-13,32
Wellington P,404,9,5,6,16,31,55,-24,21
CC Mariners,404,10,4,8,15,28,49,-21,20
Sydney FC,405,1,20,5,3,64,22,42,65
N'castle Jet,405,2,16,5,7,58,37,21,53
Melbourne C,405,3,14,4,11,43,34,9,46
Melbourne V,405,4,13,6,10,45,38,7,45
Adelaide Utd,405,5,11,6,11,37,40,-3,39
Brisbane,405,6,10,5,13,33,42,-9,35
Western Sydn,405,7,8,9,10,38,47,-9,33
Perth Glory,405,8,10,2,15,37,50,-13,32
Wellington P,405,9,5,6,16,31,55,-24,21
CC Mariners,405,10,4,8,15,28,49,-21,20
Sydney FC,406,1,20,4,4,65,24,41,64
N'castle Jet,406,2,16,5,7,60,38,22,53
Melbourne V,406,3,14,5,10,47,39,8,47
Melbourne C,406,4,14,4,11,44,36,8,46
Adelaide Utd,406,5,11,6,11,37,40,-3,39
Brisbane,406,6,10,5,13,33,42,-9,35
Western Sydn,406,7,8,9,10,38,47,-9,33
Perth Glory,406,8,10,2,15,37,50,-13,32
Wellington P,406,9,5,6,16,31,55,-24,21
CC Mariners,406,10,4,8,15,28,49,-21,20
Sydney FC,407,1,20,4,4,65,24,41,64
N'castle Jet,407,2,16,5,7,59,37,22,53
Melbourne V,407,3,14,5,10,47,39,8,47
Melbourne C,407,4,14,4,11,43,35,8,46
Adelaide Utd,407,5,11,6,11,37,40,-3,39
Brisbane,407,6,10,5,13,33,42,-9,35
Western Sydn,407,7,8,9,10,38,47,-9,33
Perth Glory,407,8,10,2,15,37,50,-13,32
Wellington P,407,9,5,6,16,31,55,-24,21
CC Mariners,407,10,4,8,15,28,49,-21,20
Sydney FC,408,1,20,4,4,66,25,41,64
N'castle Jet,408,2,16,5,7,60,38,22,53
Melbourne V,408,3,14,5,10,48,40,8,47
Melbourne C,408,4,14,4,11,44,36,8,46
Adelaide Utd,408,5,11,6,11,37,40,-3,39
Brisbane,408,6,10,5,13,33,42,-9,35
Western Sydn,408,7,8,9,10,38,47,-9,33
Perth Glory,408,8,10,2,15,37,50,-13,32
Wellington P,408,9,5,6,16,31,55,-24,21
CC Mariners,408,10,4,8,15,28,49,-21,20
Sydney FC,409,1,21,4,3,65,22,43,67
N'castle Jet,409,2,15,6,7,58,38,20,51
Melbourne C,409,3,14,5,10,44,34,10,47
Melbourne V,409,4,13,5,11,45,39,6,44
Adelaide Utd,409,5,11,6,11,37,40,-3,39
Brisbane,409,6,10,5,13,33,42,-9,35
Western Sydn,409,7,8,9,10,38,47,-9,33
Perth Glory,409,8,10,2,15,37,50,-13,32
Wellington P,409,9,5,6,16,31,55,-24,21
CC Mariners,409,10,4,8,15,28,49,-21,20
Sydney FC,410,1,21,4,3,67,22,45,67
N'castle Jet,410,2,15,5,8,57,38,19,50
Melbourne C,410,3,15,4,10,44,33,11,49
Melbourne V,410,4,13,5,11,45,41,4,44
Adelaide Utd,410,5,11,6,11,37,40,-3,39
Brisbane,410,6,10,5,13,33,42,-9,35
Western Sydn,410,7,8,9,10,38,47,-9,33
Perth Glory,410,8,10,2,15,37,50,-13,32
Wellington P,410,9,5,6,16,31,55,-24,21
CC Mariners,410,10,4,8,15,28,49,-21,20
Sydney FC,411,1,20,5,3,65,23,42,65
N'castle Jet,411,2,16,5,7,59,37,22,53
Melbourne C,411,3,14,4,11,43,35,8,46
Melbourne V,411,4,13,6,10,46,39,7,45
Adelaide Utd,411,5,11,6,11,37,40,-3,39
Brisbane,411,6,10,5,13,33,42,-9,35
Western Sydn,411,7,8,9,10,38,47,-9,33
Perth Glory,411,8,10,2,15,37,50,-13,32
Wellington P,411,9,5,6,16,31,55,-24,21
CC Mariners,411,10,4,8,15,28,49,-21,20
Sydney FC,412,1,20,5,3,67,25,42,65
N'castle Jet,412,2,16,5,7,59,37,22,53
Melbourne C,412,3,14,4,11,43,35,8,46
Melbourne V,412,4,13,6,10,48,41,7,45
Adelaide Utd,412,5,11,6,11,37,40,-3,39
Brisbane,412,6,10,5,13,33,42,-9,35
Western Sydn,412,7,8,9,10,38,47,-9,33
Perth Glory,412,8,10,2,15,37,50,-13,32
Wellington P,412,9,5,6,16,31,55,-24,21
CC Mariners,412,10,4,8,15,28,49,-21,20
Sydney FC,413,1,20,4,4,65,26,39,64
N'castle Jet,413,2,16,5,7,58,37,21,53
Melbourne V,413,3,14,5,10,49,39,10,47
Melbourne C,413,4,14,4,11,43,34,9,46
Adelaide Utd,413,5,11,6,11,37,40,-3,39
Brisbane,413,6,10,5,13,33,42,-9,35
Western Sydn,413,7,8,9,10,38,47,-9,33
Perth Glory,413,8,10,2,15,37,50,-13,32
Wellington P,413,9,5,6,16,31,55,-24,21
CC Mariners,413,10,4,8,15,28,49,-21,20
Sydney FC,414,1,21,4,3,65,22,43,67
N'castle Jet,414,2,15,6,7,58,38,20,51
Melbourne C,414,3,14,5,10,44,34,10,47
Melbourne V,414,4,13,5,11,45,39,6,44
Adelaide Utd,414,5,11,6,11,37,40,-3,39
Brisbane,414,6,10,5,13,33,42,-9,35
Western Sydn,414,7,8,9,10,38,47,-9,33
Perth Glory,414,8,10,2,15,37,50,-13,32
Wellington P,414,9,5,6,16,31,55,-24,21
CC Mariners,414,10,4,8,15,28,49,-21,20
Sydney FC,415,1,21,4,3,66,22,44,67
N'castle Jet,415,2,16,5,7,58,37,21,53
Melbourne C,415,3,14,4,11,43,34,9,46
Melbourne V,415,4,13,5,11,45,40,5,44
Adelaide Utd,415,5,11,6,11,37,40,-3,39
Brisbane,415,6,10,5,13,33,42,-9,35
Western Sydn,415,7,8,9,10,38,47,-9,33
Perth Glory,415,8,10,2,15,37,50,-13,32
Wellington P,415,9,5,6,16,31,55,-24,21
CC Mariners,415,10,4,8,15,28,49,-21,20
Sydney FC,416,1,21,4,3,65,22,43,67
N'castle Jet,416,2,16,5,7,61,38,23,53
Melbourne C,416,3,14,4,11,44,37,7,46
Melbourne V,416,4,13,5,11,45,39,6,44
Adelaide Utd,416,5,11,6,11,37,40,-3,39
Brisbane,416,6,10,5,13,33,42,-9,35
Western Sydn,416,7,8,9,10,38,47,-9,33
Perth Glory,416,8,10,2,15,37,50,-13,32
Wellington P,416,9,5,6,16,31,55,-24,21
CC Mariners,416,10,4,8,15,28,49,-21,20
Sydney FC,417,1,20,4,4,65,24,41,64
N'castle Jet,417,2,15,5,8,57,39,18,50
Melbourne C,417,3,15,4,10,45,33,12,49
Melbourne V,417,4,14,5,10,47,39,8,47
Adelaide Utd,417,5,11,6,11,37,40,-3,39
Brisbane,417,6,10,5,13,33,42,-9,35
Western Sydn,417,7,8,9,10,38,47,-9,33
Perth Glory,417,8,10,2,15,37,50,-13,32
Wellington P,417,9,5,6,16,31,55,-24,21
CC Mariners,417,10,4,8,15,28,49,-21,20
Sydney FC,418,1,20,5,3,65,23,42,65
N'castle Jet,418,2,16,5,7,60,38,22,53
Melbourne C,418,3,14,4,11,44,36,8,46
Melbourne V,418,4,13,6,10,46,39,7,45
Adelaide Utd,418,5,11,6,11,37,40,-3,39
Brisbane,418,6,10,5,13,33,42,-9,35
Western Sydn,418,7,8,9,10,38,47,-9,33
Perth Glory,418,8,10,2,15,37,50,-13,32
Wellington P,418,9,5,6,16,31,55,-24,21
CC Mariners,418,10,4,8,15,28,49,-21,20
Sydney FC,419,1,20,5,3,65,23,42,65
N'castle Jet,419,2,15,6,7,58,38,20,51
Melbourne C,419,3,14,5,10,44,34,10,47
Melbourne V,419,4,13,6,10,46,39,7,45
Adelaide Utd,419,5,11,6,11,37,40,-3,39
Brisbane,419,6,10,5,13,33,42,-9,35
Western Sydn,419,7,8,9,10,38,47,-9,33
Perth Glory,419,8,10,2,15,37,50,-13,32
Wellington P,419,9,5,6,16,31,55,-24,21
CC Mariners,419,10,4,8,15,28,49,-21,20
Sydney FC,420,1,21,4,3,69,23,46,67
N'castle Jet,420,2,15,6,7,58,38,20,51
Melbourne C,420,3,14,5,10,44,34,10,47
Melbourne V,420,4,13,5,11,46,43,3,44
Adelaide Utd,420,5,11,6,11,37,40,-3,39
Brisbane,420,6,10,5,13,33,42,-9,35
Western Sydn,420,7,8,9,10,38,47,-9,33
Perth Glory,420,8,10,2,15,37,50,-13,32
Wellington P,420,9,5,6,16,31,55,-24,21
CC Mariners,420,10,4,8,15,28,49,-21,20
Sydney FC,421,1,21,4,3,66,23,43,67
N'castle Jet,421,2,15,6,7,58,38,20,51
Melbourne C,421,3,14,5,10,44,34,10,47
Melbourne V,421,4,13,5,11,46,40,6,44
Adelaide Utd,421,5,11,6,11,37,40,-3,39
Brisbane,421,6,10,5,13,33,42,-9,35
Western Sydn,421,7,8,9,10,38,47,-9,33
Perth Glory,421,8,10,2,15,37,50,-13,32
Wellington P,421,9,5,6,16,31,55,-24,21
CC Mariners,421,10,4,8,15,28,49,-21,20
Sydney FC,422,1,21,4,3,68,22,46,67
N'castle Jet,422,2,15,6,7,60,40,20,51
Melbourne C,422,3,14,5,10,46,36,10,47
Melbourne V,422,4,13,5,11,45,42,3,44
Adelaide Utd,422,5,11,6,11,37,40,-3,39
Brisbane,422,6,10,5,13,33,42,-9,35
Western Sydn,422,7,8,9,10,38,47,-9,33
Perth Glory,422,8,10,2,15,37,50,-13,32
Wellington P,422,9,5,6,16,31,55,-24,21
CC Mariners,422,10,4,8,15,28,49,-21,20
Sydney FC,423,1,20,4,4,64,23,41,64
N'castle Jet,423,2,16,5,7,58,37,21,53
Melbourne V,423,3,14,5,10,46,38,8,47
Melbourne C,423,4,14,4,11,43,34,9,46
Adelaide Utd,423,5,11,6,11,37,40,-3,39
Brisbane,423,6,10,5,13,33,42,-9,35
Western Sydn,423,7,8,9,10,38,47,-9,33
Perth Glory,423,8,10,2,15,37,50,-13,32
Wellington P,423,9,5,6,16,31,55,-24,21
CC Mariners,423,10,4,8,15,28,49,-21,20
Sydney FC,424,1,21,4,3,66,23,43,67
N'castle Jet,424,2,15,5,8,59,40,19,50
Melbourne C,424,3,15,4,10,46,35,11,49
Melbourne V,424,4,13,5,11,46,40,6,44
Adelaide Utd,424,5,11,6,11,37,40,-3,39
Brisbane,424,6,10,5,13,33,42,-9,35
Western Sydn,424,7,8,9,10,38,47,-9,33
Perth Glory,424,8,10,2,15,37,50,-13,32
Wellington P,424,9,5,6,16,31,55,-24,21
CC Mariners,424,10,4,8,15,28,49,-21,20
Sydney FC,425,1,21,4,3,66,22,44,67
N'castle Jet,425,2,16,5,7,61,37,24,53
Melbourne C,425,3,14,4,11,43,37,6,46
Melbourne V,425,4,13,5,11,45,40,5,44
Adelaide Utd,425,5,11,6,11,37,40,-3,39
Brisbane,425,6,10,5,13,33,42,-9,35
Western Sydn,425,7,8,9,10,38,47,-9,33
Perth Glory,425,8,10,2,15,37,50,-13,32
Wellington P,425,9,5,6,16,31,55,-24,21
CC Mariners,425,10,4,8,15,28,49,-21,20
Sydney FC,426,1,20,4,4,65,24,41,64
N'castle Jet,426,2,16,5,7,61,39,22,53
Melbourne V,426,3,14,5,10,47,39,8,47
Melbourne C,426,4,14,4,11,45,37,8,46
Adelaide Utd,426,5,11,6,11,37,40,-3,39
Brisbane,426,6,10,5,13,33,42,-9,35
Western Sydn,426,7,8,9,10,38,47,-9,33
Perth Glory,426,8,10,2,15,37,50,-13,32
Wellington P,426,9,5,6,16,31,55,-24,21
CC Mariners,426,10,4,8,15,28,49,-21,20
Sydney FC,427,1,21,4,3,66,23,43,67
N'castle Jet,427,2,16,5,7,59,38,21,53
Melbourne C,427,3,14,4,11,44,35,9,46
Melbourne V,427,4,13,5,11,46,40,6,44
Adelaide Utd,427,5,11,6,11,37,40,-3,39
Brisbane,427,6,10,5,13,33,42,-9,35
Western Sydn,427,7,8,9,10,38,47,-9,33
Perth Glory,427,8,10,2,15,37,50,-13,32
Wellington P,427,9,5,6,16,31,55,-24,21
CC Mariners,427,10,4,8,15,28,49,-21,20
Sydney FC,428,1,21,4,3,66,22,44,67
N'castle Jet,428,2,15,5,8,57,38,19,50
Melbourne C,428,3,15,4,10,44,33,11,49
Melbourne V,428,4,13,5,11,45,40,5,44
Adelaide Utd,428,5,11,6,11,37,40,-3,39
Brisbane,428,6,10,5,13,33,42,-9,35
Western Sydn,428,7,8,9,10,38,47,-9,33
Perth Glory,428,8,10,2,15,37,50,-13,32
Wellington P,428,9,5,6,16,31,55,-24,21
CC Mariners,428,10,4,8,15,28,49,-21,20
Sydney FC,429,1,21,4,3,69,22,47,67
N'castle Jet,429,2,16,5,7,60,37,23,53
Melbourne C,429,3,14,4,11,43,36,7,46
Melbourne V,429,4,13,5,11,45,43,2,44
Adelaide Utd,429,5,11,6,11,37,40,-3,39
Brisbane,429,6,10,5,13,33,42,-9,35
Western Sydn,429,7,8,9,10,38,47,-9,33
Perth Glory,429,8,10,2,15,37,50,-13,32
Wellington P,429,9,5,6,16,31,55,-24,21
CC Mariners,429,10,4,8,15,28,49,-21,20
Sydney FC,430,1,21,4,3,67,24,43,67
N'castle Jet,430,2,16,5,7,60,37,23,53
Melbourne C,430,3,14,4,11,43,36,7,46
Melbourne V,430,4,13,5,11,47,41,6,44
Adelaide Utd,430,5,11,6,11,37,40,-3,39
Brisbane,430,6,10,5,13,33,42,-9,35
Western Sydn,430,7,8,9,10,38,47,-9,33
Perth Glory,430,8,10,2,15,37,50,-13,32
Wellington P,430,9,5,6,16,31,55,-24,21
CC Mariners,430,10,4,8,15,28,49,-21,20
Sydney FC,431,1,21,4,3,69,22,47,67
N'castle Jet,431,2,16,5,7,58,37,21,53
Melbourne C,431,3,14,4,11,43,34,9,46
Melbourne V,431,4,13,5,11,45,43,2,44
Adelaide Utd,431,5,11,6,11,37,40,-3,39
Brisbane,431,6,10,5,13,33,42,-9,35
Western Sydn,431,7,8,9,10,38,47,-9,33
Perth Glory,431,8,10,2,15,37,50,-13,32
Wellington P,431,9,5,6,16,31,55,-24,21
CC Mariners,431,10,4,8,15,28,49,-21,20
Sydney FC,432,1,21,4,3,67,22,45,67
N'castle Jet,432,2,15,6,7,59,39,20,51
Melbourne C,432,3,14,5,10,45,35,10,47
Melbourne V,432,4,13,5,11,45,41,4,44
Adelaide Utd,432,5,11,6,11,37,40,-3,39
Brisbane,432,6,10,5,13,33,42,-9,35
Western Sydn,432,7,8,9,10,38,47,-9,33
Perth Glory,432,8,10,2,15,37,50,-13,32
Wellington P,432,9,5,6,16,31,55,-24,21
CC Mariners,432,10,4,8,15,28,49,-21,20
Sydney FC,433,1,21,4,3,67,23,44,67
N'castle Jet,433,2,15,6,7,57,37,20,51
Melbourne C,433,3,14,5,10,43,33,10,47
Melbourne V,433,4,13,5,11,46,41,5,44
Adelaide Utd,433,5,11,6,11,37,40,-3,39
Brisbane,433,6,10,5,13,33,42,-9,35
Western Sydn,433,7,8,9,10,38,47,-9,33
Perth Glory,433,8,10,2,15,37,50,-13,32
Wellington P,433,9,5,6,16,31,55,-24,21
CC Mariners,433,10,4,8,15,28,49,-21,20
Sydney FC,434,1,21,4,3,66,23,43,67
N'castle Jet,434,2,15,6,7,60,40,20,51
Melbourne C,434,3,14,5,10,46,36,10,47
Melbourne V,434,4,13,5,11,46,40,6,44
Adelaide Utd,434,5,11,6,11,37,40,-3,39
Brisbane,434,6,10,5,13,33,42,-9,35
Western Sydn,434,7,8,9,10,38,47,-9,33
Perth Glory,434,8,10,2,15,37,50,-13,32
Wellington P,434,9,5,6,16,31,55,-24,21
CC Mariners,434,10,4,8,15,28,49,-21,20
Sydney FC,435,1,21,4,3,65,22,43,67
N'castle Jet,435,2,16,5,7,59,38,21,53
Melbourne C,435,3,14,4,11,44,35,9,46
Melbourne V,435,4,13,5,11,45,39,6,44
Adelaide Utd,435,5,11,6,11,37,40,-3,39
Brisbane,435,6,10,5,13,33,42,-9,35
Western Sydn,435,7,8,9,10,38,47,-9,33
Perth Glory,435,8,10,2,15,37,50,-13,32
Wellington P,435,9,5,6,16,31,55,-24,21
CC Mariners,435,10,4,8,15,28,49,-21,20
Sydney FC,436,1,21,4,3,69,24,45,67
N'castle Jet,436,2,15,6,7,60,40,20,51
Melbourne C,436,3,14,5,10,46,36,10,47
Melbourne V,436,4,13,5,11,47,43,4,44
Adelaide Utd,436,5,11,6,11,37,40,-3,39
Brisbane,436,6,10,5,13,33,42,-9,35
Western Sydn,436,7,8,9,10,38,47,-9,33
Perth Glory,436,8,10,2,15,37,50,-13,32
Wellington P,436,9,5,6,16,31,55,-24,21
CC Mariners,436,10,4,8,15,28,49,-21,20
Sydney FC,437,1,21,4,3,67,23,44,67
N'castle Jet,437,2,15,5,8,58,40,18,50
Melbourne C,437,3,15,4,10,46,34,12,49
Melbourne V,437,4,13,5,11,46,41,5,44
Adelaide Utd,437,5,11,6,11,37,40,-3,39
Brisbane,437,6,10,5,13,33,42,-9,35
Western Sydn,437,7,8,9,10,38,47,-9,33
Perth Glory,437,8,10,2,15,37,50,-13,32
Wellington P,437,9,5,6,16,31,55,-24,21
CC Mariners,437,10,4,8,15,28,49,-21,20
Sydney FC,438,1,21,4,3,67,23,44,67
N'castle Jet,438,2,16,5,7,60,39,21,53
Melbourne C,438,3,14,4,11,45,36,9,46
Melbourne V,438,4,13,5,11,46,41,5,44
Adelaide Utd,438,5,11,6,11,37,40,-3,39
Brisbane,438,6,10,5,13,33,42,-9,35
Western Sydn,438,7,8,9,10,38,47,-9,33
Perth Glory,438,8,10,2,15,37,50,-13,32
Wellington P,438,9,5,6,16,31,55,-24,21
CC Mariners,438,10,4,8,15,28,49,-21,20
Sydney FC,439,1,21,4,3,66,23,43,67
N'castle Jet,439,2,16,5,7,60,37,23,53
Melbourne C,439,3,14,4,11,43,36,7,46
Melbourne V,439,4,13,5,11,46,40,6,44
Adelaide Utd,439,5,11,6,11,37,40,-3,39
Brisbane,439,6,10,5,13,33,42,-9,35
Western Sydn,439,7,8,9,10,38,47,-9,33
Perth Glory,439,8,10,2,15,37,50,-13,32
Wellington P,439,9,5,6,16,31,55,-24,21
CC Mariners,439,10,4,8,15,28,49,-21,20
Sydney FC,440,1,20,5,3,65,23,42,65
N'castle Jet,440,2,16,5,7,61,40,21,53
Melbourne C,440,3,14,4,11,46,37,9,46
Melbourne V,440,4,13,6,10,46,39,7,45
Adelaide Utd,440,5,11,6,11,37,40,-3,39
Brisbane,440,6,10,5,13,33,42,-9,35
Western Sydn,440,7,8,9,10,38,47,-9,33
Perth Glory,440,8,10,2,15,37,50,-13,32
Wellington P,440,9,5,6,16,31,55,-24,21
CC Mariners,440,10,4,8,15,28,49,-21,20
Sydney FC,441,1,20,5,3,64,22,42,65
N'castle Jet,441,2,15,5,8,57,39,18,50
Melbourne C,441,3,15,4,10,45,33,12,49
Melbourne V,441,4,13,6,10,45,38,7,45
Adelaide Utd,441,5,11,6,11,37,40,-3,39
Brisbane,441,6,10,5,13,33,42,-9,35
Western Sydn,441,7,8,9,10,38,47,-9,33
Perth Glory,441,8,10,2,15,37,50,-13,32
Wellington P,441,9,5,6,16,31,55,-24,21
CC Mariners,441,10,4,8,15,28,49,-21,20
Sydney FC,442,1,20,4,4,65,24,41,64
N'castle Jet,442,2,15,5,8,58,39,19,50
Melbourne C,442,3,15,4,10,45,34,11,49
Melbourne V,442,4,14,5,10,47,39,8,47
Adelaide Utd,442,5,11,6,11,37,40,-3,39
Brisbane,442,6,10,5,13,33,42,-9,35
Western Sydn,442,7,8,9,10,38,47,-9,33
Perth Glory,442,8,10,2,15,37,50,-13,32
Wellington P,442,9,5,6,16,31,55,-24,21
CC Mariners,442,10,4,8,15,28,49,-21,20
Sydney FC,443,1,21,4,3,68,24,44,67
N'castle Jet,443,2,16,5,7,60,37,23,53
Melbourne C,443,3,14,4,11,43,36,7,46
Melbourne V,443,4,13,5,11,47,42,5,44
Adelaide Utd,443,5,11,6,11,37,40,-3,39
Brisbane,443,6,10,5,13,33,42,-9,35
Western Sydn,443,7,8,9,10,38,47,-9,33
Perth Glory,443,8,10,2,15,37,50,-13,32
Wellington P,443,9,5,6,16,31,55,-24,21
CC Mariners,443,10,4,8,15,28,49,-21,20
Sydney FC,444,1,20,5,3,64,22,42,65
N'castle Jet,444,2,16,5,7,58,37,21,53
Melbourne C,444,3,14,4,11,43,34,9,46
Melbourne V,444,4,13,6,10,45,38,7,45
Adelaide Utd,444,5,11,6,11,37,40,-3,39
Brisbane,444,6,10,5,13,33,42,-9,35
Western Sydn,444,7,8,9,10,38,47,-9,33
Perth Glory,444,8,10,2,15,37,50,-13,32
Wellington P,444,9,5,6,16,31,55,-24,21
CC Mariners,444,10,4,8,15,28,49,-21,20
Sydney FC,445,1,21,4,3,66,22,44,67
N'castle Jet,445,2,16,5,7,58,37,21,53
Melbourne C,445,3,14,4,11,43,34,9,46
Melbourne V,445,4,13,5,11,45,40,5,44
Adelaide Utd,445,5,11,6,11,37,40,-3,39
Brisbane,445,6,10,5,13,33,42,-9,35
Western Sydn,445,7,8,9,10,38,47,-9,33
Perth Glory,445,8,10,2,15,37,50,-13,32
Wellington P,445,9,5,6,16,31,55,-24,21
CC Mariners,445,10,4,8,15,28,49,-21,20
Sydney FC,446,1,20,5,3,65,23,42,65
N'castle Jet,446,2,16,5,7,61,37,24,53
Melbourne C,446,3,14,4,11,43,37,6,46
Melbourne V,446,4,13,6,10,46,39,7,45
Adelaide Utd,446,5,11,6,11,37,40,-3,39
Brisbane,446,6,10,5,13,33,42,-9,35
Western Sydn,446,7,8,9,10,38,47,-9,33
Perth Glory,446,8,10,2,15,37,50,-13,32
Wellington P,446,9,5,6,16,31,55,-24,21
CC Mariners,446,10,4,8,15,28,49,-21,20
Sydney FC,447,1,21,4,3,65,22,43,67
N'castle Jet,447,2,15,5,8,58,40,18,50
Melbourne C,447,3,15,4,10,46,34,12,49
Melbourne V,447,4,13,5,11,45,39,6,44
Adelaide Utd,447,5,11,6,11,37,40,-3,39
Brisbane,447,6,10,5,13,33,42,-9,35
Western Sydn,447,7,8,9,10,38,47,-9,33
Perth Glory,447,8,10,2,15,37,50,-13,32
Wellington P,447,9,5,6,16,31,55,-24,21
CC Mariners,447,10,4,8,15,28,49,-21,20
Sydney FC,448,1,21,4,3,67,22,45,67
N'castle Jet,448,2,16,5,7,59,37,22,53
Melbourne C,448,3,14,4,11,43,35,8,46
Melbourne V,448,4,13,5,11,45,41,4,44
Adelaide Utd,448,5,11,6,11,37,40,-3,39
Brisbane,448,6,10,5,13,33,42,-9,35
Western Sydn,448,7,8,9,10,38,47,-9,33
Perth Glory,448,8,10,2,15,37,50,-13,32
Wellington P,448,9,5,6,16,31,55,-24,21
CC Mariners,448,10,4,8,15,28,49,-21,20
Sydney FC,449,1,21,4,3,67,22,45,67
N'castle Jet,449,2,15,5,8,58,39,19,50
Melbourne C,449,3,15,4,10,45,34,11,49
Melbourne V,449,4,13,5,11,45,41,4,44
Adelaide Utd,449,5,11,6,11,37,40,-3,39
Brisbane,449,6,10,5,13,33,42,-9,35
Western Sydn,449,7,8,9,10,38,47,-9,33
Perth Glory,449,8,10,2,15,37,50,-13,32
Wellington P,449,9,5,6,16,31,55,-24,21
CC Mariners,449,10,4,8,15,28,49,-21,20
Sydney FC,450,1,20,5,3,65,23,42,65
N'castle Jet,450,2,16,5,7,59,38,21,53
Melbourne C,450,3,14,4,11,44,35,9,46
Melbourne V,450,4,13,6,10,46,39,7,45
Adelaide Utd,450,5,11,6,11,37,40,-3,39
Brisbane,450,6,10,5,13,33,42,-9,35
Western Sydn,450,7,8,9,10,38,47,-9,33
Perth Glory,450,8,10,2,15,37,50,-13,32
Wellington P,450,9,5,6,16,31,55,-24,21
CC Mariners,450,10,4,8,15,28,49,-21,20
Sydney FC,451,1,20,5,3,66,24,42,65
N'castle Jet,451,2,16,5,7,60,37,23,53
Melbourne C,451,3,14,4,11,43,36,7,46
Melbourne V,451,4,13,6,10,47,40,7,45
Adelaide Utd,451,5,11,6,11,37,40,-3,39
Brisbane,451,6,10,5,13,33,42,-9,35
Western Sydn,451,7,8,9,10,38,47,-9,33
Perth Glory,451,8,10,2,15,37,50,-13,32
Wellington P,451,9,5,6,16,31,55,-24,21
CC Mariners,451,10,4,8,15,28,49,-21,20
Sydney FC,452,1,21,4,3,69,22,47,67
N'castle Jet,452,2,16,5,7,63,37,26,53
Melbourne C,452,3,14,4,11,43,39,4,46
Melbourne V,452,4,13,5,11,45,43,2,44
Adelaide Utd,452,5,11,6,11,37,40,-3,39
Brisbane,452,6,10,5,13,33,42,-9,35
Western Sydn,452,7,8,9,10,38,47,-9,33
Perth Glory,452,8,10,2,15,37,50,-13,32
Wellington P,452,9,5,6,16,31,55,-24,21
CC Mariners,452,10,4,8,15,28,49,-21,20
Sydney FC,453,1,21,4,3,66,23,43,67
N'castle Jet,453,2,15,6,7,59,39,20,51
Melbourne C,453,3,14,5,10,45,35,10,47
Melbourne V,453,4,13,5,11,46,40,6,44
Adelaide Utd,453,5,11,6,11,37,40,-3,39
Brisbane,453,6,10,5,13,33,42,-9,35
Western Sydn,453,7,8,9,10,38,47,-9,33
Perth Glory,453,8,10,2,15,37,50,-13,32
Wellington P,453,9,5,6,16,31,55,-24,21
CC Mariners,453,10,4,8,15,28,49,-21,20
Sydney FC,454,1,21,4,3,70,23,47,67
N'castle Jet,454,2,15,5,8,59,41,18,50
Melbourne C,454,3,15,4,10,47,35,12,49
Melbourne V,454,4,13,5,11,46,44,2,44
Adelaide Utd,454,5,11,6,11,37,40,-3,39
Brisbane,454,6,10,5,13,33,42,-9,35
Western Sydn,454,7,8,9,10,38,47,-9,33
Perth Glory,454,8,10,2,15,37,50,-13,32
Wellington P,454,9,5,6,16,31,55,-24,21
CC Mariners,454,10,4,8,15,28,49,-21,20
Sydney FC,455,1,20,5,3,66,24,42,65
N'castle Jet,455,2,16,5,7,60,39,21,53
Melbourne C,455,3,14,4,11,45,36,9,46
Melbourne V,455,4,13,6,10,47,40,7,45
Adelaide Utd,455,5,11,6,11,37,40,-3,39
Brisbane,455,6,10,5,13,33,42,-9,35
Western Sydn,455,7,8,9,10,38,47,-9,33
Perth Glory,455,8,10,2,15,37,50,-13,32
Wellington P,455,9,5,6,16,31,55,-24,21
CC Mariners,455,10,4,8,15,28,49,-21,20
Sydney FC,456,1,21,4,3,65,22,43,67
N'castle Jet,456,2,16,5,7,59,37,22,53
Melbourne C,456,3,14,4,11,43,35,8,46
Melbourne V,456,4,13,5,11,45,39,6,44
Adelaide Utd,456,5,11,6,11,37,40,-3,39
Brisbane,456,6,10,5,13,33,42,-9,35
Western Sydn,456,7,8,9,10,38,47,-9,33
Perth Glory,456,8,10,2,15,37,50,-13,32
Wellington P,456,9,5,6,16,31,55,-24,21
CC Mariners,456,10,4,8,15,28,49,-21,20
Sydney FC,457,1,20,4,4,64,23,41,64
N'castle Jet,457,2,15,6,7,58,38,20,51
Melbourne C,457,3,14,5,10,44,34,10,47
Melbourne V,457,4,14,5,10,46,38,8,47
Adelaide Utd,457,5,11,6,11,37,40,-3,39
Brisbane,457,6,10,5,13,33,42,-9,35
Western Sydn,457,7,8,9,10,38,47,-9,33
Perth Glory,457,8,10,2,15,37,50,-13,32
Wellington P,457,9,5,6,16,31,55,-24,21
CC Mariners,457,10,4,8,15,28,49,-21,20
Sydney FC,458,1,20,5,3,65,23,42,65
N'castle Jet,458,2,16,5,7,59,38,21,53
Melbourne C,458,3,14,4,11,44,35,9,46
Melbourne V,458,4,13,6,10,46,39,7,45
Adelaide Utd,458,5,11,6,11,37,40,-3,39
Brisbane,458,6,10,5,13,33,42,-9,35
Western Sydn,458,7,8,9,10,38,47,-9,33
Perth Glory,458,8,10,2,15,37,50,-13,32
Wellington P,458,9,5,6,16,31,55,-24,21
CC Mariners,458,10,4,8,15,28,49,-21,20
Sydney FC,459,1,20,5,3,65,23,42,65
N'castle Jet,459,2,16,5,7,62,39,23,53
Melbourne C,459,3,14,4,11,45,38,7,46
Melbourne V,459,4,13,6,10,46,39,7,45
Adelaide Utd,459,5,11,6,11,37,40,-3,39
Brisbane,459,6,10,5,13,33,42,-9,35
Western Sydn,459,7,8,9,10,38,47,-9,33
Perth Glory,459,8,10,2,15,37,50,-13,32
Wellington P,459,9,5,6,16,31,55,-24,21
CC Mariners,459,10,4,8,15,28,49,-21,20
Sydney FC,460,1,21,4,3,69,23,46,67
N'castle Jet,460,2,15,5,8,58,39,19,50
Melbourne C,460,3,15,4,10,45,34,11,49
Melbourne V,460,4,13,5,11,46,43,3,44
Adelaide Utd,460,5,11,6,11,37,40,-3,39
Brisbane,460,6,10,5,13,33,42,-9,35
Western Sydn,460,7,8,9,10,38,47,-9,33
Perth Glory,460,8,10,2,15,37,50,-13,32
Wellington P,460,9,5,6,16,31,55,-24,21
CC Mariners,460,10,4,8,15,28,49,-21,20
Sydney FC,461,1,21,4,3,68,24,44,67
N'castle Jet,461,2,16,5,7,59,37,22,53
Melbourne C,461,3,14,4,11,43,35,8,46
Melbourne V,461,4,13,5,11,47,42,5,44
Adelaide Utd,461,5,11,6,11,37,40,-3,39
Brisbane,461,6,10,5,13,33,42,-9,35
Western Sydn,461,7,8,9,10,38,47,-9,33
Perth Glory,461,8,10,2,15,37,50,-13,32
Wellington P,461,9,5,6,16,31,55,-24,21
CC Mariners,461,10,4,8,15,28,49,-21,20
Sydney FC,462,1,21,4,3,67,24,43,67
N'castle Jet,462,2,16,5,7,61,37,24,53
Melbourne C,462,3,14,4,11,43,37,6,46
Melbourne V,462,4,13,5,11,47,41,6,44
Adelaide Utd,462,5,11,6,11,37,40,-3,39
Brisbane,462,6,10,5,13,33,42,-9,35
Western Sydn,462,7,8,9,10,38,47,-9,33
Perth Glory,462,8,10,2,15,37,50,-13,32
Wellington P,462,9,5,6,16,31,55,-24,21
CC Mariners,462,10,4,8,15,28,49,-21,20
Sydney FC,463,1,20,4,4,65,26,39,64
N'castle Jet,463,2,15,5,8,58,39,19,50
Melbourne C,463,3,15,4,10,45,34,11,49
Melbourne V,463,4,14,5,10,49,39,10,47
Adelaide Utd,463,5,11,6,11,37,40,-3,39
Brisbane,463,6,10,5,13,33,42,-9,35
Western Sydn,463,7,8,9,10,38,47,-9,33
Perth Glory,463,8,10,2,15,37,50,-13,32
Wellington P,463,9,5,6,16,31,55,-24,21
CC Mariners,463,10,4,8,15,28,49,-21,20
Sydney FC,464,1,20,5,3,64,22,42,65
N'castle Jet,464,2,16,5,7,58,37,21,53
Melbourne C,464,3,14,4,11,43,34,9,46
Melbourne V,464,4,13,6,10,45,38,7,45
Adelaide Utd,464,5,11,6,11,37,40,-3,39
Brisbane,464,6,10,5,13,33,42,-9,35
Western Sydn,464,7,8,9,10,38,47,-9,33
Perth Glory,464,8,10,2,15,37,50,-13,32
Wellington P,464,9,5,6,16,31,55,-24,21
CC Mariners,464,10,4,8,15,28,49,-21,20
Sydney FC,465,1,20,4,4,64,23,41,64
N'castle Jet,465,2,15,5,8,58,39,19,50
Melbourne C,465,3,15,4,10,45,34,11,49
Melbourne V,465,4,14,5,10,46,38,8,47
Adelaide Utd,465,5,11,6,11,37,40,-3,39
Brisbane,465,6,10,5,13,33,42,-9,35
Western Sydn,465,7,8,9,10,38,47,-9,33
Perth Glory,465,8,10,2,15,37,50,-13,32
Wellington P,465,9,5,6,16,31,55,-24,21
CC Mariners,465,10,4,8,15,28,49,-21,20
Sydney FC,466,1,21,4,3,65,22,43,67
N'castle Jet,466,2,15,6,7,57,37,20,51
Melbourne C,466,3,14,5,10,43,33,10,47
Melbourne V,466,4,13,5,11,45,39,6,44
Adelaide Utd,466,5,11,6,11,37,40,-3,39
Brisbane,466,6,10,5,13,33,42,-9,35
Western Sydn,466,7,8,9,10,38,47,-9,33
Perth Glory,466,8,10,2,15,37,50,-13,32
Wellington P,466,9,5,6,16,31,55,-24,21
CC Mariners,466,10,4,8,15,28,49,-21,20
Sydney FC,467,1,20,4,4,65,24,41,64
N'castle Jet,467,2,16,5,7,59,37,22,53
Melbourne V,467,3,14,5,10,47,39,8,47
Melbourne C,467,4,14,4,11,43,35,8,46
Adelaide Utd,467,5,11,6,11,37,40,-3,39
Brisbane,467,6,10,5,13,33,42,-9,35
Western Sydn,467,7,8,9,10,38,47,-9,33
Perth Glory,467,8,10,2,15,37,50,-13,32
Wellington P,467,9,5,6,16,31,55,-24,21
CC Mariners,467,10,4,8,15,28,49,-21,20
Sydney FC,468,1,21,4,3,66,23,43,67
N'castle Jet,468,2,15,6,7,57,37,20,51
Melbourne C,468,3,14,5,10,43,33,10,47
Melbourne V,468,4,13,5,11,46,40,6,44
Adelaide Utd,468,5,11,6,11,37,40,-3,39
Brisbane,468,6,10,5,13,33,42,-9,35
Western Sydn,468,7,8,9,10,38,47,-9,33
Perth Glory,468,8,10,2,15,37,50,-13,32
Wellington P,468,9,5,6,16,31,55,-24,21
CC Mariners,468,10,4,8,15,28,49,-21,20
Sydney FC,469,1,20,4,4,64,23,41,64
N'castle Jet,469,2,16,5,7,58,37,21,53
Melbourne V,469,3,14,5,10,46,38,8,47
Melbourne C,469,4,14,4,11,43,34,9,46
Adelaide Utd,469,5,11,6,11,37,40,-3,39
Brisbane,469,6,10,5,13,33,42,-9,35
Western Sydn,469,7,8,9,10,38,47,-9,33
Perth Glory,469,8,10,2,15,37,50,-13,32
Wellington P,469,9,5,6,16,31,55,-24,21
CC Mariners,469,10,4,8,15,28,49,-21,20
Sydney FC,470,1,21,4,3,69,23,46,67
N'castle Jet,470,2,16,5,7,58,37,21,53
Melbourne C,470,3,14,4,11,43,34,9,46
Melbourne V,470,4,13,5,11,46,43,3,44
Adelaide Utd,470,5,11,6,11,37,40,-3,39
Brisbane,470,6,10,5,13,33,42,-9,35
Western Sydn,470,7,8,9,10,38,47,-9,33
Perth Glory,470,8,10,2,15,37,50,-13,32
Wellington P,470,9,5,6,16,31,55,-24,21
CC Mariners,470,10,4,8,15,28,49,-21,20
Sydney FC,471,1,21,4,3,68,23,45,67
N'castle Jet,471,2,15,5,8,58,39,19,50
Melbourne C,471,3,15,4,10,45,34,11,49
Melbourne V,471,4,13,5,11,46,42,4,44
Adelaide Utd,471,5,11,6,11,37,40,-3,39
Brisbane,471,6,10,5,13,33,42,-9,35
Western Sydn,471,7,8,9,10,38,47,-9,33
Perth Glory,471,8,10,2,15,37,50,-13,32
Wellington P,471,9,5,6,16,31,55,-24,21
CC Mariners,471,10,4,8,15,28,49,-21,20
Sydney FC,472,1,20,4,4,65,25,40,64
N'castle Jet,472,2,15,5,8,58,39,19,50
Melbourne C,472,3,15,4,10,45,34,11,49
Melbourne V,472,4,14,5,10,48,39,9,47
Adelaide Utd,472,5,11,6,11,37,40,-3,39
Brisbane,472,6,10,5,13,33,42,-9,35
Western Sydn,472,7,8,9,10,38,47,-9,33
Perth Glory,472,8,10,2,15,37,50,-13,32
Wellington P,472,9,5,6,16,31,55,-24,21
CC Mariners,472,10,4,8,15,28,49,-21,20
Sydney FC,473,1,21,4,3,65,22,43,67
N'castle Jet,473,2,15,5,8,57,38,19,50
Melbourne C,473,3,15,4,10,44,33,11,49
Melbourne V,473,4,13,5,11,45,39,6,44
Adelaide Utd,473,5,11,6,11,37,40,-3,39
Brisbane,473,6,10,5,13,33,42,-9,35
Western Sydn,473,7,8,9,10,38,47,-9,33
Perth Glory,473,8,10,2,15,37,50,-13,32
Wellington P,473,9,5,6,16,31,55,-24,21
CC Mariners,473,10,4,8,15,28,49,-21,20
Sydney FC,474,1,21,4,3,69,24,45,67
N'castle Jet,474,2,16,5,7,58,37,21,53
Melbourne C,474,3,14,4,11,43,34,9,46
Melbourne V,474,4,13,5,11,47,43,4,44
Adelaide Utd,474,5,11,6,11,37,40,-3,39
Brisbane,474,6,10,5,13,33,42,-9,35
Western Sydn,474,7,8,9,10,38,47,-9,33
Perth Glory,474,8,10,2,15,37,50,-13,32
Wellington P,474,9,5,6,16,31,55,-24,21
CC Mariners,474,10,4,8,15,28,49,-21,20
Sydney FC,475,1,20,4,4,65,24,41,64
N'castle Jet,475,2,16,5,7,60,39,21,53
Melbourne V,475,3,14,5,10,47,39,8,47
Melbourne C,475,4,14,4,11,45,36,9,46
Adelaide Utd,475,5,11,6,11,37,40,-3,39
Brisbane,475,6,10,5,13,33,42,-9,35
Western Sydn,475,7,8,9,10,38,47,-9,33
Perth Glory,475,8,10,2,15,37,50,-13,32
Wellington P,475,9,5,6,16,31,55,-24,21
CC Mariners,475,10,4,8,15,28,49,-21,20
Sydney FC,476,1,21,4,3,67,22,45,67
N'castle Jet,476,2,15,6,7,59,39,20,51
Melbourne C,476,3,14,5,10,45,35,10,47
Melbourne V,476,4,13,5,11,45,41,4,44
Adelaide Utd,476,5,11,6,11,37,40,-3,39
Brisbane,476,6,10,5,13,33,42,-9,35
Western Sydn,476,7,8,9,10,38,47,-9,33
Perth Glory,476,8,10,2,15,37,50,-13,32
Wellington P,476,9,5,6,16,31,55,-24,21
CC Mariners,476,10,4,8,15,28,49,-21,20
Sydney FC,477,1,21,4,3,68,22,46,67
N'castle Jet,477,2,16,5,7,58,37,21,53
Melbourne C,477,3,14,4,11,43,34,9,46
Melbourne V,477,4,13,5,11,45,42,3,44
Adelaide Utd,477,5,11,6,11,37,40,-3,39
Brisbane,477,6,10,5,13,33,42,-9,35
Western Sydn,477,7,8,9,10,38,47,-9,33
Perth Glory,477,8,10,2,15,37,50,-13,32
Wellington P,477,9,5,6,16,31,55,-24,21
CC Mariners,477,10,4,8,15,28,49,-21,20
Sydney FC,478,1,21,4,3,65,22,43,67
N'castle Jet,478,2,15,5,8,59,41,18,50
Melbourne C,478,3,15,4,10,47,35,12,49
Melbourne V,478,4,13,5,11,45,39,6,44
Adelaide Utd,478,5,11,6,11,37,40,-3,39
Brisbane,478,6,10,5,13,33,42,-9,35
Western Sydn,478,7,8,9,10,38,47,-9,33
Perth Glory,478,8,10,2,15,37,50,-13,32
Wellington P,478,9,5,6,16,31,55,-24,21
CC Mariners,478,10,4,8,15,28,49,-21,20
Sydney FC,479,1,20,5,3,65,23,42,65
N'castle Jet,479,2,16,5,7,58,37,21,53
Melbourne C,479,3,14,4,11,43,34,9,46
Melbourne V,479,4,13,6,10,46,39,7,45
Adelaide Utd,479,5,11,6,11,37,40,-3,39
Brisbane,479,6,10,5,13,33,42,-9,35
Western Sydn,479,7,8,9,10,38,47,-9,33
Perth Glory,479,8,10,2,15,37,50,-13,32
Wellington P,479,9,5,6,16,31,55,-24,21
CC Mariners,479,10,4,8,15,28,49,-21,20
Sydney FC,480,1,21,4,3,66,22,44,67
N'castle Jet,480,2,15,5,8,58,39,19,50
Melbourne C,480,3,15,4,10,45,34,11,49
Melbourne V,480,4,13,5,11,45,40,5,44
Adelaide Utd,480,5,11,6,11,37,40,-3,39
Brisbane,480,6,10,5,13,33,42,-9,35
Western Sydn,480,7,8,9,10,38,47,-9,33
Perth Glory,480,8,10,2,15,37,50,-13,32
Wellington P,480,9,5,6,16,31,55,-24,21
CC Mariners,480,10,4,8,15,28,49,-21,20
Sydney FC,481,1,21,4,3,65,22,43,67
N'castle Jet,481,2,16,5,7,60,38,22,53
Melbourne C,481,3,14,4,11,44,36,8,46
Melbourne V,481,4,13,5,11,45,39,6,44
Adelaide Utd,481,5,11,6,11,37,40,-3,39
Brisbane,481,6,10,5,13,33,42,-9,35
Western Sydn,481,7,8,9,10,38,47,-9,33
Perth Glory,481,8,10,2,15,37,50,-13,32
Wellington P,481,9,5,6,16,31,55,-24,21
CC Mariners,481,10,4,8,15,28,49,-21,20
Sydney FC,482,1,21,4,3,67,22,45,67
N'castle Jet,482,2,15,6,7,59,39,20,51
Melbourne C,482,3,14,5,10,45,35,10,47
Melbourne V,482,4,13,5,11,45,41,4,44
Adelaide Utd,482,5,11,6,11,37,40,-3,39
Brisbane,482,6,10,5,13,33,42,-9,35
Western Sydn,482,7,8,9,10,38,47,-9,33
Perth Glory,482,8,10,2,15,37,50,-13,32
Wellington P,482,9,5,6,16,31,55,-24,21
CC Mariners,482,10,4,8,15,28,49,-21,20
Sydney FC,483,1,21,4,3,66,22,44,67
N'castle Jet,483,2,16,5,7,61,40,21,53
Melbourne C,483,3,14,4,11,46,37,9,46
Melbourne V,483,4,13,5,11,45,40,5,44
Adelaide Utd,483,5,11,6,11,37,40,-3,39
Brisbane,483,6,10,5,13,33,42,-9,35
Western Sydn,483,7,8,9,10,38,47,-9,33
Perth Glory,483,8,10,2,15,37,50,-13,32
Wellington P,483,9,5,6,16,31,55,-24,21
CC Mariners,483,10,4,8,15,28,49,-21,20
Sydney FC,484,1,21,4,3,67,24,43,67
N'castle Jet,484,2,16,5,7,59,38,21,53
Melbourne C,484,3,14,4,11,44,35,9,46
Melbourne V,484,4,13,5,11,47,41,6,44
Adelaide Utd,484,5,11,6,11,37,40,-3,39
Brisbane,484,6,10,5,13,33,42,-9,35
Western Sydn,484,7,8,9,10,38,47,-9,33
Perth Glory,484,8,10,2,15,37,50,-13,32
Wellington P,484,9,5,6,16,31,55,-24,21
CC Mariners,484,10,4,8,15,28,49,-21,20
Sydney FC,485,1,20,5,3,64,22,42,65
N'castle Jet,485,2,16,5,7,59,38,21,53
Melbourne C,485,3,14,4,11,44,35,9,46
Melbourne V,485,4,13,6,10,45,38,7,45
Adelaide Utd,485,5,11,6,11,37,40,-3,39
Brisbane,485,6,10,5,13,33,42,-9,35
Western Sydn,485,7,8,9,10,38,47,-9,33
Perth Glory,485,8,10,2,15,37,50,-13,32
Wellington P,485,9,5,6,16,31,55,-24,21
CC Mariners,485,10,4,8,15,28,49,-21,20
Sydney FC,486,1,20,5,3,66,24,42,65
N'castle Jet,486,2,15,5,8,59,40,19,50
Melbourne C,486,3,15,4,10,46,35,11,49
Melbourne V,486,4,13,6,10,47,40,7,45
Adelaide Utd,486,5,11,6,11,37,40,-3,39
Brisbane,486,6,10,5,13,33,42,-9,35
Western Sydn,486,7,8,9,10,38,47,-9,33
Perth Glory,486,8,10,2,15,37,50,-13,32
Wellington P,486,9,5,6,16,31,55,-24,21
CC Mariners,486,10,4,8,15,28,49,-21,20
Sydney FC,487,1,21,4,3,66,23,43,67
N'castle Jet,487,2,15,5,8,57,39,18,50
Melbourne C,487,3,15,4,10,45,33,12,49
Melbourne V,487,4,13,5,11,46,40,6,44
Adelaide Utd,487,5,11,6,11,37,40,-3,39
Brisbane,487,6,10,5,13,33,42,-9,35
Western Sydn,487,7,8,9,10,38,47,-9,33
Perth Glory,487,8,10,2,15,37,50,-13,32
Wellington P,487,9,5,6,16,31,55,-24,21
CC Mariners,487,10,4,8,15,28,49,-21,20
Sydney FC,488,1,21,4,3,66,22,44,67
N'castle Jet,488,2,15,5,8,59,40,19,50
Melbourne C,488,3,15,4,10,46,35,11,49
Melbourne V,488,4,13,5,11,45,40,5,44
Adelaide Utd,488,5,11,6,11,37,40,-3,39
Brisbane,488,6,10,5,13,33,42,-9,35
Western Sydn,488,7,8,9,10,38,47,-9,33
Perth Glory,488,8,10,2,15,37,50,-13,32
Wellington P,488,9,5,6,16,31,55,-24,21
CC Mariners,488,10,4,8,15,28,49,-21,20
Sydney FC,489,1,20,5,3,64,22,42,65
N'castle Jet,489,2,16,5,7,58,37,21,53
Melbourne C,489,3,14,4,11,43,34,9,46
Melbourne V,489,4,13,6,10,45,38,7,45
Adelaide Utd,489,5,11,6,11,37,40,-3,39
Brisbane,489,6,10,5,13,33,42,-9,35
Western Sydn,489,7,8,9,10,38,47,-9,33
Perth Glory,489,8,10,2,15,37,50,-13,32
Wellington P,489,9,5,6,16,31,55,-24,21
CC Mariners,489,10,4,8,15,28,49,-21,20
Sydney FC,490,1,21,4,3,70,22,48,67
N'castle Jet,490,2,15,6,7,58,38,20,51
Melbourne C,490,3,14,5,10,44,34,10,47
Melbourne V,490,4,13,5,11,45,44,1,44
Adelaide Utd,490,5,11,6,11,37,40,-3,39
Brisbane,490,6,10,5,13,33,42,-9,35
Western Sydn,490,7,8,9,10,38,47,-9,33
Perth Glory,490,8,10,2,15,37,50,-13,32
Wellington P,490,9,5,6,16,31,55,-24,21
CC Mariners,490,10,4,8,15,28,49,-21,20
Sydney FC,491,1,20,5,3,64,22,42,65
N'castle Jet,491,2,15,5,8,58,39,19,50
Melbourne C,491,3,15,4,10,45,34,11,49
Melbourne V,491,4,13,6,10,45,38,7,45
Adelaide Utd,491,5,11,6,11,37,40,-3,39
Brisbane,491,6,10,5,13,33,42,-9,35
Western Sydn,491,7,8,9,10,38,47,-9,33
Perth Glory,491,8,10,2,15,37,50,-13,32
Wellington P,491,9,5,6,16,31,55,-24,21
CC Mariners,491,10,4,8,15,28,49,-21,20
Sydney FC,492,1,20,5,3,65,23,42,65
N'castle Jet,492,2,15,5,8,58,40,18,50
Melbourne C,492,3,15,4,10,46,34,12,49
Melbourne V,492,4,13,6,10,46,39,7,45
Adelaide Utd,492,5,11,6,11,37,40,-3,39
Brisbane,492,6,10,5,13,33,42,-9,35
Western Sydn,492,7,8,9,10,38,47,-9,33
Perth Glory,492,8,10,2,15,37,50,-13,32
Wellington P,492,9,5,6,16,31,55,-24,21
CC Mariners,492,10,4,8,15,28,49,-21,20
Sydney FC,493,1,20,5,3,66,24,42,65
N'castle Jet,493,2,16,5,7,60,39,21,53
Melbourne C,493,3,14,4,11,45,36,9,46
Melbourne V,493,4,13,6,10,47,40,7,45
Adelaide Utd,493,5,11,6,11,37,40,-3,39
Brisbane,493,6,10,5,13,33,42,-9,35
Western Sydn,493,7,8,9,10,38,47,-9,33
Perth Glory,493,8,10,2,15,37,50,-13,32
Wellington P,493,9,5,6,16,31,55,-24,21
CC Mariners,493,10,4,8,15,28,49,-21,20
Sydney FC,494,1,21,4,3,65,22,43,67
N'castle Jet,494,2,16,5,7,61,38,23,53
Melbourne C,494,3,14,4,11,44,37,7,46
Melbourne V,494,4,13,5,11,45,39,6,44
Adelaide Utd,494,5,11,6,11,37,40,-3,39
Brisbane,494,6,10,5,13,33,42,-9,35
Western Sydn,494,7,8,9,10,38,47,-9,33
Perth Glory,494,8,10,2,15,37,50,-13,32
Wellington P,494,9,5,6,16,31,55,-24,21
CC Mariners,494,10,4,8,15,28,49,-21,20
Sydney FC,495,1,21,4,3,67,22,45,67
N'castle Jet,495,2,16,5,7,59,38,21,53
Melbourne C,495,3,14,4,11,44,35,9,46
Melbourne V,495,4,13,5,11,45,41,4,44
Adelaide Utd,495,5,11,6,11,37,40,-3,39
Brisbane,495,6,10,5,13,33,42,-9,35
Western Sydn,495,7,8,9,10,38,47,-9,33
Perth Glory,495,8,10,2,15,37,50,-13,32
Wellington P,495,9,5,6,16,31,55,-24,21
CC Mariners,495,10,4,8,15,28,49,-21,20
Sydney FC,496,1,21,4,3,67,22,45,67
N'castle Jet,496,2,15,6,7,58,38,20,51
Melbourne C,496,3,14,5,10,44,34,10,47
Melbourne V,496,4,13,5,11,45,41,4,44
Adelaide Utd,496,5,11,6,11,37,40,-3,39
Brisbane,496,6,10,5,13,33,42,-9,35
Western Sydn,496,7,8,9,10,38,47,-9,33
Perth Glory,496,8,10,2,15,37,50,-13,32
Wellington P,496,9,5,6,16,31,55,-24,21
CC Mariners,496,10,4,8,15,28,49,-21,20
Sydney FC,497,1,20,5,3,66,24,42,65
N'castle Jet,497,2,15,6,7,58,38,20,51
Melbourne C,497,3,14,5,10,44,34,10,47
Melbourne V,497,4,13,6,10,47,40,7,45
Adelaide Utd,497,5,11,6,11,37,40,-3,39
Brisbane,497,6,10,5,13,33,42,-9,35
Western Sydn,497,7,8,9,10,38,47,-9,33
Perth Glory,497,8,10,2,15,37,50,-13,32
Wellington P,497,9,5,6,16,31,55,-24,21
CC Mariners,497,10,4,8,15,28,49,-21,20
Sydney FC,498,1,21,4,3,68,23,45,67
N'castle Jet,498,2,15,5,8,57,38,19,50
Melbourne C,498,3,15,4,10,44,33,11,49
Melbourne V,498,4,13,5,11,46,42,4,44
Adelaide Utd,498,5,11,6,11,37,40,-3,39
Brisbane,498,6,10,5,13,33,42,-9,35
Western Sydn,498,7,8,9,10,38,47,-9,33
Perth Glory,498,8,10,2,15,37,50,-13,32
Wellington P,498,9,5,6,16,31,55,-24,21
CC Mariners,498,10,4,8,15,28,49,-21,20
Sydney FC,499,1,21,4,3,68,24,44,67
N'castle Jet,499,2,15,5,8,58,39,19,50
Melbourne C,499,3,15,4,10,45,34,11,49
Melbourne V,499,4,13,5,11,47,42,5,44
Adelaide Utd,499,5,11,6,11,37,40,-3,39
Brisbane,499,6,10,5,13,33,42,-9,35
Western Sydn,499,7,8,9,10,38,47,-9,33
Perth Glory,499,8,10,2,15,37,50,-13,32
Wellington P,499,9,5,6,16,31,55,-24,21
CC Mariners,499,10,4,8,15,28,49,-21,20
Sydney FC,500,1,20,4,4,67,26,41,64
N'castle Jet,500,2,16,5,7,59,38,21,53
Melbourne V,500,3,14,5,10,49,41,8,47
Melbourne C,500,4,14,4,11,44,35,9,46
Adelaide Utd,500,5,11,6,11,37,40,-3,39
Brisbane,500,6,10,5,13,33,42,-9,35
Western Sydn,500,7,8,9,10,38,47,-9,33
Perth Glory,500,8,10,2,15,37,50,-13,32
Wellington P,500,9,5,6,16,31,55,-24,21
CC Mariners,500,10,4,8,15,28,49,-21,20
Sydney FC,501,1,21,4,3,65,22,43,67
N'castle Jet,501,2,15,5,8,57,40,17,50
Melbourne C,501,3,15,4,10,46,33,13,49
Melbourne V,501,4,13,5,11,45,39,6,44
Adelaide Utd,501,5,11,6,11,37,40,-3,39
Brisbane,501,6,10,5,13,33,42,-9,35
Western Sydn,501,7,8,9,10,38,47,-9,33
Perth Glory,501,8,10,2,15,37,50,-13,32
Wellington P,501,9,5,6,16,31,55,-24,21
CC Mariners,501,10,4,8,15,28,49,-21,20
Sydney FC,502,1,21,4,3,67,24,43,67
N'castle Jet,502,2,16,5,7,60,38,22,53
Melbourne C,502,3,14,4,11,44,36,8,46
Melbourne V,502,4,13,5,11,47,41,6,44
Adelaide Utd,502,5,11,6,11,37,40,-3,39
Brisbane,502,6,10,5,13,33,42,-9,35
Western Sydn,502,7,8,9,10,38,47,-9,33
Perth Glory,502,8,10,2,15,37,50,-13,32
Wellington P,502,9,5,6,16,31,55,-24,21
CC Mariners,502,10,4,8,15,28,49,-21,20
Sydney FC,503,1,21,4,3,65,22,43,67
N'castle Jet,503,2,16,5,7,60,38,22,53
Melbourne C,503,3,14,4,11,44,36,8,46
Melbourne V,503,4,13,5,11,45,39,6,44
Adelaide Utd,503,5,11,6,11,37,40,-3,39
Brisbane,503,6,10,5,13,33,42,-9,35
Western Sydn,503,7,8,9,10,38,47,-9,33
Perth Glory,503,8,10,2,15,37,50,-13,32
Wellington P,503,9,5,6,16,31,55,-24,21
CC Mariners,503,10,4,8,15,28,49,-21,20
Sydney FC,504,1,21,4,3,69,23,46,67
N'castle Jet,504,2,15,6,7,58,38,20,51
Melbourne C,504,3,14,5,10,44,34,10,47
Melbourne V,504,4,13,5,11,46,43,3,44
Adelaide Utd,504,5,11,6,11,37,40,-3,39
Brisbane,504,6,10,5,13,33,42,-9,35
Western Sydn,504,7,8,9,10,38,47,-9,33
Perth Glory,504,8,10,2,15,37,50,-13,32
Wellington P,504,9,5,6,16,31,55,-24,21
CC Mariners,504,10,4,8,15,28,49,-21,20
Sydney FC,505,1,21,4,3,66,23,43,67
N'castle Jet,505,2,16,5,7,59,37,22,53
Melbourne C,505,3,14,4,11,43,35,8,46
Melbourne V,505,4,13,5,11,46,40,6,44
Adelaide Utd,505,5,11,6,11,37,40,-3,39
Brisbane,505,6,10,5,13,33,42,-9,35
Western Sydn,505,7,8,9,10,38,47,-9,33
Perth Glory,505,8,10,2,15,37,50,-13,32
Wellington P,505,9,5,6,16,31,55,-24,21
CC Mariners,505,10,4,8,15,28,49,-21,20
Sydney FC,506,1,20,4,4,64,24,40,64
N'castle Jet,506,2,15,5,8,57,38,19,50
Melbourne C,506,3,15,4,10,44,33,11,49
Melbourne V,506,4,14,5,10,47,38,9,47
Adelaide Utd,506,5,11,6,11,37,40,-3,39
Brisbane,506,6,10,5,13,33,42,-9,35
Western Sydn,506,7,8,9,10,38,47,-9,33
Perth Glory,506,8,10,2,15,37,50,-13,32
Wellington P,506,9,5,6,16,31,55,-24,21
CC Mariners,506,10,4,8,15,28,49,-21,20
Sydney FC,507,1,20,4,4,64,23,41,64
N'castle Jet,507,2,16,5,7,60,37,23,53
Melbourne V,507,3,14,5,10,46,38,8,47
Melbourne C,507,4,14,4,11,43,36,7,46
Adelaide Utd,507,5,11,6,11,37,40,-3,39
Brisbane,507,6,10,5,13,33,42,-9,35
Western Sydn,507,7,8,9,10,38,47,-9,33
Perth Glory,507,8,10,2,15,37,50,-13,32
Wellington P,507,9,5,6,16,31,55,-24,21
CC Mariners,507,10,4,8,15,28,49,-21,20
Sydney FC,508,1,21,4,3,65,22,43,67
N'castle Jet,508,2,15,5,8,57,41,16,50
Melbourne C,508,3,15,4,10,47,33,14,49
Melbourne V,508,4,13,5,11,45,39,6,44
Adelaide Utd,508,5,11,6,11,37,40,-3,39
Brisbane,508,6,10,5,13,33,42,-9,35
Western Sydn,508,7,8,9,10,38,47,-9,33
Perth Glory,508,8,10,2,15,37,50,-13,32
Wellington P,508,9,5,6,16,31,55,-24,21
CC Mariners,508,10,4,8,15,28,49,-21,20
Sydney FC,509,1,21,4,3,66,23,43,67
N'castle Jet,509,2,15,5,8,58,40,18,50
Melbourne C,509,3,15,4,10,46,34,12,49
Melbourne V,509,4,13,5,11,46,40,6,44
Adelaide Utd,509,5,11,6,11,37,40,-3,39
Brisbane,509,6,10,5,13,33,42,-9,35
Western Sydn,509,7,8,9,10,38,47,-9,33
Perth Glory,509,8,10,2,15,37,50,-13,32
Wellington P,509,9,5,6,16,31,55,-24,21
CC Mariners,509,10,4,8,15,28,49,-21,20
Sydney FC,510,1,20,4,4,65,24,41,64
N'castle Jet,510,2,15,5,8,57,38,19,50
Melbourne C,510,3,15,4,10,44,33,11,49
Melbourne V,510,4,14,5,10,47,39,8,47
Adelaide Utd,510,5,11,6,11,37,40,-3,39
Brisbane,510,6,10,5,13,33,42,-9,35
Western Sydn,510,7,8,9,10,38,47,-9,33
Perth Glory,510,8,10,2,15,37,50,-13,32
Wellington P,510,9,5,6,16,31,55,-24,21
CC Mariners,510,10,4,8,15,28,49,-21,20
Sydney FC,511,1,20,4,4,65,24,41,64
N'castle Jet,511,2,16,5,7,61,37,24,53
Melbourne V,511,3,14,5,10,47,39,8,47
Melbourne C,511,4,14,4,11,43,37,6,46
Adelaide Utd,511,5,11,6,11,37,40,-3,39
Brisbane,511,6,10,5,13,33,42,-9,35
Western Sydn,511,7,8,9,10,38,47,-9,33
Perth Glory,511,8,10,2,15,37,50,-13,32
Wellington P,511,9,5,6,16,31,55,-24,21
CC Mariners,511,10,4,8,15,28,49,-21,20
Sydney FC,512,1,21,4,3,68,23,45,67
N'castle Jet,512,2,16,5,7,60,39,21,53
Melbourne C,512,3,14,4,11,45,36,9,46
Melbourne V,512,4,13,5,11,46,42,4,44
Adelaide Utd,512,5,11,6,11,37,40,-3,39
Brisbane,512,6,10,5,13,33,42,-9,35
Western Sydn,512,7,8,9,10,38,47,-9,33
Perth Glory,512,8,10,2,15,37,50,-13,32
Wellington P,512,9,5,6,16,31,55,-24,21
CC Mariners,512,10,4,8,15,28,49,-21,20
Sydney FC,513,1,21,4,3,66,23,43,67
N'castle Jet,513,2,16,5,7,61,37,24,53
Melbourne C,513,3,14,4,11,43,37,6,46
Melbourne V,513,4,13,5,11,46,40,6,44
Adelaide Utd,513,5,11,6,11,37,40,-3,39
Brisbane,513,6,10,5,13,33,42,-9,35
Western Sydn,513,7,8,9,10,38,47,-9,33
Perth Glory,513,8,10,2,15,37,50,-13,32
Wellington P,513,9,5,6,16,31,55,-24,21
CC Mariners,513,10,4,8,15,28,49,-21,20
Sydney FC,514,1,20,5,3,65,23,42,65
N'castle Jet,514,2,16,5,7,58,37,21,53
Melbourne C,514,3,14,4,11,43,34,9,46
Melbourne V,514,4,13,6,10,46,39,7,45
Adelaide Utd,514,5,11,6,11,37,40,-3,39
Brisbane,514,6,10,5,13,33,42,-9,35
Western Sydn,514,7,8,9,10,38,47,-9,33
Perth Glory,514,8,10,2,15,37,50,-13,32
Wellington P,514,9,5,6,16,31,55,-24,21
CC Mariners,514,10,4,8,15,28,49,-21,20
Sydney FC,515,1,20,5,3,65,23,42,65
N'castle Jet,515,2,16,5,7,58,37,21,53
Melbourne C,515,3,14,4,11,43,34,9,46
Melbourne V,515,4,13,6,10,46,39,7,45
Adelaide Utd,515,5,11,6,11,37,40,-3,39
Brisbane,515,6,10,5,13,33,42,-9,35
Western Sydn,515,7,8,9,10,38,47,-9,33
Perth Glory,515,8,10,2,15,37,50,-13,32
Wellington P,515,9,5,6,16,31,55,-24,21
CC Mariners,515,10,4,8,15,28,49,-21,20
Sydney FC,516,1,21,4,3,67,23,44,67
N'castle Jet,516,2,15,5,8,57,38,19,50
Melbourne C,516,3,15,4,10,44,33,11,49
Melbourne V,516,4,13,5,11,46,41,5,44
Adelaide Utd,516,5,11,6,11,37,40,-3,39
Brisbane,516,6,10,5,13,33,42,-9,35
Western Sydn,516,7,8,9,10,38,47,-9,33
Perth Glory,516,8,10,2,15,37,50,-13,32
Wellington P,516,9,5,6,16,31,55,-24,21
CC Mariners,516,10,4,8,15,28,49,-21,20
Sydney FC,517,1,20,4,4,65,26,39,64
N'castle Jet,517,2,15,6,7,58,38,20,51
Melbourne V,517,3,14,5,10,49,39,10,47
Melbourne C,517,4,14,5,10,44,34,10,47
Adelaide Utd,517,5,11,6,11,37,40,-3,39
Brisbane,517,6,10,5,13,33,42,-9,35
Western Sydn,517,7,8,9,10,38,47,-9,33
Perth Glory,517,8,10,2,15,37,50,-13,32
Wellington P,517,9,5,6,16,31,55,-24,21
CC Mariners,517,10,4,8,15,28,49,-21,20
Sydney FC,518,1,21,4,3,66,23,43,67
N'castle Jet,518,2,15,5,8,58,40,18,50
Melbourne C,518,3,15,4,10,46,34,12,49
Melbourne V,518,4,13,5,11,46,40,6,44
Adelaide Utd,518,5,11,6,11,37,40,-3,39
Brisbane,518,6,10,5,13,33,42,-9,35
Western Sydn,518,7,8,9,10,38,47,-9,33
Perth Glory,518,8,10,2,15,37,50,-13,32
Wellington P,518,9,5,6,16,31,55,-24,21
CC Mariners,518,10,4,8,15,28,49,-21,20
Sydney FC,519,1,21,4,3,66,23,43,67
N'castle Jet,519,2,16,5,7,64,38,26,53
Melbourne C,519,3,14,4,11,44,40,4,46
Melbourne V,519,4,13,5,11,46,40,6,44
Adelaide Utd,519,5,11,6,11,37,40,-3,39
Brisbane,519,6,10,5,13,33,42,-9,35
Western Sydn,519,7,8,9,10,38,47,-9,33
Perth Glory,519,8,10,2,15,37,50,-13,32
Wellington P,519,9,5,6,16,31,55,-24,21
CC Mariners,519,10,4,8,15,28,49,-21,20
Sydney FC,520,1,20,5,3,65,23,42,65
N'castle Jet,520,2,15,5,8,57,40,17,50
Melbourne C,520,3,15,4,10,46,33,13,49
Melbourne V,520,4,13,6,10,46,39,7,45
Adelaide Utd,520,5,11,6,11,37,40,-3,39
Brisbane,520,6,10,5,13,33,42,-9,35
Western Sydn,520,7,8,9,10,38,47,-9,33
Perth Glory,520,8,10,2,15,37,50,-13,32
Wellington P,520,9,5,6,16,31,55,-24,21
CC Mariners,520,10,4,8,15,28,49,-21,20
Sydney FC,521,1,21,4,3,66,23,43,67
N'castle Jet,521,2,16,5,7,58,37,21,53
Melbourne C,521,3,14,4,11,43,34,9,46
Melbourne V,521,4,13,5,11,46,40,6,44
Adelaide Utd,521,5,11,6,11,37,40,-3,39
Brisbane,521,6,10,5,13,33,42,-9,35
Western Sydn,521,7,8,9,10,38,47,-9,33
Perth Glory,521,8,10,2,15,37,50,-13,32
Wellington P,521,9,5,6,16,31,55,-24,21
CC Mariners,521,10,4,8,15,28,49,-21,20
Sydney FC,522,1,20,5,3,65,23,42,65
N'castle Jet,522,2,16,5,7,59,38,21,53
Melbourne C,522,3,14,4,11,44,35,9,46
Melbourne V,522,4,13,6,10,46,39,7,45
Adelaide Utd,522,5,11,6,11,37,40,-3,39
Brisbane,522,6,10,5,13,33,42,-9,35
Western Sydn,522,7,8,9,10,38,47,-9,33
Perth Glory,522,8,10,2,15,37,50,-13,32
Wellington P,522,9,5,6,16,31,55,-24,21
CC Mariners,522,10,4,8,15,28,49,-21,20
Sydney FC,523,1,20,4,4,66,25,41,64
N'castle Jet,523,2,16,5,7,60,39,21,53
Melbourne V,523,3,14,5,10,48,40,8,47
Melbourne C,523,4,14,4,11,45,36,9,46
Adelaide Utd,523,5,11,6,11,37,40,-3,39
Brisbane,523,6,10,5,13,33,42,-9,35
Western Sydn,523,7,8,9,10,38,47,-9,33
Perth Glory,523,8,10,2,15,37,50,-13,32
Wellington P,523,9,5,6,16,31,55,-24,21
CC Mariners,523,10,4,8,15,28,49,-21,20
Sydney FC,524,1,21,4,3,66,22,44,67
N'castle Jet,524,2,16,5,7,60,39,21,53
Melbourne C,524,3,14,4,11,45,36,9,46
Melbourne V,524,4,13,5,11,45,40,5,44
Adelaide Utd,524,5,11,6,11,37,40,-3,39
Brisbane,524,6,10,5,13,33,42,-9,35
Western Sydn,524,7,8,9,10,38,47,-9,33
Perth Glory,524,8,10,2,15,37,50,-13,32
Wellington P,524,9,5,6,16,31,55,-24,21
CC Mariners,524,10,4,8,15,28,49,-21,20
Sydney FC,525,1,21,4,3,65,22,43,67
N'castle Jet,525,2,16,5,7,60,38,22,53
Melbourne C,525,3,14,4,11,44,36,8,46
Melbourne V,525,4,13,5,11,45,39,6,44
Adelaide Utd,525,5,11,6,11,37,40,-3,39
Brisbane,525,6,10,5,13,33,42,-9,35
Western Sydn,525,7,8,9,10,38,47,-9,33
Perth Glory,525,8,10,2,15,37,50,-13,32
Wellington P,525,9,5,6,16,31,55,-24,21
CC Mariners,525,10,4,8,15,28,49,-21,20
Sydney FC,526,1,21,4,3,70,24,46,67
N'castle Jet,526,2,16,5,7,60,39,21,53
Melbourne C,526,3,14,4,11,45,36,9,46
Melbourne V,526,4,13,5,11,47,44,3,44
Adelaide Utd,526,5,11,6,11,37,40,-3,39
Brisbane,526,6,10,5,13,33,42,-9,35
Western Sydn,526,7,8,9,10,38,47,-9,33
Perth Glory,526,8,10,2,15,37,50,-13,32
Wellington P,526,9,5,6,16,31,55,-24,21
CC Mariners,526,10,4,8,15,28,49,-21,20
Sydney FC,527,1,21,4,3,68,22,46,67
N'castle Jet,527,2,15,6,7,58,38,20,51
Melbourne C,527,3,14,5,10,44,34,10,47
Melbourne V,527,4,13,5,11,45,42,3,44
Adelaide Utd,527,5,11,6,11,37,40,-3,39
Brisbane,527,6,10,5,13,33,42,-9,35
Western Sydn,527,7,8,9,10,38,47,-9,33
Perth Glory,527,8,10,2,15,37,50,-13,32
Wellington P,527,9,5,6,16,31,55,-24,21
CC Mariners,527,10,4,8,15,28,49,-21,20
Sydney FC,528,1,20,5,3,65,23,42,65
N'castle Jet,528,2,16,5,7,60,38,22,53
Melbourne C,528,3,14,4,11,44,36,8,46
Melbourne V,528,4,13,6,10,46,39,7,45
Adelaide Utd,528,5,11,6,11,37,40,-3,39
Brisbane,528,6,10,5,13,33,42,-9,35
Western Sydn,528,7,8,9,10,38,47,-9,33
Perth Glory,528,8,10,2,15,37,50,-13,32
Wellington P,528,9,5,6,16,31,55,-24,21
CC Mariners,528,10,4,8,15,28,49,-21,20
Sydney FC,529,1,21,4,3,67,22,45,67
N'castle Jet,529,2,16,5,7,59,38,21,53
Melbourne C,529,3,14,4,11,44,35,9,46
Melbourne V,529,4,13,5,11,45,41,4,44
Adelaide Utd,529,5,11,6,11,37,40,-3,39
Brisbane,529,6,10,5,13,33,42,-9,35
Western Sydn,529,7,8,9,10,38,47,-9,33
Perth Glory,529,8,10,2,15,37,50,-13,32
Wellington P,529,9,5,6,16,31,55,-24,21
CC Mariners,529,10,4,8,15,28,49,-21,20
Sydney FC,530,1,21,4,3,68,23,45,67
N'castle Jet,530,2,16,5,7,60,38,22,53
Melbourne C,530,3,14,4,11,44,36,8,46
Melbourne V,530,4,13,5,11,46,42,4,44
Adelaide Utd,530,5,11,6,11,37,40,-3,39
Brisbane,530,6,10,5,13,33,42,-9,35
Western Sydn,530,7,8,9,10,38,47,-9,33
Perth Glory,530,8,10,2,15,37,50,-13,32
Wellington P,530,9,5,6,16,31,55,-24,21
CC Mariners,530,10,4,8,15,28,49,-21,20
Sydney FC,531,1,21,4,3,66,23,43,67
N'castle Jet,531,2,15,6,7,57,37,20,51
Melbourne C,531,3,14,5,10,43,33,10,47
Melbourne V,531,4,13,5,11,46,40,6,44
Adelaide Utd,531,5,11,6,11,37,40,-3,39
Brisbane,531,6,10,5,13,33,42,-9,35
Western Sydn,531,7,8,9,10,38,47,-9,33
Perth Glory,531,8,10,2,15,37,50,-13,32
Wellington P,531,9,5,6,16,31,55,-24,21
CC Mariners,531,10,4,8,15,28,49,-21,20
Sydney FC,532,1,21,4,3,67,23,44,67
N'castle Jet,532,2,16,5,7,59,37,22,53
Melbourne C,532,3,14,4,11,43,35,8,46
Melbourne V,532,4,13,5,11,46,41,5,44
Adelaide Utd,532,5,11,6,11,37,40,-3,39
Brisbane,532,6,10,5,13,33,42,-9,35
Western Sydn,532,7,8,9,10,38,47,-9,33
Perth Glory,532,8,10,2,15,37,50,-13,32
Wellington P,532,9,5,6,16,31,55,-24,21
CC Mariners,532,10,4,8,15,28,49,-21,20
Sydney FC,533,1,21,4,3,68,23,45,67
N'castle Jet,533,2,16,5,7,58,37,21,53
Melbourne C,533,3,14,4,11,43,34,9,46
Melbourne V,533,4,13,5,11,46,42,4,44
Adelaide Utd,533,5,11,6,11,37,40,-3,39
Brisbane,533,6,10,5,13,33,42,-9,35
Western Sydn,533,7,8,9,10,38,47,-9,33
Perth Glory,533,8,10,2,15,37,50,-13,32
Wellington P,533,9,5,6,16,31,55,-24,21
CC Mariners,533,10,4,8,15,28,49,-21,20
Sydney FC,534,1,21,4,3,65,22,43,67
N'castle Jet,534,2,16,5,7,60,38,22,53
Melbourne C,534,3,14,4,11,44,36,8,46
Melbourne V,534,4,13,5,11,45,39,6,44
Adelaide Utd,534,5,11,6,11,37,40,-3,39
Brisbane,534,6,10,5,13,33,42,-9,35
Western Sydn,534,7,8,9,10,38,47,-9,33
Perth Glory,534,8,10,2,15,37,50,-13,32
Wellington P,534,9,5,6,16,31,55,-24,21
CC Mariners,534,10,4,8,15,28,49,-21,20
Sydney FC,535,1,20,5,3,64,22,42,65
N'castle Jet,535,2,16,5,7,61,38,23,53
Melbourne C,535,3,14,4,11,44,37,7,46
Melbourne V,535,4,13,6,10,45,38,7,45
Adelaide Utd,535,5,11,6,11,37,40,-3,39
Brisbane,535,6,10,5,13,33,42,-9,35
Western Sydn,535,7,8,9,10,38,47,-9,33
Perth Glory,535,8,10,2,15,37,50,-13,32
Wellington P,535,9,5,6,16,31,55,-24,21
CC Mariners,535,10,4,8,15,28,49,-21,20
Sydney FC,536,1,20,4,4,65,24,41,64
N'castle Jet,536,2,15,5,8,59,41,18,50
Melbourne C,536,3,15,4,10,47,35,12,49
Melbourne V,536,4,14,5,10,47,39,8,47
Adelaide Utd,536,5,11,6,11,37,40,-3,39
Brisbane,536,6,10,5,13,33,42,-9,35
Western Sydn,536,7,8,9,10,38,47,-9,33
Perth Glory,536,8,10,2,15,37,50,-13,32
Wellington P,536,9,5,6,16,31,55,-24,21
CC Mariners,536,10,4,8,15,28,49,-21,20
Sydney FC,537,1,20,5,3,66,24,42,65
N'castle Jet,537,2,15,6,7,57,37,20,51
Melbourne C,537,3,14,5,10,43,33,10,47
Melbourne V,537,4,13,6,10,47,40,7,45
Adelaide Utd,537,5,11,6,11,37,40,-3,39
Brisbane,537,6,10,5,13,33,42,-9,35
Western Sydn,537,7,8,9,10,38,47,-9,33
Perth Glory,537,8,10,2,15,37,50,-13,32
Wellington P,537,9,5,6,16,31,55,-24,21
CC Mariners,537,10,4,8,15,28,49,-21,20
Sydney FC,538,1,21,4,3,67,24,43,67
N'castle Jet,538,2,16,5,7,60,37,23,53
Melbourne C,538,3,14,4,11,43,36,7,46
Melbourne V,538,4,13,5,11,47,41,6,44
Adelaide Utd,538,5,11,6,11,37,40,-3,39
Brisbane,538,6,10,5,13,33,42,-9,35
Western Sydn,538,7,8,9,10,38,47,-9,33
Perth Glory,538,8,10,2,15,37,50,-13,32
Wellington P,538,9,5,6,16,31,55,-24,21
CC Mariners,538,10,4,8,15,28,49,-21,20
Sydney FC,539,1,21,4,3,66,23,43,67
N'castle Jet,539,2,16,5,7,58,37,21,53
Melbourne C,539,3,14,4,11,43,34,9,46
Melbourne V,539,4,13,5,11,46,40,6,44
Adelaide Utd,539,5,11,6,11,37,40,-3,39
Brisbane,539,6,10,5,13,33,42,-9,35
Western Sydn,539,7,8,9,10,38,47,-9,33
Perth Glory,539,8,10,2,15,37,50,-13,32
Wellington P,539,9,5,6,16,31,55,-24,21
CC Mariners,539,10,4,8,15,28,49,-21,20
Sydney FC,540,1,21,4,3,66,22,44,67
N'castle Jet,540,2,16,5,7,61,38,23,53
Melbourne C,540,3,14,4,11,44,37,7,46
Melbourne V,540,4,13,5,11,45,40,5,44
Adelaide Utd,540,5,11,6,11,37,40,-3,39
Brisbane,540,6,10,5,13,33,42,-9,35
Western Sydn,540,7,8,9,10,38,47,-9,33
Perth Glory,540,8,10,2,15,37,50,-13,32
Wellington P,540,9,5,6,16,31,55,-24,21
CC Mariners,540,10,4,8,15,28,49,-21,20
Sydney FC,541,1,20,4,4,64,23,41,64
N'castle Jet,541,2,16,5,7,62,38,24,53
Melbourne V,541,3,14,5,10,46,38,8,47
Melbourne C,541,4,14,4,11,44,38,6,46
Adelaide Utd,541,5,11,6,11,37,40,-3,39
Brisbane,541,6,10,5,13,33,42,-9,35
Western Sydn,541,7,8,9,10,38,47,-9,33
Perth Glory,541,8,10,2,15,37,50,-13,32
Wellington P,541,9,5,6,16,31,55,-24,21
CC Mariners,541,10,4,8,15,28,49,-21,20
Sydney FC,542,1,21,4,3,67,23,44,67
N'castle Jet,542,2,16,5,7,59,37,22,53
Melbourne C,542,3,14,4,11,43,35,8,46
Melbourne V,542,4,13,5,11,46,41,5,44
Adelaide Utd,542,5,11,6,11,37,40,-3,39
Brisbane,542,6,10,5,13,33,42,-9,35
Western Sydn,542,7,8,9,10,38,47,-9,33
Perth Glory,542,8,10,2,15,37,50,-13,32
Wellington P,542,9,5,6,16,31,55,-24,21
CC Mariners,542,10,4,8,15,28,49,-21,20
Sydney FC,543,1,20,5,3,66,24,42,65
N'castle Jet,543,2,16,5,7,59,37,22,53
Melbourne C,543,3,14,4,11,43,35,8,46
Melbourne V,543,4,13,6,10,47,40,7,45
Adelaide Utd,543,5,11,6,11,37,40,-3,39
Brisbane,543,6,10,5,13,33,42,-9,35
Western Sydn,543,7,8,9,10,38,47,-9,33
Perth Glory,543,8,10,2,15,37,50,-13,32
Wellington P,543,9,5,6,16,31,55,-24,21
CC Mariners,543,10,4,8,15,28,49,-21,20
Sydney FC,544,1,20,5,3,64,22,42,65
N'castle Jet,544,2,15,6,7,59,39,20,51
Melbourne C,544,3,14,5,10,45,35,10,47
Melbourne V,544,4,13,6,10,45,38,7,45
Adelaide Utd,544,5,11,6,11,37,40,-3,39
Brisbane,544,6,10,5,13,33,42,-9,35
Western Sydn,544,7,8,9,10,38,47,-9,33
Perth Glory,544,8,10,2,15,37,50,-13,32
Wellington P,544,9,5,6,16,31,55,-24,21
CC Mariners,544,10,4,8,15,28,49,-21,20
Sydney FC,545,1,21,4,3,65,22,43,67
N'castle Jet,545,2,15,5,8,57,38,19,50
Melbourne C,545,3,15,4,10,44,33,11,49
Melbourne V,545,4,13,5,11,45,39,6,44
Adelaide Utd,545,5,11,6,11,37,40,-3,39
Brisbane,545,6,10,5,13,33,42,-9,35
Western Sydn,545,7,8,9,10,38,47,-9,33
Perth Glory,545,8,10,2,15,37,50,-13,32
Wellington P,545,9,5,6,16,31,55,-24,21
CC Mariners,545,10,4,8,15,28,49,-21,20
Sydney FC,546,1,20,5,3,66,24,42,65
N'castle Jet,546,2,15,6,7,57,37,20,51
Melbourne C,546,3,14,5,10,43,33,10,47
Melbourne V,546,4,13,6,10,47,40,7,45
Adelaide Utd,546,5,11,6,11,37,40,-3,39
Brisbane,546,6,10,5,13,33,42,-9,35
Western Sydn,546,7,8,9,10,38,47,-9,33
Perth Glory,546,8,10,2,15,37,50,-13,32
Wellington P,546,9,5,6,16,31,55,-24,21
CC Mariners,546,10,4,8,15,28,49,-21,20
Sydney FC,547,1,21,4,3,66,22,44,67
N'castle Jet,547,2,15,5,8,59,40,19,50
Melbourne C,547,3,15,4,10,46,35,11,49
Melbourne V,547,4,13,5,11,45,40,5,44
Adelaide Utd,547,5,11,6,11,37,40,-3,39
Brisbane,547,6,10,5,13,33,42,-9,35
Western Sydn,547,7,8,9,10,38,47,-9,33
Perth Glory,547,8,10,2,15,37,50,-13,32
Wellington P,547,9,5,6,16,31,55,-24,21
CC Mariners,547,10,4,8,15,28,49,-21,20
Sydney FC,548,1,20,5,3,65,23,42,65
N'castle Jet,548,2,16,5,7,60,38,22,53
Melbourne C,548,3,14,4,11,44,36,8,46
Melbourne V,548,4,13,6,10,46,39,7,45
Adelaide Utd,548,5,11,6,11,37,40,-3,39
Brisbane,548,6,10,5,13,33,42,-9,35
Western Sydn,548,7,8,9,10,38,47,-9,33
Perth Glory,548,8,10,2,15,37,50,-13,32
Wellington P,548,9,5,6,16,31,55,-24,21
CC Mariners,548,10,4,8,15,28,49,-21,20
Sydney FC,549,1,21,4,3,66,22,44,67
N'castle Jet,549,2,16,5,7,58,37,21,53
Melbourne C,549,3,14,4,11,43,34,9,46
Melbourne V,549,4,13,5,11,45,40,5,44
Adelaide Utd,549,5,11,6,11,37,40,-3,39
Brisbane,549,6,10,5,13,33,42,-9,35
Western Sydn,549,7,8,9,10,38,47,-9,33
Perth Glory,549,8,10,2,15,37,50,-13,32
Wellington P,549,9,5,6,16,31,55,-24,21
CC Mariners,549,10,4,8,15,28,49,-21,20
Sydney FC,550,1,21,4,3,66,23,43,67
N'castle Jet,550,2,16,5,7,59,38,21,53
Melbourne C,550,3,14,4,11,44,35,9,46
Melbourne V,550,4,13,5,11,46,40,6,44
Adelaide Utd,550,5,11,6,11,37,40,-3,39
Brisbane,550,6,10,5,13,33,42,-9,35
Western Sydn,550,7,8,9,10,38,47,-9,33
Perth Glory,550,8,10,2,15,37,50,-13,32
Wellington P,550,9,5,6,16,31,55,-24,21
CC Mariners,550,10,4,8,15,28,49,-21,20
Sydney FC,551,1,21,4,3,66,23,43,67
N'castle Jet,551,2,16,5,7,58,37,21,53
Melbourne C,551,3,14,4,11,43,34,9,46
Melbourne V,551,4,13,5,11,46,40,6,44
Adelaide Utd,551,5,11,6,11,37,40,-3,39
Brisbane,551,6,10,5,13,33,42,-9,35
Western Sydn,551,7,8,9,10,38,47,-9,33
Perth Glory,551,8,10,2,15,37,50,-13,32
Wellington P,551,9,5,6,16,31,55,-24,21
CC Mariners,551,10,4,8,15,28,49,-21,20
Sydney FC,552,1,21,4,3,66,22,44,67
N'castle Jet,552,2,15,6,7,58,38,20,51
Melbourne C,552,3,14,5,10,44,34,10,47
Melbourne V,552,4,13,5,11,45,40,5,44
Adelaide Utd,552,5,11,6,11,37,40,-3,39
Brisbane,552,6,10,5,13,33,42,-9,35
Western Sydn,552,7,8,9,10,38,47,-9,33
Perth Glory,552,8,10,2,15,37,50,-13,32
Wellington P,552,9,5,6,16,31,55,-24,21
CC Mariners,552,10,4,8,15,28,49,-21,20
Sydney FC,553,1,20,4,4,65,24,41,64
N'castle Jet,553,2,15,5,8,58,42,16,50
Melbourne C,553,3,15,4,10,48,34,14,49
Melbourne V,553,4,14,5,10,47,39,8,47
Adelaide Utd,553,5,11,6,11,37,40,-3,39
Brisbane,553,6,10,5,13,33,42,-9,35
Western Sydn,553,7,8,9,10,38,47,-9,33
Perth Glory,553,8,10,2,15,37,50,-13,32
Wellington P,553,9,5,6,16,31,55,-24,21
CC Mariners,553,10,4,8,15,28,49,-21,20
Sydney FC,554,1,21,4,3,67,22,45,67
N'castle Jet,554,2,16,5,7,59,37,22,53
Melbourne C,554,3,14,4,11,43,35,8,46
Melbourne V,554,4,13,5,11,45,41,4,44
Adelaide Utd,554,5,11,6,11,37,40,-3,39
Brisbane,554,6,10,5,13,33,42,-9,35
Western Sydn,554,7,8,9,10,38,47,-9,33
Perth Glory,554,8,10,2,15,37,50,-13,32
Wellington P,554,9,5,6,16,31,55,-24,21
CC Mariners,554,10,4,8,15,28,49,-21,20
Sydney FC,555,1,21,4,3,66,22,44,67
N'castle Jet,555,2,16,5,7,59,37,22,53
Melbourne C,555,3,14,4,11,43,35,8,46
Melbourne V,555,4,13,5,11,45,40,5,44
Adelaide Utd,555,5,11,6,11,37,40,-3,39
Brisbane,555,6,10,5,13,33,42,-9,35
Western Sydn,555,7,8,9,10,38,47,-9,33
Perth Glory,555,8,10,2,15,37,50,-13,32
Wellington P,555,9,5,6,16,31,55,-24,21
CC Mariners,555,10,4,8,15,28,49,-21,20
Sydney FC,556,1,21,4,3,65,22,43,67
N'castle Jet,556,2,15,5,8,58,41,17,50
Melbourne C,556,3,15,4,10,47,34,13,49
Melbourne V,556,4,13,5,11,45,39,6,44
Adelaide Utd,556,5,11,6,11,37,40,-3,39
Brisbane,556,6,10,5,13,33,42,-9,35
Western Sydn,556,7,8,9,10,38,47,-9,33
Perth Glory,556,8,10,2,15,37,50,-13,32
Wellington P,556,9,5,6,16,31,55,-24,21
CC Mariners,556,10,4,8,15,28,49,-21,20
Sydney FC,557,1,20,4,4,65,24,41,64
N'castle Jet,557,2,16,5,7,61,40,21,53
Melbourne V,557,3,14,5,10,47,39,8,47
Melbourne C,557,4,14,4,11,46,37,9,46
Adelaide Utd,557,5,11,6,11,37,40,-3,39
Brisbane,557,6,10,5,13,33,42,-9,35
Western Sydn,557,7,8,9,10,38,47,-9,33
Perth Glory,557,8,10,2,15,37,50,-13,32
Wellington P,557,9,5,6,16,31,55,-24,21
CC Mariners,557,10,4,8,15,28,49,-21,20
Sydney FC,558,1,21,4,3,68,22,46,67
N'castle Jet,558,2,16,5,7,58,37,21,53
Melbourne C,558,3,14,4,11,43,34,9,46
Melbourne V,558,4,13,5,11,45,42,3,44
Adelaide Utd,558,5,11,6,11,37,40,-3,39
Brisbane,558,6,10,5,13,33,42,-9,35
Western Sydn,558,7,8,9,10,38,47,-9,33
Perth Glory,558,8,10,2,15,37,50,-13,32
Wellington P,558,9,5,6,16,31,55,-24,21
CC Mariners,558,10,4,8,15,28,49,-21,20
Sydney FC,559,1,20,5,3,66,24,42,65
N'castle Jet,559,2,15,6,7,58,38,20,51
Melbourne C,559,3,14,5,10,44,34,10,47
Melbourne V,559,4,13,6,10,47,40,7,45
Adelaide Utd,559,5,11,6,11,37,40,-3,39
Brisbane,559,6,10,5,13,33,42,-9,35
Western Sydn,559,7,8,9,10,38,47,-9,33
Perth Glory,559,8,10,2,15,37,50,-13,32
Wellington P,559,9,5,6,16,31,55,-24,21
CC Mariners,559,10,4,8,15,28,49,-21,20
Sydney FC,560,1,20,5,3,65,23,42,65
N'castle Jet,560,2,15,5,8,58,39,19,50
Melbourne C,560,3,15,4,10,45,34,11,49
Melbourne V,560,4,13,6,10,46,39,7,45
Adelaide Utd,560,5,11,6,11,37,40,-3,39
Brisbane,560,6,10,5,13,33,42,-9,35
Western Sydn,560,7,8,9,10,38,47,-9,33
Perth Glory,560,8,10,2,15,37,50,-13,32
Wellington P,560,9,5,6,16,31,55,-24,21
CC Mariners,560,10,4,8,15,28,49,-21,20
Sydney FC,561,1,20,5,3,65,23,42,65
N'castle Jet,561,2,16,5,7,59,37,22,53
Melbourne C,561,3,14,4,11,43,35,8,46
Melbourne V,561,4,13,6,10,46,39,7,45
Adelaide Utd,561,5,11,6,11,37,40,-3,39
Brisbane,561,6,10,5,13,33,42,-9,35
Western Sydn,561,7,8,9,10,38,47,-9,33
Perth Glory,561,8,10,2,15,37,50,-13,32
Wellington P,561,9,5,6,16,31,55,-24,21
CC Mariners,561,10,4,8,15,28,49,-21,20
Sydney FC,562,1,21,4,3,68,22,46,67
N'castle Jet,562,2,16,5,7,59,38,21,53
Melbourne C,562,3,14,4,11,44,35,9,46
Melbourne V,562,4,13,5,11,45,42,3,44
Adelaide Utd,562,5,11,6,11,37,40,-3,39
Brisbane,562,6,10,5,13,33,42,-9,35
Western Sydn,562,7,8,9,10,38,47,-9,33
Perth Glory,562,8,10,2,15,37,50,-13,32
Wellington P,562,9,5,6,16,31,55,-24,21
CC Mariners,562,10,4,8,15,28,49,-21,20
Sydney FC,563,1,21,4,3,66,23,43,67
N'castle Jet,563,2,16,5,7,59,37,22,53
Melbourne C,563,3,14,4,11,43,35,8,46
Melbourne V,563,4,13,5,11,46,40,6,44
Adelaide Utd,563,5,11,6,11,37,40,-3,39
Brisbane,563,6,10,5,13,33,42,-9,35
Western Sydn,563,7,8,9,10,38,47,-9,33
Perth Glory,563,8,10,2,15,37,50,-13,32
Wellington P,563,9,5,6,16,31,55,-24,21
CC Mariners,563,10,4,8,15,28,49,-21,20
Sydney FC,564,1,20,5,3,66,24,42,65
N'castle Jet,564,2,15,5,8,58,39,19,50
Melbourne C,564,3,15,4,10,45,34,11,49
Melbourne V,564,4,13,6,10,47,40,7,45
Adelaide Utd,564,5,11,6,11,37,40,-3,39
Brisbane,564,6,10,5,13,33,42,-9,35
Western Sydn,564,7,8,9,10,38,47,-9,33
Perth Glory,564,8,10,2,15,37,50,-13,32
Wellington P,564,9,5,6,16,31,55,-24,21
CC Mariners,564,10,4,8,15,28,49,-21,20
Sydney FC,565,1,21,4,3,66,23,43,67
N'castle Jet,565,2,16,5,7,60,39,21,53
Melbourne C,565,3,14,4,11,45,36,9,46
Melbourne V,565,4,13,5,11,46,40,6,44
Adelaide Utd,565,5,11,6,11,37,40,-3,39
Brisbane,565,6,10,5,13,33,42,-9,35
Western Sydn,565,7,8,9,10,38,47,-9,33
Perth Glory,565,8,10,2,15,37,50,-13,32
Wellington P,565,9,5,6,16,31,55,-24,21
CC Mariners,565,10,4,8,15,28,49,-21,20
Sydney FC,566,1,21,4,3,68,24,44,67
N'castle Jet,566,2,16,5,7,59,38,21,53
Melbourne C,566,3,14,4,11,44,35,9,46
Melbourne V,566,4,13,5,11,47,42,5,44
Adelaide Utd,566,5,11,6,11,37,40,-3,39
Brisbane,566,6,10,5,13,33,42,-9,35
Western Sydn,566,7,8,9,10,38,47,-9,33
Perth Glory,566,8,10,2,15,37,50,-13,32
Wellington P,566,9,5,6,16,31,55,-24,21
CC Mariners,566,10,4,8,15,28,49,-21,20
Sydney FC,567,1,20,4,4,66,25,41,64
N'castle Jet,567,2,15,5,8,59,40,19,50
Melbourne C,567,3,15,4,10,46,35,11,49
Melbourne V,567,4,14,5,10,48,40,8,47
Adelaide Utd,567,5,11,6,11,37,40,-3,39
Brisbane,567,6,10,5,13,33,42,-9,35
Western Sydn,567,7,8,9,10,38,47,-9,33
Perth Glory,567,8,10,2,15,37,50,-13,32
Wellington P,567,9,5,6,16,31,55,-24,21
CC Mariners,567,10,4,8,15,28,49,-21,20
Sydney FC,568,1,20,4,4,66,26,40,64
N'castle Jet,568,2,16,5,7,60,38,22,53
Melbourne V,568,3,14,5,10,49,40,9,47
Melbourne C,568,4,14,4,11,44,36,8,46
Adelaide Utd,568,5,11,6,11,37,40,-3,39
Brisbane,568,6,10,5,13,33,42,-9,35
Western Sydn,568,7,8,9,10,38,47,-9,33
Perth Glory,568,8,10,2,15,37,50,-13,32
Wellington P,568,9,5,6,16,31,55,-24,21
CC Mariners,568,10,4,8,15,28,49,-21,20
Sydney FC,569,1,21,4,3,65,22,43,67
N'castle Jet,569,2,15,6,7,58,38,20,51
Melbourne C,569,3,14,5,10,44,34,10,47
Melbourne V,569,4,13,5,11,45,39,6,44
Adelaide Utd,569,5,11,6,11,37,40,-3,39
Brisbane,569,6,10,5,13,33,42,-9,35
Western Sydn,569,7,8,9,10,38,47,-9,33
Perth Glory,569,8,10,2,15,37,50,-13,32
Wellington P,569,9,5,6,16,31,55,-24,21
CC Mariners,569,10,4,8,15,28,49,-21,20
Sydney FC,570,1,20,5,3,65,23,42,65
N'castle Jet,570,2,16,5,7,58,37,21,53
Melbourne C,570,3,14,4,11,43,34,9,46
Melbourne V,570,4,13,6,10,46,39,7,45
Adelaide Utd,570,5,11,6,11,37,40,-3,39
Brisbane,570,6,10,5,13,33,42,-9,35
Western Sydn,570,7,8,9,10,38,47,-9,33
Perth Glory,570,8,10,2,15,37,50,-13,32
Wellington P,570,9,5,6,16,31,55,-24,21
CC Mariners,570,10,4,8,15,28,49,-21,20
Sydney FC,571,1,21,4,3,67,23,44,67
N'castle Jet,571,2,16,5,7,58,37,21,53
Melbourne C,571,3,14,4,11,43,34,9,46
Melbourne V,571,4,13,5,11,46,41,5,44
Adelaide Utd,571,5,11,6,11,37,40,-3,39
Brisbane,571,6,10,5,13,33,42,-9,35
Western Sydn,571,7,8,9,10,38,47,-9,33
Perth Glory,571,8,10,2,15,37,50,-13,32
Wellington P,571,9,5,6,16,31,55,-24,21
CC Mariners,571,10,4,8,15,28,49,-21,20
Sydney FC,572,1,21,4,3,68,24,44,67
N'castle Jet,572,2,15,5,8,58,39,19,50
Melbourne C,572,3,15,4,10,45,34,11,49
Melbourne V,572,4,13,5,11,47,42,5,44
Adelaide Utd,572,5,11,6,11,37,40,-3,39
Brisbane,572,6,10,5,13,33,42,-9,35
Western Sydn,572,7,8,9,10,38,47,-9,33
Perth Glory,572,8,10,2,15,37,50,-13,32
Wellington P,572,9,5,6,16,31,55,-24,21
CC Mariners,572,10,4,8,15,28,49,-21,20
Sydney FC,573,1,20,4,4,65,24,41,64
N'castle Jet,573,2,16,5,7,58,37,21,53
Melbourne V,573,3,14,5,10,47,39,8,47
Melbourne C,573,4,14,4,11,43,34,9,46
Adelaide Utd,573,5,11,6,11,37,40,-3,39
Brisbane,573,6,10,5,13,33,42,-9,35
Western Sydn,573,7,8,9,10,38,47,-9,33
Perth Glory,573,8,10,2,15,37,50,-13,32
Wellington P,573,9,5,6,16,31,55,-24,21
CC Mariners,573,10,4,8,15,28,49,-21,20
Sydney FC,574,1,20,5,3,65,23,42,65
N'castle Jet,574,2,16,5,7,61,38,23,53
Melbourne C,574,3,14,4,11,44,37,7,46
Melbourne V,574,4,13,6,10,46,39,7,45
Adelaide Utd,574,5,11,6,11,37,40,-3,39
Brisbane,574,6,10,5,13,33,42,-9,35
Western Sydn,574,7,8,9,10,38,47,-9,33
Perth Glory,574,8,10,2,15,37,50,-13,32
Wellington P,574,9,5,6,16,31,55,-24,21
CC Mariners,574,10,4,8,15,28,49,-21,20
Sydney FC,575,1,21,4,3,66,22,44,67
N'castle Jet,575,2,15,5,8,59,42,17,50
Melbourne C,575,3,15,4,10,48,35,13,49
Melbourne V,575,4,13,5,11,45,40,5,44
Adelaide Utd,575,5,11,6,11,37,40,-3,39
Brisbane,575,6,10,5,13,33,42,-9,35
Western Sydn,575,7,8,9,10,38,47,-9,33
Perth Glory,575,8,10,2,15,37,50,-13,32
Wellington P,575,9,5,6,16,31,55,-24,21
CC Mariners,575,10,4,8,15,28,49,-21,20
Sydney FC,576,1,21,4,3,66,22,44,67
N'castle Jet,576,2,16,5,7,60,38,22,53
Melbourne C,576,3,14,4,11,44,36,8,46
Melbourne V,576,4,13,5,11,45,40,5,44
Adelaide Utd,576,5,11,6,11,37,40,-3,39
Brisbane,576,6,10,5,13,33,42,-9,35
Western Sydn,576,7,8,9,10,38,47,-9,33
Perth Glory,576,8,10,2,15,37,50,-13,32
Wellington P,576,9,5,6,16,31,55,-24,21
CC Mariners,576,10,4,8,15,28,49,-21,20
Sydney FC,577,1,21,4,3,65,22,43,67
N'castle Jet,577,2,16,5,7,59,37,22,53
Melbourne C,577,3,14,4,11,43,35,8,46
Melbourne V,577,4,13,5,11,45,39,6,44
Adelaide Utd,577,5,11,6,11,37,40,-3,39
Brisbane,577,6,10,5,13,33,42,-9,35
Western Sydn,577,7,8,9,10,38,47,-9,33
Perth Glory,577,8,10,2,15,37,50,-13,32
Wellington P,577,9,5,6,16,31,55,-24,21
CC Mariners,577,10,4,8,15,28,49,-21,20
Sydney FC,578,1,21,4,3,69,22,47,67
N'castle Jet,578,2,15,6,7,58,38,20,51
Melbourne C,578,3,14,5,10,44,34,10,47
Melbourne V,578,4,13,5,11,45,43,2,44
Adelaide Utd,578,5,11,6,11,37,40,-3,39
Brisbane,578,6,10,5,13,33,42,-9,35
Western Sydn,578,7,8,9,10,38,47,-9,33
Perth Glory,578,8,10,2,15,37,50,-13,32
Wellington P,578,9,5,6,16,31,55,-24,21
CC Mariners,578,10,4,8,15,28,49,-21,20
Sydney FC,579,1,20,5,3,65,23,42,65
N'castle Jet,579,2,16,5,7,60,38,22,53
Melbourne C,579,3,14,4,11,44,36,8,46
Melbourne V,579,4,13,6,10,46,39,7,45
Adelaide Utd,579,5,11,6,11,37,40,-3,39
Brisbane,579,6,10,5,13,33,42,-9,35
Western Sydn,579,7,8,9,10,38,47,-9,33
Perth Glory,579,8,10,2,15,37,50,-13,32
Wellington P,579,9,5,6,16,31,55,-24,21
CC Mariners,579,10,4,8,15,28,49,-21,20
Sydney FC,580,1,21,4,3,67,23,44,67
N'castle Jet,580,2,16,5,7,59,37,22,53
Melbourne C,580,3,14,4,11,43,35,8,46
Melbourne V,580,4,13,5,11,46,41,5,44
Adelaide Utd,580,5,11,6,11,37,40,-3,39
Brisbane,580,6,10,5,13,33,42,-9,35
Western Sydn,580,7,8,9,10,38,47,-9,33
Perth Glory,580,8,10,2,15,37,50,-13,32
Wellington P,580,9,5,6,16,31,55,-24,21
CC Mariners,580,10,4,8,15,28,49,-21,20
Sydney FC,581,1,20,4,4,64,23,41,64
N'castle Jet,581,2,16,5,7,59,38,21,53
Melbourne V,581,3,14,5,10,46,38,8,47
Melbourne C,581,4,14,4,11,44,35,9,46
Adelaide Utd,581,5,11,6,11,37,40,-3,39
Brisbane,581,6,10,5,13,33,42,-9,35
Western Sydn,581,7,8,9,10,38,47,-9,33
Perth Glory,581,8,10,2,15,37,50,-13,32
Wellington P,581,9,5,6,16,31,55,-24,21
CC Mariners,581,10,4,8,15,28,49,-21,20
Sydney FC,582,1,21,4,3,66,22,44,67
N'castle Jet,582,2,16,5,7,60,38,22,53
Melbourne C,582,3,14,4,11,44,36,8,46
Melbourne V,582,4,13,5,11,45,40,5,44
Adelaide Utd,582,5,11,6,11,37,40,-3,39
Brisbane,582,6,10,5,13,33,42,-9,35
Western Sydn,582,7,8,9,10,38,47,-9,33
Perth Glory,582,8,10,2,15,37,50,-13,32
Wellington P,582,9,5,6,16,31,55,-24,21
CC Mariners,582,10,4,8,15,28,49,-21,20
Sydney FC,583,1,21,4,3,67,23,44,67
N'castle Jet,583,2,16,5,7,59,38,21,53
Melbourne C,583,3,14,4,11,44,35,9,46
Melbourne V,583,4,13,5,11,46,41,5,44
Adelaide Utd,583,5,11,6,11,37,40,-3,39
Brisbane,583,6,10,5,13,33,42,-9,35
Western Sydn,583,7,8,9,10,38,47,-9,33
Perth Glory,583,8,10,2,15,37,50,-13,32
Wellington P,583,9,5,6,16,31,55,-24,21
CC Mariners,583,10,4,8,15,28,49,-21,20
Sydney FC,584,1,20,4,4,65,24,41,64
N'castle Jet,584,2,16,5,7,59,38,21,53
Melbourne V,584,3,14,5,10,47,39,8,47
Melbourne C,584,4,14,4,11,44,35,9,46
Adelaide Utd,584,5,11,6,11,37,40,-3,39
Brisbane,584,6,10,5,13,33,42,-9,35
Western Sydn,584,7,8,9,10,38,47,-9,33
Perth Glory,584,8,10,2,15,37,50,-13,32
Wellington P,584,9,5,6,16,31,55,-24,21
CC Mariners,584,10,4,8,15,28,49,-21,20
Sydney FC,585,1,20,5,3,65,23,42,65
N'castle Jet,585,2,15,5,8,58,40,18,50
Melbourne C,585,3,15,4,10,46,34,12,49
Melbourne V,585,4,13,6,10,46,39,7,45
Adelaide Utd,585,5,11,6,11,37,40,-3,39
Brisbane,585,6,10,5,13,33,42,-9,35
Western Sydn,585,7,8,9,10,38,47,-9,33
Perth Glory,585,8,10,2,15,37,50,-13,32
Wellington P,585,9,5,6,16,31,55,-24,21
CC Mariners,585,10,4,8,15,28,49,-21,20
Sydney FC,586,1,20,5,3,66,24,42,65
N'castle Jet,586,2,15,6,7,60,40,20,51
Melbourne C,586,3,14,5,10,46,36,10,47
Melbourne V,586,4,13,6,10,47,40,7,45
Adelaide Utd,586,5,11,6,11,37,40,-3,39
Brisbane,586,6,10,5,13,33,42,-9,35
Western Sydn,586,7,8,9,10,38,47,-9,33
Perth Glory,586,8,10,2,15,37,50,-13,32
Wellington P,586,9,5,6,16,31,55,-24,21
CC Mariners,586,10,4,8,15,28,49,-21,20
Sydney FC,587,1,21,4,3,66,22,44,67
N'castle Jet,587,2,16,5,7,58,37,21,53
Melbourne C,587,3,14,4,11,43,34,9,46
Melbourne V,587,4,13,5,11,45,40,5,44
Adelaide Utd,587,5,11,6,11,37,40,-3,39
Brisbane,587,6,10,5,13,33,42,-9,35
Western Sydn,587,7,8,9,10,38,47,-9,33
Perth Glory,587,8,10,2,15,37,50,-13,32
Wellington P,587,9,5,6,16,31,55,-24,21
CC Mariners,587,10,4,8,15,28,49,-21,20
Sydney FC,588,1,21,4,3,70,22,48,67
N'castle Jet,588,2,15,5,8,59,40,19,50
Melbourne C,588,3,15,4,10,46,35,11,49
Melbourne V,588,4,13,5,11,45,44,1,44
Adelaide Utd,588,5,11,6,11,37,40,-3,39
Brisbane,588,6,10,5,13,33,42,-9,35
Western Sydn,588,7,8,9,10,38,47,-9,33
Perth Glory,588,8,10,2,15,37,50,-13,32
Wellington P,588,9,5,6,16,31,55,-24,21
CC Mariners,588,10,4,8,15,28,49,-21,20
Sydney FC,589,1,20,4,4,64,23,41,64
N'castle Jet,589,2,15,5,8,58,39,19,50
Melbourne C,589,3,15,4,10,45,34,11,49
Melbourne V,589,4,14,5,10,46,38,8,47
Adelaide Utd,589,5,11,6,11,37,40,-3,39
Brisbane,589,6,10,5,13,33,42,-9,35
Western Sydn,589,7,8,9,10,38,47,-9,33
Perth Glory,589,8,10,2,15,37,50,-13,32
Wellington P,589,9,5,6,16,31,55,-24,21
CC Mariners,589,10,4,8,15,28,49,-21,20
Sydney FC,590,1,20,4,4,67,26,41,64
N'castle Jet,590,2,16,5,7,58,37,21,53
Melbourne V,590,3,14,5,10,49,41,8,47
Melbourne C,590,4,14,4,11,43,34,9,46
Adelaide Utd,590,5,11,6,11,37,40,-3,39
Brisbane,590,6,10,5,13,33,42,-9,35
Western Sydn,590,7,8,9,10,38,47,-9,33
Perth Glory,590,8,10,2,15,37,50,-13,32
Wellington P,590,9,5,6,16,31,55,-24,21
CC Mariners,590,10,4,8,15,28,49,-21,20
Sydney FC,591,1,21,4,3,68,23,45,67
N'castle Jet,591,2,16,5,7,60,37,23,53
Melbourne C,591,3,14,4,11,43,36,7,46
Melbourne V,591,4,13,5,11,46,42,4,44
Adelaide Utd,591,5,11,6,11,37,40,-3,39
Brisbane,591,6,10,5,13,33,42,-9,35
Western Sydn,591,7,8,9,10,38,47,-9,33
Perth Glory,591,8,10,2,15,37,50,-13,32
Wellington P,591,9,5,6,16,31,55,-24,21
CC Mariners,591,10,4,8,15,28,49,-21,20
Sydney FC,592,1,21,4,3,65,22,43,67
N'castle Jet,592,2,15,6,7,57,37,20,51
Melbourne C,592,3,14,5,10,43,33,10,47
Melbourne V,592,4,13,5,11,45,39,6,44
Adelaide Utd,592,5,11,6,11,37,40,-3,39
Brisbane,592,6,10,5,13,33,42,-9,35
Western Sydn,592,7,8,9,10,38,47,-9,33
Perth Glory,592,8,10,2,15,37,50,-13,32
Wellington P,592,9,5,6,16,31,55,-24,21
CC Mariners,592,10,4,8,15,28,49,-21,20
Sydney FC,593,1,20,5,3,66,24,42,65
N'castle Jet,593,2,16,5,7,59,37,22,53
Melbourne C,593,3,14,4,11,43,35,8,46
Melbourne V,593,4,13,6,10,47,40,7,45
Adelaide Utd,593,5,11,6,11,37,40,-3,39
Brisbane,593,6,10,5,13,33,42,-9,35
Western Sydn,593,7,8,9,10,38,47,-9,33
Perth Glory,593,8,10,2,15,37,50,-13,32
Wellington P,593,9,5,6,16,31,55,-24,21
CC Mariners,593,10,4,8,15,28,49,-21,20
Sydney FC,594,1,20,4,4,66,25,41,64
N'castle Jet,594,2,16,5,7,60,38,22,53
Melbourne V,594,3,14,5,10,48,40,8,47
Melbourne C,594,4,14,4,11,44,36,8,46
Adelaide Utd,594,5,11,6,11,37,40,-3,39
Brisbane,594,6,10,5,13,33,42,-9,35
Western Sydn,594,7,8,9,10,38,47,-9,33
Perth Glory,594,8,10,2,15,37,50,-13,32
Wellington P,594,9,5,6,16,31,55,-24,21
CC Mariners,594,10,4,8,15,28,49,-21,20
Sydney FC,595,1,21,4,3,69,26,43,67
N'castle Jet,595,2,16,5,7,58,37,21,53
Melbourne C,595,3,14,4,11,43,34,9,46
Melbourne V,595,4,13,5,11,49,43,6,44
Adelaide Utd,595,5,11,6,11,37,40,-3,39
Brisbane,595,6,10,5,13,33,42,-9,35
Western Sydn,595,7,8,9,10,38,47,-9,33
Perth Glory,595,8,10,2,15,37,50,-13,32
Wellington P,595,9,5,6,16,31,55,-24,21
CC Mariners,595,10,4,8,15,28,49,-21,20
Sydney FC,596,1,21,4,3,66,22,44,67
N'castle Jet,596,2,15,5,8,57,39,18,50
Melbourne C,596,3,15,4,10,45,33,12,49
Melbourne V,596,4,13,5,11,45,40,5,44
Adelaide Utd,596,5,11,6,11,37,40,-3,39
Brisbane,596,6,10,5,13,33,42,-9,35
Western Sydn,596,7,8,9,10,38,47,-9,33
Perth Glory,596,8,10,2,15,37,50,-13,32
Wellington P,596,9,5,6,16,31,55,-24,21
CC Mariners,596,10,4,8,15,28,49,-21,20
Sydney FC,597,1,20,5,3,66,24,42,65
N'castle Jet,597,2,15,5,8,57,38,19,50
Melbourne C,597,3,15,4,10,44,33,11,49
Melbourne V,597,4,13,6,10,47,40,7,45
Adelaide Utd,597,5,11,6,11,37,40,-3,39
Brisbane,597,6,10,5,13,33,42,-9,35
Western Sydn,597,7,8,9,10,38,47,-9,33
Perth Glory,597,8,10,2,15,37,50,-13,32
Wellington P,597,9,5,6,16,31,55,-24,21
CC Mariners,597,10,4,8,15,28,49,-21,20
Sydney FC,598,1,21,4,3,67,22,45,67
N'castle Jet,598,2,16,5,7,59,37,22,53
Melbourne C,598,3,14,4,11,43,35,8,46
Melbourne V,598,4,13,5,11,45,41,4,44
Adelaide Utd,598,5,11,6,11,37,40,-3,39
Brisbane,598,6,10,5,13,33,42,-9,35
Western Sydn,598,7,8,9,10,38,47,-9,33
Perth Glory,598,8,10,2,15,37,50,-13,32
Wellington P,598,9,5,6,16,31,55,-24,21
CC Mariners,598,10,4,8,15,28,49,-21,20
Sydney FC,599,1,21,4,3,65,22,43,67
N'castle Jet,599,2,16,5,7,60,37,23,53
Melbourne C,599,3,14,4,11,43,36,7,46
Melbourne V,599,4,13,5,11,45,39,6,44
Adelaide Utd,599,5,11,6,11,37,40,-3,39
Brisbane,599,6,10,5,13,33,42,-9,35
Western Sydn,599,7,8,9,10,38,47,-9,33
Perth Glory,599,8,10,2,15,37,50,-13,32
Wellington P,599,9,5,6,16,31,55,-24,21
CC Mariners,599,10,4,8,15,28,49,-21,20
Sydney FC,600,1,21,4,3,66,22,44,67
N'castle Jet,600,2,16,5,7,60,39,21,53
Melbourne C,600,3,14,4,11,45,36,9,46
Melbourne V,600,4,13,5,11,45,40,5,44
Adelaide Utd,600,5,11,6,11,37,40,-3,39
Brisbane,600,6,10,5,13,33,42,-9,35
Western Sydn,600,7,8,9,10,38,47,-9,33
Perth Glory,600,8,10,2,15,37,50,-13,32
Wellington P,600,9,5,6,16,31,55,-24,21
CC Mariners,600,10,4,8,15,28,49,-21,20
Sydney FC,601,1,21,4,3,67,24,43,67
N'castle Jet,601,2,16,5,7,60,37,23,53
Melbourne C,601,3,14,4,11,43,36,7,46
Melbourne V,601,4,13,5,11,47,41,6,44
Adelaide Utd,601,5,11,6,11,37,40,-3,39
Brisbane,601,6,10,5,13,33,42,-9,35
Western Sydn,601,7,8,9,10,38,47,-9,33
Perth Glory,601,8,10,2,15,37,50,-13,32
Wellington P,601,9,5,6,16,31,55,-24,21
CC Mariners,601,10,4,8,15,28,49,-21,20
Sydney FC,602,1,21,4,3,66,22,44,67
N'castle Jet,602,2,15,6,7,58,38,20,51
Melbourne C,602,3,14,5,10,44,34,10,47
Melbourne V,602,4,13,5,11,45,40,5,44
Adelaide Utd,602,5,11,6,11,37,40,-3,39
Brisbane,602,6,10,5,13,33,42,-9,35
Western Sydn,602,7,8,9,10,38,47,-9,33
Perth Glory,602,8,10,2,15,37,50,-13,32
Wellington P,602,9,5,6,16,31,55,-24,21
CC Mariners,602,10,4,8,15,28,49,-21,20
Sydney FC,603,1,21,4,3,67,23,44,67
N'castle Jet,603,2,16,5,7,58,37,21,53
Melbourne C,603,3,14,4,11,43,34,9,46
Melbourne V,603,4,13,5,11,46,41,5,44
Adelaide Utd,603,5,11,6,11,37,40,-3,39
Brisbane,603,6,10,5,13,33,42,-9,35
Western Sydn,603,7,8,9,10,38,47,-9,33
Perth Glory,603,8,10,2,15,37,50,-13,32
Wellington P,603,9,5,6,16,31,55,-24,21
CC Mariners,603,10,4,8,15,28,49,-21,20
Sydney FC,604,1,21,4,3,67,23,44,67
N'castle Jet,604,2,16,5,7,61,38,23,53
Melbourne C,604,3,14,4,11,44,37,7,46
Melbourne V,604,4,13,5,11,46,41,5,44
Adelaide Utd,604,5,11,6,11,37,40,-3,39
Brisbane,604,6,10,5,13,33,42,-9,35
Western Sydn,604,7,8,9,10,38,47,-9,33
Perth Glory,604,8,10,2,15,37,50,-13,32
Wellington P,604,9,5,6,16,31,55,-24,21
CC Mariners,604,10,4,8,15,28,49,-21,20
Sydney FC,605,1,20,4,4,65,24,41,64
N'castle Jet,605,2,16,5,7,58,37,21,53
Melbourne V,605,3,14,5,10,47,39,8,47
Melbourne C,605,4,14,4,11,43,34,9,46
Adelaide Utd,605,5,11,6,11,37,40,-3,39
Brisbane,605,6,10,5,13,33,42,-9,35
Western Sydn,605,7,8,9,10,38,47,-9,33
Perth Glory,605,8,10,2,15,37,50,-13,32
Wellington P,605,9,5,6,16,31,55,-24,21
CC Mariners,605,10,4,8,15,28,49,-21,20
Sydney FC,606,1,20,5,3,65,23,42,65
N'castle Jet,606,2,15,5,8,58,39,19,50
Melbourne C,606,3,15,4,10,45,34,11,49
Melbourne V,606,4,13,6,10,46,39,7,45
Adelaide Utd,606,5,11,6,11,37,40,-3,39
Brisbane,606,6,10,5,13,33,42,-9,35
Western Sydn,606,7,8,9,10,38,47,-9,33
Perth Glory,606,8,10,2,15,37,50,-13,32
Wellington P,606,9,5,6,16,31,55,-24,21
CC Mariners,606,10,4,8,15,28,49,-21,20
Sydney FC,607,1,21,4,3,66,22,44,67
N'castle Jet,607,2,16,5,7,59,38,21,53
Melbourne C,607,3,14,4,11,44,35,9,46
Melbourne V,607,4,13,5,11,45,40,5,44
Adelaide Utd,607,5,11,6,11,37,40,-3,39
Brisbane,607,6,10,5,13,33,42,-9,35
Western Sydn,607,7,8,9,10,38,47,-9,33
Perth Glory,607,8,10,2,15,37,50,-13,32
Wellington P,607,9,5,6,16,31,55,-24,21
CC Mariners,607,10,4,8,15,28,49,-21,20
Sydney FC,608,1,21,4,3,68,22,46,67
N'castle Jet,608,2,15,6,7,58,38,20,51
Melbourne C,608,3,14,5,10,44,34,10,47
Melbourne V,608,4,13,5,11,45,42,3,44
Adelaide Utd,608,5,11,6,11,37,40,-3,39
Brisbane,608,6,10,5,13,33,42,-9,35
Western Sydn,608,7,8,9,10,38,47,-9,33
Perth Glory,608,8,10,2,15,37,50,-13,32
Wellington P,608,9,5,6,16,31,55,-24,21
CC Mariners,608,10,4,8,15,28,49,-21,20
Sydney FC,609,1,20,4,4,65,25,40,64
N'castle Jet,609,2,15,6,7,58,38,20,51
Melbourne C,609,3,14,5,10,44,34,10,47
Melbourne V,609,4,14,5,10,48,39,9,47
Adelaide Utd,609,5,11,6,11,37,40,-3,39
Brisbane,609,6,10,5,13,33,42,-9,35
Western Sydn,609,7,8,9,10,38,47,-9,33
Perth Glory,609,8,10,2,15,37,50,-13,32
Wellington P,609,9,5,6,16,31,55,-24,21
CC Mariners,609,10,4,8,15,28,49,-21,20
Sydney FC,610,1,21,4,3,65,22,43,67
N'castle Jet,610,2,16,5,7,59,37,22,53
Melbourne C,610,3,14,4,11,43,35,8,46
Melbourne V,610,4,13,5,11,45,39,6,44
Adelaide Utd,610,5,11,6,11,37,40,-3,39
Brisbane,610,6,10,5,13,33,42,-9,35
Western Sydn,610,7,8,9,10,38,47,-9,33
Perth Glory,610,8,10,2,15,37,50,-13,32
Wellington P,610,9,5,6,16,31,55,-24,21
CC Mariners,610,10,4,8,15,28,49,-21,20
Sydney FC,611,1,21,4,3,66,22,44,67
N'castle Jet,611,2,15,5,8,57,38,19,50
Melbourne C,611,3,15,4,10,44,33,11,49
Melbourne V,611,4,13,5,11,45,40,5,44
Adelaide Utd,611,5,11,6,11,37,40,-3,39
Brisbane,611,6,10,5,13,33,42,-9,35
Western Sydn,611,7,8,9,10,38,47,-9,33
Perth Glory,611,8,10,2,15,37,50,-13,32
Wellington P,611,9,5,6,16,31,55,-24,21
CC Mariners,611,10,4,8,15,28,49,-21,20
Sydney FC,612,1,20,4,4,64,23,41,64
N'castle Jet,612,2,16,5,7,59,37,22,53
Melbourne V,612,3,14,5,10,46,38,8,47
Melbourne C,612,4,14,4,11,43,35,8,46
Adelaide Utd,612,5,11,6,11,37,40,-3,39
Brisbane,612,6,10,5,13,33,42,-9,35
Western Sydn,612,7,8,9,10,38,47,-9,33
Perth Glory,612,8,10,2,15,37,50,-13,32
Wellington P,612,9,5,6,16,31,55,-24,21
CC Mariners,612,10,4,8,15,28,49,-21,20
Sydney FC,613,1,21,4,3,66,23,43,67
N'castle Jet,613,2,15,5,8,58,40,18,50
Melbourne C,613,3,15,4,10,46,34,12,49
Melbourne V,613,4,13,5,11,46,40,6,44
Adelaide Utd,613,5,11,6,11,37,40,-3,39
Brisbane,613,6,10,5,13,33,42,-9,35
Western Sydn,613,7,8,9,10,38,47,-9,33
Perth Glory,613,8,10,2,15,37,50,-13,32
Wellington P,613,9,5,6,16,31,55,-24,21
CC Mariners,613,10,4,8,15,28,49,-21,20
Sydney FC,614,1,20,5,3,66,24,42,65
N'castle Jet,614,2,15,5,8,60,41,19,50
Melbourne C,614,3,15,4,10,47,36,11,49
Melbourne V,614,4,13,6,10,47,40,7,45
Adelaide Utd,614,5,11,6,11,37,40,-3,39
Brisbane,614,6,10,5,13,33,42,-9,35
Western Sydn,614,7,8,9,10,38,47,-9,33
Perth Glory,614,8,10,2,15,37,50,-13,32
Wellington P,614,9,5,6,16,31,55,-24,21
CC Mariners,614,10,4,8,15,28,49,-21,20
Sydney FC,615,1,20,4,4,65,24,41,64
N'castle Jet,615,2,15,6,7,59,39,20,51
Melbourne C,615,3,14,5,10,45,35,10,47
Melbourne V,615,4,14,5,10,47,39,8,47
Adelaide Utd,615,5,11,6,11,37,40,-3,39
Brisbane,615,6,10,5,13,33,42,-9,35
Western Sydn,615,7,8,9,10,38,47,-9,33
Perth Glory,615,8,10,2,15,37,50,-13,32
Wellington P,615,9,5,6,16,31,55,-24,21
CC Mariners,615,10,4,8,15,28,49,-21,20
Sydney FC,616,1,21,4,3,65,22,43,67
N'castle Jet,616,2,16,5,7,59,38,21,53
Melbourne C,616,3,14,4,11,44,35,9,46
Melbourne V,616,4,13,5,11,45,39,6,44
Adelaide Utd,616,5,11,6,11,37,40,-3,39
Brisbane,616,6,10,5,13,33,42,-9,35
Western Sydn,616,7,8,9,10,38,47,-9,33
Perth Glory,616,8,10,2,15,37,50,-13,32
Wellington P,616,9,5,6,16,31,55,-24,21
CC Mariners,616,10,4,8,15,28,49,-21,20
Sydney FC,617,1,21,4,3,67,23,44,67
N'castle Jet,617,2,15,6,7,58,38,20,51
Melbourne C,617,3,14,5,10,44,34,10,47
Melbourne V,617,4,13,5,11,46,41,5,44
Adelaide Utd,617,5,11,6,11,37,40,-3,39
Brisbane,617,6,10,5,13,33,42,-9,35
Western Sydn,617,7,8,9,10,38,47,-9,33
Perth Glory,617,8,10,2,15,37,50,-13,32
Wellington P,617,9,5,6,16,31,55,-24,21
CC Mariners,617,10,4,8,15,28,49,-21,20
Sydney FC,618,1,20,5,3,65,23,42,65
N'castle Jet,618,2,16,5,7,61,37,24,53
Melbourne C,618,3,14,4,11,43,37,6,46
Melbourne V,618,4,13,6,10,46,39,7,45
Adelaide Utd,618,5,11,6,11,37,40,-3,39
Brisbane,618,6,10,5,13,33,42,-9,35
Western Sydn,618,7,8,9,10,38,47,-9,33
Perth Glory,618,8,10,2,15,37,50,-13,32
Wellington P,618,9,5,6,16,31,55,-24,21
CC Mariners,618,10,4,8,15,28,49,-21,20
Sydney FC,619,1,20,5,3,64,22,42,65
N'castle Jet,619,2,15,6,7,58,38,20,51
Melbourne C,619,3,14,5,10,44,34,10,47
Melbourne V,619,4,13,6,10,45,38,7,45
Adelaide Utd,619,5,11,6,11,37,40,-3,39
Brisbane,619,6,10,5,13,33,42,-9,35
Western Sydn,619,7,8,9,10,38,47,-9,33
Perth Glory,619,8,10,2,15,37,50,-13,32
Wellington P,619,9,5,6,16,31,55,-24,21
CC Mariners,619,10,4,8,15,28,49,-21,20
Sydney FC,620,1,21,4,3,70,26,44,67
N'castle Jet,620,2,16,5,7,59,38,21,53
Melbourne C,620,3,14,4,11,44,35,9,46
Melbourne V,620,4,13,5,11,49,44,5,44
Adelaide Utd,620,5,11,6,11,37,40,-3,39
Brisbane,620,6,10,5,13,33,42,-9,35
Western Sydn,620,7,8,9,10,38,47,-9,33
Perth Glory,620,8,10,2,15,37,50,-13,32
Wellington P,620,9,5,6,16,31,55,-24,21
CC Mariners,620,10,4,8,15,28,49,-21,20
Sydney FC,621,1,21,4,3,68,23,45,67
N'castle Jet,621,2,16,5,7,59,38,21,53
Melbourne C,621,3,14,4,11,44,35,9,46
Melbourne V,621,4,13,5,11,46,42,4,44
Adelaide Utd,621,5,11,6,11,37,40,-3,39
Brisbane,621,6,10,5,13,33,42,-9,35
Western Sydn,621,7,8,9,10,38,47,-9,33
Perth Glory,621,8,10,2,15,37,50,-13,32
Wellington P,621,9,5,6,16,31,55,-24,21
CC Mariners,621,10,4,8,15,28,49,-21,20
Sydney FC,622,1,20,5,3,65,23,42,65
N'castle Jet,622,2,15,5,8,58,39,19,50
Melbourne C,622,3,15,4,10,45,34,11,49
Melbourne V,622,4,13,6,10,46,39,7,45
Adelaide Utd,622,5,11,6,11,37,40,-3,39
Brisbane,622,6,10,5,13,33,42,-9,35
Western Sydn,622,7,8,9,10,38,47,-9,33
Perth Glory,622,8,10,2,15,37,50,-13,32
Wellington P,622,9,5,6,16,31,55,-24,21
CC Mariners,622,10,4,8,15,28,49,-21,20
Sydney FC,623,1,21,4,3,65,22,43,67
N'castle Jet,623,2,15,6,7,58,38,20,51
Melbourne C,623,3,14,5,10,44,34,10,47
Melbourne V,623,4,13,5,11,45,39,6,44
Adelaide Utd,623,5,11,6,11,37,40,-3,39
Brisbane,623,6,10,5,13,33,42,-9,35
Western Sydn,623,7,8,9,10,38,47,-9,33
Perth Glory,623,8,10,2,15,37,50,-13,32
Wellington P,623,9,5,6,16,31,55,-24,21
CC Mariners,623,10,4,8,15,28,49,-21,20
Sydney FC,624,1,20,4,4,64,23,41,64
N'castle Jet,624,2,16,5,7,59,38,21,53
Melbourne V,624,3,14,5,10,46,38,8,47
Melbourne C,624,4,14,4,11,44,35,9,46
Adelaide Utd,624,5,11,6,11,37,40,-3,39
Brisbane,624,6,10,5,13,33,42,-9,35
Western Sydn,624,7,8,9,10,38,47,-9,33
Perth Glory,624,8,10,2,15,37,50,-13,32
Wellington P,624,9,5,6,16,31,55,-24,21
CC Mariners,624,10,4,8,15,28,49,-21,20
Sydney FC,625,1,21,4,3,68,22,46,67
N'castle Jet,625,2,16,5,7,59,38,21,53
Melbourne C,625,3,14,4,11,44,35,9,46
Melbourne V,625,4,13,5,11,45,42,3,44
Adelaide Utd,625,5,11,6,11,37,40,-3,39
Brisbane,625,6,10,5,13,33,42,-9,35
Western Sydn,625,7,8,9,10,38,47,-9,33
Perth Glory,625,8,10,2,15,37,50,-13,32
Wellington P,625,9,5,6,16,31,55,-24,21
CC Mariners,625,10,4,8,15,28,49,-21,20
Sydney FC,626,1,20,5,3,65,23,42,65
N'castle Jet,626,2,15,5,8,58,40,18,50
Melbourne C,626,3,15,4,10,46,34,12,49
Melbourne V,626,4,13,6,10,46,39,7,45
Adelaide Utd,626,5,11,6,11,37,40,-3,39
Brisbane,626,6,10,5,13,33,42,-9,35
Western Sydn,626,7,8,9,10,38,47,-9,33
Perth Glory,626,8,10,2,15,37,50,-13,32
Wellington P,626,9,5,6,16,31,55,-24,21
CC Mariners,626,10,4,8,15,28,49,-21,20
Sydney FC,627,1,20,4,4,65,24,41,64
N'castle Jet,627,2,15,5,8,58,40,18,50
Melbourne C,627,3,15,4,10,46,34,12,49
Melbourne V,627,4,14,5,10,47,39,8,47
Adelaide Utd,627,5,11,6,11,37,40,-3,39
Brisbane,627,6,10,5,13,33,42,-9,35
Western Sydn,627,7,8,9,10,38,47,-9,33
Perth Glory,627,8,10,2,15,37,50,-13,32
Wellington P,627,9,5,6,16,31,55,-24,21
CC Mariners,627,10,4,8,15,28,49,-21,20
Sydney FC,628,1,21,4,3,68,22,46,67
N'castle Jet,628,2,16,5,7,59,37,22,53
Melbourne C,628,3,14,4,11,43,35,8,46
Melbourne V,628,4,13,5,11,45,42,3,44
Adelaide Utd,628,5,11,6,11,37,40,-3,39
Brisbane,628,6,10,5,13,33,42,-9,35
Western Sydn,628,7,8,9,10,38,47,-9,33
Perth Glory,628,8,10,2,15,37,50,-13,32
Wellington P,628,9,5,6,16,31,55,-24,21
CC Mariners,628,10,4,8,15,28,49,-21,20
Sydney FC,629,1,20,5,3,64,22,42,65
N'castle Jet,629,2,16,5,7,60,38,22,53
Melbourne C,629,3,14,4,11,44,36,8,46
Melbourne V,629,4,13,6,10,45,38,7,45
Adelaide Utd,629,5,11,6,11,37,40,-3,39
Brisbane,629,6,10,5,13,33,42,-9,35
Western Sydn,629,7,8,9,10,38,47,-9,33
Perth Glory,629,8,10,2,15,37,50,-13,32
Wellington P,629,9,5,6,16,31,55,-24,21
CC Mariners,629,10,4,8,15,28,49,-21,20
Sydney FC,630,1,21,4,3,65,22,43,67
N'castle Jet,630,2,15,6,7,57,37,20,51
Melbourne C,630,3,14,5,10,43,33,10,47
Melbourne V,630,4,13,5,11,45,39,6,44
Adelaide Utd,630,5,11,6,11,37,40,-3,39
Brisbane,630,6,10,5,13,33,42,-9,35
Western Sydn,630,7,8,9,10,38,47,-9,33
Perth Glory,630,8,10,2,15,37,50,-13,32
Wellington P,630,9,5,6,16,31,55,-24,21
CC Mariners,630,10,4,8,15,28,49,-21,20
Sydney FC,631,1,21,4,3,68,22,46,67
N'castle Jet,631,2,15,5,8,58,39,19,50
Melbourne C,631,3,15,4,10,45,34,11,49
Melbourne V,631,4,13,5,11,45,42,3,44
Adelaide Utd,631,5,11,6,11,37,40,-3,39
Brisbane,631,6,10,5,13,33,42,-9,35
Western Sydn,631,7,8,9,10,38,47,-9,33
Perth Glory,631,8,10,2,15,37,50,-13,32
Wellington P,631,9,5,6,16,31,55,-24,21
CC Mariners,631,10,4,8,15,28,49,-21,20
Sydney FC,632,1,21,4,3,66,23,43,67
N'castle Jet,632,2,16,5,7,58,37,21,53
Melbourne C,632,3,14,4,11,43,34,9,46
Melbourne V,632,4,13,5,11,46,40,6,44
Adelaide Utd,632,5,11,6,11,37,40,-3,39
Brisbane,632,6,10,5,13,33,42,-9,35
Western Sydn,632,7,8,9,10,38,47,-9,33
Perth Glory,632,8,10,2,15,37,50,-13,32
Wellington P,632,9,5,6,16,31,55,-24,21
CC Mariners,632,10,4,8,15,28,49,-21,20
Sydney FC,633,1,21,4,3,66,22,44,67
N'castle Jet,633,2,16,5,7,59,38,21,53
Melbourne C,633,3,14,4,11,44,35,9,46
Melbourne V,633,4,13,5,11,45,40,5,44
Adelaide Utd,633,5,11,6,11,37,40,-3,39
Brisbane,633,6,10,5,13,33,42,-9,35
Western Sydn,633,7,8,9,10,38,47,-9,33
Perth Glory,633,8,10,2,15,37,50,-13,32
Wellington P,633,9,5,6,16,31,55,-24,21
CC Mariners,633,10,4,8,15,28,49,-21,20
Sydney FC,634,1,21,4,3,66,23,43,67
N'castle Jet,634,2,16,5,7,61,37,24,53
Melbourne C,634,3,14,4,11,43,37,6,46
Melbourne V,634,4,13,5,11,46,40,6,44
Adelaide Utd,634,5,11,6,11,37,40,-3,39
Brisbane,634,6,10,5,13,33,42,-9,35
Western Sydn,634,7,8,9,10,38,47,-9,33
Perth Glory,634,8,10,2,15,37,50,-13,32
Wellington P,634,9,5,6,16,31,55,-24,21
CC Mariners,634,10,4,8,15,28,49,-21,20
Sydney FC,635,1,21,4,3,68,24,44,67
N'castle Jet,635,2,16,5,7,59,38,21,53
Melbourne C,635,3,14,4,11,44,35,9,46
Melbourne V,635,4,13,5,11,47,42,5,44
Adelaide Utd,635,5,11,6,11,37,40,-3,39
Brisbane,635,6,10,5,13,33,42,-9,35
Western Sydn,635,7,8,9,10,38,47,-9,33
Perth Glory,635,8,10,2,15,37,50,-13,32
Wellington P,635,9,5,6,16,31,55,-24,21
CC Mariners,635,10,4,8,15,28,49,-21,20
Sydney FC,636,1,20,4,4,64,26,38,64
N'castle Jet,636,2,15,5,8,57,38,19,50
Melbourne C,636,3,15,4,10,44,33,11,49
Melbourne V,636,4,14,5,10,49,38,11,47
Adelaide Utd,636,5,11,6,11,37,40,-3,39
Brisbane,636,6,10,5,13,33,42,-9,35
Western Sydn,636,7,8,9,10,38,47,-9,33
Perth Glory,636,8,10,2,15,37,50,-13,32
Wellington P,636,9,5,6,16,31,55,-24,21
CC Mariners,636,10,4,8,15,28,49,-21,20
Sydney FC,637,1,20,4,4,64,23,41,64
N'castle Jet,637,2,15,6,7,58,38,20,51
Melbourne C,637,3,14,5,10,44,34,10,47
Melbourne V,637,4,14,5,10,46,38,8,47
Adelaide Utd,637,5,11,6,11,37,40,-3,39
Brisbane,637,6,10,5,13,33,42,-9,35
Western Sydn,637,7,8,9,10,38,47,-9,33
Perth Glory,637,8,10,2,15,37,50,-13,32
Wellington P,637,9,5,6,16,31,55,-24,21
CC Mariners,637,10,4,8,15,28,49,-21,20
Sydney FC,638,1,21,4,3,67,22,45,67
N'castle Jet,638,2,16,5,7,58,37,21,53
Melbourne C,638,3,14,4,11,43,34,9,46
Melbourne V,638,4,13,5,11,45,41,4,44
Adelaide Utd,638,5,11,6,11,37,40,-3,39
Brisbane,638,6,10,5,13,33,42,-9,35
Western Sydn,638,7,8,9,10,38,47,-9,33
Perth Glory,638,8,10,2,15,37,50,-13,32
Wellington P,638,9,5,6,16,31,55,-24,21
CC Mariners,638,10,4,8,15,28,49,-21,20
Sydney FC,639,1,21,4,3,66,23,43,67
N'castle Jet,639,2,15,5,8,58,41,17,50
Melbourne C,639,3,15,4,10,47,34,13,49
Melbourne V,639,4,13,5,11,46,40,6,44
Adelaide Utd,639,5,11,6,11,37,40,-3,39
Brisbane,639,6,10,5,13,33,42,-9,35
Western Sydn,639,7,8,9,10,38,47,-9,33
Perth Glory,639,8,10,2,15,37,50,-13,32
Wellington P,639,9,5,6,16,31,55,-24,21
CC Mariners,639,10,4,8,15,28,49,-21,20
Sydney FC,640,1,21,4,3,67,24,43,67
N'castle Jet,640,2,16,5,7,59,38,21,53
Melbourne C,640,3,14,4,11,44,35,9,46
Melbourne V,640,4,13,5,11,47,41,6,44
Adelaide Utd,640,5,11,6,11,37,40,-3,39
Brisbane,640,6,10,5,13,33,42,-9,35
Western Sydn,640,7,8,9,10,38,47,-9,33
Perth Glory,640,8,10,2,15,37,50,-13,32
Wellington P,640,9,5,6,16,31,55,-24,21
CC Mariners,640,10,4,8,15,28,49,-21,20
Sydney FC,641,1,20,5,3,65,23,42,65
N'castle Jet,641,2,16,5,7,61,37,24,53
Melbourne C,641,3,14,4,11,43,37,6,46
Melbourne V,641,4,13,6,10,46,39,7,45
Adelaide Utd,641,5,11,6,11,37,40,-3,39
Brisbane,641,6,10,5,13,33,42,-9,35
Western Sydn,641,7,8,9,10,38,47,-9,33
Perth Glory,641,8,10,2,15,37,50,-13,32
Wellington P,641,9,5,6,16,31,55,-24,21
CC Mariners,641,10,4,8,15,28,49,-21,20
Sydney FC,642,1,21,4,3,67,23,44,67
N'castle Jet,642,2,15,6,7,57,37,20,51
Melbourne C,642,3,14,5,10,43,33,10,47
Melbourne V,642,4,13,5,11,46,41,5,44
Adelaide Utd,642,5,11,6,11,37,40,-3,39
Brisbane,642,6,10,5,13,33,42,-9,35
Western Sydn,642,7,8,9,10,38,47,-9,33
Perth Glory,642,8,10,2,15,37,50,-13,32
Wellington P,642,9,5,6,16,31,55,-24,21
CC Mariners,642,10,4,8,15,28,49,-21,20
Sydney FC,643,1,21,4,3,66,23,43,67
N'castle Jet,643,2,15,6,7,57,37,20,51
Melbourne C,643,3,14,5,10,43,33,10,47
Melbourne V,643,4,13,5,11,46,40,6,44
Adelaide Utd,643,5,11,6,11,37,40,-3,39
Brisbane,643,6,10,5,13,33,42,-9,35
Western Sydn,643,7,8,9,10,38,47,-9,33
Perth Glory,643,8,10,2,15,37,50,-13,32
Wellington P,643,9,5,6,16,31,55,-24,21
CC Mariners,643,10,4,8,15,28,49,-21,20
Sydney FC,644,1,21,4,3,65,22,43,67
N'castle Jet,644,2,15,6,7,58,38,20,51
Melbourne C,644,3,14,5,10,44,34,10,47
Melbourne V,644,4,13,5,11,45,39,6,44
Adelaide Utd,644,5,11,6,11,37,40,-3,39
Brisbane,644,6,10,5,13,33,42,-9,35
Western Sydn,644,7,8,9,10,38,47,-9,33
Perth Glory,644,8,10,2,15,37,50,-13,32
Wellington P,644,9,5,6,16,31,55,-24,21
CC Mariners,644,10,4,8,15,28,49,-21,20
Sydney FC,645,1,21,4,3,65,22,43,67
N'castle Jet,645,2,16,5,7,59,37,22,53
Melbourne C,645,3,14,4,11,43,35,8,46
Melbourne V,645,4,13,5,11,45,39,6,44
Adelaide Utd,645,5,11,6,11,37,40,-3,39
Brisbane,645,6,10,5,13,33,42,-9,35
Western Sydn,645,7,8,9,10,38,47,-9,33
Perth Glory,645,8,10,2,15,37,50,-13,32
Wellington P,645,9,5,6,16,31,55,-24,21
CC Mariners,645,10,4,8,15,28,49,-21,20
Sydney FC,646,1,21,4,3,67,23,44,67
N'castle Jet,646,2,16,5,7,59,37,22,53
Melbourne C,646,3,14,4,11,43,35,8,46
Melbourne V,646,4,13,5,11,46,41,5,44
Adelaide Utd,646,5,11,6,11,37,40,-3,39
Brisbane,646,6,10,5,13,33,42,-9,35
Western Sydn,646,7,8,9,10,38,47,-9,33
Perth Glory,646,8,10,2,15,37,50,-13,32
Wellington P,646,9,5,6,16,31,55,-24,21
CC Mariners,646,10,4,8,15,28,49,-21,20
Sydney FC,647,1,21,4,3,66,22,44,67
N'castle Jet,647,2,15,6,7,60,40,20,51
Melbourne C,647,3,14,5,10,46,36,10,47
Melbourne V,647,4,13,5,11,45,40,5,44
Adelaide Utd,647,5,11,6,11,37,40,-3,39
Brisbane,647,6,10,5,13,33,42,-9,35
Western Sydn,647,7,8,9,10,38,47,-9,33
Perth Glory,647,8,10,2,15,37,50,-13,32
Wellington P,647,9,5,6,16,31,55,-24,21
CC Mariners,647,10,4,8,15,28,49,-21,20
Sydney FC,648,1,21,4,3,68,22,46,67
N'castle Jet,648,2,16,5,7,61,37,24,53
Melbourne C,648,3,14,4,11,43,37,6,46
Melbourne V,648,4,13,5,11,45,42,3,44
Adelaide Utd,648,5,11,6,11,37,40,-3,39
Brisbane,648,6,10,5,13,33,42,-9,35
Western Sydn,648,7,8,9,10,38,47,-9,33
Perth Glory,648,8,10,2,15,37,50,-13,32
Wellington P,648,9,5,6,16,31,55,-24,21
CC Mariners,648,10,4,8,15,28,49,-21,20
Sydney FC,649,1,21,4,3,67,23,44,67
N'castle Jet,649,2,15,5,8,58,39,19,50
Melbourne C,649,3,15,4,10,45,34,11,49
Melbourne V,649,4,13,5,11,46,41,5,44
Adelaide Utd,649,5,11,6,11,37,40,-3,39
Brisbane,649,6,10,5,13,33,42,-9,35
Western Sydn,649,7,8,9,10,38,47,-9,33
Perth Glory,649,8,10,2,15,37,50,-13,32
Wellington P,649,9,5,6,16,31,55,-24,21
CC Mariners,649,10,4,8,15,28,49,-21,20
Sydney FC,650,1,20,4,4,64,23,41,64
N'castle Jet,650,2,15,6,7,59,39,20,51
Melbourne C,650,3,14,5,10,45,35,10,47
Melbourne V,650,4,14,5,10,46,38,8,47
Adelaide Utd,650,5,11,6,11,37,40,-3,39
Brisbane,650,6,10,5,13,33,42,-9,35
Western Sydn,650,7,8,9,10,38,47,-9,33
Perth Glory,650,8,10,2,15,37,50,-13,32
Wellington P,650,9,5,6,16,31,55,-24,21
CC Mariners,650,10,4,8,15,28,49,-21,20
Sydney FC,651,1,21,4,3,65,22,43,67
N'castle Jet,651,2,16,5,7,59,38,21,53
Melbourne C,651,3,14,4,11,44,35,9,46
Melbourne V,651,4,13,5,11,45,39,6,44
Adelaide Utd,651,5,11,6,11,37,40,-3,39
Brisbane,651,6,10,5,13,33,42,-9,35
Western Sydn,651,7,8,9,10,38,47,-9,33
Perth Glory,651,8,10,2,15,37,50,-13,32
Wellington P,651,9,5,6,16,31,55,-24,21
CC Mariners,651,10,4,8,15,28,49,-21,20
Sydney FC,652,1,21,4,3,67,24,43,67
N'castle Jet,652,2,15,6,7,57,37,20,51
Melbourne C,652,3,14,5,10,43,33,10,47
Melbourne V,652,4,13,5,11,47,41,6,44
Adelaide Utd,652,5,11,6,11,37,40,-3,39
Brisbane,652,6,10,5,13,33,42,-9,35
Western Sydn,652,7,8,9,10,38,47,-9,33
Perth Glory,652,8,10,2,15,37,50,-13,32
Wellington P,652,9,5,6,16,31,55,-24,21
CC Mariners,652,10,4,8,15,28,49,-21,20
Sydney FC,653,1,20,5,3,65,23,42,65
N'castle Jet,653,2,16,5,7,62,39,23,53
Melbourne C,653,3,14,4,11,45,38,7,46
Melbourne V,653,4,13,6,10,46,39,7,45
Adelaide Utd,653,5,11,6,11,37,40,-3,39
Brisbane,653,6,10,5,13,33,42,-9,35
Western Sydn,653,7,8,9,10,38,47,-9,33
Perth Glory,653,8,10,2,15,37,50,-13,32
Wellington P,653,9,5,6,16,31,55,-24,21
CC Mariners,653,10,4,8,15,28,49,-21,20
Sydney FC,654,1,21,4,3,66,22,44,67
N'castle Jet,654,2,16,5,7,62,38,24,53
Melbourne C,654,3,14,4,11,44,38,6,46
Melbourne V,654,4,13,5,11,45,40,5,44
Adelaide Utd,654,5,11,6,11,37,40,-3,39
Brisbane,654,6,10,5,13,33,42,-9,35
Western Sydn,654,7,8,9,10,38,47,-9,33
Perth Glory,654,8,10,2,15,37,50,-13,32
Wellington P,654,9,5,6,16,31,55,-24,21
CC Mariners,654,10,4,8,15,28,49,-21,20
Sydney FC,655,1,21,4,3,68,22,46,67
N'castle Jet,655,2,16,5,7,59,37,22,53
Melbourne C,655,3,14,4,11,43,35,8,46
Melbourne V,655,4,13,5,11,45,42,3,44
Adelaide Utd,655,5,11,6,11,37,40,-3,39
Brisbane,655,6,10,5,13,33,42,-9,35
Western Sydn,655,7,8,9,10,38,47,-9,33
Perth Glory,655,8,10,2,15,37,50,-13,32
Wellington P,655,9,5,6,16,31,55,-24,21
CC Mariners,655,10,4,8,15,28,49,-21,20
Sydney FC,656,1,21,4,3,65,22,43,67
N'castle Jet,656,2,16,5,7,59,38,21,53
Melbourne C,656,3,14,4,11,44,35,9,46
Melbourne V,656,4,13,5,11,45,39,6,44
Adelaide Utd,656,5,11,6,11,37,40,-3,39
Brisbane,656,6,10,5,13,33,42,-9,35
Western Sydn,656,7,8,9,10,38,47,-9,33
Perth Glory,656,8,10,2,15,37,50,-13,32
Wellington P,656,9,5,6,16,31,55,-24,21
CC Mariners,656,10,4,8,15,28,49,-21,20
Sydney FC,657,1,21,4,3,69,24,45,67
N'castle Jet,657,2,16,5,7,58,37,21,53
Melbourne C,657,3,14,4,11,43,34,9,46
Melbourne V,657,4,13,5,11,47,43,4,44
Adelaide Utd,657,5,11,6,11,37,40,-3,39
Brisbane,657,6,10,5,13,33,42,-9,35
Western Sydn,657,7,8,9,10,38,47,-9,33
Perth Glory,657,8,10,2,15,37,50,-13,32
Wellington P,657,9,5,6,16,31,55,-24,21
CC Mariners,657,10,4,8,15,28,49,-21,20
Sydney FC,658,1,21,4,3,66,23,43,67
N'castle Jet,658,2,15,6,7,58,38,20,51
Melbourne C,658,3,14,5,10,44,34,10,47
Melbourne V,658,4,13,5,11,46,40,6,44
Adelaide Utd,658,5,11,6,11,37,40,-3,39
Brisbane,658,6,10,5,13,33,42,-9,35
Western Sydn,658,7,8,9,10,38,47,-9,33
Perth Glory,658,8,10,2,15,37,50,-13,32
Wellington P,658,9,5,6,16,31,55,-24,21
CC Mariners,658,10,4,8,15,28,49,-21,20
Sydney FC,659,1,21,4,3,65,22,43,67
N'castle Jet,659,2,16,5,7,60,37,23,53
Melbourne C,659,3,14,4,11,43,36,7,46
Melbourne V,659,4,13,5,11,45,39,6,44
Adelaide Utd,659,5,11,6,11,37,40,-3,39
Brisbane,659,6,10,5,13,33,42,-9,35
Western Sydn,659,7,8,9,10,38,47,-9,33
Perth Glory,659,8,10,2,15,37,50,-13,32
Wellington P,659,9,5,6,16,31,55,-24,21
CC Mariners,659,10,4,8,15,28,49,-21,20
Sydney FC,660,1,21,4,3,67,24,43,67
N'castle Jet,660,2,16,5,7,60,39,21,53
Melbourne C,660,3,14,4,11,45,36,9,46
Melbourne V,660,4,13,5,11,47,41,6,44
Adelaide Utd,660,5,11,6,11,37,40,-3,39
Brisbane,660,6,10,5,13,33,42,-9,35
Western Sydn,660,7,8,9,10,38,47,-9,33
Perth Glory,660,8,10,2,15,37,50,-13,32
Wellington P,660,9,5,6,16,31,55,-24,21
CC Mariners,660,10,4,8,15,28,49,-21,20
Sydney FC,661,1,21,4,3,67,22,45,67
N'castle Jet,661,2,15,5,8,58,40,18,50
Melbourne C,661,3,15,4,10,46,34,12,49
Melbourne V,661,4,13,5,11,45,41,4,44
Adelaide Utd,661,5,11,6,11,37,40,-3,39
Brisbane,661,6,10,5,13,33,42,-9,35
Western Sydn,661,7,8,9,10,38,47,-9,33
Perth Glory,661,8,10,2,15,37,50,-13,32
Wellington P,661,9,5,6,16,31,55,-24,21
CC Mariners,661,10,4,8,15,28,49,-21,20
Sydney FC,662,1,21,4,3,67,24,43,67
N'castle Jet,662,2,16,5,7,59,37,22,53
Melbourne C,662,3,14,4,11,43,35,8,46
Melbourne V,662,4,13,5,11,47,41,6,44
Adelaide Utd,662,5,11,6,11,37,40,-3,39
Brisbane,662,6,10,5,13,33,42,-9,35
Western Sydn,662,7,8,9,10,38,47,-9,33
Perth Glory,662,8,10,2,15,37,50,-13,32
Wellington P,662,9,5,6,16,31,55,-24,21
CC Mariners,662,10,4,8,15,28,49,-21,20
Sydney FC,663,1,21,4,3,65,22,43,67
N'castle Jet,663,2,16,5,7,59,37,22,53
Melbourne C,663,3,14,4,11,43,35,8,46
Melbourne V,663,4,13,5,11,45,39,6,44
Adelaide Utd,663,5,11,6,11,37,40,-3,39
Brisbane,663,6,10,5,13,33,42,-9,35
Western Sydn,663,7,8,9,10,38,47,-9,33
Perth Glory,663,8,10,2,15,37,50,-13,32
Wellington P,663,9,5,6,16,31,55,-24,21
CC Mariners,663,10,4,8,15,28,49,-21,20
Sydney FC,664,1,20,5,3,65,23,42,65
N'castle Jet,664,2,15,5,8,57,38,19,50
Melbourne C,664,3,15,4,10,44,33,11,49
Melbourne V,664,4,13,6,10,46,39,7,45
Adelaide Utd,664,5,11,6,11,37,40,-3,39
Brisbane,664,6,10,5,13,33,42,-9,35
Western Sydn,664,7,8,9,10,38,47,-9,33
Perth Glory,664,8,10,2,15,37,50,-13,32
Wellington P,664,9,5,6,16,31,55,-24,21
CC Mariners,664,10,4,8,15,28,49,-21,20
Sydney FC,665,1,21,4,3,67,22,45,67
N'castle Jet,665,2,16,5,7,60,37,23,53
Melbourne C,665,3,14,4,11,43,36,7,46
Melbourne V,665,4,13,5,11,45,41,4,44
Adelaide Utd,665,5,11,6,11,37,40,-3,39
Brisbane,665,6,10,5,13,33,42,-9,35
Western Sydn,665,7,8,9,10,38,47,-9,33
Perth Glory,665,8,10,2,15,37,50,-13,32
Wellington P,665,9,5,6,16,31,55,-24,21
CC Mariners,665,10,4,8,15,28,49,-21,20
Sydney FC,666,1,21,4,3,68,24,44,67
N'castle Jet,666,2,15,5,8,58,39,19,50
Melbourne C,666,3,15,4,10,45,34,11,49
Melbourne V,666,4,13,5,11,47,42,5,44
Adelaide Utd,666,5,11,6,11,37,40,-3,39
Brisbane,666,6,10,5,13,33,42,-9,35
Western Sydn,666,7,8,9,10,38,47,-9,33
Perth Glory,666,8,10,2,15,37,50,-13,32
Wellington P,666,9,5,6,16,31,55,-24,21
CC Mariners,666,10,4,8,15,28,49,-21,20
Sydney FC,667,1,20,4,4,64,24,40,64
N'castle Jet,667,2,16,5,7,58,37,21,53
Melbourne V,667,3,14,5,10,47,38,9,47
Melbourne C,667,4,14,4,11,43,34,9,46
Adelaide Utd,667,5,11,6,11,37,40,-3,39
Brisbane,667,6,10,5,13,33,42,-9,35
Western Sydn,667,7,8,9,10,38,47,-9,33
Perth Glory,667,8,10,2,15,37,50,-13,32
Wellington P,667,9,5,6,16,31,55,-24,21
CC Mariners,667,10,4,8,15,28,49,-21,20
Sydney FC,668,1,21,4,3,67,24,43,67
N'castle Jet,668,2,15,5,8,57,39,18,50
Melbourne C,668,3,15,4,10,45,33,12,49
Melbourne V,668,4,13,5,11,47,41,6,44
Adelaide Utd,668,5,11,6,11,37,40,-3,39
Brisbane,668,6,10,5,13,33,42,-9,35
Western Sydn,668,7,8,9,10,38,47,-9,33
Perth Glory,668,8,10,2,15,37,50,-13,32
Wellington P,668,9,5,6,16,31,55,-24,21
CC Mariners,668,10,4,8,15,28,49,-21,20
Sydney FC,669,1,21,4,3,65,22,43,67
N'castle Jet,669,2,16,5,7,62,40,22,53
Melbourne C,669,3,14,4,11,46,38,8,46
Melbourne V,669,4,13,5,11,45,39,6,44
Adelaide Utd,669,5,11,6,11,37,40,-3,39
Brisbane,669,6,10,5,13,33,42,-9,35
Western Sydn,669,7,8,9,10,38,47,-9,33
Perth Glory,669,8,10,2,15,37,50,-13,32
Wellington P,669,9,5,6,16,31,55,-24,21
CC Mariners,669,10,4,8,15,28,49,-21,20
Sydney FC,670,1,20,5,3,65,23,42,65
N'castle Jet,670,2,15,6,7,58,38,20,51
Melbourne C,670,3,14,5,10,44,34,10,47
Melbourne V,670,4,13,6,10,46,39,7,45
Adelaide Utd,670,5,11,6,11,37,40,-3,39
Brisbane,670,6,10,5,13,33,42,-9,35
Western Sydn,670,7,8,9,10,38,47,-9,33
Perth Glory,670,8,10,2,15,37,50,-13,32
Wellington P,670,9,5,6,16,31,55,-24,21
CC Mariners,670,10,4,8,15,28,49,-21,20
Sydney FC,671,1,21,4,3,66,23,43,67
N'castle Jet,671,2,15,6,7,58,38,20,51
Melbourne C,671,3,14,5,10,44,34,10,47
Melbourne V,671,4,13,5,11,46,40,6,44
Adelaide Utd,671,5,11,6,11,37,40,-3,39
Brisbane,671,6,10,5,13,33,42,-9,35
Western Sydn,671,7,8,9,10,38,47,-9,33
Perth Glory,671,8,10,2,15,37,50,-13,32
Wellington P,671,9,5,6,16,31,55,-24,21
CC Mariners,671,10,4,8,15,28,49,-21,20
Sydney FC,672,1,20,4,4,65,26,39,64
N'castle Jet,672,2,15,5,8,57,38,19,50
Melbourne C,672,3,15,4,10,44,33,11,49
Melbourne V,672,4,14,5,10,49,39,10,47
Adelaide Utd,672,5,11,6,11,37,40,-3,39
Brisbane,672,6,10,5,13,33,42,-9,35
Western Sydn,672,7,8,9,10,38,47,-9,33
Perth Glory,672,8,10,2,15,37,50,-13,32
Wellington P,672,9,5,6,16,31,55,-24,21
CC Mariners,672,10,4,8,15,28,49,-21,20
Sydney FC,673,1,21,4,3,65,22,43,67
N'castle Jet,673,2,15,5,8,57,38,19,50
Melbourne C,673,3,15,4,10,44,33,11,49
Melbourne V,673,4,13,5,11,45,39,6,44
Adelaide Utd,673,5,11,6,11,37,40,-3,39
Brisbane,673,6,10,5,13,33,42,-9,35
Western Sydn,673,7,8,9,10,38,47,-9,33
Perth Glory,673,8,10,2,15,37,50,-13,32
Wellington P,673,9,5,6,16,31,55,-24,21
CC Mariners,673,10,4,8,15,28,49,-21,20
Sydney FC,674,1,21,4,3,68,23,45,67
N'castle Jet,674,2,15,5,8,57,39,18,50
Melbourne C,674,3,15,4,10,45,33,12,49
Melbourne V,674,4,13,5,11,46,42,4,44
Adelaide Utd,674,5,11,6,11,37,40,-3,39
Brisbane,674,6,10,5,13,33,42,-9,35
Western Sydn,674,7,8,9,10,38,47,-9,33
Perth Glory,674,8,10,2,15,37,50,-13,32
Wellington P,674,9,5,6,16,31,55,-24,21
CC Mariners,674,10,4,8,15,28,49,-21,20
Sydney FC,675,1,20,5,3,64,22,42,65
N'castle Jet,675,2,16,5,7,59,38,21,53
Melbourne C,675,3,14,4,11,44,35,9,46
Melbourne V,675,4,13,6,10,45,38,7,45
Adelaide Utd,675,5,11,6,11,37,40,-3,39
Brisbane,675,6,10,5,13,33,42,-9,35
Western Sydn,675,7,8,9,10,38,47,-9,33
Perth Glory,675,8,10,2,15,37,50,-13,32
Wellington P,675,9,5,6,16,31,55,-24,21
CC Mariners,675,10,4,8,15,28,49,-21,20
Sydney FC,676,1,21,4,3,67,22,45,67
N'castle Jet,676,2,15,5,8,57,38,19,50
Melbourne C,676,3,15,4,10,44,33,11,49
Melbourne V,676,4,13,5,11,45,41,4,44
Adelaide Utd,676,5,11,6,11,37,40,-3,39
Brisbane,676,6,10,5,13,33,42,-9,35
Western Sydn,676,7,8,9,10,38,47,-9,33
Perth Glory,676,8,10,2,15,37,50,-13,32
Wellington P,676,9,5,6,16,31,55,-24,21
CC Mariners,676,10,4,8,15,28,49,-21,20
Sydney FC,677,1,20,4,4,66,25,41,64
N'castle Jet,677,2,15,6,7,59,39,20,51
Melbourne C,677,3,14,5,10,45,35,10,47
Melbourne V,677,4,14,5,10,48,40,8,47
Adelaide Utd,677,5,11,6,11,37,40,-3,39
Brisbane,677,6,10,5,13,33,42,-9,35
Western Sydn,677,7,8,9,10,38,47,-9,33
Perth Glory,677,8,10,2,15,37,50,-13,32
Wellington P,677,9,5,6,16,31,55,-24,21
CC Mariners,677,10,4,8,15,28,49,-21,20
Sydney FC,678,1,21,4,3,67,23,44,67
N'castle Jet,678,2,16,5,7,58,37,21,53
Melbourne C,678,3,14,4,11,43,34,9,46
Melbourne V,678,4,13,5,11,46,41,5,44
Adelaide Utd,678,5,11,6,11,37,40,-3,39
Brisbane,678,6,10,5,13,33,42,-9,35
Western Sydn,678,7,8,9,10,38,47,-9,33
Perth Glory,678,8,10,2,15,37,50,-13,32
Wellington P,678,9,5,6,16,31,55,-24,21
CC Mariners,678,10,4,8,15,28,49,-21,20
Sydney FC,679,1,21,4,3,68,22,46,67
N'castle Jet,679,2,15,5,8,57,38,19,50
Melbourne C,679,3,15,4,10,44,33,11,49
Melbourne V,679,4,13,5,11,45,42,3,44
Adelaide Utd,679,5,11,6,11,37,40,-3,39
Brisbane,679,6,10,5,13,33,42,-9,35
Western Sydn,679,7,8,9,10,38,47,-9,33
Perth Glory,679,8,10,2,15,37,50,-13,32
Wellington P,679,9,5,6,16,31,55,-24,21
CC Mariners,679,10,4,8,15,28,49,-21,20
Sydney FC,680,1,21,4,3,68,22,46,67
N'castle Jet,680,2,15,5,8,58,40,18,50
Melbourne C,680,3,15,4,10,46,34,12,49
Melbourne V,680,4,13,5,11,45,42,3,44
Adelaide Utd,680,5,11,6,11,37,40,-3,39
Brisbane,680,6,10,5,13,33,42,-9,35
Western Sydn,680,7,8,9,10,38,47,-9,33
Perth Glory,680,8,10,2,15,37,50,-13,32
Wellington P,680,9,5,6,16,31,55,-24,21
CC Mariners,680,10,4,8,15,28,49,-21,20
Sydney FC,681,1,21,4,3,65,22,43,67
N'castle Jet,681,2,16,5,7,60,39,21,53
Melbourne C,681,3,14,4,11,45,36,9,46
Melbourne V,681,4,13,5,11,45,39,6,44
Adelaide Utd,681,5,11,6,11,37,40,-3,39
Brisbane,681,6,10,5,13,33,42,-9,35
Western Sydn,681,7,8,9,10,38,47,-9,33
Perth Glory,681,8,10,2,15,37,50,-13,32
Wellington P,681,9,5,6,16,31,55,-24,21
CC Mariners,681,10,4,8,15,28,49,-21,20
Sydney FC,682,1,21,4,3,66,23,43,67
N'castle Jet,682,2,15,6,7,59,39,20,51
Melbourne C,682,3,14,5,10,45,35,10,47
Melbourne V,682,4,13,5,11,46,40,6,44
Adelaide Utd,682,5,11,6,11,37,40,-3,39
Brisbane,682,6,10,5,13,33,42,-9,35
Western Sydn,682,7,8,9,10,38,47,-9,33
Perth Glory,682,8,10,2,15,37,50,-13,32
Wellington P,682,9,5,6,16,31,55,-24,21
CC Mariners,682,10,4,8,15,28,49,-21,20
Sydney FC,683,1,20,4,4,65,24,41,64
N'castle Jet,683,2,15,6,7,58,38,20,51
Melbourne C,683,3,14,5,10,44,34,10,47
Melbourne V,683,4,14,5,10,47,39,8,47
Adelaide Utd,683,5,11,6,11,37,40,-3,39
Brisbane,683,6,10,5,13,33,42,-9,35
Western Sydn,683,7,8,9,10,38,47,-9,33
Perth Glory,683,8,10,2,15,37,50,-13,32
Wellington P,683,9,5,6,16,31,55,-24,21
CC Mariners,683,10,4,8,15,28,49,-21,20
Sydney FC,684,1,20,5,3,65,23,42,65
N'castle Jet,684,2,16,5,7,60,39,21,53
Melbourne C,684,3,14,4,11,45,36,9,46
Melbourne V,684,4,13,6,10,46,39,7,45
Adelaide Utd,684,5,11,6,11,37,40,-3,39
Brisbane,684,6,10,5,13,33,42,-9,35
Western Sydn,684,7,8,9,10,38,47,-9,33
Perth Glory,684,8,10,2,15,37,50,-13,32
Wellington P,684,9,5,6,16,31,55,-24,21
CC Mariners,684,10,4,8,15,28,49,-21,20
Sydney FC,685,1,20,4,4,65,24,41,64
N'castle Jet,685,2,15,5,8,58,39,19,50
Melbourne C,685,3,15,4,10,45,34,11,49
Melbourne V,685,4,14,5,10,47,39,8,47
Adelaide Utd,685,5,11,6,11,37,40,-3,39
Brisbane,685,6,10,5,13,33,42,-9,35
Western Sydn,685,7,8,9,10,38,47,-9,33
Perth Glory,685,8,10,2,15,37,50,-13,32
Wellington P,685,9,5,6,16,31,55,-24,21
CC Mariners,685,10,4,8,15,28,49,-21,20
Sydney FC,686,1,20,4,4,64,23,41,64
N'castle Jet,686,2,15,5,8,57,39,18,50
Melbourne C,686,3,15,4,10,45,33,12,49
Melbourne V,686,4,14,5,10,46,38,8,47
Adelaide Utd,686,5,11,6,11,37,40,-3,39
Brisbane,686,6,10,5,13,33,42,-9,35
Western Sydn,686,7,8,9,10,38,47,-9,33
Perth Glory,686,8,10,2,15,37,50,-13,32
Wellington P,686,9,5,6,16,31,55,-24,21
CC Mariners,686,10,4,8,15,28,49,-21,20
Sydney FC,687,1,20,4,4,65,26,39,64
N'castle Jet,687,2,15,6,7,57,37,20,51
Melbourne V,687,3,14,5,10,49,39,10,47
Melbourne C,687,4,14,5,10,43,33,10,47
Adelaide Utd,687,5,11,6,11,37,40,-3,39
Brisbane,687,6,10,5,13,33,42,-9,35
Western Sydn,687,7,8,9,10,38,47,-9,33
Perth Glory,687,8,10,2,15,37,50,-13,32
Wellington P,687,9,5,6,16,31,55,-24,21
CC Mariners,687,10,4,8,15,28,49,-21,20
Sydney FC,688,1,21,4,3,67,23,44,67
N'castle Jet,688,2,15,6,7,58,38,20,51
Melbourne C,688,3,14,5,10,44,34,10,47
Melbourne V,688,4,13,5,11,46,41,5,44
Adelaide Utd,688,5,11,6,11,37,40,-3,39
Brisbane,688,6,10,5,13,33,42,-9,35
Western Sydn,688,7,8,9,10,38,47,-9,33
Perth Glory,688,8,10,2,15,37,50,-13,32
Wellington P,688,9,5,6,16,31,55,-24,21
CC Mariners,688,10,4,8,15,28,49,-21,20
Sydney FC,689,1,20,4,4,66,25,41,64
N'castle Jet,689,2,15,6,7,59,39,20,51
Melbourne C,689,3,14,5,10,45,35,10,47
Melbourne V,689,4,14,5,10,48,40,8,47
Adelaide Utd,689,5,11,6,11,37,40,-3,39
Brisbane,689,6,10,5,13,33,42,-9,35
Western Sydn,689,7,8,9,10,38,47,-9,33
Perth Glory,689,8,10,2,15,37,50,-13,32
Wellington P,689,9,5,6,16,31,55,-24,21
CC Mariners,689,10,4,8,15,28,49,-21,20
Sydney FC,690,1,21,4,3,66,22,44,67
N'castle Jet,690,2,16,5,7,59,38,21,53
Melbourne C,690,3,14,4,11,44,35,9,46
Melbourne V,690,4,13,5,11,45,40,5,44
Adelaide Utd,690,5,11,6,11,37,40,-3,39
Brisbane,690,6,10,5,13,33,42,-9,35
Western Sydn,690,7,8,9,10,38,47,-9,33
Perth Glory,690,8,10,2,15,37,50,-13,32
Wellington P,690,9,5,6,16,31,55,-24,21
CC Mariners,690,10,4,8,15,28,49,-21,20
Sydney FC,691,1,20,5,3,65,23,42,65
N'castle Jet,691,2,15,6,7,57,37,20,51
Melbourne C,691,3,14,5,10,43,33,10,47
Melbourne V,691,4,13,6,10,46,39,7,45
Adelaide Utd,691,5,11,6,11,37,40,-3,39
Brisbane,691,6,10,5,13,33,42,-9,35
Western Sydn,691,7,8,9,10,38,47,-9,33
Perth Glory,691,8,10,2,15,37,50,-13,32
Wellington P,691,9,5,6,16,31,55,-24,21
CC Mariners,691,10,4,8,15,28,49,-21,20
Sydney FC,692,1,21,4,3,66,22,44,67
N'castle Jet,692,2,16,5,7,59,38,21,53
Melbourne C,692,3,14,4,11,44,35,9,46
Melbourne V,692,4,13,5,11,45,40,5,44
Adelaide Utd,692,5,11,6,11,37,40,-3,39
Brisbane,692,6,10,5,13,33,42,-9,35
Western Sydn,692,7,8,9,10,38,47,-9,33
Perth Glory,692,8,10,2,15,37,50,-13,32
Wellington P,692,9,5,6,16,31,55,-24,21
CC Mariners,692,10,4,8,15,28,49,-21,20
Sydney FC,693,1,20,4,4,65,24,41,64
N'castle Jet,693,2,16,5,7,62,40,22,53
Melbourne V,693,3,14,5,10,47,39,8,47
Melbourne C,693,4,14,4,11,46,38,8,46
Adelaide Utd,693,5,11,6,11,37,40,-3,39
Brisbane,693,6,10,5,13,33,42,-9,35
Western Sydn,693,7,8,9,10,38,47,-9,33
Perth Glory,693,8,10,2,15,37,50,-13,32
Wellington P,693,9,5,6,16,31,55,-24,21
CC Mariners,693,10,4,8,15,28,49,-21,20
Sydney FC,694,1,20,5,3,64,22,42,65
N'castle Jet,694,2,15,6,7,57,37,20,51
Melbourne C,694,3,14,5,10,43,33,10,47
Melbourne V,694,4,13,6,10,45,38,7,45
Adelaide Utd,694,5,11,6,11,37,40,-3,39
Brisbane,694,6,10,5,13,33,42,-9,35
Western Sydn,694,7,8,9,10,38,47,-9,33
Perth Glory,694,8,10,2,15,37,50,-13,32
Wellington P,694,9,5,6,16,31,55,-24,21
CC Mariners,694,10,4,8,15,28,49,-21,20
Sydney FC,695,1,21,4,3,69,22,47,67
N'castle Jet,695,2,16,5,7,59,37,22,53
Melbourne C,695,3,14,4,11,43,35,8,46
Melbourne V,695,4,13,5,11,45,43,2,44
Adelaide Utd,695,5,11,6,11,37,40,-3,39
Brisbane,695,6,10,5,13,33,42,-9,35
Western Sydn,695,7,8,9,10,38,47,-9,33
Perth Glory,695,8,10,2,15,37,50,-13,32
Wellington P,695,9,5,6,16,31,55,-24,21
CC Mariners,695,10,4,8,15,28,49,-21,20
Sydney FC,696,1,21,4,3,67,22,45,67
N'castle Jet,696,2,16,5,7,60,37,23,53
Melbourne C,696,3,14,4,11,43,36,7,46
Melbourne V,696,4,13,5,11,45,41,4,44
Adelaide Utd,696,5,11,6,11,37,40,-3,39
Brisbane,696,6,10,5,13,33,42,-9,35
Western Sydn,696,7,8,9,10,38,47,-9,33
Perth Glory,696,8,10,2,15,37,50,-13,32
Wellington P,696,9,5,6,16,31,55,-24,21
CC Mariners,696,10,4,8,15,28,49,-21,20
Sydney FC,697,1,20,4,4,65,24,41,64
N'castle Jet,697,2,16,5,7,59,38,21,53
Melbourne V,697,3,14,5,10,47,39,8,47
Melbourne C,697,4,14,4,11,44,35,9,46
Adelaide Utd,697,5,11,6,11,37,40,-3,39
Brisbane,697,6,10,5,13,33,42,-9,35
Western Sydn,697,7,8,9,10,38,47,-9,33
Perth Glory,697,8,10,2,15,37,50,-13,32
Wellington P,697,9,5,6,16,31,55,-24,21
CC Mariners,697,10,4,8,15,28,49,-21,20
Sydney FC,698,1,21,4,3,65,22,43,67
N'castle Jet,698,2,15,6,7,59,39,20,51
Melbourne C,698,3,14,5,10,45,35,10,47
Melbourne V,698,4,13,5,11,45,39,6,44
Adelaide Utd,698,5,11,6,11,37,40,-3,39
Brisbane,698,6,10,5,13,33,42,-9,35
Western Sydn,698,7,8,9,10,38,47,-9,33
Perth Glory,698,8,10,2,15,37,50,-13,32
Wellington P,698,9,5,6,16,31,55,-24,21
CC Mariners,698,10,4,8,15,28,49,-21,20
Sydney FC,699,1,21,4,3,66,22,44,67
N'castle Jet,699,2,15,6,7,60,40,20,51
Melbourne C,699,3,14,5,10,46,36,10,47
Melbourne V,699,4,13,5,11,45,40,5,44
Adelaide Utd,699,5,11,6,11,37,40,-3,39
Brisbane,699,6,10,5,13,33,42,-9,35
Western Sydn,699,7,8,9,10,38,47,-9,33
Perth Glory,699,8,10,2,15,37,50,-13,32
Wellington P,699,9,5,6,16,31,55,-24,21
CC Mariners,699,10,4,8,15,28,49,-21,20
Sydney FC,700,1,21,4,3,66,23,43,67
N'castle Jet,700,2,16,5,7,58,37,21,53
Melbourne C,700,3,14,4,11,43,34,9,46
Melbourne V,700,4,13,5,11,46,40,6,44
Adelaide Utd,700,5,11,6,11,37,40,-3,39
Brisbane,700,6,10,5,13,33,42,-9,35
Western Sydn,700,7,8,9,10,38,47,-9,33
Perth Glory,700,8,10,2,15,37,50,-13,32
Wellington P,700,9,5,6,16,31,55,-24,21
CC Mariners,700,10,4,8,15,28,49,-21,20
Sydney FC,701,1,20,4,4,65,27,38,64
N'castle Jet,701,2,16,5,7,59,37,22,53
Melbourne V,701,3,14,5,10,50,39,11,47
Melbourne C,701,4,14,4,11,43,35,8,46
Adelaide Utd,701,5,11,6,11,37,40,-3,39
Brisbane,701,6,10,5,13,33,42,-9,35
Western Sydn,701,7,8,9,10,38,47,-9,33
Perth Glory,701,8,10,2,15,37,50,-13,32
Wellington P,701,9,5,6,16,31,55,-24,21
CC Mariners,701,10,4,8,15,28,49,-21,20
Sydney FC,702,1,21,4,3,67,22,45,67
N'castle Jet,702,2,16,5,7,60,38,22,53
Melbourne C,702,3,14,4,11,44,36,8,46
Melbourne V,702,4,13,5,11,45,41,4,44
Adelaide Utd,702,5,11,6,11,37,40,-3,39
Brisbane,702,6,10,5,13,33,42,-9,35
Western Sydn,702,7,8,9,10,38,47,-9,33
Perth Glory,702,8,10,2,15,37,50,-13,32
Wellington P,702,9,5,6,16,31,55,-24,21
CC Mariners,702,10,4,8,15,28,49,-21,20
Sydney FC,703,1,20,4,4,65,25,40,64
N'castle Jet,703,2,15,6,7,59,39,20,51
Melbourne C,703,3,14,5,10,45,35,10,47
Melbourne V,703,4,14,5,10,48,39,9,47
Adelaide Utd,703,5,11,6,11,37,40,-3,39
Brisbane,703,6,10,5,13,33,42,-9,35
Western Sydn,703,7,8,9,10,38,47,-9,33
Perth Glory,703,8,10,2,15,37,50,-13,32
Wellington P,703,9,5,6,16,31,55,-24,21
CC Mariners,703,10,4,8,15,28,49,-21,20
Sydney FC,704,1,20,4,4,64,25,39,64
N'castle Jet,704,2,16,5,7,62,38,24,53
Melbourne V,704,3,14,5,10,48,38,10,47
Melbourne C,704,4,14,4,11,44,38,6,46
Adelaide Utd,704,5,11,6,11,37,40,-3,39
Brisbane,704,6,10,5,13,33,42,-9,35
Western Sydn,704,7,8,9,10,38,47,-9,33
Perth Glory,704,8,10,2,15,37,50,-13,32
Wellington P,704,9,5,6,16,31,55,-24,21
CC Mariners,704,10,4,8,15,28,49,-21,20
Sydney FC,705,1,21,4,3,67,22,45,67
N'castle Jet,705,2,16,5,7,59,38,21,53
Melbourne C,705,3,14,4,11,44,35,9,46
Melbourne V,705,4,13,5,11,45,41,4,44
Adelaide Utd,705,5,11,6,11,37,40,-3,39
Brisbane,705,6,10,5,13,33,42,-9,35
Western Sydn,705,7,8,9,10,38,47,-9,33
Perth Glory,705,8,10,2,15,37,50,-13,32
Wellington P,705,9,5,6,16,31,55,-24,21
CC Mariners,705,10,4,8,15,28,49,-21,20
Sydney FC,706,1,21,4,3,66,23,43,67
N'castle Jet,706,2,15,5,8,57,39,18,50
Melbourne C,706,3,15,4,10,45,33,12,49
Melbourne V,706,4,13,5,11,46,40,6,44
Adelaide Utd,706,5,11,6,11,37,40,-3,39
Brisbane,706,6,10,5,13,33,42,-9,35
Western Sydn,706,7,8,9,10,38,47,-9,33
Perth Glory,706,8,10,2,15,37,50,-13,32
Wellington P,706,9,5,6,16,31,55,-24,21
CC Mariners,706,10,4,8,15,28,49,-21,20
Sydney FC,707,1,21,4,3,66,22,44,67
N'castle Jet,707,2,15,5,8,57,38,19,50
Melbourne C,707,3,15,4,10,44,33,11,49
Melbourne V,707,4,13,5,11,45,40,5,44
Adelaide Utd,707,5,11,6,11,37,40,-3,39
Brisbane,707,6,10,5,13,33,42,-9,35
Western Sydn,707,7,8,9,10,38,47,-9,33
Perth Glory,707,8,10,2,15,37,50,-13,32
Wellington P,707,9,5,6,16,31,55,-24,21
CC Mariners,707,10,4,8,15,28,49,-21,20
Sydney FC,708,1,21,4,3,66,23,43,67
N'castle Jet,708,2,15,6,7,57,37,20,51
Melbourne C,708,3,14,5,10,43,33,10,47
Melbourne V,708,4,13,5,11,46,40,6,44
Adelaide Utd,708,5,11,6,11,37,40,-3,39
Brisbane,708,6,10,5,13,33,42,-9,35
Western Sydn,708,7,8,9,10,38,47,-9,33
Perth Glory,708,8,10,2,15,37,50,-13,32
Wellington P,708,9,5,6,16,31,55,-24,21
CC Mariners,708,10,4,8,15,28,49,-21,20
Sydney FC,709,1,21,4,3,69,23,46,67
N'castle Jet,709,2,15,6,7,59,39,20,51
Melbourne C,709,3,14,5,10,45,35,10,47
Melbourne V,709,4,13,5,11,46,43,3,44
Adelaide Utd,709,5,11,6,11,37,40,-3,39
Brisbane,709,6,10,5,13,33,42,-9,35
Western Sydn,709,7,8,9,10,38,47,-9,33
Perth Glory,709,8,10,2,15,37,50,-13,32
Wellington P,709,9,5,6,16,31,55,-24,21
CC Mariners,709,10,4,8,15,28,49,-21,20
Sydney FC,710,1,21,4,3,68,22,46,67
N'castle Jet,710,2,15,5,8,59,40,19,50
Melbourne C,710,3,15,4,10,46,35,11,49
Melbourne V,710,4,13,5,11,45,42,3,44
Adelaide Utd,710,5,11,6,11,37,40,-3,39
Brisbane,710,6,10,5,13,33,42,-9,35
Western Sydn,710,7,8,9,10,38,47,-9,33
Perth Glory,710,8,10,2,15,37,50,-13,32
Wellington P,710,9,5,6,16,31,55,-24,21
CC Mariners,710,10,4,8,15,28,49,-21,20
Sydney FC,711,1,21,4,3,66,23,43,67
N'castle Jet,711,2,15,6,7,59,39,20,51
Melbourne C,711,3,14,5,10,45,35,10,47
Melbourne V,711,4,13,5,11,46,40,6,44
Adelaide Utd,711,5,11,6,11,37,40,-3,39
Brisbane,711,6,10,5,13,33,42,-9,35
Western Sydn,711,7,8,9,10,38,47,-9,33
Perth Glory,711,8,10,2,15,37,50,-13,32
Wellington P,711,9,5,6,16,31,55,-24,21
CC Mariners,711,10,4,8,15,28,49,-21,20
Sydney FC,712,1,21,4,3,67,23,44,67
N'castle Jet,712,2,15,5,8,58,42,16,50
Melbourne C,712,3,15,4,10,48,34,14,49
Melbourne V,712,4,13,5,11,46,41,5,44
Adelaide Utd,712,5,11,6,11,37,40,-3,39
Brisbane,712,6,10,5,13,33,42,-9,35
Western Sydn,712,7,8,9,10,38,47,-9,33
Perth Glory,712,8,10,2,15,37,50,-13,32
Wellington P,712,9,5,6,16,31,55,-24,21
CC Mariners,712,10,4,8,15,28,49,-21,20
Sydney FC,713,1,21,4,3,66,23,43,67
N'castle Jet,713,2,16,5,7,60,38,22,53
Melbourne C,713,3,14,4,11,44,36,8,46
Melbourne V,713,4,13,5,11,46,40,6,44
Adelaide Utd,713,5,11,6,11,37,40,-3,39
Brisbane,713,6,10,5,13,33,42,-9,35
Western Sydn,713,7,8,9,10,38,47,-9,33
Perth Glory,713,8,10,2,15,37,50,-13,32
Wellington P,713,9,5,6,16,31,55,-24,21
CC Mariners,713,10,4,8,15,28,49,-21,20
Sydney FC,714,1,21,4,3,66,22,44,67
N'castle Jet,714,2,15,5,8,58,39,19,50
Melbourne C,714,3,15,4,10,45,34,11,49
Melbourne V,714,4,13,5,11,45,40,5,44
Adelaide Utd,714,5,11,6,11,37,40,-3,39
Brisbane,714,6,10,5,13,33,42,-9,35
Western Sydn,714,7,8,9,10,38,47,-9,33
Perth Glory,714,8,10,2,15,37,50,-13,32
Wellington P,714,9,5,6,16,31,55,-24,21
CC Mariners,714,10,4,8,15,28,49,-21,20
Sydney FC,715,1,20,5,3,65,23,42,65
N'castle Jet,715,2,15,6,7,59,39,20,51
Melbourne C,715,3,14,5,10,45,35,10,47
Melbourne V,715,4,13,6,10,46,39,7,45
Adelaide Utd,715,5,11,6,11,37,40,-3,39
Brisbane,715,6,10,5,13,33,42,-9,35
Western Sydn,715,7,8,9,10,38,47,-9,33
Perth Glory,715,8,10,2,15,37,50,-13,32
Wellington P,715,9,5,6,16,31,55,-24,21
CC Mariners,715,10,4,8,15,28,49,-21,20
Sydney FC,716,1,21,4,3,66,22,44,67
N'castle Jet,716,2,15,5,8,57,40,17,50
Melbourne C,716,3,15,4,10,46,33,13,49
Melbourne V,716,4,13,5,11,45,40,5,44
Adelaide Utd,716,5,11,6,11,37,40,-3,39
Brisbane,716,6,10,5,13,33,42,-9,35
Western Sydn,716,7,8,9,10,38,47,-9,33
Perth Glory,716,8,10,2,15,37,50,-13,32
Wellington P,716,9,5,6,16,31,55,-24,21
CC Mariners,716,10,4,8,15,28,49,-21,20
Sydney FC,717,1,21,4,3,67,22,45,67
N'castle Jet,717,2,15,6,7,57,37,20,51
Melbourne C,717,3,14,5,10,43,33,10,47
Melbourne V,717,4,13,5,11,45,41,4,44
Adelaide Utd,717,5,11,6,11,37,40,-3,39
Brisbane,717,6,10,5,13,33,42,-9,35
Western Sydn,717,7,8,9,10,38,47,-9,33
Perth Glory,717,8,10,2,15,37,50,-13,32
Wellington P,717,9,5,6,16,31,55,-24,21
CC Mariners,717,10,4,8,15,28,49,-21,20
Sydney FC,718,1,21,4,3,68,22,46,67
N'castle Jet,718,2,15,5,8,57,39,18,50
Melbourne C,718,3,15,4,10,45,33,12,49
Melbourne V,718,4,13,5,11,45,42,3,44
Adelaide Utd,718,5,11,6,11,37,40,-3,39
Brisbane,718,6,10,5,13,33,42,-9,35
Western Sydn,718,7,8,9,10,38,47,-9,33
Perth Glory,718,8,10,2,15,37,50,-13,32
Wellington P,718,9,5,6,16,31,55,-24,21
CC Mariners,718,10,4,8,15,28,49,-21,20
Sydney FC,719,1,21,4,3,69,23,46,67
N'castle Jet,719,2,15,6,7,58,38,20,51
Melbourne C,719,3,14,5,10,44,34,10,47
Melbourne V,719,4,13,5,11,46,43,3,44
Adelaide Utd,719,5,11,6,11,37,40,-3,39
Brisbane,719,6,10,5,13,33,42,-9,35
Western Sydn,719,7,8,9,10,38,47,-9,33
Perth Glory,719,8,10,2,15,37,50,-13,32
Wellington P,719,9,5,6,16,31,55,-24,21
CC Mariners,719,10,4,8,15,28,49,-21,20
Sydney FC,720,1,21,4,3,66,22,44,67
N'castle Jet,720,2,16,5,7,58,37,21,53
Melbourne C,720,3,14,4,11,43,34,9,46
Melbourne V,720,4,13,5,11,45,40,5,44
Adelaide Utd,720,5,11,6,11,37,40,-3,39
Brisbane,720,6,10,5,13,33,42,-9,35
Western Sydn,720,7,8,9,10,38,47,-9,33
Perth Glory,720,8,10,2,15,37,50,-13,32
Wellington P,720,9,5,6,16,31,55,-24,21
CC Mariners,720,10,4,8,15,28,49,-21,20
Sydney FC,721,1,21,4,3,71,22,49,67
N'castle Jet,721,2,15,6,7,58,38,20,51
Melbourne C,721,3,14,5,10,44,34,10,47
Melbourne V,721,4,13,5,11,45,45,0,44
Adelaide Utd,721,5,11,6,11,37,40,-3,39
Brisbane,721,6,10,5,13,33,42,-9,35
Western Sydn,721,7,8,9,10,38,47,-9,33
Perth Glory,721,8,10,2,15,37,50,-13,32
Wellington P,721,9,5,6,16,31,55,-24,21
CC Mariners,721,10,4,8,15,28,49,-21,20
Sydney FC,722,1,21,4,3,70,22,48,67
N'castle Jet,722,2,15,6,7,58,38,20,51
Melbourne C,722,3,14,5,10,44,34,10,47
Melbourne V,722,4,13,5,11,45,44,1,44
Adelaide Utd,722,5,11,6,11,37,40,-3,39
Brisbane,722,6,10,5,13,33,42,-9,35
Western Sydn,722,7,8,9,10,38,47,-9,33
Perth Glory,722,8,10,2,15,37,50,-13,32
Wellington P,722,9,5,6,16,31,55,-24,21
CC Mariners,722,10,4,8,15,28,49,-21,20
Sydney FC,723,1,21,4,3,66,22,44,67
N'castle Jet,723,2,15,5,8,57,38,19,50
Melbourne C,723,3,15,4,10,44,33,11,49
Melbourne V,723,4,13,5,11,45,40,5,44
Adelaide Utd,723,5,11,6,11,37,40,-3,39
Brisbane,723,6,10,5,13,33,42,-9,35
Western Sydn,723,7,8,9,10,38,47,-9,33
Perth Glory,723,8,10,2,15,37,50,-13,32
Wellington P,723,9,5,6,16,31,55,-24,21
CC Mariners,723,10,4,8,15,28,49,-21,20
Sydney FC,724,1,21,4,3,67,23,44,67
N'castle Jet,724,2,16,5,7,60,37,23,53
Melbourne C,724,3,14,4,11,43,36,7,46
Melbourne V,724,4,13,5,11,46,41,5,44
Adelaide Utd,724,5,11,6,11,37,40,-3,39
Brisbane,724,6,10,5,13,33,42,-9,35
Western Sydn,724,7,8,9,10,38,47,-9,33
Perth Glory,724,8,10,2,15,37,50,-13,32
Wellington P,724,9,5,6,16,31,55,-24,21
CC Mariners,724,10,4,8,15,28,49,-21,20
Sydney FC,725,1,20,4,4,65,24,41,64
N'castle Jet,725,2,16,5,7,59,37,22,53
Melbourne V,725,3,14,5,10,47,39,8,47
Melbourne C,725,4,14,4,11,43,35,8,46
Adelaide Utd,725,5,11,6,11,37,40,-3,39
Brisbane,725,6,10,5,13,33,42,-9,35
Western Sydn,725,7,8,9,10,38,47,-9,33
Perth Glory,725,8,10,2,15,37,50,-13,32
Wellington P,725,9,5,6,16,31,55,-24,21
CC Mariners,725,10,4,8,15,28,49,-21,20
Sydney FC,726,1,21,4,3,67,23,44,67
N'castle Jet,726,2,15,5,8,58,39,19,50
Melbourne C,726,3,15,4,10,45,34,11,49
Melbourne V,726,4,13,5,11,46,41,5,44
Adelaide Utd,726,5,11,6,11,37,40,-3,39
Brisbane,726,6,10,5,13,33,42,-9,35
Western Sydn,726,7,8,9,10,38,47,-9,33
Perth Glory,726,8,10,2,15,37,50,-13,32
Wellington P,726,9,5,6,16,31,55,-24,21
CC Mariners,726,10,4,8,15,28,49,-21,20
Sydney FC,727,1,20,4,4,65,24,41,64
N'castle Jet,727,2,16,5,7,60,38,22,53
Melbourne V,727,3,14,5,10,47,39,8,47
Melbourne C,727,4,14,4,11,44,36,8,46
Adelaide Utd,727,5,11,6,11,37,40,-3,39
Brisbane,727,6,10,5,13,33,42,-9,35
Western Sydn,727,7,8,9,10,38,47,-9,33
Perth Glory,727,8,10,2,15,37,50,-13,32
Wellington P,727,9,5,6,16,31,55,-24,21
CC Mariners,727,10,4,8,15,28,49,-21,20
Sydney FC,728,1,21,4,3,67,23,44,67
N'castle Jet,728,2,16,5,7,61,39,22,53
Melbourne C,728,3,14,4,11,45,37,8,46
Melbourne V,728,4,13,5,11,46,41,5,44
Adelaide Utd,728,5,11,6,11,37,40,-3,39
Brisbane,728,6,10,5,13,33,42,-9,35
Western Sydn,728,7,8,9,10,38,47,-9,33
Perth Glory,728,8,10,2,15,37,50,-13,32
Wellington P,728,9,5,6,16,31,55,-24,21
CC Mariners,728,10,4,8,15,28,49,-21,20
Sydney FC,729,1,20,5,3,65,23,42,65
N'castle Jet,729,2,16,5,7,59,38,21,53
Melbourne C,729,3,14,4,11,44,35,9,46
Melbourne V,729,4,13,6,10,46,39,7,45
Adelaide Utd,729,5,11,6,11,37,40,-3,39
Brisbane,729,6,10,5,13,33,42,-9,35
Western Sydn,729,7,8,9,10,38,47,-9,33
Perth Glory,729,8,10,2,15,37,50,-13,32
Wellington P,729,9,5,6,16,31,55,-24,21
CC Mariners,729,10,4,8,15,28,49,-21,20
Sydney FC,730,1,21,4,3,66,22,44,67
N'castle Jet,730,2,16,5,7,59,38,21,53
Melbourne C,730,3,14,4,11,44,35,9,46
Melbourne V,730,4,13,5,11,45,40,5,44
Adelaide Utd,730,5,11,6,11,37,40,-3,39
Brisbane,730,6,10,5,13,33,42,-9,35
Western Sydn,730,7,8,9,10,38,47,-9,33
Perth Glory,730,8,10,2,15,37,50,-13,32
Wellington P,730,9,5,6,16,31,55,-24,21
CC Mariners,730,10,4,8,15,28,49,-21,20
Sydney FC,731,1,21,4,3,66,23,43,67
N'castle Jet,731,2,15,6,7,59,39,20,51
Melbourne C,731,3,14,5,10,45,35,10,47
Melbourne V,731,4,13,5,11,46,40,6,44
Adelaide Utd,731,5,11,6,11,37,40,-3,39
Brisbane,731,6,10,5,13,33,42,-9,35
Western Sydn,731,7,8,9,10,38,47,-9,33
Perth Glory,731,8,10,2,15,37,50,-13,32
Wellington P,731,9,5,6,16,31,55,-24,21
CC Mariners,731,10,4,8,15,28,49,-21,20
Sydney FC,732,1,20,5,3,65,23,42,65
N'castle Jet,732,2,16,5,7,61,38,23,53
Melbourne C,732,3,14,4,11,44,37,7,46
Melbourne V,732,4,13,6,10,46,39,7,45
Adelaide Utd,732,5,11,6,11,37,40,-3,39
Brisbane,732,6,10,5,13,33,42,-9,35
Western Sydn,732,7,8,9,10,38,47,-9,33
Perth Glory,732,8,10,2,15,37,50,-13,32
Wellington P,732,9,5,6,16,31,55,-24,21
CC Mariners,732,10,4,8,15,28,49,-21,20
Sydney FC,733,1,20,5,3,67,25,42,65
N'castle Jet,733,2,15,6,7,59,39,20,51
Melbourne C,733,3,14,5,10,45,35,10,47
Melbourne V,733,4,13,6,10,48,41,7,45
Adelaide Utd,733,5,11,6,11,37,40,-3,39
Brisbane,733,6,10,5,13,33,42,-9,35
Western Sydn,733,7,8,9,10,38,47,-9,33
Perth Glory,733,8,10,2,15,37,50,-13,32
Wellington P,733,9,5,6,16,31,55,-24,21
CC Mariners,733,10,4,8,15,28,49,-21,20
Sydney FC,734,1,21,4,3,66,23,43,67
N'castle Jet,734,2,15,6,7,60,40,20,51
Melbourne C,734,3,14,5,10,46,36,10,47
Melbourne V,734,4,13,5,11,46,40,6,44
Adelaide Utd,734,5,11,6,11,37,40,-3,39
Brisbane,734,6,10,5,13,33,42,-9,35
Western Sydn,734,7,8,9,10,38,47,-9,33
Perth Glory,734,8,10,2,15,37,50,-13,32
Wellington P,734,9,5,6,16,31,55,-24,21
CC Mariners,734,10,4,8,15,28,49,-21,20
Sydney FC,735,1,21,4,3,67,24,43,67
N'castle Jet,735,2,16,5,7,60,37,23,53
Melbourne C,735,3,14,4,11,43,36,7,46
Melbourne V,735,4,13,5,11,47,41,6,44
Adelaide Utd,735,5,11,6,11,37,40,-3,39
Brisbane,735,6,10,5,13,33,42,-9,35
Western Sydn,735,7,8,9,10,38,47,-9,33
Perth Glory,735,8,10,2,15,37,50,-13,32
Wellington P,735,9,5,6,16,31,55,-24,21
CC Mariners,735,10,4,8,15,28,49,-21,20
Sydney FC,736,1,20,4,4,65,27,38,64
N'castle Jet,736,2,15,5,8,57,39,18,50
Melbourne C,736,3,15,4,10,45,33,12,49
Melbourne V,736,4,14,5,10,50,39,11,47
Adelaide Utd,736,5,11,6,11,37,40,-3,39
Brisbane,736,6,10,5,13,33,42,-9,35
Western Sydn,736,7,8,9,10,38,47,-9,33
Perth Glory,736,8,10,2,15,37,50,-13,32
Wellington P,736,9,5,6,16,31,55,-24,21
CC Mariners,736,10,4,8,15,28,49,-21,20
Sydney FC,737,1,20,4,4,64,23,41,64
N'castle Jet,737,2,16,5,7,58,37,21,53
Melbourne V,737,3,14,5,10,46,38,8,47
Melbourne C,737,4,14,4,11,43,34,9,46
Adelaide Utd,737,5,11,6,11,37,40,-3,39
Brisbane,737,6,10,5,13,33,42,-9,35
Western Sydn,737,7,8,9,10,38,47,-9,33
Perth Glory,737,8,10,2,15,37,50,-13,32
Wellington P,737,9,5,6,16,31,55,-24,21
CC Mariners,737,10,4,8,15,28,49,-21,20
Sydney FC,738,1,20,4,4,65,24,41,64
N'castle Jet,738,2,16,5,7,59,38,21,53
Melbourne V,738,3,14,5,10,47,39,8,47
Melbourne C,738,4,14,4,11,44,35,9,46
Adelaide Utd,738,5,11,6,11,37,40,-3,39
Brisbane,738,6,10,5,13,33,42,-9,35
Western Sydn,738,7,8,9,10,38,47,-9,33
Perth Glory,738,8,10,2,15,37,50,-13,32
Wellington P,738,9,5,6,16,31,55,-24,21
CC Mariners,738,10,4,8,15,28,49,-21,20
Sydney FC,739,1,21,4,3,68,23,45,67
N'castle Jet,739,2,15,6,7,58,38,20,51
Melbourne C,739,3,14,5,10,44,34,10,47
Melbourne V,739,4,13,5,11,46,42,4,44
Adelaide Utd,739,5,11,6,11,37,40,-3,39
Brisbane,739,6,10,5,13,33,42,-9,35
Western Sydn,739,7,8,9,10,38,47,-9,33
Perth Glory,739,8,10,2,15,37,50,-13,32
Wellington P,739,9,5,6,16,31,55,-24,21
CC Mariners,739,10,4,8,15,28,49,-21,20
Sydney FC,740,1,21,4,3,66,22,44,67
N'castle Jet,740,2,16,5,7,59,38,21,53
Melbourne C,740,3,14,4,11,44,35,9,46
Melbourne V,740,4,13,5,11,45,40,5,44
Adelaide Utd,740,5,11,6,11,37,40,-3,39
Brisbane,740,6,10,5,13,33,42,-9,35
Western Sydn,740,7,8,9,10,38,47,-9,33
Perth Glory,740,8,10,2,15,37,50,-13,32
Wellington P,740,9,5,6,16,31,55,-24,21
CC Mariners,740,10,4,8,15,28,49,-21,20
Sydney FC,741,1,20,5,3,65,23,42,65
N'castle Jet,741,2,16,5,7,59,38,21,53
Melbourne C,741,3,14,4,11,44,35,9,46
Melbourne V,741,4,13,6,10,46,39,7,45
Adelaide Utd,741,5,11,6,11,37,40,-3,39
Brisbane,741,6,10,5,13,33,42,-9,35
Western Sydn,741,7,8,9,10,38,47,-9,33
Perth Glory,741,8,10,2,15,37,50,-13,32
Wellington P,741,9,5,6,16,31,55,-24,21
CC Mariners,741,10,4,8,15,28,49,-21,20
Sydney FC,742,1,20,5,3,65,23,42,65
N'castle Jet,742,2,15,5,8,58,39,19,50
Melbourne C,742,3,15,4,10,45,34,11,49
Melbourne V,742,4,13,6,10,46,39,7,45
Adelaide Utd,742,5,11,6,11,37,40,-3,39
Brisbane,742,6,10,5,13,33,42,-9,35
Western Sydn,742,7,8,9,10,38,47,-9,33
Perth Glory,742,8,10,2,15,37,50,-13,32
Wellington P,742,9,5,6,16,31,55,-24,21
CC Mariners,742,10,4,8,15,28,49,-21,20
Sydney FC,743,1,21,4,3,66,23,43,67
N'castle Jet,743,2,15,5,8,59,40,19,50
Melbourne C,743,3,15,4,10,46,35,11,49
Melbourne V,743,4,13,5,11,46,40,6,44
Adelaide Utd,743,5,11,6,11,37,40,-3,39
Brisbane,743,6,10,5,13,33,42,-9,35
Western Sydn,743,7,8,9,10,38,47,-9,33
Perth Glory,743,8,10,2,15,37,50,-13,32
Wellington P,743,9,5,6,16,31,55,-24,21
CC Mariners,743,10,4,8,15,28,49,-21,20
Sydney FC,744,1,20,5,3,65,23,42,65
N'castle Jet,744,2,16,5,7,59,38,21,53
Melbourne C,744,3,14,4,11,44,35,9,46
Melbourne V,744,4,13,6,10,46,39,7,45
Adelaide Utd,744,5,11,6,11,37,40,-3,39
Brisbane,744,6,10,5,13,33,42,-9,35
Western Sydn,744,7,8,9,10,38,47,-9,33
Perth Glory,744,8,10,2,15,37,50,-13,32
Wellington P,744,9,5,6,16,31,55,-24,21
CC Mariners,744,10,4,8,15,28,49,-21,20
Sydney FC,745,1,20,5,3,65,23,42,65
N'castle Jet,745,2,15,6,7,58,38,20,51
Melbourne C,745,3,14,5,10,44,34,10,47
Melbourne V,745,4,13,6,10,46,39,7,45
Adelaide Utd,745,5,11,6,11,37,40,-3,39
Brisbane,745,6,10,5,13,33,42,-9,35
Western Sydn,745,7,8,9,10,38,47,-9,33
Perth Glory,745,8,10,2,15,37,50,-13,32
Wellington P,745,9,5,6,16,31,55,-24,21
CC Mariners,745,10,4,8,15,28,49,-21,20
Sydney FC,746,1,20,4,4,64,23,41,64
N'castle Jet,746,2,15,6,7,58,38,20,51
Melbourne C,746,3,14,5,10,44,34,10,47
Melbourne V,746,4,14,5,10,46,38,8,47
Adelaide Utd,746,5,11,6,11,37,40,-3,39
Brisbane,746,6,10,5,13,33,42,-9,35
Western Sydn,746,7,8,9,10,38,47,-9,33
Perth Glory,746,8,10,2,15,37,50,-13,32
Wellington P,746,9,5,6,16,31,55,-24,21
CC Mariners,746,10,4,8,15,28,49,-21,20
Sydney FC,747,1,20,4,4,65,24,41,64
N'castle Jet,747,2,15,6,7,58,38,20,51
Melbourne C,747,3,14,5,10,44,34,10,47
Melbourne V,747,4,14,5,10,47,39,8,47
Adelaide Utd,747,5,11,6,11,37,40,-3,39
Brisbane,747,6,10,5,13,33,42,-9,35
Western Sydn,747,7,8,9,10,38,47,-9,33
Perth Glory,747,8,10,2,15,37,50,-13,32
Wellington P,747,9,5,6,16,31,55,-24,21
CC Mariners,747,10,4,8,15,28,49,-21,20
Sydney FC,748,1,20,5,3,66,24,42,65
N'castle Jet,748,2,15,6,7,58,38,20,51
Melbourne C,748,3,14,5,10,44,34,10,47
Melbourne V,748,4,13,6,10,47,40,7,45
Adelaide Utd,748,5,11,6,11,37,40,-3,39
Brisbane,748,6,10,5,13,33,42,-9,35
Western Sydn,748,7,8,9,10,38,47,-9,33
Perth Glory,748,8,10,2,15,37,50,-13,32
Wellington P,748,9,5,6,16,31,55,-24,21
CC Mariners,748,10,4,8,15,28,49,-21,20
Sydney FC,749,1,21,4,3,65,22,43,67
N'castle Jet,749,2,15,6,7,58,38,20,51
Melbourne C,749,3,14,5,10,44,34,10,47
Melbourne V,749,4,13,5,11,45,39,6,44
Adelaide Utd,749,5,11,6,11,37,40,-3,39
Brisbane,749,6,10,5,13,33,42,-9,35
Western Sydn,749,7,8,9,10,38,47,-9,33
Perth Glory,749,8,10,2,15,37,50,-13,32
Wellington P,749,9,5,6,16,31,55,-24,21
CC Mariners,749,10,4,8,15,28,49,-21,20
Sydney FC,750,1,21,4,3,66,22,44,67
N'castle Jet,750,2,16,5,7,60,37,23,53
Melbourne C,750,3,14,4,11,43,36,7,46
Melbourne V,750,4,13,5,11,45,40,5,44
Adelaide Utd,750,5,11,6,11,37,40,-3,39
Brisbane,750,6,10,5,13,33,42,-9,35
Western Sydn,750,7,8,9,10,38,47,-9,33
Perth Glory,750,8,10,2,15,37,50,-13,32
Wellington P,750,9,5,6,16,31,55,-24,21
CC Mariners,750,10,4,8,15,28,49,-21,20
Sydney FC,751,1,21,4,3,66,22,44,67
N'castle Jet,751,2,16,5,7,60,38,22,53
Melbourne C,751,3,14,4,11,44,36,8,46
Melbourne V,751,4,13,5,11,45,40,5,44
Adelaide Utd,751,5,11,6,11,37,40,-3,39
Brisbane,751,6,10,5,13,33,42,-9,35
Western Sydn,751,7,8,9,10,38,47,-9,33
Perth Glory,751,8,10,2,15,37,50,-13,32
Wellington P,751,9,5,6,16,31,55,-24,21
CC Mariners,751,10,4,8,15,28,49,-21,20
Sydney FC,752,1,21,4,3,66,22,44,67
N'castle Jet,752,2,15,6,7,60,40,20,51
Melbourne C,752,3,14,5,10,46,36,10,47
Melbourne V,752,4,13,5,11,45,40,5,44
Adelaide Utd,752,5,11,6,11,37,40,-3,39
Brisbane,752,6,10,5,13,33,42,-9,35
Western Sydn,752,7,8,9,10,38,47,-9,33
Perth Glory,752,8,10,2,15,37,50,-13,32
Wellington P,752,9,5,6,16,31,55,-24,21
CC Mariners,752,10,4,8,15,28,49,-21,20
Sydney FC,753,1,21,4,3,65,22,43,67
N'castle Jet,753,2,16,5,7,62,38,24,53
Melbourne C,753,3,14,4,11,44,38,6,46
Melbourne V,753,4,13,5,11,45,39,6,44
Adelaide Utd,753,5,11,6,11,37,40,-3,39
Brisbane,753,6,10,5,13,33,42,-9,35
Western Sydn,753,7,8,9,10,38,47,-9,33
Perth Glory,753,8,10,2,15,37,50,-13,32
Wellington P,753,9,5,6,16,31,55,-24,21
CC Mariners,753,10,4,8,15,28,49,-21,20
Sydney FC,754,1,21,4,3,69,22,47,67
N'castle Jet,754,2,16,5,7,60,39,21,53
Melbourne C,754,3,14,4,11,45,36,9,46
Melbourne V,754,4,13,5,11,45,43,2,44
Adelaide Utd,754,5,11,6,11,37,40,-3,39
Brisbane,754,6,10,5,13,33,42,-9,35
Western Sydn,754,7,8,9,10,38,47,-9,33
Perth Glory,754,8,10,2,15,37,50,-13,32
Wellington P,754,9,5,6,16,31,55,-24,21
CC Mariners,754,10,4,8,15,28,49,-21,20
Sydney FC,755,1,21,4,3,67,22,45,67
N'castle Jet,755,2,16,5,7,62,39,23,53
Melbourne C,755,3,14,4,11,45,38,7,46
Melbourne V,755,4,13,5,11,45,41,4,44
Adelaide Utd,755,5,11,6,11,37,40,-3,39
Brisbane,755,6,10,5,13,33,42,-9,35
Western Sydn,755,7,8,9,10,38,47,-9,33
Perth Glory,755,8,10,2,15,37,50,-13,32
Wellington P,755,9,5,6,16,31,55,-24,21
CC Mariners,755,10,4,8,15,28,49,-21,20
Sydney FC,756,1,20,4,4,64,24,40,64
N'castle Jet,756,2,15,5,8,58,40,18,50
Melbourne C,756,3,15,4,10,46,34,12,49
Melbourne V,756,4,14,5,10,47,38,9,47
Adelaide Utd,756,5,11,6,11,37,40,-3,39
Brisbane,756,6,10,5,13,33,42,-9,35
Western Sydn,756,7,8,9,10,38,47,-9,33
Perth Glory,756,8,10,2,15,37,50,-13,32
Wellington P,756,9,5,6,16,31,55,-24,21
CC Mariners,756,10,4,8,15,28,49,-21,20
Sydney FC,757,1,21,4,3,67,23,44,67
N'castle Jet,757,2,15,5,8,57,39,18,50
Melbourne C,757,3,15,4,10,45,33,12,49
Melbourne V,757,4,13,5,11,46,41,5,44
Adelaide Utd,757,5,11,6,11,37,40,-3,39
Brisbane,757,6,10,5,13,33,42,-9,35
Western Sydn,757,7,8,9,10,38,47,-9,33
Perth Glory,757,8,10,2,15,37,50,-13,32
Wellington P,757,9,5,6,16,31,55,-24,21
CC Mariners,757,10,4,8,15,28,49,-21,20
Sydney FC,758,1,21,4,3,69,23,46,67
N'castle Jet,758,2,15,5,8,58,39,19,50
Melbourne C,758,3,15,4,10,45,34,11,49
Melbourne V,758,4,13,5,11,46,43,3,44
Adelaide Utd,758,5,11,6,11,37,40,-3,39
Brisbane,758,6,10,5,13,33,42,-9,35
Western Sydn,758,7,8,9,10,38,47,-9,33
Perth Glory,758,8,10,2,15,37,50,-13,32
Wellington P,758,9,5,6,16,31,55,-24,21
CC Mariners,758,10,4,8,15,28,49,-21,20
Sydney FC,759,1,21,4,3,66,22,44,67
N'castle Jet,759,2,15,5,8,58,39,19,50
Melbourne C,759,3,15,4,10,45,34,11,49
Melbourne V,759,4,13,5,11,45,40,5,44
Adelaide Utd,759,5,11,6,11,37,40,-3,39
Brisbane,759,6,10,5,13,33,42,-9,35
Western Sydn,759,7,8,9,10,38,47,-9,33
Perth Glory,759,8,10,2,15,37,50,-13,32
Wellington P,759,9,5,6,16,31,55,-24,21
CC Mariners,759,10,4,8,15,28,49,-21,20
Sydney FC,760,1,21,4,3,67,22,45,67
N'castle Jet,760,2,15,5,8,57,38,19,50
Melbourne C,760,3,15,4,10,44,33,11,49
Melbourne V,760,4,13,5,11,45,41,4,44
Adelaide Utd,760,5,11,6,11,37,40,-3,39
Brisbane,760,6,10,5,13,33,42,-9,35
Western Sydn,760,7,8,9,10,38,47,-9,33
Perth Glory,760,8,10,2,15,37,50,-13,32
Wellington P,760,9,5,6,16,31,55,-24,21
CC Mariners,760,10,4,8,15,28,49,-21,20
Sydney FC,761,1,20,4,4,65,24,41,64
N'castle Jet,761,2,16,5,7,60,38,22,53
Melbourne V,761,3,14,5,10,47,39,8,47
Melbourne C,761,4,14,4,11,44,36,8,46
Adelaide Utd,761,5,11,6,11,37,40,-3,39
Brisbane,761,6,10,5,13,33,42,-9,35
Western Sydn,761,7,8,9,10,38,47,-9,33
Perth Glory,761,8,10,2,15,37,50,-13,32
Wellington P,761,9,5,6,16,31,55,-24,21
CC Mariners,761,10,4,8,15,28,49,-21,20
Sydney FC,762,1,21,4,3,66,23,43,67
N'castle Jet,762,2,16,5,7,60,38,22,53
Melbourne C,762,3,14,4,11,44,36,8,46
Melbourne V,762,4,13,5,11,46,40,6,44
Adelaide Utd,762,5,11,6,11,37,40,-3,39
Brisbane,762,6,10,5,13,33,42,-9,35
Western Sydn,762,7,8,9,10,38,47,-9,33
Perth Glory,762,8,10,2,15,37,50,-13,32
Wellington P,762,9,5,6,16,31,55,-24,21
CC Mariners,762,10,4,8,15,28,49,-21,20
Sydney FC,763,1,20,5,3,64,22,42,65
N'castle Jet,763,2,15,5,8,57,39,18,50
Melbourne C,763,3,15,4,10,45,33,12,49
Melbourne V,763,4,13,6,10,45,38,7,45
Adelaide Utd,763,5,11,6,11,37,40,-3,39
Brisbane,763,6,10,5,13,33,42,-9,35
Western Sydn,763,7,8,9,10,38,47,-9,33
Perth Glory,763,8,10,2,15,37,50,-13,32
Wellington P,763,9,5,6,16,31,55,-24,21
CC Mariners,763,10,4,8,15,28,49,-21,20
Sydney FC,764,1,21,4,3,67,23,44,67
N'castle Jet,764,2,16,5,7,62,37,25,53
Melbourne C,764,3,14,4,11,43,38,5,46
Melbourne V,764,4,13,5,11,46,41,5,44
Adelaide Utd,764,5,11,6,11,37,40,-3,39
Brisbane,764,6,10,5,13,33,42,-9,35
Western Sydn,764,7,8,9,10,38,47,-9,33
Perth Glory,764,8,10,2,15,37,50,-13,32
Wellington P,764,9,5,6,16,31,55,-24,21
CC Mariners,764,10,4,8,15,28,49,-21,20
Sydney FC,765,1,21,4,3,70,23,47,67
N'castle Jet,765,2,16,5,7,59,38,21,53
Melbourne C,765,3,14,4,11,44,35,9,46
Melbourne V,765,4,13,5,11,46,44,2,44
Adelaide Utd,765,5,11,6,11,37,40,-3,39
Brisbane,765,6,10,5,13,33,42,-9,35
Western Sydn,765,7,8,9,10,38,47,-9,33
Perth Glory,765,8,10,2,15,37,50,-13,32
Wellington P,765,9,5,6,16,31,55,-24,21
CC Mariners,765,10,4,8,15,28,49,-21,20
Sydney FC,766,1,21,4,3,67,22,45,67
N'castle Jet,766,2,15,6,7,58,38,20,51
Melbourne C,766,3,14,5,10,44,34,10,47
Melbourne V,766,4,13,5,11,45,41,4,44
Adelaide Utd,766,5,11,6,11,37,40,-3,39
Brisbane,766,6,10,5,13,33,42,-9,35
Western Sydn,766,7,8,9,10,38,47,-9,33
Perth Glory,766,8,10,2,15,37,50,-13,32
Wellington P,766,9,5,6,16,31,55,-24,21
CC Mariners,766,10,4,8,15,28,49,-21,20
Sydney FC,767,1,20,5,3,65,23,42,65
N'castle Jet,767,2,15,6,7,58,38,20,51
Melbourne C,767,3,14,5,10,44,34,10,47
Melbourne V,767,4,13,6,10,46,39,7,45
Adelaide Utd,767,5,11,6,11,37,40,-3,39
Brisbane,767,6,10,5,13,33,42,-9,35
Western Sydn,767,7,8,9,10,38,47,-9,33
Perth Glory,767,8,10,2,15,37,50,-13,32
Wellington P,767,9,5,6,16,31,55,-24,21
CC Mariners,767,10,4,8,15,28,49,-21,20
Sydney FC,768,1,20,4,4,64,23,41,64
N'castle Jet,768,2,15,6,7,58,38,20,51
Melbourne C,768,3,14,5,10,44,34,10,47
Melbourne V,768,4,14,5,10,46,38,8,47
Adelaide Utd,768,5,11,6,11,37,40,-3,39
Brisbane,768,6,10,5,13,33,42,-9,35
Western Sydn,768,7,8,9,10,38,47,-9,33
Perth Glory,768,8,10,2,15,37,50,-13,32
Wellington P,768,9,5,6,16,31,55,-24,21
CC Mariners,768,10,4,8,15,28,49,-21,20
Sydney FC,769,1,21,4,3,68,24,44,67
N'castle Jet,769,2,16,5,7,59,38,21,53
Melbourne C,769,3,14,4,11,44,35,9,46
Melbourne V,769,4,13,5,11,47,42,5,44
Adelaide Utd,769,5,11,6,11,37,40,-3,39
Brisbane,769,6,10,5,13,33,42,-9,35
Western Sydn,769,7,8,9,10,38,47,-9,33
Perth Glory,769,8,10,2,15,37,50,-13,32
Wellington P,769,9,5,6,16,31,55,-24,21
CC Mariners,769,10,4,8,15,28,49,-21,20
Sydney FC,770,1,21,4,3,69,24,45,67
N'castle Jet,770,2,16,5,7,59,38,21,53
Melbourne C,770,3,14,4,11,44,35,9,46
Melbourne V,770,4,13,5,11,47,43,4,44
Adelaide Utd,770,5,11,6,11,37,40,-3,39
Brisbane,770,6,10,5,13,33,42,-9,35
Western Sydn,770,7,8,9,10,38,47,-9,33
Perth Glory,770,8,10,2,15,37,50,-13,32
Wellington P,770,9,5,6,16,31,55,-24,21
CC Mariners,770,10,4,8,15,28,49,-21,20
Sydney FC,771,1,21,4,3,65,22,43,67
N'castle Jet,771,2,15,5,8,58,39,19,50
Melbourne C,771,3,15,4,10,45,34,11,49
Melbourne V,771,4,13,5,11,45,39,6,44
Adelaide Utd,771,5,11,6,11,37,40,-3,39
Brisbane,771,6,10,5,13,33,42,-9,35
Western Sydn,771,7,8,9,10,38,47,-9,33
Perth Glory,771,8,10,2,15,37,50,-13,32
Wellington P,771,9,5,6,16,31,55,-24,21
CC Mariners,771,10,4,8,15,28,49,-21,20
Sydney FC,772,1,20,4,4,67,26,41,64
N'castle Jet,772,2,15,5,8,57,38,19,50
Melbourne C,772,3,15,4,10,44,33,11,49
Melbourne V,772,4,14,5,10,49,41,8,47
Adelaide Utd,772,5,11,6,11,37,40,-3,39
Brisbane,772,6,10,5,13,33,42,-9,35
Western Sydn,772,7,8,9,10,38,47,-9,33
Perth Glory,772,8,10,2,15,37,50,-13,32
Wellington P,772,9,5,6,16,31,55,-24,21
CC Mariners,772,10,4,8,15,28,49,-21,20
Sydney FC,773,1,20,4,4,65,24,41,64
N'castle Jet,773,2,15,6,7,58,38,20,51
Melbourne C,773,3,14,5,10,44,34,10,47
Melbourne V,773,4,14,5,10,47,39,8,47
Adelaide Utd,773,5,11,6,11,37,40,-3,39
Brisbane,773,6,10,5,13,33,42,-9,35
Western Sydn,773,7,8,9,10,38,47,-9,33
Perth Glory,773,8,10,2,15,37,50,-13,32
Wellington P,773,9,5,6,16,31,55,-24,21
CC Mariners,773,10,4,8,15,28,49,-21,20
Sydney FC,774,1,21,4,3,67,23,44,67
N'castle Jet,774,2,15,6,7,59,39,20,51
Melbourne C,774,3,14,5,10,45,35,10,47
Melbourne V,774,4,13,5,11,46,41,5,44
Adelaide Utd,774,5,11,6,11,37,40,-3,39
Brisbane,774,6,10,5,13,33,42,-9,35
Western Sydn,774,7,8,9,10,38,47,-9,33
Perth Glory,774,8,10,2,15,37,50,-13,32
Wellington P,774,9,5,6,16,31,55,-24,21
CC Mariners,774,10,4,8,15,28,49,-21,20
Sydney FC,775,1,21,4,3,67,23,44,67
N'castle Jet,775,2,15,5,8,58,39,19,50
Melbourne C,775,3,15,4,10,45,34,11,49
Melbourne V,775,4,13,5,11,46,41,5,44
Adelaide Utd,775,5,11,6,11,37,40,-3,39
Brisbane,775,6,10,5,13,33,42,-9,35
Western Sydn,775,7,8,9,10,38,47,-9,33
Perth Glory,775,8,10,2,15,37,50,-13,32
Wellington P,775,9,5,6,16,31,55,-24,21
CC Mariners,775,10,4,8,15,28,49,-21,20
Sydney FC,776,1,21,4,3,68,23,45,67
N'castle Jet,776,2,15,5,8,57,39,18,50
Melbourne C,776,3,15,4,10,45,33,12,49
Melbourne V,776,4,13,5,11,46,42,4,44
Adelaide Utd,776,5,11,6,11,37,40,-3,39
Brisbane,776,6,10,5,13,33,42,-9,35
Western Sydn,776,7,8,9,10,38,47,-9,33
Perth Glory,776,8,10,2,15,37,50,-13,32
Wellington P,776,9,5,6,16,31,55,-24,21
CC Mariners,776,10,4,8,15,28,49,-21,20
Sydney FC,777,1,20,4,4,66,25,41,64
N'castle Jet,777,2,16,5,7,60,39,21,53
Melbourne V,777,3,14,5,10,48,40,8,47
Melbourne C,777,4,14,4,11,45,36,9,46
Adelaide Utd,777,5,11,6,11,37,40,-3,39
Brisbane,777,6,10,5,13,33,42,-9,35
Western Sydn,777,7,8,9,10,38,47,-9,33
Perth Glory,777,8,10,2,15,37,50,-13,32
Wellington P,777,9,5,6,16,31,55,-24,21
CC Mariners,777,10,4,8,15,28,49,-21,20
Sydney FC,778,1,21,4,3,67,22,45,67
N'castle Jet,778,2,16,5,7,60,39,21,53
Melbourne C,778,3,14,4,11,45,36,9,46
Melbourne V,778,4,13,5,11,45,41,4,44
Adelaide Utd,778,5,11,6,11,37,40,-3,39
Brisbane,778,6,10,5,13,33,42,-9,35
Western Sydn,778,7,8,9,10,38,47,-9,33
Perth Glory,778,8,10,2,15,37,50,-13,32
Wellington P,778,9,5,6,16,31,55,-24,21
CC Mariners,778,10,4,8,15,28,49,-21,20
Sydney FC,779,1,21,4,3,66,23,43,67
N'castle Jet,779,2,16,5,7,61,40,21,53
Melbourne C,779,3,14,4,11,46,37,9,46
Melbourne V,779,4,13,5,11,46,40,6,44
Adelaide Utd,779,5,11,6,11,37,40,-3,39
Brisbane,779,6,10,5,13,33,42,-9,35
Western Sydn,779,7,8,9,10,38,47,-9,33
Perth Glory,779,8,10,2,15,37,50,-13,32
Wellington P,779,9,5,6,16,31,55,-24,21
CC Mariners,779,10,4,8,15,28,49,-21,20
Sydney FC,780,1,21,4,3,66,23,43,67
N'castle Jet,780,2,15,6,7,58,38,20,51
Melbourne C,780,3,14,5,10,44,34,10,47
Melbourne V,780,4,13,5,11,46,40,6,44
Adelaide Utd,780,5,11,6,11,37,40,-3,39
Brisbane,780,6,10,5,13,33,42,-9,35
Western Sydn,780,7,8,9,10,38,47,-9,33
Perth Glory,780,8,10,2,15,37,50,-13,32
Wellington P,780,9,5,6,16,31,55,-24,21
CC Mariners,780,10,4,8,15,28,49,-21,20
Sydney FC,781,1,21,4,3,65,22,43,67
N'castle Jet,781,2,15,6,7,58,38,20,51
Melbourne C,781,3,14,5,10,44,34,10,47
Melbourne V,781,4,13,5,11,45,39,6,44
Adelaide Utd,781,5,11,6,11,37,40,-3,39
Brisbane,781,6,10,5,13,33,42,-9,35
Western Sydn,781,7,8,9,10,38,47,-9,33
Perth Glory,781,8,10,2,15,37,50,-13,32
Wellington P,781,9,5,6,16,31,55,-24,21
CC Mariners,781,10,4,8,15,28,49,-21,20
Sydney FC,782,1,21,4,3,66,22,44,67
N'castle Jet,782,2,15,6,7,58,38,20,51
Melbourne C,782,3,14,5,10,44,34,10,47
Melbourne V,782,4,13,5,11,45,40,5,44
Adelaide Utd,782,5,11,6,11,37,40,-3,39
Brisbane,782,6,10,5,13,33,42,-9,35
Western Sydn,782,7,8,9,10,38,47,-9,33
Perth Glory,782,8,10,2,15,37,50,-13,32
Wellington P,782,9,5,6,16,31,55,-24,21
CC Mariners,782,10,4,8,15,28,49,-21,20
Sydney FC,783,1,21,4,3,67,22,45,67
N'castle Jet,783,2,16,5,7,60,39,21,53
Melbourne C,783,3,14,4,11,45,36,9,46
Melbourne V,783,4,13,5,11,45,41,4,44
Adelaide Utd,783,5,11,6,11,37,40,-3,39
Brisbane,783,6,10,5,13,33,42,-9,35
Western Sydn,783,7,8,9,10,38,47,-9,33
Perth Glory,783,8,10,2,15,37,50,-13,32
Wellington P,783,9,5,6,16,31,55,-24,21
CC Mariners,783,10,4,8,15,28,49,-21,20
Sydney FC,784,1,20,5,3,65,23,42,65
N'castle Jet,784,2,15,5,8,58,39,19,50
Melbourne C,784,3,15,4,10,45,34,11,49
Melbourne V,784,4,13,6,10,46,39,7,45
Adelaide Utd,784,5,11,6,11,37,40,-3,39
Brisbane,784,6,10,5,13,33,42,-9,35
Western Sydn,784,7,8,9,10,38,47,-9,33
Perth Glory,784,8,10,2,15,37,50,-13,32
Wellington P,784,9,5,6,16,31,55,-24,21
CC Mariners,784,10,4,8,15,28,49,-21,20
Sydney FC,785,1,21,4,3,66,23,43,67
N'castle Jet,785,2,15,6,7,59,39,20,51
Melbourne C,785,3,14,5,10,45,35,10,47
Melbourne V,785,4,13,5,11,46,40,6,44
Adelaide Utd,785,5,11,6,11,37,40,-3,39
Brisbane,785,6,10,5,13,33,42,-9,35
Western Sydn,785,7,8,9,10,38,47,-9,33
Perth Glory,785,8,10,2,15,37,50,-13,32
Wellington P,785,9,5,6,16,31,55,-24,21
CC Mariners,785,10,4,8,15,28,49,-21,20
Sydney FC,786,1,21,4,3,65,22,43,67
N'castle Jet,786,2,16,5,7,58,37,21,53
Melbourne C,786,3,14,4,11,43,34,9,46
Melbourne V,786,4,13,5,11,45,39,6,44
Adelaide Utd,786,5,11,6,11,37,40,-3,39
Brisbane,786,6,10,5,13,33,42,-9,35
Western Sydn,786,7,8,9,10,38,47,-9,33
Perth Glory,786,8,10,2,15,37,50,-13,32
Wellington P,786,9,5,6,16,31,55,-24,21
CC Mariners,786,10,4,8,15,28,49,-21,20
Sydney FC,787,1,21,4,3,66,22,44,67
N'castle Jet,787,2,15,5,8,58,39,19,50
Melbourne C,787,3,15,4,10,45,34,11,49
Melbourne V,787,4,13,5,11,45,40,5,44
Adelaide Utd,787,5,11,6,11,37,40,-3,39
Brisbane,787,6,10,5,13,33,42,-9,35
Western Sydn,787,7,8,9,10,38,47,-9,33
Perth Glory,787,8,10,2,15,37,50,-13,32
Wellington P,787,9,5,6,16,31,55,-24,21
CC Mariners,787,10,4,8,15,28,49,-21,20
Sydney FC,788,1,21,4,3,67,24,43,67
N'castle Jet,788,2,15,5,8,57,40,17,50
Melbourne C,788,3,15,4,10,46,33,13,49
Melbourne V,788,4,13,5,11,47,41,6,44
Adelaide Utd,788,5,11,6,11,37,40,-3,39
Brisbane,788,6,10,5,13,33,42,-9,35
Western Sydn,788,7,8,9,10,38,47,-9,33
Perth Glory,788,8,10,2,15,37,50,-13,32
Wellington P,788,9,5,6,16,31,55,-24,21
CC Mariners,788,10,4,8,15,28,49,-21,20
Sydney FC,789,1,21,4,3,69,24,45,67
N'castle Jet,789,2,15,6,7,60,40,20,51
Melbourne C,789,3,14,5,10,46,36,10,47
Melbourne V,789,4,13,5,11,47,43,4,44
Adelaide Utd,789,5,11,6,11,37,40,-3,39
Brisbane,789,6,10,5,13,33,42,-9,35
Western Sydn,789,7,8,9,10,38,47,-9,33
Perth Glory,789,8,10,2,15,37,50,-13,32
Wellington P,789,9,5,6,16,31,55,-24,21
CC Mariners,789,10,4,8,15,28,49,-21,20
Sydney FC,790,1,21,4,3,65,22,43,67
N'castle Jet,790,2,15,6,7,57,37,20,51
Melbourne C,790,3,14,5,10,43,33,10,47
Melbourne V,790,4,13,5,11,45,39,6,44
Adelaide Utd,790,5,11,6,11,37,40,-3,39
Brisbane,790,6,10,5,13,33,42,-9,35
Western Sydn,790,7,8,9,10,38,47,-9,33
Perth Glory,790,8,10,2,15,37,50,-13,32
Wellington P,790,9,5,6,16,31,55,-24,21
CC Mariners,790,10,4,8,15,28,49,-21,20
Sydney FC,791,1,20,5,3,65,23,42,65
N'castle Jet,791,2,15,6,7,58,38,20,51
Melbourne C,791,3,14,5,10,44,34,10,47
Melbourne V,791,4,13,6,10,46,39,7,45
Adelaide Utd,791,5,11,6,11,37,40,-3,39
Brisbane,791,6,10,5,13,33,42,-9,35
Western Sydn,791,7,8,9,10,38,47,-9,33
Perth Glory,791,8,10,2,15,37,50,-13,32
Wellington P,791,9,5,6,16,31,55,-24,21
CC Mariners,791,10,4,8,15,28,49,-21,20
Sydney FC,792,1,20,4,4,64,23,41,64
N'castle Jet,792,2,16,5,7,58,37,21,53
Melbourne V,792,3,14,5,10,46,38,8,47
Melbourne C,792,4,14,4,11,43,34,9,46
Adelaide Utd,792,5,11,6,11,37,40,-3,39
Brisbane,792,6,10,5,13,33,42,-9,35
Western Sydn,792,7,8,9,10,38,47,-9,33
Perth Glory,792,8,10,2,15,37,50,-13,32
Wellington P,792,9,5,6,16,31,55,-24,21
CC Mariners,792,10,4,8,15,28,49,-21,20
Sydney FC,793,1,20,4,4,65,24,41,64
N'castle Jet,793,2,16,5,7,59,38,21,53
Melbourne V,793,3,14,5,10,47,39,8,47
Melbourne C,793,4,14,4,11,44,35,9,46
Adelaide Utd,793,5,11,6,11,37,40,-3,39
Brisbane,793,6,10,5,13,33,42,-9,35
Western Sydn,793,7,8,9,10,38,47,-9,33
Perth Glory,793,8,10,2,15,37,50,-13,32
Wellington P,793,9,5,6,16,31,55,-24,21
CC Mariners,793,10,4,8,15,28,49,-21,20
Sydney FC,794,1,21,4,3,65,22,43,67
N'castle Jet,794,2,16,5,7,59,38,21,53
Melbourne C,794,3,14,4,11,44,35,9,46
Melbourne V,794,4,13,5,11,45,39,6,44
Adelaide Utd,794,5,11,6,11,37,40,-3,39
Brisbane,794,6,10,5,13,33,42,-9,35
Western Sydn,794,7,8,9,10,38,47,-9,33
Perth Glory,794,8,10,2,15,37,50,-13,32
Wellington P,794,9,5,6,16,31,55,-24,21
CC Mariners,794,10,4,8,15,28,49,-21,20
Sydney FC,795,1,21,4,3,67,23,44,67
N'castle Jet,795,2,15,6,7,58,38,20,51
Melbourne C,795,3,14,5,10,44,34,10,47
Melbourne V,795,4,13,5,11,46,41,5,44
Adelaide Utd,795,5,11,6,11,37,40,-3,39
Brisbane,795,6,10,5,13,33,42,-9,35
Western Sydn,795,7,8,9,10,38,47,-9,33
Perth Glory,795,8,10,2,15,37,50,-13,32
Wellington P,795,9,5,6,16,31,55,-24,21
CC Mariners,795,10,4,8,15,28,49,-21,20
Sydney FC,796,1,21,4,3,67,23,44,67
N'castle Jet,796,2,16,5,7,59,38,21,53
Melbourne C,796,3,14,4,11,44,35,9,46
Melbourne V,796,4,13,5,11,46,41,5,44
Adelaide Utd,796,5,11,6,11,37,40,-3,39
Brisbane,796,6,10,5,13,33,42,-9,35
Western Sydn,796,7,8,9,10,38,47,-9,33
Perth Glory,796,8,10,2,15,37,50,-13,32
Wellington P,796,9,5,6,16,31,55,-24,21
CC Mariners,796,10,4,8,15,28,49,-21,20
Sydney FC,797,1,21,4,3,66,23,43,67
N'castle Jet,797,2,16,5,7,59,37,22,53
Melbourne C,797,3,14,4,11,43,35,8,46
Melbourne V,797,4,13,5,11,46,40,6,44
Adelaide Utd,797,5,11,6,11,37,40,-3,39
Brisbane,797,6,10,5,13,33,42,-9,35
Western Sydn,797,7,8,9,10,38,47,-9,33
Perth Glory,797,8,10,2,15,37,50,-13,32
Wellington P,797,9,5,6,16,31,55,-24,21
CC Mariners,797,10,4,8,15,28,49,-21,20
Sydney FC,798,1,21,4,3,70,23,47,67
N'castle Jet,798,2,16,5,7,61,38,23,53
Melbourne C,798,3,14,4,11,44,37,7,46
Melbourne V,798,4,13,5,11,46,44,2,44
Adelaide Utd,798,5,11,6,11,37,40,-3,39
Brisbane,798,6,10,5,13,33,42,-9,35
Western Sydn,798,7,8,9,10,38,47,-9,33
Perth Glory,798,8,10,2,15,37,50,-13,32
Wellington P,798,9,5,6,16,31,55,-24,21
CC Mariners,798,10,4,8,15,28,49,-21,20
Sydney FC,799,1,21,4,3,67,22,45,67
N'castle Jet,799,2,16,5,7,58,37,21,53
Melbourne C,799,3,14,4,11,43,34,9,46
Melbourne V,799,4,13,5,11,45,41,4,44
Adelaide Utd,799,5,11,6,11,37,40,-3,39
Brisbane,799,6,10,5,13,33,42,-9,35
Western Sydn,799,7,8,9,10,38,47,-9,33
Perth Glory,799,8,10,2,15,37,50,-13,32
Wellington P,799,9,5,6,16,31,55,-24,21
CC Mariners,799,10,4,8,15,28,49,-21,20
Sydney FC,800,1,21,4,3,66,22,44,67
N'castle Jet,800,2,16,5,7,58,37,21,53
Melbourne C,800,3,14,4,11,43,34,9,46
Melbourne V,800,4,13,5,11,45,40,5,44
Adelaide Utd,800,5,11,6,11,37,40,-3,39
Brisbane,800,6,10,5,13,33,42,-9,35
Western Sydn,800,7,8,9,10,38,47,-9,33
Perth Glory,800,8,10,2,15,37,50,-13,32
Wellington P,800,9,5,6,16,31,55,-24,21
CC Mariners,800,10,4,8,15,28,49,-21,20
Sydney FC,801,1,21,4,3,66,22,44,67
N'castle Jet,801,2,15,5,8,58,39,19,50
Melbourne C,801,3,15,4,10,45,34,11,49
Melbourne V,801,4,13,5,11,45,40,5,44
Adelaide Utd,801,5,11,6,11,37,40,-3,39
Brisbane,801,6,10,5,13,33,42,-9,35
Western Sydn,801,7,8,9,10,38,47,-9,33
Perth Glory,801,8,10,2,15,37,50,-13,32
Wellington P,801,9,5,6,16,31,55,-24,21
CC Mariners,801,10,4,8,15,28,49,-21,20
Sydney FC,802,1,20,5,3,65,23,42,65
N'castle Jet,802,2,16,5,7,59,37,22,53
Melbourne C,802,3,14,4,11,43,35,8,46
Melbourne V,802,4,13,6,10,46,39,7,45
Adelaide Utd,802,5,11,6,11,37,40,-3,39
Brisbane,802,6,10,5,13,33,42,-9,35
Western Sydn,802,7,8,9,10,38,47,-9,33
Perth Glory,802,8,10,2,15,37,50,-13,32
Wellington P,802,9,5,6,16,31,55,-24,21
CC Mariners,802,10,4,8,15,28,49,-21,20
Sydney FC,803,1,21,4,3,66,22,44,67
N'castle Jet,803,2,16,5,7,58,37,21,53
Melbourne C,803,3,14,4,11,43,34,9,46
Melbourne V,803,4,13,5,11,45,40,5,44
Adelaide Utd,803,5,11,6,11,37,40,-3,39
Brisbane,803,6,10,5,13,33,42,-9,35
Western Sydn,803,7,8,9,10,38,47,-9,33
Perth Glory,803,8,10,2,15,37,50,-13,32
Wellington P,803,9,5,6,16,31,55,-24,21
CC Mariners,803,10,4,8,15,28,49,-21,20
Sydney FC,804,1,21,4,3,66,22,44,67
N'castle Jet,804,2,16,5,7,59,38,21,53
Melbourne C,804,3,14,4,11,44,35,9,46
Melbourne V,804,4,13,5,11,45,40,5,44
Adelaide Utd,804,5,11,6,11,37,40,-3,39
Brisbane,804,6,10,5,13,33,42,-9,35
Western Sydn,804,7,8,9,10,38,47,-9,33
Perth Glory,804,8,10,2,15,37,50,-13,32
Wellington P,804,9,5,6,16,31,55,-24,21
CC Mariners,804,10,4,8,15,28,49,-21,20
Sydney FC,805,1,20,4,4,65,24,41,64
N'castle Jet,805,2,15,6,7,59,39,20,51
Melbourne C,805,3,14,5,10,45,35,10,47
Melbourne V,805,4,14,5,10,47,39,8,47
Adelaide Utd,805,5,11,6,11,37,40,-3,39
Brisbane,805,6,10,5,13,33,42,-9,35
Western Sydn,805,7,8,9,10,38,47,-9,33
Perth Glory,805,8,10,2,15,37,50,-13,32
Wellington P,805,9,5,6,16,31,55,-24,21
CC Mariners,805,10,4,8,15,28,49,-21,20
Sydney FC,806,1,21,4,3,66,22,44,67
N'castle Jet,806,2,16,5,7,64,39,25,53
Melbourne C,806,3,14,4,11,45,40,5,46
Melbourne V,806,4,13,5,11,45,40,5,44
Adelaide Utd,806,5,11,6,11,37,40,-3,39
Brisbane,806,6,10,5,13,33,42,-9,35
Western Sydn,806,7,8,9,10,38,47,-9,33
Perth Glory,806,8,10,2,15,37,50,-13,32
Wellington P,806,9,5,6,16,31,55,-24,21
CC Mariners,806,10,4,8,15,28,49,-21,20
Sydney FC,807,1,21,4,3,67,23,44,67
N'castle Jet,807,2,15,6,7,58,38,20,51
Melbourne C,807,3,14,5,10,44,34,10,47
Melbourne V,807,4,13,5,11,46,41,5,44
Adelaide Utd,807,5,11,6,11,37,40,-3,39
Brisbane,807,6,10,5,13,33,42,-9,35
Western Sydn,807,7,8,9,10,38,47,-9,33
Perth Glory,807,8,10,2,15,37,50,-13,32
Wellington P,807,9,5,6,16,31,55,-24,21
CC Mariners,807,10,4,8,15,28,49,-21,20
Sydney FC,808,1,21,4,3,67,23,44,67
N'castle Jet,808,2,15,5,8,58,39,19,50
Melbourne C,808,3,15,4,10,45,34,11,49
Melbourne V,808,4,13,5,11,46,41,5,44
Adelaide Utd,808,5,11,6,11,37,40,-3,39
Brisbane,808,6,10,5,13,33,42,-9,35
Western Sydn,808,7,8,9,10,38,47,-9,33
Perth Glory,808,8,10,2,15,37,50,-13,32
Wellington P,808,9,5,6,16,31,55,-24,21
CC Mariners,808,10,4,8,15,28,49,-21,20
Sydney FC,809,1,20,5,3,65,23,42,65
N'castle Jet,809,2,16,5,7,58,37,21,53
Melbourne C,809,3,14,4,11,43,34,9,46
Melbourne V,809,4,13,6,10,46,39,7,45
Adelaide Utd,809,5,11,6,11,37,40,-3,39
Brisbane,809,6,10,5,13,33,42,-9,35
Western Sydn,809,7,8,9,10,38,47,-9,33
Perth Glory,809,8,10,2,15,37,50,-13,32
Wellington P,809,9,5,6,16,31,55,-24,21
CC Mariners,809,10,4,8,15,28,49,-21,20
Sydney FC,810,1,21,4,3,66,22,44,67
N'castle Jet,810,2,16,5,7,62,37,25,53
Melbourne C,810,3,14,4,11,43,38,5,46
Melbourne V,810,4,13,5,11,45,40,5,44
Adelaide Utd,810,5,11,6,11,37,40,-3,39
Brisbane,810,6,10,5,13,33,42,-9,35
Western Sydn,810,7,8,9,10,38,47,-9,33
Perth Glory,810,8,10,2,15,37,50,-13,32
Wellington P,810,9,5,6,16,31,55,-24,21
CC Mariners,810,10,4,8,15,28,49,-21,20
Sydney FC,811,1,20,4,4,64,23,41,64
N'castle Jet,811,2,16,5,7,58,37,21,53
Melbourne V,811,3,14,5,10,46,38,8,47
Melbourne C,811,4,14,4,11,43,34,9,46
Adelaide Utd,811,5,11,6,11,37,40,-3,39
Brisbane,811,6,10,5,13,33,42,-9,35
Western Sydn,811,7,8,9,10,38,47,-9,33
Perth Glory,811,8,10,2,15,37,50,-13,32
Wellington P,811,9,5,6,16,31,55,-24,21
CC Mariners,811,10,4,8,15,28,49,-21,20
Sydney FC,812,1,21,4,3,66,23,43,67
N'castle Jet,812,2,16,5,7,59,37,22,53
Melbourne C,812,3,14,4,11,43,35,8,46
Melbourne V,812,4,13,5,11,46,40,6,44
Adelaide Utd,812,5,11,6,11,37,40,-3,39
Brisbane,812,6,10,5,13,33,42,-9,35
Western Sydn,812,7,8,9,10,38,47,-9,33
Perth Glory,812,8,10,2,15,37,50,-13,32
Wellington P,812,9,5,6,16,31,55,-24,21
CC Mariners,812,10,4,8,15,28,49,-21,20
Sydney FC,813,1,21,4,3,69,23,46,67
N'castle Jet,813,2,15,6,7,58,38,20,51
Melbourne C,813,3,14,5,10,44,34,10,47
Melbourne V,813,4,13,5,11,46,43,3,44
Adelaide Utd,813,5,11,6,11,37,40,-3,39
Brisbane,813,6,10,5,13,33,42,-9,35
Western Sydn,813,7,8,9,10,38,47,-9,33
Perth Glory,813,8,10,2,15,37,50,-13,32
Wellington P,813,9,5,6,16,31,55,-24,21
CC Mariners,813,10,4,8,15,28,49,-21,20
Sydney FC,814,1,21,4,3,67,22,45,67
N'castle Jet,814,2,16,5,7,59,38,21,53
Melbourne C,814,3,14,4,11,44,35,9,46
Melbourne V,814,4,13,5,11,45,41,4,44
Adelaide Utd,814,5,11,6,11,37,40,-3,39
Brisbane,814,6,10,5,13,33,42,-9,35
Western Sydn,814,7,8,9,10,38,47,-9,33
Perth Glory,814,8,10,2,15,37,50,-13,32
Wellington P,814,9,5,6,16,31,55,-24,21
CC Mariners,814,10,4,8,15,28,49,-21,20
Sydney FC,815,1,20,5,3,65,23,42,65
N'castle Jet,815,2,16,5,7,59,38,21,53
Melbourne C,815,3,14,4,11,44,35,9,46
Melbourne V,815,4,13,6,10,46,39,7,45
Adelaide Utd,815,5,11,6,11,37,40,-3,39
Brisbane,815,6,10,5,13,33,42,-9,35
Western Sydn,815,7,8,9,10,38,47,-9,33
Perth Glory,815,8,10,2,15,37,50,-13,32
Wellington P,815,9,5,6,16,31,55,-24,21
CC Mariners,815,10,4,8,15,28,49,-21,20
Sydney FC,816,1,21,4,3,67,22,45,67
N'castle Jet,816,2,16,5,7,59,38,21,53
Melbourne C,816,3,14,4,11,44,35,9,46
Melbourne V,816,4,13,5,11,45,41,4,44
Adelaide Utd,816,5,11,6,11,37,40,-3,39
Brisbane,816,6,10,5,13,33,42,-9,35
Western Sydn,816,7,8,9,10,38,47,-9,33
Perth Glory,816,8,10,2,15,37,50,-13,32
Wellington P,816,9,5,6,16,31,55,-24,21
CC Mariners,816,10,4,8,15,28,49,-21,20
Sydney FC,817,1,21,4,3,69,23,46,67
N'castle Jet,817,2,15,6,7,59,39,20,51
Melbourne C,817,3,14,5,10,45,35,10,47
Melbourne V,817,4,13,5,11,46,43,3,44
Adelaide Utd,817,5,11,6,11,37,40,-3,39
Brisbane,817,6,10,5,13,33,42,-9,35
Western Sydn,817,7,8,9,10,38,47,-9,33
Perth Glory,817,8,10,2,15,37,50,-13,32
Wellington P,817,9,5,6,16,31,55,-24,21
CC Mariners,817,10,4,8,15,28,49,-21,20
Sydney FC,818,1,21,4,3,69,22,47,67
N'castle Jet,818,2,16,5,7,62,38,24,53
Melbourne C,818,3,14,4,11,44,38,6,46
Melbourne V,818,4,13,5,11,45,43,2,44
Adelaide Utd,818,5,11,6,11,37,40,-3,39
Brisbane,818,6,10,5,13,33,42,-9,35
Western Sydn,818,7,8,9,10,38,47,-9,33
Perth Glory,818,8,10,2,15,37,50,-13,32
Wellington P,818,9,5,6,16,31,55,-24,21
CC Mariners,818,10,4,8,15,28,49,-21,20
Sydney FC,819,1,21,4,3,65,22,43,67
N'castle Jet,819,2,16,5,7,60,38,22,53
Melbourne C,819,3,14,4,11,44,36,8,46
Melbourne V,819,4,13,5,11,45,39,6,44
Adelaide Utd,819,5,11,6,11,37,40,-3,39
Brisbane,819,6,10,5,13,33,42,-9,35
Western Sydn,819,7,8,9,10,38,47,-9,33
Perth Glory,819,8,10,2,15,37,50,-13,32
Wellington P,819,9,5,6,16,31,55,-24,21
CC Mariners,819,10,4,8,15,28,49,-21,20
Sydney FC,820,1,21,4,3,66,23,43,67
N'castle Jet,820,2,15,6,7,59,39,20,51
Melbourne C,820,3,14,5,10,45,35,10,47
Melbourne V,820,4,13,5,11,46,40,6,44
Adelaide Utd,820,5,11,6,11,37,40,-3,39
Brisbane,820,6,10,5,13,33,42,-9,35
Western Sydn,820,7,8,9,10,38,47,-9,33
Perth Glory,820,8,10,2,15,37,50,-13,32
Wellington P,820,9,5,6,16,31,55,-24,21
CC Mariners,820,10,4,8,15,28,49,-21,20
Sydney FC,821,1,21,4,3,66,22,44,67
N'castle Jet,821,2,16,5,7,65,38,27,53
Melbourne C,821,3,14,4,11,44,41,3,46
Melbourne V,821,4,13,5,11,45,40,5,44
Adelaide Utd,821,5,11,6,11,37,40,-3,39
Brisbane,821,6,10,5,13,33,42,-9,35
Western Sydn,821,7,8,9,10,38,47,-9,33
Perth Glory,821,8,10,2,15,37,50,-13,32
Wellington P,821,9,5,6,16,31,55,-24,21
CC Mariners,821,10,4,8,15,28,49,-21,20
Sydney FC,822,1,20,5,3,65,23,42,65
N'castle Jet,822,2,15,5,8,57,38,19,50
Melbourne C,822,3,15,4,10,44,33,11,49
Melbourne V,822,4,13,6,10,46,39,7,45
Adelaide Utd,822,5,11,6,11,37,40,-3,39
Brisbane,822,6,10,5,13,33,42,-9,35
Western Sydn,822,7,8,9,10,38,47,-9,33
Perth Glory,822,8,10,2,15,37,50,-13,32
Wellington P,822,9,5,6,16,31,55,-24,21
CC Mariners,822,10,4,8,15,28,49,-21,20
Sydney FC,823,1,21,4,3,68,23,45,67
N'castle Jet,823,2,16,5,7,59,38,21,53
Melbourne C,823,3,14,4,11,44,35,9,46
Melbourne V,823,4,13,5,11,46,42,4,44
Adelaide Utd,823,5,11,6,11,37,40,-3,39
Brisbane,823,6,10,5,13,33,42,-9,35
Western Sydn,823,7,8,9,10,38,47,-9,33
Perth Glory,823,8,10,2,15,37,50,-13,32
Wellington P,823,9,5,6,16,31,55,-24,21
CC Mariners,823,10,4,8,15,28,49,-21,20
Sydney FC,824,1,21,4,3,66,23,43,67
N'castle Jet,824,2,16,5,7,58,37,21,53
Melbourne C,824,3,14,4,11,43,34,9,46
Melbourne V,824,4,13,5,11,46,40,6,44
Adelaide Utd,824,5,11,6,11,37,40,-3,39
Brisbane,824,6,10,5,13,33,42,-9,35
Western Sydn,824,7,8,9,10,38,47,-9,33
Perth Glory,824,8,10,2,15,37,50,-13,32
Wellington P,824,9,5,6,16,31,55,-24,21
CC Mariners,824,10,4,8,15,28,49,-21,20
Sydney FC,825,1,21,4,3,68,22,46,67
N'castle Jet,825,2,16,5,7,60,37,23,53
Melbourne C,825,3,14,4,11,43,36,7,46
Melbourne V,825,4,13,5,11,45,42,3,44
Adelaide Utd,825,5,11,6,11,37,40,-3,39
Brisbane,825,6,10,5,13,33,42,-9,35
Western Sydn,825,7,8,9,10,38,47,-9,33
Perth Glory,825,8,10,2,15,37,50,-13,32
Wellington P,825,9,5,6,16,31,55,-24,21
CC Mariners,825,10,4,8,15,28,49,-21,20
Sydney FC,826,1,21,4,3,66,22,44,67
N'castle Jet,826,2,16,5,7,59,37,22,53
Melbourne C,826,3,14,4,11,43,35,8,46
Melbourne V,826,4,13,5,11,45,40,5,44
Adelaide Utd,826,5,11,6,11,37,40,-3,39
Brisbane,826,6,10,5,13,33,42,-9,35
Western Sydn,826,7,8,9,10,38,47,-9,33
Perth Glory,826,8,10,2,15,37,50,-13,32
Wellington P,826,9,5,6,16,31,55,-24,21
CC Mariners,826,10,4,8,15,28,49,-21,20
Sydney FC,827,1,20,4,4,66,25,41,64
N'castle Jet,827,2,15,6,7,57,37,20,51
Melbourne C,827,3,14,5,10,43,33,10,47
Melbourne V,827,4,14,5,10,48,40,8,47
Adelaide Utd,827,5,11,6,11,37,40,-3,39
Brisbane,827,6,10,5,13,33,42,-9,35
Western Sydn,827,7,8,9,10,38,47,-9,33
Perth Glory,827,8,10,2,15,37,50,-13,32
Wellington P,827,9,5,6,16,31,55,-24,21
CC Mariners,827,10,4,8,15,28,49,-21,20
Sydney FC,828,1,20,5,3,66,24,42,65
N'castle Jet,828,2,16,5,7,60,38,22,53
Melbourne C,828,3,14,4,11,44,36,8,46
Melbourne V,828,4,13,6,10,47,40,7,45
Adelaide Utd,828,5,11,6,11,37,40,-3,39
Brisbane,828,6,10,5,13,33,42,-9,35
Western Sydn,828,7,8,9,10,38,47,-9,33
Perth Glory,828,8,10,2,15,37,50,-13,32
Wellington P,828,9,5,6,16,31,55,-24,21
CC Mariners,828,10,4,8,15,28,49,-21,20
Sydney FC,829,1,21,4,3,67,23,44,67
N'castle Jet,829,2,15,5,8,58,39,19,50
Melbourne C,829,3,15,4,10,45,34,11,49
Melbourne V,829,4,13,5,11,46,41,5,44
Adelaide Utd,829,5,11,6,11,37,40,-3,39
Brisbane,829,6,10,5,13,33,42,-9,35
Western Sydn,829,7,8,9,10,38,47,-9,33
Perth Glory,829,8,10,2,15,37,50,-13,32
Wellington P,829,9,5,6,16,31,55,-24,21
CC Mariners,829,10,4,8,15,28,49,-21,20
Sydney FC,830,1,20,4,4,65,25,40,64
N'castle Jet,830,2,15,5,8,57,39,18,50
Melbourne C,830,3,15,4,10,45,33,12,49
Melbourne V,830,4,14,5,10,48,39,9,47
Adelaide Utd,830,5,11,6,11,37,40,-3,39
Brisbane,830,6,10,5,13,33,42,-9,35
Western Sydn,830,7,8,9,10,38,47,-9,33
Perth Glory,830,8,10,2,15,37,50,-13,32
Wellington P,830,9,5,6,16,31,55,-24,21
CC Mariners,830,10,4,8,15,28,49,-21,20
Sydney FC,831,1,21,4,3,65,22,43,67
N'castle Jet,831,2,16,5,7,59,38,21,53
Melbourne C,831,3,14,4,11,44,35,9,46
Melbourne V,831,4,13,5,11,45,39,6,44
Adelaide Utd,831,5,11,6,11,37,40,-3,39
Brisbane,831,6,10,5,13,33,42,-9,35
Western Sydn,831,7,8,9,10,38,47,-9,33
Perth Glory,831,8,10,2,15,37,50,-13,32
Wellington P,831,9,5,6,16,31,55,-24,21
CC Mariners,831,10,4,8,15,28,49,-21,20
Sydney FC,832,1,20,4,4,65,24,41,64
N'castle Jet,832,2,16,5,7,59,38,21,53
Melbourne V,832,3,14,5,10,47,39,8,47
Melbourne C,832,4,14,4,11,44,35,9,46
Adelaide Utd,832,5,11,6,11,37,40,-3,39
Brisbane,832,6,10,5,13,33,42,-9,35
Western Sydn,832,7,8,9,10,38,47,-9,33
Perth Glory,832,8,10,2,15,37,50,-13,32
Wellington P,832,9,5,6,16,31,55,-24,21
CC Mariners,832,10,4,8,15,28,49,-21,20
Sydney FC,833,1,20,4,4,64,24,40,64
N'castle Jet,833,2,16,5,7,58,37,21,53
Melbourne V,833,3,14,5,10,47,38,9,47
Melbourne C,833,4,14,4,11,43,34,9,46
Adelaide Utd,833,5,11,6,11,37,40,-3,39
Brisbane,833,6,10,5,13,33,42,-9,35
Western Sydn,833,7,8,9,10,38,47,-9,33
Perth Glory,833,8,10,2,15,37,50,-13,32
Wellington P,833,9,5,6,16,31,55,-24,21
CC Mariners,833,10,4,8,15,28,49,-21,20
Sydney FC,834,1,21,4,3,67,23,44,67
N'castle Jet,834,2,16,5,7,59,37,22,53
Melbourne C,834,3,14,4,11,43,35,8,46
Melbourne V,834,4,13,5,11,46,41,5,44
Adelaide Utd,834,5,11,6,11,37,40,-3,39
Brisbane,834,6,10,5,13,33,42,-9,35
Western Sydn,834,7,8,9,10,38,47,-9,33
Perth Glory,834,8,10,2,15,37,50,-13,32
Wellington P,834,9,5,6,16,31,55,-24,21
CC Mariners,834,10,4,8,15,28,49,-21,20
Sydney FC,835,1,21,4,3,68,23,45,67
N'castle Jet,835,2,15,5,8,58,39,19,50
Melbourne C,835,3,15,4,10,45,34,11,49
Melbourne V,835,4,13,5,11,46,42,4,44
Adelaide Utd,835,5,11,6,11,37,40,-3,39
Brisbane,835,6,10,5,13,33,42,-9,35
Western Sydn,835,7,8,9,10,38,47,-9,33
Perth Glory,835,8,10,2,15,37,50,-13,32
Wellington P,835,9,5,6,16,31,55,-24,21
CC Mariners,835,10,4,8,15,28,49,-21,20
Sydney FC,836,1,21,4,3,66,22,44,67
N'castle Jet,836,2,16,5,7,61,40,21,53
Melbourne C,836,3,14,4,11,46,37,9,46
Melbourne V,836,4,13,5,11,45,40,5,44
Adelaide Utd,836,5,11,6,11,37,40,-3,39
Brisbane,836,6,10,5,13,33,42,-9,35
Western Sydn,836,7,8,9,10,38,47,-9,33
Perth Glory,836,8,10,2,15,37,50,-13,32
Wellington P,836,9,5,6,16,31,55,-24,21
CC Mariners,836,10,4,8,15,28,49,-21,20
Sydney FC,837,1,20,5,3,65,23,42,65
N'castle Jet,837,2,15,5,8,58,39,19,50
Melbourne C,837,3,15,4,10,45,34,11,49
Melbourne V,837,4,13,6,10,46,39,7,45
Adelaide Utd,837,5,11,6,11,37,40,-3,39
Brisbane,837,6,10,5,13,33,42,-9,35
Western Sydn,837,7,8,9,10,38,47,-9,33
Perth Glory,837,8,10,2,15,37,50,-13,32
Wellington P,837,9,5,6,16,31,55,-24,21
CC Mariners,837,10,4,8,15,28,49,-21,20
Sydney FC,838,1,20,4,4,66,26,40,64
N'castle Jet,838,2,15,5,8,58,39,19,50
Melbourne C,838,3,15,4,10,45,34,11,49
Melbourne V,838,4,14,5,10,49,40,9,47
Adelaide Utd,838,5,11,6,11,37,40,-3,39
Brisbane,838,6,10,5,13,33,42,-9,35
Western Sydn,838,7,8,9,10,38,47,-9,33
Perth Glory,838,8,10,2,15,37,50,-13,32
Wellington P,838,9,5,6,16,31,55,-24,21
CC Mariners,838,10,4,8,15,28,49,-21,20
Sydney FC,839,1,20,5,3,65,23,42,65
N'castle Jet,839,2,15,5,8,58,40,18,50
Melbourne C,839,3,15,4,10,46,34,12,49
Melbourne V,839,4,13,6,10,46,39,7,45
Adelaide Utd,839,5,11,6,11,37,40,-3,39
Brisbane,839,6,10,5,13,33,42,-9,35
Western Sydn,839,7,8,9,10,38,47,-9,33
Perth Glory,839,8,10,2,15,37,50,-13,32
Wellington P,839,9,5,6,16,31,55,-24,21
CC Mariners,839,10,4,8,15,28,49,-21,20
Sydney FC,840,1,20,5,3,64,22,42,65
N'castle Jet,840,2,15,5,8,59,41,18,50
Melbourne C,840,3,15,4,10,47,35,12,49
Melbourne V,840,4,13,6,10,45,38,7,45
Adelaide Utd,840,5,11,6,11,37,40,-3,39
Brisbane,840,6,10,5,13,33,42,-9,35
Western Sydn,840,7,8,9,10,38,47,-9,33
Perth Glory,840,8,10,2,15,37,50,-13,32
Wellington P,840,9,5,6,16,31,55,-24,21
CC Mariners,840,10,4,8,15,28,49,-21,20
Sydney FC,841,1,20,4,4,66,25,41,64
N'castle Jet,841,2,16,5,7,60,37,23,53
Melbourne V,841,3,14,5,10,48,40,8,47
Melbourne C,841,4,14,4,11,43,36,7,46
Adelaide Utd,841,5,11,6,11,37,40,-3,39
Brisbane,841,6,10,5,13,33,42,-9,35
Western Sydn,841,7,8,9,10,38,47,-9,33
Perth Glory,841,8,10,2,15,37,50,-13,32
Wellington P,841,9,5,6,16,31,55,-24,21
CC Mariners,841,10,4,8,15,28,49,-21,20
Sydney FC,842,1,21,4,3,67,23,44,67
N'castle Jet,842,2,15,5,8,57,39,18,50
Melbourne C,842,3,15,4,10,45,33,12,49
Melbourne V,842,4,13,5,11,46,41,5,44
Adelaide Utd,842,5,11,6,11,37,40,-3,39
Brisbane,842,6,10,5,13,33,42,-9,35
Western Sydn,842,7,8,9,10,38,47,-9,33
Perth Glory,842,8,10,2,15,37,50,-13,32
Wellington P,842,9,5,6,16,31,55,-24,21
CC Mariners,842,10,4,8,15,28,49,-21,20
Sydney FC,843,1,21,4,3,66,22,44,67
N'castle Jet,843,2,16,5,7,59,38,21,53
Melbourne C,843,3,14,4,11,44,35,9,46
Melbourne V,843,4,13,5,11,45,40,5,44
Adelaide Utd,843,5,11,6,11,37,40,-3,39
Brisbane,843,6,10,5,13,33,42,-9,35
Western Sydn,843,7,8,9,10,38,47,-9,33
Perth Glory,843,8,10,2,15,37,50,-13,32
Wellington P,843,9,5,6,16,31,55,-24,21
CC Mariners,843,10,4,8,15,28,49,-21,20
Sydney FC,844,1,21,4,3,68,22,46,67
N'castle Jet,844,2,16,5,7,61,39,22,53
Melbourne C,844,3,14,4,11,45,37,8,46
Melbourne V,844,4,13,5,11,45,42,3,44
Adelaide Utd,844,5,11,6,11,37,40,-3,39
Brisbane,844,6,10,5,13,33,42,-9,35
Western Sydn,844,7,8,9,10,38,47,-9,33
Perth Glory,844,8,10,2,15,37,50,-13,32
Wellington P,844,9,5,6,16,31,55,-24,21
CC Mariners,844,10,4,8,15,28,49,-21,20
Sydney FC,845,1,21,4,3,66,23,43,67
N'castle Jet,845,2,15,5,8,58,40,18,50
Melbourne C,845,3,15,4,10,46,34,12,49
Melbourne V,845,4,13,5,11,46,40,6,44
Adelaide Utd,845,5,11,6,11,37,40,-3,39
Brisbane,845,6,10,5,13,33,42,-9,35
Western Sydn,845,7,8,9,10,38,47,-9,33
Perth Glory,845,8,10,2,15,37,50,-13,32
Wellington P,845,9,5,6,16,31,55,-24,21
CC Mariners,845,10,4,8,15,28,49,-21,20
Sydney FC,846,1,20,5,3,66,24,42,65
N'castle Jet,846,2,15,6,7,58,38,20,51
Melbourne C,846,3,14,5,10,44,34,10,47
Melbourne V,846,4,13,6,10,47,40,7,45
Adelaide Utd,846,5,11,6,11,37,40,-3,39
Brisbane,846,6,10,5,13,33,42,-9,35
Western Sydn,846,7,8,9,10,38,47,-9,33
Perth Glory,846,8,10,2,15,37,50,-13,32
Wellington P,846,9,5,6,16,31,55,-24,21
CC Mariners,846,10,4,8,15,28,49,-21,20
Sydney FC,847,1,21,4,3,65,22,43,67
N'castle Jet,847,2,15,5,8,57,38,19,50
Melbourne C,847,3,15,4,10,44,33,11,49
Melbourne V,847,4,13,5,11,45,39,6,44
Adelaide Utd,847,5,11,6,11,37,40,-3,39
Brisbane,847,6,10,5,13,33,42,-9,35
Western Sydn,847,7,8,9,10,38,47,-9,33
Perth Glory,847,8,10,2,15,37,50,-13,32
Wellington P,847,9,5,6,16,31,55,-24,21
CC Mariners,847,10,4,8,15,28,49,-21,20
Sydney FC,848,1,20,4,4,64,24,40,64
N'castle Jet,848,2,16,5,7,60,39,21,53
Melbourne V,848,3,14,5,10,47,38,9,47
Melbourne C,848,4,14,4,11,45,36,9,46
Adelaide Utd,848,5,11,6,11,37,40,-3,39
Brisbane,848,6,10,5,13,33,42,-9,35
Western Sydn,848,7,8,9,10,38,47,-9,33
Perth Glory,848,8,10,2,15,37,50,-13,32
Wellington P,848,9,5,6,16,31,55,-24,21
CC Mariners,848,10,4,8,15,28,49,-21,20
Sydney FC,849,1,21,4,3,65,22,43,67
N'castle Jet,849,2,16,5,7,62,38,24,53
Melbourne C,849,3,14,4,11,44,38,6,46
Melbourne V,849,4,13,5,11,45,39,6,44
Adelaide Utd,849,5,11,6,11,37,40,-3,39
Brisbane,849,6,10,5,13,33,42,-9,35
Western Sydn,849,7,8,9,10,38,47,-9,33
Perth Glory,849,8,10,2,15,37,50,-13,32
Wellington P,849,9,5,6,16,31,55,-24,21
CC Mariners,849,10,4,8,15,28,49,-21,20
Sydney FC,850,1,21,4,3,65,22,43,67
N'castle Jet,850,2,16,5,7,60,37,23,53
Melbourne C,850,3,14,4,11,43,36,7,46
Melbourne V,850,4,13,5,11,45,39,6,44
Adelaide Utd,850,5,11,6,11,37,40,-3,39
Brisbane,850,6,10,5,13,33,42,-9,35
Western Sydn,850,7,8,9,10,38,47,-9,33
Perth Glory,850,8,10,2,15,37,50,-13,32
Wellington P,850,9,5,6,16,31,55,-24,21
CC Mariners,850,10,4,8,15,28,49,-21,20
Sydney FC,851,1,20,4,4,64,24,40,64
N'castle Jet,851,2,16,5,7,60,39,21,53
Melbourne V,851,3,14,5,10,47,38,9,47
Melbourne C,851,4,14,4,11,45,36,9,46
Adelaide Utd,851,5,11,6,11,37,40,-3,39
Brisbane,851,6,10,5,13,33,42,-9,35
Western Sydn,851,7,8,9,10,38,47,-9,33
Perth Glory,851,8,10,2,15,37,50,-13,32
Wellington P,851,9,5,6,16,31,55,-24,21
CC Mariners,851,10,4,8,15,28,49,-21,20
Sydney FC,852,1,20,4,4,64,24,40,64
N'castle Jet,852,2,15,6,7,58,38,20,51
Melbourne C,852,3,14,5,10,44,34,10,47
Melbourne V,852,4,14,5,10,47,38,9,47
Adelaide Utd,852,5,11,6,11,37,40,-3,39
Brisbane,852,6,10,5,13,33,42,-9,35
Western Sydn,852,7,8,9,10,38,47,-9,33
Perth Glory,852,8,10,2,15,37,50,-13,32
Wellington P,852,9,5,6,16,31,55,-24,21
CC Mariners,852,10,4,8,15,28,49,-21,20
Sydney FC,853,1,21,4,3,67,22,45,67
N'castle Jet,853,2,15,6,7,59,39,20,51
Melbourne C,853,3,14,5,10,45,35,10,47
Melbourne V,853,4,13,5,11,45,41,4,44
Adelaide Utd,853,5,11,6,11,37,40,-3,39
Brisbane,853,6,10,5,13,33,42,-9,35
Western Sydn,853,7,8,9,10,38,47,-9,33
Perth Glory,853,8,10,2,15,37,50,-13,32
Wellington P,853,9,5,6,16,31,55,-24,21
CC Mariners,853,10,4,8,15,28,49,-21,20
Sydney FC,854,1,20,4,4,66,25,41,64
N'castle Jet,854,2,15,5,8,59,42,17,50
Melbourne C,854,3,15,4,10,48,35,13,49
Melbourne V,854,4,14,5,10,48,40,8,47
Adelaide Utd,854,5,11,6,11,37,40,-3,39
Brisbane,854,6,10,5,13,33,42,-9,35
Western Sydn,854,7,8,9,10,38,47,-9,33
Perth Glory,854,8,10,2,15,37,50,-13,32
Wellington P,854,9,5,6,16,31,55,-24,21
CC Mariners,854,10,4,8,15,28,49,-21,20
Sydney FC,855,1,21,4,3,66,23,43,67
N'castle Jet,855,2,15,6,7,58,38,20,51
Melbourne C,855,3,14,5,10,44,34,10,47
Melbourne V,855,4,13,5,11,46,40,6,44
Adelaide Utd,855,5,11,6,11,37,40,-3,39
Brisbane,855,6,10,5,13,33,42,-9,35
Western Sydn,855,7,8,9,10,38,47,-9,33
Perth Glory,855,8,10,2,15,37,50,-13,32
Wellington P,855,9,5,6,16,31,55,-24,21
CC Mariners,855,10,4,8,15,28,49,-21,20
Sydney FC,856,1,21,4,3,66,22,44,67
N'castle Jet,856,2,16,5,7,58,37,21,53
Melbourne C,856,3,14,4,11,43,34,9,46
Melbourne V,856,4,13,5,11,45,40,5,44
Adelaide Utd,856,5,11,6,11,37,40,-3,39
Brisbane,856,6,10,5,13,33,42,-9,35
Western Sydn,856,7,8,9,10,38,47,-9,33
Perth Glory,856,8,10,2,15,37,50,-13,32
Wellington P,856,9,5,6,16,31,55,-24,21
CC Mariners,856,10,4,8,15,28,49,-21,20
Sydney FC,857,1,20,4,4,66,26,40,64
N'castle Jet,857,2,15,5,8,58,41,17,50
Melbourne C,857,3,15,4,10,47,34,13,49
Melbourne V,857,4,14,5,10,49,40,9,47
Adelaide Utd,857,5,11,6,11,37,40,-3,39
Brisbane,857,6,10,5,13,33,42,-9,35
Western Sydn,857,7,8,9,10,38,47,-9,33
Perth Glory,857,8,10,2,15,37,50,-13,32
Wellington P,857,9,5,6,16,31,55,-24,21
CC Mariners,857,10,4,8,15,28,49,-21,20
Sydney FC,858,1,21,4,3,66,23,43,67
N'castle Jet,858,2,15,5,8,58,40,18,50
Melbourne C,858,3,15,4,10,46,34,12,49
Melbourne V,858,4,13,5,11,46,40,6,44
Adelaide Utd,858,5,11,6,11,37,40,-3,39
Brisbane,858,6,10,5,13,33,42,-9,35
Western Sydn,858,7,8,9,10,38,47,-9,33
Perth Glory,858,8,10,2,15,37,50,-13,32
Wellington P,858,9,5,6,16,31,55,-24,21
CC Mariners,858,10,4,8,15,28,49,-21,20
Sydney FC,859,1,20,4,4,66,25,41,64
N'castle Jet,859,2,16,5,7,60,38,22,53
Melbourne V,859,3,14,5,10,48,40,8,47
Melbourne C,859,4,14,4,11,44,36,8,46
Adelaide Utd,859,5,11,6,11,37,40,-3,39
Brisbane,859,6,10,5,13,33,42,-9,35
Western Sydn,859,7,8,9,10,38,47,-9,33
Perth Glory,859,8,10,2,15,37,50,-13,32
Wellington P,859,9,5,6,16,31,55,-24,21
CC Mariners,859,10,4,8,15,28,49,-21,20
Sydney FC,860,1,20,5,3,65,23,42,65
N'castle Jet,860,2,16,5,7,62,39,23,53
Melbourne C,860,3,14,4,11,45,38,7,46
Melbourne V,860,4,13,6,10,46,39,7,45
Adelaide Utd,860,5,11,6,11,37,40,-3,39
Brisbane,860,6,10,5,13,33,42,-9,35
Western Sydn,860,7,8,9,10,38,47,-9,33
Perth Glory,860,8,10,2,15,37,50,-13,32
Wellington P,860,9,5,6,16,31,55,-24,21
CC Mariners,860,10,4,8,15,28,49,-21,20
Sydney FC,861,1,21,4,3,66,23,43,67
N'castle Jet,861,2,15,5,8,58,39,19,50
Melbourne C,861,3,15,4,10,45,34,11,49
Melbourne V,861,4,13,5,11,46,40,6,44
Adelaide Utd,861,5,11,6,11,37,40,-3,39
Brisbane,861,6,10,5,13,33,42,-9,35
Western Sydn,861,7,8,9,10,38,47,-9,33
Perth Glory,861,8,10,2,15,37,50,-13,32
Wellington P,861,9,5,6,16,31,55,-24,21
CC Mariners,861,10,4,8,15,28,49,-21,20
Sydney FC,862,1,21,4,3,66,22,44,67
N'castle Jet,862,2,15,5,8,57,38,19,50
Melbourne C,862,3,15,4,10,44,33,11,49
Melbourne V,862,4,13,5,11,45,40,5,44
Adelaide Utd,862,5,11,6,11,37,40,-3,39
Brisbane,862,6,10,5,13,33,42,-9,35
Western Sydn,862,7,8,9,10,38,47,-9,33
Perth Glory,862,8,10,2,15,37,50,-13,32
Wellington P,862,9,5,6,16,31,55,-24,21
CC Mariners,862,10,4,8,15,28,49,-21,20
Sydney FC,863,1,20,5,3,65,23,42,65
N'castle Jet,863,2,16,5,7,60,38,22,53
Melbourne C,863,3,14,4,11,44,36,8,46
Melbourne V,863,4,13,6,10,46,39,7,45
Adelaide Utd,863,5,11,6,11,37,40,-3,39
Brisbane,863,6,10,5,13,33,42,-9,35
Western Sydn,863,7,8,9,10,38,47,-9,33
Perth Glory,863,8,10,2,15,37,50,-13,32
Wellington P,863,9,5,6,16,31,55,-24,21
CC Mariners,863,10,4,8,15,28,49,-21,20
Sydney FC,864,1,20,5,3,65,23,42,65
N'castle Jet,864,2,16,5,7,61,39,22,53
Melbourne C,864,3,14,4,11,45,37,8,46
Melbourne V,864,4,13,6,10,46,39,7,45
Adelaide Utd,864,5,11,6,11,37,40,-3,39
Brisbane,864,6,10,5,13,33,42,-9,35
Western Sydn,864,7,8,9,10,38,47,-9,33
Perth Glory,864,8,10,2,15,37,50,-13,32
Wellington P,864,9,5,6,16,31,55,-24,21
CC Mariners,864,10,4,8,15,28,49,-21,20
Sydney FC,865,1,20,4,4,64,23,41,64
N'castle Jet,865,2,16,5,7,60,37,23,53
Melbourne V,865,3,14,5,10,46,38,8,47
Melbourne C,865,4,14,4,11,43,36,7,46
Adelaide Utd,865,5,11,6,11,37,40,-3,39
Brisbane,865,6,10,5,13,33,42,-9,35
Western Sydn,865,7,8,9,10,38,47,-9,33
Perth Glory,865,8,10,2,15,37,50,-13,32
Wellington P,865,9,5,6,16,31,55,-24,21
CC Mariners,865,10,4,8,15,28,49,-21,20
Sydney FC,866,1,20,4,4,64,24,40,64
N'castle Jet,866,2,15,6,7,59,39,20,51
Melbourne C,866,3,14,5,10,45,35,10,47
Melbourne V,866,4,14,5,10,47,38,9,47
Adelaide Utd,866,5,11,6,11,37,40,-3,39
Brisbane,866,6,10,5,13,33,42,-9,35
Western Sydn,866,7,8,9,10,38,47,-9,33
Perth Glory,866,8,10,2,15,37,50,-13,32
Wellington P,866,9,5,6,16,31,55,-24,21
CC Mariners,866,10,4,8,15,28,49,-21,20
Sydney FC,867,1,21,4,3,65,22,43,67
N'castle Jet,867,2,15,6,7,58,38,20,51
Melbourne C,867,3,14,5,10,44,34,10,47
Melbourne V,867,4,13,5,11,45,39,6,44
Adelaide Utd,867,5,11,6,11,37,40,-3,39
Brisbane,867,6,10,5,13,33,42,-9,35
Western Sydn,867,7,8,9,10,38,47,-9,33
Perth Glory,867,8,10,2,15,37,50,-13,32
Wellington P,867,9,5,6,16,31,55,-24,21
CC Mariners,867,10,4,8,15,28,49,-21,20
Sydney FC,868,1,20,4,4,64,24,40,64
N'castle Jet,868,2,16,5,7,59,38,21,53
Melbourne V,868,3,14,5,10,47,38,9,47
Melbourne C,868,4,14,4,11,44,35,9,46
Adelaide Utd,868,5,11,6,11,37,40,-3,39
Brisbane,868,6,10,5,13,33,42,-9,35
Western Sydn,868,7,8,9,10,38,47,-9,33
Perth Glory,868,8,10,2,15,37,50,-13,32
Wellington P,868,9,5,6,16,31,55,-24,21
CC Mariners,868,10,4,8,15,28,49,-21,20
Sydney FC,869,1,21,4,3,68,23,45,67
N'castle Jet,869,2,16,5,7,60,38,22,53
Melbourne C,869,3,14,4,11,44,36,8,46
Melbourne V,869,4,13,5,11,46,42,4,44
Adelaide Utd,869,5,11,6,11,37,40,-3,39
Brisbane,869,6,10,5,13,33,42,-9,35
Western Sydn,869,7,8,9,10,38,47,-9,33
Perth Glory,869,8,10,2,15,37,50,-13,32
Wellington P,869,9,5,6,16,31,55,-24,21
CC Mariners,869,10,4,8,15,28,49,-21,20
Sydney FC,870,1,21,4,3,67,22,45,67
N'castle Jet,870,2,16,5,7,59,38,21,53
Melbourne C,870,3,14,4,11,44,35,9,46
Melbourne V,870,4,13,5,11,45,41,4,44
Adelaide Utd,870,5,11,6,11,37,40,-3,39
Brisbane,870,6,10,5,13,33,42,-9,35
Western Sydn,870,7,8,9,10,38,47,-9,33
Perth Glory,870,8,10,2,15,37,50,-13,32
Wellington P,870,9,5,6,16,31,55,-24,21
CC Mariners,870,10,4,8,15,28,49,-21,20
Sydney FC,871,1,21,4,3,67,22,45,67
N'castle Jet,871,2,16,5,7,62,38,24,53
Melbourne C,871,3,14,4,11,44,38,6,46
Melbourne V,871,4,13,5,11,45,41,4,44
Adelaide Utd,871,5,11,6,11,37,40,-3,39
Brisbane,871,6,10,5,13,33,42,-9,35
Western Sydn,871,7,8,9,10,38,47,-9,33
Perth Glory,871,8,10,2,15,37,50,-13,32
Wellington P,871,9,5,6,16,31,55,-24,21
CC Mariners,871,10,4,8,15,28,49,-21,20
Sydney FC,872,1,21,4,3,66,23,43,67
N'castle Jet,872,2,15,5,8,58,39,19,50
Melbourne C,872,3,15,4,10,45,34,11,49
Melbourne V,872,4,13,5,11,46,40,6,44
Adelaide Utd,872,5,11,6,11,37,40,-3,39
Brisbane,872,6,10,5,13,33,42,-9,35
Western Sydn,872,7,8,9,10,38,47,-9,33
Perth Glory,872,8,10,2,15,37,50,-13,32
Wellington P,872,9,5,6,16,31,55,-24,21
CC Mariners,872,10,4,8,15,28,49,-21,20
Sydney FC,873,1,21,4,3,65,22,43,67
N'castle Jet,873,2,16,5,7,59,38,21,53
Melbourne C,873,3,14,4,11,44,35,9,46
Melbourne V,873,4,13,5,11,45,39,6,44
Adelaide Utd,873,5,11,6,11,37,40,-3,39
Brisbane,873,6,10,5,13,33,42,-9,35
Western Sydn,873,7,8,9,10,38,47,-9,33
Perth Glory,873,8,10,2,15,37,50,-13,32
Wellington P,873,9,5,6,16,31,55,-24,21
CC Mariners,873,10,4,8,15,28,49,-21,20
Sydney FC,874,1,20,4,4,65,25,40,64
N'castle Jet,874,2,16,5,7,60,39,21,53
Melbourne V,874,3,14,5,10,48,39,9,47
Melbourne C,874,4,14,4,11,45,36,9,46
Adelaide Utd,874,5,11,6,11,37,40,-3,39
Brisbane,874,6,10,5,13,33,42,-9,35
Western Sydn,874,7,8,9,10,38,47,-9,33
Perth Glory,874,8,10,2,15,37,50,-13,32
Wellington P,874,9,5,6,16,31,55,-24,21
CC Mariners,874,10,4,8,15,28,49,-21,20
Sydney FC,875,1,20,4,4,64,23,41,64
N'castle Jet,875,2,16,5,7,59,37,22,53
Melbourne V,875,3,14,5,10,46,38,8,47
Melbourne C,875,4,14,4,11,43,35,8,46
Adelaide Utd,875,5,11,6,11,37,40,-3,39
Brisbane,875,6,10,5,13,33,42,-9,35
Western Sydn,875,7,8,9,10,38,47,-9,33
Perth Glory,875,8,10,2,15,37,50,-13,32
Wellington P,875,9,5,6,16,31,55,-24,21
CC Mariners,875,10,4,8,15,28,49,-21,20
Sydney FC,876,1,21,4,3,68,24,44,67
N'castle Jet,876,2,15,5,8,58,43,15,50
Melbourne C,876,3,15,4,10,49,34,15,49
Melbourne V,876,4,13,5,11,47,42,5,44
Adelaide Utd,876,5,11,6,11,37,40,-3,39
Brisbane,876,6,10,5,13,33,42,-9,35
Western Sydn,876,7,8,9,10,38,47,-9,33
Perth Glory,876,8,10,2,15,37,50,-13,32
Wellington P,876,9,5,6,16,31,55,-24,21
CC Mariners,876,10,4,8,15,28,49,-21,20
Sydney FC,877,1,20,4,4,64,25,39,64
N'castle Jet,877,2,15,6,7,57,37,20,51
Melbourne V,877,3,14,5,10,48,38,10,47
Melbourne C,877,4,14,5,10,43,33,10,47
Adelaide Utd,877,5,11,6,11,37,40,-3,39
Brisbane,877,6,10,5,13,33,42,-9,35
Western Sydn,877,7,8,9,10,38,47,-9,33
Perth Glory,877,8,10,2,15,37,50,-13,32
Wellington P,877,9,5,6,16,31,55,-24,21
CC Mariners,877,10,4,8,15,28,49,-21,20
Sydney FC,878,1,20,5,3,65,23,42,65
N'castle Jet,878,2,16,5,7,63,39,24,53
Melbourne C,878,3,14,4,11,45,39,6,46
Melbourne V,878,4,13,6,10,46,39,7,45
Adelaide Utd,878,5,11,6,11,37,40,-3,39
Brisbane,878,6,10,5,13,33,42,-9,35
Western Sydn,878,7,8,9,10,38,47,-9,33
Perth Glory,878,8,10,2,15,37,50,-13,32
Wellington P,878,9,5,6,16,31,55,-24,21
CC Mariners,878,10,4,8,15,28,49,-21,20
Sydney FC,879,1,20,4,4,65,24,41,64
N'castle Jet,879,2,15,6,7,59,39,20,51
Melbourne C,879,3,14,5,10,45,35,10,47
Melbourne V,879,4,14,5,10,47,39,8,47
Adelaide Utd,879,5,11,6,11,37,40,-3,39
Brisbane,879,6,10,5,13,33,42,-9,35
Western Sydn,879,7,8,9,10,38,47,-9,33
Perth Glory,879,8,10,2,15,37,50,-13,32
Wellington P,879,9,5,6,16,31,55,-24,21
CC Mariners,879,10,4,8,15,28,49,-21,20
Sydney FC,880,1,21,4,3,67,23,44,67
N'castle Jet,880,2,16,5,7,58,37,21,53
Melbourne C,880,3,14,4,11,43,34,9,46
Melbourne V,880,4,13,5,11,46,41,5,44
Adelaide Utd,880,5,11,6,11,37,40,-3,39
Brisbane,880,6,10,5,13,33,42,-9,35
Western Sydn,880,7,8,9,10,38,47,-9,33
Perth Glory,880,8,10,2,15,37,50,-13,32
Wellington P,880,9,5,6,16,31,55,-24,21
CC Mariners,880,10,4,8,15,28,49,-21,20
Sydney FC,881,1,20,4,4,65,24,41,64
N'castle Jet,881,2,15,5,8,57,40,17,50
Melbourne C,881,3,15,4,10,46,33,13,49
Melbourne V,881,4,14,5,10,47,39,8,47
Adelaide Utd,881,5,11,6,11,37,40,-3,39
Brisbane,881,6,10,5,13,33,42,-9,35
Western Sydn,881,7,8,9,10,38,47,-9,33
Perth Glory,881,8,10,2,15,37,50,-13,32
Wellington P,881,9,5,6,16,31,55,-24,21
CC Mariners,881,10,4,8,15,28,49,-21,20
Sydney FC,882,1,20,4,4,64,24,40,64
N'castle Jet,882,2,16,5,7,59,38,21,53
Melbourne V,882,3,14,5,10,47,38,9,47
Melbourne C,882,4,14,4,11,44,35,9,46
Adelaide Utd,882,5,11,6,11,37,40,-3,39
Brisbane,882,6,10,5,13,33,42,-9,35
Western Sydn,882,7,8,9,10,38,47,-9,33
Perth Glory,882,8,10,2,15,37,50,-13,32
Wellington P,882,9,5,6,16,31,55,-24,21
CC Mariners,882,10,4,8,15,28,49,-21,20
Sydney FC,883,1,21,4,3,67,24,43,67
N'castle Jet,883,2,15,5,8,58,40,18,50
Melbourne C,883,3,15,4,10,46,34,12,49
Melbourne V,883,4,13,5,11,47,41,6,44
Adelaide Utd,883,5,11,6,11,37,40,-3,39
Brisbane,883,6,10,5,13,33,42,-9,35
Western Sydn,883,7,8,9,10,38,47,-9,33
Perth Glory,883,8,10,2,15,37,50,-13,32
Wellington P,883,9,5,6,16,31,55,-24,21
CC Mariners,883,10,4,8,15,28,49,-21,20
Sydney FC,884,1,21,4,3,68,24,44,67
N'castle Jet,884,2,16,5,7,61,38,23,53
Melbourne C,884,3,14,4,11,44,37,7,46
Melbourne V,884,4,13,5,11,47,42,5,44
Adelaide Utd,884,5,11,6,11,37,40,-3,39
Brisbane,884,6,10,5,13,33,42,-9,35
Western Sydn,884,7,8,9,10,38,47,-9,33
Perth Glory,884,8,10,2,15,37,50,-13,32
Wellington P,884,9,5,6,16,31,55,-24,21
CC Mariners,884,10,4,8,15,28,49,-21,20
Sydney FC,885,1,20,4,4,65,25,40,64
N'castle Jet,885,2,16,5,7,60,38,22,53
Melbourne V,885,3,14,5,10,48,39,9,47
Melbourne C,885,4,14,4,11,44,36,8,46
Adelaide Utd,885,5,11,6,11,37,40,-3,39
Brisbane,885,6,10,5,13,33,42,-9,35
Western Sydn,885,7,8,9,10,38,47,-9,33
Perth Glory,885,8,10,2,15,37,50,-13,32
Wellington P,885,9,5,6,16,31,55,-24,21
CC Mariners,885,10,4,8,15,28,49,-21,20
Sydney FC,886,1,21,4,3,66,23,43,67
N'castle Jet,886,2,16,5,7,59,37,22,53
Melbourne C,886,3,14,4,11,43,35,8,46
Melbourne V,886,4,13,5,11,46,40,6,44
Adelaide Utd,886,5,11,6,11,37,40,-3,39
Brisbane,886,6,10,5,13,33,42,-9,35
Western Sydn,886,7,8,9,10,38,47,-9,33
Perth Glory,886,8,10,2,15,37,50,-13,32
Wellington P,886,9,5,6,16,31,55,-24,21
CC Mariners,886,10,4,8,15,28,49,-21,20
Sydney FC,887,1,21,4,3,66,23,43,67
N'castle Jet,887,2,15,5,8,57,38,19,50
Melbourne C,887,3,15,4,10,44,33,11,49
Melbourne V,887,4,13,5,11,46,40,6,44
Adelaide Utd,887,5,11,6,11,37,40,-3,39
Brisbane,887,6,10,5,13,33,42,-9,35
Western Sydn,887,7,8,9,10,38,47,-9,33
Perth Glory,887,8,10,2,15,37,50,-13,32
Wellington P,887,9,5,6,16,31,55,-24,21
CC Mariners,887,10,4,8,15,28,49,-21,20
Sydney FC,888,1,20,5,3,67,25,42,65
N'castle Jet,888,2,15,5,8,57,38,19,50
Melbourne C,888,3,15,4,10,44,33,11,49
Melbourne V,888,4,13,6,10,48,41,7,45
Adelaide Utd,888,5,11,6,11,37,40,-3,39
Brisbane,888,6,10,5,13,33,42,-9,35
Western Sydn,888,7,8,9,10,38,47,-9,33
Perth Glory,888,8,10,2,15,37,50,-13,32
Wellington P,888,9,5,6,16,31,55,-24,21
CC Mariners,888,10,4,8,15,28,49,-21,20
Sydney FC,889,1,20,4,4,65,24,41,64
N'castle Jet,889,2,16,5,7,59,38,21,53
Melbourne V,889,3,14,5,10,47,39,8,47
Melbourne C,889,4,14,4,11,44,35,9,46
Adelaide Utd,889,5,11,6,11,37,40,-3,39
Brisbane,889,6,10,5,13,33,42,-9,35
Western Sydn,889,7,8,9,10,38,47,-9,33
Perth Glory,889,8,10,2,15,37,50,-13,32
Wellington P,889,9,5,6,16,31,55,-24,21
CC Mariners,889,10,4,8,15,28,49,-21,20
Sydney FC,890,1,20,4,4,65,26,39,64
N'castle Jet,890,2,16,5,7,60,39,21,53
Melbourne V,890,3,14,5,10,49,39,10,47
Melbourne C,890,4,14,4,11,45,36,9,46
Adelaide Utd,890,5,11,6,11,37,40,-3,39
Brisbane,890,6,10,5,13,33,42,-9,35
Western Sydn,890,7,8,9,10,38,47,-9,33
Perth Glory,890,8,10,2,15,37,50,-13,32
Wellington P,890,9,5,6,16,31,55,-24,21
CC Mariners,890,10,4,8,15,28,49,-21,20
Sydney FC,891,1,20,4,4,64,26,38,64
N'castle Jet,891,2,16,5,7,59,38,21,53
Melbourne V,891,3,14,5,10,49,38,11,47
Melbourne C,891,4,14,4,11,44,35,9,46
Adelaide Utd,891,5,11,6,11,37,40,-3,39
Brisbane,891,6,10,5,13,33,42,-9,35
Western Sydn,891,7,8,9,10,38,47,-9,33
Perth Glory,891,8,10,2,15,37,50,-13,32
Wellington P,891,9,5,6,16,31,55,-24,21
CC Mariners,891,10,4,8,15,28,49,-21,20
Sydney FC,892,1,20,5,3,65,23,42,65
N'castle Jet,892,2,16,5,7,60,37,23,53
Melbourne C,892,3,14,4,11,43,36,7,46
Melbourne V,892,4,13,6,10,46,39,7,45
Adelaide Utd,892,5,11,6,11,37,40,-3,39
Brisbane,892,6,10,5,13,33,42,-9,35
Western Sydn,892,7,8,9,10,38,47,-9,33
Perth Glory,892,8,10,2,15,37,50,-13,32
Wellington P,892,9,5,6,16,31,55,-24,21
CC Mariners,892,10,4,8,15,28,49,-21,20
Sydney FC,893,1,20,5,3,67,25,42,65
N'castle Jet,893,2,15,6,7,59,39,20,51
Melbourne C,893,3,14,5,10,45,35,10,47
Melbourne V,893,4,13,6,10,48,41,7,45
Adelaide Utd,893,5,11,6,11,37,40,-3,39
Brisbane,893,6,10,5,13,33,42,-9,35
Western Sydn,893,7,8,9,10,38,47,-9,33
Perth Glory,893,8,10,2,15,37,50,-13,32
Wellington P,893,9,5,6,16,31,55,-24,21
CC Mariners,893,10,4,8,15,28,49,-21,20
Sydney FC,894,1,20,4,4,65,24,41,64
N'castle Jet,894,2,15,6,7,59,39,20,51
Melbourne C,894,3,14,5,10,45,35,10,47
Melbourne V,894,4,14,5,10,47,39,8,47
Adelaide Utd,894,5,11,6,11,37,40,-3,39
Brisbane,894,6,10,5,13,33,42,-9,35
Western Sydn,894,7,8,9,10,38,47,-9,33
Perth Glory,894,8,10,2,15,37,50,-13,32
Wellington P,894,9,5,6,16,31,55,-24,21
CC Mariners,894,10,4,8,15,28,49,-21,20
Sydney FC,895,1,21,4,3,65,22,43,67
N'castle Jet,895,2,16,5,7,60,38,22,53
Melbourne C,895,3,14,4,11,44,36,8,46
Melbourne V,895,4,13,5,11,45,39,6,44
Adelaide Utd,895,5,11,6,11,37,40,-3,39
Brisbane,895,6,10,5,13,33,42,-9,35
Western Sydn,895,7,8,9,10,38,47,-9,33
Perth Glory,895,8,10,2,15,37,50,-13,32
Wellington P,895,9,5,6,16,31,55,-24,21
CC Mariners,895,10,4,8,15,28,49,-21,20
Sydney FC,896,1,20,4,4,67,28,39,64
N'castle Jet,896,2,15,6,7,58,38,20,51
Melbourne V,896,3,14,5,10,51,41,10,47
Melbourne C,896,4,14,5,10,44,34,10,47
Adelaide Utd,896,5,11,6,11,37,40,-3,39
Brisbane,896,6,10,5,13,33,42,-9,35
Western Sydn,896,7,8,9,10,38,47,-9,33
Perth Glory,896,8,10,2,15,37,50,-13,32
Wellington P,896,9,5,6,16,31,55,-24,21
CC Mariners,896,10,4,8,15,28,49,-21,20
Sydney FC,897,1,20,4,4,65,24,41,64
N'castle Jet,897,2,16,5,7,60,38,22,53
Melbourne V,897,3,14,5,10,47,39,8,47
Melbourne C,897,4,14,4,11,44,36,8,46
Adelaide Utd,897,5,11,6,11,37,40,-3,39
Brisbane,897,6,10,5,13,33,42,-9,35
Western Sydn,897,7,8,9,10,38,47,-9,33
Perth Glory,897,8,10,2,15,37,50,-13,32
Wellington P,897,9,5,6,16,31,55,-24,21
CC Mariners,897,10,4,8,15,28,49,-21,20
Sydney FC,898,1,21,4,3,67,22,45,67
N'castle Jet,898,2,15,5,8,57,39,18,50
Melbourne C,898,3,15,4,10,45,33,12,49
Melbourne V,898,4,13,5,11,45,41,4,44
Adelaide Utd,898,5,11,6,11,37,40,-3,39
Brisbane,898,6,10,5,13,33,42,-9,35
Western Sydn,898,7,8,9,10,38,47,-9,33
Perth Glory,898,8,10,2,15,37,50,-13,32
Wellington P,898,9,5,6,16,31,55,-24,21
CC Mariners,898,10,4,8,15,28,49,-21,20
Sydney FC,899,1,21,4,3,68,22,46,67
N'castle Jet,899,2,15,6,7,59,39,20,51
Melbourne C,899,3,14,5,10,45,35,10,47
Melbourne V,899,4,13,5,11,45,42,3,44
Adelaide Utd,899,5,11,6,11,37,40,-3,39
Brisbane,899,6,10,5,13,33,42,-9,35
Western Sydn,899,7,8,9,10,38,47,-9,33
Perth Glory,899,8,10,2,15,37,50,-13,32
Wellington P,899,9,5,6,16,31,55,-24,21
CC Mariners,899,10,4,8,15,28,49,-21,20
Sydney FC,900,1,21,4,3,68,22,46,67
N'castle Jet,900,2,16,5,7,59,37,22,53
Melbourne C,900,3,14,4,11,43,35,8,46
Melbourne V,900,4,13,5,11,45,42,3,44
Adelaide Utd,900,5,11,6,11,37,40,-3,39
Brisbane,900,6,10,5,13,33,42,-9,35
Western Sydn,900,7,8,9,10,38,47,-9,33
Perth Glory,900,8,10,2,15,37,50,-13,32
Wellington P,900,9,5,6,16,31,55,-24,21
CC Mariners,900,10,4,8,15,28,49,-21,20
Sydney FC,901,1,21,4,3,65,22,43,67
N'castle Jet,901,2,16,5,7,61,38,23,53
Melbourne C,901,3,14,4,11,44,37,7,46
Melbourne V,901,4,13,5,11,45,39,6,44
Adelaide Utd,901,5,11,6,11,37,40,-3,39
Brisbane,901,6,10,5,13,33,42,-9,35
Western Sydn,901,7,8,9,10,38,47,-9,33
Perth Glory,901,8,10,2,15,37,50,-13,32
Wellington P,901,9,5,6,16,31,55,-24,21
CC Mariners,901,10,4,8,15,28,49,-21,20
Sydney FC,902,1,20,5,3,65,23,42,65
N'castle Jet,902,2,16,5,7,59,38,21,53
Melbourne C,902,3,14,4,11,44,35,9,46
Melbourne V,902,4,13,6,10,46,39,7,45
Adelaide Utd,902,5,11,6,11,37,40,-3,39
Brisbane,902,6,10,5,13,33,42,-9,35
Western Sydn,902,7,8,9,10,38,47,-9,33
Perth Glory,902,8,10,2,15,37,50,-13,32
Wellington P,902,9,5,6,16,31,55,-24,21
CC Mariners,902,10,4,8,15,28,49,-21,20
Sydney FC,903,1,21,4,3,67,23,44,67
N'castle Jet,903,2,16,5,7,58,37,21,53
Melbourne C,903,3,14,4,11,43,34,9,46
Melbourne V,903,4,13,5,11,46,41,5,44
Adelaide Utd,903,5,11,6,11,37,40,-3,39
Brisbane,903,6,10,5,13,33,42,-9,35
Western Sydn,903,7,8,9,10,38,47,-9,33
Perth Glory,903,8,10,2,15,37,50,-13,32
Wellington P,903,9,5,6,16,31,55,-24,21
CC Mariners,903,10,4,8,15,28,49,-21,20
Sydney FC,904,1,20,4,4,64,23,41,64
N'castle Jet,904,2,15,6,7,58,38,20,51
Melbourne C,904,3,14,5,10,44,34,10,47
Melbourne V,904,4,14,5,10,46,38,8,47
Adelaide Utd,904,5,11,6,11,37,40,-3,39
Brisbane,904,6,10,5,13,33,42,-9,35
Western Sydn,904,7,8,9,10,38,47,-9,33
Perth Glory,904,8,10,2,15,37,50,-13,32
Wellington P,904,9,5,6,16,31,55,-24,21
CC Mariners,904,10,4,8,15,28,49,-21,20
Sydney FC,905,1,21,4,3,69,22,47,67
N'castle Jet,905,2,16,5,7,59,38,21,53
Melbourne C,905,3,14,4,11,44,35,9,46
Melbourne V,905,4,13,5,11,45,43,2,44
Adelaide Utd,905,5,11,6,11,37,40,-3,39
Brisbane,905,6,10,5,13,33,42,-9,35
Western Sydn,905,7,8,9,10,38,47,-9,33
Perth Glory,905,8,10,2,15,37,50,-13,32
Wellington P,905,9,5,6,16,31,55,-24,21
CC Mariners,905,10,4,8,15,28,49,-21,20
Sydney FC,906,1,20,5,3,66,24,42,65
N'castle Jet,906,2,15,6,7,58,38,20,51
Melbourne C,906,3,14,5,10,44,34,10,47
Melbourne V,906,4,13,6,10,47,40,7,45
Adelaide Utd,906,5,11,6,11,37,40,-3,39
Brisbane,906,6,10,5,13,33,42,-9,35
Western Sydn,906,7,8,9,10,38,47,-9,33
Perth Glory,906,8,10,2,15,37,50,-13,32
Wellington P,906,9,5,6,16,31,55,-24,21
CC Mariners,906,10,4,8,15,28,49,-21,20
Sydney FC,907,1,21,4,3,69,22,47,67
N'castle Jet,907,2,16,5,7,59,37,22,53
Melbourne C,907,3,14,4,11,43,35,8,46
Melbourne V,907,4,13,5,11,45,43,2,44
Adelaide Utd,907,5,11,6,11,37,40,-3,39
Brisbane,907,6,10,5,13,33,42,-9,35
Western Sydn,907,7,8,9,10,38,47,-9,33
Perth Glory,907,8,10,2,15,37,50,-13,32
Wellington P,907,9,5,6,16,31,55,-24,21
CC Mariners,907,10,4,8,15,28,49,-21,20
Sydney FC,908,1,21,4,3,66,22,44,67
N'castle Jet,908,2,16,5,7,59,38,21,53
Melbourne C,908,3,14,4,11,44,35,9,46
Melbourne V,908,4,13,5,11,45,40,5,44
Adelaide Utd,908,5,11,6,11,37,40,-3,39
Brisbane,908,6,10,5,13,33,42,-9,35
Western Sydn,908,7,8,9,10,38,47,-9,33
Perth Glory,908,8,10,2,15,37,50,-13,32
Wellington P,908,9,5,6,16,31,55,-24,21
CC Mariners,908,10,4,8,15,28,49,-21,20
Sydney FC,909,1,21,4,3,66,22,44,67
N'castle Jet,909,2,15,6,7,58,38,20,51
Melbourne C,909,3,14,5,10,44,34,10,47
Melbourne V,909,4,13,5,11,45,40,5,44
Adelaide Utd,909,5,11,6,11,37,40,-3,39
Brisbane,909,6,10,5,13,33,42,-9,35
Western Sydn,909,7,8,9,10,38,47,-9,33
Perth Glory,909,8,10,2,15,37,50,-13,32
Wellington P,909,9,5,6,16,31,55,-24,21
CC Mariners,909,10,4,8,15,28,49,-21,20
Sydney FC,910,1,21,4,3,70,23,47,67
N'castle Jet,910,2,16,5,7,62,40,22,53
Melbourne C,910,3,14,4,11,46,38,8,46
Melbourne V,910,4,13,5,11,46,44,2,44
Adelaide Utd,910,5,11,6,11,37,40,-3,39
Brisbane,910,6,10,5,13,33,42,-9,35
Western Sydn,910,7,8,9,10,38,47,-9,33
Perth Glory,910,8,10,2,15,37,50,-13,32
Wellington P,910,9,5,6,16,31,55,-24,21
CC Mariners,910,10,4,8,15,28,49,-21,20
Sydney FC,911,1,21,4,3,69,22,47,67
N'castle Jet,911,2,15,5,8,58,39,19,50
Melbourne C,911,3,15,4,10,45,34,11,49
Melbourne V,911,4,13,5,11,45,43,2,44
Adelaide Utd,911,5,11,6,11,37,40,-3,39
Brisbane,911,6,10,5,13,33,42,-9,35
Western Sydn,911,7,8,9,10,38,47,-9,33
Perth Glory,911,8,10,2,15,37,50,-13,32
Wellington P,911,9,5,6,16,31,55,-24,21
CC Mariners,911,10,4,8,15,28,49,-21,20
Sydney FC,912,1,21,4,3,68,22,46,67
N'castle Jet,912,2,15,5,8,59,40,19,50
Melbourne C,912,3,15,4,10,46,35,11,49
Melbourne V,912,4,13,5,11,45,42,3,44
Adelaide Utd,912,5,11,6,11,37,40,-3,39
Brisbane,912,6,10,5,13,33,42,-9,35
Western Sydn,912,7,8,9,10,38,47,-9,33
Perth Glory,912,8,10,2,15,37,50,-13,32
Wellington P,912,9,5,6,16,31,55,-24,21
CC Mariners,912,10,4,8,15,28,49,-21,20
Sydney FC,913,1,20,4,4,64,23,41,64
N'castle Jet,913,2,15,5,8,58,40,18,50
Melbourne C,913,3,15,4,10,46,34,12,49
Melbourne V,913,4,14,5,10,46,38,8,47
Adelaide Utd,913,5,11,6,11,37,40,-3,39
Brisbane,913,6,10,5,13,33,42,-9,35
Western Sydn,913,7,8,9,10,38,47,-9,33
Perth Glory,913,8,10,2,15,37,50,-13,32
Wellington P,913,9,5,6,16,31,55,-24,21
CC Mariners,913,10,4,8,15,28,49,-21,20
Sydney FC,914,1,21,4,3,67,22,45,67
N'castle Jet,914,2,16,5,7,60,37,23,53
Melbourne C,914,3,14,4,11,43,36,7,46
Melbourne V,914,4,13,5,11,45,41,4,44
Adelaide Utd,914,5,11,6,11,37,40,-3,39
Brisbane,914,6,10,5,13,33,42,-9,35
Western Sydn,914,7,8,9,10,38,47,-9,33
Perth Glory,914,8,10,2,15,37,50,-13,32
Wellington P,914,9,5,6,16,31,55,-24,21
CC Mariners,914,10,4,8,15,28,49,-21,20
Sydney FC,915,1,21,4,3,68,23,45,67
N'castle Jet,915,2,16,5,7,60,37,23,53
Melbourne C,915,3,14,4,11,43,36,7,46
Melbourne V,915,4,13,5,11,46,42,4,44
Adelaide Utd,915,5,11,6,11,37,40,-3,39
Brisbane,915,6,10,5,13,33,42,-9,35
Western Sydn,915,7,8,9,10,38,47,-9,33
Perth Glory,915,8,10,2,15,37,50,-13,32
Wellington P,915,9,5,6,16,31,55,-24,21
CC Mariners,915,10,4,8,15,28,49,-21,20
Sydney FC,916,1,20,4,4,66,25,41,64
N'castle Jet,916,2,15,6,7,58,38,20,51
Melbourne C,916,3,14,5,10,44,34,10,47
Melbourne V,916,4,14,5,10,48,40,8,47
Adelaide Utd,916,5,11,6,11,37,40,-3,39
Brisbane,916,6,10,5,13,33,42,-9,35
Western Sydn,916,7,8,9,10,38,47,-9,33
Perth Glory,916,8,10,2,15,37,50,-13,32
Wellington P,916,9,5,6,16,31,55,-24,21
CC Mariners,916,10,4,8,15,28,49,-21,20
Sydney FC,917,1,20,5,3,66,24,42,65
N'castle Jet,917,2,15,5,8,59,40,19,50
Melbourne C,917,3,15,4,10,46,35,11,49
Melbourne V,917,4,13,6,10,47,40,7,45
Adelaide Utd,917,5,11,6,11,37,40,-3,39
Brisbane,917,6,10,5,13,33,42,-9,35
Western Sydn,917,7,8,9,10,38,47,-9,33
Perth Glory,917,8,10,2,15,37,50,-13,32
Wellington P,917,9,5,6,16,31,55,-24,21
CC Mariners,917,10,4,8,15,28,49,-21,20
Sydney FC,918,1,21,4,3,67,22,45,67
N'castle Jet,918,2,16,5,7,60,38,22,53
Melbourne C,918,3,14,4,11,44,36,8,46
Melbourne V,918,4,13,5,11,45,41,4,44
Adelaide Utd,918,5,11,6,11,37,40,-3,39
Brisbane,918,6,10,5,13,33,42,-9,35
Western Sydn,918,7,8,9,10,38,47,-9,33
Perth Glory,918,8,10,2,15,37,50,-13,32
Wellington P,918,9,5,6,16,31,55,-24,21
CC Mariners,918,10,4,8,15,28,49,-21,20
Sydney FC,919,1,21,4,3,66,22,44,67
N'castle Jet,919,2,15,6,7,58,38,20,51
Melbourne C,919,3,14,5,10,44,34,10,47
Melbourne V,919,4,13,5,11,45,40,5,44
Adelaide Utd,919,5,11,6,11,37,40,-3,39
Brisbane,919,6,10,5,13,33,42,-9,35
Western Sydn,919,7,8,9,10,38,47,-9,33
Perth Glory,919,8,10,2,15,37,50,-13,32
Wellington P,919,9,5,6,16,31,55,-24,21
CC Mariners,919,10,4,8,15,28,49,-21,20
Sydney FC,920,1,21,4,3,68,23,45,67
N'castle Jet,920,2,16,5,7,60,39,21,53
Melbourne C,920,3,14,4,11,45,36,9,46
Melbourne V,920,4,13,5,11,46,42,4,44
Adelaide Utd,920,5,11,6,11,37,40,-3,39
Brisbane,920,6,10,5,13,33,42,-9,35
Western Sydn,920,7,8,9,10,38,47,-9,33
Perth Glory,920,8,10,2,15,37,50,-13,32
Wellington P,920,9,5,6,16,31,55,-24,21
CC Mariners,920,10,4,8,15,28,49,-21,20
Sydney FC,921,1,20,4,4,65,25,40,64
N'castle Jet,921,2,15,5,8,58,41,17,50
Melbourne C,921,3,15,4,10,47,34,13,49
Melbourne V,921,4,14,5,10,48,39,9,47
Adelaide Utd,921,5,11,6,11,37,40,-3,39
Brisbane,921,6,10,5,13,33,42,-9,35
Western Sydn,921,7,8,9,10,38,47,-9,33
Perth Glory,921,8,10,2,15,37,50,-13,32
Wellington P,921,9,5,6,16,31,55,-24,21
CC Mariners,921,10,4,8,15,28,49,-21,20
Sydney FC,922,1,21,4,3,65,22,43,67
N'castle Jet,922,2,15,5,8,58,39,19,50
Melbourne C,922,3,15,4,10,45,34,11,49
Melbourne V,922,4,13,5,11,45,39,6,44
Adelaide Utd,922,5,11,6,11,37,40,-3,39
Brisbane,922,6,10,5,13,33,42,-9,35
Western Sydn,922,7,8,9,10,38,47,-9,33
Perth Glory,922,8,10,2,15,37,50,-13,32
Wellington P,922,9,5,6,16,31,55,-24,21
CC Mariners,922,10,4,8,15,28,49,-21,20
Sydney FC,923,1,21,4,3,66,23,43,67
N'castle Jet,923,2,16,5,7,61,38,23,53
Melbourne C,923,3,14,4,11,44,37,7,46
Melbourne V,923,4,13,5,11,46,40,6,44
Adelaide Utd,923,5,11,6,11,37,40,-3,39
Brisbane,923,6,10,5,13,33,42,-9,35
Western Sydn,923,7,8,9,10,38,47,-9,33
Perth Glory,923,8,10,2,15,37,50,-13,32
Wellington P,923,9,5,6,16,31,55,-24,21
CC Mariners,923,10,4,8,15,28,49,-21,20
Sydney FC,924,1,21,4,3,68,22,46,67
N'castle Jet,924,2,16,5,7,58,37,21,53
Melbourne C,924,3,14,4,11,43,34,9,46
Melbourne V,924,4,13,5,11,45,42,3,44
Adelaide Utd,924,5,11,6,11,37,40,-3,39
Brisbane,924,6,10,5,13,33,42,-9,35
Western Sydn,924,7,8,9,10,38,47,-9,33
Perth Glory,924,8,10,2,15,37,50,-13,32
Wellington P,924,9,5,6,16,31,55,-24,21
CC Mariners,924,10,4,8,15,28,49,-21,20
Sydney FC,925,1,21,4,3,66,23,43,67
N'castle Jet,925,2,16,5,7,60,38,22,53
Melbourne C,925,3,14,4,11,44,36,8,46
Melbourne V,925,4,13,5,11,46,40,6,44
Adelaide Utd,925,5,11,6,11,37,40,-3,39
Brisbane,925,6,10,5,13,33,42,-9,35
Western Sydn,925,7,8,9,10,38,47,-9,33
Perth Glory,925,8,10,2,15,37,50,-13,32
Wellington P,925,9,5,6,16,31,55,-24,21
CC Mariners,925,10,4,8,15,28,49,-21,20
Sydney FC,926,1,20,5,3,64,22,42,65
N'castle Jet,926,2,16,5,7,60,37,23,53
Melbourne C,926,3,14,4,11,43,36,7,46
Melbourne V,926,4,13,6,10,45,38,7,45
Adelaide Utd,926,5,11,6,11,37,40,-3,39
Brisbane,926,6,10,5,13,33,42,-9,35
Western Sydn,926,7,8,9,10,38,47,-9,33
Perth Glory,926,8,10,2,15,37,50,-13,32
Wellington P,926,9,5,6,16,31,55,-24,21
CC Mariners,926,10,4,8,15,28,49,-21,20
Sydney FC,927,1,21,4,3,66,23,43,67
N'castle Jet,927,2,16,5,7,60,37,23,53
Melbourne C,927,3,14,4,11,43,36,7,46
Melbourne V,927,4,13,5,11,46,40,6,44
Adelaide Utd,927,5,11,6,11,37,40,-3,39
Brisbane,927,6,10,5,13,33,42,-9,35
Western Sydn,927,7,8,9,10,38,47,-9,33
Perth Glory,927,8,10,2,15,37,50,-13,32
Wellington P,927,9,5,6,16,31,55,-24,21
CC Mariners,927,10,4,8,15,28,49,-21,20
Sydney FC,928,1,21,4,3,67,23,44,67
N'castle Jet,928,2,16,5,7,58,37,21,53
Melbourne C,928,3,14,4,11,43,34,9,46
Melbourne V,928,4,13,5,11,46,41,5,44
Adelaide Utd,928,5,11,6,11,37,40,-3,39
Brisbane,928,6,10,5,13,33,42,-9,35
Western Sydn,928,7,8,9,10,38,47,-9,33
Perth Glory,928,8,10,2,15,37,50,-13,32
Wellington P,928,9,5,6,16,31,55,-24,21
CC Mariners,928,10,4,8,15,28,49,-21,20
Sydney FC,929,1,21,4,3,67,24,43,67
N'castle Jet,929,2,16,5,7,61,40,21,53
Melbourne C,929,3,14,4,11,46,37,9,46
Melbourne V,929,4,13,5,11,47,41,6,44
Adelaide Utd,929,5,11,6,11,37,40,-3,39
Brisbane,929,6,10,5,13,33,42,-9,35
Western Sydn,929,7,8,9,10,38,47,-9,33
Perth Glory,929,8,10,2,15,37,50,-13,32
Wellington P,929,9,5,6,16,31,55,-24,21
CC Mariners,929,10,4,8,15,28,49,-21,20
Sydney FC,930,1,21,4,3,67,24,43,67
N'castle Jet,930,2,15,6,7,59,39,20,51
Melbourne C,930,3,14,5,10,45,35,10,47
Melbourne V,930,4,13,5,11,47,41,6,44
Adelaide Utd,930,5,11,6,11,37,40,-3,39
Brisbane,930,6,10,5,13,33,42,-9,35
Western Sydn,930,7,8,9,10,38,47,-9,33
Perth Glory,930,8,10,2,15,37,50,-13,32
Wellington P,930,9,5,6,16,31,55,-24,21
CC Mariners,930,10,4,8,15,28,49,-21,20
Sydney FC,931,1,21,4,3,69,23,46,67
N'castle Jet,931,2,15,5,8,58,39,19,50
Melbourne C,931,3,15,4,10,45,34,11,49
Melbourne V,931,4,13,5,11,46,43,3,44
Adelaide Utd,931,5,11,6,11,37,40,-3,39
Brisbane,931,6,10,5,13,33,42,-9,35
Western Sydn,931,7,8,9,10,38,47,-9,33
Perth Glory,931,8,10,2,15,37,50,-13,32
Wellington P,931,9,5,6,16,31,55,-24,21
CC Mariners,931,10,4,8,15,28,49,-21,20
Sydney FC,932,1,20,5,3,65,23,42,65
N'castle Jet,932,2,16,5,7,59,38,21,53
Melbourne C,932,3,14,4,11,44,35,9,46
Melbourne V,932,4,13,6,10,46,39,7,45
Adelaide Utd,932,5,11,6,11,37,40,-3,39
Brisbane,932,6,10,5,13,33,42,-9,35
Western Sydn,932,7,8,9,10,38,47,-9,33
Perth Glory,932,8,10,2,15,37,50,-13,32
Wellington P,932,9,5,6,16,31,55,-24,21
CC Mariners,932,10,4,8,15,28,49,-21,20
Sydney FC,933,1,21,4,3,66,22,44,67
N'castle Jet,933,2,16,5,7,60,38,22,53
Melbourne C,933,3,14,4,11,44,36,8,46
Melbourne V,933,4,13,5,11,45,40,5,44
Adelaide Utd,933,5,11,6,11,37,40,-3,39
Brisbane,933,6,10,5,13,33,42,-9,35
Western Sydn,933,7,8,9,10,38,47,-9,33
Perth Glory,933,8,10,2,15,37,50,-13,32
Wellington P,933,9,5,6,16,31,55,-24,21
CC Mariners,933,10,4,8,15,28,49,-21,20
Sydney FC,934,1,20,5,3,65,23,42,65
N'castle Jet,934,2,16,5,7,60,38,22,53
Melbourne C,934,3,14,4,11,44,36,8,46
Melbourne V,934,4,13,6,10,46,39,7,45
Adelaide Utd,934,5,11,6,11,37,40,-3,39
Brisbane,934,6,10,5,13,33,42,-9,35
Western Sydn,934,7,8,9,10,38,47,-9,33
Perth Glory,934,8,10,2,15,37,50,-13,32
Wellington P,934,9,5,6,16,31,55,-24,21
CC Mariners,934,10,4,8,15,28,49,-21,20
Sydney FC,935,1,21,4,3,67,23,44,67
N'castle Jet,935,2,15,6,7,58,38,20,51
Melbourne C,935,3,14,5,10,44,34,10,47
Melbourne V,935,4,13,5,11,46,41,5,44
Adelaide Utd,935,5,11,6,11,37,40,-3,39
Brisbane,935,6,10,5,13,33,42,-9,35
Western Sydn,935,7,8,9,10,38,47,-9,33
Perth Glory,935,8,10,2,15,37,50,-13,32
Wellington P,935,9,5,6,16,31,55,-24,21
CC Mariners,935,10,4,8,15,28,49,-21,20
Sydney FC,936,1,21,4,3,71,24,47,67
N'castle Jet,936,2,16,5,7,59,37,22,53
Melbourne C,936,3,14,4,11,43,35,8,46
Melbourne V,936,4,13,5,11,47,45,2,44
Adelaide Utd,936,5,11,6,11,37,40,-3,39
Brisbane,936,6,10,5,13,33,42,-9,35
Western Sydn,936,7,8,9,10,38,47,-9,33
Perth Glory,936,8,10,2,15,37,50,-13,32
Wellington P,936,9,5,6,16,31,55,-24,21
CC Mariners,936,10,4,8,15,28,49,-21,20
Sydney FC,937,1,21,4,3,66,22,44,67
N'castle Jet,937,2,16,5,7,61,39,22,53
Melbourne C,937,3,14,4,11,45,37,8,46
Melbourne V,937,4,13,5,11,45,40,5,44
Adelaide Utd,937,5,11,6,11,37,40,-3,39
Brisbane,937,6,10,5,13,33,42,-9,35
Western Sydn,937,7,8,9,10,38,47,-9,33
Perth Glory,937,8,10,2,15,37,50,-13,32
Wellington P,937,9,5,6,16,31,55,-24,21
CC Mariners,937,10,4,8,15,28,49,-21,20
Sydney FC,938,1,21,4,3,67,22,45,67
N'castle Jet,938,2,15,5,8,58,40,18,50
Melbourne C,938,3,15,4,10,46,34,12,49
Melbourne V,938,4,13,5,11,45,41,4,44
Adelaide Utd,938,5,11,6,11,37,40,-3,39
Brisbane,938,6,10,5,13,33,42,-9,35
Western Sydn,938,7,8,9,10,38,47,-9,33
Perth Glory,938,8,10,2,15,37,50,-13,32
Wellington P,938,9,5,6,16,31,55,-24,21
CC Mariners,938,10,4,8,15,28,49,-21,20
Sydney FC,939,1,21,4,3,68,24,44,67
N'castle Jet,939,2,15,5,8,57,38,19,50
Melbourne C,939,3,15,4,10,44,33,11,49
Melbourne V,939,4,13,5,11,47,42,5,44
Adelaide Utd,939,5,11,6,11,37,40,-3,39
Brisbane,939,6,10,5,13,33,42,-9,35
Western Sydn,939,7,8,9,10,38,47,-9,33
Perth Glory,939,8,10,2,15,37,50,-13,32
Wellington P,939,9,5,6,16,31,55,-24,21
CC Mariners,939,10,4,8,15,28,49,-21,20
Sydney FC,940,1,21,4,3,68,24,44,67
N'castle Jet,940,2,16,5,7,58,37,21,53
Melbourne C,940,3,14,4,11,43,34,9,46
Melbourne V,940,4,13,5,11,47,42,5,44
Adelaide Utd,940,5,11,6,11,37,40,-3,39
Brisbane,940,6,10,5,13,33,42,-9,35
Western Sydn,940,7,8,9,10,38,47,-9,33
Perth Glory,940,8,10,2,15,37,50,-13,32
Wellington P,940,9,5,6,16,31,55,-24,21
CC Mariners,940,10,4,8,15,28,49,-21,20
Sydney FC,941,1,20,5,3,65,23,42,65
N'castle Jet,941,2,16,5,7,60,38,22,53
Melbourne C,941,3,14,4,11,44,36,8,46
Melbourne V,941,4,13,6,10,46,39,7,45
Adelaide Utd,941,5,11,6,11,37,40,-3,39
Brisbane,941,6,10,5,13,33,42,-9,35
Western Sydn,941,7,8,9,10,38,47,-9,33
Perth Glory,941,8,10,2,15,37,50,-13,32
Wellington P,941,9,5,6,16,31,55,-24,21
CC Mariners,941,10,4,8,15,28,49,-21,20
Sydney FC,942,1,21,4,3,69,22,47,67
N'castle Jet,942,2,16,5,7,60,37,23,53
Melbourne C,942,3,14,4,11,43,36,7,46
Melbourne V,942,4,13,5,11,45,43,2,44
Adelaide Utd,942,5,11,6,11,37,40,-3,39
Brisbane,942,6,10,5,13,33,42,-9,35
Western Sydn,942,7,8,9,10,38,47,-9,33
Perth Glory,942,8,10,2,15,37,50,-13,32
Wellington P,942,9,5,6,16,31,55,-24,21
CC Mariners,942,10,4,8,15,28,49,-21,20
Sydney FC,943,1,21,4,3,67,24,43,67
N'castle Jet,943,2,15,5,8,57,38,19,50
Melbourne C,943,3,15,4,10,44,33,11,49
Melbourne V,943,4,13,5,11,47,41,6,44
Adelaide Utd,943,5,11,6,11,37,40,-3,39
Brisbane,943,6,10,5,13,33,42,-9,35
Western Sydn,943,7,8,9,10,38,47,-9,33
Perth Glory,943,8,10,2,15,37,50,-13,32
Wellington P,943,9,5,6,16,31,55,-24,21
CC Mariners,943,10,4,8,15,28,49,-21,20
Sydney FC,944,1,21,4,3,69,24,45,67
N'castle Jet,944,2,16,5,7,61,39,22,53
Melbourne C,944,3,14,4,11,45,37,8,46
Melbourne V,944,4,13,5,11,47,43,4,44
Adelaide Utd,944,5,11,6,11,37,40,-3,39
Brisbane,944,6,10,5,13,33,42,-9,35
Western Sydn,944,7,8,9,10,38,47,-9,33
Perth Glory,944,8,10,2,15,37,50,-13,32
Wellington P,944,9,5,6,16,31,55,-24,21
CC Mariners,944,10,4,8,15,28,49,-21,20
Sydney FC,945,1,20,5,3,65,23,42,65
N'castle Jet,945,2,16,5,7,62,37,25,53
Melbourne C,945,3,14,4,11,43,38,5,46
Melbourne V,945,4,13,6,10,46,39,7,45
Adelaide Utd,945,5,11,6,11,37,40,-3,39
Brisbane,945,6,10,5,13,33,42,-9,35
Western Sydn,945,7,8,9,10,38,47,-9,33
Perth Glory,945,8,10,2,15,37,50,-13,32
Wellington P,945,9,5,6,16,31,55,-24,21
CC Mariners,945,10,4,8,15,28,49,-21,20
Sydney FC,946,1,21,4,3,67,23,44,67
N'castle Jet,946,2,15,6,7,58,38,20,51
Melbourne C,946,3,14,5,10,44,34,10,47
Melbourne V,946,4,13,5,11,46,41,5,44
Adelaide Utd,946,5,11,6,11,37,40,-3,39
Brisbane,946,6,10,5,13,33,42,-9,35
Western Sydn,946,7,8,9,10,38,47,-9,33
Perth Glory,946,8,10,2,15,37,50,-13,32
Wellington P,946,9,5,6,16,31,55,-24,21
CC Mariners,946,10,4,8,15,28,49,-21,20
Sydney FC,947,1,21,4,3,67,23,44,67
N'castle Jet,947,2,15,5,8,57,38,19,50
Melbourne C,947,3,15,4,10,44,33,11,49
Melbourne V,947,4,13,5,11,46,41,5,44
Adelaide Utd,947,5,11,6,11,37,40,-3,39
Brisbane,947,6,10,5,13,33,42,-9,35
Western Sydn,947,7,8,9,10,38,47,-9,33
Perth Glory,947,8,10,2,15,37,50,-13,32
Wellington P,947,9,5,6,16,31,55,-24,21
CC Mariners,947,10,4,8,15,28,49,-21,20
Sydney FC,948,1,21,4,3,68,24,44,67
N'castle Jet,948,2,16,5,7,60,38,22,53
Melbourne C,948,3,14,4,11,44,36,8,46
Melbourne V,948,4,13,5,11,47,42,5,44
Adelaide Utd,948,5,11,6,11,37,40,-3,39
Brisbane,948,6,10,5,13,33,42,-9,35
Western Sydn,948,7,8,9,10,38,47,-9,33
Perth Glory,948,8,10,2,15,37,50,-13,32
Wellington P,948,9,5,6,16,31,55,-24,21
CC Mariners,948,10,4,8,15,28,49,-21,20
Sydney FC,949,1,20,4,4,64,24,40,64
N'castle Jet,949,2,16,5,7,58,37,21,53
Melbourne V,949,3,14,5,10,47,38,9,47
Melbourne C,949,4,14,4,11,43,34,9,46
Adelaide Utd,949,5,11,6,11,37,40,-3,39
Brisbane,949,6,10,5,13,33,42,-9,35
Western Sydn,949,7,8,9,10,38,47,-9,33
Perth Glory,949,8,10,2,15,37,50,-13,32
Wellington P,949,9,5,6,16,31,55,-24,21
CC Mariners,949,10,4,8,15,28,49,-21,20
Sydney FC,950,1,20,5,3,66,24,42,65
N'castle Jet,950,2,15,5,8,57,38,19,50
Melbourne C,950,3,15,4,10,44,33,11,49
Melbourne V,950,4,13,6,10,47,40,7,45
Adelaide Utd,950,5,11,6,11,37,40,-3,39
Brisbane,950,6,10,5,13,33,42,-9,35
Western Sydn,950,7,8,9,10,38,47,-9,33
Perth Glory,950,8,10,2,15,37,50,-13,32
Wellington P,950,9,5,6,16,31,55,-24,21
CC Mariners,950,10,4,8,15,28,49,-21,20
Sydney FC,951,1,20,5,3,65,23,42,65
N'castle Jet,951,2,16,5,7,63,37,26,53
Melbourne C,951,3,14,4,11,43,39,4,46
Melbourne V,951,4,13,6,10,46,39,7,45
Adelaide Utd,951,5,11,6,11,37,40,-3,39
Brisbane,951,6,10,5,13,33,42,-9,35
Western Sydn,951,7,8,9,10,38,47,-9,33
Perth Glory,951,8,10,2,15,37,50,-13,32
Wellington P,951,9,5,6,16,31,55,-24,21
CC Mariners,951,10,4,8,15,28,49,-21,20
Sydney FC,952,1,20,4,4,66,25,41,64
N'castle Jet,952,2,16,5,7,59,37,22,53
Melbourne V,952,3,14,5,10,48,40,8,47
Melbourne C,952,4,14,4,11,43,35,8,46
Adelaide Utd,952,5,11,6,11,37,40,-3,39
Brisbane,952,6,10,5,13,33,42,-9,35
Western Sydn,952,7,8,9,10,38,47,-9,33
Perth Glory,952,8,10,2,15,37,50,-13,32
Wellington P,952,9,5,6,16,31,55,-24,21
CC Mariners,952,10,4,8,15,28,49,-21,20
Sydney FC,953,1,21,4,3,66,22,44,67
N'castle Jet,953,2,16,5,7,61,39,22,53
Melbourne C,953,3,14,4,11,45,37,8,46
Melbourne V,953,4,13,5,11,45,40,5,44
Adelaide Utd,953,5,11,6,11,37,40,-3,39
Brisbane,953,6,10,5,13,33,42,-9,35
Western Sydn,953,7,8,9,10,38,47,-9,33
Perth Glory,953,8,10,2,15,37,50,-13,32
Wellington P,953,9,5,6,16,31,55,-24,21
CC Mariners,953,10,4,8,15,28,49,-21,20
Sydney FC,954,1,20,4,4,64,23,41,64
N'castle Jet,954,2,15,5,8,58,40,18,50
Melbourne C,954,3,15,4,10,46,34,12,49
Melbourne V,954,4,14,5,10,46,38,8,47
Adelaide Utd,954,5,11,6,11,37,40,-3,39
Brisbane,954,6,10,5,13,33,42,-9,35
Western Sydn,954,7,8,9,10,38,47,-9,33
Perth Glory,954,8,10,2,15,37,50,-13,32
Wellington P,954,9,5,6,16,31,55,-24,21
CC Mariners,954,10,4,8,15,28,49,-21,20
Sydney FC,955,1,21,4,3,66,22,44,67
N'castle Jet,955,2,15,5,8,58,39,19,50
Melbourne C,955,3,15,4,10,45,34,11,49
Melbourne V,955,4,13,5,11,45,40,5,44
Adelaide Utd,955,5,11,6,11,37,40,-3,39
Brisbane,955,6,10,5,13,33,42,-9,35
Western Sydn,955,7,8,9,10,38,47,-9,33
Perth Glory,955,8,10,2,15,37,50,-13,32
Wellington P,955,9,5,6,16,31,55,-24,21
CC Mariners,955,10,4,8,15,28,49,-21,20
Sydney FC,956,1,20,4,4,65,25,40,64
N'castle Jet,956,2,16,5,7,60,38,22,53
Melbourne V,956,3,14,5,10,48,39,9,47
Melbourne C,956,4,14,4,11,44,36,8,46
Adelaide Utd,956,5,11,6,11,37,40,-3,39
Brisbane,956,6,10,5,13,33,42,-9,35
Western Sydn,956,7,8,9,10,38,47,-9,33
Perth Glory,956,8,10,2,15,37,50,-13,32
Wellington P,956,9,5,6,16,31,55,-24,21
CC Mariners,956,10,4,8,15,28,49,-21,20
Sydney FC,957,1,20,5,3,65,23,42,65
N'castle Jet,957,2,16,5,7,60,39,21,53
Melbourne C,957,3,14,4,11,45,36,9,46
Melbourne V,957,4,13,6,10,46,39,7,45
Adelaide Utd,957,5,11,6,11,37,40,-3,39
Brisbane,957,6,10,5,13,33,42,-9,35
Western Sydn,957,7,8,9,10,38,47,-9,33
Perth Glory,957,8,10,2,15,37,50,-13,32
Wellington P,957,9,5,6,16,31,55,-24,21
CC Mariners,957,10,4,8,15,28,49,-21,20
Sydney FC,958,1,20,4,4,64,24,40,64
N'castle Jet,958,2,16,5,7,60,38,22,53
Melbourne V,958,3,14,5,10,47,38,9,47
Melbourne C,958,4,14,4,11,44,36,8,46
Adelaide Utd,958,5,11,6,11,37,40,-3,39
Brisbane,958,6,10,5,13,33,42,-9,35
Western Sydn,958,7,8,9,10,38,47,-9,33
Perth Glory,958,8,10,2,15,37,50,-13,32
Wellington P,958,9,5,6,16,31,55,-24,21
CC Mariners,958,10,4,8,15,28,49,-21,20
Sydney FC,959,1,21,4,3,66,23,43,67
N'castle Jet,959,2,15,6,7,60,40,20,51
Melbourne C,959,3,14,5,10,46,36,10,47
Melbourne V,959,4,13,5,11,46,40,6,44
Adelaide Utd,959,5,11,6,11,37,40,-3,39
Brisbane,959,6,10,5,13,33,42,-9,35
Western Sydn,959,7,8,9,10,38,47,-9,33
Perth Glory,959,8,10,2,15,37,50,-13,32
Wellington P,959,9,5,6,16,31,55,-24,21
CC Mariners,959,10,4,8,15,28,49,-21,20
Sydney FC,960,1,21,4,3,67,23,44,67
N'castle Jet,960,2,15,5,8,58,39,19,50
Melbourne C,960,3,15,4,10,45,34,11,49
Melbourne V,960,4,13,5,11,46,41,5,44
Adelaide Utd,960,5,11,6,11,37,40,-3,39
Brisbane,960,6,10,5,13,33,42,-9,35
Western Sydn,960,7,8,9,10,38,47,-9,33
Perth Glory,960,8,10,2,15,37,50,-13,32
Wellington P,960,9,5,6,16,31,55,-24,21
CC Mariners,960,10,4,8,15,28,49,-21,20
Sydney FC,961,1,20,5,3,65,23,42,65
N'castle Jet,961,2,16,5,7,59,37,22,53
Melbourne C,961,3,14,4,11,43,35,8,46
Melbourne V,961,4,13,6,10,46,39,7,45
Adelaide Utd,961,5,11,6,11,37,40,-3,39
Brisbane,961,6,10,5,13,33,42,-9,35
Western Sydn,961,7,8,9,10,38,47,-9,33
Perth Glory,961,8,10,2,15,37,50,-13,32
Wellington P,961,9,5,6,16,31,55,-24,21
CC Mariners,961,10,4,8,15,28,49,-21,20
Sydney FC,962,1,21,4,3,67,22,45,67
N'castle Jet,962,2,16,5,7,60,39,21,53
Melbourne C,962,3,14,4,11,45,36,9,46
Melbourne V,962,4,13,5,11,45,41,4,44
Adelaide Utd,962,5,11,6,11,37,40,-3,39
Brisbane,962,6,10,5,13,33,42,-9,35
Western Sydn,962,7,8,9,10,38,47,-9,33
Perth Glory,962,8,10,2,15,37,50,-13,32
Wellington P,962,9,5,6,16,31,55,-24,21
CC Mariners,962,10,4,8,15,28,49,-21,20
Sydney FC,963,1,20,4,4,65,24,41,64
N'castle Jet,963,2,15,6,7,58,38,20,51
Melbourne C,963,3,14,5,10,44,34,10,47
Melbourne V,963,4,14,5,10,47,39,8,47
Adelaide Utd,963,5,11,6,11,37,40,-3,39
Brisbane,963,6,10,5,13,33,42,-9,35
Western Sydn,963,7,8,9,10,38,47,-9,33
Perth Glory,963,8,10,2,15,37,50,-13,32
Wellington P,963,9,5,6,16,31,55,-24,21
CC Mariners,963,10,4,8,15,28,49,-21,20
Sydney FC,964,1,20,4,4,66,25,41,64
N'castle Jet,964,2,16,5,7,59,38,21,53
Melbourne V,964,3,14,5,10,48,40,8,47
Melbourne C,964,4,14,4,11,44,35,9,46
Adelaide Utd,964,5,11,6,11,37,40,-3,39
Brisbane,964,6,10,5,13,33,42,-9,35
Western Sydn,964,7,8,9,10,38,47,-9,33
Perth Glory,964,8,10,2,15,37,50,-13,32
Wellington P,964,9,5,6,16,31,55,-24,21
CC Mariners,964,10,4,8,15,28,49,-21,20
Sydney FC,965,1,21,4,3,65,22,43,67
N'castle Jet,965,2,16,5,7,59,38,21,53
Melbourne C,965,3,14,4,11,44,35,9,46
Melbourne V,965,4,13,5,11,45,39,6,44
Adelaide Utd,965,5,11,6,11,37,40,-3,39
Brisbane,965,6,10,5,13,33,42,-9,35
Western Sydn,965,7,8,9,10,38,47,-9,33
Perth Glory,965,8,10,2,15,37,50,-13,32
Wellington P,965,9,5,6,16,31,55,-24,21
CC Mariners,965,10,4,8,15,28,49,-21,20
Sydney FC,966,1,20,4,4,65,25,40,64
N'castle Jet,966,2,16,5,7,58,37,21,53
Melbourne V,966,3,14,5,10,48,39,9,47
Melbourne C,966,4,14,4,11,43,34,9,46
Adelaide Utd,966,5,11,6,11,37,40,-3,39
Brisbane,966,6,10,5,13,33,42,-9,35
Western Sydn,966,7,8,9,10,38,47,-9,33
Perth Glory,966,8,10,2,15,37,50,-13,32
Wellington P,966,9,5,6,16,31,55,-24,21
CC Mariners,966,10,4,8,15,28,49,-21,20
Sydney FC,967,1,20,5,3,66,24,42,65
N'castle Jet,967,2,15,5,8,57,38,19,50
Melbourne C,967,3,15,4,10,44,33,11,49
Melbourne V,967,4,13,6,10,47,40,7,45
Adelaide Utd,967,5,11,6,11,37,40,-3,39
Brisbane,967,6,10,5,13,33,42,-9,35
Western Sydn,967,7,8,9,10,38,47,-9,33
Perth Glory,967,8,10,2,15,37,50,-13,32
Wellington P,967,9,5,6,16,31,55,-24,21
CC Mariners,967,10,4,8,15,28,49,-21,20
Sydney FC,968,1,20,5,3,66,24,42,65
N'castle Jet,968,2,15,5,8,57,38,19,50
Melbourne C,968,3,15,4,10,44,33,11,49
Melbourne V,968,4,13,6,10,47,40,7,45
Adelaide Utd,968,5,11,6,11,37,40,-3,39
Brisbane,968,6,10,5,13,33,42,-9,35
Western Sydn,968,7,8,9,10,38,47,-9,33
Perth Glory,968,8,10,2,15,37,50,-13,32
Wellington P,968,9,5,6,16,31,55,-24,21
CC Mariners,968,10,4,8,15,28,49,-21,20
Sydney FC,969,1,21,4,3,68,22,46,67
N'castle Jet,969,2,16,5,7,58,37,21,53
Melbourne C,969,3,14,4,11,43,34,9,46
Melbourne V,969,4,13,5,11,45,42,3,44
Adelaide Utd,969,5,11,6,11,37,40,-3,39
Brisbane,969,6,10,5,13,33,42,-9,35
Western Sydn,969,7,8,9,10,38,47,-9,33
Perth Glory,969,8,10,2,15,37,50,-13,32
Wellington P,969,9,5,6,16,31,55,-24,21
CC Mariners,969,10,4,8,15,28,49,-21,20
Sydney FC,970,1,20,5,3,64,22,42,65
N'castle Jet,970,2,15,6,7,61,41,20,51
Melbourne C,970,3,14,5,10,47,37,10,47
Melbourne V,970,4,13,6,10,45,38,7,45
Adelaide Utd,970,5,11,6,11,37,40,-3,39
Brisbane,970,6,10,5,13,33,42,-9,35
Western Sydn,970,7,8,9,10,38,47,-9,33
Perth Glory,970,8,10,2,15,37,50,-13,32
Wellington P,970,9,5,6,16,31,55,-24,21
CC Mariners,970,10,4,8,15,28,49,-21,20
Sydney FC,971,1,21,4,3,65,22,43,67
N'castle Jet,971,2,16,5,7,59,38,21,53
Melbourne C,971,3,14,4,11,44,35,9,46
Melbourne V,971,4,13,5,11,45,39,6,44
Adelaide Utd,971,5,11,6,11,37,40,-3,39
Brisbane,971,6,10,5,13,33,42,-9,35
Western Sydn,971,7,8,9,10,38,47,-9,33
Perth Glory,971,8,10,2,15,37,50,-13,32
Wellington P,971,9,5,6,16,31,55,-24,21
CC Mariners,971,10,4,8,15,28,49,-21,20
Sydney FC,972,1,21,4,3,67,23,44,67
N'castle Jet,972,2,15,6,7,61,41,20,51
Melbourne C,972,3,14,5,10,47,37,10,47
Melbourne V,972,4,13,5,11,46,41,5,44
Adelaide Utd,972,5,11,6,11,37,40,-3,39
Brisbane,972,6,10,5,13,33,42,-9,35
Western Sydn,972,7,8,9,10,38,47,-9,33
Perth Glory,972,8,10,2,15,37,50,-13,32
Wellington P,972,9,5,6,16,31,55,-24,21
CC Mariners,972,10,4,8,15,28,49,-21,20
Sydney FC,973,1,20,4,4,66,25,41,64
N'castle Jet,973,2,16,5,7,60,37,23,53
Melbourne V,973,3,14,5,10,48,40,8,47
Melbourne C,973,4,14,4,11,43,36,7,46
Adelaide Utd,973,5,11,6,11,37,40,-3,39
Brisbane,973,6,10,5,13,33,42,-9,35
Western Sydn,973,7,8,9,10,38,47,-9,33
Perth Glory,973,8,10,2,15,37,50,-13,32
Wellington P,973,9,5,6,16,31,55,-24,21
CC Mariners,973,10,4,8,15,28,49,-21,20
Sydney FC,974,1,21,4,3,67,22,45,67
N'castle Jet,974,2,16,5,7,61,37,24,53
Melbourne C,974,3,14,4,11,43,37,6,46
Melbourne V,974,4,13,5,11,45,41,4,44
Adelaide Utd,974,5,11,6,11,37,40,-3,39
Brisbane,974,6,10,5,13,33,42,-9,35
Western Sydn,974,7,8,9,10,38,47,-9,33
Perth Glory,974,8,10,2,15,37,50,-13,32
Wellington P,974,9,5,6,16,31,55,-24,21
CC Mariners,974,10,4,8,15,28,49,-21,20
Sydney FC,975,1,20,5,3,66,24,42,65
N'castle Jet,975,2,16,5,7,59,38,21,53
Melbourne C,975,3,14,4,11,44,35,9,46
Melbourne V,975,4,13,6,10,47,40,7,45
Adelaide Utd,975,5,11,6,11,37,40,-3,39
Brisbane,975,6,10,5,13,33,42,-9,35
Western Sydn,975,7,8,9,10,38,47,-9,33
Perth Glory,975,8,10,2,15,37,50,-13,32
Wellington P,975,9,5,6,16,31,55,-24,21
CC Mariners,975,10,4,8,15,28,49,-21,20
Sydney FC,976,1,21,4,3,66,23,43,67
N'castle Jet,976,2,15,6,7,59,39,20,51
Melbourne C,976,3,14,5,10,45,35,10,47
Melbourne V,976,4,13,5,11,46,40,6,44
Adelaide Utd,976,5,11,6,11,37,40,-3,39
Brisbane,976,6,10,5,13,33,42,-9,35
Western Sydn,976,7,8,9,10,38,47,-9,33
Perth Glory,976,8,10,2,15,37,50,-13,32
Wellington P,976,9,5,6,16,31,55,-24,21
CC Mariners,976,10,4,8,15,28,49,-21,20
Sydney FC,977,1,21,4,3,67,22,45,67
N'castle Jet,977,2,16,5,7,60,38,22,53
Melbourne C,977,3,14,4,11,44,36,8,46
Melbourne V,977,4,13,5,11,45,41,4,44
Adelaide Utd,977,5,11,6,11,37,40,-3,39
Brisbane,977,6,10,5,13,33,42,-9,35
Western Sydn,977,7,8,9,10,38,47,-9,33
Perth Glory,977,8,10,2,15,37,50,-13,32
Wellington P,977,9,5,6,16,31,55,-24,21
CC Mariners,977,10,4,8,15,28,49,-21,20
Sydney FC,978,1,21,4,3,67,23,44,67
N'castle Jet,978,2,15,6,7,57,37,20,51
Melbourne C,978,3,14,5,10,43,33,10,47
Melbourne V,978,4,13,5,11,46,41,5,44
Adelaide Utd,978,5,11,6,11,37,40,-3,39
Brisbane,978,6,10,5,13,33,42,-9,35
Western Sydn,978,7,8,9,10,38,47,-9,33
Perth Glory,978,8,10,2,15,37,50,-13,32
Wellington P,978,9,5,6,16,31,55,-24,21
CC Mariners,978,10,4,8,15,28,49,-21,20
Sydney FC,979,1,20,4,4,67,27,40,64
N'castle Jet,979,2,16,5,7,59,38,21,53
Melbourne V,979,3,14,5,10,50,41,9,47
Melbourne C,979,4,14,4,11,44,35,9,46
Adelaide Utd,979,5,11,6,11,37,40,-3,39
Brisbane,979,6,10,5,13,33,42,-9,35
Western Sydn,979,7,8,9,10,38,47,-9,33
Perth Glory,979,8,10,2,15,37,50,-13,32
Wellington P,979,9,5,6,16,31,55,-24,21
CC Mariners,979,10,4,8,15,28,49,-21,20
Sydney FC,980,1,21,4,3,67,23,44,67
N'castle Jet,980,2,15,5,8,57,38,19,50
Melbourne C,980,3,15,4,10,44,33,11,49
Melbourne V,980,4,13,5,11,46,41,5,44
Adelaide Utd,980,5,11,6,11,37,40,-3,39
Brisbane,980,6,10,5,13,33,42,-9,35
Western Sydn,980,7,8,9,10,38,47,-9,33
Perth Glory,980,8,10,2,15,37,50,-13,32
Wellington P,980,9,5,6,16,31,55,-24,21
CC Mariners,980,10,4,8,15,28,49,-21,20
Sydney FC,981,1,20,5,3,65,23,42,65
N'castle Jet,981,2,15,6,7,58,38,20,51
Melbourne C,981,3,14,5,10,44,34,10,47
Melbourne V,981,4,13,6,10,46,39,7,45
Adelaide Utd,981,5,11,6,11,37,40,-3,39
Brisbane,981,6,10,5,13,33,42,-9,35
Western Sydn,981,7,8,9,10,38,47,-9,33
Perth Glory,981,8,10,2,15,37,50,-13,32
Wellington P,981,9,5,6,16,31,55,-24,21
CC Mariners,981,10,4,8,15,28,49,-21,20
Sydney FC,982,1,20,5,3,65,23,42,65
N'castle Jet,982,2,16,5,7,59,38,21,53
Melbourne C,982,3,14,4,11,44,35,9,46
Melbourne V,982,4,13,6,10,46,39,7,45
Adelaide Utd,982,5,11,6,11,37,40,-3,39
Brisbane,982,6,10,5,13,33,42,-9,35
Western Sydn,982,7,8,9,10,38,47,-9,33
Perth Glory,982,8,10,2,15,37,50,-13,32
Wellington P,982,9,5,6,16,31,55,-24,21
CC Mariners,982,10,4,8,15,28,49,-21,20
Sydney FC,983,1,21,4,3,66,22,44,67
N'castle Jet,983,2,15,6,7,58,38,20,51
Melbourne C,983,3,14,5,10,44,34,10,47
Melbourne V,983,4,13,5,11,45,40,5,44
Adelaide Utd,983,5,11,6,11,37,40,-3,39
Brisbane,983,6,10,5,13,33,42,-9,35
Western Sydn,983,7,8,9,10,38,47,-9,33
Perth Glory,983,8,10,2,15,37,50,-13,32
Wellington P,983,9,5,6,16,31,55,-24,21
CC Mariners,983,10,4,8,15,28,49,-21,20
Sydney FC,984,1,21,4,3,66,23,43,67
N'castle Jet,984,2,15,5,8,58,39,19,50
Melbourne C,984,3,15,4,10,45,34,11,49
Melbourne V,984,4,13,5,11,46,40,6,44
Adelaide Utd,984,5,11,6,11,37,40,-3,39
Brisbane,984,6,10,5,13,33,42,-9,35
Western Sydn,984,7,8,9,10,38,47,-9,33
Perth Glory,984,8,10,2,15,37,50,-13,32
Wellington P,984,9,5,6,16,31,55,-24,21
CC Mariners,984,10,4,8,15,28,49,-21,20
Sydney FC,985,1,21,4,3,67,23,44,67
N'castle Jet,985,2,15,5,8,57,38,19,50
Melbourne C,985,3,15,4,10,44,33,11,49
Melbourne V,985,4,13,5,11,46,41,5,44
Adelaide Utd,985,5,11,6,11,37,40,-3,39
Brisbane,985,6,10,5,13,33,42,-9,35
Western Sydn,985,7,8,9,10,38,47,-9,33
Perth Glory,985,8,10,2,15,37,50,-13,32
Wellington P,985,9,5,6,16,31,55,-24,21
CC Mariners,985,10,4,8,15,28,49,-21,20
Sydney FC,986,1,20,4,4,64,24,40,64
N'castle Jet,986,2,15,5,8,58,39,19,50
Melbourne C,986,3,15,4,10,45,34,11,49
Melbourne V,986,4,14,5,10,47,38,9,47
Adelaide Utd,986,5,11,6,11,37,40,-3,39
Brisbane,986,6,10,5,13,33,42,-9,35
Western Sydn,986,7,8,9,10,38,47,-9,33
Perth Glory,986,8,10,2,15,37,50,-13,32
Wellington P,986,9,5,6,16,31,55,-24,21
CC Mariners,986,10,4,8,15,28,49,-21,20
Sydney FC,987,1,20,5,3,64,22,42,65
N'castle Jet,987,2,16,5,7,58,37,21,53
Melbourne C,987,3,14,4,11,43,34,9,46
Melbourne V,987,4,13,6,10,45,38,7,45
Adelaide Utd,987,5,11,6,11,37,40,-3,39
Brisbane,987,6,10,5,13,33,42,-9,35
Western Sydn,987,7,8,9,10,38,47,-9,33
Perth Glory,987,8,10,2,15,37,50,-13,32
Wellington P,987,9,5,6,16,31,55,-24,21
CC Mariners,987,10,4,8,15,28,49,-21,20
Sydney FC,988,1,21,4,3,68,22,46,67
N'castle Jet,988,2,16,5,7,59,38,21,53
Melbourne C,988,3,14,4,11,44,35,9,46
Melbourne V,988,4,13,5,11,45,42,3,44
Adelaide Utd,988,5,11,6,11,37,40,-3,39
Brisbane,988,6,10,5,13,33,42,-9,35
Western Sydn,988,7,8,9,10,38,47,-9,33
Perth Glory,988,8,10,2,15,37,50,-13,32
Wellington P,988,9,5,6,16,31,55,-24,21
CC Mariners,988,10,4,8,15,28,49,-21,20
Sydney FC,989,1,20,4,4,66,25,41,64
N'castle Jet,989,2,15,5,8,58,40,18,50
Melbourne C,989,3,15,4,10,46,34,12,49
Melbourne V,989,4,14,5,10,48,40,8,47
Adelaide Utd,989,5,11,6,11,37,40,-3,39
Brisbane,989,6,10,5,13,33,42,-9,35
Western Sydn,989,7,8,9,10,38,47,-9,33
Perth Glory,989,8,10,2,15,37,50,-13,32
Wellington P,989,9,5,6,16,31,55,-24,21
CC Mariners,989,10,4,8,15,28,49,-21,20
Sydney FC,990,1,21,4,3,66,22,44,67
N'castle Jet,990,2,16,5,7,63,37,26,53
Melbourne C,990,3,14,4,11,43,39,4,46
Melbourne V,990,4,13,5,11,45,40,5,44
Adelaide Utd,990,5,11,6,11,37,40,-3,39
Brisbane,990,6,10,5,13,33,42,-9,35
Western Sydn,990,7,8,9,10,38,47,-9,33
Perth Glory,990,8,10,2,15,37,50,-13,32
Wellington P,990,9,5,6,16,31,55,-24,21
CC Mariners,990,10,4,8,15,28,49,-21,20
Sydney FC,991,1,20,4,4,64,26,38,64
N'castle Jet,991,2,16,5,7,60,37,23,53
Melbourne V,991,3,14,5,10,49,38,11,47
Melbourne C,991,4,14,4,11,43,36,7,46
Adelaide Utd,991,5,11,6,11,37,40,-3,39
Brisbane,991,6,10,5,13,33,42,-9,35
Western Sydn,991,7,8,9,10,38,47,-9,33
Perth Glory,991,8,10,2,15,37,50,-13,32
Wellington P,991,9,5,6,16,31,55,-24,21
CC Mariners,991,10,4,8,15,28,49,-21,20
Sydney FC,992,1,20,4,4,66,25,41,64
N'castle Jet,992,2,16,5,7,60,38,22,53
Melbourne V,992,3,14,5,10,48,40,8,47
Melbourne C,992,4,14,4,11,44,36,8,46
Adelaide Utd,992,5,11,6,11,37,40,-3,39
Brisbane,992,6,10,5,13,33,42,-9,35
Western Sydn,992,7,8,9,10,38,47,-9,33
Perth Glory,992,8,10,2,15,37,50,-13,32
Wellington P,992,9,5,6,16,31,55,-24,21
CC Mariners,992,10,4,8,15,28,49,-21,20
Sydney FC,993,1,21,4,3,66,23,43,67
N'castle Jet,993,2,16,5,7,60,38,22,53
Melbourne C,993,3,14,4,11,44,36,8,46
Melbourne V,993,4,13,5,11,46,40,6,44
Adelaide Utd,993,5,11,6,11,37,40,-3,39
Brisbane,993,6,10,5,13,33,42,-9,35
Western Sydn,993,7,8,9,10,38,47,-9,33
Perth Glory,993,8,10,2,15,37,50,-13,32
Wellington P,993,9,5,6,16,31,55,-24,21
CC Mariners,993,10,4,8,15,28,49,-21,20
Sydney FC,994,1,20,4,4,65,25,40,64
N'castle Jet,994,2,16,5,7,63,38,25,53
Melbourne V,994,3,14,5,10,48,39,9,47
Melbourne C,994,4,14,4,11,44,39,5,46
Adelaide Utd,994,5,11,6,11,37,40,-3,39
Brisbane,994,6,10,5,13,33,42,-9,35
Western Sydn,994,7,8,9,10,38,47,-9,33
Perth Glory,994,8,10,2,15,37,50,-13,32
Wellington P,994,9,5,6,16,31,55,-24,21
CC Mariners,994,10,4,8,15,28,49,-21,20
Sydney FC,995,1,21,4,3,65,22,43,67
N'castle Jet,995,2,16,5,7,61,37,24,53
Melbourne C,995,3,14,4,11,43,37,6,46
Melbourne V,995,4,13,5,11,45,39,6,44
Adelaide Utd,995,5,11,6,11,37,40,-3,39
Brisbane,995,6,10,5,13,33,42,-9,35
Western Sydn,995,7,8,9,10,38,47,-9,33
Perth Glory,995,8,10,2,15,37,50,-13,32
Wellington P,995,9,5,6,16,31,55,-24,21
CC Mariners,995,10,4,8,15,28,49,-21,20
Sydney FC,996,1,21,4,3,70,25,45,67
N'castle Jet,996,2,16,5,7,61,37,24,53
Melbourne C,996,3,14,4,11,43,37,6,46
Melbourne V,996,4,13,5,11,48,44,4,44
Adelaide Utd,996,5,11,6,11,37,40,-3,39
Brisbane,996,6,10,5,13,33,42,-9,35
Western Sydn,996,7,8,9,10,38,47,-9,33
Perth Glory,996,8,10,2,15,37,50,-13,32
Wellington P,996,9,5,6,16,31,55,-24,21
CC Mariners,996,10,4,8,15,28,49,-21,20
Sydney FC,997,1,21,4,3,67,23,44,67
N'castle Jet,997,2,15,5,8,57,39,18,50
Melbourne C,997,3,15,4,10,45,33,12,49
Melbourne V,997,4,13,5,11,46,41,5,44
Adelaide Utd,997,5,11,6,11,37,40,-3,39
Brisbane,997,6,10,5,13,33,42,-9,35
Western Sydn,997,7,8,9,10,38,47,-9,33
Perth Glory,997,8,10,2,15,37,50,-13,32
Wellington P,997,9,5,6,16,31,55,-24,21
CC Mariners,997,10,4,8,15,28,49,-21,20
Sydney FC,998,1,21,4,3,67,22,45,67
N'castle Jet,998,2,15,5,8,57,40,17,50
Melbourne C,998,3,15,4,10,46,33,13,49
Melbourne V,998,4,13,5,11,45,41,4,44
Adelaide Utd,998,5,11,6,11,37,40,-3,39
Brisbane,998,6,10,5,13,33,42,-9,35
Western Sydn,998,7,8,9,10,38,47,-9,33
Perth Glory,998,8,10,2,15,37,50,-13,32
Wellington P,998,9,5,6,16,31,55,-24,21
CC Mariners,998,10,4,8,15,28,49,-21,20
Sydney FC,999,1,20,5,3,64,22,42,65
N'castle Jet,999,2,16,5,7,60,38,22,53
Melbourne C,999,3,14,4,11,44,36,8,46
Melbourne V,999,4,13,6,10,45,38,7,45
Adelaide Utd,999,5,11,6,11,37,40,-3,39
Brisbane,999,6,10,5,13,33,42,-9,35
Western Sydn,999,7,8,9,10,38,47,-9,33
Perth Glory,999,8,10,2,15,37,50,-13,32
Wellington P,999,9,5,6,16,31,55,-24,21
CC Mariners,999,10,4,8,15,28,49,-21,20
Sydney FC,1000,1,21,4,3,67,24,43,67
N'castle Jet,1000,2,16,5,7,58,37,21,53
Melbourne C,1000,3,14,4,11,43,34,9,46
Melbourne V,1000,4,13,5,11,47,41,6,44
Adelaide Utd,1000,5,11,6,11,37,40,-3,39
Brisbane,1000,6,10,5,13,33,42,-9,35
Western Sydn,1000,7,8,9,10,38,47,-9,33
Perth Glory,1000,8,10,2,15,37,50,-13,32
Wellington P,1000,9,5,6,16,31,55,-24,21
CC Mariners,1000,10,4,8,15,28,49,-21,20
Sydney FC,1001,1,21,4,3,66,23,43,67
N'castle Jet,1001,2,16,5,7,60,37,23,53
Melbourne C,1001,3,14,4,11,43,36,7,46
Melbourne V,1001,4,13,5,11,46,40,6,44
Adelaide Utd,1001,5,11,6,11,37,40,-3,39
Brisbane,1001,6,10,5,13,33,42,-9,35
Western Sydn,1001,7,8,9,10,38,47,-9,33
Perth Glory,1001,8,10,2,15,37,50,-13,32
Wellington P,1001,9,5,6,16,31,55,-24,21
CC Mariners,1001,10,4,8,15,28,49,-21,20
Sydney FC,1002,1,20,5,3,65,23,42,65
N'castle Jet,1002,2,16,5,7,59,37,22,53
Melbourne C,1002,3,14,4,11,43,35,8,46
Melbourne V,1002,4,13,6,10,46,39,7,45
Adelaide Utd,1002,5,11,6,11,37,40,-3,39
Brisbane,1002,6,10,5,13,33,42,-9,35
Western Sydn,1002,7,8,9,10,38,47,-9,33
Perth Glory,1002,8,10,2,15,37,50,-13,32
Wellington P,1002,9,5,6,16,31,55,-24,21
CC Mariners,1002,10,4,8,15,28,49,-21,20
Sydney FC,1003,1,21,4,3,67,23,44,67
N'castle Jet,1003,2,16,5,7,59,38,21,53
Melbourne C,1003,3,14,4,11,44,35,9,46
Melbourne V,1003,4,13,5,11,46,41,5,44
Adelaide Utd,1003,5,11,6,11,37,40,-3,39
Brisbane,1003,6,10,5,13,33,42,-9,35
Western Sydn,1003,7,8,9,10,38,47,-9,33
Perth Glory,1003,8,10,2,15,37,50,-13,32
Wellington P,1003,9,5,6,16,31,55,-24,21
CC Mariners,1003,10,4,8,15,28,49,-21,20
Sydney FC,1004,1,20,4,4,65,24,41,64
N'castle Jet,1004,2,16,5,7,60,38,22,53
Melbourne V,1004,3,14,5,10,47,39,8,47
Melbourne C,1004,4,14,4,11,44,36,8,46
Adelaide Utd,1004,5,11,6,11,37,40,-3,39
Brisbane,1004,6,10,5,13,33,42,-9,35
Western Sydn,1004,7,8,9,10,38,47,-9,33
Perth Glory,1004,8,10,2,15,37,50,-13,32
Wellington P,1004,9,5,6,16,31,55,-24,21
CC Mariners,1004,10,4,8,15,28,49,-21,20
Sydney FC,1005,1,20,5,3,66,24,42,65
N'castle Jet,1005,2,16,5,7,60,39,21,53
Melbourne C,1005,3,14,4,11,45,36,9,46
Melbourne V,1005,4,13,6,10,47,40,7,45
Adelaide Utd,1005,5,11,6,11,37,40,-3,39
Brisbane,1005,6,10,5,13,33,42,-9,35
Western Sydn,1005,7,8,9,10,38,47,-9,33
Perth Glory,1005,8,10,2,15,37,50,-13,32
Wellington P,1005,9,5,6,16,31,55,-24,21
CC Mariners,1005,10,4,8,15,28,49,-21,20
Sydney FC,1006,1,21,4,3,67,22,45,67
N'castle Jet,1006,2,16,5,7,58,37,21,53
Melbourne C,1006,3,14,4,11,43,34,9,46
Melbourne V,1006,4,13,5,11,45,41,4,44
Adelaide Utd,1006,5,11,6,11,37,40,-3,39
Brisbane,1006,6,10,5,13,33,42,-9,35
Western Sydn,1006,7,8,9,10,38,47,-9,33
Perth Glory,1006,8,10,2,15,37,50,-13,32
Wellington P,1006,9,5,6,16,31,55,-24,21
CC Mariners,1006,10,4,8,15,28,49,-21,20
Sydney FC,1007,1,20,4,4,64,23,41,64
N'castle Jet,1007,2,16,5,7,62,37,25,53
Melbourne V,1007,3,14,5,10,46,38,8,47
Melbourne C,1007,4,14,4,11,43,38,5,46
Adelaide Utd,1007,5,11,6,11,37,40,-3,39
Brisbane,1007,6,10,5,13,33,42,-9,35
Western Sydn,1007,7,8,9,10,38,47,-9,33
Perth Glory,1007,8,10,2,15,37,50,-13,32
Wellington P,1007,9,5,6,16,31,55,-24,21
CC Mariners,1007,10,4,8,15,28,49,-21,20
Sydney FC,1008,1,21,4,3,65,22,43,67
N'castle Jet,1008,2,16,5,7,60,37,23,53
Melbourne C,1008,3,14,4,11,43,36,7,46
Melbourne V,1008,4,13,5,11,45,39,6,44
Adelaide Utd,1008,5,11,6,11,37,40,-3,39
Brisbane,1008,6,10,5,13,33,42,-9,35
Western Sydn,1008,7,8,9,10,38,47,-9,33
Perth Glory,1008,8,10,2,15,37,50,-13,32
Wellington P,1008,9,5,6,16,31,55,-24,21
CC Mariners,1008,10,4,8,15,28,49,-21,20
Sydney FC,1009,1,20,5,3,65,23,42,65
N'castle Jet,1009,2,16,5,7,58,37,21,53
Melbourne C,1009,3,14,4,11,43,34,9,46
Melbourne V,1009,4,13,6,10,46,39,7,45
Adelaide Utd,1009,5,11,6,11,37,40,-3,39
Brisbane,1009,6,10,5,13,33,42,-9,35
Western Sydn,1009,7,8,9,10,38,47,-9,33
Perth Glory,1009,8,10,2,15,37,50,-13,32
Wellington P,1009,9,5,6,16,31,55,-24,21
CC Mariners,1009,10,4,8,15,28,49,-21,20
Sydney FC,1010,1,21,4,3,65,22,43,67
N'castle Jet,1010,2,15,5,8,59,40,19,50
Melbourne C,1010,3,15,4,10,46,35,11,49
Melbourne V,1010,4,13,5,11,45,39,6,44
Adelaide Utd,1010,5,11,6,11,37,40,-3,39
Brisbane,1010,6,10,5,13,33,42,-9,35
Western Sydn,1010,7,8,9,10,38,47,-9,33
Perth Glory,1010,8,10,2,15,37,50,-13,32
Wellington P,1010,9,5,6,16,31,55,-24,21
CC Mariners,1010,10,4,8,15,28,49,-21,20
Sydney FC,1011,1,21,4,3,67,23,44,67
N'castle Jet,1011,2,15,5,8,57,38,19,50
Melbourne C,1011,3,15,4,10,44,33,11,49
Melbourne V,1011,4,13,5,11,46,41,5,44
Adelaide Utd,1011,5,11,6,11,37,40,-3,39
Brisbane,1011,6,10,5,13,33,42,-9,35
Western Sydn,1011,7,8,9,10,38,47,-9,33
Perth Glory,1011,8,10,2,15,37,50,-13,32
Wellington P,1011,9,5,6,16,31,55,-24,21
CC Mariners,1011,10,4,8,15,28,49,-21,20
Sydney FC,1012,1,21,4,3,68,24,44,67
N'castle Jet,1012,2,15,5,8,58,40,18,50
Melbourne C,1012,3,15,4,10,46,34,12,49
Melbourne V,1012,4,13,5,11,47,42,5,44
Adelaide Utd,1012,5,11,6,11,37,40,-3,39
Brisbane,1012,6,10,5,13,33,42,-9,35
Western Sydn,1012,7,8,9,10,38,47,-9,33
Perth Glory,1012,8,10,2,15,37,50,-13,32
Wellington P,1012,9,5,6,16,31,55,-24,21
CC Mariners,1012,10,4,8,15,28,49,-21,20
Sydney FC,1013,1,21,4,3,68,25,43,67
N'castle Jet,1013,2,16,5,7,59,37,22,53
Melbourne C,1013,3,14,4,11,43,35,8,46
Melbourne V,1013,4,13,5,11,48,42,6,44
Adelaide Utd,1013,5,11,6,11,37,40,-3,39
Brisbane,1013,6,10,5,13,33,42,-9,35
Western Sydn,1013,7,8,9,10,38,47,-9,33
Perth Glory,1013,8,10,2,15,37,50,-13,32
Wellington P,1013,9,5,6,16,31,55,-24,21
CC Mariners,1013,10,4,8,15,28,49,-21,20
Sydney FC,1014,1,20,4,4,65,24,41,64
N'castle Jet,1014,2,15,5,8,58,40,18,50
Melbourne C,1014,3,15,4,10,46,34,12,49
Melbourne V,1014,4,14,5,10,47,39,8,47
Adelaide Utd,1014,5,11,6,11,37,40,-3,39
Brisbane,1014,6,10,5,13,33,42,-9,35
Western Sydn,1014,7,8,9,10,38,47,-9,33
Perth Glory,1014,8,10,2,15,37,50,-13,32
Wellington P,1014,9,5,6,16,31,55,-24,21
CC Mariners,1014,10,4,8,15,28,49,-21,20
Sydney FC,1015,1,21,4,3,68,24,44,67
N'castle Jet,1015,2,16,5,7,59,37,22,53
Melbourne C,1015,3,14,4,11,43,35,8,46
Melbourne V,1015,4,13,5,11,47,42,5,44
Adelaide Utd,1015,5,11,6,11,37,40,-3,39
Brisbane,1015,6,10,5,13,33,42,-9,35
Western Sydn,1015,7,8,9,10,38,47,-9,33
Perth Glory,1015,8,10,2,15,37,50,-13,32
Wellington P,1015,9,5,6,16,31,55,-24,21
CC Mariners,1015,10,4,8,15,28,49,-21,20
Sydney FC,1016,1,21,4,3,66,22,44,67
N'castle Jet,1016,2,15,6,7,57,37,20,51
Melbourne C,1016,3,14,5,10,43,33,10,47
Melbourne V,1016,4,13,5,11,45,40,5,44
Adelaide Utd,1016,5,11,6,11,37,40,-3,39
Brisbane,1016,6,10,5,13,33,42,-9,35
Western Sydn,1016,7,8,9,10,38,47,-9,33
Perth Glory,1016,8,10,2,15,37,50,-13,32
Wellington P,1016,9,5,6,16,31,55,-24,21
CC Mariners,1016,10,4,8,15,28,49,-21,20
Sydney FC,1017,1,20,5,3,65,23,42,65
N'castle Jet,1017,2,15,5,8,58,40,18,50
Melbourne C,1017,3,15,4,10,46,34,12,49
Melbourne V,1017,4,13,6,10,46,39,7,45
Adelaide Utd,1017,5,11,6,11,37,40,-3,39
Brisbane,1017,6,10,5,13,33,42,-9,35
Western Sydn,1017,7,8,9,10,38,47,-9,33
Perth Glory,1017,8,10,2,15,37,50,-13,32
Wellington P,1017,9,5,6,16,31,55,-24,21
CC Mariners,1017,10,4,8,15,28,49,-21,20
Sydney FC,1018,1,21,4,3,66,22,44,67
N'castle Jet,1018,2,15,5,8,57,40,17,50
Melbourne C,1018,3,15,4,10,46,33,13,49
Melbourne V,1018,4,13,5,11,45,40,5,44
Adelaide Utd,1018,5,11,6,11,37,40,-3,39
Brisbane,1018,6,10,5,13,33,42,-9,35
Western Sydn,1018,7,8,9,10,38,47,-9,33
Perth Glory,1018,8,10,2,15,37,50,-13,32
Wellington P,1018,9,5,6,16,31,55,-24,21
CC Mariners,1018,10,4,8,15,28,49,-21,20
Sydney FC,1019,1,21,4,3,67,22,45,67
N'castle Jet,1019,2,15,5,8,58,40,18,50
Melbourne C,1019,3,15,4,10,46,34,12,49
Melbourne V,1019,4,13,5,11,45,41,4,44
Adelaide Utd,1019,5,11,6,11,37,40,-3,39
Brisbane,1019,6,10,5,13,33,42,-9,35
Western Sydn,1019,7,8,9,10,38,47,-9,33
Perth Glory,1019,8,10,2,15,37,50,-13,32
Wellington P,1019,9,5,6,16,31,55,-24,21
CC Mariners,1019,10,4,8,15,28,49,-21,20
Sydney FC,1020,1,21,4,3,66,22,44,67
N'castle Jet,1020,2,15,6,7,59,39,20,51
Melbourne C,1020,3,14,5,10,45,35,10,47
Melbourne V,1020,4,13,5,11,45,40,5,44
Adelaide Utd,1020,5,11,6,11,37,40,-3,39
Brisbane,1020,6,10,5,13,33,42,-9,35
Western Sydn,1020,7,8,9,10,38,47,-9,33
Perth Glory,1020,8,10,2,15,37,50,-13,32
Wellington P,1020,9,5,6,16,31,55,-24,21
CC Mariners,1020,10,4,8,15,28,49,-21,20
Sydney FC,1021,1,21,4,3,67,22,45,67
N'castle Jet,1021,2,15,6,7,59,39,20,51
Melbourne C,1021,3,14,5,10,45,35,10,47
Melbourne V,1021,4,13,5,11,45,41,4,44
Adelaide Utd,1021,5,11,6,11,37,40,-3,39
Brisbane,1021,6,10,5,13,33,42,-9,35
Western Sydn,1021,7,8,9,10,38,47,-9,33
Perth Glory,1021,8,10,2,15,37,50,-13,32
Wellington P,1021,9,5,6,16,31,55,-24,21
CC Mariners,1021,10,4,8,15,28,49,-21,20
Sydney FC,1022,1,21,4,3,67,23,44,67
N'castle Jet,1022,2,15,6,7,58,38,20,51
Melbourne C,1022,3,14,5,10,44,34,10,47
Melbourne V,1022,4,13,5,11,46,41,5,44
Adelaide Utd,1022,5,11,6,11,37,40,-3,39
Brisbane,1022,6,10,5,13,33,42,-9,35
Western Sydn,1022,7,8,9,10,38,47,-9,33
Perth Glory,1022,8,10,2,15,37,50,-13,32
Wellington P,1022,9,5,6,16,31,55,-24,21
CC Mariners,1022,10,4,8,15,28,49,-21,20
Sydney FC,1023,1,20,4,4,64,23,41,64
N'castle Jet,1023,2,16,5,7,58,37,21,53
Melbourne V,1023,3,14,5,10,46,38,8,47
Melbourne C,1023,4,14,4,11,43,34,9,46
Adelaide Utd,1023,5,11,6,11,37,40,-3,39
Brisbane,1023,6,10,5,13,33,42,-9,35
Western Sydn,1023,7,8,9,10,38,47,-9,33
Perth Glory,1023,8,10,2,15,37,50,-13,32
Wellington P,1023,9,5,6,16,31,55,-24,21
CC Mariners,1023,10,4,8,15,28,49,-21,20
Sydney FC,1024,1,21,4,3,67,22,45,67
N'castle Jet,1024,2,16,5,7,61,38,23,53
Melbourne C,1024,3,14,4,11,44,37,7,46
Melbourne V,1024,4,13,5,11,45,41,4,44
Adelaide Utd,1024,5,11,6,11,37,40,-3,39
Brisbane,1024,6,10,5,13,33,42,-9,35
Western Sydn,1024,7,8,9,10,38,47,-9,33
Perth Glory,1024,8,10,2,15,37,50,-13,32
Wellington P,1024,9,5,6,16,31,55,-24,21
CC Mariners,1024,10,4,8,15,28,49,-21,20
Sydney FC,1025,1,21,4,3,69,22,47,67
N'castle Jet,1025,2,15,5,8,57,38,19,50
Melbourne C,1025,3,15,4,10,44,33,11,49
Melbourne V,1025,4,13,5,11,45,43,2,44
Adelaide Utd,1025,5,11,6,11,37,40,-3,39
Brisbane,1025,6,10,5,13,33,42,-9,35
Western Sydn,1025,7,8,9,10,38,47,-9,33
Perth Glory,1025,8,10,2,15,37,50,-13,32
Wellington P,1025,9,5,6,16,31,55,-24,21
CC Mariners,1025,10,4,8,15,28,49,-21,20
Sydney FC,1026,1,20,5,3,65,23,42,65
N'castle Jet,1026,2,16,5,7,58,37,21,53
Melbourne C,1026,3,14,4,11,43,34,9,46
Melbourne V,1026,4,13,6,10,46,39,7,45
Adelaide Utd,1026,5,11,6,11,37,40,-3,39
Brisbane,1026,6,10,5,13,33,42,-9,35
Western Sydn,1026,7,8,9,10,38,47,-9,33
Perth Glory,1026,8,10,2,15,37,50,-13,32
Wellington P,1026,9,5,6,16,31,55,-24,21
CC Mariners,1026,10,4,8,15,28,49,-21,20
Sydney FC,1027,1,20,4,4,64,23,41,64
N'castle Jet,1027,2,16,5,7,60,39,21,53
Melbourne V,1027,3,14,5,10,46,38,8,47
Melbourne C,1027,4,14,4,11,45,36,9,46
Adelaide Utd,1027,5,11,6,11,37,40,-3,39
Brisbane,1027,6,10,5,13,33,42,-9,35
Western Sydn,1027,7,8,9,10,38,47,-9,33
Perth Glory,1027,8,10,2,15,37,50,-13,32
Wellington P,1027,9,5,6,16,31,55,-24,21
CC Mariners,1027,10,4,8,15,28,49,-21,20
Sydney FC,1028,1,20,4,4,66,25,41,64
N'castle Jet,1028,2,15,5,8,58,40,18,50
Melbourne C,1028,3,15,4,10,46,34,12,49
Melbourne V,1028,4,14,5,10,48,40,8,47
Adelaide Utd,1028,5,11,6,11,37,40,-3,39
Brisbane,1028,6,10,5,13,33,42,-9,35
Western Sydn,1028,7,8,9,10,38,47,-9,33
Perth Glory,1028,8,10,2,15,37,50,-13,32
Wellington P,1028,9,5,6,16,31,55,-24,21
CC Mariners,1028,10,4,8,15,28,49,-21,20
Sydney FC,1029,1,20,4,4,67,26,41,64
N'castle Jet,1029,2,15,6,7,57,37,20,51
Melbourne C,1029,3,14,5,10,43,33,10,47
Melbourne V,1029,4,14,5,10,49,41,8,47
Adelaide Utd,1029,5,11,6,11,37,40,-3,39
Brisbane,1029,6,10,5,13,33,42,-9,35
Western Sydn,1029,7,8,9,10,38,47,-9,33
Perth Glory,1029,8,10,2,15,37,50,-13,32
Wellington P,1029,9,5,6,16,31,55,-24,21
CC Mariners,1029,10,4,8,15,28,49,-21,20
Sydney FC,1030,1,20,5,3,65,23,42,65
N'castle Jet,1030,2,15,6,7,57,37,20,51
Melbourne C,1030,3,14,5,10,43,33,10,47
Melbourne V,1030,4,13,6,10,46,39,7,45
Adelaide Utd,1030,5,11,6,11,37,40,-3,39
Brisbane,1030,6,10,5,13,33,42,-9,35
Western Sydn,1030,7,8,9,10,38,47,-9,33
Perth Glory,1030,8,10,2,15,37,50,-13,32
Wellington P,1030,9,5,6,16,31,55,-24,21
CC Mariners,1030,10,4,8,15,28,49,-21,20
Sydney FC,1031,1,20,5,3,65,23,42,65
N'castle Jet,1031,2,15,6,7,57,37,20,51
Melbourne C,1031,3,14,5,10,43,33,10,47
Melbourne V,1031,4,13,6,10,46,39,7,45
Adelaide Utd,1031,5,11,6,11,37,40,-3,39
Brisbane,1031,6,10,5,13,33,42,-9,35
Western Sydn,1031,7,8,9,10,38,47,-9,33
Perth Glory,1031,8,10,2,15,37,50,-13,32
Wellington P,1031,9,5,6,16,31,55,-24,21
CC Mariners,1031,10,4,8,15,28,49,-21,20
Sydney FC,1032,1,20,4,4,64,24,40,64
N'castle Jet,1032,2,15,6,7,58,38,20,51
Melbourne C,1032,3,14,5,10,44,34,10,47
Melbourne V,1032,4,14,5,10,47,38,9,47
Adelaide Utd,1032,5,11,6,11,37,40,-3,39
Brisbane,1032,6,10,5,13,33,42,-9,35
Western Sydn,1032,7,8,9,10,38,47,-9,33
Perth Glory,1032,8,10,2,15,37,50,-13,32
Wellington P,1032,9,5,6,16,31,55,-24,21
CC Mariners,1032,10,4,8,15,28,49,-21,20
Sydney FC,1033,1,21,4,3,66,23,43,67
N'castle Jet,1033,2,15,5,8,57,40,17,50
Melbourne C,1033,3,15,4,10,46,33,13,49
Melbourne V,1033,4,13,5,11,46,40,6,44
Adelaide Utd,1033,5,11,6,11,37,40,-3,39
Brisbane,1033,6,10,5,13,33,42,-9,35
Western Sydn,1033,7,8,9,10,38,47,-9,33
Perth Glory,1033,8,10,2,15,37,50,-13,32
Wellington P,1033,9,5,6,16,31,55,-24,21
CC Mariners,1033,10,4,8,15,28,49,-21,20
Sydney FC,1034,1,21,4,3,66,22,44,67
N'castle Jet,1034,2,16,5,7,61,39,22,53
Melbourne C,1034,3,14,4,11,45,37,8,46
Melbourne V,1034,4,13,5,11,45,40,5,44
Adelaide Utd,1034,5,11,6,11,37,40,-3,39
Brisbane,1034,6,10,5,13,33,42,-9,35
Western Sydn,1034,7,8,9,10,38,47,-9,33
Perth Glory,1034,8,10,2,15,37,50,-13,32
Wellington P,1034,9,5,6,16,31,55,-24,21
CC Mariners,1034,10,4,8,15,28,49,-21,20
Sydney FC,1035,1,21,4,3,69,22,47,67
N'castle Jet,1035,2,15,5,8,58,39,19,50
Melbourne C,1035,3,15,4,10,45,34,11,49
Melbourne V,1035,4,13,5,11,45,43,2,44
Adelaide Utd,1035,5,11,6,11,37,40,-3,39
Brisbane,1035,6,10,5,13,33,42,-9,35
Western Sydn,1035,7,8,9,10,38,47,-9,33
Perth Glory,1035,8,10,2,15,37,50,-13,32
Wellington P,1035,9,5,6,16,31,55,-24,21
CC Mariners,1035,10,4,8,15,28,49,-21,20
Sydney FC,1036,1,20,4,4,64,23,41,64
N'castle Jet,1036,2,16,5,7,60,37,23,53
Melbourne V,1036,3,14,5,10,46,38,8,47
Melbourne C,1036,4,14,4,11,43,36,7,46
Adelaide Utd,1036,5,11,6,11,37,40,-3,39
Brisbane,1036,6,10,5,13,33,42,-9,35
Western Sydn,1036,7,8,9,10,38,47,-9,33
Perth Glory,1036,8,10,2,15,37,50,-13,32
Wellington P,1036,9,5,6,16,31,55,-24,21
CC Mariners,1036,10,4,8,15,28,49,-21,20
Sydney FC,1037,1,21,4,3,66,22,44,67
N'castle Jet,1037,2,15,5,8,57,39,18,50
Melbourne C,1037,3,15,4,10,45,33,12,49
Melbourne V,1037,4,13,5,11,45,40,5,44
Adelaide Utd,1037,5,11,6,11,37,40,-3,39
Brisbane,1037,6,10,5,13,33,42,-9,35
Western Sydn,1037,7,8,9,10,38,47,-9,33
Perth Glory,1037,8,10,2,15,37,50,-13,32
Wellington P,1037,9,5,6,16,31,55,-24,21
CC Mariners,1037,10,4,8,15,28,49,-21,20
Sydney FC,1038,1,20,5,3,66,24,42,65
N'castle Jet,1038,2,16,5,7,59,38,21,53
Melbourne C,1038,3,14,4,11,44,35,9,46
Melbourne V,1038,4,13,6,10,47,40,7,45
Adelaide Utd,1038,5,11,6,11,37,40,-3,39
Brisbane,1038,6,10,5,13,33,42,-9,35
Western Sydn,1038,7,8,9,10,38,47,-9,33
Perth Glory,1038,8,10,2,15,37,50,-13,32
Wellington P,1038,9,5,6,16,31,55,-24,21
CC Mariners,1038,10,4,8,15,28,49,-21,20
Sydney FC,1039,1,21,4,3,66,23,43,67
N'castle Jet,1039,2,16,5,7,58,37,21,53
Melbourne C,1039,3,14,4,11,43,34,9,46
Melbourne V,1039,4,13,5,11,46,40,6,44
Adelaide Utd,1039,5,11,6,11,37,40,-3,39
Brisbane,1039,6,10,5,13,33,42,-9,35
Western Sydn,1039,7,8,9,10,38,47,-9,33
Perth Glory,1039,8,10,2,15,37,50,-13,32
Wellington P,1039,9,5,6,16,31,55,-24,21
CC Mariners,1039,10,4,8,15,28,49,-21,20
Sydney FC,1040,1,21,4,3,68,25,43,67
N'castle Jet,1040,2,16,5,7,60,39,21,53
Melbourne C,1040,3,14,4,11,45,36,9,46
Melbourne V,1040,4,13,5,11,48,42,6,44
Adelaide Utd,1040,5,11,6,11,37,40,-3,39
Brisbane,1040,6,10,5,13,33,42,-9,35
Western Sydn,1040,7,8,9,10,38,47,-9,33
Perth Glory,1040,8,10,2,15,37,50,-13,32
Wellington P,1040,9,5,6,16,31,55,-24,21
CC Mariners,1040,10,4,8,15,28,49,-21,20
Sydney FC,1041,1,21,4,3,67,22,45,67
N'castle Jet,1041,2,15,5,8,58,40,18,50
Melbourne C,1041,3,15,4,10,46,34,12,49
Melbourne V,1041,4,13,5,11,45,41,4,44
Adelaide Utd,1041,5,11,6,11,37,40,-3,39
Brisbane,1041,6,10,5,13,33,42,-9,35
Western Sydn,1041,7,8,9,10,38,47,-9,33
Perth Glory,1041,8,10,2,15,37,50,-13,32
Wellington P,1041,9,5,6,16,31,55,-24,21
CC Mariners,1041,10,4,8,15,28,49,-21,20
Sydney FC,1042,1,21,4,3,65,22,43,67
N'castle Jet,1042,2,16,5,7,58,37,21,53
Melbourne C,1042,3,14,4,11,43,34,9,46
Melbourne V,1042,4,13,5,11,45,39,6,44
Adelaide Utd,1042,5,11,6,11,37,40,-3,39
Brisbane,1042,6,10,5,13,33,42,-9,35
Western Sydn,1042,7,8,9,10,38,47,-9,33
Perth Glory,1042,8,10,2,15,37,50,-13,32
Wellington P,1042,9,5,6,16,31,55,-24,21
CC Mariners,1042,10,4,8,15,28,49,-21,20
Sydney FC,1043,1,21,4,3,65,22,43,67
N'castle Jet,1043,2,16,5,7,60,37,23,53
Melbourne C,1043,3,14,4,11,43,36,7,46
Melbourne V,1043,4,13,5,11,45,39,6,44
Adelaide Utd,1043,5,11,6,11,37,40,-3,39
Brisbane,1043,6,10,5,13,33,42,-9,35
Western Sydn,1043,7,8,9,10,38,47,-9,33
Perth Glory,1043,8,10,2,15,37,50,-13,32
Wellington P,1043,9,5,6,16,31,55,-24,21
CC Mariners,1043,10,4,8,15,28,49,-21,20
Sydney FC,1044,1,20,5,3,66,24,42,65
N'castle Jet,1044,2,15,6,7,58,38,20,51
Melbourne C,1044,3,14,5,10,44,34,10,47
Melbourne V,1044,4,13,6,10,47,40,7,45
Adelaide Utd,1044,5,11,6,11,37,40,-3,39
Brisbane,1044,6,10,5,13,33,42,-9,35
Western Sydn,1044,7,8,9,10,38,47,-9,33
Perth Glory,1044,8,10,2,15,37,50,-13,32
Wellington P,1044,9,5,6,16,31,55,-24,21
CC Mariners,1044,10,4,8,15,28,49,-21,20
Sydney FC,1045,1,20,5,3,65,23,42,65
N'castle Jet,1045,2,15,6,7,58,38,20,51
Melbourne C,1045,3,14,5,10,44,34,10,47
Melbourne V,1045,4,13,6,10,46,39,7,45
Adelaide Utd,1045,5,11,6,11,37,40,-3,39
Brisbane,1045,6,10,5,13,33,42,-9,35
Western Sydn,1045,7,8,9,10,38,47,-9,33
Perth Glory,1045,8,10,2,15,37,50,-13,32
Wellington P,1045,9,5,6,16,31,55,-24,21
CC Mariners,1045,10,4,8,15,28,49,-21,20
Sydney FC,1046,1,20,4,4,65,24,41,64
N'castle Jet,1046,2,15,5,8,58,39,19,50
Melbourne C,1046,3,15,4,10,45,34,11,49
Melbourne V,1046,4,14,5,10,47,39,8,47
Adelaide Utd,1046,5,11,6,11,37,40,-3,39
Brisbane,1046,6,10,5,13,33,42,-9,35
Western Sydn,1046,7,8,9,10,38,47,-9,33
Perth Glory,1046,8,10,2,15,37,50,-13,32
Wellington P,1046,9,5,6,16,31,55,-24,21
CC Mariners,1046,10,4,8,15,28,49,-21,20
Sydney FC,1047,1,20,5,3,66,24,42,65
N'castle Jet,1047,2,16,5,7,60,38,22,53
Melbourne C,1047,3,14,4,11,44,36,8,46
Melbourne V,1047,4,13,6,10,47,40,7,45
Adelaide Utd,1047,5,11,6,11,37,40,-3,39
Brisbane,1047,6,10,5,13,33,42,-9,35
Western Sydn,1047,7,8,9,10,38,47,-9,33
Perth Glory,1047,8,10,2,15,37,50,-13,32
Wellington P,1047,9,5,6,16,31,55,-24,21
CC Mariners,1047,10,4,8,15,28,49,-21,20
Sydney FC,1048,1,20,4,4,64,23,41,64
N'castle Jet,1048,2,15,6,7,59,39,20,51
Melbourne C,1048,3,14,5,10,45,35,10,47
Melbourne V,1048,4,14,5,10,46,38,8,47
Adelaide Utd,1048,5,11,6,11,37,40,-3,39
Brisbane,1048,6,10,5,13,33,42,-9,35
Western Sydn,1048,7,8,9,10,38,47,-9,33
Perth Glory,1048,8,10,2,15,37,50,-13,32
Wellington P,1048,9,5,6,16,31,55,-24,21
CC Mariners,1048,10,4,8,15,28,49,-21,20
Sydney FC,1049,1,20,4,4,67,26,41,64
N'castle Jet,1049,2,15,5,8,58,40,18,50
Melbourne C,1049,3,15,4,10,46,34,12,49
Melbourne V,1049,4,14,5,10,49,41,8,47
Adelaide Utd,1049,5,11,6,11,37,40,-3,39
Brisbane,1049,6,10,5,13,33,42,-9,35
Western Sydn,1049,7,8,9,10,38,47,-9,33
Perth Glory,1049,8,10,2,15,37,50,-13,32
Wellington P,1049,9,5,6,16,31,55,-24,21
CC Mariners,1049,10,4,8,15,28,49,-21,20
Sydney FC,1050,1,20,5,3,65,23,42,65
N'castle Jet,1050,2,16,5,7,61,37,24,53
Melbourne C,1050,3,14,4,11,43,37,6,46
Melbourne V,1050,4,13,6,10,46,39,7,45
Adelaide Utd,1050,5,11,6,11,37,40,-3,39
Brisbane,1050,6,10,5,13,33,42,-9,35
Western Sydn,1050,7,8,9,10,38,47,-9,33
Perth Glory,1050,8,10,2,15,37,50,-13,32
Wellington P,1050,9,5,6,16,31,55,-24,21
CC Mariners,1050,10,4,8,15,28,49,-21,20
Sydney FC,1051,1,21,4,3,68,24,44,67
N'castle Jet,1051,2,16,5,7,59,38,21,53
Melbourne C,1051,3,14,4,11,44,35,9,46
Melbourne V,1051,4,13,5,11,47,42,5,44
Adelaide Utd,1051,5,11,6,11,37,40,-3,39
Brisbane,1051,6,10,5,13,33,42,-9,35
Western Sydn,1051,7,8,9,10,38,47,-9,33
Perth Glory,1051,8,10,2,15,37,50,-13,32
Wellington P,1051,9,5,6,16,31,55,-24,21
CC Mariners,1051,10,4,8,15,28,49,-21,20
Sydney FC,1052,1,20,4,4,64,23,41,64
N'castle Jet,1052,2,16,5,7,62,39,23,53
Melbourne V,1052,3,14,5,10,46,38,8,47
Melbourne C,1052,4,14,4,11,45,38,7,46
Adelaide Utd,1052,5,11,6,11,37,40,-3,39
Brisbane,1052,6,10,5,13,33,42,-9,35
Western Sydn,1052,7,8,9,10,38,47,-9,33
Perth Glory,1052,8,10,2,15,37,50,-13,32
Wellington P,1052,9,5,6,16,31,55,-24,21
CC Mariners,1052,10,4,8,15,28,49,-21,20
Sydney FC,1053,1,21,4,3,66,23,43,67
N'castle Jet,1053,2,16,5,7,59,38,21,53
Melbourne C,1053,3,14,4,11,44,35,9,46
Melbourne V,1053,4,13,5,11,46,40,6,44
Adelaide Utd,1053,5,11,6,11,37,40,-3,39
Brisbane,1053,6,10,5,13,33,42,-9,35
Western Sydn,1053,7,8,9,10,38,47,-9,33
Perth Glory,1053,8,10,2,15,37,50,-13,32
Wellington P,1053,9,5,6,16,31,55,-24,21
CC Mariners,1053,10,4,8,15,28,49,-21,20
Sydney FC,1054,1,20,4,4,65,24,41,64
N'castle Jet,1054,2,15,5,8,57,40,17,50
Melbourne C,1054,3,15,4,10,46,33,13,49
Melbourne V,1054,4,14,5,10,47,39,8,47
Adelaide Utd,1054,5,11,6,11,37,40,-3,39
Brisbane,1054,6,10,5,13,33,42,-9,35
Western Sydn,1054,7,8,9,10,38,47,-9,33
Perth Glory,1054,8,10,2,15,37,50,-13,32
Wellington P,1054,9,5,6,16,31,55,-24,21
CC Mariners,1054,10,4,8,15,28,49,-21,20
Sydney FC,1055,1,20,5,3,64,22,42,65
N'castle Jet,1055,2,16,5,7,58,37,21,53
Melbourne C,1055,3,14,4,11,43,34,9,46
Melbourne V,1055,4,13,6,10,45,38,7,45
Adelaide Utd,1055,5,11,6,11,37,40,-3,39
Brisbane,1055,6,10,5,13,33,42,-9,35
Western Sydn,1055,7,8,9,10,38,47,-9,33
Perth Glory,1055,8,10,2,15,37,50,-13,32
Wellington P,1055,9,5,6,16,31,55,-24,21
CC Mariners,1055,10,4,8,15,28,49,-21,20
Sydney FC,1056,1,21,4,3,66,22,44,67
N'castle Jet,1056,2,16,5,7,60,38,22,53
Melbourne C,1056,3,14,4,11,44,36,8,46
Melbourne V,1056,4,13,5,11,45,40,5,44
Adelaide Utd,1056,5,11,6,11,37,40,-3,39
Brisbane,1056,6,10,5,13,33,42,-9,35
Western Sydn,1056,7,8,9,10,38,47,-9,33
Perth Glory,1056,8,10,2,15,37,50,-13,32
Wellington P,1056,9,5,6,16,31,55,-24,21
CC Mariners,1056,10,4,8,15,28,49,-21,20
Sydney FC,1057,1,21,4,3,67,24,43,67
N'castle Jet,1057,2,15,6,7,58,38,20,51
Melbourne C,1057,3,14,5,10,44,34,10,47
Melbourne V,1057,4,13,5,11,47,41,6,44
Adelaide Utd,1057,5,11,6,11,37,40,-3,39
Brisbane,1057,6,10,5,13,33,42,-9,35
Western Sydn,1057,7,8,9,10,38,47,-9,33
Perth Glory,1057,8,10,2,15,37,50,-13,32
Wellington P,1057,9,5,6,16,31,55,-24,21
CC Mariners,1057,10,4,8,15,28,49,-21,20
Sydney FC,1058,1,21,4,3,69,23,46,67
N'castle Jet,1058,2,15,5,8,58,40,18,50
Melbourne C,1058,3,15,4,10,46,34,12,49
Melbourne V,1058,4,13,5,11,46,43,3,44
Adelaide Utd,1058,5,11,6,11,37,40,-3,39
Brisbane,1058,6,10,5,13,33,42,-9,35
Western Sydn,1058,7,8,9,10,38,47,-9,33
Perth Glory,1058,8,10,2,15,37,50,-13,32
Wellington P,1058,9,5,6,16,31,55,-24,21
CC Mariners,1058,10,4,8,15,28,49,-21,20
Sydney FC,1059,1,20,5,3,65,23,42,65
N'castle Jet,1059,2,15,5,8,58,39,19,50
Melbourne C,1059,3,15,4,10,45,34,11,49
Melbourne V,1059,4,13,6,10,46,39,7,45
Adelaide Utd,1059,5,11,6,11,37,40,-3,39
Brisbane,1059,6,10,5,13,33,42,-9,35
Western Sydn,1059,7,8,9,10,38,47,-9,33
Perth Glory,1059,8,10,2,15,37,50,-13,32
Wellington P,1059,9,5,6,16,31,55,-24,21
CC Mariners,1059,10,4,8,15,28,49,-21,20
Sydney FC,1060,1,21,4,3,66,22,44,67
N'castle Jet,1060,2,15,6,7,58,38,20,51
Melbourne C,1060,3,14,5,10,44,34,10,47
Melbourne V,1060,4,13,5,11,45,40,5,44
Adelaide Utd,1060,5,11,6,11,37,40,-3,39
Brisbane,1060,6,10,5,13,33,42,-9,35
Western Sydn,1060,7,8,9,10,38,47,-9,33
Perth Glory,1060,8,10,2,15,37,50,-13,32
Wellington P,1060,9,5,6,16,31,55,-24,21
CC Mariners,1060,10,4,8,15,28,49,-21,20
Sydney FC,1061,1,21,4,3,65,22,43,67
N'castle Jet,1061,2,16,5,7,60,37,23,53
Melbourne C,1061,3,14,4,11,43,36,7,46
Melbourne V,1061,4,13,5,11,45,39,6,44
Adelaide Utd,1061,5,11,6,11,37,40,-3,39
Brisbane,1061,6,10,5,13,33,42,-9,35
Western Sydn,1061,7,8,9,10,38,47,-9,33
Perth Glory,1061,8,10,2,15,37,50,-13,32
Wellington P,1061,9,5,6,16,31,55,-24,21
CC Mariners,1061,10,4,8,15,28,49,-21,20
Sydney FC,1062,1,21,4,3,66,22,44,67
N'castle Jet,1062,2,16,5,7,59,38,21,53
Melbourne C,1062,3,14,4,11,44,35,9,46
Melbourne V,1062,4,13,5,11,45,40,5,44
Adelaide Utd,1062,5,11,6,11,37,40,-3,39
Brisbane,1062,6,10,5,13,33,42,-9,35
Western Sydn,1062,7,8,9,10,38,47,-9,33
Perth Glory,1062,8,10,2,15,37,50,-13,32
Wellington P,1062,9,5,6,16,31,55,-24,21
CC Mariners,1062,10,4,8,15,28,49,-21,20
Sydney FC,1063,1,20,4,4,64,23,41,64
N'castle Jet,1063,2,15,6,7,57,37,20,51
Melbourne C,1063,3,14,5,10,43,33,10,47
Melbourne V,1063,4,14,5,10,46,38,8,47
Adelaide Utd,1063,5,11,6,11,37,40,-3,39
Brisbane,1063,6,10,5,13,33,42,-9,35
Western Sydn,1063,7,8,9,10,38,47,-9,33
Perth Glory,1063,8,10,2,15,37,50,-13,32
Wellington P,1063,9,5,6,16,31,55,-24,21
CC Mariners,1063,10,4,8,15,28,49,-21,20
Sydney FC,1064,1,20,5,3,64,22,42,65
N'castle Jet,1064,2,15,6,7,58,38,20,51
Melbourne C,1064,3,14,5,10,44,34,10,47
Melbourne V,1064,4,13,6,10,45,38,7,45
Adelaide Utd,1064,5,11,6,11,37,40,-3,39
Brisbane,1064,6,10,5,13,33,42,-9,35
Western Sydn,1064,7,8,9,10,38,47,-9,33
Perth Glory,1064,8,10,2,15,37,50,-13,32
Wellington P,1064,9,5,6,16,31,55,-24,21
CC Mariners,1064,10,4,8,15,28,49,-21,20
Sydney FC,1065,1,20,5,3,64,22,42,65
N'castle Jet,1065,2,16,5,7,59,38,21,53
Melbourne C,1065,3,14,4,11,44,35,9,46
Melbourne V,1065,4,13,6,10,45,38,7,45
Adelaide Utd,1065,5,11,6,11,37,40,-3,39
Brisbane,1065,6,10,5,13,33,42,-9,35
Western Sydn,1065,7,8,9,10,38,47,-9,33
Perth Glory,1065,8,10,2,15,37,50,-13,32
Wellington P,1065,9,5,6,16,31,55,-24,21
CC Mariners,1065,10,4,8,15,28,49,-21,20
Sydney FC,1066,1,20,4,4,64,25,39,64
N'castle Jet,1066,2,16,5,7,60,39,21,53
Melbourne V,1066,3,14,5,10,48,38,10,47
Melbourne C,1066,4,14,4,11,45,36,9,46
Adelaide Utd,1066,5,11,6,11,37,40,-3,39
Brisbane,1066,6,10,5,13,33,42,-9,35
Western Sydn,1066,7,8,9,10,38,47,-9,33
Perth Glory,1066,8,10,2,15,37,50,-13,32
Wellington P,1066,9,5,6,16,31,55,-24,21
CC Mariners,1066,10,4,8,15,28,49,-21,20
Sydney FC,1067,1,21,4,3,66,22,44,67
N'castle Jet,1067,2,16,5,7,59,38,21,53
Melbourne C,1067,3,14,4,11,44,35,9,46
Melbourne V,1067,4,13,5,11,45,40,5,44
Adelaide Utd,1067,5,11,6,11,37,40,-3,39
Brisbane,1067,6,10,5,13,33,42,-9,35
Western Sydn,1067,7,8,9,10,38,47,-9,33
Perth Glory,1067,8,10,2,15,37,50,-13,32
Wellington P,1067,9,5,6,16,31,55,-24,21
CC Mariners,1067,10,4,8,15,28,49,-21,20
Sydney FC,1068,1,21,4,3,66,22,44,67
N'castle Jet,1068,2,15,5,8,57,39,18,50
Melbourne C,1068,3,15,4,10,45,33,12,49
Melbourne V,1068,4,13,5,11,45,40,5,44
Adelaide Utd,1068,5,11,6,11,37,40,-3,39
Brisbane,1068,6,10,5,13,33,42,-9,35
Western Sydn,1068,7,8,9,10,38,47,-9,33
Perth Glory,1068,8,10,2,15,37,50,-13,32
Wellington P,1068,9,5,6,16,31,55,-24,21
CC Mariners,1068,10,4,8,15,28,49,-21,20
Sydney FC,1069,1,21,4,3,67,23,44,67
N'castle Jet,1069,2,15,6,7,58,38,20,51
Melbourne C,1069,3,14,5,10,44,34,10,47
Melbourne V,1069,4,13,5,11,46,41,5,44
Adelaide Utd,1069,5,11,6,11,37,40,-3,39
Brisbane,1069,6,10,5,13,33,42,-9,35
Western Sydn,1069,7,8,9,10,38,47,-9,33
Perth Glory,1069,8,10,2,15,37,50,-13,32
Wellington P,1069,9,5,6,16,31,55,-24,21
CC Mariners,1069,10,4,8,15,28,49,-21,20
Sydney FC,1070,1,21,4,3,66,22,44,67
N'castle Jet,1070,2,15,6,7,58,38,20,51
Melbourne C,1070,3,14,5,10,44,34,10,47
Melbourne V,1070,4,13,5,11,45,40,5,44
Adelaide Utd,1070,5,11,6,11,37,40,-3,39
Brisbane,1070,6,10,5,13,33,42,-9,35
Western Sydn,1070,7,8,9,10,38,47,-9,33
Perth Glory,1070,8,10,2,15,37,50,-13,32
Wellington P,1070,9,5,6,16,31,55,-24,21
CC Mariners,1070,10,4,8,15,28,49,-21,20
Sydney FC,1071,1,21,4,3,65,22,43,67
N'castle Jet,1071,2,16,5,7,60,37,23,53
Melbourne C,1071,3,14,4,11,43,36,7,46
Melbourne V,1071,4,13,5,11,45,39,6,44
Adelaide Utd,1071,5,11,6,11,37,40,-3,39
Brisbane,1071,6,10,5,13,33,42,-9,35
Western Sydn,1071,7,8,9,10,38,47,-9,33
Perth Glory,1071,8,10,2,15,37,50,-13,32
Wellington P,1071,9,5,6,16,31,55,-24,21
CC Mariners,1071,10,4,8,15,28,49,-21,20
Sydney FC,1072,1,21,4,3,66,22,44,67
N'castle Jet,1072,2,16,5,7,60,37,23,53
Melbourne C,1072,3,14,4,11,43,36,7,46
Melbourne V,1072,4,13,5,11,45,40,5,44
Adelaide Utd,1072,5,11,6,11,37,40,-3,39
Brisbane,1072,6,10,5,13,33,42,-9,35
Western Sydn,1072,7,8,9,10,38,47,-9,33
Perth Glory,1072,8,10,2,15,37,50,-13,32
Wellington P,1072,9,5,6,16,31,55,-24,21
CC Mariners,1072,10,4,8,15,28,49,-21,20
Sydney FC,1073,1,21,4,3,66,23,43,67
N'castle Jet,1073,2,16,5,7,59,37,22,53
Melbourne C,1073,3,14,4,11,43,35,8,46
Melbourne V,1073,4,13,5,11,46,40,6,44
Adelaide Utd,1073,5,11,6,11,37,40,-3,39
Brisbane,1073,6,10,5,13,33,42,-9,35
Western Sydn,1073,7,8,9,10,38,47,-9,33
Perth Glory,1073,8,10,2,15,37,50,-13,32
Wellington P,1073,9,5,6,16,31,55,-24,21
CC Mariners,1073,10,4,8,15,28,49,-21,20
Sydney FC,1074,1,21,4,3,66,22,44,67
N'castle Jet,1074,2,15,5,8,57,39,18,50
Melbourne C,1074,3,15,4,10,45,33,12,49
Melbourne V,1074,4,13,5,11,45,40,5,44
Adelaide Utd,1074,5,11,6,11,37,40,-3,39
Brisbane,1074,6,10,5,13,33,42,-9,35
Western Sydn,1074,7,8,9,10,38,47,-9,33
Perth Glory,1074,8,10,2,15,37,50,-13,32
Wellington P,1074,9,5,6,16,31,55,-24,21
CC Mariners,1074,10,4,8,15,28,49,-21,20
Sydney FC,1075,1,21,4,3,66,22,44,67
N'castle Jet,1075,2,15,6,7,57,37,20,51
Melbourne C,1075,3,14,5,10,43,33,10,47
Melbourne V,1075,4,13,5,11,45,40,5,44
Adelaide Utd,1075,5,11,6,11,37,40,-3,39
Brisbane,1075,6,10,5,13,33,42,-9,35
Western Sydn,1075,7,8,9,10,38,47,-9,33
Perth Glory,1075,8,10,2,15,37,50,-13,32
Wellington P,1075,9,5,6,16,31,55,-24,21
CC Mariners,1075,10,4,8,15,28,49,-21,20
Sydney FC,1076,1,21,4,3,66,22,44,67
N'castle Jet,1076,2,15,6,7,58,38,20,51
Melbourne C,1076,3,14,5,10,44,34,10,47
Melbourne V,1076,4,13,5,11,45,40,5,44
Adelaide Utd,1076,5,11,6,11,37,40,-3,39
Brisbane,1076,6,10,5,13,33,42,-9,35
Western Sydn,1076,7,8,9,10,38,47,-9,33
Perth Glory,1076,8,10,2,15,37,50,-13,32
Wellington P,1076,9,5,6,16,31,55,-24,21
CC Mariners,1076,10,4,8,15,28,49,-21,20
Sydney FC,1077,1,21,4,3,68,23,45,67
N'castle Jet,1077,2,16,5,7,59,37,22,53
Melbourne C,1077,3,14,4,11,43,35,8,46
Melbourne V,1077,4,13,5,11,46,42,4,44
Adelaide Utd,1077,5,11,6,11,37,40,-3,39
Brisbane,1077,6,10,5,13,33,42,-9,35
Western Sydn,1077,7,8,9,10,38,47,-9,33
Perth Glory,1077,8,10,2,15,37,50,-13,32
Wellington P,1077,9,5,6,16,31,55,-24,21
CC Mariners,1077,10,4,8,15,28,49,-21,20
Sydney FC,1078,1,20,4,4,64,24,40,64
N'castle Jet,1078,2,15,5,8,57,38,19,50
Melbourne C,1078,3,15,4,10,44,33,11,49
Melbourne V,1078,4,14,5,10,47,38,9,47
Adelaide Utd,1078,5,11,6,11,37,40,-3,39
Brisbane,1078,6,10,5,13,33,42,-9,35
Western Sydn,1078,7,8,9,10,38,47,-9,33
Perth Glory,1078,8,10,2,15,37,50,-13,32
Wellington P,1078,9,5,6,16,31,55,-24,21
CC Mariners,1078,10,4,8,15,28,49,-21,20
Sydney FC,1079,1,20,4,4,65,24,41,64
N'castle Jet,1079,2,15,6,7,58,38,20,51
Melbourne C,1079,3,14,5,10,44,34,10,47
Melbourne V,1079,4,14,5,10,47,39,8,47
Adelaide Utd,1079,5,11,6,11,37,40,-3,39
Brisbane,1079,6,10,5,13,33,42,-9,35
Western Sydn,1079,7,8,9,10,38,47,-9,33
Perth Glory,1079,8,10,2,15,37,50,-13,32
Wellington P,1079,9,5,6,16,31,55,-24,21
CC Mariners,1079,10,4,8,15,28,49,-21,20
Sydney FC,1080,1,20,4,4,66,25,41,64
N'castle Jet,1080,2,16,5,7,59,37,22,53
Melbourne V,1080,3,14,5,10,48,40,8,47
Melbourne C,1080,4,14,4,11,43,35,8,46
Adelaide Utd,1080,5,11,6,11,37,40,-3,39
Brisbane,1080,6,10,5,13,33,42,-9,35
Western Sydn,1080,7,8,9,10,38,47,-9,33
Perth Glory,1080,8,10,2,15,37,50,-13,32
Wellington P,1080,9,5,6,16,31,55,-24,21
CC Mariners,1080,10,4,8,15,28,49,-21,20
Sydney FC,1081,1,21,4,3,66,23,43,67
N'castle Jet,1081,2,16,5,7,59,38,21,53
Melbourne C,1081,3,14,4,11,44,35,9,46
Melbourne V,1081,4,13,5,11,46,40,6,44
Adelaide Utd,1081,5,11,6,11,37,40,-3,39
Brisbane,1081,6,10,5,13,33,42,-9,35
Western Sydn,1081,7,8,9,10,38,47,-9,33
Perth Glory,1081,8,10,2,15,37,50,-13,32
Wellington P,1081,9,5,6,16,31,55,-24,21
CC Mariners,1081,10,4,8,15,28,49,-21,20
Sydney FC,1082,1,20,4,4,65,24,41,64
N'castle Jet,1082,2,16,5,7,58,37,21,53
Melbourne V,1082,3,14,5,10,47,39,8,47
Melbourne C,1082,4,14,4,11,43,34,9,46
Adelaide Utd,1082,5,11,6,11,37,40,-3,39
Brisbane,1082,6,10,5,13,33,42,-9,35
Western Sydn,1082,7,8,9,10,38,47,-9,33
Perth Glory,1082,8,10,2,15,37,50,-13,32
Wellington P,1082,9,5,6,16,31,55,-24,21
CC Mariners,1082,10,4,8,15,28,49,-21,20
Sydney FC,1083,1,20,4,4,64,24,40,64
N'castle Jet,1083,2,16,5,7,59,38,21,53
Melbourne V,1083,3,14,5,10,47,38,9,47
Melbourne C,1083,4,14,4,11,44,35,9,46
Adelaide Utd,1083,5,11,6,11,37,40,-3,39
Brisbane,1083,6,10,5,13,33,42,-9,35
Western Sydn,1083,7,8,9,10,38,47,-9,33
Perth Glory,1083,8,10,2,15,37,50,-13,32
Wellington P,1083,9,5,6,16,31,55,-24,21
CC Mariners,1083,10,4,8,15,28,49,-21,20
Sydney FC,1084,1,21,4,3,67,23,44,67
N'castle Jet,1084,2,16,5,7,59,37,22,53
Melbourne C,1084,3,14,4,11,43,35,8,46
Melbourne V,1084,4,13,5,11,46,41,5,44
Adelaide Utd,1084,5,11,6,11,37,40,-3,39
Brisbane,1084,6,10,5,13,33,42,-9,35
Western Sydn,1084,7,8,9,10,38,47,-9,33
Perth Glory,1084,8,10,2,15,37,50,-13,32
Wellington P,1084,9,5,6,16,31,55,-24,21
CC Mariners,1084,10,4,8,15,28,49,-21,20
Sydney FC,1085,1,20,5,3,65,23,42,65
N'castle Jet,1085,2,16,5,7,61,38,23,53
Melbourne C,1085,3,14,4,11,44,37,7,46
Melbourne V,1085,4,13,6,10,46,39,7,45
Adelaide Utd,1085,5,11,6,11,37,40,-3,39
Brisbane,1085,6,10,5,13,33,42,-9,35
Western Sydn,1085,7,8,9,10,38,47,-9,33
Perth Glory,1085,8,10,2,15,37,50,-13,32
Wellington P,1085,9,5,6,16,31,55,-24,21
CC Mariners,1085,10,4,8,15,28,49,-21,20
Sydney FC,1086,1,20,4,4,64,25,39,64
N'castle Jet,1086,2,15,5,8,58,39,19,50
Melbourne C,1086,3,15,4,10,45,34,11,49
Melbourne V,1086,4,14,5,10,48,38,10,47
Adelaide Utd,1086,5,11,6,11,37,40,-3,39
Brisbane,1086,6,10,5,13,33,42,-9,35
Western Sydn,1086,7,8,9,10,38,47,-9,33
Perth Glory,1086,8,10,2,15,37,50,-13,32
Wellington P,1086,9,5,6,16,31,55,-24,21
CC Mariners,1086,10,4,8,15,28,49,-21,20
Sydney FC,1087,1,21,4,3,67,23,44,67
N'castle Jet,1087,2,16,5,7,60,38,22,53
Melbourne C,1087,3,14,4,11,44,36,8,46
Melbourne V,1087,4,13,5,11,46,41,5,44
Adelaide Utd,1087,5,11,6,11,37,40,-3,39
Brisbane,1087,6,10,5,13,33,42,-9,35
Western Sydn,1087,7,8,9,10,38,47,-9,33
Perth Glory,1087,8,10,2,15,37,50,-13,32
Wellington P,1087,9,5,6,16,31,55,-24,21
CC Mariners,1087,10,4,8,15,28,49,-21,20
Sydney FC,1088,1,20,4,4,64,24,40,64
N'castle Jet,1088,2,16,5,7,61,37,24,53
Melbourne V,1088,3,14,5,10,47,38,9,47
Melbourne C,1088,4,14,4,11,43,37,6,46
Adelaide Utd,1088,5,11,6,11,37,40,-3,39
Brisbane,1088,6,10,5,13,33,42,-9,35
Western Sydn,1088,7,8,9,10,38,47,-9,33
Perth Glory,1088,8,10,2,15,37,50,-13,32
Wellington P,1088,9,5,6,16,31,55,-24,21
CC Mariners,1088,10,4,8,15,28,49,-21,20
Sydney FC,1089,1,21,4,3,68,22,46,67
N'castle Jet,1089,2,15,6,7,58,38,20,51
Melbourne C,1089,3,14,5,10,44,34,10,47
Melbourne V,1089,4,13,5,11,45,42,3,44
Adelaide Utd,1089,5,11,6,11,37,40,-3,39
Brisbane,1089,6,10,5,13,33,42,-9,35
Western Sydn,1089,7,8,9,10,38,47,-9,33
Perth Glory,1089,8,10,2,15,37,50,-13,32
Wellington P,1089,9,5,6,16,31,55,-24,21
CC Mariners,1089,10,4,8,15,28,49,-21,20
Sydney FC,1090,1,21,4,3,65,22,43,67
N'castle Jet,1090,2,15,5,8,59,40,19,50
Melbourne C,1090,3,15,4,10,46,35,11,49
Melbourne V,1090,4,13,5,11,45,39,6,44
Adelaide Utd,1090,5,11,6,11,37,40,-3,39
Brisbane,1090,6,10,5,13,33,42,-9,35
Western Sydn,1090,7,8,9,10,38,47,-9,33
Perth Glory,1090,8,10,2,15,37,50,-13,32
Wellington P,1090,9,5,6,16,31,55,-24,21
CC Mariners,1090,10,4,8,15,28,49,-21,20
Sydney FC,1091,1,20,5,3,64,22,42,65
N'castle Jet,1091,2,16,5,7,60,38,22,53
Melbourne C,1091,3,14,4,11,44,36,8,46
Melbourne V,1091,4,13,6,10,45,38,7,45
Adelaide Utd,1091,5,11,6,11,37,40,-3,39
Brisbane,1091,6,10,5,13,33,42,-9,35
Western Sydn,1091,7,8,9,10,38,47,-9,33
Perth Glory,1091,8,10,2,15,37,50,-13,32
Wellington P,1091,9,5,6,16,31,55,-24,21
CC Mariners,1091,10,4,8,15,28,49,-21,20
Sydney FC,1092,1,20,4,4,64,23,41,64
N'castle Jet,1092,2,15,6,7,58,38,20,51
Melbourne C,1092,3,14,5,10,44,34,10,47
Melbourne V,1092,4,14,5,10,46,38,8,47
Adelaide Utd,1092,5,11,6,11,37,40,-3,39
Brisbane,1092,6,10,5,13,33,42,-9,35
Western Sydn,1092,7,8,9,10,38,47,-9,33
Perth Glory,1092,8,10,2,15,37,50,-13,32
Wellington P,1092,9,5,6,16,31,55,-24,21
CC Mariners,1092,10,4,8,15,28,49,-21,20
Sydney FC,1093,1,20,5,3,64,22,42,65
N'castle Jet,1093,2,16,5,7,61,38,23,53
Melbourne C,1093,3,14,4,11,44,37,7,46
Melbourne V,1093,4,13,6,10,45,38,7,45
Adelaide Utd,1093,5,11,6,11,37,40,-3,39
Brisbane,1093,6,10,5,13,33,42,-9,35
Western Sydn,1093,7,8,9,10,38,47,-9,33
Perth Glory,1093,8,10,2,15,37,50,-13,32
Wellington P,1093,9,5,6,16,31,55,-24,21
CC Mariners,1093,10,4,8,15,28,49,-21,20
Sydney FC,1094,1,20,4,4,65,24,41,64
N'castle Jet,1094,2,15,5,8,57,38,19,50
Melbourne C,1094,3,15,4,10,44,33,11,49
Melbourne V,1094,4,14,5,10,47,39,8,47
Adelaide Utd,1094,5,11,6,11,37,40,-3,39
Brisbane,1094,6,10,5,13,33,42,-9,35
Western Sydn,1094,7,8,9,10,38,47,-9,33
Perth Glory,1094,8,10,2,15,37,50,-13,32
Wellington P,1094,9,5,6,16,31,55,-24,21
CC Mariners,1094,10,4,8,15,28,49,-21,20
Sydney FC,1095,1,20,5,3,64,22,42,65
N'castle Jet,1095,2,15,5,8,59,40,19,50
Melbourne C,1095,3,15,4,10,46,35,11,49
Melbourne V,1095,4,13,6,10,45,38,7,45
Adelaide Utd,1095,5,11,6,11,37,40,-3,39
Brisbane,1095,6,10,5,13,33,42,-9,35
Western Sydn,1095,7,8,9,10,38,47,-9,33
Perth Glory,1095,8,10,2,15,37,50,-13,32
Wellington P,1095,9,5,6,16,31,55,-24,21
CC Mariners,1095,10,4,8,15,28,49,-21,20
Sydney FC,1096,1,20,5,3,65,23,42,65
N'castle Jet,1096,2,15,5,8,57,38,19,50
Melbourne C,1096,3,15,4,10,44,33,11,49
Melbourne V,1096,4,13,6,10,46,39,7,45
Adelaide Utd,1096,5,11,6,11,37,40,-3,39
Brisbane,1096,6,10,5,13,33,42,-9,35
Western Sydn,1096,7,8,9,10,38,47,-9,33
Perth Glory,1096,8,10,2,15,37,50,-13,32
Wellington P,1096,9,5,6,16,31,55,-24,21
CC Mariners,1096,10,4,8,15,28,49,-21,20
Sydney FC,1097,1,21,4,3,66,23,43,67
N'castle Jet,1097,2,16,5,7,59,37,22,53
Melbourne C,1097,3,14,4,11,43,35,8,46
Melbourne V,1097,4,13,5,11,46,40,6,44
Adelaide Utd,1097,5,11,6,11,37,40,-3,39
Brisbane,1097,6,10,5,13,33,42,-9,35
Western Sydn,1097,7,8,9,10,38,47,-9,33
Perth Glory,1097,8,10,2,15,37,50,-13,32
Wellington P,1097,9,5,6,16,31,55,-24,21
CC Mariners,1097,10,4,8,15,28,49,-21,20
Sydney FC,1098,1,21,4,3,68,24,44,67
N'castle Jet,1098,2,16,5,7,59,38,21,53
Melbourne C,1098,3,14,4,11,44,35,9,46
Melbourne V,1098,4,13,5,11,47,42,5,44
Adelaide Utd,1098,5,11,6,11,37,40,-3,39
Brisbane,1098,6,10,5,13,33,42,-9,35
Western Sydn,1098,7,8,9,10,38,47,-9,33
Perth Glory,1098,8,10,2,15,37,50,-13,32
Wellington P,1098,9,5,6,16,31,55,-24,21
CC Mariners,1098,10,4,8,15,28,49,-21,20
Sydney FC,1099,1,21,4,3,66,23,43,67
N'castle Jet,1099,2,16,5,7,60,38,22,53
Melbourne C,1099,3,14,4,11,44,36,8,46
Melbourne V,1099,4,13,5,11,46,40,6,44
Adelaide Utd,1099,5,11,6,11,37,40,-3,39
Brisbane,1099,6,10,5,13,33,42,-9,35
Western Sydn,1099,7,8,9,10,38,47,-9,33
Perth Glory,1099,8,10,2,15,37,50,-13,32
Wellington P,1099,9,5,6,16,31,55,-24,21
CC Mariners,1099,10,4,8,15,28,49,-21,20
Sydney FC,1100,1,21,4,3,68,22,46,67
N'castle Jet,1100,2,16,5,7,59,38,21,53
Melbourne C,1100,3,14,4,11,44,35,9,46
Melbourne V,1100,4,13,5,11,45,42,3,44
Adelaide Utd,1100,5,11,6,11,37,40,-3,39
Brisbane,1100,6,10,5,13,33,42,-9,35
Western Sydn,1100,7,8,9,10,38,47,-9,33
Perth Glory,1100,8,10,2,15,37,50,-13,32
Wellington P,1100,9,5,6,16,31,55,-24,21
CC Mariners,1100,10,4,8,15,28,49,-21,20
Sydney FC,1101,1,20,5,3,66,24,42,65
N'castle Jet,1101,2,16,5,7,61,37,24,53
Melbourne C,1101,3,14,4,11,43,37,6,46
Melbourne V,1101,4,13,6,10,47,40,7,45
Adelaide Utd,1101,5,11,6,11,37,40,-3,39
Brisbane,1101,6,10,5,13,33,42,-9,35
Western Sydn,1101,7,8,9,10,38,47,-9,33
Perth Glory,1101,8,10,2,15,37,50,-13,32
Wellington P,1101,9,5,6,16,31,55,-24,21
CC Mariners,1101,10,4,8,15,28,49,-21,20
Sydney FC,1102,1,21,4,3,66,23,43,67
N'castle Jet,1102,2,15,6,7,59,39,20,51
Melbourne C,1102,3,14,5,10,45,35,10,47
Melbourne V,1102,4,13,5,11,46,40,6,44
Adelaide Utd,1102,5,11,6,11,37,40,-3,39
Brisbane,1102,6,10,5,13,33,42,-9,35
Western Sydn,1102,7,8,9,10,38,47,-9,33
Perth Glory,1102,8,10,2,15,37,50,-13,32
Wellington P,1102,9,5,6,16,31,55,-24,21
CC Mariners,1102,10,4,8,15,28,49,-21,20
Sydney FC,1103,1,21,4,3,70,22,48,67
N'castle Jet,1103,2,16,5,7,60,38,22,53
Melbourne C,1103,3,14,4,11,44,36,8,46
Melbourne V,1103,4,13,5,11,45,44,1,44
Adelaide Utd,1103,5,11,6,11,37,40,-3,39
Brisbane,1103,6,10,5,13,33,42,-9,35
Western Sydn,1103,7,8,9,10,38,47,-9,33
Perth Glory,1103,8,10,2,15,37,50,-13,32
Wellington P,1103,9,5,6,16,31,55,-24,21
CC Mariners,1103,10,4,8,15,28,49,-21,20
Sydney FC,1104,1,21,4,3,65,22,43,67
N'castle Jet,1104,2,15,5,8,59,40,19,50
Melbourne C,1104,3,15,4,10,46,35,11,49
Melbourne V,1104,4,13,5,11,45,39,6,44
Adelaide Utd,1104,5,11,6,11,37,40,-3,39
Brisbane,1104,6,10,5,13,33,42,-9,35
Western Sydn,1104,7,8,9,10,38,47,-9,33
Perth Glory,1104,8,10,2,15,37,50,-13,32
Wellington P,1104,9,5,6,16,31,55,-24,21
CC Mariners,1104,10,4,8,15,28,49,-21,20
Sydney FC,1105,1,21,4,3,67,22,45,67
N'castle Jet,1105,2,15,5,8,57,38,19,50
Melbourne C,1105,3,15,4,10,44,33,11,49
Melbourne V,1105,4,13,5,11,45,41,4,44
Adelaide Utd,1105,5,11,6,11,37,40,-3,39
Brisbane,1105,6,10,5,13,33,42,-9,35
Western Sydn,1105,7,8,9,10,38,47,-9,33
Perth Glory,1105,8,10,2,15,37,50,-13,32
Wellington P,1105,9,5,6,16,31,55,-24,21
CC Mariners,1105,10,4,8,15,28,49,-21,20
Sydney FC,1106,1,21,4,3,65,22,43,67
N'castle Jet,1106,2,16,5,7,59,37,22,53
Melbourne C,1106,3,14,4,11,43,35,8,46
Melbourne V,1106,4,13,5,11,45,39,6,44
Adelaide Utd,1106,5,11,6,11,37,40,-3,39
Brisbane,1106,6,10,5,13,33,42,-9,35
Western Sydn,1106,7,8,9,10,38,47,-9,33
Perth Glory,1106,8,10,2,15,37,50,-13,32
Wellington P,1106,9,5,6,16,31,55,-24,21
CC Mariners,1106,10,4,8,15,28,49,-21,20
Sydney FC,1107,1,20,5,3,66,24,42,65
N'castle Jet,1107,2,16,5,7,59,37,22,53
Melbourne C,1107,3,14,4,11,43,35,8,46
Melbourne V,1107,4,13,6,10,47,40,7,45
Adelaide Utd,1107,5,11,6,11,37,40,-3,39
Brisbane,1107,6,10,5,13,33,42,-9,35
Western Sydn,1107,7,8,9,10,38,47,-9,33
Perth Glory,1107,8,10,2,15,37,50,-13,32
Wellington P,1107,9,5,6,16,31,55,-24,21
CC Mariners,1107,10,4,8,15,28,49,-21,20
Sydney FC,1108,1,21,4,3,68,25,43,67
N'castle Jet,1108,2,15,6,7,58,38,20,51
Melbourne C,1108,3,14,5,10,44,34,10,47
Melbourne V,1108,4,13,5,11,48,42,6,44
Adelaide Utd,1108,5,11,6,11,37,40,-3,39
Brisbane,1108,6,10,5,13,33,42,-9,35
Western Sydn,1108,7,8,9,10,38,47,-9,33
Perth Glory,1108,8,10,2,15,37,50,-13,32
Wellington P,1108,9,5,6,16,31,55,-24,21
CC Mariners,1108,10,4,8,15,28,49,-21,20
Sydney FC,1109,1,21,4,3,65,22,43,67
N'castle Jet,1109,2,15,5,8,57,39,18,50
Melbourne C,1109,3,15,4,10,45,33,12,49
Melbourne V,1109,4,13,5,11,45,39,6,44
Adelaide Utd,1109,5,11,6,11,37,40,-3,39
Brisbane,1109,6,10,5,13,33,42,-9,35
Western Sydn,1109,7,8,9,10,38,47,-9,33
Perth Glory,1109,8,10,2,15,37,50,-13,32
Wellington P,1109,9,5,6,16,31,55,-24,21
CC Mariners,1109,10,4,8,15,28,49,-21,20
Sydney FC,1110,1,21,4,3,68,22,46,67
N'castle Jet,1110,2,16,5,7,60,38,22,53
Melbourne C,1110,3,14,4,11,44,36,8,46
Melbourne V,1110,4,13,5,11,45,42,3,44
Adelaide Utd,1110,5,11,6,11,37,40,-3,39
Brisbane,1110,6,10,5,13,33,42,-9,35
Western Sydn,1110,7,8,9,10,38,47,-9,33
Perth Glory,1110,8,10,2,15,37,50,-13,32
Wellington P,1110,9,5,6,16,31,55,-24,21
CC Mariners,1110,10,4,8,15,28,49,-21,20
Sydney FC,1111,1,21,4,3,69,23,46,67
N'castle Jet,1111,2,15,5,8,57,41,16,50
Melbourne C,1111,3,15,4,10,47,33,14,49
Melbourne V,1111,4,13,5,11,46,43,3,44
Adelaide Utd,1111,5,11,6,11,37,40,-3,39
Brisbane,1111,6,10,5,13,33,42,-9,35
Western Sydn,1111,7,8,9,10,38,47,-9,33
Perth Glory,1111,8,10,2,15,37,50,-13,32
Wellington P,1111,9,5,6,16,31,55,-24,21
CC Mariners,1111,10,4,8,15,28,49,-21,20
Sydney FC,1112,1,20,5,3,67,25,42,65
N'castle Jet,1112,2,15,5,8,57,39,18,50
Melbourne C,1112,3,15,4,10,45,33,12,49
Melbourne V,1112,4,13,6,10,48,41,7,45
Adelaide Utd,1112,5,11,6,11,37,40,-3,39
Brisbane,1112,6,10,5,13,33,42,-9,35
Western Sydn,1112,7,8,9,10,38,47,-9,33
Perth Glory,1112,8,10,2,15,37,50,-13,32
Wellington P,1112,9,5,6,16,31,55,-24,21
CC Mariners,1112,10,4,8,15,28,49,-21,20
Sydney FC,1113,1,21,4,3,65,22,43,67
N'castle Jet,1113,2,15,6,7,58,38,20,51
Melbourne C,1113,3,14,5,10,44,34,10,47
Melbourne V,1113,4,13,5,11,45,39,6,44
Adelaide Utd,1113,5,11,6,11,37,40,-3,39
Brisbane,1113,6,10,5,13,33,42,-9,35
Western Sydn,1113,7,8,9,10,38,47,-9,33
Perth Glory,1113,8,10,2,15,37,50,-13,32
Wellington P,1113,9,5,6,16,31,55,-24,21
CC Mariners,1113,10,4,8,15,28,49,-21,20
Sydney FC,1114,1,21,4,3,65,22,43,67
N'castle Jet,1114,2,15,5,8,58,41,17,50
Melbourne C,1114,3,15,4,10,47,34,13,49
Melbourne V,1114,4,13,5,11,45,39,6,44
Adelaide Utd,1114,5,11,6,11,37,40,-3,39
Brisbane,1114,6,10,5,13,33,42,-9,35
Western Sydn,1114,7,8,9,10,38,47,-9,33
Perth Glory,1114,8,10,2,15,37,50,-13,32
Wellington P,1114,9,5,6,16,31,55,-24,21
CC Mariners,1114,10,4,8,15,28,49,-21,20
Sydney FC,1115,1,21,4,3,65,22,43,67
N'castle Jet,1115,2,15,5,8,57,40,17,50
Melbourne C,1115,3,15,4,10,46,33,13,49
Melbourne V,1115,4,13,5,11,45,39,6,44
Adelaide Utd,1115,5,11,6,11,37,40,-3,39
Brisbane,1115,6,10,5,13,33,42,-9,35
Western Sydn,1115,7,8,9,10,38,47,-9,33
Perth Glory,1115,8,10,2,15,37,50,-13,32
Wellington P,1115,9,5,6,16,31,55,-24,21
CC Mariners,1115,10,4,8,15,28,49,-21,20
Sydney FC,1116,1,21,4,3,67,23,44,67
N'castle Jet,1116,2,16,5,7,58,37,21,53
Melbourne C,1116,3,14,4,11,43,34,9,46
Melbourne V,1116,4,13,5,11,46,41,5,44
Adelaide Utd,1116,5,11,6,11,37,40,-3,39
Brisbane,1116,6,10,5,13,33,42,-9,35
Western Sydn,1116,7,8,9,10,38,47,-9,33
Perth Glory,1116,8,10,2,15,37,50,-13,32
Wellington P,1116,9,5,6,16,31,55,-24,21
CC Mariners,1116,10,4,8,15,28,49,-21,20
Sydney FC,1117,1,21,4,3,67,24,43,67
N'castle Jet,1117,2,15,6,7,58,38,20,51
Melbourne C,1117,3,14,5,10,44,34,10,47
Melbourne V,1117,4,13,5,11,47,41,6,44
Adelaide Utd,1117,5,11,6,11,37,40,-3,39
Brisbane,1117,6,10,5,13,33,42,-9,35
Western Sydn,1117,7,8,9,10,38,47,-9,33
Perth Glory,1117,8,10,2,15,37,50,-13,32
Wellington P,1117,9,5,6,16,31,55,-24,21
CC Mariners,1117,10,4,8,15,28,49,-21,20
Sydney FC,1118,1,21,4,3,66,22,44,67
N'castle Jet,1118,2,15,6,7,58,38,20,51
Melbourne C,1118,3,14,5,10,44,34,10,47
Melbourne V,1118,4,13,5,11,45,40,5,44
Adelaide Utd,1118,5,11,6,11,37,40,-3,39
Brisbane,1118,6,10,5,13,33,42,-9,35
Western Sydn,1118,7,8,9,10,38,47,-9,33
Perth Glory,1118,8,10,2,15,37,50,-13,32
Wellington P,1118,9,5,6,16,31,55,-24,21
CC Mariners,1118,10,4,8,15,28,49,-21,20
Sydney FC,1119,1,20,5,3,65,23,42,65
N'castle Jet,1119,2,16,5,7,58,37,21,53
Melbourne C,1119,3,14,4,11,43,34,9,46
Melbourne V,1119,4,13,6,10,46,39,7,45
Adelaide Utd,1119,5,11,6,11,37,40,-3,39
Brisbane,1119,6,10,5,13,33,42,-9,35
Western Sydn,1119,7,8,9,10,38,47,-9,33
Perth Glory,1119,8,10,2,15,37,50,-13,32
Wellington P,1119,9,5,6,16,31,55,-24,21
CC Mariners,1119,10,4,8,15,28,49,-21,20
Sydney FC,1120,1,21,4,3,67,23,44,67
N'castle Jet,1120,2,15,6,7,59,39,20,51
Melbourne C,1120,3,14,5,10,45,35,10,47
Melbourne V,1120,4,13,5,11,46,41,5,44
Adelaide Utd,1120,5,11,6,11,37,40,-3,39
Brisbane,1120,6,10,5,13,33,42,-9,35
Western Sydn,1120,7,8,9,10,38,47,-9,33
Perth Glory,1120,8,10,2,15,37,50,-13,32
Wellington P,1120,9,5,6,16,31,55,-24,21
CC Mariners,1120,10,4,8,15,28,49,-21,20
Sydney FC,1121,1,20,4,4,64,26,38,64
N'castle Jet,1121,2,15,5,8,57,38,19,50
Melbourne C,1121,3,15,4,10,44,33,11,49
Melbourne V,1121,4,14,5,10,49,38,11,47
Adelaide Utd,1121,5,11,6,11,37,40,-3,39
Brisbane,1121,6,10,5,13,33,42,-9,35
Western Sydn,1121,7,8,9,10,38,47,-9,33
Perth Glory,1121,8,10,2,15,37,50,-13,32
Wellington P,1121,9,5,6,16,31,55,-24,21
CC Mariners,1121,10,4,8,15,28,49,-21,20
Sydney FC,1122,1,21,4,3,67,23,44,67
N'castle Jet,1122,2,16,5,7,63,38,25,53
Melbourne C,1122,3,14,4,11,44,39,5,46
Melbourne V,1122,4,13,5,11,46,41,5,44
Adelaide Utd,1122,5,11,6,11,37,40,-3,39
Brisbane,1122,6,10,5,13,33,42,-9,35
Western Sydn,1122,7,8,9,10,38,47,-9,33
Perth Glory,1122,8,10,2,15,37,50,-13,32
Wellington P,1122,9,5,6,16,31,55,-24,21
CC Mariners,1122,10,4,8,15,28,49,-21,20
Sydney FC,1123,1,21,4,3,66,22,44,67
N'castle Jet,1123,2,15,6,7,58,38,20,51
Melbourne C,1123,3,14,5,10,44,34,10,47
Melbourne V,1123,4,13,5,11,45,40,5,44
Adelaide Utd,1123,5,11,6,11,37,40,-3,39
Brisbane,1123,6,10,5,13,33,42,-9,35
Western Sydn,1123,7,8,9,10,38,47,-9,33
Perth Glory,1123,8,10,2,15,37,50,-13,32
Wellington P,1123,9,5,6,16,31,55,-24,21
CC Mariners,1123,10,4,8,15,28,49,-21,20
Sydney FC,1124,1,20,4,4,65,24,41,64
N'castle Jet,1124,2,16,5,7,58,37,21,53
Melbourne V,1124,3,14,5,10,47,39,8,47
Melbourne C,1124,4,14,4,11,43,34,9,46
Adelaide Utd,1124,5,11,6,11,37,40,-3,39
Brisbane,1124,6,10,5,13,33,42,-9,35
Western Sydn,1124,7,8,9,10,38,47,-9,33
Perth Glory,1124,8,10,2,15,37,50,-13,32
Wellington P,1124,9,5,6,16,31,55,-24,21
CC Mariners,1124,10,4,8,15,28,49,-21,20
Sydney FC,1125,1,21,4,3,69,24,45,67
N'castle Jet,1125,2,15,5,8,59,40,19,50
Melbourne C,1125,3,15,4,10,46,35,11,49
Melbourne V,1125,4,13,5,11,47,43,4,44
Adelaide Utd,1125,5,11,6,11,37,40,-3,39
Brisbane,1125,6,10,5,13,33,42,-9,35
Western Sydn,1125,7,8,9,10,38,47,-9,33
Perth Glory,1125,8,10,2,15,37,50,-13,32
Wellington P,1125,9,5,6,16,31,55,-24,21
CC Mariners,1125,10,4,8,15,28,49,-21,20
Sydney FC,1126,1,20,5,3,65,23,42,65
N'castle Jet,1126,2,15,6,7,57,37,20,51
Melbourne C,1126,3,14,5,10,43,33,10,47
Melbourne V,1126,4,13,6,10,46,39,7,45
Adelaide Utd,1126,5,11,6,11,37,40,-3,39
Brisbane,1126,6,10,5,13,33,42,-9,35
Western Sydn,1126,7,8,9,10,38,47,-9,33
Perth Glory,1126,8,10,2,15,37,50,-13,32
Wellington P,1126,9,5,6,16,31,55,-24,21
CC Mariners,1126,10,4,8,15,28,49,-21,20
Sydney FC,1127,1,20,5,3,65,23,42,65
N'castle Jet,1127,2,15,6,7,57,37,20,51
Melbourne C,1127,3,14,5,10,43,33,10,47
Melbourne V,1127,4,13,6,10,46,39,7,45
Adelaide Utd,1127,5,11,6,11,37,40,-3,39
Brisbane,1127,6,10,5,13,33,42,-9,35
Western Sydn,1127,7,8,9,10,38,47,-9,33
Perth Glory,1127,8,10,2,15,37,50,-13,32
Wellington P,1127,9,5,6,16,31,55,-24,21
CC Mariners,1127,10,4,8,15,28,49,-21,20
Sydney FC,1128,1,20,4,4,65,24,41,64
N'castle Jet,1128,2,16,5,7,60,39,21,53
Melbourne V,1128,3,14,5,10,47,39,8,47
Melbourne C,1128,4,14,4,11,45,36,9,46
Adelaide Utd,1128,5,11,6,11,37,40,-3,39
Brisbane,1128,6,10,5,13,33,42,-9,35
Western Sydn,1128,7,8,9,10,38,47,-9,33
Perth Glory,1128,8,10,2,15,37,50,-13,32
Wellington P,1128,9,5,6,16,31,55,-24,21
CC Mariners,1128,10,4,8,15,28,49,-21,20
Sydney FC,1129,1,21,4,3,65,22,43,67
N'castle Jet,1129,2,16,5,7,58,37,21,53
Melbourne C,1129,3,14,4,11,43,34,9,46
Melbourne V,1129,4,13,5,11,45,39,6,44
Adelaide Utd,1129,5,11,6,11,37,40,-3,39
Brisbane,1129,6,10,5,13,33,42,-9,35
Western Sydn,1129,7,8,9,10,38,47,-9,33
Perth Glory,1129,8,10,2,15,37,50,-13,32
Wellington P,1129,9,5,6,16,31,55,-24,21
CC Mariners,1129,10,4,8,15,28,49,-21,20
Sydney FC,1130,1,21,4,3,68,23,45,67
N'castle Jet,1130,2,15,6,7,58,38,20,51
Melbourne C,1130,3,14,5,10,44,34,10,47
Melbourne V,1130,4,13,5,11,46,42,4,44
Adelaide Utd,1130,5,11,6,11,37,40,-3,39
Brisbane,1130,6,10,5,13,33,42,-9,35
Western Sydn,1130,7,8,9,10,38,47,-9,33
Perth Glory,1130,8,10,2,15,37,50,-13,32
Wellington P,1130,9,5,6,16,31,55,-24,21
CC Mariners,1130,10,4,8,15,28,49,-21,20
Sydney FC,1131,1,20,4,4,64,23,41,64
N'castle Jet,1131,2,15,5,8,57,38,19,50
Melbourne C,1131,3,15,4,10,44,33,11,49
Melbourne V,1131,4,14,5,10,46,38,8,47
Adelaide Utd,1131,5,11,6,11,37,40,-3,39
Brisbane,1131,6,10,5,13,33,42,-9,35
Western Sydn,1131,7,8,9,10,38,47,-9,33
Perth Glory,1131,8,10,2,15,37,50,-13,32
Wellington P,1131,9,5,6,16,31,55,-24,21
CC Mariners,1131,10,4,8,15,28,49,-21,20
Sydney FC,1132,1,20,5,3,66,24,42,65
N'castle Jet,1132,2,15,5,8,57,38,19,50
Melbourne C,1132,3,15,4,10,44,33,11,49
Melbourne V,1132,4,13,6,10,47,40,7,45
Adelaide Utd,1132,5,11,6,11,37,40,-3,39
Brisbane,1132,6,10,5,13,33,42,-9,35
Western Sydn,1132,7,8,9,10,38,47,-9,33
Perth Glory,1132,8,10,2,15,37,50,-13,32
Wellington P,1132,9,5,6,16,31,55,-24,21
CC Mariners,1132,10,4,8,15,28,49,-21,20
Sydney FC,1133,1,21,4,3,65,22,43,67
N'castle Jet,1133,2,15,5,8,57,40,17,50
Melbourne C,1133,3,15,4,10,46,33,13,49
Melbourne V,1133,4,13,5,11,45,39,6,44
Adelaide Utd,1133,5,11,6,11,37,40,-3,39
Brisbane,1133,6,10,5,13,33,42,-9,35
Western Sydn,1133,7,8,9,10,38,47,-9,33
Perth Glory,1133,8,10,2,15,37,50,-13,32
Wellington P,1133,9,5,6,16,31,55,-24,21
CC Mariners,1133,10,4,8,15,28,49,-21,20
Sydney FC,1134,1,20,4,4,64,23,41,64
N'castle Jet,1134,2,16,5,7,59,37,22,53
Melbourne V,1134,3,14,5,10,46,38,8,47
Melbourne C,1134,4,14,4,11,43,35,8,46
Adelaide Utd,1134,5,11,6,11,37,40,-3,39
Brisbane,1134,6,10,5,13,33,42,-9,35
Western Sydn,1134,7,8,9,10,38,47,-9,33
Perth Glory,1134,8,10,2,15,37,50,-13,32
Wellington P,1134,9,5,6,16,31,55,-24,21
CC Mariners,1134,10,4,8,15,28,49,-21,20
Sydney FC,1135,1,21,4,3,65,22,43,67
N'castle Jet,1135,2,15,5,8,58,40,18,50
Melbourne C,1135,3,15,4,10,46,34,12,49
Melbourne V,1135,4,13,5,11,45,39,6,44
Adelaide Utd,1135,5,11,6,11,37,40,-3,39
Brisbane,1135,6,10,5,13,33,42,-9,35
Western Sydn,1135,7,8,9,10,38,47,-9,33
Perth Glory,1135,8,10,2,15,37,50,-13,32
Wellington P,1135,9,5,6,16,31,55,-24,21
CC Mariners,1135,10,4,8,15,28,49,-21,20
Sydney FC,1136,1,21,4,3,67,24,43,67
N'castle Jet,1136,2,15,5,8,58,39,19,50
Melbourne C,1136,3,15,4,10,45,34,11,49
Melbourne V,1136,4,13,5,11,47,41,6,44
Adelaide Utd,1136,5,11,6,11,37,40,-3,39
Brisbane,1136,6,10,5,13,33,42,-9,35
Western Sydn,1136,7,8,9,10,38,47,-9,33
Perth Glory,1136,8,10,2,15,37,50,-13,32
Wellington P,1136,9,5,6,16,31,55,-24,21
CC Mariners,1136,10,4,8,15,28,49,-21,20
Sydney FC,1137,1,21,4,3,69,24,45,67
N'castle Jet,1137,2,16,5,7,59,38,21,53
Melbourne C,1137,3,14,4,11,44,35,9,46
Melbourne V,1137,4,13,5,11,47,43,4,44
Adelaide Utd,1137,5,11,6,11,37,40,-3,39
Brisbane,1137,6,10,5,13,33,42,-9,35
Western Sydn,1137,7,8,9,10,38,47,-9,33
Perth Glory,1137,8,10,2,15,37,50,-13,32
Wellington P,1137,9,5,6,16,31,55,-24,21
CC Mariners,1137,10,4,8,15,28,49,-21,20
Sydney FC,1138,1,21,4,3,68,23,45,67
N'castle Jet,1138,2,15,6,7,58,38,20,51
Melbourne C,1138,3,14,5,10,44,34,10,47
Melbourne V,1138,4,13,5,11,46,42,4,44
Adelaide Utd,1138,5,11,6,11,37,40,-3,39
Brisbane,1138,6,10,5,13,33,42,-9,35
Western Sydn,1138,7,8,9,10,38,47,-9,33
Perth Glory,1138,8,10,2,15,37,50,-13,32
Wellington P,1138,9,5,6,16,31,55,-24,21
CC Mariners,1138,10,4,8,15,28,49,-21,20
Sydney FC,1139,1,21,4,3,68,22,46,67
N'castle Jet,1139,2,15,6,7,58,38,20,51
Melbourne C,1139,3,14,5,10,44,34,10,47
Melbourne V,1139,4,13,5,11,45,42,3,44
Adelaide Utd,1139,5,11,6,11,37,40,-3,39
Brisbane,1139,6,10,5,13,33,42,-9,35
Western Sydn,1139,7,8,9,10,38,47,-9,33
Perth Glory,1139,8,10,2,15,37,50,-13,32
Wellington P,1139,9,5,6,16,31,55,-24,21
CC Mariners,1139,10,4,8,15,28,49,-21,20
Sydney FC,1140,1,20,5,3,65,23,42,65
N'castle Jet,1140,2,15,5,8,58,39,19,50
Melbourne C,1140,3,15,4,10,45,34,11,49
Melbourne V,1140,4,13,6,10,46,39,7,45
Adelaide Utd,1140,5,11,6,11,37,40,-3,39
Brisbane,1140,6,10,5,13,33,42,-9,35
Western Sydn,1140,7,8,9,10,38,47,-9,33
Perth Glory,1140,8,10,2,15,37,50,-13,32
Wellington P,1140,9,5,6,16,31,55,-24,21
CC Mariners,1140,10,4,8,15,28,49,-21,20
Sydney FC,1141,1,21,4,3,65,22,43,67
N'castle Jet,1141,2,15,6,7,58,38,20,51
Melbourne C,1141,3,14,5,10,44,34,10,47
Melbourne V,1141,4,13,5,11,45,39,6,44
Adelaide Utd,1141,5,11,6,11,37,40,-3,39
Brisbane,1141,6,10,5,13,33,42,-9,35
Western Sydn,1141,7,8,9,10,38,47,-9,33
Perth Glory,1141,8,10,2,15,37,50,-13,32
Wellington P,1141,9,5,6,16,31,55,-24,21
CC Mariners,1141,10,4,8,15,28,49,-21,20
Sydney FC,1142,1,21,4,3,66,22,44,67
N'castle Jet,1142,2,16,5,7,59,38,21,53
Melbourne C,1142,3,14,4,11,44,35,9,46
Melbourne V,1142,4,13,5,11,45,40,5,44
Adelaide Utd,1142,5,11,6,11,37,40,-3,39
Brisbane,1142,6,10,5,13,33,42,-9,35
Western Sydn,1142,7,8,9,10,38,47,-9,33
Perth Glory,1142,8,10,2,15,37,50,-13,32
Wellington P,1142,9,5,6,16,31,55,-24,21
CC Mariners,1142,10,4,8,15,28,49,-21,20
Sydney FC,1143,1,20,5,3,64,22,42,65
N'castle Jet,1143,2,15,6,7,58,38,20,51
Melbourne C,1143,3,14,5,10,44,34,10,47
Melbourne V,1143,4,13,6,10,45,38,7,45
Adelaide Utd,1143,5,11,6,11,37,40,-3,39
Brisbane,1143,6,10,5,13,33,42,-9,35
Western Sydn,1143,7,8,9,10,38,47,-9,33
Perth Glory,1143,8,10,2,15,37,50,-13,32
Wellington P,1143,9,5,6,16,31,55,-24,21
CC Mariners,1143,10,4,8,15,28,49,-21,20
Sydney FC,1144,1,21,4,3,66,23,43,67
N'castle Jet,1144,2,16,5,7,59,37,22,53
Melbourne C,1144,3,14,4,11,43,35,8,46
Melbourne V,1144,4,13,5,11,46,40,6,44
Adelaide Utd,1144,5,11,6,11,37,40,-3,39
Brisbane,1144,6,10,5,13,33,42,-9,35
Western Sydn,1144,7,8,9,10,38,47,-9,33
Perth Glory,1144,8,10,2,15,37,50,-13,32
Wellington P,1144,9,5,6,16,31,55,-24,21
CC Mariners,1144,10,4,8,15,28,49,-21,20
Sydney FC,1145,1,20,4,4,65,24,41,64
N'castle Jet,1145,2,16,5,7,63,38,25,53
Melbourne V,1145,3,14,5,10,47,39,8,47
Melbourne C,1145,4,14,4,11,44,39,5,46
Adelaide Utd,1145,5,11,6,11,37,40,-3,39
Brisbane,1145,6,10,5,13,33,42,-9,35
Western Sydn,1145,7,8,9,10,38,47,-9,33
Perth Glory,1145,8,10,2,15,37,50,-13,32
Wellington P,1145,9,5,6,16,31,55,-24,21
CC Mariners,1145,10,4,8,15,28,49,-21,20
Sydney FC,1146,1,21,4,3,65,22,43,67
N'castle Jet,1146,2,16,5,7,60,39,21,53
Melbourne C,1146,3,14,4,11,45,36,9,46
Melbourne V,1146,4,13,5,11,45,39,6,44
Adelaide Utd,1146,5,11,6,11,37,40,-3,39
Brisbane,1146,6,10,5,13,33,42,-9,35
Western Sydn,1146,7,8,9,10,38,47,-9,33
Perth Glory,1146,8,10,2,15,37,50,-13,32
Wellington P,1146,9,5,6,16,31,55,-24,21
CC Mariners,1146,10,4,8,15,28,49,-21,20
Sydney FC,1147,1,21,4,3,68,22,46,67
N'castle Jet,1147,2,15,5,8,58,40,18,50
Melbourne C,1147,3,15,4,10,46,34,12,49
Melbourne V,1147,4,13,5,11,45,42,3,44
Adelaide Utd,1147,5,11,6,11,37,40,-3,39
Brisbane,1147,6,10,5,13,33,42,-9,35
Western Sydn,1147,7,8,9,10,38,47,-9,33
Perth Glory,1147,8,10,2,15,37,50,-13,32
Wellington P,1147,9,5,6,16,31,55,-24,21
CC Mariners,1147,10,4,8,15,28,49,-21,20
Sydney FC,1148,1,21,4,3,66,23,43,67
N'castle Jet,1148,2,15,6,7,58,38,20,51
Melbourne C,1148,3,14,5,10,44,34,10,47
Melbourne V,1148,4,13,5,11,46,40,6,44
Adelaide Utd,1148,5,11,6,11,37,40,-3,39
Brisbane,1148,6,10,5,13,33,42,-9,35
Western Sydn,1148,7,8,9,10,38,47,-9,33
Perth Glory,1148,8,10,2,15,37,50,-13,32
Wellington P,1148,9,5,6,16,31,55,-24,21
CC Mariners,1148,10,4,8,15,28,49,-21,20
Sydney FC,1149,1,21,4,3,66,23,43,67
N'castle Jet,1149,2,15,5,8,58,39,19,50
Melbourne C,1149,3,15,4,10,45,34,11,49
Melbourne V,1149,4,13,5,11,46,40,6,44
Adelaide Utd,1149,5,11,6,11,37,40,-3,39
Brisbane,1149,6,10,5,13,33,42,-9,35
Western Sydn,1149,7,8,9,10,38,47,-9,33
Perth Glory,1149,8,10,2,15,37,50,-13,32
Wellington P,1149,9,5,6,16,31,55,-24,21
CC Mariners,1149,10,4,8,15,28,49,-21,20
Sydney FC,1150,1,20,4,4,64,23,41,64
N'castle Jet,1150,2,16,5,7,62,40,22,53
Melbourne V,1150,3,14,5,10,46,38,8,47
Melbourne C,1150,4,14,4,11,46,38,8,46
Adelaide Utd,1150,5,11,6,11,37,40,-3,39
Brisbane,1150,6,10,5,13,33,42,-9,35
Western Sydn,1150,7,8,9,10,38,47,-9,33
Perth Glory,1150,8,10,2,15,37,50,-13,32
Wellington P,1150,9,5,6,16,31,55,-24,21
CC Mariners,1150,10,4,8,15,28,49,-21,20
Sydney FC,1151,1,21,4,3,67,22,45,67
N'castle Jet,1151,2,16,5,7,58,37,21,53
Melbourne C,1151,3,14,4,11,43,34,9,46
Melbourne V,1151,4,13,5,11,45,41,4,44
Adelaide Utd,1151,5,11,6,11,37,40,-3,39
Brisbane,1151,6,10,5,13,33,42,-9,35
Western Sydn,1151,7,8,9,10,38,47,-9,33
Perth Glory,1151,8,10,2,15,37,50,-13,32
Wellington P,1151,9,5,6,16,31,55,-24,21
CC Mariners,1151,10,4,8,15,28,49,-21,20
Sydney FC,1152,1,20,5,3,65,23,42,65
N'castle Jet,1152,2,16,5,7,58,37,21,53
Melbourne C,1152,3,14,4,11,43,34,9,46
Melbourne V,1152,4,13,6,10,46,39,7,45
Adelaide Utd,1152,5,11,6,11,37,40,-3,39
Brisbane,1152,6,10,5,13,33,42,-9,35
Western Sydn,1152,7,8,9,10,38,47,-9,33
Perth Glory,1152,8,10,2,15,37,50,-13,32
Wellington P,1152,9,5,6,16,31,55,-24,21
CC Mariners,1152,10,4,8,15,28,49,-21,20
Sydney FC,1153,1,21,4,3,66,22,44,67
N'castle Jet,1153,2,15,6,7,58,38,20,51
Melbourne C,1153,3,14,5,10,44,34,10,47
Melbourne V,1153,4,13,5,11,45,40,5,44
Adelaide Utd,1153,5,11,6,11,37,40,-3,39
Brisbane,1153,6,10,5,13,33,42,-9,35
Western Sydn,1153,7,8,9,10,38,47,-9,33
Perth Glory,1153,8,10,2,15,37,50,-13,32
Wellington P,1153,9,5,6,16,31,55,-24,21
CC Mariners,1153,10,4,8,15,28,49,-21,20
Sydney FC,1154,1,21,4,3,65,22,43,67
N'castle Jet,1154,2,16,5,7,59,38,21,53
Melbourne C,1154,3,14,4,11,44,35,9,46
Melbourne V,1154,4,13,5,11,45,39,6,44
Adelaide Utd,1154,5,11,6,11,37,40,-3,39
Brisbane,1154,6,10,5,13,33,42,-9,35
Western Sydn,1154,7,8,9,10,38,47,-9,33
Perth Glory,1154,8,10,2,15,37,50,-13,32
Wellington P,1154,9,5,6,16,31,55,-24,21
CC Mariners,1154,10,4,8,15,28,49,-21,20
Sydney FC,1155,1,20,5,3,65,23,42,65
N'castle Jet,1155,2,16,5,7,59,37,22,53
Melbourne C,1155,3,14,4,11,43,35,8,46
Melbourne V,1155,4,13,6,10,46,39,7,45
Adelaide Utd,1155,5,11,6,11,37,40,-3,39
Brisbane,1155,6,10,5,13,33,42,-9,35
Western Sydn,1155,7,8,9,10,38,47,-9,33
Perth Glory,1155,8,10,2,15,37,50,-13,32
Wellington P,1155,9,5,6,16,31,55,-24,21
CC Mariners,1155,10,4,8,15,28,49,-21,20
Sydney FC,1156,1,20,4,4,64,23,41,64
N'castle Jet,1156,2,15,6,7,58,38,20,51
Melbourne C,1156,3,14,5,10,44,34,10,47
Melbourne V,1156,4,14,5,10,46,38,8,47
Adelaide Utd,1156,5,11,6,11,37,40,-3,39
Brisbane,1156,6,10,5,13,33,42,-9,35
Western Sydn,1156,7,8,9,10,38,47,-9,33
Perth Glory,1156,8,10,2,15,37,50,-13,32
Wellington P,1156,9,5,6,16,31,55,-24,21
CC Mariners,1156,10,4,8,15,28,49,-21,20
Sydney FC,1157,1,21,4,3,68,22,46,67
N'castle Jet,1157,2,16,5,7,59,37,22,53
Melbourne C,1157,3,14,4,11,43,35,8,46
Melbourne V,1157,4,13,5,11,45,42,3,44
Adelaide Utd,1157,5,11,6,11,37,40,-3,39
Brisbane,1157,6,10,5,13,33,42,-9,35
Western Sydn,1157,7,8,9,10,38,47,-9,33
Perth Glory,1157,8,10,2,15,37,50,-13,32
Wellington P,1157,9,5,6,16,31,55,-24,21
CC Mariners,1157,10,4,8,15,28,49,-21,20
Sydney FC,1158,1,21,4,3,65,22,43,67
N'castle Jet,1158,2,15,5,8,58,39,19,50
Melbourne C,1158,3,15,4,10,45,34,11,49
Melbourne V,1158,4,13,5,11,45,39,6,44
Adelaide Utd,1158,5,11,6,11,37,40,-3,39
Brisbane,1158,6,10,5,13,33,42,-9,35
Western Sydn,1158,7,8,9,10,38,47,-9,33
Perth Glory,1158,8,10,2,15,37,50,-13,32
Wellington P,1158,9,5,6,16,31,55,-24,21
CC Mariners,1158,10,4,8,15,28,49,-21,20
Sydney FC,1159,1,21,4,3,68,23,45,67
N'castle Jet,1159,2,16,5,7,61,38,23,53
Melbourne C,1159,3,14,4,11,44,37,7,46
Melbourne V,1159,4,13,5,11,46,42,4,44
Adelaide Utd,1159,5,11,6,11,37,40,-3,39
Brisbane,1159,6,10,5,13,33,42,-9,35
Western Sydn,1159,7,8,9,10,38,47,-9,33
Perth Glory,1159,8,10,2,15,37,50,-13,32
Wellington P,1159,9,5,6,16,31,55,-24,21
CC Mariners,1159,10,4,8,15,28,49,-21,20
Sydney FC,1160,1,21,4,3,66,22,44,67
N'castle Jet,1160,2,15,6,7,58,38,20,51
Melbourne C,1160,3,14,5,10,44,34,10,47
Melbourne V,1160,4,13,5,11,45,40,5,44
Adelaide Utd,1160,5,11,6,11,37,40,-3,39
Brisbane,1160,6,10,5,13,33,42,-9,35
Western Sydn,1160,7,8,9,10,38,47,-9,33
Perth Glory,1160,8,10,2,15,37,50,-13,32
Wellington P,1160,9,5,6,16,31,55,-24,21
CC Mariners,1160,10,4,8,15,28,49,-21,20
Sydney FC,1161,1,21,4,3,65,22,43,67
N'castle Jet,1161,2,16,5,7,60,37,23,53
Melbourne C,1161,3,14,4,11,43,36,7,46
Melbourne V,1161,4,13,5,11,45,39,6,44
Adelaide Utd,1161,5,11,6,11,37,40,-3,39
Brisbane,1161,6,10,5,13,33,42,-9,35
Western Sydn,1161,7,8,9,10,38,47,-9,33
Perth Glory,1161,8,10,2,15,37,50,-13,32
Wellington P,1161,9,5,6,16,31,55,-24,21
CC Mariners,1161,10,4,8,15,28,49,-21,20
Sydney FC,1162,1,21,4,3,66,23,43,67
N'castle Jet,1162,2,15,5,8,57,39,18,50
Melbourne C,1162,3,15,4,10,45,33,12,49
Melbourne V,1162,4,13,5,11,46,40,6,44
Adelaide Utd,1162,5,11,6,11,37,40,-3,39
Brisbane,1162,6,10,5,13,33,42,-9,35
Western Sydn,1162,7,8,9,10,38,47,-9,33
Perth Glory,1162,8,10,2,15,37,50,-13,32
Wellington P,1162,9,5,6,16,31,55,-24,21
CC Mariners,1162,10,4,8,15,28,49,-21,20
Sydney FC,1163,1,21,4,3,66,22,44,67
N'castle Jet,1163,2,16,5,7,59,38,21,53
Melbourne C,1163,3,14,4,11,44,35,9,46
Melbourne V,1163,4,13,5,11,45,40,5,44
Adelaide Utd,1163,5,11,6,11,37,40,-3,39
Brisbane,1163,6,10,5,13,33,42,-9,35
Western Sydn,1163,7,8,9,10,38,47,-9,33
Perth Glory,1163,8,10,2,15,37,50,-13,32
Wellington P,1163,9,5,6,16,31,55,-24,21
CC Mariners,1163,10,4,8,15,28,49,-21,20
Sydney FC,1164,1,21,4,3,65,22,43,67
N'castle Jet,1164,2,16,5,7,60,39,21,53
Melbourne C,1164,3,14,4,11,45,36,9,46
Melbourne V,1164,4,13,5,11,45,39,6,44
Adelaide Utd,1164,5,11,6,11,37,40,-3,39
Brisbane,1164,6,10,5,13,33,42,-9,35
Western Sydn,1164,7,8,9,10,38,47,-9,33
Perth Glory,1164,8,10,2,15,37,50,-13,32
Wellington P,1164,9,5,6,16,31,55,-24,21
CC Mariners,1164,10,4,8,15,28,49,-21,20
Sydney FC,1165,1,21,4,3,68,22,46,67
N'castle Jet,1165,2,15,5,8,57,38,19,50
Melbourne C,1165,3,15,4,10,44,33,11,49
Melbourne V,1165,4,13,5,11,45,42,3,44
Adelaide Utd,1165,5,11,6,11,37,40,-3,39
Brisbane,1165,6,10,5,13,33,42,-9,35
Western Sydn,1165,7,8,9,10,38,47,-9,33
Perth Glory,1165,8,10,2,15,37,50,-13,32
Wellington P,1165,9,5,6,16,31,55,-24,21
CC Mariners,1165,10,4,8,15,28,49,-21,20
Sydney FC,1166,1,21,4,3,69,23,46,67
N'castle Jet,1166,2,15,6,7,58,38,20,51
Melbourne C,1166,3,14,5,10,44,34,10,47
Melbourne V,1166,4,13,5,11,46,43,3,44
Adelaide Utd,1166,5,11,6,11,37,40,-3,39
Brisbane,1166,6,10,5,13,33,42,-9,35
Western Sydn,1166,7,8,9,10,38,47,-9,33
Perth Glory,1166,8,10,2,15,37,50,-13,32
Wellington P,1166,9,5,6,16,31,55,-24,21
CC Mariners,1166,10,4,8,15,28,49,-21,20
Sydney FC,1167,1,21,4,3,66,22,44,67
N'castle Jet,1167,2,15,6,7,58,38,20,51
Melbourne C,1167,3,14,5,10,44,34,10,47
Melbourne V,1167,4,13,5,11,45,40,5,44
Adelaide Utd,1167,5,11,6,11,37,40,-3,39
Brisbane,1167,6,10,5,13,33,42,-9,35
Western Sydn,1167,7,8,9,10,38,47,-9,33
Perth Glory,1167,8,10,2,15,37,50,-13,32
Wellington P,1167,9,5,6,16,31,55,-24,21
CC Mariners,1167,10,4,8,15,28,49,-21,20
Sydney FC,1168,1,20,5,3,66,24,42,65
N'castle Jet,1168,2,15,5,8,58,40,18,50
Melbourne C,1168,3,15,4,10,46,34,12,49
Melbourne V,1168,4,13,6,10,47,40,7,45
Adelaide Utd,1168,5,11,6,11,37,40,-3,39
Brisbane,1168,6,10,5,13,33,42,-9,35
Western Sydn,1168,7,8,9,10,38,47,-9,33
Perth Glory,1168,8,10,2,15,37,50,-13,32
Wellington P,1168,9,5,6,16,31,55,-24,21
CC Mariners,1168,10,4,8,15,28,49,-21,20
Sydney FC,1169,1,21,4,3,65,22,43,67
N'castle Jet,1169,2,16,5,7,60,37,23,53
Melbourne C,1169,3,14,4,11,43,36,7,46
Melbourne V,1169,4,13,5,11,45,39,6,44
Adelaide Utd,1169,5,11,6,11,37,40,-3,39
Brisbane,1169,6,10,5,13,33,42,-9,35
Western Sydn,1169,7,8,9,10,38,47,-9,33
Perth Glory,1169,8,10,2,15,37,50,-13,32
Wellington P,1169,9,5,6,16,31,55,-24,21
CC Mariners,1169,10,4,8,15,28,49,-21,20
Sydney FC,1170,1,21,4,3,66,23,43,67
N'castle Jet,1170,2,15,5,8,57,39,18,50
Melbourne C,1170,3,15,4,10,45,33,12,49
Melbourne V,1170,4,13,5,11,46,40,6,44
Adelaide Utd,1170,5,11,6,11,37,40,-3,39
Brisbane,1170,6,10,5,13,33,42,-9,35
Western Sydn,1170,7,8,9,10,38,47,-9,33
Perth Glory,1170,8,10,2,15,37,50,-13,32
Wellington P,1170,9,5,6,16,31,55,-24,21
CC Mariners,1170,10,4,8,15,28,49,-21,20
Sydney FC,1171,1,20,5,3,66,24,42,65
N'castle Jet,1171,2,16,5,7,58,37,21,53
Melbourne C,1171,3,14,4,11,43,34,9,46
Melbourne V,1171,4,13,6,10,47,40,7,45
Adelaide Utd,1171,5,11,6,11,37,40,-3,39
Brisbane,1171,6,10,5,13,33,42,-9,35
Western Sydn,1171,7,8,9,10,38,47,-9,33
Perth Glory,1171,8,10,2,15,37,50,-13,32
Wellington P,1171,9,5,6,16,31,55,-24,21
CC Mariners,1171,10,4,8,15,28,49,-21,20
Sydney FC,1172,1,20,5,3,66,24,42,65
N'castle Jet,1172,2,16,5,7,59,37,22,53
Melbourne C,1172,3,14,4,11,43,35,8,46
Melbourne V,1172,4,13,6,10,47,40,7,45
Adelaide Utd,1172,5,11,6,11,37,40,-3,39
Brisbane,1172,6,10,5,13,33,42,-9,35
Western Sydn,1172,7,8,9,10,38,47,-9,33
Perth Glory,1172,8,10,2,15,37,50,-13,32
Wellington P,1172,9,5,6,16,31,55,-24,21
CC Mariners,1172,10,4,8,15,28,49,-21,20
Sydney FC,1173,1,20,5,3,64,22,42,65
N'castle Jet,1173,2,16,5,7,58,37,21,53
Melbourne C,1173,3,14,4,11,43,34,9,46
Melbourne V,1173,4,13,6,10,45,38,7,45
Adelaide Utd,1173,5,11,6,11,37,40,-3,39
Brisbane,1173,6,10,5,13,33,42,-9,35
Western Sydn,1173,7,8,9,10,38,47,-9,33
Perth Glory,1173,8,10,2,15,37,50,-13,32
Wellington P,1173,9,5,6,16,31,55,-24,21
CC Mariners,1173,10,4,8,15,28,49,-21,20
Sydney FC,1174,1,20,5,3,66,24,42,65
N'castle Jet,1174,2,15,6,7,57,37,20,51
Melbourne C,1174,3,14,5,10,43,33,10,47
Melbourne V,1174,4,13,6,10,47,40,7,45
Adelaide Utd,1174,5,11,6,11,37,40,-3,39
Brisbane,1174,6,10,5,13,33,42,-9,35
Western Sydn,1174,7,8,9,10,38,47,-9,33
Perth Glory,1174,8,10,2,15,37,50,-13,32
Wellington P,1174,9,5,6,16,31,55,-24,21
CC Mariners,1174,10,4,8,15,28,49,-21,20
Sydney FC,1175,1,20,5,3,64,22,42,65
N'castle Jet,1175,2,16,5,7,59,38,21,53
Melbourne C,1175,3,14,4,11,44,35,9,46
Melbourne V,1175,4,13,6,10,45,38,7,45
Adelaide Utd,1175,5,11,6,11,37,40,-3,39
Brisbane,1175,6,10,5,13,33,42,-9,35
Western Sydn,1175,7,8,9,10,38,47,-9,33
Perth Glory,1175,8,10,2,15,37,50,-13,32
Wellington P,1175,9,5,6,16,31,55,-24,21
CC Mariners,1175,10,4,8,15,28,49,-21,20
Sydney FC,1176,1,21,4,3,65,22,43,67
N'castle Jet,1176,2,15,5,8,57,38,19,50
Melbourne C,1176,3,15,4,10,44,33,11,49
Melbourne V,1176,4,13,5,11,45,39,6,44
Adelaide Utd,1176,5,11,6,11,37,40,-3,39
Brisbane,1176,6,10,5,13,33,42,-9,35
Western Sydn,1176,7,8,9,10,38,47,-9,33
Perth Glory,1176,8,10,2,15,37,50,-13,32
Wellington P,1176,9,5,6,16,31,55,-24,21
CC Mariners,1176,10,4,8,15,28,49,-21,20
Sydney FC,1177,1,20,4,4,65,24,41,64
N'castle Jet,1177,2,16,5,7,59,37,22,53
Melbourne V,1177,3,14,5,10,47,39,8,47
Melbourne C,1177,4,14,4,11,43,35,8,46
Adelaide Utd,1177,5,11,6,11,37,40,-3,39
Brisbane,1177,6,10,5,13,33,42,-9,35
Western Sydn,1177,7,8,9,10,38,47,-9,33
Perth Glory,1177,8,10,2,15,37,50,-13,32
Wellington P,1177,9,5,6,16,31,55,-24,21
CC Mariners,1177,10,4,8,15,28,49,-21,20
Sydney FC,1178,1,21,4,3,70,23,47,67
N'castle Jet,1178,2,16,5,7,58,37,21,53
Melbourne C,1178,3,14,4,11,43,34,9,46
Melbourne V,1178,4,13,5,11,46,44,2,44
Adelaide Utd,1178,5,11,6,11,37,40,-3,39
Brisbane,1178,6,10,5,13,33,42,-9,35
Western Sydn,1178,7,8,9,10,38,47,-9,33
Perth Glory,1178,8,10,2,15,37,50,-13,32
Wellington P,1178,9,5,6,16,31,55,-24,21
CC Mariners,1178,10,4,8,15,28,49,-21,20
Sydney FC,1179,1,20,5,3,65,23,42,65
N'castle Jet,1179,2,16,5,7,60,37,23,53
Melbourne C,1179,3,14,4,11,43,36,7,46
Melbourne V,1179,4,13,6,10,46,39,7,45
Adelaide Utd,1179,5,11,6,11,37,40,-3,39
Brisbane,1179,6,10,5,13,33,42,-9,35
Western Sydn,1179,7,8,9,10,38,47,-9,33
Perth Glory,1179,8,10,2,15,37,50,-13,32
Wellington P,1179,9,5,6,16,31,55,-24,21
CC Mariners,1179,10,4,8,15,28,49,-21,20
Sydney FC,1180,1,21,4,3,67,23,44,67
N'castle Jet,1180,2,16,5,7,62,38,24,53
Melbourne C,1180,3,14,4,11,44,38,6,46
Melbourne V,1180,4,13,5,11,46,41,5,44
Adelaide Utd,1180,5,11,6,11,37,40,-3,39
Brisbane,1180,6,10,5,13,33,42,-9,35
Western Sydn,1180,7,8,9,10,38,47,-9,33
Perth Glory,1180,8,10,2,15,37,50,-13,32
Wellington P,1180,9,5,6,16,31,55,-24,21
CC Mariners,1180,10,4,8,15,28,49,-21,20
Sydney FC,1181,1,21,4,3,68,24,44,67
N'castle Jet,1181,2,16,5,7,60,38,22,53
Melbourne C,1181,3,14,4,11,44,36,8,46
Melbourne V,1181,4,13,5,11,47,42,5,44
Adelaide Utd,1181,5,11,6,11,37,40,-3,39
Brisbane,1181,6,10,5,13,33,42,-9,35
Western Sydn,1181,7,8,9,10,38,47,-9,33
Perth Glory,1181,8,10,2,15,37,50,-13,32
Wellington P,1181,9,5,6,16,31,55,-24,21
CC Mariners,1181,10,4,8,15,28,49,-21,20
Sydney FC,1182,1,20,5,3,64,22,42,65
N'castle Jet,1182,2,16,5,7,60,39,21,53
Melbourne C,1182,3,14,4,11,45,36,9,46
Melbourne V,1182,4,13,6,10,45,38,7,45
Adelaide Utd,1182,5,11,6,11,37,40,-3,39
Brisbane,1182,6,10,5,13,33,42,-9,35
Western Sydn,1182,7,8,9,10,38,47,-9,33
Perth Glory,1182,8,10,2,15,37,50,-13,32
Wellington P,1182,9,5,6,16,31,55,-24,21
CC Mariners,1182,10,4,8,15,28,49,-21,20
Sydney FC,1183,1,21,4,3,67,23,44,67
N'castle Jet,1183,2,16,5,7,59,38,21,53
Melbourne C,1183,3,14,4,11,44,35,9,46
Melbourne V,1183,4,13,5,11,46,41,5,44
Adelaide Utd,1183,5,11,6,11,37,40,-3,39
Brisbane,1183,6,10,5,13,33,42,-9,35
Western Sydn,1183,7,8,9,10,38,47,-9,33
Perth Glory,1183,8,10,2,15,37,50,-13,32
Wellington P,1183,9,5,6,16,31,55,-24,21
CC Mariners,1183,10,4,8,15,28,49,-21,20
Sydney FC,1184,1,20,5,3,66,24,42,65
N'castle Jet,1184,2,15,5,8,58,40,18,50
Melbourne C,1184,3,15,4,10,46,34,12,49
Melbourne V,1184,4,13,6,10,47,40,7,45
Adelaide Utd,1184,5,11,6,11,37,40,-3,39
Brisbane,1184,6,10,5,13,33,42,-9,35
Western Sydn,1184,7,8,9,10,38,47,-9,33
Perth Glory,1184,8,10,2,15,37,50,-13,32
Wellington P,1184,9,5,6,16,31,55,-24,21
CC Mariners,1184,10,4,8,15,28,49,-21,20
Sydney FC,1185,1,20,4,4,64,23,41,64
N'castle Jet,1185,2,15,5,8,58,39,19,50
Melbourne C,1185,3,15,4,10,45,34,11,49
Melbourne V,1185,4,14,5,10,46,38,8,47
Adelaide Utd,1185,5,11,6,11,37,40,-3,39
Brisbane,1185,6,10,5,13,33,42,-9,35
Western Sydn,1185,7,8,9,10,38,47,-9,33
Perth Glory,1185,8,10,2,15,37,50,-13,32
Wellington P,1185,9,5,6,16,31,55,-24,21
CC Mariners,1185,10,4,8,15,28,49,-21,20
Sydney FC,1186,1,20,5,3,65,23,42,65
N'castle Jet,1186,2,15,5,8,58,39,19,50
Melbourne C,1186,3,15,4,10,45,34,11,49
Melbourne V,1186,4,13,6,10,46,39,7,45
Adelaide Utd,1186,5,11,6,11,37,40,-3,39
Brisbane,1186,6,10,5,13,33,42,-9,35
Western Sydn,1186,7,8,9,10,38,47,-9,33
Perth Glory,1186,8,10,2,15,37,50,-13,32
Wellington P,1186,9,5,6,16,31,55,-24,21
CC Mariners,1186,10,4,8,15,28,49,-21,20
Sydney FC,1187,1,21,4,3,65,22,43,67
N'castle Jet,1187,2,16,5,7,59,38,21,53
Melbourne C,1187,3,14,4,11,44,35,9,46
Melbourne V,1187,4,13,5,11,45,39,6,44
Adelaide Utd,1187,5,11,6,11,37,40,-3,39
Brisbane,1187,6,10,5,13,33,42,-9,35
Western Sydn,1187,7,8,9,10,38,47,-9,33
Perth Glory,1187,8,10,2,15,37,50,-13,32
Wellington P,1187,9,5,6,16,31,55,-24,21
CC Mariners,1187,10,4,8,15,28,49,-21,20
Sydney FC,1188,1,20,5,3,66,24,42,65
N'castle Jet,1188,2,15,6,7,59,39,20,51
Melbourne C,1188,3,14,5,10,45,35,10,47
Melbourne V,1188,4,13,6,10,47,40,7,45
Adelaide Utd,1188,5,11,6,11,37,40,-3,39
Brisbane,1188,6,10,5,13,33,42,-9,35
Western Sydn,1188,7,8,9,10,38,47,-9,33
Perth Glory,1188,8,10,2,15,37,50,-13,32
Wellington P,1188,9,5,6,16,31,55,-24,21
CC Mariners,1188,10,4,8,15,28,49,-21,20
Sydney FC,1189,1,20,4,4,66,25,41,64
N'castle Jet,1189,2,16,5,7,62,41,21,53
Melbourne V,1189,3,14,5,10,48,40,8,47
Melbourne C,1189,4,14,4,11,47,38,9,46
Adelaide Utd,1189,5,11,6,11,37,40,-3,39
Brisbane,1189,6,10,5,13,33,42,-9,35
Western Sydn,1189,7,8,9,10,38,47,-9,33
Perth Glory,1189,8,10,2,15,37,50,-13,32
Wellington P,1189,9,5,6,16,31,55,-24,21
CC Mariners,1189,10,4,8,15,28,49,-21,20
Sydney FC,1190,1,21,4,3,65,22,43,67
N'castle Jet,1190,2,16,5,7,59,37,22,53
Melbourne C,1190,3,14,4,11,43,35,8,46
Melbourne V,1190,4,13,5,11,45,39,6,44
Adelaide Utd,1190,5,11,6,11,37,40,-3,39
Brisbane,1190,6,10,5,13,33,42,-9,35
Western Sydn,1190,7,8,9,10,38,47,-9,33
Perth Glory,1190,8,10,2,15,37,50,-13,32
Wellington P,1190,9,5,6,16,31,55,-24,21
CC Mariners,1190,10,4,8,15,28,49,-21,20
Sydney FC,1191,1,20,4,4,65,25,40,64
N'castle Jet,1191,2,15,6,7,58,38,20,51
Melbourne C,1191,3,14,5,10,44,34,10,47
Melbourne V,1191,4,14,5,10,48,39,9,47
Adelaide Utd,1191,5,11,6,11,37,40,-3,39
Brisbane,1191,6,10,5,13,33,42,-9,35
Western Sydn,1191,7,8,9,10,38,47,-9,33
Perth Glory,1191,8,10,2,15,37,50,-13,32
Wellington P,1191,9,5,6,16,31,55,-24,21
CC Mariners,1191,10,4,8,15,28,49,-21,20
Sydney FC,1192,1,20,5,3,65,23,42,65
N'castle Jet,1192,2,16,5,7,60,38,22,53
Melbourne C,1192,3,14,4,11,44,36,8,46
Melbourne V,1192,4,13,6,10,46,39,7,45
Adelaide Utd,1192,5,11,6,11,37,40,-3,39
Brisbane,1192,6,10,5,13,33,42,-9,35
Western Sydn,1192,7,8,9,10,38,47,-9,33
Perth Glory,1192,8,10,2,15,37,50,-13,32
Wellington P,1192,9,5,6,16,31,55,-24,21
CC Mariners,1192,10,4,8,15,28,49,-21,20
Sydney FC,1193,1,20,5,3,64,22,42,65
N'castle Jet,1193,2,16,5,7,59,37,22,53
Melbourne C,1193,3,14,4,11,43,35,8,46
Melbourne V,1193,4,13,6,10,45,38,7,45
Adelaide Utd,1193,5,11,6,11,37,40,-3,39
Brisbane,1193,6,10,5,13,33,42,-9,35
Western Sydn,1193,7,8,9,10,38,47,-9,33
Perth Glory,1193,8,10,2,15,37,50,-13,32
Wellington P,1193,9,5,6,16,31,55,-24,21
CC Mariners,1193,10,4,8,15,28,49,-21,20
Sydney FC,1194,1,21,4,3,68,24,44,67
N'castle Jet,1194,2,15,6,7,59,39,20,51
Melbourne C,1194,3,14,5,10,45,35,10,47
Melbourne V,1194,4,13,5,11,47,42,5,44
Adelaide Utd,1194,5,11,6,11,37,40,-3,39
Brisbane,1194,6,10,5,13,33,42,-9,35
Western Sydn,1194,7,8,9,10,38,47,-9,33
Perth Glory,1194,8,10,2,15,37,50,-13,32
Wellington P,1194,9,5,6,16,31,55,-24,21
CC Mariners,1194,10,4,8,15,28,49,-21,20
Sydney FC,1195,1,21,4,3,68,23,45,67
N'castle Jet,1195,2,16,5,7,58,37,21,53
Melbourne C,1195,3,14,4,11,43,34,9,46
Melbourne V,1195,4,13,5,11,46,42,4,44
Adelaide Utd,1195,5,11,6,11,37,40,-3,39
Brisbane,1195,6,10,5,13,33,42,-9,35
Western Sydn,1195,7,8,9,10,38,47,-9,33
Perth Glory,1195,8,10,2,15,37,50,-13,32
Wellington P,1195,9,5,6,16,31,55,-24,21
CC Mariners,1195,10,4,8,15,28,49,-21,20
Sydney FC,1196,1,21,4,3,67,23,44,67
N'castle Jet,1196,2,15,6,7,59,39,20,51
Melbourne C,1196,3,14,5,10,45,35,10,47
Melbourne V,1196,4,13,5,11,46,41,5,44
Adelaide Utd,1196,5,11,6,11,37,40,-3,39
Brisbane,1196,6,10,5,13,33,42,-9,35
Western Sydn,1196,7,8,9,10,38,47,-9,33
Perth Glory,1196,8,10,2,15,37,50,-13,32
Wellington P,1196,9,5,6,16,31,55,-24,21
CC Mariners,1196,10,4,8,15,28,49,-21,20
Sydney FC,1197,1,20,5,3,65,23,42,65
N'castle Jet,1197,2,16,5,7,60,37,23,53
Melbourne C,1197,3,14,4,11,43,36,7,46
Melbourne V,1197,4,13,6,10,46,39,7,45
Adelaide Utd,1197,5,11,6,11,37,40,-3,39
Brisbane,1197,6,10,5,13,33,42,-9,35
Western Sydn,1197,7,8,9,10,38,47,-9,33
Perth Glory,1197,8,10,2,15,37,50,-13,32
Wellington P,1197,9,5,6,16,31,55,-24,21
CC Mariners,1197,10,4,8,15,28,49,-21,20
Sydney FC,1198,1,20,4,4,64,24,40,64
N'castle Jet,1198,2,16,5,7,62,37,25,53
Melbourne V,1198,3,14,5,10,47,38,9,47
Melbourne C,1198,4,14,4,11,43,38,5,46
Adelaide Utd,1198,5,11,6,11,37,40,-3,39
Brisbane,1198,6,10,5,13,33,42,-9,35
Western Sydn,1198,7,8,9,10,38,47,-9,33
Perth Glory,1198,8,10,2,15,37,50,-13,32
Wellington P,1198,9,5,6,16,31,55,-24,21
CC Mariners,1198,10,4,8,15,28,49,-21,20
Sydney FC,1199,1,20,4,4,65,24,41,64
N'castle Jet,1199,2,15,6,7,59,39,20,51
Melbourne C,1199,3,14,5,10,45,35,10,47
Melbourne V,1199,4,14,5,10,47,39,8,47
Adelaide Utd,1199,5,11,6,11,37,40,-3,39
Brisbane,1199,6,10,5,13,33,42,-9,35
Western Sydn,1199,7,8,9,10,38,47,-9,33
Perth Glory,1199,8,10,2,15,37,50,-13,32
Wellington P,1199,9,5,6,16,31,55,-24,21
CC Mariners,1199,10,4,8,15,28,49,-21,20
Sydney FC,1200,1,20,5,3,65,23,42,65
N'castle Jet,1200,2,15,6,7,58,38,20,51
Melbourne C,1200,3,14,5,10,44,34,10,47
Melbourne V,1200,4,13,6,10,46,39,7,45
Adelaide Utd,1200,5,11,6,11,37,40,-3,39
Brisbane,1200,6,10,5,13,33,42,-9,35
Western Sydn,1200,7,8,9,10,38,47,-9,33
Perth Glory,1200,8,10,2,15,37,50,-13,32
Wellington P,1200,9,5,6,16,31,55,-24,21
CC Mariners,1200,10,4,8,15,28,49,-21,20
Sydney FC,1201,1,20,4,4,65,25,40,64
N'castle Jet,1201,2,15,5,8,57,38,19,50
Melbourne C,1201,3,15,4,10,44,33,11,49
Melbourne V,1201,4,14,5,10,48,39,9,47
Adelaide Utd,1201,5,11,6,11,37,40,-3,39
Brisbane,1201,6,10,5,13,33,42,-9,35
Western Sydn,1201,7,8,9,10,38,47,-9,33
Perth Glory,1201,8,10,2,15,37,50,-13,32
Wellington P,1201,9,5,6,16,31,55,-24,21
CC Mariners,1201,10,4,8,15,28,49,-21,20
Sydney FC,1202,1,20,5,3,65,23,42,65
N'castle Jet,1202,2,16,5,7,60,37,23,53
Melbourne C,1202,3,14,4,11,43,36,7,46
Melbourne V,1202,4,13,6,10,46,39,7,45
Adelaide Utd,1202,5,11,6,11,37,40,-3,39
Brisbane,1202,6,10,5,13,33,42,-9,35
Western Sydn,1202,7,8,9,10,38,47,-9,33
Perth Glory,1202,8,10,2,15,37,50,-13,32
Wellington P,1202,9,5,6,16,31,55,-24,21
CC Mariners,1202,10,4,8,15,28,49,-21,20
Sydney FC,1203,1,21,4,3,67,22,45,67
N'castle Jet,1203,2,16,5,7,60,39,21,53
Melbourne C,1203,3,14,4,11,45,36,9,46
Melbourne V,1203,4,13,5,11,45,41,4,44
Adelaide Utd,1203,5,11,6,11,37,40,-3,39
Brisbane,1203,6,10,5,13,33,42,-9,35
Western Sydn,1203,7,8,9,10,38,47,-9,33
Perth Glory,1203,8,10,2,15,37,50,-13,32
Wellington P,1203,9,5,6,16,31,55,-24,21
CC Mariners,1203,10,4,8,15,28,49,-21,20
Sydney FC,1204,1,21,4,3,67,23,44,67
N'castle Jet,1204,2,16,5,7,60,39,21,53
Melbourne C,1204,3,14,4,11,45,36,9,46
Melbourne V,1204,4,13,5,11,46,41,5,44
Adelaide Utd,1204,5,11,6,11,37,40,-3,39
Brisbane,1204,6,10,5,13,33,42,-9,35
Western Sydn,1204,7,8,9,10,38,47,-9,33
Perth Glory,1204,8,10,2,15,37,50,-13,32
Wellington P,1204,9,5,6,16,31,55,-24,21
CC Mariners,1204,10,4,8,15,28,49,-21,20
Sydney FC,1205,1,20,5,3,65,23,42,65
N'castle Jet,1205,2,15,5,8,58,41,17,50
Melbourne C,1205,3,15,4,10,47,34,13,49
Melbourne V,1205,4,13,6,10,46,39,7,45
Adelaide Utd,1205,5,11,6,11,37,40,-3,39
Brisbane,1205,6,10,5,13,33,42,-9,35
Western Sydn,1205,7,8,9,10,38,47,-9,33
Perth Glory,1205,8,10,2,15,37,50,-13,32
Wellington P,1205,9,5,6,16,31,55,-24,21
CC Mariners,1205,10,4,8,15,28,49,-21,20
Sydney FC,1206,1,20,5,3,66,24,42,65
N'castle Jet,1206,2,15,5,8,58,39,19,50
Melbourne C,1206,3,15,4,10,45,34,11,49
Melbourne V,1206,4,13,6,10,47,40,7,45
Adelaide Utd,1206,5,11,6,11,37,40,-3,39
Brisbane,1206,6,10,5,13,33,42,-9,35
Western Sydn,1206,7,8,9,10,38,47,-9,33
Perth Glory,1206,8,10,2,15,37,50,-13,32
Wellington P,1206,9,5,6,16,31,55,-24,21
CC Mariners,1206,10,4,8,15,28,49,-21,20
Sydney FC,1207,1,21,4,3,68,22,46,67
N'castle Jet,1207,2,16,5,7,60,37,23,53
Melbourne C,1207,3,14,4,11,43,36,7,46
Melbourne V,1207,4,13,5,11,45,42,3,44
Adelaide Utd,1207,5,11,6,11,37,40,-3,39
Brisbane,1207,6,10,5,13,33,42,-9,35
Western Sydn,1207,7,8,9,10,38,47,-9,33
Perth Glory,1207,8,10,2,15,37,50,-13,32
Wellington P,1207,9,5,6,16,31,55,-24,21
CC Mariners,1207,10,4,8,15,28,49,-21,20
Sydney FC,1208,1,21,4,3,65,22,43,67
N'castle Jet,1208,2,15,5,8,57,39,18,50
Melbourne C,1208,3,15,4,10,45,33,12,49
Melbourne V,1208,4,13,5,11,45,39,6,44
Adelaide Utd,1208,5,11,6,11,37,40,-3,39
Brisbane,1208,6,10,5,13,33,42,-9,35
Western Sydn,1208,7,8,9,10,38,47,-9,33
Perth Glory,1208,8,10,2,15,37,50,-13,32
Wellington P,1208,9,5,6,16,31,55,-24,21
CC Mariners,1208,10,4,8,15,28,49,-21,20
Sydney FC,1209,1,20,4,4,64,25,39,64
N'castle Jet,1209,2,16,5,7,61,38,23,53
Melbourne V,1209,3,14,5,10,48,38,10,47
Melbourne C,1209,4,14,4,11,44,37,7,46
Adelaide Utd,1209,5,11,6,11,37,40,-3,39
Brisbane,1209,6,10,5,13,33,42,-9,35
Western Sydn,1209,7,8,9,10,38,47,-9,33
Perth Glory,1209,8,10,2,15,37,50,-13,32
Wellington P,1209,9,5,6,16,31,55,-24,21
CC Mariners,1209,10,4,8,15,28,49,-21,20
Sydney FC,1210,1,21,4,3,66,23,43,67
N'castle Jet,1210,2,16,5,7,59,38,21,53
Melbourne C,1210,3,14,4,11,44,35,9,46
Melbourne V,1210,4,13,5,11,46,40,6,44
Adelaide Utd,1210,5,11,6,11,37,40,-3,39
Brisbane,1210,6,10,5,13,33,42,-9,35
Western Sydn,1210,7,8,9,10,38,47,-9,33
Perth Glory,1210,8,10,2,15,37,50,-13,32
Wellington P,1210,9,5,6,16,31,55,-24,21
CC Mariners,1210,10,4,8,15,28,49,-21,20
Sydney FC,1211,1,21,4,3,67,22,45,67
N'castle Jet,1211,2,15,5,8,58,41,17,50
Melbourne C,1211,3,15,4,10,47,34,13,49
Melbourne V,1211,4,13,5,11,45,41,4,44
Adelaide Utd,1211,5,11,6,11,37,40,-3,39
Brisbane,1211,6,10,5,13,33,42,-9,35
Western Sydn,1211,7,8,9,10,38,47,-9,33
Perth Glory,1211,8,10,2,15,37,50,-13,32
Wellington P,1211,9,5,6,16,31,55,-24,21
CC Mariners,1211,10,4,8,15,28,49,-21,20
Sydney FC,1212,1,20,5,3,65,23,42,65
N'castle Jet,1212,2,16,5,7,60,38,22,53
Melbourne C,1212,3,14,4,11,44,36,8,46
Melbourne V,1212,4,13,6,10,46,39,7,45
Adelaide Utd,1212,5,11,6,11,37,40,-3,39
Brisbane,1212,6,10,5,13,33,42,-9,35
Western Sydn,1212,7,8,9,10,38,47,-9,33
Perth Glory,1212,8,10,2,15,37,50,-13,32
Wellington P,1212,9,5,6,16,31,55,-24,21
CC Mariners,1212,10,4,8,15,28,49,-21,20
Sydney FC,1213,1,21,4,3,65,22,43,67
N'castle Jet,1213,2,15,5,8,57,39,18,50
Melbourne C,1213,3,15,4,10,45,33,12,49
Melbourne V,1213,4,13,5,11,45,39,6,44
Adelaide Utd,1213,5,11,6,11,37,40,-3,39
Brisbane,1213,6,10,5,13,33,42,-9,35
Western Sydn,1213,7,8,9,10,38,47,-9,33
Perth Glory,1213,8,10,2,15,37,50,-13,32
Wellington P,1213,9,5,6,16,31,55,-24,21
CC Mariners,1213,10,4,8,15,28,49,-21,20
Sydney FC,1214,1,21,4,3,67,22,45,67
N'castle Jet,1214,2,15,5,8,58,42,16,50
Melbourne C,1214,3,15,4,10,48,34,14,49
Melbourne V,1214,4,13,5,11,45,41,4,44
Adelaide Utd,1214,5,11,6,11,37,40,-3,39
Brisbane,1214,6,10,5,13,33,42,-9,35
Western Sydn,1214,7,8,9,10,38,47,-9,33
Perth Glory,1214,8,10,2,15,37,50,-13,32
Wellington P,1214,9,5,6,16,31,55,-24,21
CC Mariners,1214,10,4,8,15,28,49,-21,20
Sydney FC,1215,1,21,4,3,66,22,44,67
N'castle Jet,1215,2,16,5,7,60,38,22,53
Melbourne C,1215,3,14,4,11,44,36,8,46
Melbourne V,1215,4,13,5,11,45,40,5,44
Adelaide Utd,1215,5,11,6,11,37,40,-3,39
Brisbane,1215,6,10,5,13,33,42,-9,35
Western Sydn,1215,7,8,9,10,38,47,-9,33
Perth Glory,1215,8,10,2,15,37,50,-13,32
Wellington P,1215,9,5,6,16,31,55,-24,21
CC Mariners,1215,10,4,8,15,28,49,-21,20
Sydney FC,1216,1,21,4,3,69,24,45,67
N'castle Jet,1216,2,15,6,7,57,37,20,51
Melbourne C,1216,3,14,5,10,43,33,10,47
Melbourne V,1216,4,13,5,11,47,43,4,44
Adelaide Utd,1216,5,11,6,11,37,40,-3,39
Brisbane,1216,6,10,5,13,33,42,-9,35
Western Sydn,1216,7,8,9,10,38,47,-9,33
Perth Glory,1216,8,10,2,15,37,50,-13,32
Wellington P,1216,9,5,6,16,31,55,-24,21
CC Mariners,1216,10,4,8,15,28,49,-21,20
Sydney FC,1217,1,20,4,4,65,24,41,64
N'castle Jet,1217,2,15,5,8,57,39,18,50
Melbourne C,1217,3,15,4,10,45,33,12,49
Melbourne V,1217,4,14,5,10,47,39,8,47
Adelaide Utd,1217,5,11,6,11,37,40,-3,39
Brisbane,1217,6,10,5,13,33,42,-9,35
Western Sydn,1217,7,8,9,10,38,47,-9,33
Perth Glory,1217,8,10,2,15,37,50,-13,32
Wellington P,1217,9,5,6,16,31,55,-24,21
CC Mariners,1217,10,4,8,15,28,49,-21,20
Sydney FC,1218,1,21,4,3,67,22,45,67
N'castle Jet,1218,2,15,5,8,57,38,19,50
Melbourne C,1218,3,15,4,10,44,33,11,49
Melbourne V,1218,4,13,5,11,45,41,4,44
Adelaide Utd,1218,5,11,6,11,37,40,-3,39
Brisbane,1218,6,10,5,13,33,42,-9,35
Western Sydn,1218,7,8,9,10,38,47,-9,33
Perth Glory,1218,8,10,2,15,37,50,-13,32
Wellington P,1218,9,5,6,16,31,55,-24,21
CC Mariners,1218,10,4,8,15,28,49,-21,20
Sydney FC,1219,1,21,4,3,68,22,46,67
N'castle Jet,1219,2,15,6,7,59,39,20,51
Melbourne C,1219,3,14,5,10,45,35,10,47
Melbourne V,1219,4,13,5,11,45,42,3,44
Adelaide Utd,1219,5,11,6,11,37,40,-3,39
Brisbane,1219,6,10,5,13,33,42,-9,35
Western Sydn,1219,7,8,9,10,38,47,-9,33
Perth Glory,1219,8,10,2,15,37,50,-13,32
Wellington P,1219,9,5,6,16,31,55,-24,21
CC Mariners,1219,10,4,8,15,28,49,-21,20
Sydney FC,1220,1,20,4,4,65,25,40,64
N'castle Jet,1220,2,16,5,7,60,38,22,53
Melbourne V,1220,3,14,5,10,48,39,9,47
Melbourne C,1220,4,14,4,11,44,36,8,46
Adelaide Utd,1220,5,11,6,11,37,40,-3,39
Brisbane,1220,6,10,5,13,33,42,-9,35
Western Sydn,1220,7,8,9,10,38,47,-9,33
Perth Glory,1220,8,10,2,15,37,50,-13,32
Wellington P,1220,9,5,6,16,31,55,-24,21
CC Mariners,1220,10,4,8,15,28,49,-21,20
Sydney FC,1221,1,21,4,3,68,24,44,67
N'castle Jet,1221,2,15,6,7,58,38,20,51
Melbourne C,1221,3,14,5,10,44,34,10,47
Melbourne V,1221,4,13,5,11,47,42,5,44
Adelaide Utd,1221,5,11,6,11,37,40,-3,39
Brisbane,1221,6,10,5,13,33,42,-9,35
Western Sydn,1221,7,8,9,10,38,47,-9,33
Perth Glory,1221,8,10,2,15,37,50,-13,32
Wellington P,1221,9,5,6,16,31,55,-24,21
CC Mariners,1221,10,4,8,15,28,49,-21,20
Sydney FC,1222,1,20,5,3,66,24,42,65
N'castle Jet,1222,2,16,5,7,62,38,24,53
Melbourne C,1222,3,14,4,11,44,38,6,46
Melbourne V,1222,4,13,6,10,47,40,7,45
Adelaide Utd,1222,5,11,6,11,37,40,-3,39
Brisbane,1222,6,10,5,13,33,42,-9,35
Western Sydn,1222,7,8,9,10,38,47,-9,33
Perth Glory,1222,8,10,2,15,37,50,-13,32
Wellington P,1222,9,5,6,16,31,55,-24,21
CC Mariners,1222,10,4,8,15,28,49,-21,20
Sydney FC,1223,1,21,4,3,66,23,43,67
N'castle Jet,1223,2,15,5,8,57,39,18,50
Melbourne C,1223,3,15,4,10,45,33,12,49
Melbourne V,1223,4,13,5,11,46,40,6,44
Adelaide Utd,1223,5,11,6,11,37,40,-3,39
Brisbane,1223,6,10,5,13,33,42,-9,35
Western Sydn,1223,7,8,9,10,38,47,-9,33
Perth Glory,1223,8,10,2,15,37,50,-13,32
Wellington P,1223,9,5,6,16,31,55,-24,21
CC Mariners,1223,10,4,8,15,28,49,-21,20
Sydney FC,1224,1,21,4,3,66,23,43,67
N'castle Jet,1224,2,15,6,7,58,38,20,51
Melbourne C,1224,3,14,5,10,44,34,10,47
Melbourne V,1224,4,13,5,11,46,40,6,44
Adelaide Utd,1224,5,11,6,11,37,40,-3,39
Brisbane,1224,6,10,5,13,33,42,-9,35
Western Sydn,1224,7,8,9,10,38,47,-9,33
Perth Glory,1224,8,10,2,15,37,50,-13,32
Wellington P,1224,9,5,6,16,31,55,-24,21
CC Mariners,1224,10,4,8,15,28,49,-21,20
Sydney FC,1225,1,20,5,3,64,22,42,65
N'castle Jet,1225,2,16,5,7,60,39,21,53
Melbourne C,1225,3,14,4,11,45,36,9,46
Melbourne V,1225,4,13,6,10,45,38,7,45
Adelaide Utd,1225,5,11,6,11,37,40,-3,39
Brisbane,1225,6,10,5,13,33,42,-9,35
Western Sydn,1225,7,8,9,10,38,47,-9,33
Perth Glory,1225,8,10,2,15,37,50,-13,32
Wellington P,1225,9,5,6,16,31,55,-24,21
CC Mariners,1225,10,4,8,15,28,49,-21,20
Sydney FC,1226,1,20,4,4,64,23,41,64
N'castle Jet,1226,2,16,5,7,59,38,21,53
Melbourne V,1226,3,14,5,10,46,38,8,47
Melbourne C,1226,4,14,4,11,44,35,9,46
Adelaide Utd,1226,5,11,6,11,37,40,-3,39
Brisbane,1226,6,10,5,13,33,42,-9,35
Western Sydn,1226,7,8,9,10,38,47,-9,33
Perth Glory,1226,8,10,2,15,37,50,-13,32
Wellington P,1226,9,5,6,16,31,55,-24,21
CC Mariners,1226,10,4,8,15,28,49,-21,20
Sydney FC,1227,1,21,4,3,66,22,44,67
N'castle Jet,1227,2,16,5,7,59,38,21,53
Melbourne C,1227,3,14,4,11,44,35,9,46
Melbourne V,1227,4,13,5,11,45,40,5,44
Adelaide Utd,1227,5,11,6,11,37,40,-3,39
Brisbane,1227,6,10,5,13,33,42,-9,35
Western Sydn,1227,7,8,9,10,38,47,-9,33
Perth Glory,1227,8,10,2,15,37,50,-13,32
Wellington P,1227,9,5,6,16,31,55,-24,21
CC Mariners,1227,10,4,8,15,28,49,-21,20
Sydney FC,1228,1,21,4,3,67,22,45,67
N'castle Jet,1228,2,16,5,7,60,37,23,53
Melbourne C,1228,3,14,4,11,43,36,7,46
Melbourne V,1228,4,13,5,11,45,41,4,44
Adelaide Utd,1228,5,11,6,11,37,40,-3,39
Brisbane,1228,6,10,5,13,33,42,-9,35
Western Sydn,1228,7,8,9,10,38,47,-9,33
Perth Glory,1228,8,10,2,15,37,50,-13,32
Wellington P,1228,9,5,6,16,31,55,-24,21
CC Mariners,1228,10,4,8,15,28,49,-21,20
Sydney FC,1229,1,21,4,3,68,22,46,67
N'castle Jet,1229,2,16,5,7,60,38,22,53
Melbourne C,1229,3,14,4,11,44,36,8,46
Melbourne V,1229,4,13,5,11,45,42,3,44
Adelaide Utd,1229,5,11,6,11,37,40,-3,39
Brisbane,1229,6,10,5,13,33,42,-9,35
Western Sydn,1229,7,8,9,10,38,47,-9,33
Perth Glory,1229,8,10,2,15,37,50,-13,32
Wellington P,1229,9,5,6,16,31,55,-24,21
CC Mariners,1229,10,4,8,15,28,49,-21,20
Sydney FC,1230,1,20,4,4,64,23,41,64
N'castle Jet,1230,2,15,6,7,57,37,20,51
Melbourne C,1230,3,14,5,10,43,33,10,47
Melbourne V,1230,4,14,5,10,46,38,8,47
Adelaide Utd,1230,5,11,6,11,37,40,-3,39
Brisbane,1230,6,10,5,13,33,42,-9,35
Western Sydn,1230,7,8,9,10,38,47,-9,33
Perth Glory,1230,8,10,2,15,37,50,-13,32
Wellington P,1230,9,5,6,16,31,55,-24,21
CC Mariners,1230,10,4,8,15,28,49,-21,20
Sydney FC,1231,1,21,4,3,67,22,45,67
N'castle Jet,1231,2,15,6,7,58,38,20,51
Melbourne C,1231,3,14,5,10,44,34,10,47
Melbourne V,1231,4,13,5,11,45,41,4,44
Adelaide Utd,1231,5,11,6,11,37,40,-3,39
Brisbane,1231,6,10,5,13,33,42,-9,35
Western Sydn,1231,7,8,9,10,38,47,-9,33
Perth Glory,1231,8,10,2,15,37,50,-13,32
Wellington P,1231,9,5,6,16,31,55,-24,21
CC Mariners,1231,10,4,8,15,28,49,-21,20
Sydney FC,1232,1,21,4,3,67,23,44,67
N'castle Jet,1232,2,15,5,8,57,38,19,50
Melbourne C,1232,3,15,4,10,44,33,11,49
Melbourne V,1232,4,13,5,11,46,41,5,44
Adelaide Utd,1232,5,11,6,11,37,40,-3,39
Brisbane,1232,6,10,5,13,33,42,-9,35
Western Sydn,1232,7,8,9,10,38,47,-9,33
Perth Glory,1232,8,10,2,15,37,50,-13,32
Wellington P,1232,9,5,6,16,31,55,-24,21
CC Mariners,1232,10,4,8,15,28,49,-21,20
Sydney FC,1233,1,20,5,3,66,24,42,65
N'castle Jet,1233,2,16,5,7,59,37,22,53
Melbourne C,1233,3,14,4,11,43,35,8,46
Melbourne V,1233,4,13,6,10,47,40,7,45
Adelaide Utd,1233,5,11,6,11,37,40,-3,39
Brisbane,1233,6,10,5,13,33,42,-9,35
Western Sydn,1233,7,8,9,10,38,47,-9,33
Perth Glory,1233,8,10,2,15,37,50,-13,32
Wellington P,1233,9,5,6,16,31,55,-24,21
CC Mariners,1233,10,4,8,15,28,49,-21,20
Sydney FC,1234,1,21,4,3,67,23,44,67
N'castle Jet,1234,2,15,6,7,59,39,20,51
Melbourne C,1234,3,14,5,10,45,35,10,47
Melbourne V,1234,4,13,5,11,46,41,5,44
Adelaide Utd,1234,5,11,6,11,37,40,-3,39
Brisbane,1234,6,10,5,13,33,42,-9,35
Western Sydn,1234,7,8,9,10,38,47,-9,33
Perth Glory,1234,8,10,2,15,37,50,-13,32
Wellington P,1234,9,5,6,16,31,55,-24,21
CC Mariners,1234,10,4,8,15,28,49,-21,20
Sydney FC,1235,1,21,4,3,65,22,43,67
N'castle Jet,1235,2,16,5,7,62,39,23,53
Melbourne C,1235,3,14,4,11,45,38,7,46
Melbourne V,1235,4,13,5,11,45,39,6,44
Adelaide Utd,1235,5,11,6,11,37,40,-3,39
Brisbane,1235,6,10,5,13,33,42,-9,35
Western Sydn,1235,7,8,9,10,38,47,-9,33
Perth Glory,1235,8,10,2,15,37,50,-13,32
Wellington P,1235,9,5,6,16,31,55,-24,21
CC Mariners,1235,10,4,8,15,28,49,-21,20
Sydney FC,1236,1,21,4,3,67,23,44,67
N'castle Jet,1236,2,15,5,8,57,38,19,50
Melbourne C,1236,3,15,4,10,44,33,11,49
Melbourne V,1236,4,13,5,11,46,41,5,44
Adelaide Utd,1236,5,11,6,11,37,40,-3,39
Brisbane,1236,6,10,5,13,33,42,-9,35
Western Sydn,1236,7,8,9,10,38,47,-9,33
Perth Glory,1236,8,10,2,15,37,50,-13,32
Wellington P,1236,9,5,6,16,31,55,-24,21
CC Mariners,1236,10,4,8,15,28,49,-21,20
Sydney FC,1237,1,21,4,3,67,22,45,67
N'castle Jet,1237,2,16,5,7,58,37,21,53
Melbourne C,1237,3,14,4,11,43,34,9,46
Melbourne V,1237,4,13,5,11,45,41,4,44
Adelaide Utd,1237,5,11,6,11,37,40,-3,39
Brisbane,1237,6,10,5,13,33,42,-9,35
Western Sydn,1237,7,8,9,10,38,47,-9,33
Perth Glory,1237,8,10,2,15,37,50,-13,32
Wellington P,1237,9,5,6,16,31,55,-24,21
CC Mariners,1237,10,4,8,15,28,49,-21,20
Sydney FC,1238,1,21,4,3,67,24,43,67
N'castle Jet,1238,2,16,5,7,59,37,22,53
Melbourne C,1238,3,14,4,11,43,35,8,46
Melbourne V,1238,4,13,5,11,47,41,6,44
Adelaide Utd,1238,5,11,6,11,37,40,-3,39
Brisbane,1238,6,10,5,13,33,42,-9,35
Western Sydn,1238,7,8,9,10,38,47,-9,33
Perth Glory,1238,8,10,2,15,37,50,-13,32
Wellington P,1238,9,5,6,16,31,55,-24,21
CC Mariners,1238,10,4,8,15,28,49,-21,20
Sydney FC,1239,1,20,5,3,65,23,42,65
N'castle Jet,1239,2,15,5,8,57,41,16,50
Melbourne C,1239,3,15,4,10,47,33,14,49
Melbourne V,1239,4,13,6,10,46,39,7,45
Adelaide Utd,1239,5,11,6,11,37,40,-3,39
Brisbane,1239,6,10,5,13,33,42,-9,35
Western Sydn,1239,7,8,9,10,38,47,-9,33
Perth Glory,1239,8,10,2,15,37,50,-13,32
Wellington P,1239,9,5,6,16,31,55,-24,21
CC Mariners,1239,10,4,8,15,28,49,-21,20
Sydney FC,1240,1,20,4,4,65,25,40,64
N'castle Jet,1240,2,16,5,7,60,38,22,53
Melbourne V,1240,3,14,5,10,48,39,9,47
Melbourne C,1240,4,14,4,11,44,36,8,46
Adelaide Utd,1240,5,11,6,11,37,40,-3,39
Brisbane,1240,6,10,5,13,33,42,-9,35
Western Sydn,1240,7,8,9,10,38,47,-9,33
Perth Glory,1240,8,10,2,15,37,50,-13,32
Wellington P,1240,9,5,6,16,31,55,-24,21
CC Mariners,1240,10,4,8,15,28,49,-21,20
Sydney FC,1241,1,20,4,4,64,23,41,64
N'castle Jet,1241,2,16,5,7,58,37,21,53
Melbourne V,1241,3,14,5,10,46,38,8,47
Melbourne C,1241,4,14,4,11,43,34,9,46
Adelaide Utd,1241,5,11,6,11,37,40,-3,39
Brisbane,1241,6,10,5,13,33,42,-9,35
Western Sydn,1241,7,8,9,10,38,47,-9,33
Perth Glory,1241,8,10,2,15,37,50,-13,32
Wellington P,1241,9,5,6,16,31,55,-24,21
CC Mariners,1241,10,4,8,15,28,49,-21,20
Sydney FC,1242,1,21,4,3,66,23,43,67
N'castle Jet,1242,2,16,5,7,63,37,26,53
Melbourne C,1242,3,14,4,11,43,39,4,46
Melbourne V,1242,4,13,5,11,46,40,6,44
Adelaide Utd,1242,5,11,6,11,37,40,-3,39
Brisbane,1242,6,10,5,13,33,42,-9,35
Western Sydn,1242,7,8,9,10,38,47,-9,33
Perth Glory,1242,8,10,2,15,37,50,-13,32
Wellington P,1242,9,5,6,16,31,55,-24,21
CC Mariners,1242,10,4,8,15,28,49,-21,20
Sydney FC,1243,1,21,4,3,65,22,43,67
N'castle Jet,1243,2,16,5,7,63,40,23,53
Melbourne C,1243,3,14,4,11,46,39,7,46
Melbourne V,1243,4,13,5,11,45,39,6,44
Adelaide Utd,1243,5,11,6,11,37,40,-3,39
Brisbane,1243,6,10,5,13,33,42,-9,35
Western Sydn,1243,7,8,9,10,38,47,-9,33
Perth Glory,1243,8,10,2,15,37,50,-13,32
Wellington P,1243,9,5,6,16,31,55,-24,21
CC Mariners,1243,10,4,8,15,28,49,-21,20
Sydney FC,1244,1,20,5,3,66,24,42,65
N'castle Jet,1244,2,16,5,7,62,38,24,53
Melbourne C,1244,3,14,4,11,44,38,6,46
Melbourne V,1244,4,13,6,10,47,40,7,45
Adelaide Utd,1244,5,11,6,11,37,40,-3,39
Brisbane,1244,6,10,5,13,33,42,-9,35
Western Sydn,1244,7,8,9,10,38,47,-9,33
Perth Glory,1244,8,10,2,15,37,50,-13,32
Wellington P,1244,9,5,6,16,31,55,-24,21
CC Mariners,1244,10,4,8,15,28,49,-21,20
Sydney FC,1245,1,21,4,3,66,23,43,67
N'castle Jet,1245,2,16,5,7,60,37,23,53
Melbourne C,1245,3,14,4,11,43,36,7,46
Melbourne V,1245,4,13,5,11,46,40,6,44
Adelaide Utd,1245,5,11,6,11,37,40,-3,39
Brisbane,1245,6,10,5,13,33,42,-9,35
Western Sydn,1245,7,8,9,10,38,47,-9,33
Perth Glory,1245,8,10,2,15,37,50,-13,32
Wellington P,1245,9,5,6,16,31,55,-24,21
CC Mariners,1245,10,4,8,15,28,49,-21,20
Sydney FC,1246,1,21,4,3,67,23,44,67
N'castle Jet,1246,2,16,5,7,59,37,22,53
Melbourne C,1246,3,14,4,11,43,35,8,46
Melbourne V,1246,4,13,5,11,46,41,5,44
Adelaide Utd,1246,5,11,6,11,37,40,-3,39
Brisbane,1246,6,10,5,13,33,42,-9,35
Western Sydn,1246,7,8,9,10,38,47,-9,33
Perth Glory,1246,8,10,2,15,37,50,-13,32
Wellington P,1246,9,5,6,16,31,55,-24,21
CC Mariners,1246,10,4,8,15,28,49,-21,20
Sydney FC,1247,1,20,5,3,64,22,42,65
N'castle Jet,1247,2,16,5,7,59,37,22,53
Melbourne C,1247,3,14,4,11,43,35,8,46
Melbourne V,1247,4,13,6,10,45,38,7,45
Adelaide Utd,1247,5,11,6,11,37,40,-3,39
Brisbane,1247,6,10,5,13,33,42,-9,35
Western Sydn,1247,7,8,9,10,38,47,-9,33
Perth Glory,1247,8,10,2,15,37,50,-13,32
Wellington P,1247,9,5,6,16,31,55,-24,21
CC Mariners,1247,10,4,8,15,28,49,-21,20
Sydney FC,1248,1,20,4,4,65,24,41,64
N'castle Jet,1248,2,16,5,7,59,37,22,53
Melbourne V,1248,3,14,5,10,47,39,8,47
Melbourne C,1248,4,14,4,11,43,35,8,46
Adelaide Utd,1248,5,11,6,11,37,40,-3,39
Brisbane,1248,6,10,5,13,33,42,-9,35
Western Sydn,1248,7,8,9,10,38,47,-9,33
Perth Glory,1248,8,10,2,15,37,50,-13,32
Wellington P,1248,9,5,6,16,31,55,-24,21
CC Mariners,1248,10,4,8,15,28,49,-21,20
Sydney FC,1249,1,21,4,3,66,23,43,67
N'castle Jet,1249,2,15,5,8,58,39,19,50
Melbourne C,1249,3,15,4,10,45,34,11,49
Melbourne V,1249,4,13,5,11,46,40,6,44
Adelaide Utd,1249,5,11,6,11,37,40,-3,39
Brisbane,1249,6,10,5,13,33,42,-9,35
Western Sydn,1249,7,8,9,10,38,47,-9,33
Perth Glory,1249,8,10,2,15,37,50,-13,32
Wellington P,1249,9,5,6,16,31,55,-24,21
CC Mariners,1249,10,4,8,15,28,49,-21,20
Sydney FC,1250,1,20,5,3,64,22,42,65
N'castle Jet,1250,2,15,6,7,58,38,20,51
Melbourne C,1250,3,14,5,10,44,34,10,47
Melbourne V,1250,4,13,6,10,45,38,7,45
Adelaide Utd,1250,5,11,6,11,37,40,-3,39
Brisbane,1250,6,10,5,13,33,42,-9,35
Western Sydn,1250,7,8,9,10,38,47,-9,33
Perth Glory,1250,8,10,2,15,37,50,-13,32
Wellington P,1250,9,5,6,16,31,55,-24,21
CC Mariners,1250,10,4,8,15,28,49,-21,20
Sydney FC,1251,1,20,5,3,65,23,42,65
N'castle Jet,1251,2,16,5,7,59,37,22,53
Melbourne C,1251,3,14,4,11,43,35,8,46
Melbourne V,1251,4,13,6,10,46,39,7,45
Adelaide Utd,1251,5,11,6,11,37,40,-3,39
Brisbane,1251,6,10,5,13,33,42,-9,35
Western Sydn,1251,7,8,9,10,38,47,-9,33
Perth Glory,1251,8,10,2,15,37,50,-13,32
Wellington P,1251,9,5,6,16,31,55,-24,21
CC Mariners,1251,10,4,8,15,28,49,-21,20
Sydney FC,1252,1,21,4,3,66,23,43,67
N'castle Jet,1252,2,15,6,7,58,38,20,51
Melbourne C,1252,3,14,5,10,44,34,10,47
Melbourne V,1252,4,13,5,11,46,40,6,44
Adelaide Utd,1252,5,11,6,11,37,40,-3,39
Brisbane,1252,6,10,5,13,33,42,-9,35
Western Sydn,1252,7,8,9,10,38,47,-9,33
Perth Glory,1252,8,10,2,15,37,50,-13,32
Wellington P,1252,9,5,6,16,31,55,-24,21
CC Mariners,1252,10,4,8,15,28,49,-21,20
Sydney FC,1253,1,21,4,3,67,22,45,67
N'castle Jet,1253,2,16,5,7,60,37,23,53
Melbourne C,1253,3,14,4,11,43,36,7,46
Melbourne V,1253,4,13,5,11,45,41,4,44
Adelaide Utd,1253,5,11,6,11,37,40,-3,39
Brisbane,1253,6,10,5,13,33,42,-9,35
Western Sydn,1253,7,8,9,10,38,47,-9,33
Perth Glory,1253,8,10,2,15,37,50,-13,32
Wellington P,1253,9,5,6,16,31,55,-24,21
CC Mariners,1253,10,4,8,15,28,49,-21,20
Sydney FC,1254,1,20,4,4,66,25,41,64
N'castle Jet,1254,2,16,5,7,62,37,25,53
Melbourne V,1254,3,14,5,10,48,40,8,47
Melbourne C,1254,4,14,4,11,43,38,5,46
Adelaide Utd,1254,5,11,6,11,37,40,-3,39
Brisbane,1254,6,10,5,13,33,42,-9,35
Western Sydn,1254,7,8,9,10,38,47,-9,33
Perth Glory,1254,8,10,2,15,37,50,-13,32
Wellington P,1254,9,5,6,16,31,55,-24,21
CC Mariners,1254,10,4,8,15,28,49,-21,20
Sydney FC,1255,1,20,5,3,64,22,42,65
N'castle Jet,1255,2,16,5,7,58,37,21,53
Melbourne C,1255,3,14,4,11,43,34,9,46
Melbourne V,1255,4,13,6,10,45,38,7,45
Adelaide Utd,1255,5,11,6,11,37,40,-3,39
Brisbane,1255,6,10,5,13,33,42,-9,35
Western Sydn,1255,7,8,9,10,38,47,-9,33
Perth Glory,1255,8,10,2,15,37,50,-13,32
Wellington P,1255,9,5,6,16,31,55,-24,21
CC Mariners,1255,10,4,8,15,28,49,-21,20
Sydney FC,1256,1,21,4,3,67,22,45,67
N'castle Jet,1256,2,16,5,7,59,37,22,53
Melbourne C,1256,3,14,4,11,43,35,8,46
Melbourne V,1256,4,13,5,11,45,41,4,44
Adelaide Utd,1256,5,11,6,11,37,40,-3,39
Brisbane,1256,6,10,5,13,33,42,-9,35
Western Sydn,1256,7,8,9,10,38,47,-9,33
Perth Glory,1256,8,10,2,15,37,50,-13,32
Wellington P,1256,9,5,6,16,31,55,-24,21
CC Mariners,1256,10,4,8,15,28,49,-21,20
Sydney FC,1257,1,21,4,3,67,22,45,67
N'castle Jet,1257,2,15,5,8,57,39,18,50
Melbourne C,1257,3,15,4,10,45,33,12,49
Melbourne V,1257,4,13,5,11,45,41,4,44
Adelaide Utd,1257,5,11,6,11,37,40,-3,39
Brisbane,1257,6,10,5,13,33,42,-9,35
Western Sydn,1257,7,8,9,10,38,47,-9,33
Perth Glory,1257,8,10,2,15,37,50,-13,32
Wellington P,1257,9,5,6,16,31,55,-24,21
CC Mariners,1257,10,4,8,15,28,49,-21,20
Sydney FC,1258,1,21,4,3,65,22,43,67
N'castle Jet,1258,2,16,5,7,58,37,21,53
Melbourne C,1258,3,14,4,11,43,34,9,46
Melbourne V,1258,4,13,5,11,45,39,6,44
Adelaide Utd,1258,5,11,6,11,37,40,-3,39
Brisbane,1258,6,10,5,13,33,42,-9,35
Western Sydn,1258,7,8,9,10,38,47,-9,33
Perth Glory,1258,8,10,2,15,37,50,-13,32
Wellington P,1258,9,5,6,16,31,55,-24,21
CC Mariners,1258,10,4,8,15,28,49,-21,20
Sydney FC,1259,1,20,4,4,64,23,41,64
N'castle Jet,1259,2,16,5,7,59,38,21,53
Melbourne V,1259,3,14,5,10,46,38,8,47
Melbourne C,1259,4,14,4,11,44,35,9,46
Adelaide Utd,1259,5,11,6,11,37,40,-3,39
Brisbane,1259,6,10,5,13,33,42,-9,35
Western Sydn,1259,7,8,9,10,38,47,-9,33
Perth Glory,1259,8,10,2,15,37,50,-13,32
Wellington P,1259,9,5,6,16,31,55,-24,21
CC Mariners,1259,10,4,8,15,28,49,-21,20
Sydney FC,1260,1,21,4,3,65,22,43,67
N'castle Jet,1260,2,15,5,8,58,39,19,50
Melbourne C,1260,3,15,4,10,45,34,11,49
Melbourne V,1260,4,13,5,11,45,39,6,44
Adelaide Utd,1260,5,11,6,11,37,40,-3,39
Brisbane,1260,6,10,5,13,33,42,-9,35
Western Sydn,1260,7,8,9,10,38,47,-9,33
Perth Glory,1260,8,10,2,15,37,50,-13,32
Wellington P,1260,9,5,6,16,31,55,-24,21
CC Mariners,1260,10,4,8,15,28,49,-21,20
Sydney FC,1261,1,20,4,4,64,23,41,64
N'castle Jet,1261,2,15,5,8,57,39,18,50
Melbourne C,1261,3,15,4,10,45,33,12,49
Melbourne V,1261,4,14,5,10,46,38,8,47
Adelaide Utd,1261,5,11,6,11,37,40,-3,39
Brisbane,1261,6,10,5,13,33,42,-9,35
Western Sydn,1261,7,8,9,10,38,47,-9,33
Perth Glory,1261,8,10,2,15,37,50,-13,32
Wellington P,1261,9,5,6,16,31,55,-24,21
CC Mariners,1261,10,4,8,15,28,49,-21,20
Sydney FC,1262,1,20,5,3,64,22,42,65
N'castle Jet,1262,2,16,5,7,59,38,21,53
Melbourne C,1262,3,14,4,11,44,35,9,46
Melbourne V,1262,4,13,6,10,45,38,7,45
Adelaide Utd,1262,5,11,6,11,37,40,-3,39
Brisbane,1262,6,10,5,13,33,42,-9,35
Western Sydn,1262,7,8,9,10,38,47,-9,33
Perth Glory,1262,8,10,2,15,37,50,-13,32
Wellington P,1262,9,5,6,16,31,55,-24,21
CC Mariners,1262,10,4,8,15,28,49,-21,20
Sydney FC,1263,1,20,5,3,66,24,42,65
N'castle Jet,1263,2,16,5,7,60,37,23,53
Melbourne C,1263,3,14,4,11,43,36,7,46
Melbourne V,1263,4,13,6,10,47,40,7,45
Adelaide Utd,1263,5,11,6,11,37,40,-3,39
Brisbane,1263,6,10,5,13,33,42,-9,35
Western Sydn,1263,7,8,9,10,38,47,-9,33
Perth Glory,1263,8,10,2,15,37,50,-13,32
Wellington P,1263,9,5,6,16,31,55,-24,21
CC Mariners,1263,10,4,8,15,28,49,-21,20
Sydney FC,1264,1,20,5,3,65,23,42,65
N'castle Jet,1264,2,15,5,8,57,41,16,50
Melbourne C,1264,3,15,4,10,47,33,14,49
Melbourne V,1264,4,13,6,10,46,39,7,45
Adelaide Utd,1264,5,11,6,11,37,40,-3,39
Brisbane,1264,6,10,5,13,33,42,-9,35
Western Sydn,1264,7,8,9,10,38,47,-9,33
Perth Glory,1264,8,10,2,15,37,50,-13,32
Wellington P,1264,9,5,6,16,31,55,-24,21
CC Mariners,1264,10,4,8,15,28,49,-21,20
Sydney FC,1265,1,20,4,4,64,24,40,64
N'castle Jet,1265,2,15,5,8,58,39,19,50
Melbourne C,1265,3,15,4,10,45,34,11,49
Melbourne V,1265,4,14,5,10,47,38,9,47
Adelaide Utd,1265,5,11,6,11,37,40,-3,39
Brisbane,1265,6,10,5,13,33,42,-9,35
Western Sydn,1265,7,8,9,10,38,47,-9,33
Perth Glory,1265,8,10,2,15,37,50,-13,32
Wellington P,1265,9,5,6,16,31,55,-24,21
CC Mariners,1265,10,4,8,15,28,49,-21,20
Sydney FC,1266,1,21,4,3,68,25,43,67
N'castle Jet,1266,2,15,6,7,58,38,20,51
Melbourne C,1266,3,14,5,10,44,34,10,47
Melbourne V,1266,4,13,5,11,48,42,6,44
Adelaide Utd,1266,5,11,6,11,37,40,-3,39
Brisbane,1266,6,10,5,13,33,42,-9,35
Western Sydn,1266,7,8,9,10,38,47,-9,33
Perth Glory,1266,8,10,2,15,37,50,-13,32
Wellington P,1266,9,5,6,16,31,55,-24,21
CC Mariners,1266,10,4,8,15,28,49,-21,20
Sydney FC,1267,1,21,4,3,67,23,44,67
N'castle Jet,1267,2,16,5,7,60,37,23,53
Melbourne C,1267,3,14,4,11,43,36,7,46
Melbourne V,1267,4,13,5,11,46,41,5,44
Adelaide Utd,1267,5,11,6,11,37,40,-3,39
Brisbane,1267,6,10,5,13,33,42,-9,35
Western Sydn,1267,7,8,9,10,38,47,-9,33
Perth Glory,1267,8,10,2,15,37,50,-13,32
Wellington P,1267,9,5,6,16,31,55,-24,21
CC Mariners,1267,10,4,8,15,28,49,-21,20
Sydney FC,1268,1,20,5,3,66,24,42,65
N'castle Jet,1268,2,15,6,7,58,38,20,51
Melbourne C,1268,3,14,5,10,44,34,10,47
Melbourne V,1268,4,13,6,10,47,40,7,45
Adelaide Utd,1268,5,11,6,11,37,40,-3,39
Brisbane,1268,6,10,5,13,33,42,-9,35
Western Sydn,1268,7,8,9,10,38,47,-9,33
Perth Glory,1268,8,10,2,15,37,50,-13,32
Wellington P,1268,9,5,6,16,31,55,-24,21
CC Mariners,1268,10,4,8,15,28,49,-21,20
Sydney FC,1269,1,20,4,4,66,25,41,64
N'castle Jet,1269,2,16,5,7,58,37,21,53
Melbourne V,1269,3,14,5,10,48,40,8,47
Melbourne C,1269,4,14,4,11,43,34,9,46
Adelaide Utd,1269,5,11,6,11,37,40,-3,39
Brisbane,1269,6,10,5,13,33,42,-9,35
Western Sydn,1269,7,8,9,10,38,47,-9,33
Perth Glory,1269,8,10,2,15,37,50,-13,32
Wellington P,1269,9,5,6,16,31,55,-24,21
CC Mariners,1269,10,4,8,15,28,49,-21,20
Sydney FC,1270,1,21,4,3,69,23,46,67
N'castle Jet,1270,2,15,5,8,58,40,18,50
Melbourne C,1270,3,15,4,10,46,34,12,49
Melbourne V,1270,4,13,5,11,46,43,3,44
Adelaide Utd,1270,5,11,6,11,37,40,-3,39
Brisbane,1270,6,10,5,13,33,42,-9,35
Western Sydn,1270,7,8,9,10,38,47,-9,33
Perth Glory,1270,8,10,2,15,37,50,-13,32
Wellington P,1270,9,5,6,16,31,55,-24,21
CC Mariners,1270,10,4,8,15,28,49,-21,20
Sydney FC,1271,1,21,4,3,67,22,45,67
N'castle Jet,1271,2,15,5,8,58,39,19,50
Melbourne C,1271,3,15,4,10,45,34,11,49
Melbourne V,1271,4,13,5,11,45,41,4,44
Adelaide Utd,1271,5,11,6,11,37,40,-3,39
Brisbane,1271,6,10,5,13,33,42,-9,35
Western Sydn,1271,7,8,9,10,38,47,-9,33
Perth Glory,1271,8,10,2,15,37,50,-13,32
Wellington P,1271,9,5,6,16,31,55,-24,21
CC Mariners,1271,10,4,8,15,28,49,-21,20
Sydney FC,1272,1,20,5,3,64,22,42,65
N'castle Jet,1272,2,15,5,8,59,40,19,50
Melbourne C,1272,3,15,4,10,46,35,11,49
Melbourne V,1272,4,13,6,10,45,38,7,45
Adelaide Utd,1272,5,11,6,11,37,40,-3,39
Brisbane,1272,6,10,5,13,33,42,-9,35
Western Sydn,1272,7,8,9,10,38,47,-9,33
Perth Glory,1272,8,10,2,15,37,50,-13,32
Wellington P,1272,9,5,6,16,31,55,-24,21
CC Mariners,1272,10,4,8,15,28,49,-21,20
Sydney FC,1273,1,21,4,3,66,23,43,67
N'castle Jet,1273,2,16,5,7,59,37,22,53
Melbourne C,1273,3,14,4,11,43,35,8,46
Melbourne V,1273,4,13,5,11,46,40,6,44
Adelaide Utd,1273,5,11,6,11,37,40,-3,39
Brisbane,1273,6,10,5,13,33,42,-9,35
Western Sydn,1273,7,8,9,10,38,47,-9,33
Perth Glory,1273,8,10,2,15,37,50,-13,32
Wellington P,1273,9,5,6,16,31,55,-24,21
CC Mariners,1273,10,4,8,15,28,49,-21,20
Sydney FC,1274,1,21,4,3,66,23,43,67
N'castle Jet,1274,2,16,5,7,60,39,21,53
Melbourne C,1274,3,14,4,11,45,36,9,46
Melbourne V,1274,4,13,5,11,46,40,6,44
Adelaide Utd,1274,5,11,6,11,37,40,-3,39
Brisbane,1274,6,10,5,13,33,42,-9,35
Western Sydn,1274,7,8,9,10,38,47,-9,33
Perth Glory,1274,8,10,2,15,37,50,-13,32
Wellington P,1274,9,5,6,16,31,55,-24,21
CC Mariners,1274,10,4,8,15,28,49,-21,20
Sydney FC,1275,1,21,4,3,67,22,45,67
N'castle Jet,1275,2,16,5,7,63,39,24,53
Melbourne C,1275,3,14,4,11,45,39,6,46
Melbourne V,1275,4,13,5,11,45,41,4,44
Adelaide Utd,1275,5,11,6,11,37,40,-3,39
Brisbane,1275,6,10,5,13,33,42,-9,35
Western Sydn,1275,7,8,9,10,38,47,-9,33
Perth Glory,1275,8,10,2,15,37,50,-13,32
Wellington P,1275,9,5,6,16,31,55,-24,21
CC Mariners,1275,10,4,8,15,28,49,-21,20
Sydney FC,1276,1,21,4,3,65,22,43,67
N'castle Jet,1276,2,16,5,7,60,38,22,53
Melbourne C,1276,3,14,4,11,44,36,8,46
Melbourne V,1276,4,13,5,11,45,39,6,44
Adelaide Utd,1276,5,11,6,11,37,40,-3,39
Brisbane,1276,6,10,5,13,33,42,-9,35
Western Sydn,1276,7,8,9,10,38,47,-9,33
Perth Glory,1276,8,10,2,15,37,50,-13,32
Wellington P,1276,9,5,6,16,31,55,-24,21
CC Mariners,1276,10,4,8,15,28,49,-21,20
Sydney FC,1277,1,20,5,3,64,22,42,65
N'castle Jet,1277,2,16,5,7,59,38,21,53
Melbourne C,1277,3,14,4,11,44,35,9,46
Melbourne V,1277,4,13,6,10,45,38,7,45
Adelaide Utd,1277,5,11,6,11,37,40,-3,39
Brisbane,1277,6,10,5,13,33,42,-9,35
Western Sydn,1277,7,8,9,10,38,47,-9,33
Perth Glory,1277,8,10,2,15,37,50,-13,32
Wellington P,1277,9,5,6,16,31,55,-24,21
CC Mariners,1277,10,4,8,15,28,49,-21,20
Sydney FC,1278,1,20,5,3,67,25,42,65
N'castle Jet,1278,2,16,5,7,61,38,23,53
Melbourne C,1278,3,14,4,11,44,37,7,46
Melbourne V,1278,4,13,6,10,48,41,7,45
Adelaide Utd,1278,5,11,6,11,37,40,-3,39
Brisbane,1278,6,10,5,13,33,42,-9,35
Western Sydn,1278,7,8,9,10,38,47,-9,33
Perth Glory,1278,8,10,2,15,37,50,-13,32
Wellington P,1278,9,5,6,16,31,55,-24,21
CC Mariners,1278,10,4,8,15,28,49,-21,20
Sydney FC,1279,1,21,4,3,67,22,45,67
N'castle Jet,1279,2,15,5,8,57,39,18,50
Melbourne C,1279,3,15,4,10,45,33,12,49
Melbourne V,1279,4,13,5,11,45,41,4,44
Adelaide Utd,1279,5,11,6,11,37,40,-3,39
Brisbane,1279,6,10,5,13,33,42,-9,35
Western Sydn,1279,7,8,9,10,38,47,-9,33
Perth Glory,1279,8,10,2,15,37,50,-13,32
Wellington P,1279,9,5,6,16,31,55,-24,21
CC Mariners,1279,10,4,8,15,28,49,-21,20
Sydney FC,1280,1,20,4,4,64,23,41,64
N'castle Jet,1280,2,15,6,7,59,39,20,51
Melbourne C,1280,3,14,5,10,45,35,10,47
Melbourne V,1280,4,14,5,10,46,38,8,47
Adelaide Utd,1280,5,11,6,11,37,40,-3,39
Brisbane,1280,6,10,5,13,33,42,-9,35
Western Sydn,1280,7,8,9,10,38,47,-9,33
Perth Glory,1280,8,10,2,15,37,50,-13,32
Wellington P,1280,9,5,6,16,31,55,-24,21
CC Mariners,1280,10,4,8,15,28,49,-21,20
Sydney FC,1281,1,21,4,3,67,23,44,67
N'castle Jet,1281,2,16,5,7,59,38,21,53
Melbourne C,1281,3,14,4,11,44,35,9,46
Melbourne V,1281,4,13,5,11,46,41,5,44
Adelaide Utd,1281,5,11,6,11,37,40,-3,39
Brisbane,1281,6,10,5,13,33,42,-9,35
Western Sydn,1281,7,8,9,10,38,47,-9,33
Perth Glory,1281,8,10,2,15,37,50,-13,32
Wellington P,1281,9,5,6,16,31,55,-24,21
CC Mariners,1281,10,4,8,15,28,49,-21,20
Sydney FC,1282,1,20,4,4,64,23,41,64
N'castle Jet,1282,2,16,5,7,59,37,22,53
Melbourne V,1282,3,14,5,10,46,38,8,47
Melbourne C,1282,4,14,4,11,43,35,8,46
Adelaide Utd,1282,5,11,6,11,37,40,-3,39
Brisbane,1282,6,10,5,13,33,42,-9,35
Western Sydn,1282,7,8,9,10,38,47,-9,33
Perth Glory,1282,8,10,2,15,37,50,-13,32
Wellington P,1282,9,5,6,16,31,55,-24,21
CC Mariners,1282,10,4,8,15,28,49,-21,20
Sydney FC,1283,1,20,5,3,64,22,42,65
N'castle Jet,1283,2,16,5,7,59,38,21,53
Melbourne C,1283,3,14,4,11,44,35,9,46
Melbourne V,1283,4,13,6,10,45,38,7,45
Adelaide Utd,1283,5,11,6,11,37,40,-3,39
Brisbane,1283,6,10,5,13,33,42,-9,35
Western Sydn,1283,7,8,9,10,38,47,-9,33
Perth Glory,1283,8,10,2,15,37,50,-13,32
Wellington P,1283,9,5,6,16,31,55,-24,21
CC Mariners,1283,10,4,8,15,28,49,-21,20
Sydney FC,1284,1,20,4,4,66,25,41,64
N'castle Jet,1284,2,16,5,7,62,37,25,53
Melbourne V,1284,3,14,5,10,48,40,8,47
Melbourne C,1284,4,14,4,11,43,38,5,46
Adelaide Utd,1284,5,11,6,11,37,40,-3,39
Brisbane,1284,6,10,5,13,33,42,-9,35
Western Sydn,1284,7,8,9,10,38,47,-9,33
Perth Glory,1284,8,10,2,15,37,50,-13,32
Wellington P,1284,9,5,6,16,31,55,-24,21
CC Mariners,1284,10,4,8,15,28,49,-21,20
Sydney FC,1285,1,21,4,3,66,22,44,67
N'castle Jet,1285,2,15,6,7,58,38,20,51
Melbourne C,1285,3,14,5,10,44,34,10,47
Melbourne V,1285,4,13,5,11,45,40,5,44
Adelaide Utd,1285,5,11,6,11,37,40,-3,39
Brisbane,1285,6,10,5,13,33,42,-9,35
Western Sydn,1285,7,8,9,10,38,47,-9,33
Perth Glory,1285,8,10,2,15,37,50,-13,32
Wellington P,1285,9,5,6,16,31,55,-24,21
CC Mariners,1285,10,4,8,15,28,49,-21,20
Sydney FC,1286,1,20,5,3,65,23,42,65
N'castle Jet,1286,2,15,6,7,59,39,20,51
Melbourne C,1286,3,14,5,10,45,35,10,47
Melbourne V,1286,4,13,6,10,46,39,7,45
Adelaide Utd,1286,5,11,6,11,37,40,-3,39
Brisbane,1286,6,10,5,13,33,42,-9,35
Western Sydn,1286,7,8,9,10,38,47,-9,33
Perth Glory,1286,8,10,2,15,37,50,-13,32
Wellington P,1286,9,5,6,16,31,55,-24,21
CC Mariners,1286,10,4,8,15,28,49,-21,20
Sydney FC,1287,1,21,4,3,67,22,45,67
N'castle Jet,1287,2,16,5,7,59,38,21,53
Melbourne C,1287,3,14,4,11,44,35,9,46
Melbourne V,1287,4,13,5,11,45,41,4,44
Adelaide Utd,1287,5,11,6,11,37,40,-3,39
Brisbane,1287,6,10,5,13,33,42,-9,35
Western Sydn,1287,7,8,9,10,38,47,-9,33
Perth Glory,1287,8,10,2,15,37,50,-13,32
Wellington P,1287,9,5,6,16,31,55,-24,21
CC Mariners,1287,10,4,8,15,28,49,-21,20
Sydney FC,1288,1,21,4,3,68,23,45,67
N'castle Jet,1288,2,15,6,7,58,38,20,51
Melbourne C,1288,3,14,5,10,44,34,10,47
Melbourne V,1288,4,13,5,11,46,42,4,44
Adelaide Utd,1288,5,11,6,11,37,40,-3,39
Brisbane,1288,6,10,5,13,33,42,-9,35
Western Sydn,1288,7,8,9,10,38,47,-9,33
Perth Glory,1288,8,10,2,15,37,50,-13,32
Wellington P,1288,9,5,6,16,31,55,-24,21
CC Mariners,1288,10,4,8,15,28,49,-21,20
Sydney FC,1289,1,21,4,3,66,22,44,67
N'castle Jet,1289,2,16,5,7,62,37,25,53
Melbourne C,1289,3,14,4,11,43,38,5,46
Melbourne V,1289,4,13,5,11,45,40,5,44
Adelaide Utd,1289,5,11,6,11,37,40,-3,39
Brisbane,1289,6,10,5,13,33,42,-9,35
Western Sydn,1289,7,8,9,10,38,47,-9,33
Perth Glory,1289,8,10,2,15,37,50,-13,32
Wellington P,1289,9,5,6,16,31,55,-24,21
CC Mariners,1289,10,4,8,15,28,49,-21,20
Sydney FC,1290,1,21,4,3,69,23,46,67
N'castle Jet,1290,2,16,5,7,59,37,22,53
Melbourne C,1290,3,14,4,11,43,35,8,46
Melbourne V,1290,4,13,5,11,46,43,3,44
Adelaide Utd,1290,5,11,6,11,37,40,-3,39
Brisbane,1290,6,10,5,13,33,42,-9,35
Western Sydn,1290,7,8,9,10,38,47,-9,33
Perth Glory,1290,8,10,2,15,37,50,-13,32
Wellington P,1290,9,5,6,16,31,55,-24,21
CC Mariners,1290,10,4,8,15,28,49,-21,20
Sydney FC,1291,1,20,4,4,64,23,41,64
N'castle Jet,1291,2,15,5,8,58,40,18,50
Melbourne C,1291,3,15,4,10,46,34,12,49
Melbourne V,1291,4,14,5,10,46,38,8,47
Adelaide Utd,1291,5,11,6,11,37,40,-3,39
Brisbane,1291,6,10,5,13,33,42,-9,35
Western Sydn,1291,7,8,9,10,38,47,-9,33
Perth Glory,1291,8,10,2,15,37,50,-13,32
Wellington P,1291,9,5,6,16,31,55,-24,21
CC Mariners,1291,10,4,8,15,28,49,-21,20
Sydney FC,1292,1,21,4,3,67,22,45,67
N'castle Jet,1292,2,16,5,7,59,38,21,53
Melbourne C,1292,3,14,4,11,44,35,9,46
Melbourne V,1292,4,13,5,11,45,41,4,44
Adelaide Utd,1292,5,11,6,11,37,40,-3,39
Brisbane,1292,6,10,5,13,33,42,-9,35
Western Sydn,1292,7,8,9,10,38,47,-9,33
Perth Glory,1292,8,10,2,15,37,50,-13,32
Wellington P,1292,9,5,6,16,31,55,-24,21
CC Mariners,1292,10,4,8,15,28,49,-21,20
Sydney FC,1293,1,21,4,3,68,22,46,67
N'castle Jet,1293,2,15,6,7,59,39,20,51
Melbourne C,1293,3,14,5,10,45,35,10,47
Melbourne V,1293,4,13,5,11,45,42,3,44
Adelaide Utd,1293,5,11,6,11,37,40,-3,39
Brisbane,1293,6,10,5,13,33,42,-9,35
Western Sydn,1293,7,8,9,10,38,47,-9,33
Perth Glory,1293,8,10,2,15,37,50,-13,32
Wellington P,1293,9,5,6,16,31,55,-24,21
CC Mariners,1293,10,4,8,15,28,49,-21,20
Sydney FC,1294,1,21,4,3,66,22,44,67
N'castle Jet,1294,2,15,6,7,57,37,20,51
Melbourne C,1294,3,14,5,10,43,33,10,47
Melbourne V,1294,4,13,5,11,45,40,5,44
Adelaide Utd,1294,5,11,6,11,37,40,-3,39
Brisbane,1294,6,10,5,13,33,42,-9,35
Western Sydn,1294,7,8,9,10,38,47,-9,33
Perth Glory,1294,8,10,2,15,37,50,-13,32
Wellington P,1294,9,5,6,16,31,55,-24,21
CC Mariners,1294,10,4,8,15,28,49,-21,20
Sydney FC,1295,1,21,4,3,66,22,44,67
N'castle Jet,1295,2,15,5,8,57,40,17,50
Melbourne C,1295,3,15,4,10,46,33,13,49
Melbourne V,1295,4,13,5,11,45,40,5,44
Adelaide Utd,1295,5,11,6,11,37,40,-3,39
Brisbane,1295,6,10,5,13,33,42,-9,35
Western Sydn,1295,7,8,9,10,38,47,-9,33
Perth Glory,1295,8,10,2,15,37,50,-13,32
Wellington P,1295,9,5,6,16,31,55,-24,21
CC Mariners,1295,10,4,8,15,28,49,-21,20
Sydney FC,1296,1,20,5,3,65,23,42,65
N'castle Jet,1296,2,15,5,8,60,42,18,50
Melbourne C,1296,3,15,4,10,48,36,12,49
Melbourne V,1296,4,13,6,10,46,39,7,45
Adelaide Utd,1296,5,11,6,11,37,40,-3,39
Brisbane,1296,6,10,5,13,33,42,-9,35
Western Sydn,1296,7,8,9,10,38,47,-9,33
Perth Glory,1296,8,10,2,15,37,50,-13,32
Wellington P,1296,9,5,6,16,31,55,-24,21
CC Mariners,1296,10,4,8,15,28,49,-21,20
Sydney FC,1297,1,21,4,3,65,22,43,67
N'castle Jet,1297,2,15,5,8,58,40,18,50
Melbourne C,1297,3,15,4,10,46,34,12,49
Melbourne V,1297,4,13,5,11,45,39,6,44
Adelaide Utd,1297,5,11,6,11,37,40,-3,39
Brisbane,1297,6,10,5,13,33,42,-9,35
Western Sydn,1297,7,8,9,10,38,47,-9,33
Perth Glory,1297,8,10,2,15,37,50,-13,32
Wellington P,1297,9,5,6,16,31,55,-24,21
CC Mariners,1297,10,4,8,15,28,49,-21,20
Sydney FC,1298,1,21,4,3,66,23,43,67
N'castle Jet,1298,2,16,5,7,61,39,22,53
Melbourne C,1298,3,14,4,11,45,37,8,46
Melbourne V,1298,4,13,5,11,46,40,6,44
Adelaide Utd,1298,5,11,6,11,37,40,-3,39
Brisbane,1298,6,10,5,13,33,42,-9,35
Western Sydn,1298,7,8,9,10,38,47,-9,33
Perth Glory,1298,8,10,2,15,37,50,-13,32
Wellington P,1298,9,5,6,16,31,55,-24,21
CC Mariners,1298,10,4,8,15,28,49,-21,20
Sydney FC,1299,1,21,4,3,66,23,43,67
N'castle Jet,1299,2,16,5,7,60,38,22,53
Melbourne C,1299,3,14,4,11,44,36,8,46
Melbourne V,1299,4,13,5,11,46,40,6,44
Adelaide Utd,1299,5,11,6,11,37,40,-3,39
Brisbane,1299,6,10,5,13,33,42,-9,35
Western Sydn,1299,7,8,9,10,38,47,-9,33
Perth Glory,1299,8,10,2,15,37,50,-13,32
Wellington P,1299,9,5,6,16,31,55,-24,21
CC Mariners,1299,10,4,8,15,28,49,-21,20
Sydney FC,1300,1,21,4,3,66,23,43,67
N'castle Jet,1300,2,15,5,8,59,40,19,50
Melbourne C,1300,3,15,4,10,46,35,11,49
Melbourne V,1300,4,13,5,11,46,40,6,44
Adelaide Utd,1300,5,11,6,11,37,40,-3,39
Brisbane,1300,6,10,5,13,33,42,-9,35
Western Sydn,1300,7,8,9,10,38,47,-9,33
Perth Glory,1300,8,10,2,15,37,50,-13,32
Wellington P,1300,9,5,6,16,31,55,-24,21
CC Mariners,1300,10,4,8,15,28,49,-21,20
Sydney FC,1301,1,21,4,3,66,23,43,67
N'castle Jet,1301,2,15,6,7,58,38,20,51
Melbourne C,1301,3,14,5,10,44,34,10,47
Melbourne V,1301,4,13,5,11,46,40,6,44
Adelaide Utd,1301,5,11,6,11,37,40,-3,39
Brisbane,1301,6,10,5,13,33,42,-9,35
Western Sydn,1301,7,8,9,10,38,47,-9,33
Perth Glory,1301,8,10,2,15,37,50,-13,32
Wellington P,1301,9,5,6,16,31,55,-24,21
CC Mariners,1301,10,4,8,15,28,49,-21,20
Sydney FC,1302,1,21,4,3,65,22,43,67
N'castle Jet,1302,2,15,5,8,59,40,19,50
Melbourne C,1302,3,15,4,10,46,35,11,49
Melbourne V,1302,4,13,5,11,45,39,6,44
Adelaide Utd,1302,5,11,6,11,37,40,-3,39
Brisbane,1302,6,10,5,13,33,42,-9,35
Western Sydn,1302,7,8,9,10,38,47,-9,33
Perth Glory,1302,8,10,2,15,37,50,-13,32
Wellington P,1302,9,5,6,16,31,55,-24,21
CC Mariners,1302,10,4,8,15,28,49,-21,20
Sydney FC,1303,1,20,4,4,64,23,41,64
N'castle Jet,1303,2,16,5,7,60,38,22,53
Melbourne V,1303,3,14,5,10,46,38,8,47
Melbourne C,1303,4,14,4,11,44,36,8,46
Adelaide Utd,1303,5,11,6,11,37,40,-3,39
Brisbane,1303,6,10,5,13,33,42,-9,35
Western Sydn,1303,7,8,9,10,38,47,-9,33
Perth Glory,1303,8,10,2,15,37,50,-13,32
Wellington P,1303,9,5,6,16,31,55,-24,21
CC Mariners,1303,10,4,8,15,28,49,-21,20
Sydney FC,1304,1,21,4,3,67,22,45,67
N'castle Jet,1304,2,15,5,8,59,40,19,50
Melbourne C,1304,3,15,4,10,46,35,11,49
Melbourne V,1304,4,13,5,11,45,41,4,44
Adelaide Utd,1304,5,11,6,11,37,40,-3,39
Brisbane,1304,6,10,5,13,33,42,-9,35
Western Sydn,1304,7,8,9,10,38,47,-9,33
Perth Glory,1304,8,10,2,15,37,50,-13,32
Wellington P,1304,9,5,6,16,31,55,-24,21
CC Mariners,1304,10,4,8,15,28,49,-21,20
Sydney FC,1305,1,21,4,3,68,22,46,67
N'castle Jet,1305,2,16,5,7,58,37,21,53
Melbourne C,1305,3,14,4,11,43,34,9,46
Melbourne V,1305,4,13,5,11,45,42,3,44
Adelaide Utd,1305,5,11,6,11,37,40,-3,39
Brisbane,1305,6,10,5,13,33,42,-9,35
Western Sydn,1305,7,8,9,10,38,47,-9,33
Perth Glory,1305,8,10,2,15,37,50,-13,32
Wellington P,1305,9,5,6,16,31,55,-24,21
CC Mariners,1305,10,4,8,15,28,49,-21,20
Sydney FC,1306,1,20,5,3,66,24,42,65
N'castle Jet,1306,2,16,5,7,60,38,22,53
Melbourne C,1306,3,14,4,11,44,36,8,46
Melbourne V,1306,4,13,6,10,47,40,7,45
Adelaide Utd,1306,5,11,6,11,37,40,-3,39
Brisbane,1306,6,10,5,13,33,42,-9,35
Western Sydn,1306,7,8,9,10,38,47,-9,33
Perth Glory,1306,8,10,2,15,37,50,-13,32
Wellington P,1306,9,5,6,16,31,55,-24,21
CC Mariners,1306,10,4,8,15,28,49,-21,20
Sydney FC,1307,1,21,4,3,67,22,45,67
N'castle Jet,1307,2,16,5,7,60,37,23,53
Melbourne C,1307,3,14,4,11,43,36,7,46
Melbourne V,1307,4,13,5,11,45,41,4,44
Adelaide Utd,1307,5,11,6,11,37,40,-3,39
Brisbane,1307,6,10,5,13,33,42,-9,35
Western Sydn,1307,7,8,9,10,38,47,-9,33
Perth Glory,1307,8,10,2,15,37,50,-13,32
Wellington P,1307,9,5,6,16,31,55,-24,21
CC Mariners,1307,10,4,8,15,28,49,-21,20
Sydney FC,1308,1,20,5,3,65,23,42,65
N'castle Jet,1308,2,16,5,7,60,37,23,53
Melbourne C,1308,3,14,4,11,43,36,7,46
Melbourne V,1308,4,13,6,10,46,39,7,45
Adelaide Utd,1308,5,11,6,11,37,40,-3,39
Brisbane,1308,6,10,5,13,33,42,-9,35
Western Sydn,1308,7,8,9,10,38,47,-9,33
Perth Glory,1308,8,10,2,15,37,50,-13,32
Wellington P,1308,9,5,6,16,31,55,-24,21
CC Mariners,1308,10,4,8,15,28,49,-21,20
Sydney FC,1309,1,20,4,4,65,24,41,64
N'castle Jet,1309,2,15,6,7,58,38,20,51
Melbourne C,1309,3,14,5,10,44,34,10,47
Melbourne V,1309,4,14,5,10,47,39,8,47
Adelaide Utd,1309,5,11,6,11,37,40,-3,39
Brisbane,1309,6,10,5,13,33,42,-9,35
Western Sydn,1309,7,8,9,10,38,47,-9,33
Perth Glory,1309,8,10,2,15,37,50,-13,32
Wellington P,1309,9,5,6,16,31,55,-24,21
CC Mariners,1309,10,4,8,15,28,49,-21,20
Sydney FC,1310,1,20,5,3,64,22,42,65
N'castle Jet,1310,2,15,6,7,57,37,20,51
Melbourne C,1310,3,14,5,10,43,33,10,47
Melbourne V,1310,4,13,6,10,45,38,7,45
Adelaide Utd,1310,5,11,6,11,37,40,-3,39
Brisbane,1310,6,10,5,13,33,42,-9,35
Western Sydn,1310,7,8,9,10,38,47,-9,33
Perth Glory,1310,8,10,2,15,37,50,-13,32
Wellington P,1310,9,5,6,16,31,55,-24,21
CC Mariners,1310,10,4,8,15,28,49,-21,20
Sydney FC,1311,1,20,4,4,65,24,41,64
N'castle Jet,1311,2,15,5,8,58,40,18,50
Melbourne C,1311,3,15,4,10,46,34,12,49
Melbourne V,1311,4,14,5,10,47,39,8,47
Adelaide Utd,1311,5,11,6,11,37,40,-3,39
Brisbane,1311,6,10,5,13,33,42,-9,35
Western Sydn,1311,7,8,9,10,38,47,-9,33
Perth Glory,1311,8,10,2,15,37,50,-13,32
Wellington P,1311,9,5,6,16,31,55,-24,21
CC Mariners,1311,10,4,8,15,28,49,-21,20
Sydney FC,1312,1,21,4,3,66,22,44,67
N'castle Jet,1312,2,16,5,7,60,37,23,53
Melbourne C,1312,3,14,4,11,43,36,7,46
Melbourne V,1312,4,13,5,11,45,40,5,44
Adelaide Utd,1312,5,11,6,11,37,40,-3,39
Brisbane,1312,6,10,5,13,33,42,-9,35
Western Sydn,1312,7,8,9,10,38,47,-9,33
Perth Glory,1312,8,10,2,15,37,50,-13,32
Wellington P,1312,9,5,6,16,31,55,-24,21
CC Mariners,1312,10,4,8,15,28,49,-21,20
Sydney FC,1313,1,21,4,3,67,22,45,67
N'castle Jet,1313,2,15,6,7,59,39,20,51
Melbourne C,1313,3,14,5,10,45,35,10,47
Melbourne V,1313,4,13,5,11,45,41,4,44
Adelaide Utd,1313,5,11,6,11,37,40,-3,39
Brisbane,1313,6,10,5,13,33,42,-9,35
Western Sydn,1313,7,8,9,10,38,47,-9,33
Perth Glory,1313,8,10,2,15,37,50,-13,32
Wellington P,1313,9,5,6,16,31,55,-24,21
CC Mariners,1313,10,4,8,15,28,49,-21,20
Sydney FC,1314,1,21,4,3,66,22,44,67
N'castle Jet,1314,2,16,5,7,58,37,21,53
Melbourne C,1314,3,14,4,11,43,34,9,46
Melbourne V,1314,4,13,5,11,45,40,5,44
Adelaide Utd,1314,5,11,6,11,37,40,-3,39
Brisbane,1314,6,10,5,13,33,42,-9,35
Western Sydn,1314,7,8,9,10,38,47,-9,33
Perth Glory,1314,8,10,2,15,37,50,-13,32
Wellington P,1314,9,5,6,16,31,55,-24,21
CC Mariners,1314,10,4,8,15,28,49,-21,20
Sydney FC,1315,1,21,4,3,69,22,47,67
N'castle Jet,1315,2,15,5,8,59,40,19,50
Melbourne C,1315,3,15,4,10,46,35,11,49
Melbourne V,1315,4,13,5,11,45,43,2,44
Adelaide Utd,1315,5,11,6,11,37,40,-3,39
Brisbane,1315,6,10,5,13,33,42,-9,35
Western Sydn,1315,7,8,9,10,38,47,-9,33
Perth Glory,1315,8,10,2,15,37,50,-13,32
Wellington P,1315,9,5,6,16,31,55,-24,21
CC Mariners,1315,10,4,8,15,28,49,-21,20
Sydney FC,1316,1,20,5,3,65,23,42,65
N'castle Jet,1316,2,15,5,8,58,39,19,50
Melbourne C,1316,3,15,4,10,45,34,11,49
Melbourne V,1316,4,13,6,10,46,39,7,45
Adelaide Utd,1316,5,11,6,11,37,40,-3,39
Brisbane,1316,6,10,5,13,33,42,-9,35
Western Sydn,1316,7,8,9,10,38,47,-9,33
Perth Glory,1316,8,10,2,15,37,50,-13,32
Wellington P,1316,9,5,6,16,31,55,-24,21
CC Mariners,1316,10,4,8,15,28,49,-21,20
Sydney FC,1317,1,21,4,3,66,22,44,67
N'castle Jet,1317,2,16,5,7,60,39,21,53
Melbourne C,1317,3,14,4,11,45,36,9,46
Melbourne V,1317,4,13,5,11,45,40,5,44
Adelaide Utd,1317,5,11,6,11,37,40,-3,39
Brisbane,1317,6,10,5,13,33,42,-9,35
Western Sydn,1317,7,8,9,10,38,47,-9,33
Perth Glory,1317,8,10,2,15,37,50,-13,32
Wellington P,1317,9,5,6,16,31,55,-24,21
CC Mariners,1317,10,4,8,15,28,49,-21,20
Sydney FC,1318,1,20,4,4,67,26,41,64
N'castle Jet,1318,2,16,5,7,60,37,23,53
Melbourne V,1318,3,14,5,10,49,41,8,47
Melbourne C,1318,4,14,4,11,43,36,7,46
Adelaide Utd,1318,5,11,6,11,37,40,-3,39
Brisbane,1318,6,10,5,13,33,42,-9,35
Western Sydn,1318,7,8,9,10,38,47,-9,33
Perth Glory,1318,8,10,2,15,37,50,-13,32
Wellington P,1318,9,5,6,16,31,55,-24,21
CC Mariners,1318,10,4,8,15,28,49,-21,20
Sydney FC,1319,1,20,5,3,65,23,42,65
N'castle Jet,1319,2,15,5,8,57,39,18,50
Melbourne C,1319,3,15,4,10,45,33,12,49
Melbourne V,1319,4,13,6,10,46,39,7,45
Adelaide Utd,1319,5,11,6,11,37,40,-3,39
Brisbane,1319,6,10,5,13,33,42,-9,35
Western Sydn,1319,7,8,9,10,38,47,-9,33
Perth Glory,1319,8,10,2,15,37,50,-13,32
Wellington P,1319,9,5,6,16,31,55,-24,21
CC Mariners,1319,10,4,8,15,28,49,-21,20
Sydney FC,1320,1,21,4,3,66,23,43,67
N'castle Jet,1320,2,16,5,7,61,40,21,53
Melbourne C,1320,3,14,4,11,46,37,9,46
Melbourne V,1320,4,13,5,11,46,40,6,44
Adelaide Utd,1320,5,11,6,11,37,40,-3,39
Brisbane,1320,6,10,5,13,33,42,-9,35
Western Sydn,1320,7,8,9,10,38,47,-9,33
Perth Glory,1320,8,10,2,15,37,50,-13,32
Wellington P,1320,9,5,6,16,31,55,-24,21
CC Mariners,1320,10,4,8,15,28,49,-21,20
Sydney FC,1321,1,21,4,3,65,22,43,67
N'castle Jet,1321,2,16,5,7,61,37,24,53
Melbourne C,1321,3,14,4,11,43,37,6,46
Melbourne V,1321,4,13,5,11,45,39,6,44
Adelaide Utd,1321,5,11,6,11,37,40,-3,39
Brisbane,1321,6,10,5,13,33,42,-9,35
Western Sydn,1321,7,8,9,10,38,47,-9,33
Perth Glory,1321,8,10,2,15,37,50,-13,32
Wellington P,1321,9,5,6,16,31,55,-24,21
CC Mariners,1321,10,4,8,15,28,49,-21,20
Sydney FC,1322,1,21,4,3,66,22,44,67
N'castle Jet,1322,2,16,5,7,61,39,22,53
Melbourne C,1322,3,14,4,11,45,37,8,46
Melbourne V,1322,4,13,5,11,45,40,5,44
Adelaide Utd,1322,5,11,6,11,37,40,-3,39
Brisbane,1322,6,10,5,13,33,42,-9,35
Western Sydn,1322,7,8,9,10,38,47,-9,33
Perth Glory,1322,8,10,2,15,37,50,-13,32
Wellington P,1322,9,5,6,16,31,55,-24,21
CC Mariners,1322,10,4,8,15,28,49,-21,20
Sydney FC,1323,1,20,4,4,64,23,41,64
N'castle Jet,1323,2,16,5,7,61,38,23,53
Melbourne V,1323,3,14,5,10,46,38,8,47
Melbourne C,1323,4,14,4,11,44,37,7,46
Adelaide Utd,1323,5,11,6,11,37,40,-3,39
Brisbane,1323,6,10,5,13,33,42,-9,35
Western Sydn,1323,7,8,9,10,38,47,-9,33
Perth Glory,1323,8,10,2,15,37,50,-13,32
Wellington P,1323,9,5,6,16,31,55,-24,21
CC Mariners,1323,10,4,8,15,28,49,-21,20
Sydney FC,1324,1,21,4,3,68,22,46,67
N'castle Jet,1324,2,16,5,7,62,37,25,53
Melbourne C,1324,3,14,4,11,43,38,5,46
Melbourne V,1324,4,13,5,11,45,42,3,44
Adelaide Utd,1324,5,11,6,11,37,40,-3,39
Brisbane,1324,6,10,5,13,33,42,-9,35
Western Sydn,1324,7,8,9,10,38,47,-9,33
Perth Glory,1324,8,10,2,15,37,50,-13,32
Wellington P,1324,9,5,6,16,31,55,-24,21
CC Mariners,1324,10,4,8,15,28,49,-21,20
Sydney FC,1325,1,21,4,3,67,22,45,67
N'castle Jet,1325,2,16,5,7,60,37,23,53
Melbourne C,1325,3,14,4,11,43,36,7,46
Melbourne V,1325,4,13,5,11,45,41,4,44
Adelaide Utd,1325,5,11,6,11,37,40,-3,39
Brisbane,1325,6,10,5,13,33,42,-9,35
Western Sydn,1325,7,8,9,10,38,47,-9,33
Perth Glory,1325,8,10,2,15,37,50,-13,32
Wellington P,1325,9,5,6,16,31,55,-24,21
CC Mariners,1325,10,4,8,15,28,49,-21,20
Sydney FC,1326,1,21,4,3,65,22,43,67
N'castle Jet,1326,2,15,5,8,57,38,19,50
Melbourne C,1326,3,15,4,10,44,33,11,49
Melbourne V,1326,4,13,5,11,45,39,6,44
Adelaide Utd,1326,5,11,6,11,37,40,-3,39
Brisbane,1326,6,10,5,13,33,42,-9,35
Western Sydn,1326,7,8,9,10,38,47,-9,33
Perth Glory,1326,8,10,2,15,37,50,-13,32
Wellington P,1326,9,5,6,16,31,55,-24,21
CC Mariners,1326,10,4,8,15,28,49,-21,20
Sydney FC,1327,1,21,4,3,69,23,46,67
N'castle Jet,1327,2,16,5,7,59,37,22,53
Melbourne C,1327,3,14,4,11,43,35,8,46
Melbourne V,1327,4,13,5,11,46,43,3,44
Adelaide Utd,1327,5,11,6,11,37,40,-3,39
Brisbane,1327,6,10,5,13,33,42,-9,35
Western Sydn,1327,7,8,9,10,38,47,-9,33
Perth Glory,1327,8,10,2,15,37,50,-13,32
Wellington P,1327,9,5,6,16,31,55,-24,21
CC Mariners,1327,10,4,8,15,28,49,-21,20
Sydney FC,1328,1,21,4,3,66,22,44,67
N'castle Jet,1328,2,15,6,7,59,39,20,51
Melbourne C,1328,3,14,5,10,45,35,10,47
Melbourne V,1328,4,13,5,11,45,40,5,44
Adelaide Utd,1328,5,11,6,11,37,40,-3,39
Brisbane,1328,6,10,5,13,33,42,-9,35
Western Sydn,1328,7,8,9,10,38,47,-9,33
Perth Glory,1328,8,10,2,15,37,50,-13,32
Wellington P,1328,9,5,6,16,31,55,-24,21
CC Mariners,1328,10,4,8,15,28,49,-21,20
Sydney FC,1329,1,20,5,3,64,22,42,65
N'castle Jet,1329,2,16,5,7,58,37,21,53
Melbourne C,1329,3,14,4,11,43,34,9,46
Melbourne V,1329,4,13,6,10,45,38,7,45
Adelaide Utd,1329,5,11,6,11,37,40,-3,39
Brisbane,1329,6,10,5,13,33,42,-9,35
Western Sydn,1329,7,8,9,10,38,47,-9,33
Perth Glory,1329,8,10,2,15,37,50,-13,32
Wellington P,1329,9,5,6,16,31,55,-24,21
CC Mariners,1329,10,4,8,15,28,49,-21,20
Sydney FC,1330,1,20,4,4,65,24,41,64
N'castle Jet,1330,2,15,6,7,58,38,20,51
Melbourne C,1330,3,14,5,10,44,34,10,47
Melbourne V,1330,4,14,5,10,47,39,8,47
Adelaide Utd,1330,5,11,6,11,37,40,-3,39
Brisbane,1330,6,10,5,13,33,42,-9,35
Western Sydn,1330,7,8,9,10,38,47,-9,33
Perth Glory,1330,8,10,2,15,37,50,-13,32
Wellington P,1330,9,5,6,16,31,55,-24,21
CC Mariners,1330,10,4,8,15,28,49,-21,20
Sydney FC,1331,1,21,4,3,66,23,43,67
N'castle Jet,1331,2,15,5,8,58,39,19,50
Melbourne C,1331,3,15,4,10,45,34,11,49
Melbourne V,1331,4,13,5,11,46,40,6,44
Adelaide Utd,1331,5,11,6,11,37,40,-3,39
Brisbane,1331,6,10,5,13,33,42,-9,35
Western Sydn,1331,7,8,9,10,38,47,-9,33
Perth Glory,1331,8,10,2,15,37,50,-13,32
Wellington P,1331,9,5,6,16,31,55,-24,21
CC Mariners,1331,10,4,8,15,28,49,-21,20
Sydney FC,1332,1,21,4,3,66,22,44,67
N'castle Jet,1332,2,15,6,7,58,38,20,51
Melbourne C,1332,3,14,5,10,44,34,10,47
Melbourne V,1332,4,13,5,11,45,40,5,44
Adelaide Utd,1332,5,11,6,11,37,40,-3,39
Brisbane,1332,6,10,5,13,33,42,-9,35
Western Sydn,1332,7,8,9,10,38,47,-9,33
Perth Glory,1332,8,10,2,15,37,50,-13,32
Wellington P,1332,9,5,6,16,31,55,-24,21
CC Mariners,1332,10,4,8,15,28,49,-21,20
Sydney FC,1333,1,20,5,3,65,23,42,65
N'castle Jet,1333,2,16,5,7,59,37,22,53
Melbourne C,1333,3,14,4,11,43,35,8,46
Melbourne V,1333,4,13,6,10,46,39,7,45
Adelaide Utd,1333,5,11,6,11,37,40,-3,39
Brisbane,1333,6,10,5,13,33,42,-9,35
Western Sydn,1333,7,8,9,10,38,47,-9,33
Perth Glory,1333,8,10,2,15,37,50,-13,32
Wellington P,1333,9,5,6,16,31,55,-24,21
CC Mariners,1333,10,4,8,15,28,49,-21,20
Sydney FC,1334,1,21,4,3,67,22,45,67
N'castle Jet,1334,2,15,5,8,59,40,19,50
Melbourne C,1334,3,15,4,10,46,35,11,49
Melbourne V,1334,4,13,5,11,45,41,4,44
Adelaide Utd,1334,5,11,6,11,37,40,-3,39
Brisbane,1334,6,10,5,13,33,42,-9,35
Western Sydn,1334,7,8,9,10,38,47,-9,33
Perth Glory,1334,8,10,2,15,37,50,-13,32
Wellington P,1334,9,5,6,16,31,55,-24,21
CC Mariners,1334,10,4,8,15,28,49,-21,20
Sydney FC,1335,1,20,5,3,65,23,42,65
N'castle Jet,1335,2,15,6,7,57,37,20,51
Melbourne C,1335,3,14,5,10,43,33,10,47
Melbourne V,1335,4,13,6,10,46,39,7,45
Adelaide Utd,1335,5,11,6,11,37,40,-3,39
Brisbane,1335,6,10,5,13,33,42,-9,35
Western Sydn,1335,7,8,9,10,38,47,-9,33
Perth Glory,1335,8,10,2,15,37,50,-13,32
Wellington P,1335,9,5,6,16,31,55,-24,21
CC Mariners,1335,10,4,8,15,28,49,-21,20
Sydney FC,1336,1,20,4,4,64,23,41,64
N'castle Jet,1336,2,15,5,8,57,38,19,50
Melbourne C,1336,3,15,4,10,44,33,11,49
Melbourne V,1336,4,14,5,10,46,38,8,47
Adelaide Utd,1336,5,11,6,11,37,40,-3,39
Brisbane,1336,6,10,5,13,33,42,-9,35
Western Sydn,1336,7,8,9,10,38,47,-9,33
Perth Glory,1336,8,10,2,15,37,50,-13,32
Wellington P,1336,9,5,6,16,31,55,-24,21
CC Mariners,1336,10,4,8,15,28,49,-21,20
Sydney FC,1337,1,21,4,3,65,22,43,67
N'castle Jet,1337,2,16,5,7,60,37,23,53
Melbourne C,1337,3,14,4,11,43,36,7,46
Melbourne V,1337,4,13,5,11,45,39,6,44
Adelaide Utd,1337,5,11,6,11,37,40,-3,39
Brisbane,1337,6,10,5,13,33,42,-9,35
Western Sydn,1337,7,8,9,10,38,47,-9,33
Perth Glory,1337,8,10,2,15,37,50,-13,32
Wellington P,1337,9,5,6,16,31,55,-24,21
CC Mariners,1337,10,4,8,15,28,49,-21,20
Sydney FC,1338,1,21,4,3,66,23,43,67
N'castle Jet,1338,2,15,5,8,58,41,17,50
Melbourne C,1338,3,15,4,10,47,34,13,49
Melbourne V,1338,4,13,5,11,46,40,6,44
Adelaide Utd,1338,5,11,6,11,37,40,-3,39
Brisbane,1338,6,10,5,13,33,42,-9,35
Western Sydn,1338,7,8,9,10,38,47,-9,33
Perth Glory,1338,8,10,2,15,37,50,-13,32
Wellington P,1338,9,5,6,16,31,55,-24,21
CC Mariners,1338,10,4,8,15,28,49,-21,20
Sydney FC,1339,1,20,4,4,64,23,41,64
N'castle Jet,1339,2,16,5,7,59,37,22,53
Melbourne V,1339,3,14,5,10,46,38,8,47
Melbourne C,1339,4,14,4,11,43,35,8,46
Adelaide Utd,1339,5,11,6,11,37,40,-3,39
Brisbane,1339,6,10,5,13,33,42,-9,35
Western Sydn,1339,7,8,9,10,38,47,-9,33
Perth Glory,1339,8,10,2,15,37,50,-13,32
Wellington P,1339,9,5,6,16,31,55,-24,21
CC Mariners,1339,10,4,8,15,28,49,-21,20
Sydney FC,1340,1,21,4,3,67,22,45,67
N'castle Jet,1340,2,16,5,7,61,39,22,53
Melbourne C,1340,3,14,4,11,45,37,8,46
Melbourne V,1340,4,13,5,11,45,41,4,44
Adelaide Utd,1340,5,11,6,11,37,40,-3,39
Brisbane,1340,6,10,5,13,33,42,-9,35
Western Sydn,1340,7,8,9,10,38,47,-9,33
Perth Glory,1340,8,10,2,15,37,50,-13,32
Wellington P,1340,9,5,6,16,31,55,-24,21
CC Mariners,1340,10,4,8,15,28,49,-21,20
Sydney FC,1341,1,21,4,3,69,22,47,67
N'castle Jet,1341,2,16,5,7,60,38,22,53
Melbourne C,1341,3,14,4,11,44,36,8,46
Melbourne V,1341,4,13,5,11,45,43,2,44
Adelaide Utd,1341,5,11,6,11,37,40,-3,39
Brisbane,1341,6,10,5,13,33,42,-9,35
Western Sydn,1341,7,8,9,10,38,47,-9,33
Perth Glory,1341,8,10,2,15,37,50,-13,32
Wellington P,1341,9,5,6,16,31,55,-24,21
CC Mariners,1341,10,4,8,15,28,49,-21,20
Sydney FC,1342,1,21,4,3,68,22,46,67
N'castle Jet,1342,2,15,6,7,58,38,20,51
Melbourne C,1342,3,14,5,10,44,34,10,47
Melbourne V,1342,4,13,5,11,45,42,3,44
Adelaide Utd,1342,5,11,6,11,37,40,-3,39
Brisbane,1342,6,10,5,13,33,42,-9,35
Western Sydn,1342,7,8,9,10,38,47,-9,33
Perth Glory,1342,8,10,2,15,37,50,-13,32
Wellington P,1342,9,5,6,16,31,55,-24,21
CC Mariners,1342,10,4,8,15,28,49,-21,20
Sydney FC,1343,1,21,4,3,66,22,44,67
N'castle Jet,1343,2,15,5,8,58,40,18,50
Melbourne C,1343,3,15,4,10,46,34,12,49
Melbourne V,1343,4,13,5,11,45,40,5,44
Adelaide Utd,1343,5,11,6,11,37,40,-3,39
Brisbane,1343,6,10,5,13,33,42,-9,35
Western Sydn,1343,7,8,9,10,38,47,-9,33
Perth Glory,1343,8,10,2,15,37,50,-13,32
Wellington P,1343,9,5,6,16,31,55,-24,21
CC Mariners,1343,10,4,8,15,28,49,-21,20
Sydney FC,1344,1,21,4,3,68,25,43,67
N'castle Jet,1344,2,15,6,7,59,39,20,51
Melbourne C,1344,3,14,5,10,45,35,10,47
Melbourne V,1344,4,13,5,11,48,42,6,44
Adelaide Utd,1344,5,11,6,11,37,40,-3,39
Brisbane,1344,6,10,5,13,33,42,-9,35
Western Sydn,1344,7,8,9,10,38,47,-9,33
Perth Glory,1344,8,10,2,15,37,50,-13,32
Wellington P,1344,9,5,6,16,31,55,-24,21
CC Mariners,1344,10,4,8,15,28,49,-21,20
Sydney FC,1345,1,21,4,3,66,22,44,67
N'castle Jet,1345,2,16,5,7,60,37,23,53
Melbourne C,1345,3,14,4,11,43,36,7,46
Melbourne V,1345,4,13,5,11,45,40,5,44
Adelaide Utd,1345,5,11,6,11,37,40,-3,39
Brisbane,1345,6,10,5,13,33,42,-9,35
Western Sydn,1345,7,8,9,10,38,47,-9,33
Perth Glory,1345,8,10,2,15,37,50,-13,32
Wellington P,1345,9,5,6,16,31,55,-24,21
CC Mariners,1345,10,4,8,15,28,49,-21,20
Sydney FC,1346,1,20,4,4,66,25,41,64
N'castle Jet,1346,2,16,5,7,58,37,21,53
Melbourne V,1346,3,14,5,10,48,40,8,47
Melbourne C,1346,4,14,4,11,43,34,9,46
Adelaide Utd,1346,5,11,6,11,37,40,-3,39
Brisbane,1346,6,10,5,13,33,42,-9,35
Western Sydn,1346,7,8,9,10,38,47,-9,33
Perth Glory,1346,8,10,2,15,37,50,-13,32
Wellington P,1346,9,5,6,16,31,55,-24,21
CC Mariners,1346,10,4,8,15,28,49,-21,20
Sydney FC,1347,1,21,4,3,66,23,43,67
N'castle Jet,1347,2,16,5,7,60,38,22,53
Melbourne C,1347,3,14,4,11,44,36,8,46
Melbourne V,1347,4,13,5,11,46,40,6,44
Adelaide Utd,1347,5,11,6,11,37,40,-3,39
Brisbane,1347,6,10,5,13,33,42,-9,35
Western Sydn,1347,7,8,9,10,38,47,-9,33
Perth Glory,1347,8,10,2,15,37,50,-13,32
Wellington P,1347,9,5,6,16,31,55,-24,21
CC Mariners,1347,10,4,8,15,28,49,-21,20
Sydney FC,1348,1,21,4,3,68,22,46,67
N'castle Jet,1348,2,15,6,7,57,37,20,51
Melbourne C,1348,3,14,5,10,43,33,10,47
Melbourne V,1348,4,13,5,11,45,42,3,44
Adelaide Utd,1348,5,11,6,11,37,40,-3,39
Brisbane,1348,6,10,5,13,33,42,-9,35
Western Sydn,1348,7,8,9,10,38,47,-9,33
Perth Glory,1348,8,10,2,15,37,50,-13,32
Wellington P,1348,9,5,6,16,31,55,-24,21
CC Mariners,1348,10,4,8,15,28,49,-21,20
Sydney FC,1349,1,20,5,3,65,23,42,65
N'castle Jet,1349,2,16,5,7,58,37,21,53
Melbourne C,1349,3,14,4,11,43,34,9,46
Melbourne V,1349,4,13,6,10,46,39,7,45
Adelaide Utd,1349,5,11,6,11,37,40,-3,39
Brisbane,1349,6,10,5,13,33,42,-9,35
Western Sydn,1349,7,8,9,10,38,47,-9,33
Perth Glory,1349,8,10,2,15,37,50,-13,32
Wellington P,1349,9,5,6,16,31,55,-24,21
CC Mariners,1349,10,4,8,15,28,49,-21,20
Sydney FC,1350,1,21,4,3,69,23,46,67
N'castle Jet,1350,2,16,5,7,58,37,21,53
Melbourne C,1350,3,14,4,11,43,34,9,46
Melbourne V,1350,4,13,5,11,46,43,3,44
Adelaide Utd,1350,5,11,6,11,37,40,-3,39
Brisbane,1350,6,10,5,13,33,42,-9,35
Western Sydn,1350,7,8,9,10,38,47,-9,33
Perth Glory,1350,8,10,2,15,37,50,-13,32
Wellington P,1350,9,5,6,16,31,55,-24,21
CC Mariners,1350,10,4,8,15,28,49,-21,20
Sydney FC,1351,1,20,5,3,65,23,42,65
N'castle Jet,1351,2,15,5,8,58,39,19,50
Melbourne C,1351,3,15,4,10,45,34,11,49
Melbourne V,1351,4,13,6,10,46,39,7,45
Adelaide Utd,1351,5,11,6,11,37,40,-3,39
Brisbane,1351,6,10,5,13,33,42,-9,35
Western Sydn,1351,7,8,9,10,38,47,-9,33
Perth Glory,1351,8,10,2,15,37,50,-13,32
Wellington P,1351,9,5,6,16,31,55,-24,21
CC Mariners,1351,10,4,8,15,28,49,-21,20
Sydney FC,1352,1,21,4,3,66,22,44,67
N'castle Jet,1352,2,15,5,8,60,43,17,50
Melbourne C,1352,3,15,4,10,49,36,13,49
Melbourne V,1352,4,13,5,11,45,40,5,44
Adelaide Utd,1352,5,11,6,11,37,40,-3,39
Brisbane,1352,6,10,5,13,33,42,-9,35
Western Sydn,1352,7,8,9,10,38,47,-9,33
Perth Glory,1352,8,10,2,15,37,50,-13,32
Wellington P,1352,9,5,6,16,31,55,-24,21
CC Mariners,1352,10,4,8,15,28,49,-21,20
Sydney FC,1353,1,21,4,3,67,22,45,67
N'castle Jet,1353,2,15,6,7,59,39,20,51
Melbourne C,1353,3,14,5,10,45,35,10,47
Melbourne V,1353,4,13,5,11,45,41,4,44
Adelaide Utd,1353,5,11,6,11,37,40,-3,39
Brisbane,1353,6,10,5,13,33,42,-9,35
Western Sydn,1353,7,8,9,10,38,47,-9,33
Perth Glory,1353,8,10,2,15,37,50,-13,32
Wellington P,1353,9,5,6,16,31,55,-24,21
CC Mariners,1353,10,4,8,15,28,49,-21,20
Sydney FC,1354,1,21,4,3,66,23,43,67
N'castle Jet,1354,2,16,5,7,59,38,21,53
Melbourne C,1354,3,14,4,11,44,35,9,46
Melbourne V,1354,4,13,5,11,46,40,6,44
Adelaide Utd,1354,5,11,6,11,37,40,-3,39
Brisbane,1354,6,10,5,13,33,42,-9,35
Western Sydn,1354,7,8,9,10,38,47,-9,33
Perth Glory,1354,8,10,2,15,37,50,-13,32
Wellington P,1354,9,5,6,16,31,55,-24,21
CC Mariners,1354,10,4,8,15,28,49,-21,20
Sydney FC,1355,1,20,5,3,65,23,42,65
N'castle Jet,1355,2,15,6,7,59,39,20,51
Melbourne C,1355,3,14,5,10,45,35,10,47
Melbourne V,1355,4,13,6,10,46,39,7,45
Adelaide Utd,1355,5,11,6,11,37,40,-3,39
Brisbane,1355,6,10,5,13,33,42,-9,35
Western Sydn,1355,7,8,9,10,38,47,-9,33
Perth Glory,1355,8,10,2,15,37,50,-13,32
Wellington P,1355,9,5,6,16,31,55,-24,21
CC Mariners,1355,10,4,8,15,28,49,-21,20
Sydney FC,1356,1,20,4,4,64,23,41,64
N'castle Jet,1356,2,16,5,7,58,37,21,53
Melbourne V,1356,3,14,5,10,46,38,8,47
Melbourne C,1356,4,14,4,11,43,34,9,46
Adelaide Utd,1356,5,11,6,11,37,40,-3,39
Brisbane,1356,6,10,5,13,33,42,-9,35
Western Sydn,1356,7,8,9,10,38,47,-9,33
Perth Glory,1356,8,10,2,15,37,50,-13,32
Wellington P,1356,9,5,6,16,31,55,-24,21
CC Mariners,1356,10,4,8,15,28,49,-21,20
Sydney FC,1357,1,21,4,3,65,22,43,67
N'castle Jet,1357,2,16,5,7,60,38,22,53
Melbourne C,1357,3,14,4,11,44,36,8,46
Melbourne V,1357,4,13,5,11,45,39,6,44
Adelaide Utd,1357,5,11,6,11,37,40,-3,39
Brisbane,1357,6,10,5,13,33,42,-9,35
Western Sydn,1357,7,8,9,10,38,47,-9,33
Perth Glory,1357,8,10,2,15,37,50,-13,32
Wellington P,1357,9,5,6,16,31,55,-24,21
CC Mariners,1357,10,4,8,15,28,49,-21,20
Sydney FC,1358,1,20,4,4,65,25,40,64
N'castle Jet,1358,2,16,5,7,60,38,22,53
Melbourne V,1358,3,14,5,10,48,39,9,47
Melbourne C,1358,4,14,4,11,44,36,8,46
Adelaide Utd,1358,5,11,6,11,37,40,-3,39
Brisbane,1358,6,10,5,13,33,42,-9,35
Western Sydn,1358,7,8,9,10,38,47,-9,33
Perth Glory,1358,8,10,2,15,37,50,-13,32
Wellington P,1358,9,5,6,16,31,55,-24,21
CC Mariners,1358,10,4,8,15,28,49,-21,20
Sydney FC,1359,1,21,4,3,67,23,44,67
N'castle Jet,1359,2,15,6,7,57,37,20,51
Melbourne C,1359,3,14,5,10,43,33,10,47
Melbourne V,1359,4,13,5,11,46,41,5,44
Adelaide Utd,1359,5,11,6,11,37,40,-3,39
Brisbane,1359,6,10,5,13,33,42,-9,35
Western Sydn,1359,7,8,9,10,38,47,-9,33
Perth Glory,1359,8,10,2,15,37,50,-13,32
Wellington P,1359,9,5,6,16,31,55,-24,21
CC Mariners,1359,10,4,8,15,28,49,-21,20
Sydney FC,1360,1,21,4,3,66,22,44,67
N'castle Jet,1360,2,15,6,7,58,38,20,51
Melbourne C,1360,3,14,5,10,44,34,10,47
Melbourne V,1360,4,13,5,11,45,40,5,44
Adelaide Utd,1360,5,11,6,11,37,40,-3,39
Brisbane,1360,6,10,5,13,33,42,-9,35
Western Sydn,1360,7,8,9,10,38,47,-9,33
Perth Glory,1360,8,10,2,15,37,50,-13,32
Wellington P,1360,9,5,6,16,31,55,-24,21
CC Mariners,1360,10,4,8,15,28,49,-21,20
Sydney FC,1361,1,21,4,3,65,22,43,67
N'castle Jet,1361,2,16,5,7,58,37,21,53
Melbourne C,1361,3,14,4,11,43,34,9,46
Melbourne V,1361,4,13,5,11,45,39,6,44
Adelaide Utd,1361,5,11,6,11,37,40,-3,39
Brisbane,1361,6,10,5,13,33,42,-9,35
Western Sydn,1361,7,8,9,10,38,47,-9,33
Perth Glory,1361,8,10,2,15,37,50,-13,32
Wellington P,1361,9,5,6,16,31,55,-24,21
CC Mariners,1361,10,4,8,15,28,49,-21,20
Sydney FC,1362,1,21,4,3,65,22,43,67
N'castle Jet,1362,2,16,5,7,60,37,23,53
Melbourne C,1362,3,14,4,11,43,36,7,46
Melbourne V,1362,4,13,5,11,45,39,6,44
Adelaide Utd,1362,5,11,6,11,37,40,-3,39
Brisbane,1362,6,10,5,13,33,42,-9,35
Western Sydn,1362,7,8,9,10,38,47,-9,33
Perth Glory,1362,8,10,2,15,37,50,-13,32
Wellington P,1362,9,5,6,16,31,55,-24,21
CC Mariners,1362,10,4,8,15,28,49,-21,20
Sydney FC,1363,1,21,4,3,67,22,45,67
N'castle Jet,1363,2,15,6,7,59,39,20,51
Melbourne C,1363,3,14,5,10,45,35,10,47
Melbourne V,1363,4,13,5,11,45,41,4,44
Adelaide Utd,1363,5,11,6,11,37,40,-3,39
Brisbane,1363,6,10,5,13,33,42,-9,35
Western Sydn,1363,7,8,9,10,38,47,-9,33
Perth Glory,1363,8,10,2,15,37,50,-13,32
Wellington P,1363,9,5,6,16,31,55,-24,21
CC Mariners,1363,10,4,8,15,28,49,-21,20
Sydney FC,1364,1,21,4,3,66,23,43,67
N'castle Jet,1364,2,15,5,8,57,38,19,50
Melbourne C,1364,3,15,4,10,44,33,11,49
Melbourne V,1364,4,13,5,11,46,40,6,44
Adelaide Utd,1364,5,11,6,11,37,40,-3,39
Brisbane,1364,6,10,5,13,33,42,-9,35
Western Sydn,1364,7,8,9,10,38,47,-9,33
Perth Glory,1364,8,10,2,15,37,50,-13,32
Wellington P,1364,9,5,6,16,31,55,-24,21
CC Mariners,1364,10,4,8,15,28,49,-21,20
Sydney FC,1365,1,20,5,3,64,22,42,65
N'castle Jet,1365,2,15,6,7,59,39,20,51
Melbourne C,1365,3,14,5,10,45,35,10,47
Melbourne V,1365,4,13,6,10,45,38,7,45
Adelaide Utd,1365,5,11,6,11,37,40,-3,39
Brisbane,1365,6,10,5,13,33,42,-9,35
Western Sydn,1365,7,8,9,10,38,47,-9,33
Perth Glory,1365,8,10,2,15,37,50,-13,32
Wellington P,1365,9,5,6,16,31,55,-24,21
CC Mariners,1365,10,4,8,15,28,49,-21,20
Sydney FC,1366,1,20,5,3,65,23,42,65
N'castle Jet,1366,2,16,5,7,59,37,22,53
Melbourne C,1366,3,14,4,11,43,35,8,46
Melbourne V,1366,4,13,6,10,46,39,7,45
Adelaide Utd,1366,5,11,6,11,37,40,-3,39
Brisbane,1366,6,10,5,13,33,42,-9,35
Western Sydn,1366,7,8,9,10,38,47,-9,33
Perth Glory,1366,8,10,2,15,37,50,-13,32
Wellington P,1366,9,5,6,16,31,55,-24,21
CC Mariners,1366,10,4,8,15,28,49,-21,20
Sydney FC,1367,1,21,4,3,69,23,46,67
N'castle Jet,1367,2,15,5,8,57,38,19,50
Melbourne C,1367,3,15,4,10,44,33,11,49
Melbourne V,1367,4,13,5,11,46,43,3,44
Adelaide Utd,1367,5,11,6,11,37,40,-3,39
Brisbane,1367,6,10,5,13,33,42,-9,35
Western Sydn,1367,7,8,9,10,38,47,-9,33
Perth Glory,1367,8,10,2,15,37,50,-13,32
Wellington P,1367,9,5,6,16,31,55,-24,21
CC Mariners,1367,10,4,8,15,28,49,-21,20
Sydney FC,1368,1,21,4,3,67,24,43,67
N'castle Jet,1368,2,15,6,7,59,39,20,51
Melbourne C,1368,3,14,5,10,45,35,10,47
Melbourne V,1368,4,13,5,11,47,41,6,44
Adelaide Utd,1368,5,11,6,11,37,40,-3,39
Brisbane,1368,6,10,5,13,33,42,-9,35
Western Sydn,1368,7,8,9,10,38,47,-9,33
Perth Glory,1368,8,10,2,15,37,50,-13,32
Wellington P,1368,9,5,6,16,31,55,-24,21
CC Mariners,1368,10,4,8,15,28,49,-21,20
Sydney FC,1369,1,21,4,3,70,24,46,67
N'castle Jet,1369,2,16,5,7,59,38,21,53
Melbourne C,1369,3,14,4,11,44,35,9,46
Melbourne V,1369,4,13,5,11,47,44,3,44
Adelaide Utd,1369,5,11,6,11,37,40,-3,39
Brisbane,1369,6,10,5,13,33,42,-9,35
Western Sydn,1369,7,8,9,10,38,47,-9,33
Perth Glory,1369,8,10,2,15,37,50,-13,32
Wellington P,1369,9,5,6,16,31,55,-24,21
CC Mariners,1369,10,4,8,15,28,49,-21,20
Sydney FC,1370,1,21,4,3,66,22,44,67
N'castle Jet,1370,2,16,5,7,61,39,22,53
Melbourne C,1370,3,14,4,11,45,37,8,46
Melbourne V,1370,4,13,5,11,45,40,5,44
Adelaide Utd,1370,5,11,6,11,37,40,-3,39
Brisbane,1370,6,10,5,13,33,42,-9,35
Western Sydn,1370,7,8,9,10,38,47,-9,33
Perth Glory,1370,8,10,2,15,37,50,-13,32
Wellington P,1370,9,5,6,16,31,55,-24,21
CC Mariners,1370,10,4,8,15,28,49,-21,20
Sydney FC,1371,1,21,4,3,65,22,43,67
N'castle Jet,1371,2,16,5,7,60,37,23,53
Melbourne C,1371,3,14,4,11,43,36,7,46
Melbourne V,1371,4,13,5,11,45,39,6,44
Adelaide Utd,1371,5,11,6,11,37,40,-3,39
Brisbane,1371,6,10,5,13,33,42,-9,35
Western Sydn,1371,7,8,9,10,38,47,-9,33
Perth Glory,1371,8,10,2,15,37,50,-13,32
Wellington P,1371,9,5,6,16,31,55,-24,21
CC Mariners,1371,10,4,8,15,28,49,-21,20
Sydney FC,1372,1,21,4,3,68,24,44,67
N'castle Jet,1372,2,15,5,8,58,39,19,50
Melbourne C,1372,3,15,4,10,45,34,11,49
Melbourne V,1372,4,13,5,11,47,42,5,44
Adelaide Utd,1372,5,11,6,11,37,40,-3,39
Brisbane,1372,6,10,5,13,33,42,-9,35
Western Sydn,1372,7,8,9,10,38,47,-9,33
Perth Glory,1372,8,10,2,15,37,50,-13,32
Wellington P,1372,9,5,6,16,31,55,-24,21
CC Mariners,1372,10,4,8,15,28,49,-21,20
Sydney FC,1373,1,21,4,3,66,23,43,67
N'castle Jet,1373,2,15,5,8,57,38,19,50
Melbourne C,1373,3,15,4,10,44,33,11,49
Melbourne V,1373,4,13,5,11,46,40,6,44
Adelaide Utd,1373,5,11,6,11,37,40,-3,39
Brisbane,1373,6,10,5,13,33,42,-9,35
Western Sydn,1373,7,8,9,10,38,47,-9,33
Perth Glory,1373,8,10,2,15,37,50,-13,32
Wellington P,1373,9,5,6,16,31,55,-24,21
CC Mariners,1373,10,4,8,15,28,49,-21,20
Sydney FC,1374,1,21,4,3,67,22,45,67
N'castle Jet,1374,2,16,5,7,59,38,21,53
Melbourne C,1374,3,14,4,11,44,35,9,46
Melbourne V,1374,4,13,5,11,45,41,4,44
Adelaide Utd,1374,5,11,6,11,37,40,-3,39
Brisbane,1374,6,10,5,13,33,42,-9,35
Western Sydn,1374,7,8,9,10,38,47,-9,33
Perth Glory,1374,8,10,2,15,37,50,-13,32
Wellington P,1374,9,5,6,16,31,55,-24,21
CC Mariners,1374,10,4,8,15,28,49,-21,20
Sydney FC,1375,1,21,4,3,67,22,45,67
N'castle Jet,1375,2,16,5,7,59,37,22,53
Melbourne C,1375,3,14,4,11,43,35,8,46
Melbourne V,1375,4,13,5,11,45,41,4,44
Adelaide Utd,1375,5,11,6,11,37,40,-3,39
Brisbane,1375,6,10,5,13,33,42,-9,35
Western Sydn,1375,7,8,9,10,38,47,-9,33
Perth Glory,1375,8,10,2,15,37,50,-13,32
Wellington P,1375,9,5,6,16,31,55,-24,21
CC Mariners,1375,10,4,8,15,28,49,-21,20
Sydney FC,1376,1,21,4,3,66,23,43,67
N'castle Jet,1376,2,15,6,7,58,38,20,51
Melbourne C,1376,3,14,5,10,44,34,10,47
Melbourne V,1376,4,13,5,11,46,40,6,44
Adelaide Utd,1376,5,11,6,11,37,40,-3,39
Brisbane,1376,6,10,5,13,33,42,-9,35
Western Sydn,1376,7,8,9,10,38,47,-9,33
Perth Glory,1376,8,10,2,15,37,50,-13,32
Wellington P,1376,9,5,6,16,31,55,-24,21
CC Mariners,1376,10,4,8,15,28,49,-21,20
Sydney FC,1377,1,20,4,4,65,24,41,64
N'castle Jet,1377,2,16,5,7,60,39,21,53
Melbourne V,1377,3,14,5,10,47,39,8,47
Melbourne C,1377,4,14,4,11,45,36,9,46
Adelaide Utd,1377,5,11,6,11,37,40,-3,39
Brisbane,1377,6,10,5,13,33,42,-9,35
Western Sydn,1377,7,8,9,10,38,47,-9,33
Perth Glory,1377,8,10,2,15,37,50,-13,32
Wellington P,1377,9,5,6,16,31,55,-24,21
CC Mariners,1377,10,4,8,15,28,49,-21,20
Sydney FC,1378,1,21,4,3,66,23,43,67
N'castle Jet,1378,2,16,5,7,62,38,24,53
Melbourne C,1378,3,14,4,11,44,38,6,46
Melbourne V,1378,4,13,5,11,46,40,6,44
Adelaide Utd,1378,5,11,6,11,37,40,-3,39
Brisbane,1378,6,10,5,13,33,42,-9,35
Western Sydn,1378,7,8,9,10,38,47,-9,33
Perth Glory,1378,8,10,2,15,37,50,-13,32
Wellington P,1378,9,5,6,16,31,55,-24,21
CC Mariners,1378,10,4,8,15,28,49,-21,20
Sydney FC,1379,1,21,4,3,66,22,44,67
N'castle Jet,1379,2,16,5,7,58,37,21,53
Melbourne C,1379,3,14,4,11,43,34,9,46
Melbourne V,1379,4,13,5,11,45,40,5,44
Adelaide Utd,1379,5,11,6,11,37,40,-3,39
Brisbane,1379,6,10,5,13,33,42,-9,35
Western Sydn,1379,7,8,9,10,38,47,-9,33
Perth Glory,1379,8,10,2,15,37,50,-13,32
Wellington P,1379,9,5,6,16,31,55,-24,21
CC Mariners,1379,10,4,8,15,28,49,-21,20
Sydney FC,1380,1,21,4,3,66,23,43,67
N'castle Jet,1380,2,16,5,7,63,40,23,53
Melbourne C,1380,3,14,4,11,46,39,7,46
Melbourne V,1380,4,13,5,11,46,40,6,44
Adelaide Utd,1380,5,11,6,11,37,40,-3,39
Brisbane,1380,6,10,5,13,33,42,-9,35
Western Sydn,1380,7,8,9,10,38,47,-9,33
Perth Glory,1380,8,10,2,15,37,50,-13,32
Wellington P,1380,9,5,6,16,31,55,-24,21
CC Mariners,1380,10,4,8,15,28,49,-21,20
Sydney FC,1381,1,21,4,3,66,22,44,67
N'castle Jet,1381,2,16,5,7,60,38,22,53
Melbourne C,1381,3,14,4,11,44,36,8,46
Melbourne V,1381,4,13,5,11,45,40,5,44
Adelaide Utd,1381,5,11,6,11,37,40,-3,39
Brisbane,1381,6,10,5,13,33,42,-9,35
Western Sydn,1381,7,8,9,10,38,47,-9,33
Perth Glory,1381,8,10,2,15,37,50,-13,32
Wellington P,1381,9,5,6,16,31,55,-24,21
CC Mariners,1381,10,4,8,15,28,49,-21,20
Sydney FC,1382,1,21,4,3,67,22,45,67
N'castle Jet,1382,2,15,5,8,58,39,19,50
Melbourne C,1382,3,15,4,10,45,34,11,49
Melbourne V,1382,4,13,5,11,45,41,4,44
Adelaide Utd,1382,5,11,6,11,37,40,-3,39
Brisbane,1382,6,10,5,13,33,42,-9,35
Western Sydn,1382,7,8,9,10,38,47,-9,33
Perth Glory,1382,8,10,2,15,37,50,-13,32
Wellington P,1382,9,5,6,16,31,55,-24,21
CC Mariners,1382,10,4,8,15,28,49,-21,20
Sydney FC,1383,1,20,4,4,64,23,41,64
N'castle Jet,1383,2,15,6,7,57,37,20,51
Melbourne C,1383,3,14,5,10,43,33,10,47
Melbourne V,1383,4,14,5,10,46,38,8,47
Adelaide Utd,1383,5,11,6,11,37,40,-3,39
Brisbane,1383,6,10,5,13,33,42,-9,35
Western Sydn,1383,7,8,9,10,38,47,-9,33
Perth Glory,1383,8,10,2,15,37,50,-13,32
Wellington P,1383,9,5,6,16,31,55,-24,21
CC Mariners,1383,10,4,8,15,28,49,-21,20
Sydney FC,1384,1,21,4,3,67,22,45,67
N'castle Jet,1384,2,16,5,7,58,37,21,53
Melbourne C,1384,3,14,4,11,43,34,9,46
Melbourne V,1384,4,13,5,11,45,41,4,44
Adelaide Utd,1384,5,11,6,11,37,40,-3,39
Brisbane,1384,6,10,5,13,33,42,-9,35
Western Sydn,1384,7,8,9,10,38,47,-9,33
Perth Glory,1384,8,10,2,15,37,50,-13,32
Wellington P,1384,9,5,6,16,31,55,-24,21
CC Mariners,1384,10,4,8,15,28,49,-21,20
Sydney FC,1385,1,20,5,3,65,23,42,65
N'castle Jet,1385,2,16,5,7,59,37,22,53
Melbourne C,1385,3,14,4,11,43,35,8,46
Melbourne V,1385,4,13,6,10,46,39,7,45
Adelaide Utd,1385,5,11,6,11,37,40,-3,39
Brisbane,1385,6,10,5,13,33,42,-9,35
Western Sydn,1385,7,8,9,10,38,47,-9,33
Perth Glory,1385,8,10,2,15,37,50,-13,32
Wellington P,1385,9,5,6,16,31,55,-24,21
CC Mariners,1385,10,4,8,15,28,49,-21,20
Sydney FC,1386,1,20,5,3,67,25,42,65
N'castle Jet,1386,2,15,6,7,58,38,20,51
Melbourne C,1386,3,14,5,10,44,34,10,47
Melbourne V,1386,4,13,6,10,48,41,7,45
Adelaide Utd,1386,5,11,6,11,37,40,-3,39
Brisbane,1386,6,10,5,13,33,42,-9,35
Western Sydn,1386,7,8,9,10,38,47,-9,33
Perth Glory,1386,8,10,2,15,37,50,-13,32
Wellington P,1386,9,5,6,16,31,55,-24,21
CC Mariners,1386,10,4,8,15,28,49,-21,20
Sydney FC,1387,1,21,4,3,68,24,44,67
N'castle Jet,1387,2,16,5,7,59,38,21,53
Melbourne C,1387,3,14,4,11,44,35,9,46
Melbourne V,1387,4,13,5,11,47,42,5,44
Adelaide Utd,1387,5,11,6,11,37,40,-3,39
Brisbane,1387,6,10,5,13,33,42,-9,35
Western Sydn,1387,7,8,9,10,38,47,-9,33
Perth Glory,1387,8,10,2,15,37,50,-13,32
Wellington P,1387,9,5,6,16,31,55,-24,21
CC Mariners,1387,10,4,8,15,28,49,-21,20
Sydney FC,1388,1,20,4,4,64,24,40,64
N'castle Jet,1388,2,15,6,7,58,38,20,51
Melbourne C,1388,3,14,5,10,44,34,10,47
Melbourne V,1388,4,14,5,10,47,38,9,47
Adelaide Utd,1388,5,11,6,11,37,40,-3,39
Brisbane,1388,6,10,5,13,33,42,-9,35
Western Sydn,1388,7,8,9,10,38,47,-9,33
Perth Glory,1388,8,10,2,15,37,50,-13,32
Wellington P,1388,9,5,6,16,31,55,-24,21
CC Mariners,1388,10,4,8,15,28,49,-21,20
Sydney FC,1389,1,21,4,3,68,23,45,67
N'castle Jet,1389,2,16,5,7,60,38,22,53
Melbourne C,1389,3,14,4,11,44,36,8,46
Melbourne V,1389,4,13,5,11,46,42,4,44
Adelaide Utd,1389,5,11,6,11,37,40,-3,39
Brisbane,1389,6,10,5,13,33,42,-9,35
Western Sydn,1389,7,8,9,10,38,47,-9,33
Perth Glory,1389,8,10,2,15,37,50,-13,32
Wellington P,1389,9,5,6,16,31,55,-24,21
CC Mariners,1389,10,4,8,15,28,49,-21,20
Sydney FC,1390,1,21,4,3,65,22,43,67
N'castle Jet,1390,2,16,5,7,58,37,21,53
Melbourne C,1390,3,14,4,11,43,34,9,46
Melbourne V,1390,4,13,5,11,45,39,6,44
Adelaide Utd,1390,5,11,6,11,37,40,-3,39
Brisbane,1390,6,10,5,13,33,42,-9,35
Western Sydn,1390,7,8,9,10,38,47,-9,33
Perth Glory,1390,8,10,2,15,37,50,-13,32
Wellington P,1390,9,5,6,16,31,55,-24,21
CC Mariners,1390,10,4,8,15,28,49,-21,20
Sydney FC,1391,1,21,4,3,68,25,43,67
N'castle Jet,1391,2,15,5,8,57,38,19,50
Melbourne C,1391,3,15,4,10,44,33,11,49
Melbourne V,1391,4,13,5,11,48,42,6,44
Adelaide Utd,1391,5,11,6,11,37,40,-3,39
Brisbane,1391,6,10,5,13,33,42,-9,35
Western Sydn,1391,7,8,9,10,38,47,-9,33
Perth Glory,1391,8,10,2,15,37,50,-13,32
Wellington P,1391,9,5,6,16,31,55,-24,21
CC Mariners,1391,10,4,8,15,28,49,-21,20
Sydney FC,1392,1,21,4,3,68,22,46,67
N'castle Jet,1392,2,16,5,7,59,37,22,53
Melbourne C,1392,3,14,4,11,43,35,8,46
Melbourne V,1392,4,13,5,11,45,42,3,44
Adelaide Utd,1392,5,11,6,11,37,40,-3,39
Brisbane,1392,6,10,5,13,33,42,-9,35
Western Sydn,1392,7,8,9,10,38,47,-9,33
Perth Glory,1392,8,10,2,15,37,50,-13,32
Wellington P,1392,9,5,6,16,31,55,-24,21
CC Mariners,1392,10,4,8,15,28,49,-21,20
Sydney FC,1393,1,20,5,3,65,23,42,65
N'castle Jet,1393,2,15,5,8,58,39,19,50
Melbourne C,1393,3,15,4,10,45,34,11,49
Melbourne V,1393,4,13,6,10,46,39,7,45
Adelaide Utd,1393,5,11,6,11,37,40,-3,39
Brisbane,1393,6,10,5,13,33,42,-9,35
Western Sydn,1393,7,8,9,10,38,47,-9,33
Perth Glory,1393,8,10,2,15,37,50,-13,32
Wellington P,1393,9,5,6,16,31,55,-24,21
CC Mariners,1393,10,4,8,15,28,49,-21,20
Sydney FC,1394,1,21,4,3,69,23,46,67
N'castle Jet,1394,2,15,5,8,58,39,19,50
Melbourne C,1394,3,15,4,10,45,34,11,49
Melbourne V,1394,4,13,5,11,46,43,3,44
Adelaide Utd,1394,5,11,6,11,37,40,-3,39
Brisbane,1394,6,10,5,13,33,42,-9,35
Western Sydn,1394,7,8,9,10,38,47,-9,33
Perth Glory,1394,8,10,2,15,37,50,-13,32
Wellington P,1394,9,5,6,16,31,55,-24,21
CC Mariners,1394,10,4,8,15,28,49,-21,20
Sydney FC,1395,1,21,4,3,66,22,44,67
N'castle Jet,1395,2,16,5,7,59,38,21,53
Melbourne C,1395,3,14,4,11,44,35,9,46
Melbourne V,1395,4,13,5,11,45,40,5,44
Adelaide Utd,1395,5,11,6,11,37,40,-3,39
Brisbane,1395,6,10,5,13,33,42,-9,35
Western Sydn,1395,7,8,9,10,38,47,-9,33
Perth Glory,1395,8,10,2,15,37,50,-13,32
Wellington P,1395,9,5,6,16,31,55,-24,21
CC Mariners,1395,10,4,8,15,28,49,-21,20
Sydney FC,1396,1,20,4,4,66,26,40,64
N'castle Jet,1396,2,16,5,7,60,38,22,53
Melbourne V,1396,3,14,5,10,49,40,9,47
Melbourne C,1396,4,14,4,11,44,36,8,46
Adelaide Utd,1396,5,11,6,11,37,40,-3,39
Brisbane,1396,6,10,5,13,33,42,-9,35
Western Sydn,1396,7,8,9,10,38,47,-9,33
Perth Glory,1396,8,10,2,15,37,50,-13,32
Wellington P,1396,9,5,6,16,31,55,-24,21
CC Mariners,1396,10,4,8,15,28,49,-21,20
Sydney FC,1397,1,21,4,3,65,22,43,67
N'castle Jet,1397,2,16,5,7,62,37,25,53
Melbourne C,1397,3,14,4,11,43,38,5,46
Melbourne V,1397,4,13,5,11,45,39,6,44
Adelaide Utd,1397,5,11,6,11,37,40,-3,39
Brisbane,1397,6,10,5,13,33,42,-9,35
Western Sydn,1397,7,8,9,10,38,47,-9,33
Perth Glory,1397,8,10,2,15,37,50,-13,32
Wellington P,1397,9,5,6,16,31,55,-24,21
CC Mariners,1397,10,4,8,15,28,49,-21,20
Sydney FC,1398,1,21,4,3,66,23,43,67
N'castle Jet,1398,2,16,5,7,60,38,22,53
Melbourne C,1398,3,14,4,11,44,36,8,46
Melbourne V,1398,4,13,5,11,46,40,6,44
Adelaide Utd,1398,5,11,6,11,37,40,-3,39
Brisbane,1398,6,10,5,13,33,42,-9,35
Western Sydn,1398,7,8,9,10,38,47,-9,33
Perth Glory,1398,8,10,2,15,37,50,-13,32
Wellington P,1398,9,5,6,16,31,55,-24,21
CC Mariners,1398,10,4,8,15,28,49,-21,20
Sydney FC,1399,1,21,4,3,65,22,43,67
N'castle Jet,1399,2,16,5,7,59,37,22,53
Melbourne C,1399,3,14,4,11,43,35,8,46
Melbourne V,1399,4,13,5,11,45,39,6,44
Adelaide Utd,1399,5,11,6,11,37,40,-3,39
Brisbane,1399,6,10,5,13,33,42,-9,35
Western Sydn,1399,7,8,9,10,38,47,-9,33
Perth Glory,1399,8,10,2,15,37,50,-13,32
Wellington P,1399,9,5,6,16,31,55,-24,21
CC Mariners,1399,10,4,8,15,28,49,-21,20
Sydney FC,1400,1,21,4,3,66,22,44,67
N'castle Jet,1400,2,16,5,7,59,38,21,53
Melbourne C,1400,3,14,4,11,44,35,9,46
Melbourne V,1400,4,13,5,11,45,40,5,44
Adelaide Utd,1400,5,11,6,11,37,40,-3,39
Brisbane,1400,6,10,5,13,33,42,-9,35
Western Sydn,1400,7,8,9,10,38,47,-9,33
Perth Glory,1400,8,10,2,15,37,50,-13,32
Wellington P,1400,9,5,6,16,31,55,-24,21
CC Mariners,1400,10,4,8,15,28,49,-21,20
Sydney FC,1401,1,20,4,4,65,24,41,64
N'castle Jet,1401,2,15,6,7,58,38,20,51
Melbourne C,1401,3,14,5,10,44,34,10,47
Melbourne V,1401,4,14,5,10,47,39,8,47
Adelaide Utd,1401,5,11,6,11,37,40,-3,39
Brisbane,1401,6,10,5,13,33,42,-9,35
Western Sydn,1401,7,8,9,10,38,47,-9,33
Perth Glory,1401,8,10,2,15,37,50,-13,32
Wellington P,1401,9,5,6,16,31,55,-24,21
CC Mariners,1401,10,4,8,15,28,49,-21,20
Sydney FC,1402,1,20,4,4,65,24,41,64
N'castle Jet,1402,2,16,5,7,61,39,22,53
Melbourne V,1402,3,14,5,10,47,39,8,47
Melbourne C,1402,4,14,4,11,45,37,8,46
Adelaide Utd,1402,5,11,6,11,37,40,-3,39
Brisbane,1402,6,10,5,13,33,42,-9,35
Western Sydn,1402,7,8,9,10,38,47,-9,33
Perth Glory,1402,8,10,2,15,37,50,-13,32
Wellington P,1402,9,5,6,16,31,55,-24,21
CC Mariners,1402,10,4,8,15,28,49,-21,20
Sydney FC,1403,1,21,4,3,67,22,45,67
N'castle Jet,1403,2,15,5,8,59,41,18,50
Melbourne C,1403,3,15,4,10,47,35,12,49
Melbourne V,1403,4,13,5,11,45,41,4,44
Adelaide Utd,1403,5,11,6,11,37,40,-3,39
Brisbane,1403,6,10,5,13,33,42,-9,35
Western Sydn,1403,7,8,9,10,38,47,-9,33
Perth Glory,1403,8,10,2,15,37,50,-13,32
Wellington P,1403,9,5,6,16,31,55,-24,21
CC Mariners,1403,10,4,8,15,28,49,-21,20
Sydney FC,1404,1,20,5,3,64,22,42,65
N'castle Jet,1404,2,16,5,7,59,38,21,53
Melbourne C,1404,3,14,4,11,44,35,9,46
Melbourne V,1404,4,13,6,10,45,38,7,45
Adelaide Utd,1404,5,11,6,11,37,40,-3,39
Brisbane,1404,6,10,5,13,33,42,-9,35
Western Sydn,1404,7,8,9,10,38,47,-9,33
Perth Glory,1404,8,10,2,15,37,50,-13,32
Wellington P,1404,9,5,6,16,31,55,-24,21
CC Mariners,1404,10,4,8,15,28,49,-21,20
Sydney FC,1405,1,20,5,3,65,23,42,65
N'castle Jet,1405,2,15,5,8,57,40,17,50
Melbourne C,1405,3,15,4,10,46,33,13,49
Melbourne V,1405,4,13,6,10,46,39,7,45
Adelaide Utd,1405,5,11,6,11,37,40,-3,39
Brisbane,1405,6,10,5,13,33,42,-9,35
Western Sydn,1405,7,8,9,10,38,47,-9,33
Perth Glory,1405,8,10,2,15,37,50,-13,32
Wellington P,1405,9,5,6,16,31,55,-24,21
CC Mariners,1405,10,4,8,15,28,49,-21,20
Sydney FC,1406,1,21,4,3,68,22,46,67
N'castle Jet,1406,2,16,5,7,59,38,21,53
Melbourne C,1406,3,14,4,11,44,35,9,46
Melbourne V,1406,4,13,5,11,45,42,3,44
Adelaide Utd,1406,5,11,6,11,37,40,-3,39
Brisbane,1406,6,10,5,13,33,42,-9,35
Western Sydn,1406,7,8,9,10,38,47,-9,33
Perth Glory,1406,8,10,2,15,37,50,-13,32
Wellington P,1406,9,5,6,16,31,55,-24,21
CC Mariners,1406,10,4,8,15,28,49,-21,20
Sydney FC,1407,1,21,4,3,67,22,45,67
N'castle Jet,1407,2,15,5,8,57,40,17,50
Melbourne C,1407,3,15,4,10,46,33,13,49
Melbourne V,1407,4,13,5,11,45,41,4,44
Adelaide Utd,1407,5,11,6,11,37,40,-3,39
Brisbane,1407,6,10,5,13,33,42,-9,35
Western Sydn,1407,7,8,9,10,38,47,-9,33
Perth Glory,1407,8,10,2,15,37,50,-13,32
Wellington P,1407,9,5,6,16,31,55,-24,21
CC Mariners,1407,10,4,8,15,28,49,-21,20
Sydney FC,1408,1,21,4,3,66,22,44,67
N'castle Jet,1408,2,16,5,7,58,37,21,53
Melbourne C,1408,3,14,4,11,43,34,9,46
Melbourne V,1408,4,13,5,11,45,40,5,44
Adelaide Utd,1408,5,11,6,11,37,40,-3,39
Brisbane,1408,6,10,5,13,33,42,-9,35
Western Sydn,1408,7,8,9,10,38,47,-9,33
Perth Glory,1408,8,10,2,15,37,50,-13,32
Wellington P,1408,9,5,6,16,31,55,-24,21
CC Mariners,1408,10,4,8,15,28,49,-21,20
Sydney FC,1409,1,20,4,4,65,24,41,64
N'castle Jet,1409,2,16,5,7,59,38,21,53
Melbourne V,1409,3,14,5,10,47,39,8,47
Melbourne C,1409,4,14,4,11,44,35,9,46
Adelaide Utd,1409,5,11,6,11,37,40,-3,39
Brisbane,1409,6,10,5,13,33,42,-9,35
Western Sydn,1409,7,8,9,10,38,47,-9,33
Perth Glory,1409,8,10,2,15,37,50,-13,32
Wellington P,1409,9,5,6,16,31,55,-24,21
CC Mariners,1409,10,4,8,15,28,49,-21,20
Sydney FC,1410,1,21,4,3,66,23,43,67
N'castle Jet,1410,2,16,5,7,60,38,22,53
Melbourne C,1410,3,14,4,11,44,36,8,46
Melbourne V,1410,4,13,5,11,46,40,6,44
Adelaide Utd,1410,5,11,6,11,37,40,-3,39
Brisbane,1410,6,10,5,13,33,42,-9,35
Western Sydn,1410,7,8,9,10,38,47,-9,33
Perth Glory,1410,8,10,2,15,37,50,-13,32
Wellington P,1410,9,5,6,16,31,55,-24,21
CC Mariners,1410,10,4,8,15,28,49,-21,20
Sydney FC,1411,1,21,4,3,65,22,43,67
N'castle Jet,1411,2,16,5,7,59,37,22,53
Melbourne C,1411,3,14,4,11,43,35,8,46
Melbourne V,1411,4,13,5,11,45,39,6,44
Adelaide Utd,1411,5,11,6,11,37,40,-3,39
Brisbane,1411,6,10,5,13,33,42,-9,35
Western Sydn,1411,7,8,9,10,38,47,-9,33
Perth Glory,1411,8,10,2,15,37,50,-13,32
Wellington P,1411,9,5,6,16,31,55,-24,21
CC Mariners,1411,10,4,8,15,28,49,-21,20
Sydney FC,1412,1,21,4,3,67,23,44,67
N'castle Jet,1412,2,15,6,7,58,38,20,51
Melbourne C,1412,3,14,5,10,44,34,10,47
Melbourne V,1412,4,13,5,11,46,41,5,44
Adelaide Utd,1412,5,11,6,11,37,40,-3,39
Brisbane,1412,6,10,5,13,33,42,-9,35
Western Sydn,1412,7,8,9,10,38,47,-9,33
Perth Glory,1412,8,10,2,15,37,50,-13,32
Wellington P,1412,9,5,6,16,31,55,-24,21
CC Mariners,1412,10,4,8,15,28,49,-21,20
Sydney FC,1413,1,20,4,4,66,25,41,64
N'castle Jet,1413,2,16,5,7,60,37,23,53
Melbourne V,1413,3,14,5,10,48,40,8,47
Melbourne C,1413,4,14,4,11,43,36,7,46
Adelaide Utd,1413,5,11,6,11,37,40,-3,39
Brisbane,1413,6,10,5,13,33,42,-9,35
Western Sydn,1413,7,8,9,10,38,47,-9,33
Perth Glory,1413,8,10,2,15,37,50,-13,32
Wellington P,1413,9,5,6,16,31,55,-24,21
CC Mariners,1413,10,4,8,15,28,49,-21,20
Sydney FC,1414,1,20,5,3,66,24,42,65
N'castle Jet,1414,2,16,5,7,60,38,22,53
Melbourne C,1414,3,14,4,11,44,36,8,46
Melbourne V,1414,4,13,6,10,47,40,7,45
Adelaide Utd,1414,5,11,6,11,37,40,-3,39
Brisbane,1414,6,10,5,13,33,42,-9,35
Western Sydn,1414,7,8,9,10,38,47,-9,33
Perth Glory,1414,8,10,2,15,37,50,-13,32
Wellington P,1414,9,5,6,16,31,55,-24,21
CC Mariners,1414,10,4,8,15,28,49,-21,20
Sydney FC,1415,1,21,4,3,67,22,45,67
N'castle Jet,1415,2,15,5,8,57,38,19,50
Melbourne C,1415,3,15,4,10,44,33,11,49
Melbourne V,1415,4,13,5,11,45,41,4,44
Adelaide Utd,1415,5,11,6,11,37,40,-3,39
Brisbane,1415,6,10,5,13,33,42,-9,35
Western Sydn,1415,7,8,9,10,38,47,-9,33
Perth Glory,1415,8,10,2,15,37,50,-13,32
Wellington P,1415,9,5,6,16,31,55,-24,21
CC Mariners,1415,10,4,8,15,28,49,-21,20
Sydney FC,1416,1,21,4,3,69,24,45,67
N'castle Jet,1416,2,15,5,8,57,38,19,50
Melbourne C,1416,3,15,4,10,44,33,11,49
Melbourne V,1416,4,13,5,11,47,43,4,44
Adelaide Utd,1416,5,11,6,11,37,40,-3,39
Brisbane,1416,6,10,5,13,33,42,-9,35
Western Sydn,1416,7,8,9,10,38,47,-9,33
Perth Glory,1416,8,10,2,15,37,50,-13,32
Wellington P,1416,9,5,6,16,31,55,-24,21
CC Mariners,1416,10,4,8,15,28,49,-21,20
Sydney FC,1417,1,21,4,3,68,24,44,67
N'castle Jet,1417,2,16,5,7,60,39,21,53
Melbourne C,1417,3,14,4,11,45,36,9,46
Melbourne V,1417,4,13,5,11,47,42,5,44
Adelaide Utd,1417,5,11,6,11,37,40,-3,39
Brisbane,1417,6,10,5,13,33,42,-9,35
Western Sydn,1417,7,8,9,10,38,47,-9,33
Perth Glory,1417,8,10,2,15,37,50,-13,32
Wellington P,1417,9,5,6,16,31,55,-24,21
CC Mariners,1417,10,4,8,15,28,49,-21,20
Sydney FC,1418,1,20,5,3,65,23,42,65
N'castle Jet,1418,2,16,5,7,58,37,21,53
Melbourne C,1418,3,14,4,11,43,34,9,46
Melbourne V,1418,4,13,6,10,46,39,7,45
Adelaide Utd,1418,5,11,6,11,37,40,-3,39
Brisbane,1418,6,10,5,13,33,42,-9,35
Western Sydn,1418,7,8,9,10,38,47,-9,33
Perth Glory,1418,8,10,2,15,37,50,-13,32
Wellington P,1418,9,5,6,16,31,55,-24,21
CC Mariners,1418,10,4,8,15,28,49,-21,20
Sydney FC,1419,1,21,4,3,67,23,44,67
N'castle Jet,1419,2,16,5,7,64,38,26,53
Melbourne C,1419,3,14,4,11,44,40,4,46
Melbourne V,1419,4,13,5,11,46,41,5,44
Adelaide Utd,1419,5,11,6,11,37,40,-3,39
Brisbane,1419,6,10,5,13,33,42,-9,35
Western Sydn,1419,7,8,9,10,38,47,-9,33
Perth Glory,1419,8,10,2,15,37,50,-13,32
Wellington P,1419,9,5,6,16,31,55,-24,21
CC Mariners,1419,10,4,8,15,28,49,-21,20
Sydney FC,1420,1,21,4,3,67,24,43,67
N'castle Jet,1420,2,16,5,7,59,37,22,53
Melbourne C,1420,3,14,4,11,43,35,8,46
Melbourne V,1420,4,13,5,11,47,41,6,44
Adelaide Utd,1420,5,11,6,11,37,40,-3,39
Brisbane,1420,6,10,5,13,33,42,-9,35
Western Sydn,1420,7,8,9,10,38,47,-9,33
Perth Glory,1420,8,10,2,15,37,50,-13,32
Wellington P,1420,9,5,6,16,31,55,-24,21
CC Mariners,1420,10,4,8,15,28,49,-21,20
Sydney FC,1421,1,21,4,3,66,23,43,67
N'castle Jet,1421,2,15,5,8,57,39,18,50
Melbourne C,1421,3,15,4,10,45,33,12,49
Melbourne V,1421,4,13,5,11,46,40,6,44
Adelaide Utd,1421,5,11,6,11,37,40,-3,39
Brisbane,1421,6,10,5,13,33,42,-9,35
Western Sydn,1421,7,8,9,10,38,47,-9,33
Perth Glory,1421,8,10,2,15,37,50,-13,32
Wellington P,1421,9,5,6,16,31,55,-24,21
CC Mariners,1421,10,4,8,15,28,49,-21,20
Sydney FC,1422,1,21,4,3,67,23,44,67
N'castle Jet,1422,2,16,5,7,58,37,21,53
Melbourne C,1422,3,14,4,11,43,34,9,46
Melbourne V,1422,4,13,5,11,46,41,5,44
Adelaide Utd,1422,5,11,6,11,37,40,-3,39
Brisbane,1422,6,10,5,13,33,42,-9,35
Western Sydn,1422,7,8,9,10,38,47,-9,33
Perth Glory,1422,8,10,2,15,37,50,-13,32
Wellington P,1422,9,5,6,16,31,55,-24,21
CC Mariners,1422,10,4,8,15,28,49,-21,20
Sydney FC,1423,1,20,4,4,66,26,40,64
N'castle Jet,1423,2,15,6,7,58,38,20,51
Melbourne C,1423,3,14,5,10,44,34,10,47
Melbourne V,1423,4,14,5,10,49,40,9,47
Adelaide Utd,1423,5,11,6,11,37,40,-3,39
Brisbane,1423,6,10,5,13,33,42,-9,35
Western Sydn,1423,7,8,9,10,38,47,-9,33
Perth Glory,1423,8,10,2,15,37,50,-13,32
Wellington P,1423,9,5,6,16,31,55,-24,21
CC Mariners,1423,10,4,8,15,28,49,-21,20
Sydney FC,1424,1,21,4,3,66,23,43,67
N'castle Jet,1424,2,15,5,8,58,40,18,50
Melbourne C,1424,3,15,4,10,46,34,12,49
Melbourne V,1424,4,13,5,11,46,40,6,44
Adelaide Utd,1424,5,11,6,11,37,40,-3,39
Brisbane,1424,6,10,5,13,33,42,-9,35
Western Sydn,1424,7,8,9,10,38,47,-9,33
Perth Glory,1424,8,10,2,15,37,50,-13,32
Wellington P,1424,9,5,6,16,31,55,-24,21
CC Mariners,1424,10,4,8,15,28,49,-21,20
Sydney FC,1425,1,21,4,3,66,23,43,67
N'castle Jet,1425,2,15,6,7,58,38,20,51
Melbourne C,1425,3,14,5,10,44,34,10,47
Melbourne V,1425,4,13,5,11,46,40,6,44
Adelaide Utd,1425,5,11,6,11,37,40,-3,39
Brisbane,1425,6,10,5,13,33,42,-9,35
Western Sydn,1425,7,8,9,10,38,47,-9,33
Perth Glory,1425,8,10,2,15,37,50,-13,32
Wellington P,1425,9,5,6,16,31,55,-24,21
CC Mariners,1425,10,4,8,15,28,49,-21,20
Sydney FC,1426,1,21,4,3,67,23,44,67
N'castle Jet,1426,2,16,5,7,60,37,23,53
Melbourne C,1426,3,14,4,11,43,36,7,46
Melbourne V,1426,4,13,5,11,46,41,5,44
Adelaide Utd,1426,5,11,6,11,37,40,-3,39
Brisbane,1426,6,10,5,13,33,42,-9,35
Western Sydn,1426,7,8,9,10,38,47,-9,33
Perth Glory,1426,8,10,2,15,37,50,-13,32
Wellington P,1426,9,5,6,16,31,55,-24,21
CC Mariners,1426,10,4,8,15,28,49,-21,20
Sydney FC,1427,1,21,4,3,67,23,44,67
N'castle Jet,1427,2,15,6,7,57,37,20,51
Melbourne C,1427,3,14,5,10,43,33,10,47
Melbourne V,1427,4,13,5,11,46,41,5,44
Adelaide Utd,1427,5,11,6,11,37,40,-3,39
Brisbane,1427,6,10,5,13,33,42,-9,35
Western Sydn,1427,7,8,9,10,38,47,-9,33
Perth Glory,1427,8,10,2,15,37,50,-13,32
Wellington P,1427,9,5,6,16,31,55,-24,21
CC Mariners,1427,10,4,8,15,28,49,-21,20
Sydney FC,1428,1,20,5,3,67,25,42,65
N'castle Jet,1428,2,16,5,7,58,37,21,53
Melbourne C,1428,3,14,4,11,43,34,9,46
Melbourne V,1428,4,13,6,10,48,41,7,45
Adelaide Utd,1428,5,11,6,11,37,40,-3,39
Brisbane,1428,6,10,5,13,33,42,-9,35
Western Sydn,1428,7,8,9,10,38,47,-9,33
Perth Glory,1428,8,10,2,15,37,50,-13,32
Wellington P,1428,9,5,6,16,31,55,-24,21
CC Mariners,1428,10,4,8,15,28,49,-21,20
Sydney FC,1429,1,20,5,3,64,22,42,65
N'castle Jet,1429,2,16,5,7,60,38,22,53
Melbourne C,1429,3,14,4,11,44,36,8,46
Melbourne V,1429,4,13,6,10,45,38,7,45
Adelaide Utd,1429,5,11,6,11,37,40,-3,39
Brisbane,1429,6,10,5,13,33,42,-9,35
Western Sydn,1429,7,8,9,10,38,47,-9,33
Perth Glory,1429,8,10,2,15,37,50,-13,32
Wellington P,1429,9,5,6,16,31,55,-24,21
CC Mariners,1429,10,4,8,15,28,49,-21,20
Sydney FC,1430,1,21,4,3,69,25,44,67
N'castle Jet,1430,2,16,5,7,59,37,22,53
Melbourne C,1430,3,14,4,11,43,35,8,46
Melbourne V,1430,4,13,5,11,48,43,5,44
Adelaide Utd,1430,5,11,6,11,37,40,-3,39
Brisbane,1430,6,10,5,13,33,42,-9,35
Western Sydn,1430,7,8,9,10,38,47,-9,33
Perth Glory,1430,8,10,2,15,37,50,-13,32
Wellington P,1430,9,5,6,16,31,55,-24,21
CC Mariners,1430,10,4,8,15,28,49,-21,20
Sydney FC,1431,1,21,4,3,67,22,45,67
N'castle Jet,1431,2,15,5,8,58,39,19,50
Melbourne C,1431,3,15,4,10,45,34,11,49
Melbourne V,1431,4,13,5,11,45,41,4,44
Adelaide Utd,1431,5,11,6,11,37,40,-3,39
Brisbane,1431,6,10,5,13,33,42,-9,35
Western Sydn,1431,7,8,9,10,38,47,-9,33
Perth Glory,1431,8,10,2,15,37,50,-13,32
Wellington P,1431,9,5,6,16,31,55,-24,21
CC Mariners,1431,10,4,8,15,28,49,-21,20
Sydney FC,1432,1,21,4,3,67,24,43,67
N'castle Jet,1432,2,16,5,7,61,39,22,53
Melbourne C,1432,3,14,4,11,45,37,8,46
Melbourne V,1432,4,13,5,11,47,41,6,44
Adelaide Utd,1432,5,11,6,11,37,40,-3,39
Brisbane,1432,6,10,5,13,33,42,-9,35
Western Sydn,1432,7,8,9,10,38,47,-9,33
Perth Glory,1432,8,10,2,15,37,50,-13,32
Wellington P,1432,9,5,6,16,31,55,-24,21
CC Mariners,1432,10,4,8,15,28,49,-21,20
Sydney FC,1433,1,20,4,4,65,25,40,64
N'castle Jet,1433,2,16,5,7,61,38,23,53
Melbourne V,1433,3,14,5,10,48,39,9,47
Melbourne C,1433,4,14,4,11,44,37,7,46
Adelaide Utd,1433,5,11,6,11,37,40,-3,39
Brisbane,1433,6,10,5,13,33,42,-9,35
Western Sydn,1433,7,8,9,10,38,47,-9,33
Perth Glory,1433,8,10,2,15,37,50,-13,32
Wellington P,1433,9,5,6,16,31,55,-24,21
CC Mariners,1433,10,4,8,15,28,49,-21,20
Sydney FC,1434,1,20,5,3,66,24,42,65
N'castle Jet,1434,2,16,5,7,60,38,22,53
Melbourne C,1434,3,14,4,11,44,36,8,46
Melbourne V,1434,4,13,6,10,47,40,7,45
Adelaide Utd,1434,5,11,6,11,37,40,-3,39
Brisbane,1434,6,10,5,13,33,42,-9,35
Western Sydn,1434,7,8,9,10,38,47,-9,33
Perth Glory,1434,8,10,2,15,37,50,-13,32
Wellington P,1434,9,5,6,16,31,55,-24,21
CC Mariners,1434,10,4,8,15,28,49,-21,20
Sydney FC,1435,1,20,4,4,66,25,41,64
N'castle Jet,1435,2,15,5,8,58,41,17,50
Melbourne C,1435,3,15,4,10,47,34,13,49
Melbourne V,1435,4,14,5,10,48,40,8,47
Adelaide Utd,1435,5,11,6,11,37,40,-3,39
Brisbane,1435,6,10,5,13,33,42,-9,35
Western Sydn,1435,7,8,9,10,38,47,-9,33
Perth Glory,1435,8,10,2,15,37,50,-13,32
Wellington P,1435,9,5,6,16,31,55,-24,21
CC Mariners,1435,10,4,8,15,28,49,-21,20
Sydney FC,1436,1,21,4,3,68,24,44,67
N'castle Jet,1436,2,16,5,7,59,38,21,53
Melbourne C,1436,3,14,4,11,44,35,9,46
Melbourne V,1436,4,13,5,11,47,42,5,44
Adelaide Utd,1436,5,11,6,11,37,40,-3,39
Brisbane,1436,6,10,5,13,33,42,-9,35
Western Sydn,1436,7,8,9,10,38,47,-9,33
Perth Glory,1436,8,10,2,15,37,50,-13,32
Wellington P,1436,9,5,6,16,31,55,-24,21
CC Mariners,1436,10,4,8,15,28,49,-21,20
Sydney FC,1437,1,20,5,3,65,23,42,65
N'castle Jet,1437,2,15,5,8,57,39,18,50
Melbourne C,1437,3,15,4,10,45,33,12,49
Melbourne V,1437,4,13,6,10,46,39,7,45
Adelaide Utd,1437,5,11,6,11,37,40,-3,39
Brisbane,1437,6,10,5,13,33,42,-9,35
Western Sydn,1437,7,8,9,10,38,47,-9,33
Perth Glory,1437,8,10,2,15,37,50,-13,32
Wellington P,1437,9,5,6,16,31,55,-24,21
CC Mariners,1437,10,4,8,15,28,49,-21,20
Sydney FC,1438,1,20,4,4,65,24,41,64
N'castle Jet,1438,2,16,5,7,61,38,23,53
Melbourne V,1438,3,14,5,10,47,39,8,47
Melbourne C,1438,4,14,4,11,44,37,7,46
Adelaide Utd,1438,5,11,6,11,37,40,-3,39
Brisbane,1438,6,10,5,13,33,42,-9,35
Western Sydn,1438,7,8,9,10,38,47,-9,33
Perth Glory,1438,8,10,2,15,37,50,-13,32
Wellington P,1438,9,5,6,16,31,55,-24,21
CC Mariners,1438,10,4,8,15,28,49,-21,20
Sydney FC,1439,1,21,4,3,67,22,45,67
N'castle Jet,1439,2,15,6,7,58,38,20,51
Melbourne C,1439,3,14,5,10,44,34,10,47
Melbourne V,1439,4,13,5,11,45,41,4,44
Adelaide Utd,1439,5,11,6,11,37,40,-3,39
Brisbane,1439,6,10,5,13,33,42,-9,35
Western Sydn,1439,7,8,9,10,38,47,-9,33
Perth Glory,1439,8,10,2,15,37,50,-13,32
Wellington P,1439,9,5,6,16,31,55,-24,21
CC Mariners,1439,10,4,8,15,28,49,-21,20
Sydney FC,1440,1,20,4,4,65,25,40,64
N'castle Jet,1440,2,15,5,8,57,38,19,50
Melbourne C,1440,3,15,4,10,44,33,11,49
Melbourne V,1440,4,14,5,10,48,39,9,47
Adelaide Utd,1440,5,11,6,11,37,40,-3,39
Brisbane,1440,6,10,5,13,33,42,-9,35
Western Sydn,1440,7,8,9,10,38,47,-9,33
Perth Glory,1440,8,10,2,15,37,50,-13,32
Wellington P,1440,9,5,6,16,31,55,-24,21
CC Mariners,1440,10,4,8,15,28,49,-21,20
Sydney FC,1441,1,20,5,3,65,23,42,65
N'castle Jet,1441,2,16,5,7,60,38,22,53
Melbourne C,1441,3,14,4,11,44,36,8,46
Melbourne V,1441,4,13,6,10,46,39,7,45
Adelaide Utd,1441,5,11,6,11,37,40,-3,39
Brisbane,1441,6,10,5,13,33,42,-9,35
Western Sydn,1441,7,8,9,10,38,47,-9,33
Perth Glory,1441,8,10,2,15,37,50,-13,32
Wellington P,1441,9,5,6,16,31,55,-24,21
CC Mariners,1441,10,4,8,15,28,49,-21,20
Sydney FC,1442,1,20,5,3,67,25,42,65
N'castle Jet,1442,2,16,5,7,59,38,21,53
Melbourne C,1442,3,14,4,11,44,35,9,46
Melbourne V,1442,4,13,6,10,48,41,7,45
Adelaide Utd,1442,5,11,6,11,37,40,-3,39
Brisbane,1442,6,10,5,13,33,42,-9,35
Western Sydn,1442,7,8,9,10,38,47,-9,33
Perth Glory,1442,8,10,2,15,37,50,-13,32
Wellington P,1442,9,5,6,16,31,55,-24,21
CC Mariners,1442,10,4,8,15,28,49,-21,20
Sydney FC,1443,1,21,4,3,67,24,43,67
N'castle Jet,1443,2,16,5,7,60,39,21,53
Melbourne C,1443,3,14,4,11,45,36,9,46
Melbourne V,1443,4,13,5,11,47,41,6,44
Adelaide Utd,1443,5,11,6,11,37,40,-3,39
Brisbane,1443,6,10,5,13,33,42,-9,35
Western Sydn,1443,7,8,9,10,38,47,-9,33
Perth Glory,1443,8,10,2,15,37,50,-13,32
Wellington P,1443,9,5,6,16,31,55,-24,21
CC Mariners,1443,10,4,8,15,28,49,-21,20
Sydney FC,1444,1,21,4,3,66,23,43,67
N'castle Jet,1444,2,16,5,7,59,38,21,53
Melbourne C,1444,3,14,4,11,44,35,9,46
Melbourne V,1444,4,13,5,11,46,40,6,44
Adelaide Utd,1444,5,11,6,11,37,40,-3,39
Brisbane,1444,6,10,5,13,33,42,-9,35
Western Sydn,1444,7,8,9,10,38,47,-9,33
Perth Glory,1444,8,10,2,15,37,50,-13,32
Wellington P,1444,9,5,6,16,31,55,-24,21
CC Mariners,1444,10,4,8,15,28,49,-21,20
Sydney FC,1445,1,21,4,3,66,23,43,67
N'castle Jet,1445,2,16,5,7,60,37,23,53
Melbourne C,1445,3,14,4,11,43,36,7,46
Melbourne V,1445,4,13,5,11,46,40,6,44
Adelaide Utd,1445,5,11,6,11,37,40,-3,39
Brisbane,1445,6,10,5,13,33,42,-9,35
Western Sydn,1445,7,8,9,10,38,47,-9,33
Perth Glory,1445,8,10,2,15,37,50,-13,32
Wellington P,1445,9,5,6,16,31,55,-24,21
CC Mariners,1445,10,4,8,15,28,49,-21,20
Sydney FC,1446,1,21,4,3,66,22,44,67
N'castle Jet,1446,2,16,5,7,59,38,21,53
Melbourne C,1446,3,14,4,11,44,35,9,46
Melbourne V,1446,4,13,5,11,45,40,5,44
Adelaide Utd,1446,5,11,6,11,37,40,-3,39
Brisbane,1446,6,10,5,13,33,42,-9,35
Western Sydn,1446,7,8,9,10,38,47,-9,33
Perth Glory,1446,8,10,2,15,37,50,-13,32
Wellington P,1446,9,5,6,16,31,55,-24,21
CC Mariners,1446,10,4,8,15,28,49,-21,20
Sydney FC,1447,1,20,5,3,65,23,42,65
N'castle Jet,1447,2,15,6,7,58,38,20,51
Melbourne C,1447,3,14,5,10,44,34,10,47
Melbourne V,1447,4,13,6,10,46,39,7,45
Adelaide Utd,1447,5,11,6,11,37,40,-3,39
Brisbane,1447,6,10,5,13,33,42,-9,35
Western Sydn,1447,7,8,9,10,38,47,-9,33
Perth Glory,1447,8,10,2,15,37,50,-13,32
Wellington P,1447,9,5,6,16,31,55,-24,21
CC Mariners,1447,10,4,8,15,28,49,-21,20
Sydney FC,1448,1,21,4,3,68,22,46,67
N'castle Jet,1448,2,16,5,7,62,38,24,53
Melbourne C,1448,3,14,4,11,44,38,6,46
Melbourne V,1448,4,13,5,11,45,42,3,44
Adelaide Utd,1448,5,11,6,11,37,40,-3,39
Brisbane,1448,6,10,5,13,33,42,-9,35
Western Sydn,1448,7,8,9,10,38,47,-9,33
Perth Glory,1448,8,10,2,15,37,50,-13,32
Wellington P,1448,9,5,6,16,31,55,-24,21
CC Mariners,1448,10,4,8,15,28,49,-21,20
Sydney FC,1449,1,20,5,3,65,23,42,65
N'castle Jet,1449,2,15,6,7,58,38,20,51
Melbourne C,1449,3,14,5,10,44,34,10,47
Melbourne V,1449,4,13,6,10,46,39,7,45
Adelaide Utd,1449,5,11,6,11,37,40,-3,39
Brisbane,1449,6,10,5,13,33,42,-9,35
Western Sydn,1449,7,8,9,10,38,47,-9,33
Perth Glory,1449,8,10,2,15,37,50,-13,32
Wellington P,1449,9,5,6,16,31,55,-24,21
CC Mariners,1449,10,4,8,15,28,49,-21,20
Sydney FC,1450,1,20,5,3,65,23,42,65
N'castle Jet,1450,2,16,5,7,61,38,23,53
Melbourne C,1450,3,14,4,11,44,37,7,46
Melbourne V,1450,4,13,6,10,46,39,7,45
Adelaide Utd,1450,5,11,6,11,37,40,-3,39
Brisbane,1450,6,10,5,13,33,42,-9,35
Western Sydn,1450,7,8,9,10,38,47,-9,33
Perth Glory,1450,8,10,2,15,37,50,-13,32
Wellington P,1450,9,5,6,16,31,55,-24,21
CC Mariners,1450,10,4,8,15,28,49,-21,20
Sydney FC,1451,1,20,4,4,65,24,41,64
N'castle Jet,1451,2,15,6,7,58,38,20,51
Melbourne C,1451,3,14,5,10,44,34,10,47
Melbourne V,1451,4,14,5,10,47,39,8,47
Adelaide Utd,1451,5,11,6,11,37,40,-3,39
Brisbane,1451,6,10,5,13,33,42,-9,35
Western Sydn,1451,7,8,9,10,38,47,-9,33
Perth Glory,1451,8,10,2,15,37,50,-13,32
Wellington P,1451,9,5,6,16,31,55,-24,21
CC Mariners,1451,10,4,8,15,28,49,-21,20
Sydney FC,1452,1,21,4,3,67,24,43,67
N'castle Jet,1452,2,15,6,7,58,38,20,51
Melbourne C,1452,3,14,5,10,44,34,10,47
Melbourne V,1452,4,13,5,11,47,41,6,44
Adelaide Utd,1452,5,11,6,11,37,40,-3,39
Brisbane,1452,6,10,5,13,33,42,-9,35
Western Sydn,1452,7,8,9,10,38,47,-9,33
Perth Glory,1452,8,10,2,15,37,50,-13,32
Wellington P,1452,9,5,6,16,31,55,-24,21
CC Mariners,1452,10,4,8,15,28,49,-21,20
Sydney FC,1453,1,21,4,3,66,23,43,67
N'castle Jet,1453,2,15,5,8,58,39,19,50
Melbourne C,1453,3,15,4,10,45,34,11,49
Melbourne V,1453,4,13,5,11,46,40,6,44
Adelaide Utd,1453,5,11,6,11,37,40,-3,39
Brisbane,1453,6,10,5,13,33,42,-9,35
Western Sydn,1453,7,8,9,10,38,47,-9,33
Perth Glory,1453,8,10,2,15,37,50,-13,32
Wellington P,1453,9,5,6,16,31,55,-24,21
CC Mariners,1453,10,4,8,15,28,49,-21,20
Sydney FC,1454,1,21,4,3,67,22,45,67
N'castle Jet,1454,2,16,5,7,58,37,21,53
Melbourne C,1454,3,14,4,11,43,34,9,46
Melbourne V,1454,4,13,5,11,45,41,4,44
Adelaide Utd,1454,5,11,6,11,37,40,-3,39
Brisbane,1454,6,10,5,13,33,42,-9,35
Western Sydn,1454,7,8,9,10,38,47,-9,33
Perth Glory,1454,8,10,2,15,37,50,-13,32
Wellington P,1454,9,5,6,16,31,55,-24,21
CC Mariners,1454,10,4,8,15,28,49,-21,20
Sydney FC,1455,1,21,4,3,66,22,44,67
N'castle Jet,1455,2,16,5,7,58,37,21,53
Melbourne C,1455,3,14,4,11,43,34,9,46
Melbourne V,1455,4,13,5,11,45,40,5,44
Adelaide Utd,1455,5,11,6,11,37,40,-3,39
Brisbane,1455,6,10,5,13,33,42,-9,35
Western Sydn,1455,7,8,9,10,38,47,-9,33
Perth Glory,1455,8,10,2,15,37,50,-13,32
Wellington P,1455,9,5,6,16,31,55,-24,21
CC Mariners,1455,10,4,8,15,28,49,-21,20
Sydney FC,1456,1,21,4,3,65,22,43,67
N'castle Jet,1456,2,16,5,7,60,37,23,53
Melbourne C,1456,3,14,4,11,43,36,7,46
Melbourne V,1456,4,13,5,11,45,39,6,44
Adelaide Utd,1456,5,11,6,11,37,40,-3,39
Brisbane,1456,6,10,5,13,33,42,-9,35
Western Sydn,1456,7,8,9,10,38,47,-9,33
Perth Glory,1456,8,10,2,15,37,50,-13,32
Wellington P,1456,9,5,6,16,31,55,-24,21
CC Mariners,1456,10,4,8,15,28,49,-21,20
Sydney FC,1457,1,20,4,4,64,24,40,64
N'castle Jet,1457,2,15,5,8,57,40,17,50
Melbourne C,1457,3,15,4,10,46,33,13,49
Melbourne V,1457,4,14,5,10,47,38,9,47
Adelaide Utd,1457,5,11,6,11,37,40,-3,39
Brisbane,1457,6,10,5,13,33,42,-9,35
Western Sydn,1457,7,8,9,10,38,47,-9,33
Perth Glory,1457,8,10,2,15,37,50,-13,32
Wellington P,1457,9,5,6,16,31,55,-24,21
CC Mariners,1457,10,4,8,15,28,49,-21,20
Sydney FC,1458,1,20,4,4,64,23,41,64
N'castle Jet,1458,2,15,6,7,58,38,20,51
Melbourne C,1458,3,14,5,10,44,34,10,47
Melbourne V,1458,4,14,5,10,46,38,8,47
Adelaide Utd,1458,5,11,6,11,37,40,-3,39
Brisbane,1458,6,10,5,13,33,42,-9,35
Western Sydn,1458,7,8,9,10,38,47,-9,33
Perth Glory,1458,8,10,2,15,37,50,-13,32
Wellington P,1458,9,5,6,16,31,55,-24,21
CC Mariners,1458,10,4,8,15,28,49,-21,20
Sydney FC,1459,1,21,4,3,70,24,46,67
N'castle Jet,1459,2,16,5,7,59,38,21,53
Melbourne C,1459,3,14,4,11,44,35,9,46
Melbourne V,1459,4,13,5,11,47,44,3,44
Adelaide Utd,1459,5,11,6,11,37,40,-3,39
Brisbane,1459,6,10,5,13,33,42,-9,35
Western Sydn,1459,7,8,9,10,38,47,-9,33
Perth Glory,1459,8,10,2,15,37,50,-13,32
Wellington P,1459,9,5,6,16,31,55,-24,21
CC Mariners,1459,10,4,8,15,28,49,-21,20
Sydney FC,1460,1,21,4,3,71,22,49,67
N'castle Jet,1460,2,16,5,7,61,40,21,53
Melbourne C,1460,3,14,4,11,46,37,9,46
Melbourne V,1460,4,13,5,11,45,45,0,44
Adelaide Utd,1460,5,11,6,11,37,40,-3,39
Brisbane,1460,6,10,5,13,33,42,-9,35
Western Sydn,1460,7,8,9,10,38,47,-9,33
Perth Glory,1460,8,10,2,15,37,50,-13,32
Wellington P,1460,9,5,6,16,31,55,-24,21
CC Mariners,1460,10,4,8,15,28,49,-21,20
Sydney FC,1461,1,21,4,3,67,22,45,67
N'castle Jet,1461,2,15,5,8,58,40,18,50
Melbourne C,1461,3,15,4,10,46,34,12,49
Melbourne V,1461,4,13,5,11,45,41,4,44
Adelaide Utd,1461,5,11,6,11,37,40,-3,39
Brisbane,1461,6,10,5,13,33,42,-9,35
Western Sydn,1461,7,8,9,10,38,47,-9,33
Perth Glory,1461,8,10,2,15,37,50,-13,32
Wellington P,1461,9,5,6,16,31,55,-24,21
CC Mariners,1461,10,4,8,15,28,49,-21,20
Sydney FC,1462,1,21,4,3,66,22,44,67
N'castle Jet,1462,2,15,6,7,58,38,20,51
Melbourne C,1462,3,14,5,10,44,34,10,47
Melbourne V,1462,4,13,5,11,45,40,5,44
Adelaide Utd,1462,5,11,6,11,37,40,-3,39
Brisbane,1462,6,10,5,13,33,42,-9,35
Western Sydn,1462,7,8,9,10,38,47,-9,33
Perth Glory,1462,8,10,2,15,37,50,-13,32
Wellington P,1462,9,5,6,16,31,55,-24,21
CC Mariners,1462,10,4,8,15,28,49,-21,20
Sydney FC,1463,1,20,4,4,65,25,40,64
N'castle Jet,1463,2,16,5,7,59,37,22,53
Melbourne V,1463,3,14,5,10,48,39,9,47
Melbourne C,1463,4,14,4,11,43,35,8,46
Adelaide Utd,1463,5,11,6,11,37,40,-3,39
Brisbane,1463,6,10,5,13,33,42,-9,35
Western Sydn,1463,7,8,9,10,38,47,-9,33
Perth Glory,1463,8,10,2,15,37,50,-13,32
Wellington P,1463,9,5,6,16,31,55,-24,21
CC Mariners,1463,10,4,8,15,28,49,-21,20
Sydney FC,1464,1,21,4,3,67,24,43,67
N'castle Jet,1464,2,16,5,7,59,37,22,53
Melbourne C,1464,3,14,4,11,43,35,8,46
Melbourne V,1464,4,13,5,11,47,41,6,44
Adelaide Utd,1464,5,11,6,11,37,40,-3,39
Brisbane,1464,6,10,5,13,33,42,-9,35
Western Sydn,1464,7,8,9,10,38,47,-9,33
Perth Glory,1464,8,10,2,15,37,50,-13,32
Wellington P,1464,9,5,6,16,31,55,-24,21
CC Mariners,1464,10,4,8,15,28,49,-21,20
Sydney FC,1465,1,20,4,4,64,25,39,64
N'castle Jet,1465,2,15,6,7,58,38,20,51
Melbourne V,1465,3,14,5,10,48,38,10,47
Melbourne C,1465,4,14,5,10,44,34,10,47
Adelaide Utd,1465,5,11,6,11,37,40,-3,39
Brisbane,1465,6,10,5,13,33,42,-9,35
Western Sydn,1465,7,8,9,10,38,47,-9,33
Perth Glory,1465,8,10,2,15,37,50,-13,32
Wellington P,1465,9,5,6,16,31,55,-24,21
CC Mariners,1465,10,4,8,15,28,49,-21,20
Sydney FC,1466,1,21,4,3,65,22,43,67
N'castle Jet,1466,2,16,5,7,59,38,21,53
Melbourne C,1466,3,14,4,11,44,35,9,46
Melbourne V,1466,4,13,5,11,45,39,6,44
Adelaide Utd,1466,5,11,6,11,37,40,-3,39
Brisbane,1466,6,10,5,13,33,42,-9,35
Western Sydn,1466,7,8,9,10,38,47,-9,33
Perth Glory,1466,8,10,2,15,37,50,-13,32
Wellington P,1466,9,5,6,16,31,55,-24,21
CC Mariners,1466,10,4,8,15,28,49,-21,20
Sydney FC,1467,1,21,4,3,69,23,46,67
N'castle Jet,1467,2,15,5,8,57,40,17,50
Melbourne C,1467,3,15,4,10,46,33,13,49
Melbourne V,1467,4,13,5,11,46,43,3,44
Adelaide Utd,1467,5,11,6,11,37,40,-3,39
Brisbane,1467,6,10,5,13,33,42,-9,35
Western Sydn,1467,7,8,9,10,38,47,-9,33
Perth Glory,1467,8,10,2,15,37,50,-13,32
Wellington P,1467,9,5,6,16,31,55,-24,21
CC Mariners,1467,10,4,8,15,28,49,-21,20
Sydney FC,1468,1,21,4,3,66,22,44,67
N'castle Jet,1468,2,16,5,7,59,38,21,53
Melbourne C,1468,3,14,4,11,44,35,9,46
Melbourne V,1468,4,13,5,11,45,40,5,44
Adelaide Utd,1468,5,11,6,11,37,40,-3,39
Brisbane,1468,6,10,5,13,33,42,-9,35
Western Sydn,1468,7,8,9,10,38,47,-9,33
Perth Glory,1468,8,10,2,15,37,50,-13,32
Wellington P,1468,9,5,6,16,31,55,-24,21
CC Mariners,1468,10,4,8,15,28,49,-21,20
Sydney FC,1469,1,21,4,3,67,22,45,67
N'castle Jet,1469,2,16,5,7,61,39,22,53
Melbourne C,1469,3,14,4,11,45,37,8,46
Melbourne V,1469,4,13,5,11,45,41,4,44
Adelaide Utd,1469,5,11,6,11,37,40,-3,39
Brisbane,1469,6,10,5,13,33,42,-9,35
Western Sydn,1469,7,8,9,10,38,47,-9,33
Perth Glory,1469,8,10,2,15,37,50,-13,32
Wellington P,1469,9,5,6,16,31,55,-24,21
CC Mariners,1469,10,4,8,15,28,49,-21,20
Sydney FC,1470,1,21,4,3,68,23,45,67
N'castle Jet,1470,2,16,5,7,61,39,22,53
Melbourne C,1470,3,14,4,11,45,37,8,46
Melbourne V,1470,4,13,5,11,46,42,4,44
Adelaide Utd,1470,5,11,6,11,37,40,-3,39
Brisbane,1470,6,10,5,13,33,42,-9,35
Western Sydn,1470,7,8,9,10,38,47,-9,33
Perth Glory,1470,8,10,2,15,37,50,-13,32
Wellington P,1470,9,5,6,16,31,55,-24,21
CC Mariners,1470,10,4,8,15,28,49,-21,20
Sydney FC,1471,1,21,4,3,66,22,44,67
N'castle Jet,1471,2,15,6,7,57,37,20,51
Melbourne C,1471,3,14,5,10,43,33,10,47
Melbourne V,1471,4,13,5,11,45,40,5,44
Adelaide Utd,1471,5,11,6,11,37,40,-3,39
Brisbane,1471,6,10,5,13,33,42,-9,35
Western Sydn,1471,7,8,9,10,38,47,-9,33
Perth Glory,1471,8,10,2,15,37,50,-13,32
Wellington P,1471,9,5,6,16,31,55,-24,21
CC Mariners,1471,10,4,8,15,28,49,-21,20
Sydney FC,1472,1,21,4,3,66,23,43,67
N'castle Jet,1472,2,16,5,7,59,38,21,53
Melbourne C,1472,3,14,4,11,44,35,9,46
Melbourne V,1472,4,13,5,11,46,40,6,44
Adelaide Utd,1472,5,11,6,11,37,40,-3,39
Brisbane,1472,6,10,5,13,33,42,-9,35
Western Sydn,1472,7,8,9,10,38,47,-9,33
Perth Glory,1472,8,10,2,15,37,50,-13,32
Wellington P,1472,9,5,6,16,31,55,-24,21
CC Mariners,1472,10,4,8,15,28,49,-21,20
Sydney FC,1473,1,21,4,3,66,23,43,67
N'castle Jet,1473,2,15,5,8,57,38,19,50
Melbourne C,1473,3,15,4,10,44,33,11,49
Melbourne V,1473,4,13,5,11,46,40,6,44
Adelaide Utd,1473,5,11,6,11,37,40,-3,39
Brisbane,1473,6,10,5,13,33,42,-9,35
Western Sydn,1473,7,8,9,10,38,47,-9,33
Perth Glory,1473,8,10,2,15,37,50,-13,32
Wellington P,1473,9,5,6,16,31,55,-24,21
CC Mariners,1473,10,4,8,15,28,49,-21,20
Sydney FC,1474,1,21,4,3,66,22,44,67
N'castle Jet,1474,2,16,5,7,60,39,21,53
Melbourne C,1474,3,14,4,11,45,36,9,46
Melbourne V,1474,4,13,5,11,45,40,5,44
Adelaide Utd,1474,5,11,6,11,37,40,-3,39
Brisbane,1474,6,10,5,13,33,42,-9,35
Western Sydn,1474,7,8,9,10,38,47,-9,33
Perth Glory,1474,8,10,2,15,37,50,-13,32
Wellington P,1474,9,5,6,16,31,55,-24,21
CC Mariners,1474,10,4,8,15,28,49,-21,20
Sydney FC,1475,1,20,4,4,65,24,41,64
N'castle Jet,1475,2,15,6,7,57,37,20,51
Melbourne C,1475,3,14,5,10,43,33,10,47
Melbourne V,1475,4,14,5,10,47,39,8,47
Adelaide Utd,1475,5,11,6,11,37,40,-3,39
Brisbane,1475,6,10,5,13,33,42,-9,35
Western Sydn,1475,7,8,9,10,38,47,-9,33
Perth Glory,1475,8,10,2,15,37,50,-13,32
Wellington P,1475,9,5,6,16,31,55,-24,21
CC Mariners,1475,10,4,8,15,28,49,-21,20
Sydney FC,1476,1,20,5,3,65,23,42,65
N'castle Jet,1476,2,16,5,7,60,38,22,53
Melbourne C,1476,3,14,4,11,44,36,8,46
Melbourne V,1476,4,13,6,10,46,39,7,45
Adelaide Utd,1476,5,11,6,11,37,40,-3,39
Brisbane,1476,6,10,5,13,33,42,-9,35
Western Sydn,1476,7,8,9,10,38,47,-9,33
Perth Glory,1476,8,10,2,15,37,50,-13,32
Wellington P,1476,9,5,6,16,31,55,-24,21
CC Mariners,1476,10,4,8,15,28,49,-21,20
Sydney FC,1477,1,21,4,3,65,22,43,67
N'castle Jet,1477,2,15,6,7,57,37,20,51
Melbourne C,1477,3,14,5,10,43,33,10,47
Melbourne V,1477,4,13,5,11,45,39,6,44
Adelaide Utd,1477,5,11,6,11,37,40,-3,39
Brisbane,1477,6,10,5,13,33,42,-9,35
Western Sydn,1477,7,8,9,10,38,47,-9,33
Perth Glory,1477,8,10,2,15,37,50,-13,32
Wellington P,1477,9,5,6,16,31,55,-24,21
CC Mariners,1477,10,4,8,15,28,49,-21,20
Sydney FC,1478,1,21,4,3,67,23,44,67
N'castle Jet,1478,2,15,5,8,58,39,19,50
Melbourne C,1478,3,15,4,10,45,34,11,49
Melbourne V,1478,4,13,5,11,46,41,5,44
Adelaide Utd,1478,5,11,6,11,37,40,-3,39
Brisbane,1478,6,10,5,13,33,42,-9,35
Western Sydn,1478,7,8,9,10,38,47,-9,33
Perth Glory,1478,8,10,2,15,37,50,-13,32
Wellington P,1478,9,5,6,16,31,55,-24,21
CC Mariners,1478,10,4,8,15,28,49,-21,20
Sydney FC,1479,1,20,5,3,65,23,42,65
N'castle Jet,1479,2,15,5,8,57,39,18,50
Melbourne C,1479,3,15,4,10,45,33,12,49
Melbourne V,1479,4,13,6,10,46,39,7,45
Adelaide Utd,1479,5,11,6,11,37,40,-3,39
Brisbane,1479,6,10,5,13,33,42,-9,35
Western Sydn,1479,7,8,9,10,38,47,-9,33
Perth Glory,1479,8,10,2,15,37,50,-13,32
Wellington P,1479,9,5,6,16,31,55,-24,21
CC Mariners,1479,10,4,8,15,28,49,-21,20
Sydney FC,1480,1,20,5,3,64,22,42,65
N'castle Jet,1480,2,16,5,7,62,39,23,53
Melbourne C,1480,3,14,4,11,45,38,7,46
Melbourne V,1480,4,13,6,10,45,38,7,45
Adelaide Utd,1480,5,11,6,11,37,40,-3,39
Brisbane,1480,6,10,5,13,33,42,-9,35
Western Sydn,1480,7,8,9,10,38,47,-9,33
Perth Glory,1480,8,10,2,15,37,50,-13,32
Wellington P,1480,9,5,6,16,31,55,-24,21
CC Mariners,1480,10,4,8,15,28,49,-21,20
Sydney FC,1481,1,20,5,3,65,23,42,65
N'castle Jet,1481,2,16,5,7,59,38,21,53
Melbourne C,1481,3,14,4,11,44,35,9,46
Melbourne V,1481,4,13,6,10,46,39,7,45
Adelaide Utd,1481,5,11,6,11,37,40,-3,39
Brisbane,1481,6,10,5,13,33,42,-9,35
Western Sydn,1481,7,8,9,10,38,47,-9,33
Perth Glory,1481,8,10,2,15,37,50,-13,32
Wellington P,1481,9,5,6,16,31,55,-24,21
CC Mariners,1481,10,4,8,15,28,49,-21,20
Sydney FC,1482,1,21,4,3,65,22,43,67
N'castle Jet,1482,2,16,5,7,58,37,21,53
Melbourne C,1482,3,14,4,11,43,34,9,46
Melbourne V,1482,4,13,5,11,45,39,6,44
Adelaide Utd,1482,5,11,6,11,37,40,-3,39
Brisbane,1482,6,10,5,13,33,42,-9,35
Western Sydn,1482,7,8,9,10,38,47,-9,33
Perth Glory,1482,8,10,2,15,37,50,-13,32
Wellington P,1482,9,5,6,16,31,55,-24,21
CC Mariners,1482,10,4,8,15,28,49,-21,20
Sydney FC,1483,1,20,5,3,65,23,42,65
N'castle Jet,1483,2,16,5,7,60,37,23,53
Melbourne C,1483,3,14,4,11,43,36,7,46
Melbourne V,1483,4,13,6,10,46,39,7,45
Adelaide Utd,1483,5,11,6,11,37,40,-3,39
Brisbane,1483,6,10,5,13,33,42,-9,35
Western Sydn,1483,7,8,9,10,38,47,-9,33
Perth Glory,1483,8,10,2,15,37,50,-13,32
Wellington P,1483,9,5,6,16,31,55,-24,21
CC Mariners,1483,10,4,8,15,28,49,-21,20
Sydney FC,1484,1,20,4,4,64,24,40,64
N'castle Jet,1484,2,16,5,7,59,37,22,53
Melbourne V,1484,3,14,5,10,47,38,9,47
Melbourne C,1484,4,14,4,11,43,35,8,46
Adelaide Utd,1484,5,11,6,11,37,40,-3,39
Brisbane,1484,6,10,5,13,33,42,-9,35
Western Sydn,1484,7,8,9,10,38,47,-9,33
Perth Glory,1484,8,10,2,15,37,50,-13,32
Wellington P,1484,9,5,6,16,31,55,-24,21
CC Mariners,1484,10,4,8,15,28,49,-21,20
Sydney FC,1485,1,21,4,3,67,23,44,67
N'castle Jet,1485,2,15,6,7,58,38,20,51
Melbourne C,1485,3,14,5,10,44,34,10,47
Melbourne V,1485,4,13,5,11,46,41,5,44
Adelaide Utd,1485,5,11,6,11,37,40,-3,39
Brisbane,1485,6,10,5,13,33,42,-9,35
Western Sydn,1485,7,8,9,10,38,47,-9,33
Perth Glory,1485,8,10,2,15,37,50,-13,32
Wellington P,1485,9,5,6,16,31,55,-24,21
CC Mariners,1485,10,4,8,15,28,49,-21,20
Sydney FC,1486,1,21,4,3,66,23,43,67
N'castle Jet,1486,2,15,6,7,58,38,20,51
Melbourne C,1486,3,14,5,10,44,34,10,47
Melbourne V,1486,4,13,5,11,46,40,6,44
Adelaide Utd,1486,5,11,6,11,37,40,-3,39
Brisbane,1486,6,10,5,13,33,42,-9,35
Western Sydn,1486,7,8,9,10,38,47,-9,33
Perth Glory,1486,8,10,2,15,37,50,-13,32
Wellington P,1486,9,5,6,16,31,55,-24,21
CC Mariners,1486,10,4,8,15,28,49,-21,20
Sydney FC,1487,1,21,4,3,66,23,43,67
N'castle Jet,1487,2,15,5,8,58,39,19,50
Melbourne C,1487,3,15,4,10,45,34,11,49
Melbourne V,1487,4,13,5,11,46,40,6,44
Adelaide Utd,1487,5,11,6,11,37,40,-3,39
Brisbane,1487,6,10,5,13,33,42,-9,35
Western Sydn,1487,7,8,9,10,38,47,-9,33
Perth Glory,1487,8,10,2,15,37,50,-13,32
Wellington P,1487,9,5,6,16,31,55,-24,21
CC Mariners,1487,10,4,8,15,28,49,-21,20
Sydney FC,1488,1,21,4,3,66,23,43,67
N'castle Jet,1488,2,16,5,7,62,39,23,53
Melbourne C,1488,3,14,4,11,45,38,7,46
Melbourne V,1488,4,13,5,11,46,40,6,44
Adelaide Utd,1488,5,11,6,11,37,40,-3,39
Brisbane,1488,6,10,5,13,33,42,-9,35
Western Sydn,1488,7,8,9,10,38,47,-9,33
Perth Glory,1488,8,10,2,15,37,50,-13,32
Wellington P,1488,9,5,6,16,31,55,-24,21
CC Mariners,1488,10,4,8,15,28,49,-21,20
Sydney FC,1489,1,20,5,3,65,23,42,65
N'castle Jet,1489,2,15,6,7,57,37,20,51
Melbourne C,1489,3,14,5,10,43,33,10,47
Melbourne V,1489,4,13,6,10,46,39,7,45
Adelaide Utd,1489,5,11,6,11,37,40,-3,39
Brisbane,1489,6,10,5,13,33,42,-9,35
Western Sydn,1489,7,8,9,10,38,47,-9,33
Perth Glory,1489,8,10,2,15,37,50,-13,32
Wellington P,1489,9,5,6,16,31,55,-24,21
CC Mariners,1489,10,4,8,15,28,49,-21,20
Sydney FC,1490,1,20,5,3,66,24,42,65
N'castle Jet,1490,2,15,6,7,58,38,20,51
Melbourne C,1490,3,14,5,10,44,34,10,47
Melbourne V,1490,4,13,6,10,47,40,7,45
Adelaide Utd,1490,5,11,6,11,37,40,-3,39
Brisbane,1490,6,10,5,13,33,42,-9,35
Western Sydn,1490,7,8,9,10,38,47,-9,33
Perth Glory,1490,8,10,2,15,37,50,-13,32
Wellington P,1490,9,5,6,16,31,55,-24,21
CC Mariners,1490,10,4,8,15,28,49,-21,20
Sydney FC,1491,1,21,4,3,67,23,44,67
N'castle Jet,1491,2,16,5,7,59,37,22,53
Melbourne C,1491,3,14,4,11,43,35,8,46
Melbourne V,1491,4,13,5,11,46,41,5,44
Adelaide Utd,1491,5,11,6,11,37,40,-3,39
Brisbane,1491,6,10,5,13,33,42,-9,35
Western Sydn,1491,7,8,9,10,38,47,-9,33
Perth Glory,1491,8,10,2,15,37,50,-13,32
Wellington P,1491,9,5,6,16,31,55,-24,21
CC Mariners,1491,10,4,8,15,28,49,-21,20
Sydney FC,1492,1,21,4,3,68,23,45,67
N'castle Jet,1492,2,16,5,7,60,38,22,53
Melbourne C,1492,3,14,4,11,44,36,8,46
Melbourne V,1492,4,13,5,11,46,42,4,44
Adelaide Utd,1492,5,11,6,11,37,40,-3,39
Brisbane,1492,6,10,5,13,33,42,-9,35
Western Sydn,1492,7,8,9,10,38,47,-9,33
Perth Glory,1492,8,10,2,15,37,50,-13,32
Wellington P,1492,9,5,6,16,31,55,-24,21
CC Mariners,1492,10,4,8,15,28,49,-21,20
Sydney FC,1493,1,21,4,3,66,22,44,67
N'castle Jet,1493,2,16,5,7,59,37,22,53
Melbourne C,1493,3,14,4,11,43,35,8,46
Melbourne V,1493,4,13,5,11,45,40,5,44
Adelaide Utd,1493,5,11,6,11,37,40,-3,39
Brisbane,1493,6,10,5,13,33,42,-9,35
Western Sydn,1493,7,8,9,10,38,47,-9,33
Perth Glory,1493,8,10,2,15,37,50,-13,32
Wellington P,1493,9,5,6,16,31,55,-24,21
CC Mariners,1493,10,4,8,15,28,49,-21,20
Sydney FC,1494,1,20,5,3,64,22,42,65
N'castle Jet,1494,2,15,6,7,60,40,20,51
Melbourne C,1494,3,14,5,10,46,36,10,47
Melbourne V,1494,4,13,6,10,45,38,7,45
Adelaide Utd,1494,5,11,6,11,37,40,-3,39
Brisbane,1494,6,10,5,13,33,42,-9,35
Western Sydn,1494,7,8,9,10,38,47,-9,33
Perth Glory,1494,8,10,2,15,37,50,-13,32
Wellington P,1494,9,5,6,16,31,55,-24,21
CC Mariners,1494,10,4,8,15,28,49,-21,20
Sydney FC,1495,1,20,5,3,66,24,42,65
N'castle Jet,1495,2,15,6,7,59,39,20,51
Melbourne C,1495,3,14,5,10,45,35,10,47
Melbourne V,1495,4,13,6,10,47,40,7,45
Adelaide Utd,1495,5,11,6,11,37,40,-3,39
Brisbane,1495,6,10,5,13,33,42,-9,35
Western Sydn,1495,7,8,9,10,38,47,-9,33
Perth Glory,1495,8,10,2,15,37,50,-13,32
Wellington P,1495,9,5,6,16,31,55,-24,21
CC Mariners,1495,10,4,8,15,28,49,-21,20
Sydney FC,1496,1,21,4,3,67,23,44,67
N'castle Jet,1496,2,15,5,8,59,40,19,50
Melbourne C,1496,3,15,4,10,46,35,11,49
Melbourne V,1496,4,13,5,11,46,41,5,44
Adelaide Utd,1496,5,11,6,11,37,40,-3,39
Brisbane,1496,6,10,5,13,33,42,-9,35
Western Sydn,1496,7,8,9,10,38,47,-9,33
Perth Glory,1496,8,10,2,15,37,50,-13,32
Wellington P,1496,9,5,6,16,31,55,-24,21
CC Mariners,1496,10,4,8,15,28,49,-21,20
Sydney FC,1497,1,20,4,4,65,24,41,64
N'castle Jet,1497,2,15,6,7,59,39,20,51
Melbourne C,1497,3,14,5,10,45,35,10,47
Melbourne V,1497,4,14,5,10,47,39,8,47
Adelaide Utd,1497,5,11,6,11,37,40,-3,39
Brisbane,1497,6,10,5,13,33,42,-9,35
Western Sydn,1497,7,8,9,10,38,47,-9,33
Perth Glory,1497,8,10,2,15,37,50,-13,32
Wellington P,1497,9,5,6,16,31,55,-24,21
CC Mariners,1497,10,4,8,15,28,49,-21,20
Sydney FC,1498,1,21,4,3,65,22,43,67
N'castle Jet,1498,2,15,6,7,59,39,20,51
Melbourne C,1498,3,14,5,10,45,35,10,47
Melbourne V,1498,4,13,5,11,45,39,6,44
Adelaide Utd,1498,5,11,6,11,37,40,-3,39
Brisbane,1498,6,10,5,13,33,42,-9,35
Western Sydn,1498,7,8,9,10,38,47,-9,33
Perth Glory,1498,8,10,2,15,37,50,-13,32
Wellington P,1498,9,5,6,16,31,55,-24,21
CC Mariners,1498,10,4,8,15,28,49,-21,20
Sydney FC,1499,1,21,4,3,67,23,44,67
N'castle Jet,1499,2,16,5,7,58,37,21,53
Melbourne C,1499,3,14,4,11,43,34,9,46
Melbourne V,1499,4,13,5,11,46,41,5,44
Adelaide Utd,1499,5,11,6,11,37,40,-3,39
Brisbane,1499,6,10,5,13,33,42,-9,35
Western Sydn,1499,7,8,9,10,38,47,-9,33
Perth Glory,1499,8,10,2,15,37,50,-13,32
Wellington P,1499,9,5,6,16,31,55,-24,21
CC Mariners,1499,10,4,8,15,28,49,-21,20
Sydney FC,1500,1,20,5,3,66,24,42,65
N'castle Jet,1500,2,16,5,7,58,37,21,53
Melbourne C,1500,3,14,4,11,43,34,9,46
Melbourne V,1500,4,13,6,10,47,40,7,45
Adelaide Utd,1500,5,11,6,11,37,40,-3,39
Brisbane,1500,6,10,5,13,33,42,-9,35
Western Sydn,1500,7,8,9,10,38,47,-9,33
Perth Glory,1500,8,10,2,15,37,50,-13,32
Wellington P,1500,9,5,6,16,31,55,-24,21
CC Mariners,1500,10,4,8,15,28,49,-21,20
Sydney FC,1501,1,20,5,3,66,24,42,65
N'castle Jet,1501,2,16,5,7,61,38,23,53
Melbourne C,1501,3,14,4,11,44,37,7,46
Melbourne V,1501,4,13,6,10,47,40,7,45
Adelaide Utd,1501,5,11,6,11,37,40,-3,39
Brisbane,1501,6,10,5,13,33,42,-9,35
Western Sydn,1501,7,8,9,10,38,47,-9,33
Perth Glory,1501,8,10,2,15,37,50,-13,32
Wellington P,1501,9,5,6,16,31,55,-24,21
CC Mariners,1501,10,4,8,15,28,49,-21,20
Sydney FC,1502,1,20,5,3,66,24,42,65
N'castle Jet,1502,2,15,6,7,58,38,20,51
Melbourne C,1502,3,14,5,10,44,34,10,47
Melbourne V,1502,4,13,6,10,47,40,7,45
Adelaide Utd,1502,5,11,6,11,37,40,-3,39
Brisbane,1502,6,10,5,13,33,42,-9,35
Western Sydn,1502,7,8,9,10,38,47,-9,33
Perth Glory,1502,8,10,2,15,37,50,-13,32
Wellington P,1502,9,5,6,16,31,55,-24,21
CC Mariners,1502,10,4,8,15,28,49,-21,20
Sydney FC,1503,1,20,4,4,64,23,41,64
N'castle Jet,1503,2,15,5,8,57,40,17,50
Melbourne C,1503,3,15,4,10,46,33,13,49
Melbourne V,1503,4,14,5,10,46,38,8,47
Adelaide Utd,1503,5,11,6,11,37,40,-3,39
Brisbane,1503,6,10,5,13,33,42,-9,35
Western Sydn,1503,7,8,9,10,38,47,-9,33
Perth Glory,1503,8,10,2,15,37,50,-13,32
Wellington P,1503,9,5,6,16,31,55,-24,21
CC Mariners,1503,10,4,8,15,28,49,-21,20
Sydney FC,1504,1,21,4,3,66,22,44,67
N'castle Jet,1504,2,16,5,7,58,37,21,53
Melbourne C,1504,3,14,4,11,43,34,9,46
Melbourne V,1504,4,13,5,11,45,40,5,44
Adelaide Utd,1504,5,11,6,11,37,40,-3,39
Brisbane,1504,6,10,5,13,33,42,-9,35
Western Sydn,1504,7,8,9,10,38,47,-9,33
Perth Glory,1504,8,10,2,15,37,50,-13,32
Wellington P,1504,9,5,6,16,31,55,-24,21
CC Mariners,1504,10,4,8,15,28,49,-21,20
Sydney FC,1505,1,20,4,4,64,23,41,64
N'castle Jet,1505,2,15,5,8,58,41,17,50
Melbourne C,1505,3,15,4,10,47,34,13,49
Melbourne V,1505,4,14,5,10,46,38,8,47
Adelaide Utd,1505,5,11,6,11,37,40,-3,39
Brisbane,1505,6,10,5,13,33,42,-9,35
Western Sydn,1505,7,8,9,10,38,47,-9,33
Perth Glory,1505,8,10,2,15,37,50,-13,32
Wellington P,1505,9,5,6,16,31,55,-24,21
CC Mariners,1505,10,4,8,15,28,49,-21,20
Sydney FC,1506,1,21,4,3,67,23,44,67
N'castle Jet,1506,2,16,5,7,60,37,23,53
Melbourne C,1506,3,14,4,11,43,36,7,46
Melbourne V,1506,4,13,5,11,46,41,5,44
Adelaide Utd,1506,5,11,6,11,37,40,-3,39
Brisbane,1506,6,10,5,13,33,42,-9,35
Western Sydn,1506,7,8,9,10,38,47,-9,33
Perth Glory,1506,8,10,2,15,37,50,-13,32
Wellington P,1506,9,5,6,16,31,55,-24,21
CC Mariners,1506,10,4,8,15,28,49,-21,20
Sydney FC,1507,1,21,4,3,68,23,45,67
N'castle Jet,1507,2,16,5,7,60,38,22,53
Melbourne C,1507,3,14,4,11,44,36,8,46
Melbourne V,1507,4,13,5,11,46,42,4,44
Adelaide Utd,1507,5,11,6,11,37,40,-3,39
Brisbane,1507,6,10,5,13,33,42,-9,35
Western Sydn,1507,7,8,9,10,38,47,-9,33
Perth Glory,1507,8,10,2,15,37,50,-13,32
Wellington P,1507,9,5,6,16,31,55,-24,21
CC Mariners,1507,10,4,8,15,28,49,-21,20
Sydney FC,1508,1,21,4,3,67,23,44,67
N'castle Jet,1508,2,16,5,7,60,38,22,53
Melbourne C,1508,3,14,4,11,44,36,8,46
Melbourne V,1508,4,13,5,11,46,41,5,44
Adelaide Utd,1508,5,11,6,11,37,40,-3,39
Brisbane,1508,6,10,5,13,33,42,-9,35
Western Sydn,1508,7,8,9,10,38,47,-9,33
Perth Glory,1508,8,10,2,15,37,50,-13,32
Wellington P,1508,9,5,6,16,31,55,-24,21
CC Mariners,1508,10,4,8,15,28,49,-21,20
Sydney FC,1509,1,20,5,3,66,24,42,65
N'castle Jet,1509,2,15,5,8,59,40,19,50
Melbourne C,1509,3,15,4,10,46,35,11,49
Melbourne V,1509,4,13,6,10,47,40,7,45
Adelaide Utd,1509,5,11,6,11,37,40,-3,39
Brisbane,1509,6,10,5,13,33,42,-9,35
Western Sydn,1509,7,8,9,10,38,47,-9,33
Perth Glory,1509,8,10,2,15,37,50,-13,32
Wellington P,1509,9,5,6,16,31,55,-24,21
CC Mariners,1509,10,4,8,15,28,49,-21,20
Sydney FC,1510,1,21,4,3,67,22,45,67
N'castle Jet,1510,2,16,5,7,58,37,21,53
Melbourne C,1510,3,14,4,11,43,34,9,46
Melbourne V,1510,4,13,5,11,45,41,4,44
Adelaide Utd,1510,5,11,6,11,37,40,-3,39
Brisbane,1510,6,10,5,13,33,42,-9,35
Western Sydn,1510,7,8,9,10,38,47,-9,33
Perth Glory,1510,8,10,2,15,37,50,-13,32
Wellington P,1510,9,5,6,16,31,55,-24,21
CC Mariners,1510,10,4,8,15,28,49,-21,20
Sydney FC,1511,1,21,4,3,66,23,43,67
N'castle Jet,1511,2,16,5,7,59,37,22,53
Melbourne C,1511,3,14,4,11,43,35,8,46
Melbourne V,1511,4,13,5,11,46,40,6,44
Adelaide Utd,1511,5,11,6,11,37,40,-3,39
Brisbane,1511,6,10,5,13,33,42,-9,35
Western Sydn,1511,7,8,9,10,38,47,-9,33
Perth Glory,1511,8,10,2,15,37,50,-13,32
Wellington P,1511,9,5,6,16,31,55,-24,21
CC Mariners,1511,10,4,8,15,28,49,-21,20
Sydney FC,1512,1,20,5,3,65,23,42,65
N'castle Jet,1512,2,16,5,7,59,37,22,53
Melbourne C,1512,3,14,4,11,43,35,8,46
Melbourne V,1512,4,13,6,10,46,39,7,45
Adelaide Utd,1512,5,11,6,11,37,40,-3,39
Brisbane,1512,6,10,5,13,33,42,-9,35
Western Sydn,1512,7,8,9,10,38,47,-9,33
Perth Glory,1512,8,10,2,15,37,50,-13,32
Wellington P,1512,9,5,6,16,31,55,-24,21
CC Mariners,1512,10,4,8,15,28,49,-21,20
Sydney FC,1513,1,21,4,3,66,22,44,67
N'castle Jet,1513,2,15,6,7,58,38,20,51
Melbourne C,1513,3,14,5,10,44,34,10,47
Melbourne V,1513,4,13,5,11,45,40,5,44
Adelaide Utd,1513,5,11,6,11,37,40,-3,39
Brisbane,1513,6,10,5,13,33,42,-9,35
Western Sydn,1513,7,8,9,10,38,47,-9,33
Perth Glory,1513,8,10,2,15,37,50,-13,32
Wellington P,1513,9,5,6,16,31,55,-24,21
CC Mariners,1513,10,4,8,15,28,49,-21,20
Sydney FC,1514,1,21,4,3,65,22,43,67
N'castle Jet,1514,2,16,5,7,59,38,21,53
Melbourne C,1514,3,14,4,11,44,35,9,46
Melbourne V,1514,4,13,5,11,45,39,6,44
Adelaide Utd,1514,5,11,6,11,37,40,-3,39
Brisbane,1514,6,10,5,13,33,42,-9,35
Western Sydn,1514,7,8,9,10,38,47,-9,33
Perth Glory,1514,8,10,2,15,37,50,-13,32
Wellington P,1514,9,5,6,16,31,55,-24,21
CC Mariners,1514,10,4,8,15,28,49,-21,20
Sydney FC,1515,1,20,4,4,65,25,40,64
N'castle Jet,1515,2,16,5,7,59,38,21,53
Melbourne V,1515,3,14,5,10,48,39,9,47
Melbourne C,1515,4,14,4,11,44,35,9,46
Adelaide Utd,1515,5,11,6,11,37,40,-3,39
Brisbane,1515,6,10,5,13,33,42,-9,35
Western Sydn,1515,7,8,9,10,38,47,-9,33
Perth Glory,1515,8,10,2,15,37,50,-13,32
Wellington P,1515,9,5,6,16,31,55,-24,21
CC Mariners,1515,10,4,8,15,28,49,-21,20
Sydney FC,1516,1,20,5,3,64,22,42,65
N'castle Jet,1516,2,16,5,7,59,37,22,53
Melbourne C,1516,3,14,4,11,43,35,8,46
Melbourne V,1516,4,13,6,10,45,38,7,45
Adelaide Utd,1516,5,11,6,11,37,40,-3,39
Brisbane,1516,6,10,5,13,33,42,-9,35
Western Sydn,1516,7,8,9,10,38,47,-9,33
Perth Glory,1516,8,10,2,15,37,50,-13,32
Wellington P,1516,9,5,6,16,31,55,-24,21
CC Mariners,1516,10,4,8,15,28,49,-21,20
Sydney FC,1517,1,21,4,3,68,23,45,67
N'castle Jet,1517,2,15,5,8,58,39,19,50
Melbourne C,1517,3,15,4,10,45,34,11,49
Melbourne V,1517,4,13,5,11,46,42,4,44
Adelaide Utd,1517,5,11,6,11,37,40,-3,39
Brisbane,1517,6,10,5,13,33,42,-9,35
Western Sydn,1517,7,8,9,10,38,47,-9,33
Perth Glory,1517,8,10,2,15,37,50,-13,32
Wellington P,1517,9,5,6,16,31,55,-24,21
CC Mariners,1517,10,4,8,15,28,49,-21,20
Sydney FC,1518,1,21,4,3,66,22,44,67
N'castle Jet,1518,2,15,6,7,57,37,20,51
Melbourne C,1518,3,14,5,10,43,33,10,47
Melbourne V,1518,4,13,5,11,45,40,5,44
Adelaide Utd,1518,5,11,6,11,37,40,-3,39
Brisbane,1518,6,10,5,13,33,42,-9,35
Western Sydn,1518,7,8,9,10,38,47,-9,33
Perth Glory,1518,8,10,2,15,37,50,-13,32
Wellington P,1518,9,5,6,16,31,55,-24,21
CC Mariners,1518,10,4,8,15,28,49,-21,20
Sydney FC,1519,1,21,4,3,69,22,47,67
N'castle Jet,1519,2,15,6,7,58,38,20,51
Melbourne C,1519,3,14,5,10,44,34,10,47
Melbourne V,1519,4,13,5,11,45,43,2,44
Adelaide Utd,1519,5,11,6,11,37,40,-3,39
Brisbane,1519,6,10,5,13,33,42,-9,35
Western Sydn,1519,7,8,9,10,38,47,-9,33
Perth Glory,1519,8,10,2,15,37,50,-13,32
Wellington P,1519,9,5,6,16,31,55,-24,21
CC Mariners,1519,10,4,8,15,28,49,-21,20
Sydney FC,1520,1,20,4,4,64,24,40,64
N'castle Jet,1520,2,16,5,7,61,38,23,53
Melbourne V,1520,3,14,5,10,47,38,9,47
Melbourne C,1520,4,14,4,11,44,37,7,46
Adelaide Utd,1520,5,11,6,11,37,40,-3,39
Brisbane,1520,6,10,5,13,33,42,-9,35
Western Sydn,1520,7,8,9,10,38,47,-9,33
Perth Glory,1520,8,10,2,15,37,50,-13,32
Wellington P,1520,9,5,6,16,31,55,-24,21
CC Mariners,1520,10,4,8,15,28,49,-21,20
Sydney FC,1521,1,21,4,3,70,23,47,67
N'castle Jet,1521,2,15,5,8,58,39,19,50
Melbourne C,1521,3,15,4,10,45,34,11,49
Melbourne V,1521,4,13,5,11,46,44,2,44
Adelaide Utd,1521,5,11,6,11,37,40,-3,39
Brisbane,1521,6,10,5,13,33,42,-9,35
Western Sydn,1521,7,8,9,10,38,47,-9,33
Perth Glory,1521,8,10,2,15,37,50,-13,32
Wellington P,1521,9,5,6,16,31,55,-24,21
CC Mariners,1521,10,4,8,15,28,49,-21,20
Sydney FC,1522,1,21,4,3,69,22,47,67
N'castle Jet,1522,2,16,5,7,61,37,24,53
Melbourne C,1522,3,14,4,11,43,37,6,46
Melbourne V,1522,4,13,5,11,45,43,2,44
Adelaide Utd,1522,5,11,6,11,37,40,-3,39
Brisbane,1522,6,10,5,13,33,42,-9,35
Western Sydn,1522,7,8,9,10,38,47,-9,33
Perth Glory,1522,8,10,2,15,37,50,-13,32
Wellington P,1522,9,5,6,16,31,55,-24,21
CC Mariners,1522,10,4,8,15,28,49,-21,20
Sydney FC,1523,1,20,4,4,66,25,41,64
N'castle Jet,1523,2,16,5,7,59,38,21,53
Melbourne V,1523,3,14,5,10,48,40,8,47
Melbourne C,1523,4,14,4,11,44,35,9,46
Adelaide Utd,1523,5,11,6,11,37,40,-3,39
Brisbane,1523,6,10,5,13,33,42,-9,35
Western Sydn,1523,7,8,9,10,38,47,-9,33
Perth Glory,1523,8,10,2,15,37,50,-13,32
Wellington P,1523,9,5,6,16,31,55,-24,21
CC Mariners,1523,10,4,8,15,28,49,-21,20
Sydney FC,1524,1,20,5,3,66,24,42,65
N'castle Jet,1524,2,16,5,7,60,37,23,53
Melbourne C,1524,3,14,4,11,43,36,7,46
Melbourne V,1524,4,13,6,10,47,40,7,45
Adelaide Utd,1524,5,11,6,11,37,40,-3,39
Brisbane,1524,6,10,5,13,33,42,-9,35
Western Sydn,1524,7,8,9,10,38,47,-9,33
Perth Glory,1524,8,10,2,15,37,50,-13,32
Wellington P,1524,9,5,6,16,31,55,-24,21
CC Mariners,1524,10,4,8,15,28,49,-21,20
Sydney FC,1525,1,21,4,3,65,22,43,67
N'castle Jet,1525,2,15,5,8,59,43,16,50
Melbourne C,1525,3,15,4,10,49,35,14,49
Melbourne V,1525,4,13,5,11,45,39,6,44
Adelaide Utd,1525,5,11,6,11,37,40,-3,39
Brisbane,1525,6,10,5,13,33,42,-9,35
Western Sydn,1525,7,8,9,10,38,47,-9,33
Perth Glory,1525,8,10,2,15,37,50,-13,32
Wellington P,1525,9,5,6,16,31,55,-24,21
CC Mariners,1525,10,4,8,15,28,49,-21,20
Sydney FC,1526,1,21,4,3,66,23,43,67
N'castle Jet,1526,2,16,5,7,59,37,22,53
Melbourne C,1526,3,14,4,11,43,35,8,46
Melbourne V,1526,4,13,5,11,46,40,6,44
Adelaide Utd,1526,5,11,6,11,37,40,-3,39
Brisbane,1526,6,10,5,13,33,42,-9,35
Western Sydn,1526,7,8,9,10,38,47,-9,33
Perth Glory,1526,8,10,2,15,37,50,-13,32
Wellington P,1526,9,5,6,16,31,55,-24,21
CC Mariners,1526,10,4,8,15,28,49,-21,20
Sydney FC,1527,1,21,4,3,66,22,44,67
N'castle Jet,1527,2,15,5,8,57,38,19,50
Melbourne C,1527,3,15,4,10,44,33,11,49
Melbourne V,1527,4,13,5,11,45,40,5,44
Adelaide Utd,1527,5,11,6,11,37,40,-3,39
Brisbane,1527,6,10,5,13,33,42,-9,35
Western Sydn,1527,7,8,9,10,38,47,-9,33
Perth Glory,1527,8,10,2,15,37,50,-13,32
Wellington P,1527,9,5,6,16,31,55,-24,21
CC Mariners,1527,10,4,8,15,28,49,-21,20
Sydney FC,1528,1,21,4,3,67,22,45,67
N'castle Jet,1528,2,15,6,7,58,38,20,51
Melbourne C,1528,3,14,5,10,44,34,10,47
Melbourne V,1528,4,13,5,11,45,41,4,44
Adelaide Utd,1528,5,11,6,11,37,40,-3,39
Brisbane,1528,6,10,5,13,33,42,-9,35
Western Sydn,1528,7,8,9,10,38,47,-9,33
Perth Glory,1528,8,10,2,15,37,50,-13,32
Wellington P,1528,9,5,6,16,31,55,-24,21
CC Mariners,1528,10,4,8,15,28,49,-21,20
Sydney FC,1529,1,21,4,3,66,22,44,67
N'castle Jet,1529,2,16,5,7,58,37,21,53
Melbourne C,1529,3,14,4,11,43,34,9,46
Melbourne V,1529,4,13,5,11,45,40,5,44
Adelaide Utd,1529,5,11,6,11,37,40,-3,39
Brisbane,1529,6,10,5,13,33,42,-9,35
Western Sydn,1529,7,8,9,10,38,47,-9,33
Perth Glory,1529,8,10,2,15,37,50,-13,32
Wellington P,1529,9,5,6,16,31,55,-24,21
CC Mariners,1529,10,4,8,15,28,49,-21,20
Sydney FC,1530,1,21,4,3,67,23,44,67
N'castle Jet,1530,2,16,5,7,60,38,22,53
Melbourne C,1530,3,14,4,11,44,36,8,46
Melbourne V,1530,4,13,5,11,46,41,5,44
Adelaide Utd,1530,5,11,6,11,37,40,-3,39
Brisbane,1530,6,10,5,13,33,42,-9,35
Western Sydn,1530,7,8,9,10,38,47,-9,33
Perth Glory,1530,8,10,2,15,37,50,-13,32
Wellington P,1530,9,5,6,16,31,55,-24,21
CC Mariners,1530,10,4,8,15,28,49,-21,20
Sydney FC,1531,1,20,5,3,67,25,42,65
N'castle Jet,1531,2,15,5,8,57,38,19,50
Melbourne C,1531,3,15,4,10,44,33,11,49
Melbourne V,1531,4,13,6,10,48,41,7,45
Adelaide Utd,1531,5,11,6,11,37,40,-3,39
Brisbane,1531,6,10,5,13,33,42,-9,35
Western Sydn,1531,7,8,9,10,38,47,-9,33
Perth Glory,1531,8,10,2,15,37,50,-13,32
Wellington P,1531,9,5,6,16,31,55,-24,21
CC Mariners,1531,10,4,8,15,28,49,-21,20
Sydney FC,1532,1,21,4,3,67,22,45,67
N'castle Jet,1532,2,15,5,8,58,39,19,50
Melbourne C,1532,3,15,4,10,45,34,11,49
Melbourne V,1532,4,13,5,11,45,41,4,44
Adelaide Utd,1532,5,11,6,11,37,40,-3,39
Brisbane,1532,6,10,5,13,33,42,-9,35
Western Sydn,1532,7,8,9,10,38,47,-9,33
Perth Glory,1532,8,10,2,15,37,50,-13,32
Wellington P,1532,9,5,6,16,31,55,-24,21
CC Mariners,1532,10,4,8,15,28,49,-21,20
Sydney FC,1533,1,21,4,3,67,23,44,67
N'castle Jet,1533,2,16,5,7,61,40,21,53
Melbourne C,1533,3,14,4,11,46,37,9,46
Melbourne V,1533,4,13,5,11,46,41,5,44
Adelaide Utd,1533,5,11,6,11,37,40,-3,39
Brisbane,1533,6,10,5,13,33,42,-9,35
Western Sydn,1533,7,8,9,10,38,47,-9,33
Perth Glory,1533,8,10,2,15,37,50,-13,32
Wellington P,1533,9,5,6,16,31,55,-24,21
CC Mariners,1533,10,4,8,15,28,49,-21,20
Sydney FC,1534,1,20,5,3,64,22,42,65
N'castle Jet,1534,2,15,6,7,58,38,20,51
Melbourne C,1534,3,14,5,10,44,34,10,47
Melbourne V,1534,4,13,6,10,45,38,7,45
Adelaide Utd,1534,5,11,6,11,37,40,-3,39
Brisbane,1534,6,10,5,13,33,42,-9,35
Western Sydn,1534,7,8,9,10,38,47,-9,33
Perth Glory,1534,8,10,2,15,37,50,-13,32
Wellington P,1534,9,5,6,16,31,55,-24,21
CC Mariners,1534,10,4,8,15,28,49,-21,20
Sydney FC,1535,1,21,4,3,68,25,43,67
N'castle Jet,1535,2,16,5,7,59,37,22,53
Melbourne C,1535,3,14,4,11,43,35,8,46
Melbourne V,1535,4,13,5,11,48,42,6,44
Adelaide Utd,1535,5,11,6,11,37,40,-3,39
Brisbane,1535,6,10,5,13,33,42,-9,35
Western Sydn,1535,7,8,9,10,38,47,-9,33
Perth Glory,1535,8,10,2,15,37,50,-13,32
Wellington P,1535,9,5,6,16,31,55,-24,21
CC Mariners,1535,10,4,8,15,28,49,-21,20
Sydney FC,1536,1,20,5,3,65,23,42,65
N'castle Jet,1536,2,15,5,8,57,39,18,50
Melbourne C,1536,3,15,4,10,45,33,12,49
Melbourne V,1536,4,13,6,10,46,39,7,45
Adelaide Utd,1536,5,11,6,11,37,40,-3,39
Brisbane,1536,6,10,5,13,33,42,-9,35
Western Sydn,1536,7,8,9,10,38,47,-9,33
Perth Glory,1536,8,10,2,15,37,50,-13,32
Wellington P,1536,9,5,6,16,31,55,-24,21
CC Mariners,1536,10,4,8,15,28,49,-21,20
Sydney FC,1537,1,21,4,3,67,23,44,67
N'castle Jet,1537,2,16,5,7,59,37,22,53
Melbourne C,1537,3,14,4,11,43,35,8,46
Melbourne V,1537,4,13,5,11,46,41,5,44
Adelaide Utd,1537,5,11,6,11,37,40,-3,39
Brisbane,1537,6,10,5,13,33,42,-9,35
Western Sydn,1537,7,8,9,10,38,47,-9,33
Perth Glory,1537,8,10,2,15,37,50,-13,32
Wellington P,1537,9,5,6,16,31,55,-24,21
CC Mariners,1537,10,4,8,15,28,49,-21,20
Sydney FC,1538,1,21,4,3,68,22,46,67
N'castle Jet,1538,2,16,5,7,61,38,23,53
Melbourne C,1538,3,14,4,11,44,37,7,46
Melbourne V,1538,4,13,5,11,45,42,3,44
Adelaide Utd,1538,5,11,6,11,37,40,-3,39
Brisbane,1538,6,10,5,13,33,42,-9,35
Western Sydn,1538,7,8,9,10,38,47,-9,33
Perth Glory,1538,8,10,2,15,37,50,-13,32
Wellington P,1538,9,5,6,16,31,55,-24,21
CC Mariners,1538,10,4,8,15,28,49,-21,20
Sydney FC,1539,1,20,4,4,65,24,41,64
N'castle Jet,1539,2,16,5,7,59,37,22,53
Melbourne V,1539,3,14,5,10,47,39,8,47
Melbourne C,1539,4,14,4,11,43,35,8,46
Adelaide Utd,1539,5,11,6,11,37,40,-3,39
Brisbane,1539,6,10,5,13,33,42,-9,35
Western Sydn,1539,7,8,9,10,38,47,-9,33
Perth Glory,1539,8,10,2,15,37,50,-13,32
Wellington P,1539,9,5,6,16,31,55,-24,21
CC Mariners,1539,10,4,8,15,28,49,-21,20
Sydney FC,1540,1,20,4,4,65,25,40,64
N'castle Jet,1540,2,15,5,8,59,40,19,50
Melbourne C,1540,3,15,4,10,46,35,11,49
Melbourne V,1540,4,14,5,10,48,39,9,47
Adelaide Utd,1540,5,11,6,11,37,40,-3,39
Brisbane,1540,6,10,5,13,33,42,-9,35
Western Sydn,1540,7,8,9,10,38,47,-9,33
Perth Glory,1540,8,10,2,15,37,50,-13,32
Wellington P,1540,9,5,6,16,31,55,-24,21
CC Mariners,1540,10,4,8,15,28,49,-21,20
Sydney FC,1541,1,21,4,3,67,24,43,67
N'castle Jet,1541,2,15,5,8,57,38,19,50
Melbourne C,1541,3,15,4,10,44,33,11,49
Melbourne V,1541,4,13,5,11,47,41,6,44
Adelaide Utd,1541,5,11,6,11,37,40,-3,39
Brisbane,1541,6,10,5,13,33,42,-9,35
Western Sydn,1541,7,8,9,10,38,47,-9,33
Perth Glory,1541,8,10,2,15,37,50,-13,32
Wellington P,1541,9,5,6,16,31,55,-24,21
CC Mariners,1541,10,4,8,15,28,49,-21,20
Sydney FC,1542,1,21,4,3,68,24,44,67
N'castle Jet,1542,2,16,5,7,59,37,22,53
Melbourne C,1542,3,14,4,11,43,35,8,46
Melbourne V,1542,4,13,5,11,47,42,5,44
Adelaide Utd,1542,5,11,6,11,37,40,-3,39
Brisbane,1542,6,10,5,13,33,42,-9,35
Western Sydn,1542,7,8,9,10,38,47,-9,33
Perth Glory,1542,8,10,2,15,37,50,-13,32
Wellington P,1542,9,5,6,16,31,55,-24,21
CC Mariners,1542,10,4,8,15,28,49,-21,20
Sydney FC,1543,1,21,4,3,67,23,44,67
N'castle Jet,1543,2,15,6,7,58,38,20,51
Melbourne C,1543,3,14,5,10,44,34,10,47
Melbourne V,1543,4,13,5,11,46,41,5,44
Adelaide Utd,1543,5,11,6,11,37,40,-3,39
Brisbane,1543,6,10,5,13,33,42,-9,35
Western Sydn,1543,7,8,9,10,38,47,-9,33
Perth Glory,1543,8,10,2,15,37,50,-13,32
Wellington P,1543,9,5,6,16,31,55,-24,21
CC Mariners,1543,10,4,8,15,28,49,-21,20
Sydney FC,1544,1,21,4,3,65,22,43,67
N'castle Jet,1544,2,15,6,7,59,39,20,51
Melbourne C,1544,3,14,5,10,45,35,10,47
Melbourne V,1544,4,13,5,11,45,39,6,44
Adelaide Utd,1544,5,11,6,11,37,40,-3,39
Brisbane,1544,6,10,5,13,33,42,-9,35
Western Sydn,1544,7,8,9,10,38,47,-9,33
Perth Glory,1544,8,10,2,15,37,50,-13,32
Wellington P,1544,9,5,6,16,31,55,-24,21
CC Mariners,1544,10,4,8,15,28,49,-21,20
Sydney FC,1545,1,21,4,3,68,22,46,67
N'castle Jet,1545,2,15,5,8,58,41,17,50
Melbourne C,1545,3,15,4,10,47,34,13,49
Melbourne V,1545,4,13,5,11,45,42,3,44
Adelaide Utd,1545,5,11,6,11,37,40,-3,39
Brisbane,1545,6,10,5,13,33,42,-9,35
Western Sydn,1545,7,8,9,10,38,47,-9,33
Perth Glory,1545,8,10,2,15,37,50,-13,32
Wellington P,1545,9,5,6,16,31,55,-24,21
CC Mariners,1545,10,4,8,15,28,49,-21,20
Sydney FC,1546,1,21,4,3,67,23,44,67
N'castle Jet,1546,2,15,6,7,59,39,20,51
Melbourne C,1546,3,14,5,10,45,35,10,47
Melbourne V,1546,4,13,5,11,46,41,5,44
Adelaide Utd,1546,5,11,6,11,37,40,-3,39
Brisbane,1546,6,10,5,13,33,42,-9,35
Western Sydn,1546,7,8,9,10,38,47,-9,33
Perth Glory,1546,8,10,2,15,37,50,-13,32
Wellington P,1546,9,5,6,16,31,55,-24,21
CC Mariners,1546,10,4,8,15,28,49,-21,20
Sydney FC,1547,1,21,4,3,66,23,43,67
N'castle Jet,1547,2,15,5,8,57,39,18,50
Melbourne C,1547,3,15,4,10,45,33,12,49
Melbourne V,1547,4,13,5,11,46,40,6,44
Adelaide Utd,1547,5,11,6,11,37,40,-3,39
Brisbane,1547,6,10,5,13,33,42,-9,35
Western Sydn,1547,7,8,9,10,38,47,-9,33
Perth Glory,1547,8,10,2,15,37,50,-13,32
Wellington P,1547,9,5,6,16,31,55,-24,21
CC Mariners,1547,10,4,8,15,28,49,-21,20
Sydney FC,1548,1,21,4,3,67,23,44,67
N'castle Jet,1548,2,15,5,8,59,40,19,50
Melbourne C,1548,3,15,4,10,46,35,11,49
Melbourne V,1548,4,13,5,11,46,41,5,44
Adelaide Utd,1548,5,11,6,11,37,40,-3,39
Brisbane,1548,6,10,5,13,33,42,-9,35
Western Sydn,1548,7,8,9,10,38,47,-9,33
Perth Glory,1548,8,10,2,15,37,50,-13,32
Wellington P,1548,9,5,6,16,31,55,-24,21
CC Mariners,1548,10,4,8,15,28,49,-21,20
Sydney FC,1549,1,20,5,3,65,23,42,65
N'castle Jet,1549,2,16,5,7,60,39,21,53
Melbourne C,1549,3,14,4,11,45,36,9,46
Melbourne V,1549,4,13,6,10,46,39,7,45
Adelaide Utd,1549,5,11,6,11,37,40,-3,39
Brisbane,1549,6,10,5,13,33,42,-9,35
Western Sydn,1549,7,8,9,10,38,47,-9,33
Perth Glory,1549,8,10,2,15,37,50,-13,32
Wellington P,1549,9,5,6,16,31,55,-24,21
CC Mariners,1549,10,4,8,15,28,49,-21,20
Sydney FC,1550,1,20,4,4,65,25,40,64
N'castle Jet,1550,2,16,5,7,60,37,23,53
Melbourne V,1550,3,14,5,10,48,39,9,47
Melbourne C,1550,4,14,4,11,43,36,7,46
Adelaide Utd,1550,5,11,6,11,37,40,-3,39
Brisbane,1550,6,10,5,13,33,42,-9,35
Western Sydn,1550,7,8,9,10,38,47,-9,33
Perth Glory,1550,8,10,2,15,37,50,-13,32
Wellington P,1550,9,5,6,16,31,55,-24,21
CC Mariners,1550,10,4,8,15,28,49,-21,20
Sydney FC,1551,1,21,4,3,67,22,45,67
N'castle Jet,1551,2,16,5,7,58,37,21,53
Melbourne C,1551,3,14,4,11,43,34,9,46
Melbourne V,1551,4,13,5,11,45,41,4,44
Adelaide Utd,1551,5,11,6,11,37,40,-3,39
Brisbane,1551,6,10,5,13,33,42,-9,35
Western Sydn,1551,7,8,9,10,38,47,-9,33
Perth Glory,1551,8,10,2,15,37,50,-13,32
Wellington P,1551,9,5,6,16,31,55,-24,21
CC Mariners,1551,10,4,8,15,28,49,-21,20
Sydney FC,1552,1,21,4,3,68,24,44,67
N'castle Jet,1552,2,16,5,7,60,38,22,53
Melbourne C,1552,3,14,4,11,44,36,8,46
Melbourne V,1552,4,13,5,11,47,42,5,44
Adelaide Utd,1552,5,11,6,11,37,40,-3,39
Brisbane,1552,6,10,5,13,33,42,-9,35
Western Sydn,1552,7,8,9,10,38,47,-9,33
Perth Glory,1552,8,10,2,15,37,50,-13,32
Wellington P,1552,9,5,6,16,31,55,-24,21
CC Mariners,1552,10,4,8,15,28,49,-21,20
Sydney FC,1553,1,21,4,3,67,24,43,67
N'castle Jet,1553,2,16,5,7,59,37,22,53
Melbourne C,1553,3,14,4,11,43,35,8,46
Melbourne V,1553,4,13,5,11,47,41,6,44
Adelaide Utd,1553,5,11,6,11,37,40,-3,39
Brisbane,1553,6,10,5,13,33,42,-9,35
Western Sydn,1553,7,8,9,10,38,47,-9,33
Perth Glory,1553,8,10,2,15,37,50,-13,32
Wellington P,1553,9,5,6,16,31,55,-24,21
CC Mariners,1553,10,4,8,15,28,49,-21,20
Sydney FC,1554,1,21,4,3,66,23,43,67
N'castle Jet,1554,2,15,5,8,57,38,19,50
Melbourne C,1554,3,15,4,10,44,33,11,49
Melbourne V,1554,4,13,5,11,46,40,6,44
Adelaide Utd,1554,5,11,6,11,37,40,-3,39
Brisbane,1554,6,10,5,13,33,42,-9,35
Western Sydn,1554,7,8,9,10,38,47,-9,33
Perth Glory,1554,8,10,2,15,37,50,-13,32
Wellington P,1554,9,5,6,16,31,55,-24,21
CC Mariners,1554,10,4,8,15,28,49,-21,20
Sydney FC,1555,1,21,4,3,70,24,46,67
N'castle Jet,1555,2,15,6,7,58,38,20,51
Melbourne C,1555,3,14,5,10,44,34,10,47
Melbourne V,1555,4,13,5,11,47,44,3,44
Adelaide Utd,1555,5,11,6,11,37,40,-3,39
Brisbane,1555,6,10,5,13,33,42,-9,35
Western Sydn,1555,7,8,9,10,38,47,-9,33
Perth Glory,1555,8,10,2,15,37,50,-13,32
Wellington P,1555,9,5,6,16,31,55,-24,21
CC Mariners,1555,10,4,8,15,28,49,-21,20
Sydney FC,1556,1,21,4,3,66,22,44,67
N'castle Jet,1556,2,16,5,7,60,39,21,53
Melbourne C,1556,3,14,4,11,45,36,9,46
Melbourne V,1556,4,13,5,11,45,40,5,44
Adelaide Utd,1556,5,11,6,11,37,40,-3,39
Brisbane,1556,6,10,5,13,33,42,-9,35
Western Sydn,1556,7,8,9,10,38,47,-9,33
Perth Glory,1556,8,10,2,15,37,50,-13,32
Wellington P,1556,9,5,6,16,31,55,-24,21
CC Mariners,1556,10,4,8,15,28,49,-21,20
Sydney FC,1557,1,21,4,3,68,22,46,67
N'castle Jet,1557,2,16,5,7,59,37,22,53
Melbourne C,1557,3,14,4,11,43,35,8,46
Melbourne V,1557,4,13,5,11,45,42,3,44
Adelaide Utd,1557,5,11,6,11,37,40,-3,39
Brisbane,1557,6,10,5,13,33,42,-9,35
Western Sydn,1557,7,8,9,10,38,47,-9,33
Perth Glory,1557,8,10,2,15,37,50,-13,32
Wellington P,1557,9,5,6,16,31,55,-24,21
CC Mariners,1557,10,4,8,15,28,49,-21,20
Sydney FC,1558,1,21,4,3,66,22,44,67
N'castle Jet,1558,2,15,5,8,57,38,19,50
Melbourne C,1558,3,15,4,10,44,33,11,49
Melbourne V,1558,4,13,5,11,45,40,5,44
Adelaide Utd,1558,5,11,6,11,37,40,-3,39
Brisbane,1558,6,10,5,13,33,42,-9,35
Western Sydn,1558,7,8,9,10,38,47,-9,33
Perth Glory,1558,8,10,2,15,37,50,-13,32
Wellington P,1558,9,5,6,16,31,55,-24,21
CC Mariners,1558,10,4,8,15,28,49,-21,20
Sydney FC,1559,1,21,4,3,65,22,43,67
N'castle Jet,1559,2,15,5,8,58,40,18,50
Melbourne C,1559,3,15,4,10,46,34,12,49
Melbourne V,1559,4,13,5,11,45,39,6,44
Adelaide Utd,1559,5,11,6,11,37,40,-3,39
Brisbane,1559,6,10,5,13,33,42,-9,35
Western Sydn,1559,7,8,9,10,38,47,-9,33
Perth Glory,1559,8,10,2,15,37,50,-13,32
Wellington P,1559,9,5,6,16,31,55,-24,21
CC Mariners,1559,10,4,8,15,28,49,-21,20
Sydney FC,1560,1,20,4,4,65,24,41,64
N'castle Jet,1560,2,16,5,7,59,38,21,53
Melbourne V,1560,3,14,5,10,47,39,8,47
Melbourne C,1560,4,14,4,11,44,35,9,46
Adelaide Utd,1560,5,11,6,11,37,40,-3,39
Brisbane,1560,6,10,5,13,33,42,-9,35
Western Sydn,1560,7,8,9,10,38,47,-9,33
Perth Glory,1560,8,10,2,15,37,50,-13,32
Wellington P,1560,9,5,6,16,31,55,-24,21
CC Mariners,1560,10,4,8,15,28,49,-21,20
Sydney FC,1561,1,21,4,3,67,23,44,67
N'castle Jet,1561,2,15,5,8,59,43,16,50
Melbourne C,1561,3,15,4,10,49,35,14,49
Melbourne V,1561,4,13,5,11,46,41,5,44
Adelaide Utd,1561,5,11,6,11,37,40,-3,39
Brisbane,1561,6,10,5,13,33,42,-9,35
Western Sydn,1561,7,8,9,10,38,47,-9,33
Perth Glory,1561,8,10,2,15,37,50,-13,32
Wellington P,1561,9,5,6,16,31,55,-24,21
CC Mariners,1561,10,4,8,15,28,49,-21,20
Sydney FC,1562,1,21,4,3,66,23,43,67
N'castle Jet,1562,2,16,5,7,60,39,21,53
Melbourne C,1562,3,14,4,11,45,36,9,46
Melbourne V,1562,4,13,5,11,46,40,6,44
Adelaide Utd,1562,5,11,6,11,37,40,-3,39
Brisbane,1562,6,10,5,13,33,42,-9,35
Western Sydn,1562,7,8,9,10,38,47,-9,33
Perth Glory,1562,8,10,2,15,37,50,-13,32
Wellington P,1562,9,5,6,16,31,55,-24,21
CC Mariners,1562,10,4,8,15,28,49,-21,20
Sydney FC,1563,1,21,4,3,65,22,43,67
N'castle Jet,1563,2,16,5,7,61,40,21,53
Melbourne C,1563,3,14,4,11,46,37,9,46
Melbourne V,1563,4,13,5,11,45,39,6,44
Adelaide Utd,1563,5,11,6,11,37,40,-3,39
Brisbane,1563,6,10,5,13,33,42,-9,35
Western Sydn,1563,7,8,9,10,38,47,-9,33
Perth Glory,1563,8,10,2,15,37,50,-13,32
Wellington P,1563,9,5,6,16,31,55,-24,21
CC Mariners,1563,10,4,8,15,28,49,-21,20
Sydney FC,1564,1,21,4,3,66,22,44,67
N'castle Jet,1564,2,15,6,7,59,39,20,51
Melbourne C,1564,3,14,5,10,45,35,10,47
Melbourne V,1564,4,13,5,11,45,40,5,44
Adelaide Utd,1564,5,11,6,11,37,40,-3,39
Brisbane,1564,6,10,5,13,33,42,-9,35
Western Sydn,1564,7,8,9,10,38,47,-9,33
Perth Glory,1564,8,10,2,15,37,50,-13,32
Wellington P,1564,9,5,6,16,31,55,-24,21
CC Mariners,1564,10,4,8,15,28,49,-21,20
Sydney FC,1565,1,21,4,3,67,22,45,67
N'castle Jet,1565,2,15,6,7,58,38,20,51
Melbourne C,1565,3,14,5,10,44,34,10,47
Melbourne V,1565,4,13,5,11,45,41,4,44
Adelaide Utd,1565,5,11,6,11,37,40,-3,39
Brisbane,1565,6,10,5,13,33,42,-9,35
Western Sydn,1565,7,8,9,10,38,47,-9,33
Perth Glory,1565,8,10,2,15,37,50,-13,32
Wellington P,1565,9,5,6,16,31,55,-24,21
CC Mariners,1565,10,4,8,15,28,49,-21,20
Sydney FC,1566,1,20,5,3,64,22,42,65
N'castle Jet,1566,2,16,5,7,58,37,21,53
Melbourne C,1566,3,14,4,11,43,34,9,46
Melbourne V,1566,4,13,6,10,45,38,7,45
Adelaide Utd,1566,5,11,6,11,37,40,-3,39
Brisbane,1566,6,10,5,13,33,42,-9,35
Western Sydn,1566,7,8,9,10,38,47,-9,33
Perth Glory,1566,8,10,2,15,37,50,-13,32
Wellington P,1566,9,5,6,16,31,55,-24,21
CC Mariners,1566,10,4,8,15,28,49,-21,20
Sydney FC,1567,1,20,5,3,65,23,42,65
N'castle Jet,1567,2,16,5,7,60,37,23,53
Melbourne C,1567,3,14,4,11,43,36,7,46
Melbourne V,1567,4,13,6,10,46,39,7,45
Adelaide Utd,1567,5,11,6,11,37,40,-3,39
Brisbane,1567,6,10,5,13,33,42,-9,35
Western Sydn,1567,7,8,9,10,38,47,-9,33
Perth Glory,1567,8,10,2,15,37,50,-13,32
Wellington P,1567,9,5,6,16,31,55,-24,21
CC Mariners,1567,10,4,8,15,28,49,-21,20
Sydney FC,1568,1,20,4,4,65,25,40,64
N'castle Jet,1568,2,15,6,7,58,38,20,51
Melbourne C,1568,3,14,5,10,44,34,10,47
Melbourne V,1568,4,14,5,10,48,39,9,47
Adelaide Utd,1568,5,11,6,11,37,40,-3,39
Brisbane,1568,6,10,5,13,33,42,-9,35
Western Sydn,1568,7,8,9,10,38,47,-9,33
Perth Glory,1568,8,10,2,15,37,50,-13,32
Wellington P,1568,9,5,6,16,31,55,-24,21
CC Mariners,1568,10,4,8,15,28,49,-21,20
Sydney FC,1569,1,20,4,4,64,24,40,64
N'castle Jet,1569,2,16,5,7,60,37,23,53
Melbourne V,1569,3,14,5,10,47,38,9,47
Melbourne C,1569,4,14,4,11,43,36,7,46
Adelaide Utd,1569,5,11,6,11,37,40,-3,39
Brisbane,1569,6,10,5,13,33,42,-9,35
Western Sydn,1569,7,8,9,10,38,47,-9,33
Perth Glory,1569,8,10,2,15,37,50,-13,32
Wellington P,1569,9,5,6,16,31,55,-24,21
CC Mariners,1569,10,4,8,15,28,49,-21,20
Sydney FC,1570,1,21,4,3,67,22,45,67
N'castle Jet,1570,2,16,5,7,59,38,21,53
Melbourne C,1570,3,14,4,11,44,35,9,46
Melbourne V,1570,4,13,5,11,45,41,4,44
Adelaide Utd,1570,5,11,6,11,37,40,-3,39
Brisbane,1570,6,10,5,13,33,42,-9,35
Western Sydn,1570,7,8,9,10,38,47,-9,33
Perth Glory,1570,8,10,2,15,37,50,-13,32
Wellington P,1570,9,5,6,16,31,55,-24,21
CC Mariners,1570,10,4,8,15,28,49,-21,20
Sydney FC,1571,1,20,5,3,64,22,42,65
N'castle Jet,1571,2,16,5,7,60,39,21,53
Melbourne C,1571,3,14,4,11,45,36,9,46
Melbourne V,1571,4,13,6,10,45,38,7,45
Adelaide Utd,1571,5,11,6,11,37,40,-3,39
Brisbane,1571,6,10,5,13,33,42,-9,35
Western Sydn,1571,7,8,9,10,38,47,-9,33
Perth Glory,1571,8,10,2,15,37,50,-13,32
Wellington P,1571,9,5,6,16,31,55,-24,21
CC Mariners,1571,10,4,8,15,28,49,-21,20
Sydney FC,1572,1,20,4,4,65,24,41,64
N'castle Jet,1572,2,16,5,7,60,37,23,53
Melbourne V,1572,3,14,5,10,47,39,8,47
Melbourne C,1572,4,14,4,11,43,36,7,46
Adelaide Utd,1572,5,11,6,11,37,40,-3,39
Brisbane,1572,6,10,5,13,33,42,-9,35
Western Sydn,1572,7,8,9,10,38,47,-9,33
Perth Glory,1572,8,10,2,15,37,50,-13,32
Wellington P,1572,9,5,6,16,31,55,-24,21
CC Mariners,1572,10,4,8,15,28,49,-21,20
Sydney FC,1573,1,20,5,3,65,23,42,65
N'castle Jet,1573,2,16,5,7,58,37,21,53
Melbourne C,1573,3,14,4,11,43,34,9,46
Melbourne V,1573,4,13,6,10,46,39,7,45
Adelaide Utd,1573,5,11,6,11,37,40,-3,39
Brisbane,1573,6,10,5,13,33,42,-9,35
Western Sydn,1573,7,8,9,10,38,47,-9,33
Perth Glory,1573,8,10,2,15,37,50,-13,32
Wellington P,1573,9,5,6,16,31,55,-24,21
CC Mariners,1573,10,4,8,15,28,49,-21,20
Sydney FC,1574,1,21,4,3,66,23,43,67
N'castle Jet,1574,2,15,5,8,58,39,19,50
Melbourne C,1574,3,15,4,10,45,34,11,49
Melbourne V,1574,4,13,5,11,46,40,6,44
Adelaide Utd,1574,5,11,6,11,37,40,-3,39
Brisbane,1574,6,10,5,13,33,42,-9,35
Western Sydn,1574,7,8,9,10,38,47,-9,33
Perth Glory,1574,8,10,2,15,37,50,-13,32
Wellington P,1574,9,5,6,16,31,55,-24,21
CC Mariners,1574,10,4,8,15,28,49,-21,20
Sydney FC,1575,1,20,5,3,64,22,42,65
N'castle Jet,1575,2,16,5,7,60,38,22,53
Melbourne C,1575,3,14,4,11,44,36,8,46
Melbourne V,1575,4,13,6,10,45,38,7,45
Adelaide Utd,1575,5,11,6,11,37,40,-3,39
Brisbane,1575,6,10,5,13,33,42,-9,35
Western Sydn,1575,7,8,9,10,38,47,-9,33
Perth Glory,1575,8,10,2,15,37,50,-13,32
Wellington P,1575,9,5,6,16,31,55,-24,21
CC Mariners,1575,10,4,8,15,28,49,-21,20
Sydney FC,1576,1,21,4,3,66,23,43,67
N'castle Jet,1576,2,15,6,7,59,39,20,51
Melbourne C,1576,3,14,5,10,45,35,10,47
Melbourne V,1576,4,13,5,11,46,40,6,44
Adelaide Utd,1576,5,11,6,11,37,40,-3,39
Brisbane,1576,6,10,5,13,33,42,-9,35
Western Sydn,1576,7,8,9,10,38,47,-9,33
Perth Glory,1576,8,10,2,15,37,50,-13,32
Wellington P,1576,9,5,6,16,31,55,-24,21
CC Mariners,1576,10,4,8,15,28,49,-21,20
Sydney FC,1577,1,21,4,3,68,22,46,67
N'castle Jet,1577,2,15,6,7,58,38,20,51
Melbourne C,1577,3,14,5,10,44,34,10,47
Melbourne V,1577,4,13,5,11,45,42,3,44
Adelaide Utd,1577,5,11,6,11,37,40,-3,39
Brisbane,1577,6,10,5,13,33,42,-9,35
Western Sydn,1577,7,8,9,10,38,47,-9,33
Perth Glory,1577,8,10,2,15,37,50,-13,32
Wellington P,1577,9,5,6,16,31,55,-24,21
CC Mariners,1577,10,4,8,15,28,49,-21,20
Sydney FC,1578,1,20,5,3,65,23,42,65
N'castle Jet,1578,2,16,5,7,59,38,21,53
Melbourne C,1578,3,14,4,11,44,35,9,46
Melbourne V,1578,4,13,6,10,46,39,7,45
Adelaide Utd,1578,5,11,6,11,37,40,-3,39
Brisbane,1578,6,10,5,13,33,42,-9,35
Western Sydn,1578,7,8,9,10,38,47,-9,33
Perth Glory,1578,8,10,2,15,37,50,-13,32
Wellington P,1578,9,5,6,16,31,55,-24,21
CC Mariners,1578,10,4,8,15,28,49,-21,20
Sydney FC,1579,1,21,4,3,66,23,43,67
N'castle Jet,1579,2,15,5,8,57,38,19,50
Melbourne C,1579,3,15,4,10,44,33,11,49
Melbourne V,1579,4,13,5,11,46,40,6,44
Adelaide Utd,1579,5,11,6,11,37,40,-3,39
Brisbane,1579,6,10,5,13,33,42,-9,35
Western Sydn,1579,7,8,9,10,38,47,-9,33
Perth Glory,1579,8,10,2,15,37,50,-13,32
Wellington P,1579,9,5,6,16,31,55,-24,21
CC Mariners,1579,10,4,8,15,28,49,-21,20
Sydney FC,1580,1,20,4,4,64,23,41,64
N'castle Jet,1580,2,15,5,8,57,39,18,50
Melbourne C,1580,3,15,4,10,45,33,12,49
Melbourne V,1580,4,14,5,10,46,38,8,47
Adelaide Utd,1580,5,11,6,11,37,40,-3,39
Brisbane,1580,6,10,5,13,33,42,-9,35
Western Sydn,1580,7,8,9,10,38,47,-9,33
Perth Glory,1580,8,10,2,15,37,50,-13,32
Wellington P,1580,9,5,6,16,31,55,-24,21
CC Mariners,1580,10,4,8,15,28,49,-21,20
Sydney FC,1581,1,20,5,3,64,22,42,65
N'castle Jet,1581,2,16,5,7,60,38,22,53
Melbourne C,1581,3,14,4,11,44,36,8,46
Melbourne V,1581,4,13,6,10,45,38,7,45
Adelaide Utd,1581,5,11,6,11,37,40,-3,39
Brisbane,1581,6,10,5,13,33,42,-9,35
Western Sydn,1581,7,8,9,10,38,47,-9,33
Perth Glory,1581,8,10,2,15,37,50,-13,32
Wellington P,1581,9,5,6,16,31,55,-24,21
CC Mariners,1581,10,4,8,15,28,49,-21,20
Sydney FC,1582,1,21,4,3,65,22,43,67
N'castle Jet,1582,2,16,5,7,59,38,21,53
Melbourne C,1582,3,14,4,11,44,35,9,46
Melbourne V,1582,4,13,5,11,45,39,6,44
Adelaide Utd,1582,5,11,6,11,37,40,-3,39
Brisbane,1582,6,10,5,13,33,42,-9,35
Western Sydn,1582,7,8,9,10,38,47,-9,33
Perth Glory,1582,8,10,2,15,37,50,-13,32
Wellington P,1582,9,5,6,16,31,55,-24,21
CC Mariners,1582,10,4,8,15,28,49,-21,20
Sydney FC,1583,1,21,4,3,67,23,44,67
N'castle Jet,1583,2,16,5,7,58,37,21,53
Melbourne C,1583,3,14,4,11,43,34,9,46
Melbourne V,1583,4,13,5,11,46,41,5,44
Adelaide Utd,1583,5,11,6,11,37,40,-3,39
Brisbane,1583,6,10,5,13,33,42,-9,35
Western Sydn,1583,7,8,9,10,38,47,-9,33
Perth Glory,1583,8,10,2,15,37,50,-13,32
Wellington P,1583,9,5,6,16,31,55,-24,21
CC Mariners,1583,10,4,8,15,28,49,-21,20
Sydney FC,1584,1,21,4,3,68,23,45,67
N'castle Jet,1584,2,16,5,7,58,37,21,53
Melbourne C,1584,3,14,4,11,43,34,9,46
Melbourne V,1584,4,13,5,11,46,42,4,44
Adelaide Utd,1584,5,11,6,11,37,40,-3,39
Brisbane,1584,6,10,5,13,33,42,-9,35
Western Sydn,1584,7,8,9,10,38,47,-9,33
Perth Glory,1584,8,10,2,15,37,50,-13,32
Wellington P,1584,9,5,6,16,31,55,-24,21
CC Mariners,1584,10,4,8,15,28,49,-21,20
Sydney FC,1585,1,21,4,3,67,22,45,67
N'castle Jet,1585,2,15,5,8,57,39,18,50
Melbourne C,1585,3,15,4,10,45,33,12,49
Melbourne V,1585,4,13,5,11,45,41,4,44
Adelaide Utd,1585,5,11,6,11,37,40,-3,39
Brisbane,1585,6,10,5,13,33,42,-9,35
Western Sydn,1585,7,8,9,10,38,47,-9,33
Perth Glory,1585,8,10,2,15,37,50,-13,32
Wellington P,1585,9,5,6,16,31,55,-24,21
CC Mariners,1585,10,4,8,15,28,49,-21,20
Sydney FC,1586,1,20,5,3,65,23,42,65
N'castle Jet,1586,2,15,6,7,60,40,20,51
Melbourne C,1586,3,14,5,10,46,36,10,47
Melbourne V,1586,4,13,6,10,46,39,7,45
Adelaide Utd,1586,5,11,6,11,37,40,-3,39
Brisbane,1586,6,10,5,13,33,42,-9,35
Western Sydn,1586,7,8,9,10,38,47,-9,33
Perth Glory,1586,8,10,2,15,37,50,-13,32
Wellington P,1586,9,5,6,16,31,55,-24,21
CC Mariners,1586,10,4,8,15,28,49,-21,20
Sydney FC,1587,1,21,4,3,66,23,43,67
N'castle Jet,1587,2,15,5,8,58,39,19,50
Melbourne C,1587,3,15,4,10,45,34,11,49
Melbourne V,1587,4,13,5,11,46,40,6,44
Adelaide Utd,1587,5,11,6,11,37,40,-3,39
Brisbane,1587,6,10,5,13,33,42,-9,35
Western Sydn,1587,7,8,9,10,38,47,-9,33
Perth Glory,1587,8,10,2,15,37,50,-13,32
Wellington P,1587,9,5,6,16,31,55,-24,21
CC Mariners,1587,10,4,8,15,28,49,-21,20
Sydney FC,1588,1,21,4,3,66,23,43,67
N'castle Jet,1588,2,15,5,8,59,40,19,50
Melbourne C,1588,3,15,4,10,46,35,11,49
Melbourne V,1588,4,13,5,11,46,40,6,44
Adelaide Utd,1588,5,11,6,11,37,40,-3,39
Brisbane,1588,6,10,5,13,33,42,-9,35
Western Sydn,1588,7,8,9,10,38,47,-9,33
Perth Glory,1588,8,10,2,15,37,50,-13,32
Wellington P,1588,9,5,6,16,31,55,-24,21
CC Mariners,1588,10,4,8,15,28,49,-21,20
Sydney FC,1589,1,21,4,3,67,23,44,67
N'castle Jet,1589,2,15,6,7,59,39,20,51
Melbourne C,1589,3,14,5,10,45,35,10,47
Melbourne V,1589,4,13,5,11,46,41,5,44
Adelaide Utd,1589,5,11,6,11,37,40,-3,39
Brisbane,1589,6,10,5,13,33,42,-9,35
Western Sydn,1589,7,8,9,10,38,47,-9,33
Perth Glory,1589,8,10,2,15,37,50,-13,32
Wellington P,1589,9,5,6,16,31,55,-24,21
CC Mariners,1589,10,4,8,15,28,49,-21,20
Sydney FC,1590,1,21,4,3,67,22,45,67
N'castle Jet,1590,2,16,5,7,59,38,21,53
Melbourne C,1590,3,14,4,11,44,35,9,46
Melbourne V,1590,4,13,5,11,45,41,4,44
Adelaide Utd,1590,5,11,6,11,37,40,-3,39
Brisbane,1590,6,10,5,13,33,42,-9,35
Western Sydn,1590,7,8,9,10,38,47,-9,33
Perth Glory,1590,8,10,2,15,37,50,-13,32
Wellington P,1590,9,5,6,16,31,55,-24,21
CC Mariners,1590,10,4,8,15,28,49,-21,20
Sydney FC,1591,1,21,4,3,67,22,45,67
N'castle Jet,1591,2,16,5,7,60,39,21,53
Melbourne C,1591,3,14,4,11,45,36,9,46
Melbourne V,1591,4,13,5,11,45,41,4,44
Adelaide Utd,1591,5,11,6,11,37,40,-3,39
Brisbane,1591,6,10,5,13,33,42,-9,35
Western Sydn,1591,7,8,9,10,38,47,-9,33
Perth Glory,1591,8,10,2,15,37,50,-13,32
Wellington P,1591,9,5,6,16,31,55,-24,21
CC Mariners,1591,10,4,8,15,28,49,-21,20
Sydney FC,1592,1,20,4,4,64,23,41,64
N'castle Jet,1592,2,15,6,7,57,37,20,51
Melbourne C,1592,3,14,5,10,43,33,10,47
Melbourne V,1592,4,14,5,10,46,38,8,47
Adelaide Utd,1592,5,11,6,11,37,40,-3,39
Brisbane,1592,6,10,5,13,33,42,-9,35
Western Sydn,1592,7,8,9,10,38,47,-9,33
Perth Glory,1592,8,10,2,15,37,50,-13,32
Wellington P,1592,9,5,6,16,31,55,-24,21
CC Mariners,1592,10,4,8,15,28,49,-21,20
Sydney FC,1593,1,21,4,3,66,22,44,67
N'castle Jet,1593,2,16,5,7,59,37,22,53
Melbourne C,1593,3,14,4,11,43,35,8,46
Melbourne V,1593,4,13,5,11,45,40,5,44
Adelaide Utd,1593,5,11,6,11,37,40,-3,39
Brisbane,1593,6,10,5,13,33,42,-9,35
Western Sydn,1593,7,8,9,10,38,47,-9,33
Perth Glory,1593,8,10,2,15,37,50,-13,32
Wellington P,1593,9,5,6,16,31,55,-24,21
CC Mariners,1593,10,4,8,15,28,49,-21,20
Sydney FC,1594,1,20,5,3,65,23,42,65
N'castle Jet,1594,2,15,5,8,59,41,18,50
Melbourne C,1594,3,15,4,10,47,35,12,49
Melbourne V,1594,4,13,6,10,46,39,7,45
Adelaide Utd,1594,5,11,6,11,37,40,-3,39
Brisbane,1594,6,10,5,13,33,42,-9,35
Western Sydn,1594,7,8,9,10,38,47,-9,33
Perth Glory,1594,8,10,2,15,37,50,-13,32
Wellington P,1594,9,5,6,16,31,55,-24,21
CC Mariners,1594,10,4,8,15,28,49,-21,20
Sydney FC,1595,1,20,5,3,64,22,42,65
N'castle Jet,1595,2,15,6,7,59,39,20,51
Melbourne C,1595,3,14,5,10,45,35,10,47
Melbourne V,1595,4,13,6,10,45,38,7,45
Adelaide Utd,1595,5,11,6,11,37,40,-3,39
Brisbane,1595,6,10,5,13,33,42,-9,35
Western Sydn,1595,7,8,9,10,38,47,-9,33
Perth Glory,1595,8,10,2,15,37,50,-13,32
Wellington P,1595,9,5,6,16,31,55,-24,21
CC Mariners,1595,10,4,8,15,28,49,-21,20
Sydney FC,1596,1,20,5,3,65,23,42,65
N'castle Jet,1596,2,15,6,7,58,38,20,51
Melbourne C,1596,3,14,5,10,44,34,10,47
Melbourne V,1596,4,13,6,10,46,39,7,45
Adelaide Utd,1596,5,11,6,11,37,40,-3,39
Brisbane,1596,6,10,5,13,33,42,-9,35
Western Sydn,1596,7,8,9,10,38,47,-9,33
Perth Glory,1596,8,10,2,15,37,50,-13,32
Wellington P,1596,9,5,6,16,31,55,-24,21
CC Mariners,1596,10,4,8,15,28,49,-21,20
Sydney FC,1597,1,21,4,3,66,22,44,67
N'castle Jet,1597,2,15,5,8,58,39,19,50
Melbourne C,1597,3,15,4,10,45,34,11,49
Melbourne V,1597,4,13,5,11,45,40,5,44
Adelaide Utd,1597,5,11,6,11,37,40,-3,39
Brisbane,1597,6,10,5,13,33,42,-9,35
Western Sydn,1597,7,8,9,10,38,47,-9,33
Perth Glory,1597,8,10,2,15,37,50,-13,32
Wellington P,1597,9,5,6,16,31,55,-24,21
CC Mariners,1597,10,4,8,15,28,49,-21,20
Sydney FC,1598,1,21,4,3,66,22,44,67
N'castle Jet,1598,2,16,5,7,58,37,21,53
Melbourne C,1598,3,14,4,11,43,34,9,46
Melbourne V,1598,4,13,5,11,45,40,5,44
Adelaide Utd,1598,5,11,6,11,37,40,-3,39
Brisbane,1598,6,10,5,13,33,42,-9,35
Western Sydn,1598,7,8,9,10,38,47,-9,33
Perth Glory,1598,8,10,2,15,37,50,-13,32
Wellington P,1598,9,5,6,16,31,55,-24,21
CC Mariners,1598,10,4,8,15,28,49,-21,20
Sydney FC,1599,1,21,4,3,65,22,43,67
N'castle Jet,1599,2,16,5,7,58,37,21,53
Melbourne C,1599,3,14,4,11,43,34,9,46
Melbourne V,1599,4,13,5,11,45,39,6,44
Adelaide Utd,1599,5,11,6,11,37,40,-3,39
Brisbane,1599,6,10,5,13,33,42,-9,35
Western Sydn,1599,7,8,9,10,38,47,-9,33
Perth Glory,1599,8,10,2,15,37,50,-13,32
Wellington P,1599,9,5,6,16,31,55,-24,21
CC Mariners,1599,10,4,8,15,28,49,-21,20
Sydney FC,1600,1,20,5,3,65,23,42,65
N'castle Jet,1600,2,15,5,8,57,39,18,50
Melbourne C,1600,3,15,4,10,45,33,12,49
Melbourne V,1600,4,13,6,10,46,39,7,45
Adelaide Utd,1600,5,11,6,11,37,40,-3,39
Brisbane,1600,6,10,5,13,33,42,-9,35
Western Sydn,1600,7,8,9,10,38,47,-9,33
Perth Glory,1600,8,10,2,15,37,50,-13,32
Wellington P,1600,9,5,6,16,31,55,-24,21
CC Mariners,1600,10,4,8,15,28,49,-21,20
Sydney FC,1601,1,20,4,4,64,23,41,64
N'castle Jet,1601,2,16,5,7,59,38,21,53
Melbourne V,1601,3,14,5,10,46,38,8,47
Melbourne C,1601,4,14,4,11,44,35,9,46
Adelaide Utd,1601,5,11,6,11,37,40,-3,39
Brisbane,1601,6,10,5,13,33,42,-9,35
Western Sydn,1601,7,8,9,10,38,47,-9,33
Perth Glory,1601,8,10,2,15,37,50,-13,32
Wellington P,1601,9,5,6,16,31,55,-24,21
CC Mariners,1601,10,4,8,15,28,49,-21,20
Sydney FC,1602,1,21,4,3,66,23,43,67
N'castle Jet,1602,2,16,5,7,63,37,26,53
Melbourne C,1602,3,14,4,11,43,39,4,46
Melbourne V,1602,4,13,5,11,46,40,6,44
Adelaide Utd,1602,5,11,6,11,37,40,-3,39
Brisbane,1602,6,10,5,13,33,42,-9,35
Western Sydn,1602,7,8,9,10,38,47,-9,33
Perth Glory,1602,8,10,2,15,37,50,-13,32
Wellington P,1602,9,5,6,16,31,55,-24,21
CC Mariners,1602,10,4,8,15,28,49,-21,20
Sydney FC,1603,1,21,4,3,68,24,44,67
N'castle Jet,1603,2,15,6,7,58,38,20,51
Melbourne C,1603,3,14,5,10,44,34,10,47
Melbourne V,1603,4,13,5,11,47,42,5,44
Adelaide Utd,1603,5,11,6,11,37,40,-3,39
Brisbane,1603,6,10,5,13,33,42,-9,35
Western Sydn,1603,7,8,9,10,38,47,-9,33
Perth Glory,1603,8,10,2,15,37,50,-13,32
Wellington P,1603,9,5,6,16,31,55,-24,21
CC Mariners,1603,10,4,8,15,28,49,-21,20
Sydney FC,1604,1,21,4,3,69,24,45,67
N'castle Jet,1604,2,16,5,7,58,37,21,53
Melbourne C,1604,3,14,4,11,43,34,9,46
Melbourne V,1604,4,13,5,11,47,43,4,44
Adelaide Utd,1604,5,11,6,11,37,40,-3,39
Brisbane,1604,6,10,5,13,33,42,-9,35
Western Sydn,1604,7,8,9,10,38,47,-9,33
Perth Glory,1604,8,10,2,15,37,50,-13,32
Wellington P,1604,9,5,6,16,31,55,-24,21
CC Mariners,1604,10,4,8,15,28,49,-21,20
Sydney FC,1605,1,21,4,3,68,22,46,67
N'castle Jet,1605,2,16,5,7,60,39,21,53
Melbourne C,1605,3,14,4,11,45,36,9,46
Melbourne V,1605,4,13,5,11,45,42,3,44
Adelaide Utd,1605,5,11,6,11,37,40,-3,39
Brisbane,1605,6,10,5,13,33,42,-9,35
Western Sydn,1605,7,8,9,10,38,47,-9,33
Perth Glory,1605,8,10,2,15,37,50,-13,32
Wellington P,1605,9,5,6,16,31,55,-24,21
CC Mariners,1605,10,4,8,15,28,49,-21,20
Sydney FC,1606,1,21,4,3,67,23,44,67
N'castle Jet,1606,2,15,6,7,57,37,20,51
Melbourne C,1606,3,14,5,10,43,33,10,47
Melbourne V,1606,4,13,5,11,46,41,5,44
Adelaide Utd,1606,5,11,6,11,37,40,-3,39
Brisbane,1606,6,10,5,13,33,42,-9,35
Western Sydn,1606,7,8,9,10,38,47,-9,33
Perth Glory,1606,8,10,2,15,37,50,-13,32
Wellington P,1606,9,5,6,16,31,55,-24,21
CC Mariners,1606,10,4,8,15,28,49,-21,20
Sydney FC,1607,1,20,4,4,64,23,41,64
N'castle Jet,1607,2,15,5,8,58,39,19,50
Melbourne C,1607,3,15,4,10,45,34,11,49
Melbourne V,1607,4,14,5,10,46,38,8,47
Adelaide Utd,1607,5,11,6,11,37,40,-3,39
Brisbane,1607,6,10,5,13,33,42,-9,35
Western Sydn,1607,7,8,9,10,38,47,-9,33
Perth Glory,1607,8,10,2,15,37,50,-13,32
Wellington P,1607,9,5,6,16,31,55,-24,21
CC Mariners,1607,10,4,8,15,28,49,-21,20
Sydney FC,1608,1,20,5,3,64,22,42,65
N'castle Jet,1608,2,15,6,7,58,38,20,51
Melbourne C,1608,3,14,5,10,44,34,10,47
Melbourne V,1608,4,13,6,10,45,38,7,45
Adelaide Utd,1608,5,11,6,11,37,40,-3,39
Brisbane,1608,6,10,5,13,33,42,-9,35
Western Sydn,1608,7,8,9,10,38,47,-9,33
Perth Glory,1608,8,10,2,15,37,50,-13,32
Wellington P,1608,9,5,6,16,31,55,-24,21
CC Mariners,1608,10,4,8,15,28,49,-21,20
Sydney FC,1609,1,21,4,3,69,22,47,67
N'castle Jet,1609,2,16,5,7,61,37,24,53
Melbourne C,1609,3,14,4,11,43,37,6,46
Melbourne V,1609,4,13,5,11,45,43,2,44
Adelaide Utd,1609,5,11,6,11,37,40,-3,39
Brisbane,1609,6,10,5,13,33,42,-9,35
Western Sydn,1609,7,8,9,10,38,47,-9,33
Perth Glory,1609,8,10,2,15,37,50,-13,32
Wellington P,1609,9,5,6,16,31,55,-24,21
CC Mariners,1609,10,4,8,15,28,49,-21,20
Sydney FC,1610,1,21,4,3,65,22,43,67
N'castle Jet,1610,2,16,5,7,59,37,22,53
Melbourne C,1610,3,14,4,11,43,35,8,46
Melbourne V,1610,4,13,5,11,45,39,6,44
Adelaide Utd,1610,5,11,6,11,37,40,-3,39
Brisbane,1610,6,10,5,13,33,42,-9,35
Western Sydn,1610,7,8,9,10,38,47,-9,33
Perth Glory,1610,8,10,2,15,37,50,-13,32
Wellington P,1610,9,5,6,16,31,55,-24,21
CC Mariners,1610,10,4,8,15,28,49,-21,20
Sydney FC,1611,1,21,4,3,66,23,43,67
N'castle Jet,1611,2,15,5,8,58,39,19,50
Melbourne C,1611,3,15,4,10,45,34,11,49
Melbourne V,1611,4,13,5,11,46,40,6,44
Adelaide Utd,1611,5,11,6,11,37,40,-3,39
Brisbane,1611,6,10,5,13,33,42,-9,35
Western Sydn,1611,7,8,9,10,38,47,-9,33
Perth Glory,1611,8,10,2,15,37,50,-13,32
Wellington P,1611,9,5,6,16,31,55,-24,21
CC Mariners,1611,10,4,8,15,28,49,-21,20
Sydney FC,1612,1,21,4,3,68,23,45,67
N'castle Jet,1612,2,15,5,8,57,40,17,50
Melbourne C,1612,3,15,4,10,46,33,13,49
Melbourne V,1612,4,13,5,11,46,42,4,44
Adelaide Utd,1612,5,11,6,11,37,40,-3,39
Brisbane,1612,6,10,5,13,33,42,-9,35
Western Sydn,1612,7,8,9,10,38,47,-9,33
Perth Glory,1612,8,10,2,15,37,50,-13,32
Wellington P,1612,9,5,6,16,31,55,-24,21
CC Mariners,1612,10,4,8,15,28,49,-21,20
Sydney FC,1613,1,21,4,3,66,23,43,67
N'castle Jet,1613,2,16,5,7,61,37,24,53
Melbourne C,1613,3,14,4,11,43,37,6,46
Melbourne V,1613,4,13,5,11,46,40,6,44
Adelaide Utd,1613,5,11,6,11,37,40,-3,39
Brisbane,1613,6,10,5,13,33,42,-9,35
Western Sydn,1613,7,8,9,10,38,47,-9,33
Perth Glory,1613,8,10,2,15,37,50,-13,32
Wellington P,1613,9,5,6,16,31,55,-24,21
CC Mariners,1613,10,4,8,15,28,49,-21,20
Sydney FC,1614,1,21,4,3,66,23,43,67
N'castle Jet,1614,2,15,6,7,59,39,20,51
Melbourne C,1614,3,14,5,10,45,35,10,47
Melbourne V,1614,4,13,5,11,46,40,6,44
Adelaide Utd,1614,5,11,6,11,37,40,-3,39
Brisbane,1614,6,10,5,13,33,42,-9,35
Western Sydn,1614,7,8,9,10,38,47,-9,33
Perth Glory,1614,8,10,2,15,37,50,-13,32
Wellington P,1614,9,5,6,16,31,55,-24,21
CC Mariners,1614,10,4,8,15,28,49,-21,20
Sydney FC,1615,1,21,4,3,67,23,44,67
N'castle Jet,1615,2,16,5,7,58,37,21,53
Melbourne C,1615,3,14,4,11,43,34,9,46
Melbourne V,1615,4,13,5,11,46,41,5,44
Adelaide Utd,1615,5,11,6,11,37,40,-3,39
Brisbane,1615,6,10,5,13,33,42,-9,35
Western Sydn,1615,7,8,9,10,38,47,-9,33
Perth Glory,1615,8,10,2,15,37,50,-13,32
Wellington P,1615,9,5,6,16,31,55,-24,21
CC Mariners,1615,10,4,8,15,28,49,-21,20
Sydney FC,1616,1,21,4,3,68,23,45,67
N'castle Jet,1616,2,16,5,7,59,38,21,53
Melbourne C,1616,3,14,4,11,44,35,9,46
Melbourne V,1616,4,13,5,11,46,42,4,44
Adelaide Utd,1616,5,11,6,11,37,40,-3,39
Brisbane,1616,6,10,5,13,33,42,-9,35
Western Sydn,1616,7,8,9,10,38,47,-9,33
Perth Glory,1616,8,10,2,15,37,50,-13,32
Wellington P,1616,9,5,6,16,31,55,-24,21
CC Mariners,1616,10,4,8,15,28,49,-21,20
Sydney FC,1617,1,21,4,3,67,24,43,67
N'castle Jet,1617,2,16,5,7,58,37,21,53
Melbourne C,1617,3,14,4,11,43,34,9,46
Melbourne V,1617,4,13,5,11,47,41,6,44
Adelaide Utd,1617,5,11,6,11,37,40,-3,39
Brisbane,1617,6,10,5,13,33,42,-9,35
Western Sydn,1617,7,8,9,10,38,47,-9,33
Perth Glory,1617,8,10,2,15,37,50,-13,32
Wellington P,1617,9,5,6,16,31,55,-24,21
CC Mariners,1617,10,4,8,15,28,49,-21,20
Sydney FC,1618,1,21,4,3,65,22,43,67
N'castle Jet,1618,2,16,5,7,59,37,22,53
Melbourne C,1618,3,14,4,11,43,35,8,46
Melbourne V,1618,4,13,5,11,45,39,6,44
Adelaide Utd,1618,5,11,6,11,37,40,-3,39
Brisbane,1618,6,10,5,13,33,42,-9,35
Western Sydn,1618,7,8,9,10,38,47,-9,33
Perth Glory,1618,8,10,2,15,37,50,-13,32
Wellington P,1618,9,5,6,16,31,55,-24,21
CC Mariners,1618,10,4,8,15,28,49,-21,20
Sydney FC,1619,1,21,4,3,67,23,44,67
N'castle Jet,1619,2,16,5,7,62,37,25,53
Melbourne C,1619,3,14,4,11,43,38,5,46
Melbourne V,1619,4,13,5,11,46,41,5,44
Adelaide Utd,1619,5,11,6,11,37,40,-3,39
Brisbane,1619,6,10,5,13,33,42,-9,35
Western Sydn,1619,7,8,9,10,38,47,-9,33
Perth Glory,1619,8,10,2,15,37,50,-13,32
Wellington P,1619,9,5,6,16,31,55,-24,21
CC Mariners,1619,10,4,8,15,28,49,-21,20
Sydney FC,1620,1,21,4,3,69,23,46,67
N'castle Jet,1620,2,15,5,8,58,39,19,50
Melbourne C,1620,3,15,4,10,45,34,11,49
Melbourne V,1620,4,13,5,11,46,43,3,44
Adelaide Utd,1620,5,11,6,11,37,40,-3,39
Brisbane,1620,6,10,5,13,33,42,-9,35
Western Sydn,1620,7,8,9,10,38,47,-9,33
Perth Glory,1620,8,10,2,15,37,50,-13,32
Wellington P,1620,9,5,6,16,31,55,-24,21
CC Mariners,1620,10,4,8,15,28,49,-21,20
Sydney FC,1621,1,21,4,3,68,23,45,67
N'castle Jet,1621,2,16,5,7,62,38,24,53
Melbourne C,1621,3,14,4,11,44,38,6,46
Melbourne V,1621,4,13,5,11,46,42,4,44
Adelaide Utd,1621,5,11,6,11,37,40,-3,39
Brisbane,1621,6,10,5,13,33,42,-9,35
Western Sydn,1621,7,8,9,10,38,47,-9,33
Perth Glory,1621,8,10,2,15,37,50,-13,32
Wellington P,1621,9,5,6,16,31,55,-24,21
CC Mariners,1621,10,4,8,15,28,49,-21,20
Sydney FC,1622,1,20,4,4,64,24,40,64
N'castle Jet,1622,2,16,5,7,58,37,21,53
Melbourne V,1622,3,14,5,10,47,38,9,47
Melbourne C,1622,4,14,4,11,43,34,9,46
Adelaide Utd,1622,5,11,6,11,37,40,-3,39
Brisbane,1622,6,10,5,13,33,42,-9,35
Western Sydn,1622,7,8,9,10,38,47,-9,33
Perth Glory,1622,8,10,2,15,37,50,-13,32
Wellington P,1622,9,5,6,16,31,55,-24,21
CC Mariners,1622,10,4,8,15,28,49,-21,20
Sydney FC,1623,1,20,5,3,65,23,42,65
N'castle Jet,1623,2,15,6,7,60,40,20,51
Melbourne C,1623,3,14,5,10,46,36,10,47
Melbourne V,1623,4,13,6,10,46,39,7,45
Adelaide Utd,1623,5,11,6,11,37,40,-3,39
Brisbane,1623,6,10,5,13,33,42,-9,35
Western Sydn,1623,7,8,9,10,38,47,-9,33
Perth Glory,1623,8,10,2,15,37,50,-13,32
Wellington P,1623,9,5,6,16,31,55,-24,21
CC Mariners,1623,10,4,8,15,28,49,-21,20
Sydney FC,1624,1,21,4,3,67,23,44,67
N'castle Jet,1624,2,15,6,7,59,39,20,51
Melbourne C,1624,3,14,5,10,45,35,10,47
Melbourne V,1624,4,13,5,11,46,41,5,44
Adelaide Utd,1624,5,11,6,11,37,40,-3,39
Brisbane,1624,6,10,5,13,33,42,-9,35
Western Sydn,1624,7,8,9,10,38,47,-9,33
Perth Glory,1624,8,10,2,15,37,50,-13,32
Wellington P,1624,9,5,6,16,31,55,-24,21
CC Mariners,1624,10,4,8,15,28,49,-21,20
Sydney FC,1625,1,20,4,4,64,24,40,64
N'castle Jet,1625,2,16,5,7,60,39,21,53
Melbourne V,1625,3,14,5,10,47,38,9,47
Melbourne C,1625,4,14,4,11,45,36,9,46
Adelaide Utd,1625,5,11,6,11,37,40,-3,39
Brisbane,1625,6,10,5,13,33,42,-9,35
Western Sydn,1625,7,8,9,10,38,47,-9,33
Perth Glory,1625,8,10,2,15,37,50,-13,32
Wellington P,1625,9,5,6,16,31,55,-24,21
CC Mariners,1625,10,4,8,15,28,49,-21,20
Sydney FC,1626,1,20,5,3,65,23,42,65
N'castle Jet,1626,2,15,6,7,59,39,20,51
Melbourne C,1626,3,14,5,10,45,35,10,47
Melbourne V,1626,4,13,6,10,46,39,7,45
Adelaide Utd,1626,5,11,6,11,37,40,-3,39
Brisbane,1626,6,10,5,13,33,42,-9,35
Western Sydn,1626,7,8,9,10,38,47,-9,33
Perth Glory,1626,8,10,2,15,37,50,-13,32
Wellington P,1626,9,5,6,16,31,55,-24,21
CC Mariners,1626,10,4,8,15,28,49,-21,20
Sydney FC,1627,1,21,4,3,68,22,46,67
N'castle Jet,1627,2,15,5,8,58,40,18,50
Melbourne C,1627,3,15,4,10,46,34,12,49
Melbourne V,1627,4,13,5,11,45,42,3,44
Adelaide Utd,1627,5,11,6,11,37,40,-3,39
Brisbane,1627,6,10,5,13,33,42,-9,35
Western Sydn,1627,7,8,9,10,38,47,-9,33
Perth Glory,1627,8,10,2,15,37,50,-13,32
Wellington P,1627,9,5,6,16,31,55,-24,21
CC Mariners,1627,10,4,8,15,28,49,-21,20
Sydney FC,1628,1,20,4,4,65,24,41,64
N'castle Jet,1628,2,16,5,7,59,37,22,53
Melbourne V,1628,3,14,5,10,47,39,8,47
Melbourne C,1628,4,14,4,11,43,35,8,46
Adelaide Utd,1628,5,11,6,11,37,40,-3,39
Brisbane,1628,6,10,5,13,33,42,-9,35
Western Sydn,1628,7,8,9,10,38,47,-9,33
Perth Glory,1628,8,10,2,15,37,50,-13,32
Wellington P,1628,9,5,6,16,31,55,-24,21
CC Mariners,1628,10,4,8,15,28,49,-21,20
Sydney FC,1629,1,20,4,4,64,23,41,64
N'castle Jet,1629,2,16,5,7,61,39,22,53
Melbourne V,1629,3,14,5,10,46,38,8,47
Melbourne C,1629,4,14,4,11,45,37,8,46
Adelaide Utd,1629,5,11,6,11,37,40,-3,39
Brisbane,1629,6,10,5,13,33,42,-9,35
Western Sydn,1629,7,8,9,10,38,47,-9,33
Perth Glory,1629,8,10,2,15,37,50,-13,32
Wellington P,1629,9,5,6,16,31,55,-24,21
CC Mariners,1629,10,4,8,15,28,49,-21,20
Sydney FC,1630,1,20,5,3,64,22,42,65
N'castle Jet,1630,2,16,5,7,59,38,21,53
Melbourne C,1630,3,14,4,11,44,35,9,46
Melbourne V,1630,4,13,6,10,45,38,7,45
Adelaide Utd,1630,5,11,6,11,37,40,-3,39
Brisbane,1630,6,10,5,13,33,42,-9,35
Western Sydn,1630,7,8,9,10,38,47,-9,33
Perth Glory,1630,8,10,2,15,37,50,-13,32
Wellington P,1630,9,5,6,16,31,55,-24,21
CC Mariners,1630,10,4,8,15,28,49,-21,20
Sydney FC,1631,1,21,4,3,67,23,44,67
N'castle Jet,1631,2,16,5,7,61,38,23,53
Melbourne C,1631,3,14,4,11,44,37,7,46
Melbourne V,1631,4,13,5,11,46,41,5,44
Adelaide Utd,1631,5,11,6,11,37,40,-3,39
Brisbane,1631,6,10,5,13,33,42,-9,35
Western Sydn,1631,7,8,9,10,38,47,-9,33
Perth Glory,1631,8,10,2,15,37,50,-13,32
Wellington P,1631,9,5,6,16,31,55,-24,21
CC Mariners,1631,10,4,8,15,28,49,-21,20
Sydney FC,1632,1,21,4,3,66,22,44,67
N'castle Jet,1632,2,15,6,7,58,38,20,51
Melbourne C,1632,3,14,5,10,44,34,10,47
Melbourne V,1632,4,13,5,11,45,40,5,44
Adelaide Utd,1632,5,11,6,11,37,40,-3,39
Brisbane,1632,6,10,5,13,33,42,-9,35
Western Sydn,1632,7,8,9,10,38,47,-9,33
Perth Glory,1632,8,10,2,15,37,50,-13,32
Wellington P,1632,9,5,6,16,31,55,-24,21
CC Mariners,1632,10,4,8,15,28,49,-21,20
Sydney FC,1633,1,20,4,4,64,24,40,64
N'castle Jet,1633,2,15,6,7,58,38,20,51
Melbourne C,1633,3,14,5,10,44,34,10,47
Melbourne V,1633,4,14,5,10,47,38,9,47
Adelaide Utd,1633,5,11,6,11,37,40,-3,39
Brisbane,1633,6,10,5,13,33,42,-9,35
Western Sydn,1633,7,8,9,10,38,47,-9,33
Perth Glory,1633,8,10,2,15,37,50,-13,32
Wellington P,1633,9,5,6,16,31,55,-24,21
CC Mariners,1633,10,4,8,15,28,49,-21,20
Sydney FC,1634,1,21,4,3,65,22,43,67
N'castle Jet,1634,2,15,5,8,57,38,19,50
Melbourne C,1634,3,15,4,10,44,33,11,49
Melbourne V,1634,4,13,5,11,45,39,6,44
Adelaide Utd,1634,5,11,6,11,37,40,-3,39
Brisbane,1634,6,10,5,13,33,42,-9,35
Western Sydn,1634,7,8,9,10,38,47,-9,33
Perth Glory,1634,8,10,2,15,37,50,-13,32
Wellington P,1634,9,5,6,16,31,55,-24,21
CC Mariners,1634,10,4,8,15,28,49,-21,20
Sydney FC,1635,1,21,4,3,68,23,45,67
N'castle Jet,1635,2,16,5,7,58,37,21,53
Melbourne C,1635,3,14,4,11,43,34,9,46
Melbourne V,1635,4,13,5,11,46,42,4,44
Adelaide Utd,1635,5,11,6,11,37,40,-3,39
Brisbane,1635,6,10,5,13,33,42,-9,35
Western Sydn,1635,7,8,9,10,38,47,-9,33
Perth Glory,1635,8,10,2,15,37,50,-13,32
Wellington P,1635,9,5,6,16,31,55,-24,21
CC Mariners,1635,10,4,8,15,28,49,-21,20
Sydney FC,1636,1,21,4,3,66,23,43,67
N'castle Jet,1636,2,15,6,7,58,38,20,51
Melbourne C,1636,3,14,5,10,44,34,10,47
Melbourne V,1636,4,13,5,11,46,40,6,44
Adelaide Utd,1636,5,11,6,11,37,40,-3,39
Brisbane,1636,6,10,5,13,33,42,-9,35
Western Sydn,1636,7,8,9,10,38,47,-9,33
Perth Glory,1636,8,10,2,15,37,50,-13,32
Wellington P,1636,9,5,6,16,31,55,-24,21
CC Mariners,1636,10,4,8,15,28,49,-21,20
Sydney FC,1637,1,21,4,3,71,23,48,67
N'castle Jet,1637,2,15,6,7,59,39,20,51
Melbourne C,1637,3,14,5,10,45,35,10,47
Melbourne V,1637,4,13,5,11,46,45,1,44
Adelaide Utd,1637,5,11,6,11,37,40,-3,39
Brisbane,1637,6,10,5,13,33,42,-9,35
Western Sydn,1637,7,8,9,10,38,47,-9,33
Perth Glory,1637,8,10,2,15,37,50,-13,32
Wellington P,1637,9,5,6,16,31,55,-24,21
CC Mariners,1637,10,4,8,15,28,49,-21,20
Sydney FC,1638,1,20,5,3,67,25,42,65
N'castle Jet,1638,2,15,6,7,58,38,20,51
Melbourne C,1638,3,14,5,10,44,34,10,47
Melbourne V,1638,4,13,6,10,48,41,7,45
Adelaide Utd,1638,5,11,6,11,37,40,-3,39
Brisbane,1638,6,10,5,13,33,42,-9,35
Western Sydn,1638,7,8,9,10,38,47,-9,33
Perth Glory,1638,8,10,2,15,37,50,-13,32
Wellington P,1638,9,5,6,16,31,55,-24,21
CC Mariners,1638,10,4,8,15,28,49,-21,20
Sydney FC,1639,1,21,4,3,65,22,43,67
N'castle Jet,1639,2,15,5,8,57,38,19,50
Melbourne C,1639,3,15,4,10,44,33,11,49
Melbourne V,1639,4,13,5,11,45,39,6,44
Adelaide Utd,1639,5,11,6,11,37,40,-3,39
Brisbane,1639,6,10,5,13,33,42,-9,35
Western Sydn,1639,7,8,9,10,38,47,-9,33
Perth Glory,1639,8,10,2,15,37,50,-13,32
Wellington P,1639,9,5,6,16,31,55,-24,21
CC Mariners,1639,10,4,8,15,28,49,-21,20
Sydney FC,1640,1,20,5,3,65,23,42,65
N'castle Jet,1640,2,16,5,7,59,38,21,53
Melbourne C,1640,3,14,4,11,44,35,9,46
Melbourne V,1640,4,13,6,10,46,39,7,45
Adelaide Utd,1640,5,11,6,11,37,40,-3,39
Brisbane,1640,6,10,5,13,33,42,-9,35
Western Sydn,1640,7,8,9,10,38,47,-9,33
Perth Glory,1640,8,10,2,15,37,50,-13,32
Wellington P,1640,9,5,6,16,31,55,-24,21
CC Mariners,1640,10,4,8,15,28,49,-21,20
Sydney FC,1641,1,21,4,3,67,22,45,67
N'castle Jet,1641,2,16,5,7,59,37,22,53
Melbourne C,1641,3,14,4,11,43,35,8,46
Melbourne V,1641,4,13,5,11,45,41,4,44
Adelaide Utd,1641,5,11,6,11,37,40,-3,39
Brisbane,1641,6,10,5,13,33,42,-9,35
Western Sydn,1641,7,8,9,10,38,47,-9,33
Perth Glory,1641,8,10,2,15,37,50,-13,32
Wellington P,1641,9,5,6,16,31,55,-24,21
CC Mariners,1641,10,4,8,15,28,49,-21,20
Sydney FC,1642,1,20,4,4,65,26,39,64
N'castle Jet,1642,2,15,6,7,58,38,20,51
Melbourne V,1642,3,14,5,10,49,39,10,47
Melbourne C,1642,4,14,5,10,44,34,10,47
Adelaide Utd,1642,5,11,6,11,37,40,-3,39
Brisbane,1642,6,10,5,13,33,42,-9,35
Western Sydn,1642,7,8,9,10,38,47,-9,33
Perth Glory,1642,8,10,2,15,37,50,-13,32
Wellington P,1642,9,5,6,16,31,55,-24,21
CC Mariners,1642,10,4,8,15,28,49,-21,20
Sydney FC,1643,1,21,4,3,65,22,43,67
N'castle Jet,1643,2,15,5,8,59,40,19,50
Melbourne C,1643,3,15,4,10,46,35,11,49
Melbourne V,1643,4,13,5,11,45,39,6,44
Adelaide Utd,1643,5,11,6,11,37,40,-3,39
Brisbane,1643,6,10,5,13,33,42,-9,35
Western Sydn,1643,7,8,9,10,38,47,-9,33
Perth Glory,1643,8,10,2,15,37,50,-13,32
Wellington P,1643,9,5,6,16,31,55,-24,21
CC Mariners,1643,10,4,8,15,28,49,-21,20
Sydney FC,1644,1,21,4,3,67,22,45,67
N'castle Jet,1644,2,16,5,7,60,38,22,53
Melbourne C,1644,3,14,4,11,44,36,8,46
Melbourne V,1644,4,13,5,11,45,41,4,44
Adelaide Utd,1644,5,11,6,11,37,40,-3,39
Brisbane,1644,6,10,5,13,33,42,-9,35
Western Sydn,1644,7,8,9,10,38,47,-9,33
Perth Glory,1644,8,10,2,15,37,50,-13,32
Wellington P,1644,9,5,6,16,31,55,-24,21
CC Mariners,1644,10,4,8,15,28,49,-21,20
Sydney FC,1645,1,21,4,3,65,22,43,67
N'castle Jet,1645,2,15,5,8,58,39,19,50
Melbourne C,1645,3,15,4,10,45,34,11,49
Melbourne V,1645,4,13,5,11,45,39,6,44
Adelaide Utd,1645,5,11,6,11,37,40,-3,39
Brisbane,1645,6,10,5,13,33,42,-9,35
Western Sydn,1645,7,8,9,10,38,47,-9,33
Perth Glory,1645,8,10,2,15,37,50,-13,32
Wellington P,1645,9,5,6,16,31,55,-24,21
CC Mariners,1645,10,4,8,15,28,49,-21,20
Sydney FC,1646,1,21,4,3,66,23,43,67
N'castle Jet,1646,2,16,5,7,59,38,21,53
Melbourne C,1646,3,14,4,11,44,35,9,46
Melbourne V,1646,4,13,5,11,46,40,6,44
Adelaide Utd,1646,5,11,6,11,37,40,-3,39
Brisbane,1646,6,10,5,13,33,42,-9,35
Western Sydn,1646,7,8,9,10,38,47,-9,33
Perth Glory,1646,8,10,2,15,37,50,-13,32
Wellington P,1646,9,5,6,16,31,55,-24,21
CC Mariners,1646,10,4,8,15,28,49,-21,20
Sydney FC,1647,1,21,4,3,70,24,46,67
N'castle Jet,1647,2,16,5,7,59,38,21,53
Melbourne C,1647,3,14,4,11,44,35,9,46
Melbourne V,1647,4,13,5,11,47,44,3,44
Adelaide Utd,1647,5,11,6,11,37,40,-3,39
Brisbane,1647,6,10,5,13,33,42,-9,35
Western Sydn,1647,7,8,9,10,38,47,-9,33
Perth Glory,1647,8,10,2,15,37,50,-13,32
Wellington P,1647,9,5,6,16,31,55,-24,21
CC Mariners,1647,10,4,8,15,28,49,-21,20
Sydney FC,1648,1,20,4,4,64,23,41,64
N'castle Jet,1648,2,16,5,7,59,38,21,53
Melbourne V,1648,3,14,5,10,46,38,8,47
Melbourne C,1648,4,14,4,11,44,35,9,46
Adelaide Utd,1648,5,11,6,11,37,40,-3,39
Brisbane,1648,6,10,5,13,33,42,-9,35
Western Sydn,1648,7,8,9,10,38,47,-9,33
Perth Glory,1648,8,10,2,15,37,50,-13,32
Wellington P,1648,9,5,6,16,31,55,-24,21
CC Mariners,1648,10,4,8,15,28,49,-21,20
Sydney FC,1649,1,20,5,3,66,24,42,65
N'castle Jet,1649,2,15,6,7,59,39,20,51
Melbourne C,1649,3,14,5,10,45,35,10,47
Melbourne V,1649,4,13,6,10,47,40,7,45
Adelaide Utd,1649,5,11,6,11,37,40,-3,39
Brisbane,1649,6,10,5,13,33,42,-9,35
Western Sydn,1649,7,8,9,10,38,47,-9,33
Perth Glory,1649,8,10,2,15,37,50,-13,32
Wellington P,1649,9,5,6,16,31,55,-24,21
CC Mariners,1649,10,4,8,15,28,49,-21,20
Sydney FC,1650,1,21,4,3,68,22,46,67
N'castle Jet,1650,2,16,5,7,59,37,22,53
Melbourne C,1650,3,14,4,11,43,35,8,46
Melbourne V,1650,4,13,5,11,45,42,3,44
Adelaide Utd,1650,5,11,6,11,37,40,-3,39
Brisbane,1650,6,10,5,13,33,42,-9,35
Western Sydn,1650,7,8,9,10,38,47,-9,33
Perth Glory,1650,8,10,2,15,37,50,-13,32
Wellington P,1650,9,5,6,16,31,55,-24,21
CC Mariners,1650,10,4,8,15,28,49,-21,20
Sydney FC,1651,1,21,4,3,68,22,46,67
N'castle Jet,1651,2,15,5,8,58,40,18,50
Melbourne C,1651,3,15,4,10,46,34,12,49
Melbourne V,1651,4,13,5,11,45,42,3,44
Adelaide Utd,1651,5,11,6,11,37,40,-3,39
Brisbane,1651,6,10,5,13,33,42,-9,35
Western Sydn,1651,7,8,9,10,38,47,-9,33
Perth Glory,1651,8,10,2,15,37,50,-13,32
Wellington P,1651,9,5,6,16,31,55,-24,21
CC Mariners,1651,10,4,8,15,28,49,-21,20
Sydney FC,1652,1,21,4,3,67,23,44,67
N'castle Jet,1652,2,15,5,8,59,40,19,50
Melbourne C,1652,3,15,4,10,46,35,11,49
Melbourne V,1652,4,13,5,11,46,41,5,44
Adelaide Utd,1652,5,11,6,11,37,40,-3,39
Brisbane,1652,6,10,5,13,33,42,-9,35
Western Sydn,1652,7,8,9,10,38,47,-9,33
Perth Glory,1652,8,10,2,15,37,50,-13,32
Wellington P,1652,9,5,6,16,31,55,-24,21
CC Mariners,1652,10,4,8,15,28,49,-21,20
Sydney FC,1653,1,21,4,3,67,22,45,67
N'castle Jet,1653,2,16,5,7,58,37,21,53
Melbourne C,1653,3,14,4,11,43,34,9,46
Melbourne V,1653,4,13,5,11,45,41,4,44
Adelaide Utd,1653,5,11,6,11,37,40,-3,39
Brisbane,1653,6,10,5,13,33,42,-9,35
Western Sydn,1653,7,8,9,10,38,47,-9,33
Perth Glory,1653,8,10,2,15,37,50,-13,32
Wellington P,1653,9,5,6,16,31,55,-24,21
CC Mariners,1653,10,4,8,15,28,49,-21,20
Sydney FC,1654,1,20,5,3,65,23,42,65
N'castle Jet,1654,2,15,5,8,57,39,18,50
Melbourne C,1654,3,15,4,10,45,33,12,49
Melbourne V,1654,4,13,6,10,46,39,7,45
Adelaide Utd,1654,5,11,6,11,37,40,-3,39
Brisbane,1654,6,10,5,13,33,42,-9,35
Western Sydn,1654,7,8,9,10,38,47,-9,33
Perth Glory,1654,8,10,2,15,37,50,-13,32
Wellington P,1654,9,5,6,16,31,55,-24,21
CC Mariners,1654,10,4,8,15,28,49,-21,20
Sydney FC,1655,1,21,4,3,66,22,44,67
N'castle Jet,1655,2,16,5,7,59,38,21,53
Melbourne C,1655,3,14,4,11,44,35,9,46
Melbourne V,1655,4,13,5,11,45,40,5,44
Adelaide Utd,1655,5,11,6,11,37,40,-3,39
Brisbane,1655,6,10,5,13,33,42,-9,35
Western Sydn,1655,7,8,9,10,38,47,-9,33
Perth Glory,1655,8,10,2,15,37,50,-13,32
Wellington P,1655,9,5,6,16,31,55,-24,21
CC Mariners,1655,10,4,8,15,28,49,-21,20
Sydney FC,1656,1,21,4,3,67,23,44,67
N'castle Jet,1656,2,15,6,7,59,39,20,51
Melbourne C,1656,3,14,5,10,45,35,10,47
Melbourne V,1656,4,13,5,11,46,41,5,44
Adelaide Utd,1656,5,11,6,11,37,40,-3,39
Brisbane,1656,6,10,5,13,33,42,-9,35
Western Sydn,1656,7,8,9,10,38,47,-9,33
Perth Glory,1656,8,10,2,15,37,50,-13,32
Wellington P,1656,9,5,6,16,31,55,-24,21
CC Mariners,1656,10,4,8,15,28,49,-21,20
Sydney FC,1657,1,21,4,3,67,24,43,67
N'castle Jet,1657,2,16,5,7,59,38,21,53
Melbourne C,1657,3,14,4,11,44,35,9,46
Melbourne V,1657,4,13,5,11,47,41,6,44
Adelaide Utd,1657,5,11,6,11,37,40,-3,39
Brisbane,1657,6,10,5,13,33,42,-9,35
Western Sydn,1657,7,8,9,10,38,47,-9,33
Perth Glory,1657,8,10,2,15,37,50,-13,32
Wellington P,1657,9,5,6,16,31,55,-24,21
CC Mariners,1657,10,4,8,15,28,49,-21,20
Sydney FC,1658,1,20,4,4,64,23,41,64
N'castle Jet,1658,2,15,6,7,58,38,20,51
Melbourne C,1658,3,14,5,10,44,34,10,47
Melbourne V,1658,4,14,5,10,46,38,8,47
Adelaide Utd,1658,5,11,6,11,37,40,-3,39
Brisbane,1658,6,10,5,13,33,42,-9,35
Western Sydn,1658,7,8,9,10,38,47,-9,33
Perth Glory,1658,8,10,2,15,37,50,-13,32
Wellington P,1658,9,5,6,16,31,55,-24,21
CC Mariners,1658,10,4,8,15,28,49,-21,20
Sydney FC,1659,1,21,4,3,66,23,43,67
N'castle Jet,1659,2,16,5,7,59,38,21,53
Melbourne C,1659,3,14,4,11,44,35,9,46
Melbourne V,1659,4,13,5,11,46,40,6,44
Adelaide Utd,1659,5,11,6,11,37,40,-3,39
Brisbane,1659,6,10,5,13,33,42,-9,35
Western Sydn,1659,7,8,9,10,38,47,-9,33
Perth Glory,1659,8,10,2,15,37,50,-13,32
Wellington P,1659,9,5,6,16,31,55,-24,21
CC Mariners,1659,10,4,8,15,28,49,-21,20
Sydney FC,1660,1,20,4,4,65,24,41,64
N'castle Jet,1660,2,15,6,7,57,37,20,51
Melbourne C,1660,3,14,5,10,43,33,10,47
Melbourne V,1660,4,14,5,10,47,39,8,47
Adelaide Utd,1660,5,11,6,11,37,40,-3,39
Brisbane,1660,6,10,5,13,33,42,-9,35
Western Sydn,1660,7,8,9,10,38,47,-9,33
Perth Glory,1660,8,10,2,15,37,50,-13,32
Wellington P,1660,9,5,6,16,31,55,-24,21
CC Mariners,1660,10,4,8,15,28,49,-21,20
Sydney FC,1661,1,21,4,3,68,22,46,67
N'castle Jet,1661,2,16,5,7,59,37,22,53
Melbourne C,1661,3,14,4,11,43,35,8,46
Melbourne V,1661,4,13,5,11,45,42,3,44
Adelaide Utd,1661,5,11,6,11,37,40,-3,39
Brisbane,1661,6,10,5,13,33,42,-9,35
Western Sydn,1661,7,8,9,10,38,47,-9,33
Perth Glory,1661,8,10,2,15,37,50,-13,32
Wellington P,1661,9,5,6,16,31,55,-24,21
CC Mariners,1661,10,4,8,15,28,49,-21,20
Sydney FC,1662,1,20,5,3,66,24,42,65
N'castle Jet,1662,2,16,5,7,63,39,24,53
Melbourne C,1662,3,14,4,11,45,39,6,46
Melbourne V,1662,4,13,6,10,47,40,7,45
Adelaide Utd,1662,5,11,6,11,37,40,-3,39
Brisbane,1662,6,10,5,13,33,42,-9,35
Western Sydn,1662,7,8,9,10,38,47,-9,33
Perth Glory,1662,8,10,2,15,37,50,-13,32
Wellington P,1662,9,5,6,16,31,55,-24,21
CC Mariners,1662,10,4,8,15,28,49,-21,20
Sydney FC,1663,1,20,5,3,66,24,42,65
N'castle Jet,1663,2,16,5,7,60,39,21,53
Melbourne C,1663,3,14,4,11,45,36,9,46
Melbourne V,1663,4,13,6,10,47,40,7,45
Adelaide Utd,1663,5,11,6,11,37,40,-3,39
Brisbane,1663,6,10,5,13,33,42,-9,35
Western Sydn,1663,7,8,9,10,38,47,-9,33
Perth Glory,1663,8,10,2,15,37,50,-13,32
Wellington P,1663,9,5,6,16,31,55,-24,21
CC Mariners,1663,10,4,8,15,28,49,-21,20
Sydney FC,1664,1,21,4,3,66,22,44,67
N'castle Jet,1664,2,16,5,7,59,38,21,53
Melbourne C,1664,3,14,4,11,44,35,9,46
Melbourne V,1664,4,13,5,11,45,40,5,44
Adelaide Utd,1664,5,11,6,11,37,40,-3,39
Brisbane,1664,6,10,5,13,33,42,-9,35
Western Sydn,1664,7,8,9,10,38,47,-9,33
Perth Glory,1664,8,10,2,15,37,50,-13,32
Wellington P,1664,9,5,6,16,31,55,-24,21
CC Mariners,1664,10,4,8,15,28,49,-21,20
Sydney FC,1665,1,21,4,3,66,23,43,67
N'castle Jet,1665,2,16,5,7,61,39,22,53
Melbourne C,1665,3,14,4,11,45,37,8,46
Melbourne V,1665,4,13,5,11,46,40,6,44
Adelaide Utd,1665,5,11,6,11,37,40,-3,39
Brisbane,1665,6,10,5,13,33,42,-9,35
Western Sydn,1665,7,8,9,10,38,47,-9,33
Perth Glory,1665,8,10,2,15,37,50,-13,32
Wellington P,1665,9,5,6,16,31,55,-24,21
CC Mariners,1665,10,4,8,15,28,49,-21,20
Sydney FC,1666,1,21,4,3,68,24,44,67
N'castle Jet,1666,2,16,5,7,59,38,21,53
Melbourne C,1666,3,14,4,11,44,35,9,46
Melbourne V,1666,4,13,5,11,47,42,5,44
Adelaide Utd,1666,5,11,6,11,37,40,-3,39
Brisbane,1666,6,10,5,13,33,42,-9,35
Western Sydn,1666,7,8,9,10,38,47,-9,33
Perth Glory,1666,8,10,2,15,37,50,-13,32
Wellington P,1666,9,5,6,16,31,55,-24,21
CC Mariners,1666,10,4,8,15,28,49,-21,20
Sydney FC,1667,1,21,4,3,67,24,43,67
N'castle Jet,1667,2,15,5,8,59,40,19,50
Melbourne C,1667,3,15,4,10,46,35,11,49
Melbourne V,1667,4,13,5,11,47,41,6,44
Adelaide Utd,1667,5,11,6,11,37,40,-3,39
Brisbane,1667,6,10,5,13,33,42,-9,35
Western Sydn,1667,7,8,9,10,38,47,-9,33
Perth Glory,1667,8,10,2,15,37,50,-13,32
Wellington P,1667,9,5,6,16,31,55,-24,21
CC Mariners,1667,10,4,8,15,28,49,-21,20
Sydney FC,1668,1,20,4,4,65,24,41,64
N'castle Jet,1668,2,16,5,7,58,37,21,53
Melbourne V,1668,3,14,5,10,47,39,8,47
Melbourne C,1668,4,14,4,11,43,34,9,46
Adelaide Utd,1668,5,11,6,11,37,40,-3,39
Brisbane,1668,6,10,5,13,33,42,-9,35
Western Sydn,1668,7,8,9,10,38,47,-9,33
Perth Glory,1668,8,10,2,15,37,50,-13,32
Wellington P,1668,9,5,6,16,31,55,-24,21
CC Mariners,1668,10,4,8,15,28,49,-21,20
Sydney FC,1669,1,20,4,4,64,23,41,64
N'castle Jet,1669,2,16,5,7,60,38,22,53
Melbourne V,1669,3,14,5,10,46,38,8,47
Melbourne C,1669,4,14,4,11,44,36,8,46
Adelaide Utd,1669,5,11,6,11,37,40,-3,39
Brisbane,1669,6,10,5,13,33,42,-9,35
Western Sydn,1669,7,8,9,10,38,47,-9,33
Perth Glory,1669,8,10,2,15,37,50,-13,32
Wellington P,1669,9,5,6,16,31,55,-24,21
CC Mariners,1669,10,4,8,15,28,49,-21,20
Sydney FC,1670,1,21,4,3,66,22,44,67
N'castle Jet,1670,2,15,5,8,58,39,19,50
Melbourne C,1670,3,15,4,10,45,34,11,49
Melbourne V,1670,4,13,5,11,45,40,5,44
Adelaide Utd,1670,5,11,6,11,37,40,-3,39
Brisbane,1670,6,10,5,13,33,42,-9,35
Western Sydn,1670,7,8,9,10,38,47,-9,33
Perth Glory,1670,8,10,2,15,37,50,-13,32
Wellington P,1670,9,5,6,16,31,55,-24,21
CC Mariners,1670,10,4,8,15,28,49,-21,20
Sydney FC,1671,1,21,4,3,65,22,43,67
N'castle Jet,1671,2,16,5,7,60,39,21,53
Melbourne C,1671,3,14,4,11,45,36,9,46
Melbourne V,1671,4,13,5,11,45,39,6,44
Adelaide Utd,1671,5,11,6,11,37,40,-3,39
Brisbane,1671,6,10,5,13,33,42,-9,35
Western Sydn,1671,7,8,9,10,38,47,-9,33
Perth Glory,1671,8,10,2,15,37,50,-13,32
Wellington P,1671,9,5,6,16,31,55,-24,21
CC Mariners,1671,10,4,8,15,28,49,-21,20
Sydney FC,1672,1,21,4,3,65,22,43,67
N'castle Jet,1672,2,16,5,7,59,38,21,53
Melbourne C,1672,3,14,4,11,44,35,9,46
Melbourne V,1672,4,13,5,11,45,39,6,44
Adelaide Utd,1672,5,11,6,11,37,40,-3,39
Brisbane,1672,6,10,5,13,33,42,-9,35
Western Sydn,1672,7,8,9,10,38,47,-9,33
Perth Glory,1672,8,10,2,15,37,50,-13,32
Wellington P,1672,9,5,6,16,31,55,-24,21
CC Mariners,1672,10,4,8,15,28,49,-21,20
Sydney FC,1673,1,21,4,3,66,22,44,67
N'castle Jet,1673,2,15,5,8,57,39,18,50
Melbourne C,1673,3,15,4,10,45,33,12,49
Melbourne V,1673,4,13,5,11,45,40,5,44
Adelaide Utd,1673,5,11,6,11,37,40,-3,39
Brisbane,1673,6,10,5,13,33,42,-9,35
Western Sydn,1673,7,8,9,10,38,47,-9,33
Perth Glory,1673,8,10,2,15,37,50,-13,32
Wellington P,1673,9,5,6,16,31,55,-24,21
CC Mariners,1673,10,4,8,15,28,49,-21,20
Sydney FC,1674,1,21,4,3,66,23,43,67
N'castle Jet,1674,2,15,5,8,57,41,16,50
Melbourne C,1674,3,15,4,10,47,33,14,49
Melbourne V,1674,4,13,5,11,46,40,6,44
Adelaide Utd,1674,5,11,6,11,37,40,-3,39
Brisbane,1674,6,10,5,13,33,42,-9,35
Western Sydn,1674,7,8,9,10,38,47,-9,33
Perth Glory,1674,8,10,2,15,37,50,-13,32
Wellington P,1674,9,5,6,16,31,55,-24,21
CC Mariners,1674,10,4,8,15,28,49,-21,20
Sydney FC,1675,1,21,4,3,68,22,46,67
N'castle Jet,1675,2,15,6,7,58,38,20,51
Melbourne C,1675,3,14,5,10,44,34,10,47
Melbourne V,1675,4,13,5,11,45,42,3,44
Adelaide Utd,1675,5,11,6,11,37,40,-3,39
Brisbane,1675,6,10,5,13,33,42,-9,35
Western Sydn,1675,7,8,9,10,38,47,-9,33
Perth Glory,1675,8,10,2,15,37,50,-13,32
Wellington P,1675,9,5,6,16,31,55,-24,21
CC Mariners,1675,10,4,8,15,28,49,-21,20
Sydney FC,1676,1,20,4,4,64,26,38,64
N'castle Jet,1676,2,16,5,7,60,39,21,53
Melbourne V,1676,3,14,5,10,49,38,11,47
Melbourne C,1676,4,14,4,11,45,36,9,46
Adelaide Utd,1676,5,11,6,11,37,40,-3,39
Brisbane,1676,6,10,5,13,33,42,-9,35
Western Sydn,1676,7,8,9,10,38,47,-9,33
Perth Glory,1676,8,10,2,15,37,50,-13,32
Wellington P,1676,9,5,6,16,31,55,-24,21
CC Mariners,1676,10,4,8,15,28,49,-21,20
Sydney FC,1677,1,20,5,3,64,22,42,65
N'castle Jet,1677,2,15,6,7,59,39,20,51
Melbourne C,1677,3,14,5,10,45,35,10,47
Melbourne V,1677,4,13,6,10,45,38,7,45
Adelaide Utd,1677,5,11,6,11,37,40,-3,39
Brisbane,1677,6,10,5,13,33,42,-9,35
Western Sydn,1677,7,8,9,10,38,47,-9,33
Perth Glory,1677,8,10,2,15,37,50,-13,32
Wellington P,1677,9,5,6,16,31,55,-24,21
CC Mariners,1677,10,4,8,15,28,49,-21,20
Sydney FC,1678,1,21,4,3,66,22,44,67
N'castle Jet,1678,2,16,5,7,61,40,21,53
Melbourne C,1678,3,14,4,11,46,37,9,46
Melbourne V,1678,4,13,5,11,45,40,5,44
Adelaide Utd,1678,5,11,6,11,37,40,-3,39
Brisbane,1678,6,10,5,13,33,42,-9,35
Western Sydn,1678,7,8,9,10,38,47,-9,33
Perth Glory,1678,8,10,2,15,37,50,-13,32
Wellington P,1678,9,5,6,16,31,55,-24,21
CC Mariners,1678,10,4,8,15,28,49,-21,20
Sydney FC,1679,1,20,5,3,65,23,42,65
N'castle Jet,1679,2,16,5,7,61,39,22,53
Melbourne C,1679,3,14,4,11,45,37,8,46
Melbourne V,1679,4,13,6,10,46,39,7,45
Adelaide Utd,1679,5,11,6,11,37,40,-3,39
Brisbane,1679,6,10,5,13,33,42,-9,35
Western Sydn,1679,7,8,9,10,38,47,-9,33
Perth Glory,1679,8,10,2,15,37,50,-13,32
Wellington P,1679,9,5,6,16,31,55,-24,21
CC Mariners,1679,10,4,8,15,28,49,-21,20
Sydney FC,1680,1,21,4,3,66,22,44,67
N'castle Jet,1680,2,15,5,8,59,40,19,50
Melbourne C,1680,3,15,4,10,46,35,11,49
Melbourne V,1680,4,13,5,11,45,40,5,44
Adelaide Utd,1680,5,11,6,11,37,40,-3,39
Brisbane,1680,6,10,5,13,33,42,-9,35
Western Sydn,1680,7,8,9,10,38,47,-9,33
Perth Glory,1680,8,10,2,15,37,50,-13,32
Wellington P,1680,9,5,6,16,31,55,-24,21
CC Mariners,1680,10,4,8,15,28,49,-21,20
Sydney FC,1681,1,21,4,3,67,22,45,67
N'castle Jet,1681,2,15,5,8,58,39,19,50
Melbourne C,1681,3,15,4,10,45,34,11,49
Melbourne V,1681,4,13,5,11,45,41,4,44
Adelaide Utd,1681,5,11,6,11,37,40,-3,39
Brisbane,1681,6,10,5,13,33,42,-9,35
Western Sydn,1681,7,8,9,10,38,47,-9,33
Perth Glory,1681,8,10,2,15,37,50,-13,32
Wellington P,1681,9,5,6,16,31,55,-24,21
CC Mariners,1681,10,4,8,15,28,49,-21,20
Sydney FC,1682,1,21,4,3,68,22,46,67
N'castle Jet,1682,2,15,5,8,57,38,19,50
Melbourne C,1682,3,15,4,10,44,33,11,49
Melbourne V,1682,4,13,5,11,45,42,3,44
Adelaide Utd,1682,5,11,6,11,37,40,-3,39
Brisbane,1682,6,10,5,13,33,42,-9,35
Western Sydn,1682,7,8,9,10,38,47,-9,33
Perth Glory,1682,8,10,2,15,37,50,-13,32
Wellington P,1682,9,5,6,16,31,55,-24,21
CC Mariners,1682,10,4,8,15,28,49,-21,20
Sydney FC,1683,1,20,5,3,65,23,42,65
N'castle Jet,1683,2,15,6,7,59,39,20,51
Melbourne C,1683,3,14,5,10,45,35,10,47
Melbourne V,1683,4,13,6,10,46,39,7,45
Adelaide Utd,1683,5,11,6,11,37,40,-3,39
Brisbane,1683,6,10,5,13,33,42,-9,35
Western Sydn,1683,7,8,9,10,38,47,-9,33
Perth Glory,1683,8,10,2,15,37,50,-13,32
Wellington P,1683,9,5,6,16,31,55,-24,21
CC Mariners,1683,10,4,8,15,28,49,-21,20
Sydney FC,1684,1,20,4,4,64,23,41,64
N'castle Jet,1684,2,16,5,7,61,38,23,53
Melbourne V,1684,3,14,5,10,46,38,8,47
Melbourne C,1684,4,14,4,11,44,37,7,46
Adelaide Utd,1684,5,11,6,11,37,40,-3,39
Brisbane,1684,6,10,5,13,33,42,-9,35
Western Sydn,1684,7,8,9,10,38,47,-9,33
Perth Glory,1684,8,10,2,15,37,50,-13,32
Wellington P,1684,9,5,6,16,31,55,-24,21
CC Mariners,1684,10,4,8,15,28,49,-21,20
Sydney FC,1685,1,21,4,3,66,23,43,67
N'castle Jet,1685,2,15,5,8,57,38,19,50
Melbourne C,1685,3,15,4,10,44,33,11,49
Melbourne V,1685,4,13,5,11,46,40,6,44
Adelaide Utd,1685,5,11,6,11,37,40,-3,39
Brisbane,1685,6,10,5,13,33,42,-9,35
Western Sydn,1685,7,8,9,10,38,47,-9,33
Perth Glory,1685,8,10,2,15,37,50,-13,32
Wellington P,1685,9,5,6,16,31,55,-24,21
CC Mariners,1685,10,4,8,15,28,49,-21,20
Sydney FC,1686,1,21,4,3,66,22,44,67
N'castle Jet,1686,2,16,5,7,59,38,21,53
Melbourne C,1686,3,14,4,11,44,35,9,46
Melbourne V,1686,4,13,5,11,45,40,5,44
Adelaide Utd,1686,5,11,6,11,37,40,-3,39
Brisbane,1686,6,10,5,13,33,42,-9,35
Western Sydn,1686,7,8,9,10,38,47,-9,33
Perth Glory,1686,8,10,2,15,37,50,-13,32
Wellington P,1686,9,5,6,16,31,55,-24,21
CC Mariners,1686,10,4,8,15,28,49,-21,20
Sydney FC,1687,1,20,5,3,64,22,42,65
N'castle Jet,1687,2,15,5,8,58,40,18,50
Melbourne C,1687,3,15,4,10,46,34,12,49
Melbourne V,1687,4,13,6,10,45,38,7,45
Adelaide Utd,1687,5,11,6,11,37,40,-3,39
Brisbane,1687,6,10,5,13,33,42,-9,35
Western Sydn,1687,7,8,9,10,38,47,-9,33
Perth Glory,1687,8,10,2,15,37,50,-13,32
Wellington P,1687,9,5,6,16,31,55,-24,21
CC Mariners,1687,10,4,8,15,28,49,-21,20
Sydney FC,1688,1,21,4,3,66,22,44,67
N'castle Jet,1688,2,16,5,7,61,37,24,53
Melbourne C,1688,3,14,4,11,43,37,6,46
Melbourne V,1688,4,13,5,11,45,40,5,44
Adelaide Utd,1688,5,11,6,11,37,40,-3,39
Brisbane,1688,6,10,5,13,33,42,-9,35
Western Sydn,1688,7,8,9,10,38,47,-9,33
Perth Glory,1688,8,10,2,15,37,50,-13,32
Wellington P,1688,9,5,6,16,31,55,-24,21
CC Mariners,1688,10,4,8,15,28,49,-21,20
Sydney FC,1689,1,20,5,3,66,24,42,65
N'castle Jet,1689,2,15,6,7,59,39,20,51
Melbourne C,1689,3,14,5,10,45,35,10,47
Melbourne V,1689,4,13,6,10,47,40,7,45
Adelaide Utd,1689,5,11,6,11,37,40,-3,39
Brisbane,1689,6,10,5,13,33,42,-9,35
Western Sydn,1689,7,8,9,10,38,47,-9,33
Perth Glory,1689,8,10,2,15,37,50,-13,32
Wellington P,1689,9,5,6,16,31,55,-24,21
CC Mariners,1689,10,4,8,15,28,49,-21,20
Sydney FC,1690,1,20,5,3,66,24,42,65
N'castle Jet,1690,2,16,5,7,60,37,23,53
Melbourne C,1690,3,14,4,11,43,36,7,46
Melbourne V,1690,4,13,6,10,47,40,7,45
Adelaide Utd,1690,5,11,6,11,37,40,-3,39
Brisbane,1690,6,10,5,13,33,42,-9,35
Western Sydn,1690,7,8,9,10,38,47,-9,33
Perth Glory,1690,8,10,2,15,37,50,-13,32
Wellington P,1690,9,5,6,16,31,55,-24,21
CC Mariners,1690,10,4,8,15,28,49,-21,20
Sydney FC,1691,1,20,5,3,66,24,42,65
N'castle Jet,1691,2,16,5,7,61,38,23,53
Melbourne C,1691,3,14,4,11,44,37,7,46
Melbourne V,1691,4,13,6,10,47,40,7,45
Adelaide Utd,1691,5,11,6,11,37,40,-3,39
Brisbane,1691,6,10,5,13,33,42,-9,35
Western Sydn,1691,7,8,9,10,38,47,-9,33
Perth Glory,1691,8,10,2,15,37,50,-13,32
Wellington P,1691,9,5,6,16,31,55,-24,21
CC Mariners,1691,10,4,8,15,28,49,-21,20
Sydney FC,1692,1,21,4,3,67,23,44,67
N'castle Jet,1692,2,16,5,7,61,37,24,53
Melbourne C,1692,3,14,4,11,43,37,6,46
Melbourne V,1692,4,13,5,11,46,41,5,44
Adelaide Utd,1692,5,11,6,11,37,40,-3,39
Brisbane,1692,6,10,5,13,33,42,-9,35
Western Sydn,1692,7,8,9,10,38,47,-9,33
Perth Glory,1692,8,10,2,15,37,50,-13,32
Wellington P,1692,9,5,6,16,31,55,-24,21
CC Mariners,1692,10,4,8,15,28,49,-21,20
Sydney FC,1693,1,20,4,4,66,25,41,64
N'castle Jet,1693,2,16,5,7,59,37,22,53
Melbourne V,1693,3,14,5,10,48,40,8,47
Melbourne C,1693,4,14,4,11,43,35,8,46
Adelaide Utd,1693,5,11,6,11,37,40,-3,39
Brisbane,1693,6,10,5,13,33,42,-9,35
Western Sydn,1693,7,8,9,10,38,47,-9,33
Perth Glory,1693,8,10,2,15,37,50,-13,32
Wellington P,1693,9,5,6,16,31,55,-24,21
CC Mariners,1693,10,4,8,15,28,49,-21,20
Sydney FC,1694,1,21,4,3,66,23,43,67
N'castle Jet,1694,2,15,5,8,57,39,18,50
Melbourne C,1694,3,15,4,10,45,33,12,49
Melbourne V,1694,4,13,5,11,46,40,6,44
Adelaide Utd,1694,5,11,6,11,37,40,-3,39
Brisbane,1694,6,10,5,13,33,42,-9,35
Western Sydn,1694,7,8,9,10,38,47,-9,33
Perth Glory,1694,8,10,2,15,37,50,-13,32
Wellington P,1694,9,5,6,16,31,55,-24,21
CC Mariners,1694,10,4,8,15,28,49,-21,20
Sydney FC,1695,1,21,4,3,68,22,46,67
N'castle Jet,1695,2,15,5,8,58,39,19,50
Melbourne C,1695,3,15,4,10,45,34,11,49
Melbourne V,1695,4,13,5,11,45,42,3,44
Adelaide Utd,1695,5,11,6,11,37,40,-3,39
Brisbane,1695,6,10,5,13,33,42,-9,35
Western Sydn,1695,7,8,9,10,38,47,-9,33
Perth Glory,1695,8,10,2,15,37,50,-13,32
Wellington P,1695,9,5,6,16,31,55,-24,21
CC Mariners,1695,10,4,8,15,28,49,-21,20
Sydney FC,1696,1,21,4,3,67,22,45,67
N'castle Jet,1696,2,16,5,7,61,37,24,53
Melbourne C,1696,3,14,4,11,43,37,6,46
Melbourne V,1696,4,13,5,11,45,41,4,44
Adelaide Utd,1696,5,11,6,11,37,40,-3,39
Brisbane,1696,6,10,5,13,33,42,-9,35
Western Sydn,1696,7,8,9,10,38,47,-9,33
Perth Glory,1696,8,10,2,15,37,50,-13,32
Wellington P,1696,9,5,6,16,31,55,-24,21
CC Mariners,1696,10,4,8,15,28,49,-21,20
Sydney FC,1697,1,20,4,4,64,23,41,64
N'castle Jet,1697,2,15,5,8,58,40,18,50
Melbourne C,1697,3,15,4,10,46,34,12,49
Melbourne V,1697,4,14,5,10,46,38,8,47
Adelaide Utd,1697,5,11,6,11,37,40,-3,39
Brisbane,1697,6,10,5,13,33,42,-9,35
Western Sydn,1697,7,8,9,10,38,47,-9,33
Perth Glory,1697,8,10,2,15,37,50,-13,32
Wellington P,1697,9,5,6,16,31,55,-24,21
CC Mariners,1697,10,4,8,15,28,49,-21,20
Sydney FC,1698,1,20,4,4,65,24,41,64
N'castle Jet,1698,2,16,5,7,59,38,21,53
Melbourne V,1698,3,14,5,10,47,39,8,47
Melbourne C,1698,4,14,4,11,44,35,9,46
Adelaide Utd,1698,5,11,6,11,37,40,-3,39
Brisbane,1698,6,10,5,13,33,42,-9,35
Western Sydn,1698,7,8,9,10,38,47,-9,33
Perth Glory,1698,8,10,2,15,37,50,-13,32
Wellington P,1698,9,5,6,16,31,55,-24,21
CC Mariners,1698,10,4,8,15,28,49,-21,20
Sydney FC,1699,1,21,4,3,66,22,44,67
N'castle Jet,1699,2,16,5,7,60,39,21,53
Melbourne C,1699,3,14,4,11,45,36,9,46
Melbourne V,1699,4,13,5,11,45,40,5,44
Adelaide Utd,1699,5,11,6,11,37,40,-3,39
Brisbane,1699,6,10,5,13,33,42,-9,35
Western Sydn,1699,7,8,9,10,38,47,-9,33
Perth Glory,1699,8,10,2,15,37,50,-13,32
Wellington P,1699,9,5,6,16,31,55,-24,21
CC Mariners,1699,10,4,8,15,28,49,-21,20
Sydney FC,1700,1,21,4,3,66,23,43,67
N'castle Jet,1700,2,15,6,7,59,39,20,51
Melbourne C,1700,3,14,5,10,45,35,10,47
Melbourne V,1700,4,13,5,11,46,40,6,44
Adelaide Utd,1700,5,11,6,11,37,40,-3,39
Brisbane,1700,6,10,5,13,33,42,-9,35
Western Sydn,1700,7,8,9,10,38,47,-9,33
Perth Glory,1700,8,10,2,15,37,50,-13,32
Wellington P,1700,9,5,6,16,31,55,-24,21
CC Mariners,1700,10,4,8,15,28,49,-21,20
Sydney FC,1701,1,20,5,3,65,23,42,65
N'castle Jet,1701,2,15,6,7,57,37,20,51
Melbourne C,1701,3,14,5,10,43,33,10,47
Melbourne V,1701,4,13,6,10,46,39,7,45
Adelaide Utd,1701,5,11,6,11,37,40,-3,39
Brisbane,1701,6,10,5,13,33,42,-9,35
Western Sydn,1701,7,8,9,10,38,47,-9,33
Perth Glory,1701,8,10,2,15,37,50,-13,32
Wellington P,1701,9,5,6,16,31,55,-24,21
CC Mariners,1701,10,4,8,15,28,49,-21,20
Sydney FC,1702,1,21,4,3,66,23,43,67
N'castle Jet,1702,2,15,6,7,58,38,20,51
Melbourne C,1702,3,14,5,10,44,34,10,47
Melbourne V,1702,4,13,5,11,46,40,6,44
Adelaide Utd,1702,5,11,6,11,37,40,-3,39
Brisbane,1702,6,10,5,13,33,42,-9,35
Western Sydn,1702,7,8,9,10,38,47,-9,33
Perth Glory,1702,8,10,2,15,37,50,-13,32
Wellington P,1702,9,5,6,16,31,55,-24,21
CC Mariners,1702,10,4,8,15,28,49,-21,20
Sydney FC,1703,1,21,4,3,69,23,46,67
N'castle Jet,1703,2,15,5,8,59,41,18,50
Melbourne C,1703,3,15,4,10,47,35,12,49
Melbourne V,1703,4,13,5,11,46,43,3,44
Adelaide Utd,1703,5,11,6,11,37,40,-3,39
Brisbane,1703,6,10,5,13,33,42,-9,35
Western Sydn,1703,7,8,9,10,38,47,-9,33
Perth Glory,1703,8,10,2,15,37,50,-13,32
Wellington P,1703,9,5,6,16,31,55,-24,21
CC Mariners,1703,10,4,8,15,28,49,-21,20
Sydney FC,1704,1,20,4,4,65,24,41,64
N'castle Jet,1704,2,15,5,8,57,39,18,50
Melbourne C,1704,3,15,4,10,45,33,12,49
Melbourne V,1704,4,14,5,10,47,39,8,47
Adelaide Utd,1704,5,11,6,11,37,40,-3,39
Brisbane,1704,6,10,5,13,33,42,-9,35
Western Sydn,1704,7,8,9,10,38,47,-9,33
Perth Glory,1704,8,10,2,15,37,50,-13,32
Wellington P,1704,9,5,6,16,31,55,-24,21
CC Mariners,1704,10,4,8,15,28,49,-21,20
Sydney FC,1705,1,20,5,3,65,23,42,65
N'castle Jet,1705,2,16,5,7,61,38,23,53
Melbourne C,1705,3,14,4,11,44,37,7,46
Melbourne V,1705,4,13,6,10,46,39,7,45
Adelaide Utd,1705,5,11,6,11,37,40,-3,39
Brisbane,1705,6,10,5,13,33,42,-9,35
Western Sydn,1705,7,8,9,10,38,47,-9,33
Perth Glory,1705,8,10,2,15,37,50,-13,32
Wellington P,1705,9,5,6,16,31,55,-24,21
CC Mariners,1705,10,4,8,15,28,49,-21,20
Sydney FC,1706,1,21,4,3,68,22,46,67
N'castle Jet,1706,2,15,5,8,58,39,19,50
Melbourne C,1706,3,15,4,10,45,34,11,49
Melbourne V,1706,4,13,5,11,45,42,3,44
Adelaide Utd,1706,5,11,6,11,37,40,-3,39
Brisbane,1706,6,10,5,13,33,42,-9,35
Western Sydn,1706,7,8,9,10,38,47,-9,33
Perth Glory,1706,8,10,2,15,37,50,-13,32
Wellington P,1706,9,5,6,16,31,55,-24,21
CC Mariners,1706,10,4,8,15,28,49,-21,20
Sydney FC,1707,1,21,4,3,66,22,44,67
N'castle Jet,1707,2,16,5,7,60,37,23,53
Melbourne C,1707,3,14,4,11,43,36,7,46
Melbourne V,1707,4,13,5,11,45,40,5,44
Adelaide Utd,1707,5,11,6,11,37,40,-3,39
Brisbane,1707,6,10,5,13,33,42,-9,35
Western Sydn,1707,7,8,9,10,38,47,-9,33
Perth Glory,1707,8,10,2,15,37,50,-13,32
Wellington P,1707,9,5,6,16,31,55,-24,21
CC Mariners,1707,10,4,8,15,28,49,-21,20
Sydney FC,1708,1,21,4,3,65,22,43,67
N'castle Jet,1708,2,15,6,7,60,40,20,51
Melbourne C,1708,3,14,5,10,46,36,10,47
Melbourne V,1708,4,13,5,11,45,39,6,44
Adelaide Utd,1708,5,11,6,11,37,40,-3,39
Brisbane,1708,6,10,5,13,33,42,-9,35
Western Sydn,1708,7,8,9,10,38,47,-9,33
Perth Glory,1708,8,10,2,15,37,50,-13,32
Wellington P,1708,9,5,6,16,31,55,-24,21
CC Mariners,1708,10,4,8,15,28,49,-21,20
Sydney FC,1709,1,21,4,3,66,23,43,67
N'castle Jet,1709,2,16,5,7,64,40,24,53
Melbourne C,1709,3,14,4,11,46,40,6,46
Melbourne V,1709,4,13,5,11,46,40,6,44
Adelaide Utd,1709,5,11,6,11,37,40,-3,39
Brisbane,1709,6,10,5,13,33,42,-9,35
Western Sydn,1709,7,8,9,10,38,47,-9,33
Perth Glory,1709,8,10,2,15,37,50,-13,32
Wellington P,1709,9,5,6,16,31,55,-24,21
CC Mariners,1709,10,4,8,15,28,49,-21,20
Sydney FC,1710,1,21,4,3,67,22,45,67
N'castle Jet,1710,2,15,6,7,58,38,20,51
Melbourne C,1710,3,14,5,10,44,34,10,47
Melbourne V,1710,4,13,5,11,45,41,4,44
Adelaide Utd,1710,5,11,6,11,37,40,-3,39
Brisbane,1710,6,10,5,13,33,42,-9,35
Western Sydn,1710,7,8,9,10,38,47,-9,33
Perth Glory,1710,8,10,2,15,37,50,-13,32
Wellington P,1710,9,5,6,16,31,55,-24,21
CC Mariners,1710,10,4,8,15,28,49,-21,20
Sydney FC,1711,1,21,4,3,67,24,43,67
N'castle Jet,1711,2,16,5,7,62,38,24,53
Melbourne C,1711,3,14,4,11,44,38,6,46
Melbourne V,1711,4,13,5,11,47,41,6,44
Adelaide Utd,1711,5,11,6,11,37,40,-3,39
Brisbane,1711,6,10,5,13,33,42,-9,35
Western Sydn,1711,7,8,9,10,38,47,-9,33
Perth Glory,1711,8,10,2,15,37,50,-13,32
Wellington P,1711,9,5,6,16,31,55,-24,21
CC Mariners,1711,10,4,8,15,28,49,-21,20
Sydney FC,1712,1,20,4,4,65,24,41,64
N'castle Jet,1712,2,16,5,7,61,38,23,53
Melbourne V,1712,3,14,5,10,47,39,8,47
Melbourne C,1712,4,14,4,11,44,37,7,46
Adelaide Utd,1712,5,11,6,11,37,40,-3,39
Brisbane,1712,6,10,5,13,33,42,-9,35
Western Sydn,1712,7,8,9,10,38,47,-9,33
Perth Glory,1712,8,10,2,15,37,50,-13,32
Wellington P,1712,9,5,6,16,31,55,-24,21
CC Mariners,1712,10,4,8,15,28,49,-21,20
Sydney FC,1713,1,21,4,3,69,22,47,67
N'castle Jet,1713,2,15,5,8,57,38,19,50
Melbourne C,1713,3,15,4,10,44,33,11,49
Melbourne V,1713,4,13,5,11,45,43,2,44
Adelaide Utd,1713,5,11,6,11,37,40,-3,39
Brisbane,1713,6,10,5,13,33,42,-9,35
Western Sydn,1713,7,8,9,10,38,47,-9,33
Perth Glory,1713,8,10,2,15,37,50,-13,32
Wellington P,1713,9,5,6,16,31,55,-24,21
CC Mariners,1713,10,4,8,15,28,49,-21,20
Sydney FC,1714,1,21,4,3,66,22,44,67
N'castle Jet,1714,2,16,5,7,60,37,23,53
Melbourne C,1714,3,14,4,11,43,36,7,46
Melbourne V,1714,4,13,5,11,45,40,5,44
Adelaide Utd,1714,5,11,6,11,37,40,-3,39
Brisbane,1714,6,10,5,13,33,42,-9,35
Western Sydn,1714,7,8,9,10,38,47,-9,33
Perth Glory,1714,8,10,2,15,37,50,-13,32
Wellington P,1714,9,5,6,16,31,55,-24,21
CC Mariners,1714,10,4,8,15,28,49,-21,20
Sydney FC,1715,1,21,4,3,66,23,43,67
N'castle Jet,1715,2,16,5,7,60,39,21,53
Melbourne C,1715,3,14,4,11,45,36,9,46
Melbourne V,1715,4,13,5,11,46,40,6,44
Adelaide Utd,1715,5,11,6,11,37,40,-3,39
Brisbane,1715,6,10,5,13,33,42,-9,35
Western Sydn,1715,7,8,9,10,38,47,-9,33
Perth Glory,1715,8,10,2,15,37,50,-13,32
Wellington P,1715,9,5,6,16,31,55,-24,21
CC Mariners,1715,10,4,8,15,28,49,-21,20
Sydney FC,1716,1,21,4,3,68,24,44,67
N'castle Jet,1716,2,15,6,7,57,37,20,51
Melbourne C,1716,3,14,5,10,43,33,10,47
Melbourne V,1716,4,13,5,11,47,42,5,44
Adelaide Utd,1716,5,11,6,11,37,40,-3,39
Brisbane,1716,6,10,5,13,33,42,-9,35
Western Sydn,1716,7,8,9,10,38,47,-9,33
Perth Glory,1716,8,10,2,15,37,50,-13,32
Wellington P,1716,9,5,6,16,31,55,-24,21
CC Mariners,1716,10,4,8,15,28,49,-21,20
Sydney FC,1717,1,21,4,3,66,23,43,67
N'castle Jet,1717,2,15,6,7,57,37,20,51
Melbourne C,1717,3,14,5,10,43,33,10,47
Melbourne V,1717,4,13,5,11,46,40,6,44
Adelaide Utd,1717,5,11,6,11,37,40,-3,39
Brisbane,1717,6,10,5,13,33,42,-9,35
Western Sydn,1717,7,8,9,10,38,47,-9,33
Perth Glory,1717,8,10,2,15,37,50,-13,32
Wellington P,1717,9,5,6,16,31,55,-24,21
CC Mariners,1717,10,4,8,15,28,49,-21,20
Sydney FC,1718,1,21,4,3,68,22,46,67
N'castle Jet,1718,2,15,6,7,60,40,20,51
Melbourne C,1718,3,14,5,10,46,36,10,47
Melbourne V,1718,4,13,5,11,45,42,3,44
Adelaide Utd,1718,5,11,6,11,37,40,-3,39
Brisbane,1718,6,10,5,13,33,42,-9,35
Western Sydn,1718,7,8,9,10,38,47,-9,33
Perth Glory,1718,8,10,2,15,37,50,-13,32
Wellington P,1718,9,5,6,16,31,55,-24,21
CC Mariners,1718,10,4,8,15,28,49,-21,20
Sydney FC,1719,1,21,4,3,68,24,44,67
N'castle Jet,1719,2,15,6,7,58,38,20,51
Melbourne C,1719,3,14,5,10,44,34,10,47
Melbourne V,1719,4,13,5,11,47,42,5,44
Adelaide Utd,1719,5,11,6,11,37,40,-3,39
Brisbane,1719,6,10,5,13,33,42,-9,35
Western Sydn,1719,7,8,9,10,38,47,-9,33
Perth Glory,1719,8,10,2,15,37,50,-13,32
Wellington P,1719,9,5,6,16,31,55,-24,21
CC Mariners,1719,10,4,8,15,28,49,-21,20
Sydney FC,1720,1,21,4,3,67,22,45,67
N'castle Jet,1720,2,16,5,7,59,38,21,53
Melbourne C,1720,3,14,4,11,44,35,9,46
Melbourne V,1720,4,13,5,11,45,41,4,44
Adelaide Utd,1720,5,11,6,11,37,40,-3,39
Brisbane,1720,6,10,5,13,33,42,-9,35
Western Sydn,1720,7,8,9,10,38,47,-9,33
Perth Glory,1720,8,10,2,15,37,50,-13,32
Wellington P,1720,9,5,6,16,31,55,-24,21
CC Mariners,1720,10,4,8,15,28,49,-21,20
Sydney FC,1721,1,20,5,3,65,23,42,65
N'castle Jet,1721,2,15,6,7,60,40,20,51
Melbourne C,1721,3,14,5,10,46,36,10,47
Melbourne V,1721,4,13,6,10,46,39,7,45
Adelaide Utd,1721,5,11,6,11,37,40,-3,39
Brisbane,1721,6,10,5,13,33,42,-9,35
Western Sydn,1721,7,8,9,10,38,47,-9,33
Perth Glory,1721,8,10,2,15,37,50,-13,32
Wellington P,1721,9,5,6,16,31,55,-24,21
CC Mariners,1721,10,4,8,15,28,49,-21,20
Sydney FC,1722,1,21,4,3,66,22,44,67
N'castle Jet,1722,2,15,6,7,59,39,20,51
Melbourne C,1722,3,14,5,10,45,35,10,47
Melbourne V,1722,4,13,5,11,45,40,5,44
Adelaide Utd,1722,5,11,6,11,37,40,-3,39
Brisbane,1722,6,10,5,13,33,42,-9,35
Western Sydn,1722,7,8,9,10,38,47,-9,33
Perth Glory,1722,8,10,2,15,37,50,-13,32
Wellington P,1722,9,5,6,16,31,55,-24,21
CC Mariners,1722,10,4,8,15,28,49,-21,20
Sydney FC,1723,1,21,4,3,66,22,44,67
N'castle Jet,1723,2,15,5,8,59,42,17,50
Melbourne C,1723,3,15,4,10,48,35,13,49
Melbourne V,1723,4,13,5,11,45,40,5,44
Adelaide Utd,1723,5,11,6,11,37,40,-3,39
Brisbane,1723,6,10,5,13,33,42,-9,35
Western Sydn,1723,7,8,9,10,38,47,-9,33
Perth Glory,1723,8,10,2,15,37,50,-13,32
Wellington P,1723,9,5,6,16,31,55,-24,21
CC Mariners,1723,10,4,8,15,28,49,-21,20
Sydney FC,1724,1,21,4,3,68,23,45,67
N'castle Jet,1724,2,15,6,7,57,37,20,51
Melbourne C,1724,3,14,5,10,43,33,10,47
Melbourne V,1724,4,13,5,11,46,42,4,44
Adelaide Utd,1724,5,11,6,11,37,40,-3,39
Brisbane,1724,6,10,5,13,33,42,-9,35
Western Sydn,1724,7,8,9,10,38,47,-9,33
Perth Glory,1724,8,10,2,15,37,50,-13,32
Wellington P,1724,9,5,6,16,31,55,-24,21
CC Mariners,1724,10,4,8,15,28,49,-21,20
Sydney FC,1725,1,21,4,3,65,22,43,67
N'castle Jet,1725,2,15,6,7,61,41,20,51
Melbourne C,1725,3,14,5,10,47,37,10,47
Melbourne V,1725,4,13,5,11,45,39,6,44
Adelaide Utd,1725,5,11,6,11,37,40,-3,39
Brisbane,1725,6,10,5,13,33,42,-9,35
Western Sydn,1725,7,8,9,10,38,47,-9,33
Perth Glory,1725,8,10,2,15,37,50,-13,32
Wellington P,1725,9,5,6,16,31,55,-24,21
CC Mariners,1725,10,4,8,15,28,49,-21,20
Sydney FC,1726,1,21,4,3,65,22,43,67
N'castle Jet,1726,2,15,5,8,58,40,18,50
Melbourne C,1726,3,15,4,10,46,34,12,49
Melbourne V,1726,4,13,5,11,45,39,6,44
Adelaide Utd,1726,5,11,6,11,37,40,-3,39
Brisbane,1726,6,10,5,13,33,42,-9,35
Western Sydn,1726,7,8,9,10,38,47,-9,33
Perth Glory,1726,8,10,2,15,37,50,-13,32
Wellington P,1726,9,5,6,16,31,55,-24,21
CC Mariners,1726,10,4,8,15,28,49,-21,20
Sydney FC,1727,1,21,4,3,65,22,43,67
N'castle Jet,1727,2,16,5,7,68,37,31,53
Melbourne C,1727,3,14,4,11,43,44,-1,46
Melbourne V,1727,4,13,5,11,45,39,6,44
Adelaide Utd,1727,5,11,6,11,37,40,-3,39
Brisbane,1727,6,10,5,13,33,42,-9,35
Western Sydn,1727,7,8,9,10,38,47,-9,33
Perth Glory,1727,8,10,2,15,37,50,-13,32
Wellington P,1727,9,5,6,16,31,55,-24,21
CC Mariners,1727,10,4,8,15,28,49,-21,20
Sydney FC,1728,1,21,4,3,66,23,43,67
N'castle Jet,1728,2,15,5,8,59,40,19,50
Melbourne C,1728,3,15,4,10,46,35,11,49
Melbourne V,1728,4,13,5,11,46,40,6,44
Adelaide Utd,1728,5,11,6,11,37,40,-3,39
Brisbane,1728,6,10,5,13,33,42,-9,35
Western Sydn,1728,7,8,9,10,38,47,-9,33
Perth Glory,1728,8,10,2,15,37,50,-13,32
Wellington P,1728,9,5,6,16,31,55,-24,21
CC Mariners,1728,10,4,8,15,28,49,-21,20
Sydney FC,1729,1,21,4,3,68,22,46,67
N'castle Jet,1729,2,15,6,7,57,37,20,51
Melbourne C,1729,3,14,5,10,43,33,10,47
Melbourne V,1729,4,13,5,11,45,42,3,44
Adelaide Utd,1729,5,11,6,11,37,40,-3,39
Brisbane,1729,6,10,5,13,33,42,-9,35
Western Sydn,1729,7,8,9,10,38,47,-9,33
Perth Glory,1729,8,10,2,15,37,50,-13,32
Wellington P,1729,9,5,6,16,31,55,-24,21
CC Mariners,1729,10,4,8,15,28,49,-21,20
Sydney FC,1730,1,20,5,3,64,22,42,65
N'castle Jet,1730,2,16,5,7,59,38,21,53
Melbourne C,1730,3,14,4,11,44,35,9,46
Melbourne V,1730,4,13,6,10,45,38,7,45
Adelaide Utd,1730,5,11,6,11,37,40,-3,39
Brisbane,1730,6,10,5,13,33,42,-9,35
Western Sydn,1730,7,8,9,10,38,47,-9,33
Perth Glory,1730,8,10,2,15,37,50,-13,32
Wellington P,1730,9,5,6,16,31,55,-24,21
CC Mariners,1730,10,4,8,15,28,49,-21,20
Sydney FC,1731,1,20,4,4,64,24,40,64
N'castle Jet,1731,2,16,5,7,58,37,21,53
Melbourne V,1731,3,14,5,10,47,38,9,47
Melbourne C,1731,4,14,4,11,43,34,9,46
Adelaide Utd,1731,5,11,6,11,37,40,-3,39
Brisbane,1731,6,10,5,13,33,42,-9,35
Western Sydn,1731,7,8,9,10,38,47,-9,33
Perth Glory,1731,8,10,2,15,37,50,-13,32
Wellington P,1731,9,5,6,16,31,55,-24,21
CC Mariners,1731,10,4,8,15,28,49,-21,20
Sydney FC,1732,1,20,5,3,65,23,42,65
N'castle Jet,1732,2,15,6,7,60,40,20,51
Melbourne C,1732,3,14,5,10,46,36,10,47
Melbourne V,1732,4,13,6,10,46,39,7,45
Adelaide Utd,1732,5,11,6,11,37,40,-3,39
Brisbane,1732,6,10,5,13,33,42,-9,35
Western Sydn,1732,7,8,9,10,38,47,-9,33
Perth Glory,1732,8,10,2,15,37,50,-13,32
Wellington P,1732,9,5,6,16,31,55,-24,21
CC Mariners,1732,10,4,8,15,28,49,-21,20
Sydney FC,1733,1,21,4,3,66,23,43,67
N'castle Jet,1733,2,15,5,8,57,39,18,50
Melbourne C,1733,3,15,4,10,45,33,12,49
Melbourne V,1733,4,13,5,11,46,40,6,44
Adelaide Utd,1733,5,11,6,11,37,40,-3,39
Brisbane,1733,6,10,5,13,33,42,-9,35
Western Sydn,1733,7,8,9,10,38,47,-9,33
Perth Glory,1733,8,10,2,15,37,50,-13,32
Wellington P,1733,9,5,6,16,31,55,-24,21
CC Mariners,1733,10,4,8,15,28,49,-21,20
Sydney FC,1734,1,20,4,4,64,23,41,64
N'castle Jet,1734,2,15,6,7,58,38,20,51
Melbourne C,1734,3,14,5,10,44,34,10,47
Melbourne V,1734,4,14,5,10,46,38,8,47
Adelaide Utd,1734,5,11,6,11,37,40,-3,39
Brisbane,1734,6,10,5,13,33,42,-9,35
Western Sydn,1734,7,8,9,10,38,47,-9,33
Perth Glory,1734,8,10,2,15,37,50,-13,32
Wellington P,1734,9,5,6,16,31,55,-24,21
CC Mariners,1734,10,4,8,15,28,49,-21,20
Sydney FC,1735,1,21,4,3,67,22,45,67
N'castle Jet,1735,2,16,5,7,59,37,22,53
Melbourne C,1735,3,14,4,11,43,35,8,46
Melbourne V,1735,4,13,5,11,45,41,4,44
Adelaide Utd,1735,5,11,6,11,37,40,-3,39
Brisbane,1735,6,10,5,13,33,42,-9,35
Western Sydn,1735,7,8,9,10,38,47,-9,33
Perth Glory,1735,8,10,2,15,37,50,-13,32
Wellington P,1735,9,5,6,16,31,55,-24,21
CC Mariners,1735,10,4,8,15,28,49,-21,20
Sydney FC,1736,1,21,4,3,66,23,43,67
N'castle Jet,1736,2,15,6,7,58,38,20,51
Melbourne C,1736,3,14,5,10,44,34,10,47
Melbourne V,1736,4,13,5,11,46,40,6,44
Adelaide Utd,1736,5,11,6,11,37,40,-3,39
Brisbane,1736,6,10,5,13,33,42,-9,35
Western Sydn,1736,7,8,9,10,38,47,-9,33
Perth Glory,1736,8,10,2,15,37,50,-13,32
Wellington P,1736,9,5,6,16,31,55,-24,21
CC Mariners,1736,10,4,8,15,28,49,-21,20
Sydney FC,1737,1,21,4,3,68,22,46,67
N'castle Jet,1737,2,15,5,8,58,39,19,50
Melbourne C,1737,3,15,4,10,45,34,11,49
Melbourne V,1737,4,13,5,11,45,42,3,44
Adelaide Utd,1737,5,11,6,11,37,40,-3,39
Brisbane,1737,6,10,5,13,33,42,-9,35
Western Sydn,1737,7,8,9,10,38,47,-9,33
Perth Glory,1737,8,10,2,15,37,50,-13,32
Wellington P,1737,9,5,6,16,31,55,-24,21
CC Mariners,1737,10,4,8,15,28,49,-21,20
Sydney FC,1738,1,20,4,4,65,24,41,64
N'castle Jet,1738,2,15,6,7,57,37,20,51
Melbourne C,1738,3,14,5,10,43,33,10,47
Melbourne V,1738,4,14,5,10,47,39,8,47
Adelaide Utd,1738,5,11,6,11,37,40,-3,39
Brisbane,1738,6,10,5,13,33,42,-9,35
Western Sydn,1738,7,8,9,10,38,47,-9,33
Perth Glory,1738,8,10,2,15,37,50,-13,32
Wellington P,1738,9,5,6,16,31,55,-24,21
CC Mariners,1738,10,4,8,15,28,49,-21,20
Sydney FC,1739,1,21,4,3,71,23,48,67
N'castle Jet,1739,2,16,5,7,60,38,22,53
Melbourne C,1739,3,14,4,11,44,36,8,46
Melbourne V,1739,4,13,5,11,46,45,1,44
Adelaide Utd,1739,5,11,6,11,37,40,-3,39
Brisbane,1739,6,10,5,13,33,42,-9,35
Western Sydn,1739,7,8,9,10,38,47,-9,33
Perth Glory,1739,8,10,2,15,37,50,-13,32
Wellington P,1739,9,5,6,16,31,55,-24,21
CC Mariners,1739,10,4,8,15,28,49,-21,20
Sydney FC,1740,1,21,4,3,65,22,43,67
N'castle Jet,1740,2,16,5,7,59,38,21,53
Melbourne C,1740,3,14,4,11,44,35,9,46
Melbourne V,1740,4,13,5,11,45,39,6,44
Adelaide Utd,1740,5,11,6,11,37,40,-3,39
Brisbane,1740,6,10,5,13,33,42,-9,35
Western Sydn,1740,7,8,9,10,38,47,-9,33
Perth Glory,1740,8,10,2,15,37,50,-13,32
Wellington P,1740,9,5,6,16,31,55,-24,21
CC Mariners,1740,10,4,8,15,28,49,-21,20
Sydney FC,1741,1,21,4,3,65,22,43,67
N'castle Jet,1741,2,15,6,7,58,38,20,51
Melbourne C,1741,3,14,5,10,44,34,10,47
Melbourne V,1741,4,13,5,11,45,39,6,44
Adelaide Utd,1741,5,11,6,11,37,40,-3,39
Brisbane,1741,6,10,5,13,33,42,-9,35
Western Sydn,1741,7,8,9,10,38,47,-9,33
Perth Glory,1741,8,10,2,15,37,50,-13,32
Wellington P,1741,9,5,6,16,31,55,-24,21
CC Mariners,1741,10,4,8,15,28,49,-21,20
Sydney FC,1742,1,21,4,3,67,23,44,67
N'castle Jet,1742,2,15,6,7,59,39,20,51
Melbourne C,1742,3,14,5,10,45,35,10,47
Melbourne V,1742,4,13,5,11,46,41,5,44
Adelaide Utd,1742,5,11,6,11,37,40,-3,39
Brisbane,1742,6,10,5,13,33,42,-9,35
Western Sydn,1742,7,8,9,10,38,47,-9,33
Perth Glory,1742,8,10,2,15,37,50,-13,32
Wellington P,1742,9,5,6,16,31,55,-24,21
CC Mariners,1742,10,4,8,15,28,49,-21,20
Sydney FC,1743,1,21,4,3,68,22,46,67
N'castle Jet,1743,2,15,5,8,58,39,19,50
Melbourne C,1743,3,15,4,10,45,34,11,49
Melbourne V,1743,4,13,5,11,45,42,3,44
Adelaide Utd,1743,5,11,6,11,37,40,-3,39
Brisbane,1743,6,10,5,13,33,42,-9,35
Western Sydn,1743,7,8,9,10,38,47,-9,33
Perth Glory,1743,8,10,2,15,37,50,-13,32
Wellington P,1743,9,5,6,16,31,55,-24,21
CC Mariners,1743,10,4,8,15,28,49,-21,20
Sydney FC,1744,1,21,4,3,65,22,43,67
N'castle Jet,1744,2,16,5,7,60,39,21,53
Melbourne C,1744,3,14,4,11,45,36,9,46
Melbourne V,1744,4,13,5,11,45,39,6,44
Adelaide Utd,1744,5,11,6,11,37,40,-3,39
Brisbane,1744,6,10,5,13,33,42,-9,35
Western Sydn,1744,7,8,9,10,38,47,-9,33
Perth Glory,1744,8,10,2,15,37,50,-13,32
Wellington P,1744,9,5,6,16,31,55,-24,21
CC Mariners,1744,10,4,8,15,28,49,-21,20
Sydney FC,1745,1,21,4,3,66,23,43,67
N'castle Jet,1745,2,15,6,7,59,39,20,51
Melbourne C,1745,3,14,5,10,45,35,10,47
Melbourne V,1745,4,13,5,11,46,40,6,44
Adelaide Utd,1745,5,11,6,11,37,40,-3,39
Brisbane,1745,6,10,5,13,33,42,-9,35
Western Sydn,1745,7,8,9,10,38,47,-9,33
Perth Glory,1745,8,10,2,15,37,50,-13,32
Wellington P,1745,9,5,6,16,31,55,-24,21
CC Mariners,1745,10,4,8,15,28,49,-21,20
Sydney FC,1746,1,21,4,3,68,22,46,67
N'castle Jet,1746,2,15,5,8,59,40,19,50
Melbourne C,1746,3,15,4,10,46,35,11,49
Melbourne V,1746,4,13,5,11,45,42,3,44
Adelaide Utd,1746,5,11,6,11,37,40,-3,39
Brisbane,1746,6,10,5,13,33,42,-9,35
Western Sydn,1746,7,8,9,10,38,47,-9,33
Perth Glory,1746,8,10,2,15,37,50,-13,32
Wellington P,1746,9,5,6,16,31,55,-24,21
CC Mariners,1746,10,4,8,15,28,49,-21,20
Sydney FC,1747,1,20,5,3,66,24,42,65
N'castle Jet,1747,2,16,5,7,59,38,21,53
Melbourne C,1747,3,14,4,11,44,35,9,46
Melbourne V,1747,4,13,6,10,47,40,7,45
Adelaide Utd,1747,5,11,6,11,37,40,-3,39
Brisbane,1747,6,10,5,13,33,42,-9,35
Western Sydn,1747,7,8,9,10,38,47,-9,33
Perth Glory,1747,8,10,2,15,37,50,-13,32
Wellington P,1747,9,5,6,16,31,55,-24,21
CC Mariners,1747,10,4,8,15,28,49,-21,20
Sydney FC,1748,1,21,4,3,67,23,44,67
N'castle Jet,1748,2,15,5,8,58,40,18,50
Melbourne C,1748,3,15,4,10,46,34,12,49
Melbourne V,1748,4,13,5,11,46,41,5,44
Adelaide Utd,1748,5,11,6,11,37,40,-3,39
Brisbane,1748,6,10,5,13,33,42,-9,35
Western Sydn,1748,7,8,9,10,38,47,-9,33
Perth Glory,1748,8,10,2,15,37,50,-13,32
Wellington P,1748,9,5,6,16,31,55,-24,21
CC Mariners,1748,10,4,8,15,28,49,-21,20
Sydney FC,1749,1,21,4,3,68,23,45,67
N'castle Jet,1749,2,16,5,7,59,38,21,53
Melbourne C,1749,3,14,4,11,44,35,9,46
Melbourne V,1749,4,13,5,11,46,42,4,44
Adelaide Utd,1749,5,11,6,11,37,40,-3,39
Brisbane,1749,6,10,5,13,33,42,-9,35
Western Sydn,1749,7,8,9,10,38,47,-9,33
Perth Glory,1749,8,10,2,15,37,50,-13,32
Wellington P,1749,9,5,6,16,31,55,-24,21
CC Mariners,1749,10,4,8,15,28,49,-21,20
Sydney FC,1750,1,21,4,3,65,22,43,67
N'castle Jet,1750,2,16,5,7,60,37,23,53
Melbourne C,1750,3,14,4,11,43,36,7,46
Melbourne V,1750,4,13,5,11,45,39,6,44
Adelaide Utd,1750,5,11,6,11,37,40,-3,39
Brisbane,1750,6,10,5,13,33,42,-9,35
Western Sydn,1750,7,8,9,10,38,47,-9,33
Perth Glory,1750,8,10,2,15,37,50,-13,32
Wellington P,1750,9,5,6,16,31,55,-24,21
CC Mariners,1750,10,4,8,15,28,49,-21,20
Sydney FC,1751,1,21,4,3,69,22,47,67
N'castle Jet,1751,2,16,5,7,59,37,22,53
Melbourne C,1751,3,14,4,11,43,35,8,46
Melbourne V,1751,4,13,5,11,45,43,2,44
Adelaide Utd,1751,5,11,6,11,37,40,-3,39
Brisbane,1751,6,10,5,13,33,42,-9,35
Western Sydn,1751,7,8,9,10,38,47,-9,33
Perth Glory,1751,8,10,2,15,37,50,-13,32
Wellington P,1751,9,5,6,16,31,55,-24,21
CC Mariners,1751,10,4,8,15,28,49,-21,20
Sydney FC,1752,1,20,5,3,65,23,42,65
N'castle Jet,1752,2,16,5,7,61,39,22,53
Melbourne C,1752,3,14,4,11,45,37,8,46
Melbourne V,1752,4,13,6,10,46,39,7,45
Adelaide Utd,1752,5,11,6,11,37,40,-3,39
Brisbane,1752,6,10,5,13,33,42,-9,35
Western Sydn,1752,7,8,9,10,38,47,-9,33
Perth Glory,1752,8,10,2,15,37,50,-13,32
Wellington P,1752,9,5,6,16,31,55,-24,21
CC Mariners,1752,10,4,8,15,28,49,-21,20
Sydney FC,1753,1,20,5,3,64,22,42,65
N'castle Jet,1753,2,15,5,8,57,38,19,50
Melbourne C,1753,3,15,4,10,44,33,11,49
Melbourne V,1753,4,13,6,10,45,38,7,45
Adelaide Utd,1753,5,11,6,11,37,40,-3,39
Brisbane,1753,6,10,5,13,33,42,-9,35
Western Sydn,1753,7,8,9,10,38,47,-9,33
Perth Glory,1753,8,10,2,15,37,50,-13,32
Wellington P,1753,9,5,6,16,31,55,-24,21
CC Mariners,1753,10,4,8,15,28,49,-21,20
Sydney FC,1754,1,21,4,3,67,23,44,67
N'castle Jet,1754,2,16,5,7,62,39,23,53
Melbourne C,1754,3,14,4,11,45,38,7,46
Melbourne V,1754,4,13,5,11,46,41,5,44
Adelaide Utd,1754,5,11,6,11,37,40,-3,39
Brisbane,1754,6,10,5,13,33,42,-9,35
Western Sydn,1754,7,8,9,10,38,47,-9,33
Perth Glory,1754,8,10,2,15,37,50,-13,32
Wellington P,1754,9,5,6,16,31,55,-24,21
CC Mariners,1754,10,4,8,15,28,49,-21,20
Sydney FC,1755,1,21,4,3,66,23,43,67
N'castle Jet,1755,2,15,5,8,60,41,19,50
Melbourne C,1755,3,15,4,10,47,36,11,49
Melbourne V,1755,4,13,5,11,46,40,6,44
Adelaide Utd,1755,5,11,6,11,37,40,-3,39
Brisbane,1755,6,10,5,13,33,42,-9,35
Western Sydn,1755,7,8,9,10,38,47,-9,33
Perth Glory,1755,8,10,2,15,37,50,-13,32
Wellington P,1755,9,5,6,16,31,55,-24,21
CC Mariners,1755,10,4,8,15,28,49,-21,20
Sydney FC,1756,1,21,4,3,67,24,43,67
N'castle Jet,1756,2,15,5,8,60,41,19,50
Melbourne C,1756,3,15,4,10,47,36,11,49
Melbourne V,1756,4,13,5,11,47,41,6,44
Adelaide Utd,1756,5,11,6,11,37,40,-3,39
Brisbane,1756,6,10,5,13,33,42,-9,35
Western Sydn,1756,7,8,9,10,38,47,-9,33
Perth Glory,1756,8,10,2,15,37,50,-13,32
Wellington P,1756,9,5,6,16,31,55,-24,21
CC Mariners,1756,10,4,8,15,28,49,-21,20
Sydney FC,1757,1,20,5,3,66,24,42,65
N'castle Jet,1757,2,15,5,8,58,39,19,50
Melbourne C,1757,3,15,4,10,45,34,11,49
Melbourne V,1757,4,13,6,10,47,40,7,45
Adelaide Utd,1757,5,11,6,11,37,40,-3,39
Brisbane,1757,6,10,5,13,33,42,-9,35
Western Sydn,1757,7,8,9,10,38,47,-9,33
Perth Glory,1757,8,10,2,15,37,50,-13,32
Wellington P,1757,9,5,6,16,31,55,-24,21
CC Mariners,1757,10,4,8,15,28,49,-21,20
Sydney FC,1758,1,20,5,3,66,24,42,65
N'castle Jet,1758,2,15,5,8,60,42,18,50
Melbourne C,1758,3,15,4,10,48,36,12,49
Melbourne V,1758,4,13,6,10,47,40,7,45
Adelaide Utd,1758,5,11,6,11,37,40,-3,39
Brisbane,1758,6,10,5,13,33,42,-9,35
Western Sydn,1758,7,8,9,10,38,47,-9,33
Perth Glory,1758,8,10,2,15,37,50,-13,32
Wellington P,1758,9,5,6,16,31,55,-24,21
CC Mariners,1758,10,4,8,15,28,49,-21,20
Sydney FC,1759,1,20,5,3,64,22,42,65
N'castle Jet,1759,2,15,5,8,58,39,19,50
Melbourne C,1759,3,15,4,10,45,34,11,49
Melbourne V,1759,4,13,6,10,45,38,7,45
Adelaide Utd,1759,5,11,6,11,37,40,-3,39
Brisbane,1759,6,10,5,13,33,42,-9,35
Western Sydn,1759,7,8,9,10,38,47,-9,33
Perth Glory,1759,8,10,2,15,37,50,-13,32
Wellington P,1759,9,5,6,16,31,55,-24,21
CC Mariners,1759,10,4,8,15,28,49,-21,20
Sydney FC,1760,1,20,5,3,65,23,42,65
N'castle Jet,1760,2,16,5,7,60,37,23,53
Melbourne C,1760,3,14,4,11,43,36,7,46
Melbourne V,1760,4,13,6,10,46,39,7,45
Adelaide Utd,1760,5,11,6,11,37,40,-3,39
Brisbane,1760,6,10,5,13,33,42,-9,35
Western Sydn,1760,7,8,9,10,38,47,-9,33
Perth Glory,1760,8,10,2,15,37,50,-13,32
Wellington P,1760,9,5,6,16,31,55,-24,21
CC Mariners,1760,10,4,8,15,28,49,-21,20
Sydney FC,1761,1,20,4,4,64,23,41,64
N'castle Jet,1761,2,15,5,8,58,39,19,50
Melbourne C,1761,3,15,4,10,45,34,11,49
Melbourne V,1761,4,14,5,10,46,38,8,47
Adelaide Utd,1761,5,11,6,11,37,40,-3,39
Brisbane,1761,6,10,5,13,33,42,-9,35
Western Sydn,1761,7,8,9,10,38,47,-9,33
Perth Glory,1761,8,10,2,15,37,50,-13,32
Wellington P,1761,9,5,6,16,31,55,-24,21
CC Mariners,1761,10,4,8,15,28,49,-21,20
Sydney FC,1762,1,21,4,3,65,22,43,67
N'castle Jet,1762,2,16,5,7,60,38,22,53
Melbourne C,1762,3,14,4,11,44,36,8,46
Melbourne V,1762,4,13,5,11,45,39,6,44
Adelaide Utd,1762,5,11,6,11,37,40,-3,39
Brisbane,1762,6,10,5,13,33,42,-9,35
Western Sydn,1762,7,8,9,10,38,47,-9,33
Perth Glory,1762,8,10,2,15,37,50,-13,32
Wellington P,1762,9,5,6,16,31,55,-24,21
CC Mariners,1762,10,4,8,15,28,49,-21,20
Sydney FC,1763,1,20,5,3,67,25,42,65
N'castle Jet,1763,2,16,5,7,58,37,21,53
Melbourne C,1763,3,14,4,11,43,34,9,46
Melbourne V,1763,4,13,6,10,48,41,7,45
Adelaide Utd,1763,5,11,6,11,37,40,-3,39
Brisbane,1763,6,10,5,13,33,42,-9,35
Western Sydn,1763,7,8,9,10,38,47,-9,33
Perth Glory,1763,8,10,2,15,37,50,-13,32
Wellington P,1763,9,5,6,16,31,55,-24,21
CC Mariners,1763,10,4,8,15,28,49,-21,20
Sydney FC,1764,1,21,4,3,65,22,43,67
N'castle Jet,1764,2,16,5,7,58,37,21,53
Melbourne C,1764,3,14,4,11,43,34,9,46
Melbourne V,1764,4,13,5,11,45,39,6,44
Adelaide Utd,1764,5,11,6,11,37,40,-3,39
Brisbane,1764,6,10,5,13,33,42,-9,35
Western Sydn,1764,7,8,9,10,38,47,-9,33
Perth Glory,1764,8,10,2,15,37,50,-13,32
Wellington P,1764,9,5,6,16,31,55,-24,21
CC Mariners,1764,10,4,8,15,28,49,-21,20
Sydney FC,1765,1,21,4,3,68,24,44,67
N'castle Jet,1765,2,16,5,7,60,39,21,53
Melbourne C,1765,3,14,4,11,45,36,9,46
Melbourne V,1765,4,13,5,11,47,42,5,44
Adelaide Utd,1765,5,11,6,11,37,40,-3,39
Brisbane,1765,6,10,5,13,33,42,-9,35
Western Sydn,1765,7,8,9,10,38,47,-9,33
Perth Glory,1765,8,10,2,15,37,50,-13,32
Wellington P,1765,9,5,6,16,31,55,-24,21
CC Mariners,1765,10,4,8,15,28,49,-21,20
Sydney FC,1766,1,20,4,4,65,24,41,64
N'castle Jet,1766,2,16,5,7,60,38,22,53
Melbourne V,1766,3,14,5,10,47,39,8,47
Melbourne C,1766,4,14,4,11,44,36,8,46
Adelaide Utd,1766,5,11,6,11,37,40,-3,39
Brisbane,1766,6,10,5,13,33,42,-9,35
Western Sydn,1766,7,8,9,10,38,47,-9,33
Perth Glory,1766,8,10,2,15,37,50,-13,32
Wellington P,1766,9,5,6,16,31,55,-24,21
CC Mariners,1766,10,4,8,15,28,49,-21,20
Sydney FC,1767,1,20,4,4,65,24,41,64
N'castle Jet,1767,2,15,5,8,57,39,18,50
Melbourne C,1767,3,15,4,10,45,33,12,49
Melbourne V,1767,4,14,5,10,47,39,8,47
Adelaide Utd,1767,5,11,6,11,37,40,-3,39
Brisbane,1767,6,10,5,13,33,42,-9,35
Western Sydn,1767,7,8,9,10,38,47,-9,33
Perth Glory,1767,8,10,2,15,37,50,-13,32
Wellington P,1767,9,5,6,16,31,55,-24,21
CC Mariners,1767,10,4,8,15,28,49,-21,20
Sydney FC,1768,1,21,4,3,66,22,44,67
N'castle Jet,1768,2,16,5,7,59,37,22,53
Melbourne C,1768,3,14,4,11,43,35,8,46
Melbourne V,1768,4,13,5,11,45,40,5,44
Adelaide Utd,1768,5,11,6,11,37,40,-3,39
Brisbane,1768,6,10,5,13,33,42,-9,35
Western Sydn,1768,7,8,9,10,38,47,-9,33
Perth Glory,1768,8,10,2,15,37,50,-13,32
Wellington P,1768,9,5,6,16,31,55,-24,21
CC Mariners,1768,10,4,8,15,28,49,-21,20
Sydney FC,1769,1,21,4,3,67,24,43,67
N'castle Jet,1769,2,16,5,7,58,37,21,53
Melbourne C,1769,3,14,4,11,43,34,9,46
Melbourne V,1769,4,13,5,11,47,41,6,44
Adelaide Utd,1769,5,11,6,11,37,40,-3,39
Brisbane,1769,6,10,5,13,33,42,-9,35
Western Sydn,1769,7,8,9,10,38,47,-9,33
Perth Glory,1769,8,10,2,15,37,50,-13,32
Wellington P,1769,9,5,6,16,31,55,-24,21
CC Mariners,1769,10,4,8,15,28,49,-21,20
Sydney FC,1770,1,21,4,3,68,25,43,67
N'castle Jet,1770,2,16,5,7,58,37,21,53
Melbourne C,1770,3,14,4,11,43,34,9,46
Melbourne V,1770,4,13,5,11,48,42,6,44
Adelaide Utd,1770,5,11,6,11,37,40,-3,39
Brisbane,1770,6,10,5,13,33,42,-9,35
Western Sydn,1770,7,8,9,10,38,47,-9,33
Perth Glory,1770,8,10,2,15,37,50,-13,32
Wellington P,1770,9,5,6,16,31,55,-24,21
CC Mariners,1770,10,4,8,15,28,49,-21,20
Sydney FC,1771,1,20,4,4,64,23,41,64
N'castle Jet,1771,2,16,5,7,58,37,21,53
Melbourne V,1771,3,14,5,10,46,38,8,47
Melbourne C,1771,4,14,4,11,43,34,9,46
Adelaide Utd,1771,5,11,6,11,37,40,-3,39
Brisbane,1771,6,10,5,13,33,42,-9,35
Western Sydn,1771,7,8,9,10,38,47,-9,33
Perth Glory,1771,8,10,2,15,37,50,-13,32
Wellington P,1771,9,5,6,16,31,55,-24,21
CC Mariners,1771,10,4,8,15,28,49,-21,20
Sydney FC,1772,1,21,4,3,68,23,45,67
N'castle Jet,1772,2,16,5,7,60,38,22,53
Melbourne C,1772,3,14,4,11,44,36,8,46
Melbourne V,1772,4,13,5,11,46,42,4,44
Adelaide Utd,1772,5,11,6,11,37,40,-3,39
Brisbane,1772,6,10,5,13,33,42,-9,35
Western Sydn,1772,7,8,9,10,38,47,-9,33
Perth Glory,1772,8,10,2,15,37,50,-13,32
Wellington P,1772,9,5,6,16,31,55,-24,21
CC Mariners,1772,10,4,8,15,28,49,-21,20
Sydney FC,1773,1,20,5,3,64,22,42,65
N'castle Jet,1773,2,16,5,7,59,37,22,53
Melbourne C,1773,3,14,4,11,43,35,8,46
Melbourne V,1773,4,13,6,10,45,38,7,45
Adelaide Utd,1773,5,11,6,11,37,40,-3,39
Brisbane,1773,6,10,5,13,33,42,-9,35
Western Sydn,1773,7,8,9,10,38,47,-9,33
Perth Glory,1773,8,10,2,15,37,50,-13,32
Wellington P,1773,9,5,6,16,31,55,-24,21
CC Mariners,1773,10,4,8,15,28,49,-21,20
Sydney FC,1774,1,21,4,3,65,22,43,67
N'castle Jet,1774,2,15,5,8,58,39,19,50
Melbourne C,1774,3,15,4,10,45,34,11,49
Melbourne V,1774,4,13,5,11,45,39,6,44
Adelaide Utd,1774,5,11,6,11,37,40,-3,39
Brisbane,1774,6,10,5,13,33,42,-9,35
Western Sydn,1774,7,8,9,10,38,47,-9,33
Perth Glory,1774,8,10,2,15,37,50,-13,32
Wellington P,1774,9,5,6,16,31,55,-24,21
CC Mariners,1774,10,4,8,15,28,49,-21,20
Sydney FC,1775,1,21,4,3,66,22,44,67
N'castle Jet,1775,2,16,5,7,60,38,22,53
Melbourne C,1775,3,14,4,11,44,36,8,46
Melbourne V,1775,4,13,5,11,45,40,5,44
Adelaide Utd,1775,5,11,6,11,37,40,-3,39
Brisbane,1775,6,10,5,13,33,42,-9,35
Western Sydn,1775,7,8,9,10,38,47,-9,33
Perth Glory,1775,8,10,2,15,37,50,-13,32
Wellington P,1775,9,5,6,16,31,55,-24,21
CC Mariners,1775,10,4,8,15,28,49,-21,20
Sydney FC,1776,1,21,4,3,68,24,44,67
N'castle Jet,1776,2,16,5,7,58,37,21,53
Melbourne C,1776,3,14,4,11,43,34,9,46
Melbourne V,1776,4,13,5,11,47,42,5,44
Adelaide Utd,1776,5,11,6,11,37,40,-3,39
Brisbane,1776,6,10,5,13,33,42,-9,35
Western Sydn,1776,7,8,9,10,38,47,-9,33
Perth Glory,1776,8,10,2,15,37,50,-13,32
Wellington P,1776,9,5,6,16,31,55,-24,21
CC Mariners,1776,10,4,8,15,28,49,-21,20
Sydney FC,1777,1,20,4,4,66,25,41,64
N'castle Jet,1777,2,15,5,8,58,39,19,50
Melbourne C,1777,3,15,4,10,45,34,11,49
Melbourne V,1777,4,14,5,10,48,40,8,47
Adelaide Utd,1777,5,11,6,11,37,40,-3,39
Brisbane,1777,6,10,5,13,33,42,-9,35
Western Sydn,1777,7,8,9,10,38,47,-9,33
Perth Glory,1777,8,10,2,15,37,50,-13,32
Wellington P,1777,9,5,6,16,31,55,-24,21
CC Mariners,1777,10,4,8,15,28,49,-21,20
Sydney FC,1778,1,21,4,3,68,23,45,67
N'castle Jet,1778,2,15,5,8,57,39,18,50
Melbourne C,1778,3,15,4,10,45,33,12,49
Melbourne V,1778,4,13,5,11,46,42,4,44
Adelaide Utd,1778,5,11,6,11,37,40,-3,39
Brisbane,1778,6,10,5,13,33,42,-9,35
Western Sydn,1778,7,8,9,10,38,47,-9,33
Perth Glory,1778,8,10,2,15,37,50,-13,32
Wellington P,1778,9,5,6,16,31,55,-24,21
CC Mariners,1778,10,4,8,15,28,49,-21,20
Sydney FC,1779,1,21,4,3,66,23,43,67
N'castle Jet,1779,2,16,5,7,61,37,24,53
Melbourne C,1779,3,14,4,11,43,37,6,46
Melbourne V,1779,4,13,5,11,46,40,6,44
Adelaide Utd,1779,5,11,6,11,37,40,-3,39
Brisbane,1779,6,10,5,13,33,42,-9,35
Western Sydn,1779,7,8,9,10,38,47,-9,33
Perth Glory,1779,8,10,2,15,37,50,-13,32
Wellington P,1779,9,5,6,16,31,55,-24,21
CC Mariners,1779,10,4,8,15,28,49,-21,20
Sydney FC,1780,1,21,4,3,68,22,46,67
N'castle Jet,1780,2,15,5,8,57,38,19,50
Melbourne C,1780,3,15,4,10,44,33,11,49
Melbourne V,1780,4,13,5,11,45,42,3,44
Adelaide Utd,1780,5,11,6,11,37,40,-3,39
Brisbane,1780,6,10,5,13,33,42,-9,35
Western Sydn,1780,7,8,9,10,38,47,-9,33
Perth Glory,1780,8,10,2,15,37,50,-13,32
Wellington P,1780,9,5,6,16,31,55,-24,21
CC Mariners,1780,10,4,8,15,28,49,-21,20
Sydney FC,1781,1,20,4,4,64,24,40,64
N'castle Jet,1781,2,16,5,7,60,39,21,53
Melbourne V,1781,3,14,5,10,47,38,9,47
Melbourne C,1781,4,14,4,11,45,36,9,46
Adelaide Utd,1781,5,11,6,11,37,40,-3,39
Brisbane,1781,6,10,5,13,33,42,-9,35
Western Sydn,1781,7,8,9,10,38,47,-9,33
Perth Glory,1781,8,10,2,15,37,50,-13,32
Wellington P,1781,9,5,6,16,31,55,-24,21
CC Mariners,1781,10,4,8,15,28,49,-21,20
Sydney FC,1782,1,20,5,3,66,24,42,65
N'castle Jet,1782,2,15,6,7,58,38,20,51
Melbourne C,1782,3,14,5,10,44,34,10,47
Melbourne V,1782,4,13,6,10,47,40,7,45
Adelaide Utd,1782,5,11,6,11,37,40,-3,39
Brisbane,1782,6,10,5,13,33,42,-9,35
Western Sydn,1782,7,8,9,10,38,47,-9,33
Perth Glory,1782,8,10,2,15,37,50,-13,32
Wellington P,1782,9,5,6,16,31,55,-24,21
CC Mariners,1782,10,4,8,15,28,49,-21,20
Sydney FC,1783,1,20,5,3,64,22,42,65
N'castle Jet,1783,2,15,6,7,58,38,20,51
Melbourne C,1783,3,14,5,10,44,34,10,47
Melbourne V,1783,4,13,6,10,45,38,7,45
Adelaide Utd,1783,5,11,6,11,37,40,-3,39
Brisbane,1783,6,10,5,13,33,42,-9,35
Western Sydn,1783,7,8,9,10,38,47,-9,33
Perth Glory,1783,8,10,2,15,37,50,-13,32
Wellington P,1783,9,5,6,16,31,55,-24,21
CC Mariners,1783,10,4,8,15,28,49,-21,20
Sydney FC,1784,1,20,4,4,65,24,41,64
N'castle Jet,1784,2,16,5,7,59,37,22,53
Melbourne V,1784,3,14,5,10,47,39,8,47
Melbourne C,1784,4,14,4,11,43,35,8,46
Adelaide Utd,1784,5,11,6,11,37,40,-3,39
Brisbane,1784,6,10,5,13,33,42,-9,35
Western Sydn,1784,7,8,9,10,38,47,-9,33
Perth Glory,1784,8,10,2,15,37,50,-13,32
Wellington P,1784,9,5,6,16,31,55,-24,21
CC Mariners,1784,10,4,8,15,28,49,-21,20
Sydney FC,1785,1,21,4,3,67,22,45,67
N'castle Jet,1785,2,15,5,8,58,39,19,50
Melbourne C,1785,3,15,4,10,45,34,11,49
Melbourne V,1785,4,13,5,11,45,41,4,44
Adelaide Utd,1785,5,11,6,11,37,40,-3,39
Brisbane,1785,6,10,5,13,33,42,-9,35
Western Sydn,1785,7,8,9,10,38,47,-9,33
Perth Glory,1785,8,10,2,15,37,50,-13,32
Wellington P,1785,9,5,6,16,31,55,-24,21
CC Mariners,1785,10,4,8,15,28,49,-21,20
Sydney FC,1786,1,21,4,3,68,22,46,67
N'castle Jet,1786,2,16,5,7,58,37,21,53
Melbourne C,1786,3,14,4,11,43,34,9,46
Melbourne V,1786,4,13,5,11,45,42,3,44
Adelaide Utd,1786,5,11,6,11,37,40,-3,39
Brisbane,1786,6,10,5,13,33,42,-9,35
Western Sydn,1786,7,8,9,10,38,47,-9,33
Perth Glory,1786,8,10,2,15,37,50,-13,32
Wellington P,1786,9,5,6,16,31,55,-24,21
CC Mariners,1786,10,4,8,15,28,49,-21,20
Sydney FC,1787,1,21,4,3,65,22,43,67
N'castle Jet,1787,2,16,5,7,61,38,23,53
Melbourne C,1787,3,14,4,11,44,37,7,46
Melbourne V,1787,4,13,5,11,45,39,6,44
Adelaide Utd,1787,5,11,6,11,37,40,-3,39
Brisbane,1787,6,10,5,13,33,42,-9,35
Western Sydn,1787,7,8,9,10,38,47,-9,33
Perth Glory,1787,8,10,2,15,37,50,-13,32
Wellington P,1787,9,5,6,16,31,55,-24,21
CC Mariners,1787,10,4,8,15,28,49,-21,20
Sydney FC,1788,1,21,4,3,65,22,43,67
N'castle Jet,1788,2,16,5,7,59,38,21,53
Melbourne C,1788,3,14,4,11,44,35,9,46
Melbourne V,1788,4,13,5,11,45,39,6,44
Adelaide Utd,1788,5,11,6,11,37,40,-3,39
Brisbane,1788,6,10,5,13,33,42,-9,35
Western Sydn,1788,7,8,9,10,38,47,-9,33
Perth Glory,1788,8,10,2,15,37,50,-13,32
Wellington P,1788,9,5,6,16,31,55,-24,21
CC Mariners,1788,10,4,8,15,28,49,-21,20
Sydney FC,1789,1,20,5,3,65,23,42,65
N'castle Jet,1789,2,15,5,8,58,39,19,50
Melbourne C,1789,3,15,4,10,45,34,11,49
Melbourne V,1789,4,13,6,10,46,39,7,45
Adelaide Utd,1789,5,11,6,11,37,40,-3,39
Brisbane,1789,6,10,5,13,33,42,-9,35
Western Sydn,1789,7,8,9,10,38,47,-9,33
Perth Glory,1789,8,10,2,15,37,50,-13,32
Wellington P,1789,9,5,6,16,31,55,-24,21
CC Mariners,1789,10,4,8,15,28,49,-21,20
Sydney FC,1790,1,21,4,3,68,22,46,67
N'castle Jet,1790,2,16,5,7,60,38,22,53
Melbourne C,1790,3,14,4,11,44,36,8,46
Melbourne V,1790,4,13,5,11,45,42,3,44
Adelaide Utd,1790,5,11,6,11,37,40,-3,39
Brisbane,1790,6,10,5,13,33,42,-9,35
Western Sydn,1790,7,8,9,10,38,47,-9,33
Perth Glory,1790,8,10,2,15,37,50,-13,32
Wellington P,1790,9,5,6,16,31,55,-24,21
CC Mariners,1790,10,4,8,15,28,49,-21,20
Sydney FC,1791,1,21,4,3,66,23,43,67
N'castle Jet,1791,2,16,5,7,59,37,22,53
Melbourne C,1791,3,14,4,11,43,35,8,46
Melbourne V,1791,4,13,5,11,46,40,6,44
Adelaide Utd,1791,5,11,6,11,37,40,-3,39
Brisbane,1791,6,10,5,13,33,42,-9,35
Western Sydn,1791,7,8,9,10,38,47,-9,33
Perth Glory,1791,8,10,2,15,37,50,-13,32
Wellington P,1791,9,5,6,16,31,55,-24,21
CC Mariners,1791,10,4,8,15,28,49,-21,20
Sydney FC,1792,1,20,4,4,64,23,41,64
N'castle Jet,1792,2,15,6,7,58,38,20,51
Melbourne C,1792,3,14,5,10,44,34,10,47
Melbourne V,1792,4,14,5,10,46,38,8,47
Adelaide Utd,1792,5,11,6,11,37,40,-3,39
Brisbane,1792,6,10,5,13,33,42,-9,35
Western Sydn,1792,7,8,9,10,38,47,-9,33
Perth Glory,1792,8,10,2,15,37,50,-13,32
Wellington P,1792,9,5,6,16,31,55,-24,21
CC Mariners,1792,10,4,8,15,28,49,-21,20
Sydney FC,1793,1,21,4,3,65,22,43,67
N'castle Jet,1793,2,16,5,7,59,38,21,53
Melbourne C,1793,3,14,4,11,44,35,9,46
Melbourne V,1793,4,13,5,11,45,39,6,44
Adelaide Utd,1793,5,11,6,11,37,40,-3,39
Brisbane,1793,6,10,5,13,33,42,-9,35
Western Sydn,1793,7,8,9,10,38,47,-9,33
Perth Glory,1793,8,10,2,15,37,50,-13,32
Wellington P,1793,9,5,6,16,31,55,-24,21
CC Mariners,1793,10,4,8,15,28,49,-21,20
Sydney FC,1794,1,21,4,3,69,23,46,67
N'castle Jet,1794,2,15,5,8,59,41,18,50
Melbourne C,1794,3,15,4,10,47,35,12,49
Melbourne V,1794,4,13,5,11,46,43,3,44
Adelaide Utd,1794,5,11,6,11,37,40,-3,39
Brisbane,1794,6,10,5,13,33,42,-9,35
Western Sydn,1794,7,8,9,10,38,47,-9,33
Perth Glory,1794,8,10,2,15,37,50,-13,32
Wellington P,1794,9,5,6,16,31,55,-24,21
CC Mariners,1794,10,4,8,15,28,49,-21,20
Sydney FC,1795,1,21,4,3,66,23,43,67
N'castle Jet,1795,2,16,5,7,61,39,22,53
Melbourne C,1795,3,14,4,11,45,37,8,46
Melbourne V,1795,4,13,5,11,46,40,6,44
Adelaide Utd,1795,5,11,6,11,37,40,-3,39
Brisbane,1795,6,10,5,13,33,42,-9,35
Western Sydn,1795,7,8,9,10,38,47,-9,33
Perth Glory,1795,8,10,2,15,37,50,-13,32
Wellington P,1795,9,5,6,16,31,55,-24,21
CC Mariners,1795,10,4,8,15,28,49,-21,20
Sydney FC,1796,1,21,4,3,66,22,44,67
N'castle Jet,1796,2,16,5,7,58,37,21,53
Melbourne C,1796,3,14,4,11,43,34,9,46
Melbourne V,1796,4,13,5,11,45,40,5,44
Adelaide Utd,1796,5,11,6,11,37,40,-3,39
Brisbane,1796,6,10,5,13,33,42,-9,35
Western Sydn,1796,7,8,9,10,38,47,-9,33
Perth Glory,1796,8,10,2,15,37,50,-13,32
Wellington P,1796,9,5,6,16,31,55,-24,21
CC Mariners,1796,10,4,8,15,28,49,-21,20
Sydney FC,1797,1,20,4,4,64,24,40,64
N'castle Jet,1797,2,16,5,7,62,38,24,53
Melbourne V,1797,3,14,5,10,47,38,9,47
Melbourne C,1797,4,14,4,11,44,38,6,46
Adelaide Utd,1797,5,11,6,11,37,40,-3,39
Brisbane,1797,6,10,5,13,33,42,-9,35
Western Sydn,1797,7,8,9,10,38,47,-9,33
Perth Glory,1797,8,10,2,15,37,50,-13,32
Wellington P,1797,9,5,6,16,31,55,-24,21
CC Mariners,1797,10,4,8,15,28,49,-21,20
Sydney FC,1798,1,20,4,4,65,25,40,64
N'castle Jet,1798,2,16,5,7,60,39,21,53
Melbourne V,1798,3,14,5,10,48,39,9,47
Melbourne C,1798,4,14,4,11,45,36,9,46
Adelaide Utd,1798,5,11,6,11,37,40,-3,39
Brisbane,1798,6,10,5,13,33,42,-9,35
Western Sydn,1798,7,8,9,10,38,47,-9,33
Perth Glory,1798,8,10,2,15,37,50,-13,32
Wellington P,1798,9,5,6,16,31,55,-24,21
CC Mariners,1798,10,4,8,15,28,49,-21,20
Sydney FC,1799,1,20,5,3,64,22,42,65
N'castle Jet,1799,2,16,5,7,60,37,23,53
Melbourne C,1799,3,14,4,11,43,36,7,46
Melbourne V,1799,4,13,6,10,45,38,7,45
Adelaide Utd,1799,5,11,6,11,37,40,-3,39
Brisbane,1799,6,10,5,13,33,42,-9,35
Western Sydn,1799,7,8,9,10,38,47,-9,33
Perth Glory,1799,8,10,2,15,37,50,-13,32
Wellington P,1799,9,5,6,16,31,55,-24,21
CC Mariners,1799,10,4,8,15,28,49,-21,20
Sydney FC,1800,1,21,4,3,65,22,43,67
N'castle Jet,1800,2,15,5,8,57,39,18,50
Melbourne C,1800,3,15,4,10,45,33,12,49
Melbourne V,1800,4,13,5,11,45,39,6,44
Adelaide Utd,1800,5,11,6,11,37,40,-3,39
Brisbane,1800,6,10,5,13,33,42,-9,35
Western Sydn,1800,7,8,9,10,38,47,-9,33
Perth Glory,1800,8,10,2,15,37,50,-13,32
Wellington P,1800,9,5,6,16,31,55,-24,21
CC Mariners,1800,10,4,8,15,28,49,-21,20
Sydney FC,1801,1,21,4,3,67,23,44,67
N'castle Jet,1801,2,15,6,7,58,38,20,51
Melbourne C,1801,3,14,5,10,44,34,10,47
Melbourne V,1801,4,13,5,11,46,41,5,44
Adelaide Utd,1801,5,11,6,11,37,40,-3,39
Brisbane,1801,6,10,5,13,33,42,-9,35
Western Sydn,1801,7,8,9,10,38,47,-9,33
Perth Glory,1801,8,10,2,15,37,50,-13,32
Wellington P,1801,9,5,6,16,31,55,-24,21
CC Mariners,1801,10,4,8,15,28,49,-21,20
Sydney FC,1802,1,21,4,3,67,23,44,67
N'castle Jet,1802,2,15,5,8,58,39,19,50
Melbourne C,1802,3,15,4,10,45,34,11,49
Melbourne V,1802,4,13,5,11,46,41,5,44
Adelaide Utd,1802,5,11,6,11,37,40,-3,39
Brisbane,1802,6,10,5,13,33,42,-9,35
Western Sydn,1802,7,8,9,10,38,47,-9,33
Perth Glory,1802,8,10,2,15,37,50,-13,32
Wellington P,1802,9,5,6,16,31,55,-24,21
CC Mariners,1802,10,4,8,15,28,49,-21,20
Sydney FC,1803,1,21,4,3,67,23,44,67
N'castle Jet,1803,2,15,6,7,58,38,20,51
Melbourne C,1803,3,14,5,10,44,34,10,47
Melbourne V,1803,4,13,5,11,46,41,5,44
Adelaide Utd,1803,5,11,6,11,37,40,-3,39
Brisbane,1803,6,10,5,13,33,42,-9,35
Western Sydn,1803,7,8,9,10,38,47,-9,33
Perth Glory,1803,8,10,2,15,37,50,-13,32
Wellington P,1803,9,5,6,16,31,55,-24,21
CC Mariners,1803,10,4,8,15,28,49,-21,20
Sydney FC,1804,1,21,4,3,66,23,43,67
N'castle Jet,1804,2,16,5,7,58,37,21,53
Melbourne C,1804,3,14,4,11,43,34,9,46
Melbourne V,1804,4,13,5,11,46,40,6,44
Adelaide Utd,1804,5,11,6,11,37,40,-3,39
Brisbane,1804,6,10,5,13,33,42,-9,35
Western Sydn,1804,7,8,9,10,38,47,-9,33
Perth Glory,1804,8,10,2,15,37,50,-13,32
Wellington P,1804,9,5,6,16,31,55,-24,21
CC Mariners,1804,10,4,8,15,28,49,-21,20
Sydney FC,1805,1,20,5,3,65,23,42,65
N'castle Jet,1805,2,16,5,7,61,38,23,53
Melbourne C,1805,3,14,4,11,44,37,7,46
Melbourne V,1805,4,13,6,10,46,39,7,45
Adelaide Utd,1805,5,11,6,11,37,40,-3,39
Brisbane,1805,6,10,5,13,33,42,-9,35
Western Sydn,1805,7,8,9,10,38,47,-9,33
Perth Glory,1805,8,10,2,15,37,50,-13,32
Wellington P,1805,9,5,6,16,31,55,-24,21
CC Mariners,1805,10,4,8,15,28,49,-21,20
Sydney FC,1806,1,21,4,3,66,22,44,67
N'castle Jet,1806,2,15,6,7,58,38,20,51
Melbourne C,1806,3,14,5,10,44,34,10,47
Melbourne V,1806,4,13,5,11,45,40,5,44
Adelaide Utd,1806,5,11,6,11,37,40,-3,39
Brisbane,1806,6,10,5,13,33,42,-9,35
Western Sydn,1806,7,8,9,10,38,47,-9,33
Perth Glory,1806,8,10,2,15,37,50,-13,32
Wellington P,1806,9,5,6,16,31,55,-24,21
CC Mariners,1806,10,4,8,15,28,49,-21,20
Sydney FC,1807,1,20,5,3,65,23,42,65
N'castle Jet,1807,2,15,6,7,57,37,20,51
Melbourne C,1807,3,14,5,10,43,33,10,47
Melbourne V,1807,4,13,6,10,46,39,7,45
Adelaide Utd,1807,5,11,6,11,37,40,-3,39
Brisbane,1807,6,10,5,13,33,42,-9,35
Western Sydn,1807,7,8,9,10,38,47,-9,33
Perth Glory,1807,8,10,2,15,37,50,-13,32
Wellington P,1807,9,5,6,16,31,55,-24,21
CC Mariners,1807,10,4,8,15,28,49,-21,20
Sydney FC,1808,1,21,4,3,67,24,43,67
N'castle Jet,1808,2,15,5,8,57,39,18,50
Melbourne C,1808,3,15,4,10,45,33,12,49
Melbourne V,1808,4,13,5,11,47,41,6,44
Adelaide Utd,1808,5,11,6,11,37,40,-3,39
Brisbane,1808,6,10,5,13,33,42,-9,35
Western Sydn,1808,7,8,9,10,38,47,-9,33
Perth Glory,1808,8,10,2,15,37,50,-13,32
Wellington P,1808,9,5,6,16,31,55,-24,21
CC Mariners,1808,10,4,8,15,28,49,-21,20
Sydney FC,1809,1,21,4,3,67,22,45,67
N'castle Jet,1809,2,16,5,7,59,38,21,53
Melbourne C,1809,3,14,4,11,44,35,9,46
Melbourne V,1809,4,13,5,11,45,41,4,44
Adelaide Utd,1809,5,11,6,11,37,40,-3,39
Brisbane,1809,6,10,5,13,33,42,-9,35
Western Sydn,1809,7,8,9,10,38,47,-9,33
Perth Glory,1809,8,10,2,15,37,50,-13,32
Wellington P,1809,9,5,6,16,31,55,-24,21
CC Mariners,1809,10,4,8,15,28,49,-21,20
Sydney FC,1810,1,21,4,3,68,23,45,67
N'castle Jet,1810,2,15,5,8,57,38,19,50
Melbourne C,1810,3,15,4,10,44,33,11,49
Melbourne V,1810,4,13,5,11,46,42,4,44
Adelaide Utd,1810,5,11,6,11,37,40,-3,39
Brisbane,1810,6,10,5,13,33,42,-9,35
Western Sydn,1810,7,8,9,10,38,47,-9,33
Perth Glory,1810,8,10,2,15,37,50,-13,32
Wellington P,1810,9,5,6,16,31,55,-24,21
CC Mariners,1810,10,4,8,15,28,49,-21,20
Sydney FC,1811,1,20,5,3,66,24,42,65
N'castle Jet,1811,2,15,5,8,58,39,19,50
Melbourne C,1811,3,15,4,10,45,34,11,49
Melbourne V,1811,4,13,6,10,47,40,7,45
Adelaide Utd,1811,5,11,6,11,37,40,-3,39
Brisbane,1811,6,10,5,13,33,42,-9,35
Western Sydn,1811,7,8,9,10,38,47,-9,33
Perth Glory,1811,8,10,2,15,37,50,-13,32
Wellington P,1811,9,5,6,16,31,55,-24,21
CC Mariners,1811,10,4,8,15,28,49,-21,20
Sydney FC,1812,1,20,5,3,65,23,42,65
N'castle Jet,1812,2,16,5,7,58,37,21,53
Melbourne C,1812,3,14,4,11,43,34,9,46
Melbourne V,1812,4,13,6,10,46,39,7,45
Adelaide Utd,1812,5,11,6,11,37,40,-3,39
Brisbane,1812,6,10,5,13,33,42,-9,35
Western Sydn,1812,7,8,9,10,38,47,-9,33
Perth Glory,1812,8,10,2,15,37,50,-13,32
Wellington P,1812,9,5,6,16,31,55,-24,21
CC Mariners,1812,10,4,8,15,28,49,-21,20
Sydney FC,1813,1,21,4,3,68,24,44,67
N'castle Jet,1813,2,15,6,7,59,39,20,51
Melbourne C,1813,3,14,5,10,45,35,10,47
Melbourne V,1813,4,13,5,11,47,42,5,44
Adelaide Utd,1813,5,11,6,11,37,40,-3,39
Brisbane,1813,6,10,5,13,33,42,-9,35
Western Sydn,1813,7,8,9,10,38,47,-9,33
Perth Glory,1813,8,10,2,15,37,50,-13,32
Wellington P,1813,9,5,6,16,31,55,-24,21
CC Mariners,1813,10,4,8,15,28,49,-21,20
Sydney FC,1814,1,21,4,3,66,23,43,67
N'castle Jet,1814,2,15,6,7,59,39,20,51
Melbourne C,1814,3,14,5,10,45,35,10,47
Melbourne V,1814,4,13,5,11,46,40,6,44
Adelaide Utd,1814,5,11,6,11,37,40,-3,39
Brisbane,1814,6,10,5,13,33,42,-9,35
Western Sydn,1814,7,8,9,10,38,47,-9,33
Perth Glory,1814,8,10,2,15,37,50,-13,32
Wellington P,1814,9,5,6,16,31,55,-24,21
CC Mariners,1814,10,4,8,15,28,49,-21,20
Sydney FC,1815,1,20,5,3,65,23,42,65
N'castle Jet,1815,2,16,5,7,61,38,23,53
Melbourne C,1815,3,14,4,11,44,37,7,46
Melbourne V,1815,4,13,6,10,46,39,7,45
Adelaide Utd,1815,5,11,6,11,37,40,-3,39
Brisbane,1815,6,10,5,13,33,42,-9,35
Western Sydn,1815,7,8,9,10,38,47,-9,33
Perth Glory,1815,8,10,2,15,37,50,-13,32
Wellington P,1815,9,5,6,16,31,55,-24,21
CC Mariners,1815,10,4,8,15,28,49,-21,20
Sydney FC,1816,1,21,4,3,67,22,45,67
N'castle Jet,1816,2,15,5,8,57,38,19,50
Melbourne C,1816,3,15,4,10,44,33,11,49
Melbourne V,1816,4,13,5,11,45,41,4,44
Adelaide Utd,1816,5,11,6,11,37,40,-3,39
Brisbane,1816,6,10,5,13,33,42,-9,35
Western Sydn,1816,7,8,9,10,38,47,-9,33
Perth Glory,1816,8,10,2,15,37,50,-13,32
Wellington P,1816,9,5,6,16,31,55,-24,21
CC Mariners,1816,10,4,8,15,28,49,-21,20
Sydney FC,1817,1,21,4,3,65,22,43,67
N'castle Jet,1817,2,16,5,7,59,38,21,53
Melbourne C,1817,3,14,4,11,44,35,9,46
Melbourne V,1817,4,13,5,11,45,39,6,44
Adelaide Utd,1817,5,11,6,11,37,40,-3,39
Brisbane,1817,6,10,5,13,33,42,-9,35
Western Sydn,1817,7,8,9,10,38,47,-9,33
Perth Glory,1817,8,10,2,15,37,50,-13,32
Wellington P,1817,9,5,6,16,31,55,-24,21
CC Mariners,1817,10,4,8,15,28,49,-21,20
Sydney FC,1818,1,21,4,3,67,23,44,67
N'castle Jet,1818,2,16,5,7,61,39,22,53
Melbourne C,1818,3,14,4,11,45,37,8,46
Melbourne V,1818,4,13,5,11,46,41,5,44
Adelaide Utd,1818,5,11,6,11,37,40,-3,39
Brisbane,1818,6,10,5,13,33,42,-9,35
Western Sydn,1818,7,8,9,10,38,47,-9,33
Perth Glory,1818,8,10,2,15,37,50,-13,32
Wellington P,1818,9,5,6,16,31,55,-24,21
CC Mariners,1818,10,4,8,15,28,49,-21,20
Sydney FC,1819,1,21,4,3,67,22,45,67
N'castle Jet,1819,2,16,5,7,62,38,24,53
Melbourne C,1819,3,14,4,11,44,38,6,46
Melbourne V,1819,4,13,5,11,45,41,4,44
Adelaide Utd,1819,5,11,6,11,37,40,-3,39
Brisbane,1819,6,10,5,13,33,42,-9,35
Western Sydn,1819,7,8,9,10,38,47,-9,33
Perth Glory,1819,8,10,2,15,37,50,-13,32
Wellington P,1819,9,5,6,16,31,55,-24,21
CC Mariners,1819,10,4,8,15,28,49,-21,20
Sydney FC,1820,1,20,4,4,65,24,41,64
N'castle Jet,1820,2,16,5,7,61,38,23,53
Melbourne V,1820,3,14,5,10,47,39,8,47
Melbourne C,1820,4,14,4,11,44,37,7,46
Adelaide Utd,1820,5,11,6,11,37,40,-3,39
Brisbane,1820,6,10,5,13,33,42,-9,35
Western Sydn,1820,7,8,9,10,38,47,-9,33
Perth Glory,1820,8,10,2,15,37,50,-13,32
Wellington P,1820,9,5,6,16,31,55,-24,21
CC Mariners,1820,10,4,8,15,28,49,-21,20
Sydney FC,1821,1,20,4,4,64,23,41,64
N'castle Jet,1821,2,15,5,8,57,39,18,50
Melbourne C,1821,3,15,4,10,45,33,12,49
Melbourne V,1821,4,14,5,10,46,38,8,47
Adelaide Utd,1821,5,11,6,11,37,40,-3,39
Brisbane,1821,6,10,5,13,33,42,-9,35
Western Sydn,1821,7,8,9,10,38,47,-9,33
Perth Glory,1821,8,10,2,15,37,50,-13,32
Wellington P,1821,9,5,6,16,31,55,-24,21
CC Mariners,1821,10,4,8,15,28,49,-21,20
Sydney FC,1822,1,21,4,3,66,23,43,67
N'castle Jet,1822,2,16,5,7,59,38,21,53
Melbourne C,1822,3,14,4,11,44,35,9,46
Melbourne V,1822,4,13,5,11,46,40,6,44
Adelaide Utd,1822,5,11,6,11,37,40,-3,39
Brisbane,1822,6,10,5,13,33,42,-9,35
Western Sydn,1822,7,8,9,10,38,47,-9,33
Perth Glory,1822,8,10,2,15,37,50,-13,32
Wellington P,1822,9,5,6,16,31,55,-24,21
CC Mariners,1822,10,4,8,15,28,49,-21,20
Sydney FC,1823,1,21,4,3,67,22,45,67
N'castle Jet,1823,2,16,5,7,61,38,23,53
Melbourne C,1823,3,14,4,11,44,37,7,46
Melbourne V,1823,4,13,5,11,45,41,4,44
Adelaide Utd,1823,5,11,6,11,37,40,-3,39
Brisbane,1823,6,10,5,13,33,42,-9,35
Western Sydn,1823,7,8,9,10,38,47,-9,33
Perth Glory,1823,8,10,2,15,37,50,-13,32
Wellington P,1823,9,5,6,16,31,55,-24,21
CC Mariners,1823,10,4,8,15,28,49,-21,20
Sydney FC,1824,1,21,4,3,65,22,43,67
N'castle Jet,1824,2,15,6,7,59,39,20,51
Melbourne C,1824,3,14,5,10,45,35,10,47
Melbourne V,1824,4,13,5,11,45,39,6,44
Adelaide Utd,1824,5,11,6,11,37,40,-3,39
Brisbane,1824,6,10,5,13,33,42,-9,35
Western Sydn,1824,7,8,9,10,38,47,-9,33
Perth Glory,1824,8,10,2,15,37,50,-13,32
Wellington P,1824,9,5,6,16,31,55,-24,21
CC Mariners,1824,10,4,8,15,28,49,-21,20
Sydney FC,1825,1,21,4,3,67,22,45,67
N'castle Jet,1825,2,15,6,7,57,37,20,51
Melbourne C,1825,3,14,5,10,43,33,10,47
Melbourne V,1825,4,13,5,11,45,41,4,44
Adelaide Utd,1825,5,11,6,11,37,40,-3,39
Brisbane,1825,6,10,5,13,33,42,-9,35
Western Sydn,1825,7,8,9,10,38,47,-9,33
Perth Glory,1825,8,10,2,15,37,50,-13,32
Wellington P,1825,9,5,6,16,31,55,-24,21
CC Mariners,1825,10,4,8,15,28,49,-21,20
Sydney FC,1826,1,21,4,3,65,22,43,67
N'castle Jet,1826,2,16,5,7,59,38,21,53
Melbourne C,1826,3,14,4,11,44,35,9,46
Melbourne V,1826,4,13,5,11,45,39,6,44
Adelaide Utd,1826,5,11,6,11,37,40,-3,39
Brisbane,1826,6,10,5,13,33,42,-9,35
Western Sydn,1826,7,8,9,10,38,47,-9,33
Perth Glory,1826,8,10,2,15,37,50,-13,32
Wellington P,1826,9,5,6,16,31,55,-24,21
CC Mariners,1826,10,4,8,15,28,49,-21,20
Sydney FC,1827,1,20,5,3,65,23,42,65
N'castle Jet,1827,2,16,5,7,60,38,22,53
Melbourne C,1827,3,14,4,11,44,36,8,46
Melbourne V,1827,4,13,6,10,46,39,7,45
Adelaide Utd,1827,5,11,6,11,37,40,-3,39
Brisbane,1827,6,10,5,13,33,42,-9,35
Western Sydn,1827,7,8,9,10,38,47,-9,33
Perth Glory,1827,8,10,2,15,37,50,-13,32
Wellington P,1827,9,5,6,16,31,55,-24,21
CC Mariners,1827,10,4,8,15,28,49,-21,20
Sydney FC,1828,1,20,5,3,66,24,42,65
N'castle Jet,1828,2,15,6,7,60,40,20,51
Melbourne C,1828,3,14,5,10,46,36,10,47
Melbourne V,1828,4,13,6,10,47,40,7,45
Adelaide Utd,1828,5,11,6,11,37,40,-3,39
Brisbane,1828,6,10,5,13,33,42,-9,35
Western Sydn,1828,7,8,9,10,38,47,-9,33
Perth Glory,1828,8,10,2,15,37,50,-13,32
Wellington P,1828,9,5,6,16,31,55,-24,21
CC Mariners,1828,10,4,8,15,28,49,-21,20
Sydney FC,1829,1,21,4,3,66,22,44,67
N'castle Jet,1829,2,16,5,7,62,37,25,53
Melbourne C,1829,3,14,4,11,43,38,5,46
Melbourne V,1829,4,13,5,11,45,40,5,44
Adelaide Utd,1829,5,11,6,11,37,40,-3,39
Brisbane,1829,6,10,5,13,33,42,-9,35
Western Sydn,1829,7,8,9,10,38,47,-9,33
Perth Glory,1829,8,10,2,15,37,50,-13,32
Wellington P,1829,9,5,6,16,31,55,-24,21
CC Mariners,1829,10,4,8,15,28,49,-21,20
Sydney FC,1830,1,21,4,3,65,22,43,67
N'castle Jet,1830,2,16,5,7,59,37,22,53
Melbourne C,1830,3,14,4,11,43,35,8,46
Melbourne V,1830,4,13,5,11,45,39,6,44
Adelaide Utd,1830,5,11,6,11,37,40,-3,39
Brisbane,1830,6,10,5,13,33,42,-9,35
Western Sydn,1830,7,8,9,10,38,47,-9,33
Perth Glory,1830,8,10,2,15,37,50,-13,32
Wellington P,1830,9,5,6,16,31,55,-24,21
CC Mariners,1830,10,4,8,15,28,49,-21,20
Sydney FC,1831,1,21,4,3,65,22,43,67
N'castle Jet,1831,2,16,5,7,59,38,21,53
Melbourne C,1831,3,14,4,11,44,35,9,46
Melbourne V,1831,4,13,5,11,45,39,6,44
Adelaide Utd,1831,5,11,6,11,37,40,-3,39
Brisbane,1831,6,10,5,13,33,42,-9,35
Western Sydn,1831,7,8,9,10,38,47,-9,33
Perth Glory,1831,8,10,2,15,37,50,-13,32
Wellington P,1831,9,5,6,16,31,55,-24,21
CC Mariners,1831,10,4,8,15,28,49,-21,20
Sydney FC,1832,1,21,4,3,66,23,43,67
N'castle Jet,1832,2,16,5,7,61,37,24,53
Melbourne C,1832,3,14,4,11,43,37,6,46
Melbourne V,1832,4,13,5,11,46,40,6,44
Adelaide Utd,1832,5,11,6,11,37,40,-3,39
Brisbane,1832,6,10,5,13,33,42,-9,35
Western Sydn,1832,7,8,9,10,38,47,-9,33
Perth Glory,1832,8,10,2,15,37,50,-13,32
Wellington P,1832,9,5,6,16,31,55,-24,21
CC Mariners,1832,10,4,8,15,28,49,-21,20
Sydney FC,1833,1,21,4,3,66,23,43,67
N'castle Jet,1833,2,16,5,7,59,37,22,53
Melbourne C,1833,3,14,4,11,43,35,8,46
Melbourne V,1833,4,13,5,11,46,40,6,44
Adelaide Utd,1833,5,11,6,11,37,40,-3,39
Brisbane,1833,6,10,5,13,33,42,-9,35
Western Sydn,1833,7,8,9,10,38,47,-9,33
Perth Glory,1833,8,10,2,15,37,50,-13,32
Wellington P,1833,9,5,6,16,31,55,-24,21
CC Mariners,1833,10,4,8,15,28,49,-21,20
Sydney FC,1834,1,20,5,3,65,23,42,65
N'castle Jet,1834,2,16,5,7,61,38,23,53
Melbourne C,1834,3,14,4,11,44,37,7,46
Melbourne V,1834,4,13,6,10,46,39,7,45
Adelaide Utd,1834,5,11,6,11,37,40,-3,39
Brisbane,1834,6,10,5,13,33,42,-9,35
Western Sydn,1834,7,8,9,10,38,47,-9,33
Perth Glory,1834,8,10,2,15,37,50,-13,32
Wellington P,1834,9,5,6,16,31,55,-24,21
CC Mariners,1834,10,4,8,15,28,49,-21,20
Sydney FC,1835,1,21,4,3,65,22,43,67
N'castle Jet,1835,2,15,6,7,58,38,20,51
Melbourne C,1835,3,14,5,10,44,34,10,47
Melbourne V,1835,4,13,5,11,45,39,6,44
Adelaide Utd,1835,5,11,6,11,37,40,-3,39
Brisbane,1835,6,10,5,13,33,42,-9,35
Western Sydn,1835,7,8,9,10,38,47,-9,33
Perth Glory,1835,8,10,2,15,37,50,-13,32
Wellington P,1835,9,5,6,16,31,55,-24,21
CC Mariners,1835,10,4,8,15,28,49,-21,20
Sydney FC,1836,1,21,4,3,67,22,45,67
N'castle Jet,1836,2,15,6,7,59,39,20,51
Melbourne C,1836,3,14,5,10,45,35,10,47
Melbourne V,1836,4,13,5,11,45,41,4,44
Adelaide Utd,1836,5,11,6,11,37,40,-3,39
Brisbane,1836,6,10,5,13,33,42,-9,35
Western Sydn,1836,7,8,9,10,38,47,-9,33
Perth Glory,1836,8,10,2,15,37,50,-13,32
Wellington P,1836,9,5,6,16,31,55,-24,21
CC Mariners,1836,10,4,8,15,28,49,-21,20
Sydney FC,1837,1,21,4,3,67,23,44,67
N'castle Jet,1837,2,16,5,7,61,37,24,53
Melbourne C,1837,3,14,4,11,43,37,6,46
Melbourne V,1837,4,13,5,11,46,41,5,44
Adelaide Utd,1837,5,11,6,11,37,40,-3,39
Brisbane,1837,6,10,5,13,33,42,-9,35
Western Sydn,1837,7,8,9,10,38,47,-9,33
Perth Glory,1837,8,10,2,15,37,50,-13,32
Wellington P,1837,9,5,6,16,31,55,-24,21
CC Mariners,1837,10,4,8,15,28,49,-21,20
Sydney FC,1838,1,21,4,3,66,23,43,67
N'castle Jet,1838,2,16,5,7,59,38,21,53
Melbourne C,1838,3,14,4,11,44,35,9,46
Melbourne V,1838,4,13,5,11,46,40,6,44
Adelaide Utd,1838,5,11,6,11,37,40,-3,39
Brisbane,1838,6,10,5,13,33,42,-9,35
Western Sydn,1838,7,8,9,10,38,47,-9,33
Perth Glory,1838,8,10,2,15,37,50,-13,32
Wellington P,1838,9,5,6,16,31,55,-24,21
CC Mariners,1838,10,4,8,15,28,49,-21,20
Sydney FC,1839,1,21,4,3,66,23,43,67
N'castle Jet,1839,2,16,5,7,59,37,22,53
Melbourne C,1839,3,14,4,11,43,35,8,46
Melbourne V,1839,4,13,5,11,46,40,6,44
Adelaide Utd,1839,5,11,6,11,37,40,-3,39
Brisbane,1839,6,10,5,13,33,42,-9,35
Western Sydn,1839,7,8,9,10,38,47,-9,33
Perth Glory,1839,8,10,2,15,37,50,-13,32
Wellington P,1839,9,5,6,16,31,55,-24,21
CC Mariners,1839,10,4,8,15,28,49,-21,20
Sydney FC,1840,1,20,5,3,64,22,42,65
N'castle Jet,1840,2,15,5,8,57,38,19,50
Melbourne C,1840,3,15,4,10,44,33,11,49
Melbourne V,1840,4,13,6,10,45,38,7,45
Adelaide Utd,1840,5,11,6,11,37,40,-3,39
Brisbane,1840,6,10,5,13,33,42,-9,35
Western Sydn,1840,7,8,9,10,38,47,-9,33
Perth Glory,1840,8,10,2,15,37,50,-13,32
Wellington P,1840,9,5,6,16,31,55,-24,21
CC Mariners,1840,10,4,8,15,28,49,-21,20
Sydney FC,1841,1,21,4,3,67,22,45,67
N'castle Jet,1841,2,16,5,7,59,38,21,53
Melbourne C,1841,3,14,4,11,44,35,9,46
Melbourne V,1841,4,13,5,11,45,41,4,44
Adelaide Utd,1841,5,11,6,11,37,40,-3,39
Brisbane,1841,6,10,5,13,33,42,-9,35
Western Sydn,1841,7,8,9,10,38,47,-9,33
Perth Glory,1841,8,10,2,15,37,50,-13,32
Wellington P,1841,9,5,6,16,31,55,-24,21
CC Mariners,1841,10,4,8,15,28,49,-21,20
Sydney FC,1842,1,21,4,3,66,22,44,67
N'castle Jet,1842,2,16,5,7,59,38,21,53
Melbourne C,1842,3,14,4,11,44,35,9,46
Melbourne V,1842,4,13,5,11,45,40,5,44
Adelaide Utd,1842,5,11,6,11,37,40,-3,39
Brisbane,1842,6,10,5,13,33,42,-9,35
Western Sydn,1842,7,8,9,10,38,47,-9,33
Perth Glory,1842,8,10,2,15,37,50,-13,32
Wellington P,1842,9,5,6,16,31,55,-24,21
CC Mariners,1842,10,4,8,15,28,49,-21,20
Sydney FC,1843,1,20,4,4,65,24,41,64
N'castle Jet,1843,2,16,5,7,62,38,24,53
Melbourne V,1843,3,14,5,10,47,39,8,47
Melbourne C,1843,4,14,4,11,44,38,6,46
Adelaide Utd,1843,5,11,6,11,37,40,-3,39
Brisbane,1843,6,10,5,13,33,42,-9,35
Western Sydn,1843,7,8,9,10,38,47,-9,33
Perth Glory,1843,8,10,2,15,37,50,-13,32
Wellington P,1843,9,5,6,16,31,55,-24,21
CC Mariners,1843,10,4,8,15,28,49,-21,20
Sydney FC,1844,1,20,4,4,65,24,41,64
N'castle Jet,1844,2,15,5,8,58,40,18,50
Melbourne C,1844,3,15,4,10,46,34,12,49
Melbourne V,1844,4,14,5,10,47,39,8,47
Adelaide Utd,1844,5,11,6,11,37,40,-3,39
Brisbane,1844,6,10,5,13,33,42,-9,35
Western Sydn,1844,7,8,9,10,38,47,-9,33
Perth Glory,1844,8,10,2,15,37,50,-13,32
Wellington P,1844,9,5,6,16,31,55,-24,21
CC Mariners,1844,10,4,8,15,28,49,-21,20
Sydney FC,1845,1,21,4,3,66,22,44,67
N'castle Jet,1845,2,15,6,7,57,37,20,51
Melbourne C,1845,3,14,5,10,43,33,10,47
Melbourne V,1845,4,13,5,11,45,40,5,44
Adelaide Utd,1845,5,11,6,11,37,40,-3,39
Brisbane,1845,6,10,5,13,33,42,-9,35
Western Sydn,1845,7,8,9,10,38,47,-9,33
Perth Glory,1845,8,10,2,15,37,50,-13,32
Wellington P,1845,9,5,6,16,31,55,-24,21
CC Mariners,1845,10,4,8,15,28,49,-21,20
Sydney FC,1846,1,21,4,3,67,23,44,67
N'castle Jet,1846,2,16,5,7,59,37,22,53
Melbourne C,1846,3,14,4,11,43,35,8,46
Melbourne V,1846,4,13,5,11,46,41,5,44
Adelaide Utd,1846,5,11,6,11,37,40,-3,39
Brisbane,1846,6,10,5,13,33,42,-9,35
Western Sydn,1846,7,8,9,10,38,47,-9,33
Perth Glory,1846,8,10,2,15,37,50,-13,32
Wellington P,1846,9,5,6,16,31,55,-24,21
CC Mariners,1846,10,4,8,15,28,49,-21,20
Sydney FC,1847,1,21,4,3,67,23,44,67
N'castle Jet,1847,2,16,5,7,60,37,23,53
Melbourne C,1847,3,14,4,11,43,36,7,46
Melbourne V,1847,4,13,5,11,46,41,5,44
Adelaide Utd,1847,5,11,6,11,37,40,-3,39
Brisbane,1847,6,10,5,13,33,42,-9,35
Western Sydn,1847,7,8,9,10,38,47,-9,33
Perth Glory,1847,8,10,2,15,37,50,-13,32
Wellington P,1847,9,5,6,16,31,55,-24,21
CC Mariners,1847,10,4,8,15,28,49,-21,20
Sydney FC,1848,1,21,4,3,69,23,46,67
N'castle Jet,1848,2,16,5,7,60,37,23,53
Melbourne C,1848,3,14,4,11,43,36,7,46
Melbourne V,1848,4,13,5,11,46,43,3,44
Adelaide Utd,1848,5,11,6,11,37,40,-3,39
Brisbane,1848,6,10,5,13,33,42,-9,35
Western Sydn,1848,7,8,9,10,38,47,-9,33
Perth Glory,1848,8,10,2,15,37,50,-13,32
Wellington P,1848,9,5,6,16,31,55,-24,21
CC Mariners,1848,10,4,8,15,28,49,-21,20
Sydney FC,1849,1,21,4,3,68,22,46,67
N'castle Jet,1849,2,15,6,7,57,37,20,51
Melbourne C,1849,3,14,5,10,43,33,10,47
Melbourne V,1849,4,13,5,11,45,42,3,44
Adelaide Utd,1849,5,11,6,11,37,40,-3,39
Brisbane,1849,6,10,5,13,33,42,-9,35
Western Sydn,1849,7,8,9,10,38,47,-9,33
Perth Glory,1849,8,10,2,15,37,50,-13,32
Wellington P,1849,9,5,6,16,31,55,-24,21
CC Mariners,1849,10,4,8,15,28,49,-21,20
Sydney FC,1850,1,20,5,3,65,23,42,65
N'castle Jet,1850,2,16,5,7,59,38,21,53
Melbourne C,1850,3,14,4,11,44,35,9,46
Melbourne V,1850,4,13,6,10,46,39,7,45
Adelaide Utd,1850,5,11,6,11,37,40,-3,39
Brisbane,1850,6,10,5,13,33,42,-9,35
Western Sydn,1850,7,8,9,10,38,47,-9,33
Perth Glory,1850,8,10,2,15,37,50,-13,32
Wellington P,1850,9,5,6,16,31,55,-24,21
CC Mariners,1850,10,4,8,15,28,49,-21,20
Sydney FC,1851,1,20,4,4,65,24,41,64
N'castle Jet,1851,2,15,6,7,57,37,20,51
Melbourne C,1851,3,14,5,10,43,33,10,47
Melbourne V,1851,4,14,5,10,47,39,8,47
Adelaide Utd,1851,5,11,6,11,37,40,-3,39
Brisbane,1851,6,10,5,13,33,42,-9,35
Western Sydn,1851,7,8,9,10,38,47,-9,33
Perth Glory,1851,8,10,2,15,37,50,-13,32
Wellington P,1851,9,5,6,16,31,55,-24,21
CC Mariners,1851,10,4,8,15,28,49,-21,20
Sydney FC,1852,1,20,4,4,64,23,41,64
N'castle Jet,1852,2,15,6,7,58,38,20,51
Melbourne C,1852,3,14,5,10,44,34,10,47
Melbourne V,1852,4,14,5,10,46,38,8,47
Adelaide Utd,1852,5,11,6,11,37,40,-3,39
Brisbane,1852,6,10,5,13,33,42,-9,35
Western Sydn,1852,7,8,9,10,38,47,-9,33
Perth Glory,1852,8,10,2,15,37,50,-13,32
Wellington P,1852,9,5,6,16,31,55,-24,21
CC Mariners,1852,10,4,8,15,28,49,-21,20
Sydney FC,1853,1,20,5,3,64,22,42,65
N'castle Jet,1853,2,15,5,8,58,39,19,50
Melbourne C,1853,3,15,4,10,45,34,11,49
Melbourne V,1853,4,13,6,10,45,38,7,45
Adelaide Utd,1853,5,11,6,11,37,40,-3,39
Brisbane,1853,6,10,5,13,33,42,-9,35
Western Sydn,1853,7,8,9,10,38,47,-9,33
Perth Glory,1853,8,10,2,15,37,50,-13,32
Wellington P,1853,9,5,6,16,31,55,-24,21
CC Mariners,1853,10,4,8,15,28,49,-21,20
Sydney FC,1854,1,21,4,3,67,22,45,67
N'castle Jet,1854,2,16,5,7,58,37,21,53
Melbourne C,1854,3,14,4,11,43,34,9,46
Melbourne V,1854,4,13,5,11,45,41,4,44
Adelaide Utd,1854,5,11,6,11,37,40,-3,39
Brisbane,1854,6,10,5,13,33,42,-9,35
Western Sydn,1854,7,8,9,10,38,47,-9,33
Perth Glory,1854,8,10,2,15,37,50,-13,32
Wellington P,1854,9,5,6,16,31,55,-24,21
CC Mariners,1854,10,4,8,15,28,49,-21,20
Sydney FC,1855,1,20,5,3,65,23,42,65
N'castle Jet,1855,2,15,6,7,57,37,20,51
Melbourne C,1855,3,14,5,10,43,33,10,47
Melbourne V,1855,4,13,6,10,46,39,7,45
Adelaide Utd,1855,5,11,6,11,37,40,-3,39
Brisbane,1855,6,10,5,13,33,42,-9,35
Western Sydn,1855,7,8,9,10,38,47,-9,33
Perth Glory,1855,8,10,2,15,37,50,-13,32
Wellington P,1855,9,5,6,16,31,55,-24,21
CC Mariners,1855,10,4,8,15,28,49,-21,20
Sydney FC,1856,1,20,5,3,67,25,42,65
N'castle Jet,1856,2,16,5,7,59,38,21,53
Melbourne C,1856,3,14,4,11,44,35,9,46
Melbourne V,1856,4,13,6,10,48,41,7,45
Adelaide Utd,1856,5,11,6,11,37,40,-3,39
Brisbane,1856,6,10,5,13,33,42,-9,35
Western Sydn,1856,7,8,9,10,38,47,-9,33
Perth Glory,1856,8,10,2,15,37,50,-13,32
Wellington P,1856,9,5,6,16,31,55,-24,21
CC Mariners,1856,10,4,8,15,28,49,-21,20
Sydney FC,1857,1,20,4,4,64,24,40,64
N'castle Jet,1857,2,16,5,7,60,37,23,53
Melbourne V,1857,3,14,5,10,47,38,9,47
Melbourne C,1857,4,14,4,11,43,36,7,46
Adelaide Utd,1857,5,11,6,11,37,40,-3,39
Brisbane,1857,6,10,5,13,33,42,-9,35
Western Sydn,1857,7,8,9,10,38,47,-9,33
Perth Glory,1857,8,10,2,15,37,50,-13,32
Wellington P,1857,9,5,6,16,31,55,-24,21
CC Mariners,1857,10,4,8,15,28,49,-21,20
Sydney FC,1858,1,21,4,3,66,22,44,67
N'castle Jet,1858,2,16,5,7,60,37,23,53
Melbourne C,1858,3,14,4,11,43,36,7,46
Melbourne V,1858,4,13,5,11,45,40,5,44
Adelaide Utd,1858,5,11,6,11,37,40,-3,39
Brisbane,1858,6,10,5,13,33,42,-9,35
Western Sydn,1858,7,8,9,10,38,47,-9,33
Perth Glory,1858,8,10,2,15,37,50,-13,32
Wellington P,1858,9,5,6,16,31,55,-24,21
CC Mariners,1858,10,4,8,15,28,49,-21,20
Sydney FC,1859,1,21,4,3,66,23,43,67
N'castle Jet,1859,2,15,6,7,59,39,20,51
Melbourne C,1859,3,14,5,10,45,35,10,47
Melbourne V,1859,4,13,5,11,46,40,6,44
Adelaide Utd,1859,5,11,6,11,37,40,-3,39
Brisbane,1859,6,10,5,13,33,42,-9,35
Western Sydn,1859,7,8,9,10,38,47,-9,33
Perth Glory,1859,8,10,2,15,37,50,-13,32
Wellington P,1859,9,5,6,16,31,55,-24,21
CC Mariners,1859,10,4,8,15,28,49,-21,20
Sydney FC,1860,1,21,4,3,67,22,45,67
N'castle Jet,1860,2,15,5,8,59,40,19,50
Melbourne C,1860,3,15,4,10,46,35,11,49
Melbourne V,1860,4,13,5,11,45,41,4,44
Adelaide Utd,1860,5,11,6,11,37,40,-3,39
Brisbane,1860,6,10,5,13,33,42,-9,35
Western Sydn,1860,7,8,9,10,38,47,-9,33
Perth Glory,1860,8,10,2,15,37,50,-13,32
Wellington P,1860,9,5,6,16,31,55,-24,21
CC Mariners,1860,10,4,8,15,28,49,-21,20
Sydney FC,1861,1,21,4,3,68,22,46,67
N'castle Jet,1861,2,16,5,7,59,38,21,53
Melbourne C,1861,3,14,4,11,44,35,9,46
Melbourne V,1861,4,13,5,11,45,42,3,44
Adelaide Utd,1861,5,11,6,11,37,40,-3,39
Brisbane,1861,6,10,5,13,33,42,-9,35
Western Sydn,1861,7,8,9,10,38,47,-9,33
Perth Glory,1861,8,10,2,15,37,50,-13,32
Wellington P,1861,9,5,6,16,31,55,-24,21
CC Mariners,1861,10,4,8,15,28,49,-21,20
Sydney FC,1862,1,21,4,3,70,22,48,67
N'castle Jet,1862,2,16,5,7,60,38,22,53
Melbourne C,1862,3,14,4,11,44,36,8,46
Melbourne V,1862,4,13,5,11,45,44,1,44
Adelaide Utd,1862,5,11,6,11,37,40,-3,39
Brisbane,1862,6,10,5,13,33,42,-9,35
Western Sydn,1862,7,8,9,10,38,47,-9,33
Perth Glory,1862,8,10,2,15,37,50,-13,32
Wellington P,1862,9,5,6,16,31,55,-24,21
CC Mariners,1862,10,4,8,15,28,49,-21,20
Sydney FC,1863,1,21,4,3,70,23,47,67
N'castle Jet,1863,2,16,5,7,60,38,22,53
Melbourne C,1863,3,14,4,11,44,36,8,46
Melbourne V,1863,4,13,5,11,46,44,2,44
Adelaide Utd,1863,5,11,6,11,37,40,-3,39
Brisbane,1863,6,10,5,13,33,42,-9,35
Western Sydn,1863,7,8,9,10,38,47,-9,33
Perth Glory,1863,8,10,2,15,37,50,-13,32
Wellington P,1863,9,5,6,16,31,55,-24,21
CC Mariners,1863,10,4,8,15,28,49,-21,20
Sydney FC,1864,1,21,4,3,68,22,46,67
N'castle Jet,1864,2,16,5,7,61,37,24,53
Melbourne C,1864,3,14,4,11,43,37,6,46
Melbourne V,1864,4,13,5,11,45,42,3,44
Adelaide Utd,1864,5,11,6,11,37,40,-3,39
Brisbane,1864,6,10,5,13,33,42,-9,35
Western Sydn,1864,7,8,9,10,38,47,-9,33
Perth Glory,1864,8,10,2,15,37,50,-13,32
Wellington P,1864,9,5,6,16,31,55,-24,21
CC Mariners,1864,10,4,8,15,28,49,-21,20
Sydney FC,1865,1,21,4,3,67,23,44,67
N'castle Jet,1865,2,15,6,7,58,38,20,51
Melbourne C,1865,3,14,5,10,44,34,10,47
Melbourne V,1865,4,13,5,11,46,41,5,44
Adelaide Utd,1865,5,11,6,11,37,40,-3,39
Brisbane,1865,6,10,5,13,33,42,-9,35
Western Sydn,1865,7,8,9,10,38,47,-9,33
Perth Glory,1865,8,10,2,15,37,50,-13,32
Wellington P,1865,9,5,6,16,31,55,-24,21
CC Mariners,1865,10,4,8,15,28,49,-21,20
Sydney FC,1866,1,21,4,3,67,24,43,67
N'castle Jet,1866,2,16,5,7,59,38,21,53
Melbourne C,1866,3,14,4,11,44,35,9,46
Melbourne V,1866,4,13,5,11,47,41,6,44
Adelaide Utd,1866,5,11,6,11,37,40,-3,39
Brisbane,1866,6,10,5,13,33,42,-9,35
Western Sydn,1866,7,8,9,10,38,47,-9,33
Perth Glory,1866,8,10,2,15,37,50,-13,32
Wellington P,1866,9,5,6,16,31,55,-24,21
CC Mariners,1866,10,4,8,15,28,49,-21,20
Sydney FC,1867,1,20,5,3,65,23,42,65
N'castle Jet,1867,2,15,6,7,59,39,20,51
Melbourne C,1867,3,14,5,10,45,35,10,47
Melbourne V,1867,4,13,6,10,46,39,7,45
Adelaide Utd,1867,5,11,6,11,37,40,-3,39
Brisbane,1867,6,10,5,13,33,42,-9,35
Western Sydn,1867,7,8,9,10,38,47,-9,33
Perth Glory,1867,8,10,2,15,37,50,-13,32
Wellington P,1867,9,5,6,16,31,55,-24,21
CC Mariners,1867,10,4,8,15,28,49,-21,20
Sydney FC,1868,1,20,4,4,64,23,41,64
N'castle Jet,1868,2,16,5,7,58,37,21,53
Melbourne V,1868,3,14,5,10,46,38,8,47
Melbourne C,1868,4,14,4,11,43,34,9,46
Adelaide Utd,1868,5,11,6,11,37,40,-3,39
Brisbane,1868,6,10,5,13,33,42,-9,35
Western Sydn,1868,7,8,9,10,38,47,-9,33
Perth Glory,1868,8,10,2,15,37,50,-13,32
Wellington P,1868,9,5,6,16,31,55,-24,21
CC Mariners,1868,10,4,8,15,28,49,-21,20
Sydney FC,1869,1,21,4,3,67,22,45,67
N'castle Jet,1869,2,16,5,7,59,37,22,53
Melbourne C,1869,3,14,4,11,43,35,8,46
Melbourne V,1869,4,13,5,11,45,41,4,44
Adelaide Utd,1869,5,11,6,11,37,40,-3,39
Brisbane,1869,6,10,5,13,33,42,-9,35
Western Sydn,1869,7,8,9,10,38,47,-9,33
Perth Glory,1869,8,10,2,15,37,50,-13,32
Wellington P,1869,9,5,6,16,31,55,-24,21
CC Mariners,1869,10,4,8,15,28,49,-21,20
Sydney FC,1870,1,20,5,3,66,24,42,65
N'castle Jet,1870,2,16,5,7,59,38,21,53
Melbourne C,1870,3,14,4,11,44,35,9,46
Melbourne V,1870,4,13,6,10,47,40,7,45
Adelaide Utd,1870,5,11,6,11,37,40,-3,39
Brisbane,1870,6,10,5,13,33,42,-9,35
Western Sydn,1870,7,8,9,10,38,47,-9,33
Perth Glory,1870,8,10,2,15,37,50,-13,32
Wellington P,1870,9,5,6,16,31,55,-24,21
CC Mariners,1870,10,4,8,15,28,49,-21,20
Sydney FC,1871,1,21,4,3,65,22,43,67
N'castle Jet,1871,2,16,5,7,60,38,22,53
Melbourne C,1871,3,14,4,11,44,36,8,46
Melbourne V,1871,4,13,5,11,45,39,6,44
Adelaide Utd,1871,5,11,6,11,37,40,-3,39
Brisbane,1871,6,10,5,13,33,42,-9,35
Western Sydn,1871,7,8,9,10,38,47,-9,33
Perth Glory,1871,8,10,2,15,37,50,-13,32
Wellington P,1871,9,5,6,16,31,55,-24,21
CC Mariners,1871,10,4,8,15,28,49,-21,20
Sydney FC,1872,1,21,4,3,67,22,45,67
N'castle Jet,1872,2,15,5,8,57,38,19,50
Melbourne C,1872,3,15,4,10,44,33,11,49
Melbourne V,1872,4,13,5,11,45,41,4,44
Adelaide Utd,1872,5,11,6,11,37,40,-3,39
Brisbane,1872,6,10,5,13,33,42,-9,35
Western Sydn,1872,7,8,9,10,38,47,-9,33
Perth Glory,1872,8,10,2,15,37,50,-13,32
Wellington P,1872,9,5,6,16,31,55,-24,21
CC Mariners,1872,10,4,8,15,28,49,-21,20
Sydney FC,1873,1,20,4,4,64,23,41,64
N'castle Jet,1873,2,15,5,8,57,38,19,50
Melbourne C,1873,3,15,4,10,44,33,11,49
Melbourne V,1873,4,14,5,10,46,38,8,47
Adelaide Utd,1873,5,11,6,11,37,40,-3,39
Brisbane,1873,6,10,5,13,33,42,-9,35
Western Sydn,1873,7,8,9,10,38,47,-9,33
Perth Glory,1873,8,10,2,15,37,50,-13,32
Wellington P,1873,9,5,6,16,31,55,-24,21
CC Mariners,1873,10,4,8,15,28,49,-21,20
Sydney FC,1874,1,20,4,4,64,26,38,64
N'castle Jet,1874,2,15,5,8,58,40,18,50
Melbourne C,1874,3,15,4,10,46,34,12,49
Melbourne V,1874,4,14,5,10,49,38,11,47
Adelaide Utd,1874,5,11,6,11,37,40,-3,39
Brisbane,1874,6,10,5,13,33,42,-9,35
Western Sydn,1874,7,8,9,10,38,47,-9,33
Perth Glory,1874,8,10,2,15,37,50,-13,32
Wellington P,1874,9,5,6,16,31,55,-24,21
CC Mariners,1874,10,4,8,15,28,49,-21,20
Sydney FC,1875,1,21,4,3,68,23,45,67
N'castle Jet,1875,2,15,5,8,57,40,17,50
Melbourne C,1875,3,15,4,10,46,33,13,49
Melbourne V,1875,4,13,5,11,46,42,4,44
Adelaide Utd,1875,5,11,6,11,37,40,-3,39
Brisbane,1875,6,10,5,13,33,42,-9,35
Western Sydn,1875,7,8,9,10,38,47,-9,33
Perth Glory,1875,8,10,2,15,37,50,-13,32
Wellington P,1875,9,5,6,16,31,55,-24,21
CC Mariners,1875,10,4,8,15,28,49,-21,20
Sydney FC,1876,1,20,5,3,65,23,42,65
N'castle Jet,1876,2,16,5,7,60,38,22,53
Melbourne C,1876,3,14,4,11,44,36,8,46
Melbourne V,1876,4,13,6,10,46,39,7,45
Adelaide Utd,1876,5,11,6,11,37,40,-3,39
Brisbane,1876,6,10,5,13,33,42,-9,35
Western Sydn,1876,7,8,9,10,38,47,-9,33
Perth Glory,1876,8,10,2,15,37,50,-13,32
Wellington P,1876,9,5,6,16,31,55,-24,21
CC Mariners,1876,10,4,8,15,28,49,-21,20
Sydney FC,1877,1,21,4,3,67,24,43,67
N'castle Jet,1877,2,15,6,7,59,39,20,51
Melbourne C,1877,3,14,5,10,45,35,10,47
Melbourne V,1877,4,13,5,11,47,41,6,44
Adelaide Utd,1877,5,11,6,11,37,40,-3,39
Brisbane,1877,6,10,5,13,33,42,-9,35
Western Sydn,1877,7,8,9,10,38,47,-9,33
Perth Glory,1877,8,10,2,15,37,50,-13,32
Wellington P,1877,9,5,6,16,31,55,-24,21
CC Mariners,1877,10,4,8,15,28,49,-21,20
Sydney FC,1878,1,20,5,3,66,24,42,65
N'castle Jet,1878,2,15,5,8,57,38,19,50
Melbourne C,1878,3,15,4,10,44,33,11,49
Melbourne V,1878,4,13,6,10,47,40,7,45
Adelaide Utd,1878,5,11,6,11,37,40,-3,39
Brisbane,1878,6,10,5,13,33,42,-9,35
Western Sydn,1878,7,8,9,10,38,47,-9,33
Perth Glory,1878,8,10,2,15,37,50,-13,32
Wellington P,1878,9,5,6,16,31,55,-24,21
CC Mariners,1878,10,4,8,15,28,49,-21,20
Sydney FC,1879,1,20,5,3,65,23,42,65
N'castle Jet,1879,2,16,5,7,61,38,23,53
Melbourne C,1879,3,14,4,11,44,37,7,46
Melbourne V,1879,4,13,6,10,46,39,7,45
Adelaide Utd,1879,5,11,6,11,37,40,-3,39
Brisbane,1879,6,10,5,13,33,42,-9,35
Western Sydn,1879,7,8,9,10,38,47,-9,33
Perth Glory,1879,8,10,2,15,37,50,-13,32
Wellington P,1879,9,5,6,16,31,55,-24,21
CC Mariners,1879,10,4,8,15,28,49,-21,20
Sydney FC,1880,1,21,4,3,65,22,43,67
N'castle Jet,1880,2,15,5,8,58,39,19,50
Melbourne C,1880,3,15,4,10,45,34,11,49
Melbourne V,1880,4,13,5,11,45,39,6,44
Adelaide Utd,1880,5,11,6,11,37,40,-3,39
Brisbane,1880,6,10,5,13,33,42,-9,35
Western Sydn,1880,7,8,9,10,38,47,-9,33
Perth Glory,1880,8,10,2,15,37,50,-13,32
Wellington P,1880,9,5,6,16,31,55,-24,21
CC Mariners,1880,10,4,8,15,28,49,-21,20
Sydney FC,1881,1,20,4,4,65,24,41,64
N'castle Jet,1881,2,16,5,7,58,37,21,53
Melbourne V,1881,3,14,5,10,47,39,8,47
Melbourne C,1881,4,14,4,11,43,34,9,46
Adelaide Utd,1881,5,11,6,11,37,40,-3,39
Brisbane,1881,6,10,5,13,33,42,-9,35
Western Sydn,1881,7,8,9,10,38,47,-9,33
Perth Glory,1881,8,10,2,15,37,50,-13,32
Wellington P,1881,9,5,6,16,31,55,-24,21
CC Mariners,1881,10,4,8,15,28,49,-21,20
Sydney FC,1882,1,20,4,4,65,24,41,64
N'castle Jet,1882,2,16,5,7,61,39,22,53
Melbourne V,1882,3,14,5,10,47,39,8,47
Melbourne C,1882,4,14,4,11,45,37,8,46
Adelaide Utd,1882,5,11,6,11,37,40,-3,39
Brisbane,1882,6,10,5,13,33,42,-9,35
Western Sydn,1882,7,8,9,10,38,47,-9,33
Perth Glory,1882,8,10,2,15,37,50,-13,32
Wellington P,1882,9,5,6,16,31,55,-24,21
CC Mariners,1882,10,4,8,15,28,49,-21,20
Sydney FC,1883,1,21,4,3,67,23,44,67
N'castle Jet,1883,2,16,5,7,62,37,25,53
Melbourne C,1883,3,14,4,11,43,38,5,46
Melbourne V,1883,4,13,5,11,46,41,5,44
Adelaide Utd,1883,5,11,6,11,37,40,-3,39
Brisbane,1883,6,10,5,13,33,42,-9,35
Western Sydn,1883,7,8,9,10,38,47,-9,33
Perth Glory,1883,8,10,2,15,37,50,-13,32
Wellington P,1883,9,5,6,16,31,55,-24,21
CC Mariners,1883,10,4,8,15,28,49,-21,20
Sydney FC,1884,1,20,4,4,66,25,41,64
N'castle Jet,1884,2,16,5,7,59,38,21,53
Melbourne V,1884,3,14,5,10,48,40,8,47
Melbourne C,1884,4,14,4,11,44,35,9,46
Adelaide Utd,1884,5,11,6,11,37,40,-3,39
Brisbane,1884,6,10,5,13,33,42,-9,35
Western Sydn,1884,7,8,9,10,38,47,-9,33
Perth Glory,1884,8,10,2,15,37,50,-13,32
Wellington P,1884,9,5,6,16,31,55,-24,21
CC Mariners,1884,10,4,8,15,28,49,-21,20
Sydney FC,1885,1,21,4,3,67,22,45,67
N'castle Jet,1885,2,16,5,7,58,37,21,53
Melbourne C,1885,3,14,4,11,43,34,9,46
Melbourne V,1885,4,13,5,11,45,41,4,44
Adelaide Utd,1885,5,11,6,11,37,40,-3,39
Brisbane,1885,6,10,5,13,33,42,-9,35
Western Sydn,1885,7,8,9,10,38,47,-9,33
Perth Glory,1885,8,10,2,15,37,50,-13,32
Wellington P,1885,9,5,6,16,31,55,-24,21
CC Mariners,1885,10,4,8,15,28,49,-21,20
Sydney FC,1886,1,20,5,3,65,23,42,65
N'castle Jet,1886,2,16,5,7,59,38,21,53
Melbourne C,1886,3,14,4,11,44,35,9,46
Melbourne V,1886,4,13,6,10,46,39,7,45
Adelaide Utd,1886,5,11,6,11,37,40,-3,39
Brisbane,1886,6,10,5,13,33,42,-9,35
Western Sydn,1886,7,8,9,10,38,47,-9,33
Perth Glory,1886,8,10,2,15,37,50,-13,32
Wellington P,1886,9,5,6,16,31,55,-24,21
CC Mariners,1886,10,4,8,15,28,49,-21,20
Sydney FC,1887,1,21,4,3,65,22,43,67
N'castle Jet,1887,2,15,6,7,57,37,20,51
Melbourne C,1887,3,14,5,10,43,33,10,47
Melbourne V,1887,4,13,5,11,45,39,6,44
Adelaide Utd,1887,5,11,6,11,37,40,-3,39
Brisbane,1887,6,10,5,13,33,42,-9,35
Western Sydn,1887,7,8,9,10,38,47,-9,33
Perth Glory,1887,8,10,2,15,37,50,-13,32
Wellington P,1887,9,5,6,16,31,55,-24,21
CC Mariners,1887,10,4,8,15,28,49,-21,20
Sydney FC,1888,1,21,4,3,66,23,43,67
N'castle Jet,1888,2,16,5,7,59,37,22,53
Melbourne C,1888,3,14,4,11,43,35,8,46
Melbourne V,1888,4,13,5,11,46,40,6,44
Adelaide Utd,1888,5,11,6,11,37,40,-3,39
Brisbane,1888,6,10,5,13,33,42,-9,35
Western Sydn,1888,7,8,9,10,38,47,-9,33
Perth Glory,1888,8,10,2,15,37,50,-13,32
Wellington P,1888,9,5,6,16,31,55,-24,21
CC Mariners,1888,10,4,8,15,28,49,-21,20
Sydney FC,1889,1,20,4,4,64,23,41,64
N'castle Jet,1889,2,16,5,7,58,37,21,53
Melbourne V,1889,3,14,5,10,46,38,8,47
Melbourne C,1889,4,14,4,11,43,34,9,46
Adelaide Utd,1889,5,11,6,11,37,40,-3,39
Brisbane,1889,6,10,5,13,33,42,-9,35
Western Sydn,1889,7,8,9,10,38,47,-9,33
Perth Glory,1889,8,10,2,15,37,50,-13,32
Wellington P,1889,9,5,6,16,31,55,-24,21
CC Mariners,1889,10,4,8,15,28,49,-21,20
Sydney FC,1890,1,21,4,3,65,22,43,67
N'castle Jet,1890,2,15,5,8,57,38,19,50
Melbourne C,1890,3,15,4,10,44,33,11,49
Melbourne V,1890,4,13,5,11,45,39,6,44
Adelaide Utd,1890,5,11,6,11,37,40,-3,39
Brisbane,1890,6,10,5,13,33,42,-9,35
Western Sydn,1890,7,8,9,10,38,47,-9,33
Perth Glory,1890,8,10,2,15,37,50,-13,32
Wellington P,1890,9,5,6,16,31,55,-24,21
CC Mariners,1890,10,4,8,15,28,49,-21,20
Sydney FC,1891,1,20,4,4,64,23,41,64
N'castle Jet,1891,2,16,5,7,58,37,21,53
Melbourne V,1891,3,14,5,10,46,38,8,47
Melbourne C,1891,4,14,4,11,43,34,9,46
Adelaide Utd,1891,5,11,6,11,37,40,-3,39
Brisbane,1891,6,10,5,13,33,42,-9,35
Western Sydn,1891,7,8,9,10,38,47,-9,33
Perth Glory,1891,8,10,2,15,37,50,-13,32
Wellington P,1891,9,5,6,16,31,55,-24,21
CC Mariners,1891,10,4,8,15,28,49,-21,20
Sydney FC,1892,1,21,4,3,67,22,45,67
N'castle Jet,1892,2,16,5,7,62,37,25,53
Melbourne C,1892,3,14,4,11,43,38,5,46
Melbourne V,1892,4,13,5,11,45,41,4,44
Adelaide Utd,1892,5,11,6,11,37,40,-3,39
Brisbane,1892,6,10,5,13,33,42,-9,35
Western Sydn,1892,7,8,9,10,38,47,-9,33
Perth Glory,1892,8,10,2,15,37,50,-13,32
Wellington P,1892,9,5,6,16,31,55,-24,21
CC Mariners,1892,10,4,8,15,28,49,-21,20
Sydney FC,1893,1,21,4,3,67,23,44,67
N'castle Jet,1893,2,15,5,8,59,40,19,50
Melbourne C,1893,3,15,4,10,46,35,11,49
Melbourne V,1893,4,13,5,11,46,41,5,44
Adelaide Utd,1893,5,11,6,11,37,40,-3,39
Brisbane,1893,6,10,5,13,33,42,-9,35
Western Sydn,1893,7,8,9,10,38,47,-9,33
Perth Glory,1893,8,10,2,15,37,50,-13,32
Wellington P,1893,9,5,6,16,31,55,-24,21
CC Mariners,1893,10,4,8,15,28,49,-21,20
Sydney FC,1894,1,20,5,3,64,22,42,65
N'castle Jet,1894,2,16,5,7,62,38,24,53
Melbourne C,1894,3,14,4,11,44,38,6,46
Melbourne V,1894,4,13,6,10,45,38,7,45
Adelaide Utd,1894,5,11,6,11,37,40,-3,39
Brisbane,1894,6,10,5,13,33,42,-9,35
Western Sydn,1894,7,8,9,10,38,47,-9,33
Perth Glory,1894,8,10,2,15,37,50,-13,32
Wellington P,1894,9,5,6,16,31,55,-24,21
CC Mariners,1894,10,4,8,15,28,49,-21,20
Sydney FC,1895,1,21,4,3,65,22,43,67
N'castle Jet,1895,2,16,5,7,60,39,21,53
Melbourne C,1895,3,14,4,11,45,36,9,46
Melbourne V,1895,4,13,5,11,45,39,6,44
Adelaide Utd,1895,5,11,6,11,37,40,-3,39
Brisbane,1895,6,10,5,13,33,42,-9,35
Western Sydn,1895,7,8,9,10,38,47,-9,33
Perth Glory,1895,8,10,2,15,37,50,-13,32
Wellington P,1895,9,5,6,16,31,55,-24,21
CC Mariners,1895,10,4,8,15,28,49,-21,20
Sydney FC,1896,1,21,4,3,67,23,44,67
N'castle Jet,1896,2,15,6,7,57,37,20,51
Melbourne C,1896,3,14,5,10,43,33,10,47
Melbourne V,1896,4,13,5,11,46,41,5,44
Adelaide Utd,1896,5,11,6,11,37,40,-3,39
Brisbane,1896,6,10,5,13,33,42,-9,35
Western Sydn,1896,7,8,9,10,38,47,-9,33
Perth Glory,1896,8,10,2,15,37,50,-13,32
Wellington P,1896,9,5,6,16,31,55,-24,21
CC Mariners,1896,10,4,8,15,28,49,-21,20
Sydney FC,1897,1,21,4,3,66,23,43,67
N'castle Jet,1897,2,15,5,8,57,42,15,50
Melbourne C,1897,3,15,4,10,48,33,15,49
Melbourne V,1897,4,13,5,11,46,40,6,44
Adelaide Utd,1897,5,11,6,11,37,40,-3,39
Brisbane,1897,6,10,5,13,33,42,-9,35
Western Sydn,1897,7,8,9,10,38,47,-9,33
Perth Glory,1897,8,10,2,15,37,50,-13,32
Wellington P,1897,9,5,6,16,31,55,-24,21
CC Mariners,1897,10,4,8,15,28,49,-21,20
Sydney FC,1898,1,20,4,4,64,23,41,64
N'castle Jet,1898,2,15,6,7,59,39,20,51
Melbourne C,1898,3,14,5,10,45,35,10,47
Melbourne V,1898,4,14,5,10,46,38,8,47
Adelaide Utd,1898,5,11,6,11,37,40,-3,39
Brisbane,1898,6,10,5,13,33,42,-9,35
Western Sydn,1898,7,8,9,10,38,47,-9,33
Perth Glory,1898,8,10,2,15,37,50,-13,32
Wellington P,1898,9,5,6,16,31,55,-24,21
CC Mariners,1898,10,4,8,15,28,49,-21,20
Sydney FC,1899,1,21,4,3,67,24,43,67
N'castle Jet,1899,2,16,5,7,58,37,21,53
Melbourne C,1899,3,14,4,11,43,34,9,46
Melbourne V,1899,4,13,5,11,47,41,6,44
Adelaide Utd,1899,5,11,6,11,37,40,-3,39
Brisbane,1899,6,10,5,13,33,42,-9,35
Western Sydn,1899,7,8,9,10,38,47,-9,33
Perth Glory,1899,8,10,2,15,37,50,-13,32
Wellington P,1899,9,5,6,16,31,55,-24,21
CC Mariners,1899,10,4,8,15,28,49,-21,20
Sydney FC,1900,1,21,4,3,65,22,43,67
N'castle Jet,1900,2,16,5,7,59,37,22,53
Melbourne C,1900,3,14,4,11,43,35,8,46
Melbourne V,1900,4,13,5,11,45,39,6,44
Adelaide Utd,1900,5,11,6,11,37,40,-3,39
Brisbane,1900,6,10,5,13,33,42,-9,35
Western Sydn,1900,7,8,9,10,38,47,-9,33
Perth Glory,1900,8,10,2,15,37,50,-13,32
Wellington P,1900,9,5,6,16,31,55,-24,21
CC Mariners,1900,10,4,8,15,28,49,-21,20
Sydney FC,1901,1,20,5,3,64,22,42,65
N'castle Jet,1901,2,15,5,8,57,38,19,50
Melbourne C,1901,3,15,4,10,44,33,11,49
Melbourne V,1901,4,13,6,10,45,38,7,45
Adelaide Utd,1901,5,11,6,11,37,40,-3,39
Brisbane,1901,6,10,5,13,33,42,-9,35
Western Sydn,1901,7,8,9,10,38,47,-9,33
Perth Glory,1901,8,10,2,15,37,50,-13,32
Wellington P,1901,9,5,6,16,31,55,-24,21
CC Mariners,1901,10,4,8,15,28,49,-21,20
Sydney FC,1902,1,20,5,3,65,23,42,65
N'castle Jet,1902,2,16,5,7,58,37,21,53
Melbourne C,1902,3,14,4,11,43,34,9,46
Melbourne V,1902,4,13,6,10,46,39,7,45
Adelaide Utd,1902,5,11,6,11,37,40,-3,39
Brisbane,1902,6,10,5,13,33,42,-9,35
Western Sydn,1902,7,8,9,10,38,47,-9,33
Perth Glory,1902,8,10,2,15,37,50,-13,32
Wellington P,1902,9,5,6,16,31,55,-24,21
CC Mariners,1902,10,4,8,15,28,49,-21,20
Sydney FC,1903,1,21,4,3,67,23,44,67
N'castle Jet,1903,2,16,5,7,58,37,21,53
Melbourne C,1903,3,14,4,11,43,34,9,46
Melbourne V,1903,4,13,5,11,46,41,5,44
Adelaide Utd,1903,5,11,6,11,37,40,-3,39
Brisbane,1903,6,10,5,13,33,42,-9,35
Western Sydn,1903,7,8,9,10,38,47,-9,33
Perth Glory,1903,8,10,2,15,37,50,-13,32
Wellington P,1903,9,5,6,16,31,55,-24,21
CC Mariners,1903,10,4,8,15,28,49,-21,20
Sydney FC,1904,1,21,4,3,67,23,44,67
N'castle Jet,1904,2,15,6,7,57,37,20,51
Melbourne C,1904,3,14,5,10,43,33,10,47
Melbourne V,1904,4,13,5,11,46,41,5,44
Adelaide Utd,1904,5,11,6,11,37,40,-3,39
Brisbane,1904,6,10,5,13,33,42,-9,35
Western Sydn,1904,7,8,9,10,38,47,-9,33
Perth Glory,1904,8,10,2,15,37,50,-13,32
Wellington P,1904,9,5,6,16,31,55,-24,21
CC Mariners,1904,10,4,8,15,28,49,-21,20
Sydney FC,1905,1,21,4,3,69,25,44,67
N'castle Jet,1905,2,16,5,7,59,38,21,53
Melbourne C,1905,3,14,4,11,44,35,9,46
Melbourne V,1905,4,13,5,11,48,43,5,44
Adelaide Utd,1905,5,11,6,11,37,40,-3,39
Brisbane,1905,6,10,5,13,33,42,-9,35
Western Sydn,1905,7,8,9,10,38,47,-9,33
Perth Glory,1905,8,10,2,15,37,50,-13,32
Wellington P,1905,9,5,6,16,31,55,-24,21
CC Mariners,1905,10,4,8,15,28,49,-21,20
Sydney FC,1906,1,20,5,3,65,23,42,65
N'castle Jet,1906,2,15,5,8,58,41,17,50
Melbourne C,1906,3,15,4,10,47,34,13,49
Melbourne V,1906,4,13,6,10,46,39,7,45
Adelaide Utd,1906,5,11,6,11,37,40,-3,39
Brisbane,1906,6,10,5,13,33,42,-9,35
Western Sydn,1906,7,8,9,10,38,47,-9,33
Perth Glory,1906,8,10,2,15,37,50,-13,32
Wellington P,1906,9,5,6,16,31,55,-24,21
CC Mariners,1906,10,4,8,15,28,49,-21,20
Sydney FC,1907,1,21,4,3,67,22,45,67
N'castle Jet,1907,2,15,6,7,58,38,20,51
Melbourne C,1907,3,14,5,10,44,34,10,47
Melbourne V,1907,4,13,5,11,45,41,4,44
Adelaide Utd,1907,5,11,6,11,37,40,-3,39
Brisbane,1907,6,10,5,13,33,42,-9,35
Western Sydn,1907,7,8,9,10,38,47,-9,33
Perth Glory,1907,8,10,2,15,37,50,-13,32
Wellington P,1907,9,5,6,16,31,55,-24,21
CC Mariners,1907,10,4,8,15,28,49,-21,20
Sydney FC,1908,1,21,4,3,66,23,43,67
N'castle Jet,1908,2,15,5,8,58,39,19,50
Melbourne C,1908,3,15,4,10,45,34,11,49
Melbourne V,1908,4,13,5,11,46,40,6,44
Adelaide Utd,1908,5,11,6,11,37,40,-3,39
Brisbane,1908,6,10,5,13,33,42,-9,35
Western Sydn,1908,7,8,9,10,38,47,-9,33
Perth Glory,1908,8,10,2,15,37,50,-13,32
Wellington P,1908,9,5,6,16,31,55,-24,21
CC Mariners,1908,10,4,8,15,28,49,-21,20
Sydney FC,1909,1,21,4,3,66,23,43,67
N'castle Jet,1909,2,16,5,7,59,38,21,53
Melbourne C,1909,3,14,4,11,44,35,9,46
Melbourne V,1909,4,13,5,11,46,40,6,44
Adelaide Utd,1909,5,11,6,11,37,40,-3,39
Brisbane,1909,6,10,5,13,33,42,-9,35
Western Sydn,1909,7,8,9,10,38,47,-9,33
Perth Glory,1909,8,10,2,15,37,50,-13,32
Wellington P,1909,9,5,6,16,31,55,-24,21
CC Mariners,1909,10,4,8,15,28,49,-21,20
Sydney FC,1910,1,20,5,3,67,25,42,65
N'castle Jet,1910,2,15,5,8,58,41,17,50
Melbourne C,1910,3,15,4,10,47,34,13,49
Melbourne V,1910,4,13,6,10,48,41,7,45
Adelaide Utd,1910,5,11,6,11,37,40,-3,39
Brisbane,1910,6,10,5,13,33,42,-9,35
Western Sydn,1910,7,8,9,10,38,47,-9,33
Perth Glory,1910,8,10,2,15,37,50,-13,32
Wellington P,1910,9,5,6,16,31,55,-24,21
CC Mariners,1910,10,4,8,15,28,49,-21,20
Sydney FC,1911,1,20,5,3,65,23,42,65
N'castle Jet,1911,2,16,5,7,59,37,22,53
Melbourne C,1911,3,14,4,11,43,35,8,46
Melbourne V,1911,4,13,6,10,46,39,7,45
Adelaide Utd,1911,5,11,6,11,37,40,-3,39
Brisbane,1911,6,10,5,13,33,42,-9,35
Western Sydn,1911,7,8,9,10,38,47,-9,33
Perth Glory,1911,8,10,2,15,37,50,-13,32
Wellington P,1911,9,5,6,16,31,55,-24,21
CC Mariners,1911,10,4,8,15,28,49,-21,20
Sydney FC,1912,1,21,4,3,66,23,43,67
N'castle Jet,1912,2,16,5,7,61,38,23,53
Melbourne C,1912,3,14,4,11,44,37,7,46
Melbourne V,1912,4,13,5,11,46,40,6,44
Adelaide Utd,1912,5,11,6,11,37,40,-3,39
Brisbane,1912,6,10,5,13,33,42,-9,35
Western Sydn,1912,7,8,9,10,38,47,-9,33
Perth Glory,1912,8,10,2,15,37,50,-13,32
Wellington P,1912,9,5,6,16,31,55,-24,21
CC Mariners,1912,10,4,8,15,28,49,-21,20
Sydney FC,1913,1,21,4,3,67,24,43,67
N'castle Jet,1913,2,16,5,7,58,37,21,53
Melbourne C,1913,3,14,4,11,43,34,9,46
Melbourne V,1913,4,13,5,11,47,41,6,44
Adelaide Utd,1913,5,11,6,11,37,40,-3,39
Brisbane,1913,6,10,5,13,33,42,-9,35
Western Sydn,1913,7,8,9,10,38,47,-9,33
Perth Glory,1913,8,10,2,15,37,50,-13,32
Wellington P,1913,9,5,6,16,31,55,-24,21
CC Mariners,1913,10,4,8,15,28,49,-21,20
Sydney FC,1914,1,21,4,3,67,23,44,67
N'castle Jet,1914,2,15,6,7,58,38,20,51
Melbourne C,1914,3,14,5,10,44,34,10,47
Melbourne V,1914,4,13,5,11,46,41,5,44
Adelaide Utd,1914,5,11,6,11,37,40,-3,39
Brisbane,1914,6,10,5,13,33,42,-9,35
Western Sydn,1914,7,8,9,10,38,47,-9,33
Perth Glory,1914,8,10,2,15,37,50,-13,32
Wellington P,1914,9,5,6,16,31,55,-24,21
CC Mariners,1914,10,4,8,15,28,49,-21,20
Sydney FC,1915,1,21,4,3,68,22,46,67
N'castle Jet,1915,2,16,5,7,60,37,23,53
Melbourne C,1915,3,14,4,11,43,36,7,46
Melbourne V,1915,4,13,5,11,45,42,3,44
Adelaide Utd,1915,5,11,6,11,37,40,-3,39
Brisbane,1915,6,10,5,13,33,42,-9,35
Western Sydn,1915,7,8,9,10,38,47,-9,33
Perth Glory,1915,8,10,2,15,37,50,-13,32
Wellington P,1915,9,5,6,16,31,55,-24,21
CC Mariners,1915,10,4,8,15,28,49,-21,20
Sydney FC,1916,1,21,4,3,67,23,44,67
N'castle Jet,1916,2,15,6,7,58,38,20,51
Melbourne C,1916,3,14,5,10,44,34,10,47
Melbourne V,1916,4,13,5,11,46,41,5,44
Adelaide Utd,1916,5,11,6,11,37,40,-3,39
Brisbane,1916,6,10,5,13,33,42,-9,35
Western Sydn,1916,7,8,9,10,38,47,-9,33
Perth Glory,1916,8,10,2,15,37,50,-13,32
Wellington P,1916,9,5,6,16,31,55,-24,21
CC Mariners,1916,10,4,8,15,28,49,-21,20
Sydney FC,1917,1,21,4,3,67,23,44,67
N'castle Jet,1917,2,16,5,7,60,38,22,53
Melbourne C,1917,3,14,4,11,44,36,8,46
Melbourne V,1917,4,13,5,11,46,41,5,44
Adelaide Utd,1917,5,11,6,11,37,40,-3,39
Brisbane,1917,6,10,5,13,33,42,-9,35
Western Sydn,1917,7,8,9,10,38,47,-9,33
Perth Glory,1917,8,10,2,15,37,50,-13,32
Wellington P,1917,9,5,6,16,31,55,-24,21
CC Mariners,1917,10,4,8,15,28,49,-21,20
Sydney FC,1918,1,21,4,3,68,22,46,67
N'castle Jet,1918,2,16,5,7,59,38,21,53
Melbourne C,1918,3,14,4,11,44,35,9,46
Melbourne V,1918,4,13,5,11,45,42,3,44
Adelaide Utd,1918,5,11,6,11,37,40,-3,39
Brisbane,1918,6,10,5,13,33,42,-9,35
Western Sydn,1918,7,8,9,10,38,47,-9,33
Perth Glory,1918,8,10,2,15,37,50,-13,32
Wellington P,1918,9,5,6,16,31,55,-24,21
CC Mariners,1918,10,4,8,15,28,49,-21,20
Sydney FC,1919,1,21,4,3,66,22,44,67
N'castle Jet,1919,2,16,5,7,60,38,22,53
Melbourne C,1919,3,14,4,11,44,36,8,46
Melbourne V,1919,4,13,5,11,45,40,5,44
Adelaide Utd,1919,5,11,6,11,37,40,-3,39
Brisbane,1919,6,10,5,13,33,42,-9,35
Western Sydn,1919,7,8,9,10,38,47,-9,33
Perth Glory,1919,8,10,2,15,37,50,-13,32
Wellington P,1919,9,5,6,16,31,55,-24,21
CC Mariners,1919,10,4,8,15,28,49,-21,20
Sydney FC,1920,1,21,4,3,65,22,43,67
N'castle Jet,1920,2,15,6,7,58,38,20,51
Melbourne C,1920,3,14,5,10,44,34,10,47
Melbourne V,1920,4,13,5,11,45,39,6,44
Adelaide Utd,1920,5,11,6,11,37,40,-3,39
Brisbane,1920,6,10,5,13,33,42,-9,35
Western Sydn,1920,7,8,9,10,38,47,-9,33
Perth Glory,1920,8,10,2,15,37,50,-13,32
Wellington P,1920,9,5,6,16,31,55,-24,21
CC Mariners,1920,10,4,8,15,28,49,-21,20
Sydney FC,1921,1,20,4,4,64,25,39,64
N'castle Jet,1921,2,16,5,7,59,38,21,53
Melbourne V,1921,3,14,5,10,48,38,10,47
Melbourne C,1921,4,14,4,11,44,35,9,46
Adelaide Utd,1921,5,11,6,11,37,40,-3,39
Brisbane,1921,6,10,5,13,33,42,-9,35
Western Sydn,1921,7,8,9,10,38,47,-9,33
Perth Glory,1921,8,10,2,15,37,50,-13,32
Wellington P,1921,9,5,6,16,31,55,-24,21
CC Mariners,1921,10,4,8,15,28,49,-21,20
Sydney FC,1922,1,21,4,3,68,23,45,67
N'castle Jet,1922,2,16,5,7,59,37,22,53
Melbourne C,1922,3,14,4,11,43,35,8,46
Melbourne V,1922,4,13,5,11,46,42,4,44
Adelaide Utd,1922,5,11,6,11,37,40,-3,39
Brisbane,1922,6,10,5,13,33,42,-9,35
Western Sydn,1922,7,8,9,10,38,47,-9,33
Perth Glory,1922,8,10,2,15,37,50,-13,32
Wellington P,1922,9,5,6,16,31,55,-24,21
CC Mariners,1922,10,4,8,15,28,49,-21,20
Sydney FC,1923,1,21,4,3,67,23,44,67
N'castle Jet,1923,2,16,5,7,58,37,21,53
Melbourne C,1923,3,14,4,11,43,34,9,46
Melbourne V,1923,4,13,5,11,46,41,5,44
Adelaide Utd,1923,5,11,6,11,37,40,-3,39
Brisbane,1923,6,10,5,13,33,42,-9,35
Western Sydn,1923,7,8,9,10,38,47,-9,33
Perth Glory,1923,8,10,2,15,37,50,-13,32
Wellington P,1923,9,5,6,16,31,55,-24,21
CC Mariners,1923,10,4,8,15,28,49,-21,20
Sydney FC,1924,1,21,4,3,71,24,47,67
N'castle Jet,1924,2,16,5,7,60,39,21,53
Melbourne C,1924,3,14,4,11,45,36,9,46
Melbourne V,1924,4,13,5,11,47,45,2,44
Adelaide Utd,1924,5,11,6,11,37,40,-3,39
Brisbane,1924,6,10,5,13,33,42,-9,35
Western Sydn,1924,7,8,9,10,38,47,-9,33
Perth Glory,1924,8,10,2,15,37,50,-13,32
Wellington P,1924,9,5,6,16,31,55,-24,21
CC Mariners,1924,10,4,8,15,28,49,-21,20
Sydney FC,1925,1,21,4,3,67,22,45,67
N'castle Jet,1925,2,15,6,7,59,39,20,51
Melbourne C,1925,3,14,5,10,45,35,10,47
Melbourne V,1925,4,13,5,11,45,41,4,44
Adelaide Utd,1925,5,11,6,11,37,40,-3,39
Brisbane,1925,6,10,5,13,33,42,-9,35
Western Sydn,1925,7,8,9,10,38,47,-9,33
Perth Glory,1925,8,10,2,15,37,50,-13,32
Wellington P,1925,9,5,6,16,31,55,-24,21
CC Mariners,1925,10,4,8,15,28,49,-21,20
Sydney FC,1926,1,21,4,3,66,23,43,67
N'castle Jet,1926,2,16,5,7,61,37,24,53
Melbourne C,1926,3,14,4,11,43,37,6,46
Melbourne V,1926,4,13,5,11,46,40,6,44
Adelaide Utd,1926,5,11,6,11,37,40,-3,39
Brisbane,1926,6,10,5,13,33,42,-9,35
Western Sydn,1926,7,8,9,10,38,47,-9,33
Perth Glory,1926,8,10,2,15,37,50,-13,32
Wellington P,1926,9,5,6,16,31,55,-24,21
CC Mariners,1926,10,4,8,15,28,49,-21,20
Sydney FC,1927,1,21,4,3,67,22,45,67
N'castle Jet,1927,2,16,5,7,60,39,21,53
Melbourne C,1927,3,14,4,11,45,36,9,46
Melbourne V,1927,4,13,5,11,45,41,4,44
Adelaide Utd,1927,5,11,6,11,37,40,-3,39
Brisbane,1927,6,10,5,13,33,42,-9,35
Western Sydn,1927,7,8,9,10,38,47,-9,33
Perth Glory,1927,8,10,2,15,37,50,-13,32
Wellington P,1927,9,5,6,16,31,55,-24,21
CC Mariners,1927,10,4,8,15,28,49,-21,20
Sydney FC,1928,1,21,4,3,68,22,46,67
N'castle Jet,1928,2,15,6,7,58,38,20,51
Melbourne C,1928,3,14,5,10,44,34,10,47
Melbourne V,1928,4,13,5,11,45,42,3,44
Adelaide Utd,1928,5,11,6,11,37,40,-3,39
Brisbane,1928,6,10,5,13,33,42,-9,35
Western Sydn,1928,7,8,9,10,38,47,-9,33
Perth Glory,1928,8,10,2,15,37,50,-13,32
Wellington P,1928,9,5,6,16,31,55,-24,21
CC Mariners,1928,10,4,8,15,28,49,-21,20
Sydney FC,1929,1,21,4,3,67,23,44,67
N'castle Jet,1929,2,16,5,7,59,37,22,53
Melbourne C,1929,3,14,4,11,43,35,8,46
Melbourne V,1929,4,13,5,11,46,41,5,44
Adelaide Utd,1929,5,11,6,11,37,40,-3,39
Brisbane,1929,6,10,5,13,33,42,-9,35
Western Sydn,1929,7,8,9,10,38,47,-9,33
Perth Glory,1929,8,10,2,15,37,50,-13,32
Wellington P,1929,9,5,6,16,31,55,-24,21
CC Mariners,1929,10,4,8,15,28,49,-21,20
Sydney FC,1930,1,20,4,4,64,25,39,64
N'castle Jet,1930,2,16,5,7,60,38,22,53
Melbourne V,1930,3,14,5,10,48,38,10,47
Melbourne C,1930,4,14,4,11,44,36,8,46
Adelaide Utd,1930,5,11,6,11,37,40,-3,39
Brisbane,1930,6,10,5,13,33,42,-9,35
Western Sydn,1930,7,8,9,10,38,47,-9,33
Perth Glory,1930,8,10,2,15,37,50,-13,32
Wellington P,1930,9,5,6,16,31,55,-24,21
CC Mariners,1930,10,4,8,15,28,49,-21,20
Sydney FC,1931,1,21,4,3,66,23,43,67
N'castle Jet,1931,2,16,5,7,59,38,21,53
Melbourne C,1931,3,14,4,11,44,35,9,46
Melbourne V,1931,4,13,5,11,46,40,6,44
Adelaide Utd,1931,5,11,6,11,37,40,-3,39
Brisbane,1931,6,10,5,13,33,42,-9,35
Western Sydn,1931,7,8,9,10,38,47,-9,33
Perth Glory,1931,8,10,2,15,37,50,-13,32
Wellington P,1931,9,5,6,16,31,55,-24,21
CC Mariners,1931,10,4,8,15,28,49,-21,20
Sydney FC,1932,1,20,5,3,65,23,42,65
N'castle Jet,1932,2,15,5,8,57,41,16,50
Melbourne C,1932,3,15,4,10,47,33,14,49
Melbourne V,1932,4,13,6,10,46,39,7,45
Adelaide Utd,1932,5,11,6,11,37,40,-3,39
Brisbane,1932,6,10,5,13,33,42,-9,35
Western Sydn,1932,7,8,9,10,38,47,-9,33
Perth Glory,1932,8,10,2,15,37,50,-13,32
Wellington P,1932,9,5,6,16,31,55,-24,21
CC Mariners,1932,10,4,8,15,28,49,-21,20
Sydney FC,1933,1,20,5,3,66,24,42,65
N'castle Jet,1933,2,15,5,8,58,41,17,50
Melbourne C,1933,3,15,4,10,47,34,13,49
Melbourne V,1933,4,13,6,10,47,40,7,45
Adelaide Utd,1933,5,11,6,11,37,40,-3,39
Brisbane,1933,6,10,5,13,33,42,-9,35
Western Sydn,1933,7,8,9,10,38,47,-9,33
Perth Glory,1933,8,10,2,15,37,50,-13,32
Wellington P,1933,9,5,6,16,31,55,-24,21
CC Mariners,1933,10,4,8,15,28,49,-21,20
Sydney FC,1934,1,21,4,3,66,23,43,67
N'castle Jet,1934,2,16,5,7,60,37,23,53
Melbourne C,1934,3,14,4,11,43,36,7,46
Melbourne V,1934,4,13,5,11,46,40,6,44
Adelaide Utd,1934,5,11,6,11,37,40,-3,39
Brisbane,1934,6,10,5,13,33,42,-9,35
Western Sydn,1934,7,8,9,10,38,47,-9,33
Perth Glory,1934,8,10,2,15,37,50,-13,32
Wellington P,1934,9,5,6,16,31,55,-24,21
CC Mariners,1934,10,4,8,15,28,49,-21,20
Sydney FC,1935,1,21,4,3,67,22,45,67
N'castle Jet,1935,2,16,5,7,60,37,23,53
Melbourne C,1935,3,14,4,11,43,36,7,46
Melbourne V,1935,4,13,5,11,45,41,4,44
Adelaide Utd,1935,5,11,6,11,37,40,-3,39
Brisbane,1935,6,10,5,13,33,42,-9,35
Western Sydn,1935,7,8,9,10,38,47,-9,33
Perth Glory,1935,8,10,2,15,37,50,-13,32
Wellington P,1935,9,5,6,16,31,55,-24,21
CC Mariners,1935,10,4,8,15,28,49,-21,20
Sydney FC,1936,1,21,4,3,66,23,43,67
N'castle Jet,1936,2,15,5,8,59,41,18,50
Melbourne C,1936,3,15,4,10,47,35,12,49
Melbourne V,1936,4,13,5,11,46,40,6,44
Adelaide Utd,1936,5,11,6,11,37,40,-3,39
Brisbane,1936,6,10,5,13,33,42,-9,35
Western Sydn,1936,7,8,9,10,38,47,-9,33
Perth Glory,1936,8,10,2,15,37,50,-13,32
Wellington P,1936,9,5,6,16,31,55,-24,21
CC Mariners,1936,10,4,8,15,28,49,-21,20
Sydney FC,1937,1,21,4,3,65,22,43,67
N'castle Jet,1937,2,16,5,7,62,39,23,53
Melbourne C,1937,3,14,4,11,45,38,7,46
Melbourne V,1937,4,13,5,11,45,39,6,44
Adelaide Utd,1937,5,11,6,11,37,40,-3,39
Brisbane,1937,6,10,5,13,33,42,-9,35
Western Sydn,1937,7,8,9,10,38,47,-9,33
Perth Glory,1937,8,10,2,15,37,50,-13,32
Wellington P,1937,9,5,6,16,31,55,-24,21
CC Mariners,1937,10,4,8,15,28,49,-21,20
Sydney FC,1938,1,20,4,4,64,23,41,64
N'castle Jet,1938,2,16,5,7,60,37,23,53
Melbourne V,1938,3,14,5,10,46,38,8,47
Melbourne C,1938,4,14,4,11,43,36,7,46
Adelaide Utd,1938,5,11,6,11,37,40,-3,39
Brisbane,1938,6,10,5,13,33,42,-9,35
Western Sydn,1938,7,8,9,10,38,47,-9,33
Perth Glory,1938,8,10,2,15,37,50,-13,32
Wellington P,1938,9,5,6,16,31,55,-24,21
CC Mariners,1938,10,4,8,15,28,49,-21,20
Sydney FC,1939,1,21,4,3,67,22,45,67
N'castle Jet,1939,2,16,5,7,61,38,23,53
Melbourne C,1939,3,14,4,11,44,37,7,46
Melbourne V,1939,4,13,5,11,45,41,4,44
Adelaide Utd,1939,5,11,6,11,37,40,-3,39
Brisbane,1939,6,10,5,13,33,42,-9,35
Western Sydn,1939,7,8,9,10,38,47,-9,33
Perth Glory,1939,8,10,2,15,37,50,-13,32
Wellington P,1939,9,5,6,16,31,55,-24,21
CC Mariners,1939,10,4,8,15,28,49,-21,20
Sydney FC,1940,1,21,4,3,70,22,48,67
N'castle Jet,1940,2,15,6,7,57,37,20,51
Melbourne C,1940,3,14,5,10,43,33,10,47
Melbourne V,1940,4,13,5,11,45,44,1,44
Adelaide Utd,1940,5,11,6,11,37,40,-3,39
Brisbane,1940,6,10,5,13,33,42,-9,35
Western Sydn,1940,7,8,9,10,38,47,-9,33
Perth Glory,1940,8,10,2,15,37,50,-13,32
Wellington P,1940,9,5,6,16,31,55,-24,21
CC Mariners,1940,10,4,8,15,28,49,-21,20
Sydney FC,1941,1,20,5,3,65,23,42,65
N'castle Jet,1941,2,15,6,7,58,38,20,51
Melbourne C,1941,3,14,5,10,44,34,10,47
Melbourne V,1941,4,13,6,10,46,39,7,45
Adelaide Utd,1941,5,11,6,11,37,40,-3,39
Brisbane,1941,6,10,5,13,33,42,-9,35
Western Sydn,1941,7,8,9,10,38,47,-9,33
Perth Glory,1941,8,10,2,15,37,50,-13,32
Wellington P,1941,9,5,6,16,31,55,-24,21
CC Mariners,1941,10,4,8,15,28,49,-21,20
Sydney FC,1942,1,21,4,3,66,23,43,67
N'castle Jet,1942,2,16,5,7,60,38,22,53
Melbourne C,1942,3,14,4,11,44,36,8,46
Melbourne V,1942,4,13,5,11,46,40,6,44
Adelaide Utd,1942,5,11,6,11,37,40,-3,39
Brisbane,1942,6,10,5,13,33,42,-9,35
Western Sydn,1942,7,8,9,10,38,47,-9,33
Perth Glory,1942,8,10,2,15,37,50,-13,32
Wellington P,1942,9,5,6,16,31,55,-24,21
CC Mariners,1942,10,4,8,15,28,49,-21,20
Sydney FC,1943,1,20,5,3,66,24,42,65
N'castle Jet,1943,2,16,5,7,59,38,21,53
Melbourne C,1943,3,14,4,11,44,35,9,46
Melbourne V,1943,4,13,6,10,47,40,7,45
Adelaide Utd,1943,5,11,6,11,37,40,-3,39
Brisbane,1943,6,10,5,13,33,42,-9,35
Western Sydn,1943,7,8,9,10,38,47,-9,33
Perth Glory,1943,8,10,2,15,37,50,-13,32
Wellington P,1943,9,5,6,16,31,55,-24,21
CC Mariners,1943,10,4,8,15,28,49,-21,20
Sydney FC,1944,1,20,4,4,65,25,40,64
N'castle Jet,1944,2,16,5,7,58,37,21,53
Melbourne V,1944,3,14,5,10,48,39,9,47
Melbourne C,1944,4,14,4,11,43,34,9,46
Adelaide Utd,1944,5,11,6,11,37,40,-3,39
Brisbane,1944,6,10,5,13,33,42,-9,35
Western Sydn,1944,7,8,9,10,38,47,-9,33
Perth Glory,1944,8,10,2,15,37,50,-13,32
Wellington P,1944,9,5,6,16,31,55,-24,21
CC Mariners,1944,10,4,8,15,28,49,-21,20
Sydney FC,1945,1,20,5,3,65,23,42,65
N'castle Jet,1945,2,15,5,8,57,38,19,50
Melbourne C,1945,3,15,4,10,44,33,11,49
Melbourne V,1945,4,13,6,10,46,39,7,45
Adelaide Utd,1945,5,11,6,11,37,40,-3,39
Brisbane,1945,6,10,5,13,33,42,-9,35
Western Sydn,1945,7,8,9,10,38,47,-9,33
Perth Glory,1945,8,10,2,15,37,50,-13,32
Wellington P,1945,9,5,6,16,31,55,-24,21
CC Mariners,1945,10,4,8,15,28,49,-21,20
Sydney FC,1946,1,20,4,4,64,23,41,64
N'castle Jet,1946,2,15,6,7,57,37,20,51
Melbourne C,1946,3,14,5,10,43,33,10,47
Melbourne V,1946,4,14,5,10,46,38,8,47
Adelaide Utd,1946,5,11,6,11,37,40,-3,39
Brisbane,1946,6,10,5,13,33,42,-9,35
Western Sydn,1946,7,8,9,10,38,47,-9,33
Perth Glory,1946,8,10,2,15,37,50,-13,32
Wellington P,1946,9,5,6,16,31,55,-24,21
CC Mariners,1946,10,4,8,15,28,49,-21,20
Sydney FC,1947,1,20,5,3,65,23,42,65
N'castle Jet,1947,2,15,6,7,57,37,20,51
Melbourne C,1947,3,14,5,10,43,33,10,47
Melbourne V,1947,4,13,6,10,46,39,7,45
Adelaide Utd,1947,5,11,6,11,37,40,-3,39
Brisbane,1947,6,10,5,13,33,42,-9,35
Western Sydn,1947,7,8,9,10,38,47,-9,33
Perth Glory,1947,8,10,2,15,37,50,-13,32
Wellington P,1947,9,5,6,16,31,55,-24,21
CC Mariners,1947,10,4,8,15,28,49,-21,20
Sydney FC,1948,1,20,5,3,64,22,42,65
N'castle Jet,1948,2,16,5,7,61,38,23,53
Melbourne C,1948,3,14,4,11,44,37,7,46
Melbourne V,1948,4,13,6,10,45,38,7,45
Adelaide Utd,1948,5,11,6,11,37,40,-3,39
Brisbane,1948,6,10,5,13,33,42,-9,35
Western Sydn,1948,7,8,9,10,38,47,-9,33
Perth Glory,1948,8,10,2,15,37,50,-13,32
Wellington P,1948,9,5,6,16,31,55,-24,21
CC Mariners,1948,10,4,8,15,28,49,-21,20
Sydney FC,1949,1,21,4,3,69,24,45,67
N'castle Jet,1949,2,16,5,7,59,38,21,53
Melbourne C,1949,3,14,4,11,44,35,9,46
Melbourne V,1949,4,13,5,11,47,43,4,44
Adelaide Utd,1949,5,11,6,11,37,40,-3,39
Brisbane,1949,6,10,5,13,33,42,-9,35
Western Sydn,1949,7,8,9,10,38,47,-9,33
Perth Glory,1949,8,10,2,15,37,50,-13,32
Wellington P,1949,9,5,6,16,31,55,-24,21
CC Mariners,1949,10,4,8,15,28,49,-21,20
Sydney FC,1950,1,21,4,3,66,22,44,67
N'castle Jet,1950,2,16,5,7,60,37,23,53
Melbourne C,1950,3,14,4,11,43,36,7,46
Melbourne V,1950,4,13,5,11,45,40,5,44
Adelaide Utd,1950,5,11,6,11,37,40,-3,39
Brisbane,1950,6,10,5,13,33,42,-9,35
Western Sydn,1950,7,8,9,10,38,47,-9,33
Perth Glory,1950,8,10,2,15,37,50,-13,32
Wellington P,1950,9,5,6,16,31,55,-24,21
CC Mariners,1950,10,4,8,15,28,49,-21,20
Sydney FC,1951,1,20,4,4,64,23,41,64
N'castle Jet,1951,2,15,5,8,58,39,19,50
Melbourne C,1951,3,15,4,10,45,34,11,49
Melbourne V,1951,4,14,5,10,46,38,8,47
Adelaide Utd,1951,5,11,6,11,37,40,-3,39
Brisbane,1951,6,10,5,13,33,42,-9,35
Western Sydn,1951,7,8,9,10,38,47,-9,33
Perth Glory,1951,8,10,2,15,37,50,-13,32
Wellington P,1951,9,5,6,16,31,55,-24,21
CC Mariners,1951,10,4,8,15,28,49,-21,20
Sydney FC,1952,1,21,4,3,67,23,44,67
N'castle Jet,1952,2,15,5,8,59,40,19,50
Melbourne C,1952,3,15,4,10,46,35,11,49
Melbourne V,1952,4,13,5,11,46,41,5,44
Adelaide Utd,1952,5,11,6,11,37,40,-3,39
Brisbane,1952,6,10,5,13,33,42,-9,35
Western Sydn,1952,7,8,9,10,38,47,-9,33
Perth Glory,1952,8,10,2,15,37,50,-13,32
Wellington P,1952,9,5,6,16,31,55,-24,21
CC Mariners,1952,10,4,8,15,28,49,-21,20
Sydney FC,1953,1,21,4,3,67,23,44,67
N'castle Jet,1953,2,16,5,7,59,38,21,53
Melbourne C,1953,3,14,4,11,44,35,9,46
Melbourne V,1953,4,13,5,11,46,41,5,44
Adelaide Utd,1953,5,11,6,11,37,40,-3,39
Brisbane,1953,6,10,5,13,33,42,-9,35
Western Sydn,1953,7,8,9,10,38,47,-9,33
Perth Glory,1953,8,10,2,15,37,50,-13,32
Wellington P,1953,9,5,6,16,31,55,-24,21
CC Mariners,1953,10,4,8,15,28,49,-21,20
Sydney FC,1954,1,21,4,3,66,23,43,67
N'castle Jet,1954,2,15,5,8,57,39,18,50
Melbourne C,1954,3,15,4,10,45,33,12,49
Melbourne V,1954,4,13,5,11,46,40,6,44
Adelaide Utd,1954,5,11,6,11,37,40,-3,39
Brisbane,1954,6,10,5,13,33,42,-9,35
Western Sydn,1954,7,8,9,10,38,47,-9,33
Perth Glory,1954,8,10,2,15,37,50,-13,32
Wellington P,1954,9,5,6,16,31,55,-24,21
CC Mariners,1954,10,4,8,15,28,49,-21,20
Sydney FC,1955,1,21,4,3,66,22,44,67
N'castle Jet,1955,2,16,5,7,59,38,21,53
Melbourne C,1955,3,14,4,11,44,35,9,46
Melbourne V,1955,4,13,5,11,45,40,5,44
Adelaide Utd,1955,5,11,6,11,37,40,-3,39
Brisbane,1955,6,10,5,13,33,42,-9,35
Western Sydn,1955,7,8,9,10,38,47,-9,33
Perth Glory,1955,8,10,2,15,37,50,-13,32
Wellington P,1955,9,5,6,16,31,55,-24,21
CC Mariners,1955,10,4,8,15,28,49,-21,20
Sydney FC,1956,1,20,4,4,65,24,41,64
N'castle Jet,1956,2,16,5,7,61,37,24,53
Melbourne V,1956,3,14,5,10,47,39,8,47
Melbourne C,1956,4,14,4,11,43,37,6,46
Adelaide Utd,1956,5,11,6,11,37,40,-3,39
Brisbane,1956,6,10,5,13,33,42,-9,35
Western Sydn,1956,7,8,9,10,38,47,-9,33
Perth Glory,1956,8,10,2,15,37,50,-13,32
Wellington P,1956,9,5,6,16,31,55,-24,21
CC Mariners,1956,10,4,8,15,28,49,-21,20
Sydney FC,1957,1,21,4,3,66,22,44,67
N'castle Jet,1957,2,15,5,8,59,40,19,50
Melbourne C,1957,3,15,4,10,46,35,11,49
Melbourne V,1957,4,13,5,11,45,40,5,44
Adelaide Utd,1957,5,11,6,11,37,40,-3,39
Brisbane,1957,6,10,5,13,33,42,-9,35
Western Sydn,1957,7,8,9,10,38,47,-9,33
Perth Glory,1957,8,10,2,15,37,50,-13,32
Wellington P,1957,9,5,6,16,31,55,-24,21
CC Mariners,1957,10,4,8,15,28,49,-21,20
Sydney FC,1958,1,21,4,3,67,22,45,67
N'castle Jet,1958,2,15,6,7,59,39,20,51
Melbourne C,1958,3,14,5,10,45,35,10,47
Melbourne V,1958,4,13,5,11,45,41,4,44
Adelaide Utd,1958,5,11,6,11,37,40,-3,39
Brisbane,1958,6,10,5,13,33,42,-9,35
Western Sydn,1958,7,8,9,10,38,47,-9,33
Perth Glory,1958,8,10,2,15,37,50,-13,32
Wellington P,1958,9,5,6,16,31,55,-24,21
CC Mariners,1958,10,4,8,15,28,49,-21,20
Sydney FC,1959,1,21,4,3,66,23,43,67
N'castle Jet,1959,2,15,5,8,57,38,19,50
Melbourne C,1959,3,15,4,10,44,33,11,49
Melbourne V,1959,4,13,5,11,46,40,6,44
Adelaide Utd,1959,5,11,6,11,37,40,-3,39
Brisbane,1959,6,10,5,13,33,42,-9,35
Western Sydn,1959,7,8,9,10,38,47,-9,33
Perth Glory,1959,8,10,2,15,37,50,-13,32
Wellington P,1959,9,5,6,16,31,55,-24,21
CC Mariners,1959,10,4,8,15,28,49,-21,20
Sydney FC,1960,1,20,5,3,64,22,42,65
N'castle Jet,1960,2,15,6,7,58,38,20,51
Melbourne C,1960,3,14,5,10,44,34,10,47
Melbourne V,1960,4,13,6,10,45,38,7,45
Adelaide Utd,1960,5,11,6,11,37,40,-3,39
Brisbane,1960,6,10,5,13,33,42,-9,35
Western Sydn,1960,7,8,9,10,38,47,-9,33
Perth Glory,1960,8,10,2,15,37,50,-13,32
Wellington P,1960,9,5,6,16,31,55,-24,21
CC Mariners,1960,10,4,8,15,28,49,-21,20
Sydney FC,1961,1,20,4,4,65,24,41,64
N'castle Jet,1961,2,16,5,7,58,37,21,53
Melbourne V,1961,3,14,5,10,47,39,8,47
Melbourne C,1961,4,14,4,11,43,34,9,46
Adelaide Utd,1961,5,11,6,11,37,40,-3,39
Brisbane,1961,6,10,5,13,33,42,-9,35
Western Sydn,1961,7,8,9,10,38,47,-9,33
Perth Glory,1961,8,10,2,15,37,50,-13,32
Wellington P,1961,9,5,6,16,31,55,-24,21
CC Mariners,1961,10,4,8,15,28,49,-21,20
Sydney FC,1962,1,21,4,3,67,22,45,67
N'castle Jet,1962,2,16,5,7,58,37,21,53
Melbourne C,1962,3,14,4,11,43,34,9,46
Melbourne V,1962,4,13,5,11,45,41,4,44
Adelaide Utd,1962,5,11,6,11,37,40,-3,39
Brisbane,1962,6,10,5,13,33,42,-9,35
Western Sydn,1962,7,8,9,10,38,47,-9,33
Perth Glory,1962,8,10,2,15,37,50,-13,32
Wellington P,1962,9,5,6,16,31,55,-24,21
CC Mariners,1962,10,4,8,15,28,49,-21,20
Sydney FC,1963,1,20,4,4,65,24,41,64
N'castle Jet,1963,2,16,5,7,59,38,21,53
Melbourne V,1963,3,14,5,10,47,39,8,47
Melbourne C,1963,4,14,4,11,44,35,9,46
Adelaide Utd,1963,5,11,6,11,37,40,-3,39
Brisbane,1963,6,10,5,13,33,42,-9,35
Western Sydn,1963,7,8,9,10,38,47,-9,33
Perth Glory,1963,8,10,2,15,37,50,-13,32
Wellington P,1963,9,5,6,16,31,55,-24,21
CC Mariners,1963,10,4,8,15,28,49,-21,20
Sydney FC,1964,1,21,4,3,67,23,44,67
N'castle Jet,1964,2,15,5,8,58,39,19,50
Melbourne C,1964,3,15,4,10,45,34,11,49
Melbourne V,1964,4,13,5,11,46,41,5,44
Adelaide Utd,1964,5,11,6,11,37,40,-3,39
Brisbane,1964,6,10,5,13,33,42,-9,35
Western Sydn,1964,7,8,9,10,38,47,-9,33
Perth Glory,1964,8,10,2,15,37,50,-13,32
Wellington P,1964,9,5,6,16,31,55,-24,21
CC Mariners,1964,10,4,8,15,28,49,-21,20
Sydney FC,1965,1,21,4,3,67,23,44,67
N'castle Jet,1965,2,15,5,8,57,38,19,50
Melbourne C,1965,3,15,4,10,44,33,11,49
Melbourne V,1965,4,13,5,11,46,41,5,44
Adelaide Utd,1965,5,11,6,11,37,40,-3,39
Brisbane,1965,6,10,5,13,33,42,-9,35
Western Sydn,1965,7,8,9,10,38,47,-9,33
Perth Glory,1965,8,10,2,15,37,50,-13,32
Wellington P,1965,9,5,6,16,31,55,-24,21
CC Mariners,1965,10,4,8,15,28,49,-21,20
Sydney FC,1966,1,21,4,3,67,23,44,67
N'castle Jet,1966,2,16,5,7,59,38,21,53
Melbourne C,1966,3,14,4,11,44,35,9,46
Melbourne V,1966,4,13,5,11,46,41,5,44
Adelaide Utd,1966,5,11,6,11,37,40,-3,39
Brisbane,1966,6,10,5,13,33,42,-9,35
Western Sydn,1966,7,8,9,10,38,47,-9,33
Perth Glory,1966,8,10,2,15,37,50,-13,32
Wellington P,1966,9,5,6,16,31,55,-24,21
CC Mariners,1966,10,4,8,15,28,49,-21,20
Sydney FC,1967,1,21,4,3,71,22,49,67
N'castle Jet,1967,2,16,5,7,59,37,22,53
Melbourne C,1967,3,14,4,11,43,35,8,46
Melbourne V,1967,4,13,5,11,45,45,0,44
Adelaide Utd,1967,5,11,6,11,37,40,-3,39
Brisbane,1967,6,10,5,13,33,42,-9,35
Western Sydn,1967,7,8,9,10,38,47,-9,33
Perth Glory,1967,8,10,2,15,37,50,-13,32
Wellington P,1967,9,5,6,16,31,55,-24,21
CC Mariners,1967,10,4,8,15,28,49,-21,20
Sydney FC,1968,1,21,4,3,66,23,43,67
N'castle Jet,1968,2,15,5,8,57,38,19,50
Melbourne C,1968,3,15,4,10,44,33,11,49
Melbourne V,1968,4,13,5,11,46,40,6,44
Adelaide Utd,1968,5,11,6,11,37,40,-3,39
Brisbane,1968,6,10,5,13,33,42,-9,35
Western Sydn,1968,7,8,9,10,38,47,-9,33
Perth Glory,1968,8,10,2,15,37,50,-13,32
Wellington P,1968,9,5,6,16,31,55,-24,21
CC Mariners,1968,10,4,8,15,28,49,-21,20
Sydney FC,1969,1,21,4,3,65,22,43,67
N'castle Jet,1969,2,15,6,7,58,38,20,51
Melbourne C,1969,3,14,5,10,44,34,10,47
Melbourne V,1969,4,13,5,11,45,39,6,44
Adelaide Utd,1969,5,11,6,11,37,40,-3,39
Brisbane,1969,6,10,5,13,33,42,-9,35
Western Sydn,1969,7,8,9,10,38,47,-9,33
Perth Glory,1969,8,10,2,15,37,50,-13,32
Wellington P,1969,9,5,6,16,31,55,-24,21
CC Mariners,1969,10,4,8,15,28,49,-21,20
Sydney FC,1970,1,21,4,3,66,22,44,67
N'castle Jet,1970,2,15,6,7,57,37,20,51
Melbourne C,1970,3,14,5,10,43,33,10,47
Melbourne V,1970,4,13,5,11,45,40,5,44
Adelaide Utd,1970,5,11,6,11,37,40,-3,39
Brisbane,1970,6,10,5,13,33,42,-9,35
Western Sydn,1970,7,8,9,10,38,47,-9,33
Perth Glory,1970,8,10,2,15,37,50,-13,32
Wellington P,1970,9,5,6,16,31,55,-24,21
CC Mariners,1970,10,4,8,15,28,49,-21,20
Sydney FC,1971,1,21,4,3,67,22,45,67
N'castle Jet,1971,2,16,5,7,59,37,22,53
Melbourne C,1971,3,14,4,11,43,35,8,46
Melbourne V,1971,4,13,5,11,45,41,4,44
Adelaide Utd,1971,5,11,6,11,37,40,-3,39
Brisbane,1971,6,10,5,13,33,42,-9,35
Western Sydn,1971,7,8,9,10,38,47,-9,33
Perth Glory,1971,8,10,2,15,37,50,-13,32
Wellington P,1971,9,5,6,16,31,55,-24,21
CC Mariners,1971,10,4,8,15,28,49,-21,20
Sydney FC,1972,1,21,4,3,68,23,45,67
N'castle Jet,1972,2,16,5,7,61,38,23,53
Melbourne C,1972,3,14,4,11,44,37,7,46
Melbourne V,1972,4,13,5,11,46,42,4,44
Adelaide Utd,1972,5,11,6,11,37,40,-3,39
Brisbane,1972,6,10,5,13,33,42,-9,35
Western Sydn,1972,7,8,9,10,38,47,-9,33
Perth Glory,1972,8,10,2,15,37,50,-13,32
Wellington P,1972,9,5,6,16,31,55,-24,21
CC Mariners,1972,10,4,8,15,28,49,-21,20
Sydney FC,1973,1,21,4,3,67,22,45,67
N'castle Jet,1973,2,16,5,7,59,38,21,53
Melbourne C,1973,3,14,4,11,44,35,9,46
Melbourne V,1973,4,13,5,11,45,41,4,44
Adelaide Utd,1973,5,11,6,11,37,40,-3,39
Brisbane,1973,6,10,5,13,33,42,-9,35
Western Sydn,1973,7,8,9,10,38,47,-9,33
Perth Glory,1973,8,10,2,15,37,50,-13,32
Wellington P,1973,9,5,6,16,31,55,-24,21
CC Mariners,1973,10,4,8,15,28,49,-21,20
Sydney FC,1974,1,21,4,3,66,23,43,67
N'castle Jet,1974,2,15,5,8,57,40,17,50
Melbourne C,1974,3,15,4,10,46,33,13,49
Melbourne V,1974,4,13,5,11,46,40,6,44
Adelaide Utd,1974,5,11,6,11,37,40,-3,39
Brisbane,1974,6,10,5,13,33,42,-9,35
Western Sydn,1974,7,8,9,10,38,47,-9,33
Perth Glory,1974,8,10,2,15,37,50,-13,32
Wellington P,1974,9,5,6,16,31,55,-24,21
CC Mariners,1974,10,4,8,15,28,49,-21,20
Sydney FC,1975,1,20,5,3,64,22,42,65
N'castle Jet,1975,2,15,5,8,57,38,19,50
Melbourne C,1975,3,15,4,10,44,33,11,49
Melbourne V,1975,4,13,6,10,45,38,7,45
Adelaide Utd,1975,5,11,6,11,37,40,-3,39
Brisbane,1975,6,10,5,13,33,42,-9,35
Western Sydn,1975,7,8,9,10,38,47,-9,33
Perth Glory,1975,8,10,2,15,37,50,-13,32
Wellington P,1975,9,5,6,16,31,55,-24,21
CC Mariners,1975,10,4,8,15,28,49,-21,20
Sydney FC,1976,1,20,4,4,65,24,41,64
N'castle Jet,1976,2,15,6,7,58,38,20,51
Melbourne C,1976,3,14,5,10,44,34,10,47
Melbourne V,1976,4,14,5,10,47,39,8,47
Adelaide Utd,1976,5,11,6,11,37,40,-3,39
Brisbane,1976,6,10,5,13,33,42,-9,35
Western Sydn,1976,7,8,9,10,38,47,-9,33
Perth Glory,1976,8,10,2,15,37,50,-13,32
Wellington P,1976,9,5,6,16,31,55,-24,21
CC Mariners,1976,10,4,8,15,28,49,-21,20
Sydney FC,1977,1,21,4,3,69,25,44,67
N'castle Jet,1977,2,15,6,7,59,39,20,51
Melbourne C,1977,3,14,5,10,45,35,10,47
Melbourne V,1977,4,13,5,11,48,43,5,44
Adelaide Utd,1977,5,11,6,11,37,40,-3,39
Brisbane,1977,6,10,5,13,33,42,-9,35
Western Sydn,1977,7,8,9,10,38,47,-9,33
Perth Glory,1977,8,10,2,15,37,50,-13,32
Wellington P,1977,9,5,6,16,31,55,-24,21
CC Mariners,1977,10,4,8,15,28,49,-21,20
Sydney FC,1978,1,20,5,3,65,23,42,65
N'castle Jet,1978,2,15,5,8,58,39,19,50
Melbourne C,1978,3,15,4,10,45,34,11,49
Melbourne V,1978,4,13,6,10,46,39,7,45
Adelaide Utd,1978,5,11,6,11,37,40,-3,39
Brisbane,1978,6,10,5,13,33,42,-9,35
Western Sydn,1978,7,8,9,10,38,47,-9,33
Perth Glory,1978,8,10,2,15,37,50,-13,32
Wellington P,1978,9,5,6,16,31,55,-24,21
CC Mariners,1978,10,4,8,15,28,49,-21,20
Sydney FC,1979,1,20,5,3,64,22,42,65
N'castle Jet,1979,2,15,5,8,58,39,19,50
Melbourne C,1979,3,15,4,10,45,34,11,49
Melbourne V,1979,4,13,6,10,45,38,7,45
Adelaide Utd,1979,5,11,6,11,37,40,-3,39
Brisbane,1979,6,10,5,13,33,42,-9,35
Western Sydn,1979,7,8,9,10,38,47,-9,33
Perth Glory,1979,8,10,2,15,37,50,-13,32
Wellington P,1979,9,5,6,16,31,55,-24,21
CC Mariners,1979,10,4,8,15,28,49,-21,20
Sydney FC,1980,1,21,4,3,67,24,43,67
N'castle Jet,1980,2,16,5,7,60,37,23,53
Melbourne C,1980,3,14,4,11,43,36,7,46
Melbourne V,1980,4,13,5,11,47,41,6,44
Adelaide Utd,1980,5,11,6,11,37,40,-3,39
Brisbane,1980,6,10,5,13,33,42,-9,35
Western Sydn,1980,7,8,9,10,38,47,-9,33
Perth Glory,1980,8,10,2,15,37,50,-13,32
Wellington P,1980,9,5,6,16,31,55,-24,21
CC Mariners,1980,10,4,8,15,28,49,-21,20
Sydney FC,1981,1,21,4,3,67,22,45,67
N'castle Jet,1981,2,16,5,7,59,38,21,53
Melbourne C,1981,3,14,4,11,44,35,9,46
Melbourne V,1981,4,13,5,11,45,41,4,44
Adelaide Utd,1981,5,11,6,11,37,40,-3,39
Brisbane,1981,6,10,5,13,33,42,-9,35
Western Sydn,1981,7,8,9,10,38,47,-9,33
Perth Glory,1981,8,10,2,15,37,50,-13,32
Wellington P,1981,9,5,6,16,31,55,-24,21
CC Mariners,1981,10,4,8,15,28,49,-21,20
Sydney FC,1982,1,20,4,4,66,25,41,64
N'castle Jet,1982,2,15,5,8,58,39,19,50
Melbourne C,1982,3,15,4,10,45,34,11,49
Melbourne V,1982,4,14,5,10,48,40,8,47
Adelaide Utd,1982,5,11,6,11,37,40,-3,39
Brisbane,1982,6,10,5,13,33,42,-9,35
Western Sydn,1982,7,8,9,10,38,47,-9,33
Perth Glory,1982,8,10,2,15,37,50,-13,32
Wellington P,1982,9,5,6,16,31,55,-24,21
CC Mariners,1982,10,4,8,15,28,49,-21,20
Sydney FC,1983,1,21,4,3,68,23,45,67
N'castle Jet,1983,2,16,5,7,58,37,21,53
Melbourne C,1983,3,14,4,11,43,34,9,46
Melbourne V,1983,4,13,5,11,46,42,4,44
Adelaide Utd,1983,5,11,6,11,37,40,-3,39
Brisbane,1983,6,10,5,13,33,42,-9,35
Western Sydn,1983,7,8,9,10,38,47,-9,33
Perth Glory,1983,8,10,2,15,37,50,-13,32
Wellington P,1983,9,5,6,16,31,55,-24,21
CC Mariners,1983,10,4,8,15,28,49,-21,20
Sydney FC,1984,1,20,5,3,68,26,42,65
N'castle Jet,1984,2,16,5,7,60,37,23,53
Melbourne C,1984,3,14,4,11,43,36,7,46
Melbourne V,1984,4,13,6,10,49,42,7,45
Adelaide Utd,1984,5,11,6,11,37,40,-3,39
Brisbane,1984,6,10,5,13,33,42,-9,35
Western Sydn,1984,7,8,9,10,38,47,-9,33
Perth Glory,1984,8,10,2,15,37,50,-13,32
Wellington P,1984,9,5,6,16,31,55,-24,21
CC Mariners,1984,10,4,8,15,28,49,-21,20
Sydney FC,1985,1,20,4,4,64,25,39,64
N'castle Jet,1985,2,15,5,8,57,39,18,50
Melbourne C,1985,3,15,4,10,45,33,12,49
Melbourne V,1985,4,14,5,10,48,38,10,47
Adelaide Utd,1985,5,11,6,11,37,40,-3,39
Brisbane,1985,6,10,5,13,33,42,-9,35
Western Sydn,1985,7,8,9,10,38,47,-9,33
Perth Glory,1985,8,10,2,15,37,50,-13,32
Wellington P,1985,9,5,6,16,31,55,-24,21
CC Mariners,1985,10,4,8,15,28,49,-21,20
Sydney FC,1986,1,21,4,3,66,22,44,67
N'castle Jet,1986,2,16,5,7,60,37,23,53
Melbourne C,1986,3,14,4,11,43,36,7,46
Melbourne V,1986,4,13,5,11,45,40,5,44
Adelaide Utd,1986,5,11,6,11,37,40,-3,39
Brisbane,1986,6,10,5,13,33,42,-9,35
Western Sydn,1986,7,8,9,10,38,47,-9,33
Perth Glory,1986,8,10,2,15,37,50,-13,32
Wellington P,1986,9,5,6,16,31,55,-24,21
CC Mariners,1986,10,4,8,15,28,49,-21,20
Sydney FC,1987,1,21,4,3,66,23,43,67
N'castle Jet,1987,2,16,5,7,59,38,21,53
Melbourne C,1987,3,14,4,11,44,35,9,46
Melbourne V,1987,4,13,5,11,46,40,6,44
Adelaide Utd,1987,5,11,6,11,37,40,-3,39
Brisbane,1987,6,10,5,13,33,42,-9,35
Western Sydn,1987,7,8,9,10,38,47,-9,33
Perth Glory,1987,8,10,2,15,37,50,-13,32
Wellington P,1987,9,5,6,16,31,55,-24,21
CC Mariners,1987,10,4,8,15,28,49,-21,20
Sydney FC,1988,1,21,4,3,66,22,44,67
N'castle Jet,1988,2,15,6,7,58,38,20,51
Melbourne C,1988,3,14,5,10,44,34,10,47
Melbourne V,1988,4,13,5,11,45,40,5,44
Adelaide Utd,1988,5,11,6,11,37,40,-3,39
Brisbane,1988,6,10,5,13,33,42,-9,35
Western Sydn,1988,7,8,9,10,38,47,-9,33
Perth Glory,1988,8,10,2,15,37,50,-13,32
Wellington P,1988,9,5,6,16,31,55,-24,21
CC Mariners,1988,10,4,8,15,28,49,-21,20
Sydney FC,1989,1,21,4,3,67,22,45,67
N'castle Jet,1989,2,15,6,7,59,39,20,51
Melbourne C,1989,3,14,5,10,45,35,10,47
Melbourne V,1989,4,13,5,11,45,41,4,44
Adelaide Utd,1989,5,11,6,11,37,40,-3,39
Brisbane,1989,6,10,5,13,33,42,-9,35
Western Sydn,1989,7,8,9,10,38,47,-9,33
Perth Glory,1989,8,10,2,15,37,50,-13,32
Wellington P,1989,9,5,6,16,31,55,-24,21
CC Mariners,1989,10,4,8,15,28,49,-21,20
Sydney FC,1990,1,21,4,3,66,23,43,67
N'castle Jet,1990,2,15,5,8,58,39,19,50
Melbourne C,1990,3,15,4,10,45,34,11,49
Melbourne V,1990,4,13,5,11,46,40,6,44
Adelaide Utd,1990,5,11,6,11,37,40,-3,39
Brisbane,1990,6,10,5,13,33,42,-9,35
Western Sydn,1990,7,8,9,10,38,47,-9,33
Perth Glory,1990,8,10,2,15,37,50,-13,32
Wellington P,1990,9,5,6,16,31,55,-24,21
CC Mariners,1990,10,4,8,15,28,49,-21,20
Sydney FC,1991,1,20,4,4,65,24,41,64
N'castle Jet,1991,2,16,5,7,62,37,25,53
Melbourne V,1991,3,14,5,10,47,39,8,47
Melbourne C,1991,4,14,4,11,43,38,5,46
Adelaide Utd,1991,5,11,6,11,37,40,-3,39
Brisbane,1991,6,10,5,13,33,42,-9,35
Western Sydn,1991,7,8,9,10,38,47,-9,33
Perth Glory,1991,8,10,2,15,37,50,-13,32
Wellington P,1991,9,5,6,16,31,55,-24,21
CC Mariners,1991,10,4,8,15,28,49,-21,20
Sydney FC,1992,1,21,4,3,66,22,44,67
N'castle Jet,1992,2,15,5,8,57,38,19,50
Melbourne C,1992,3,15,4,10,44,33,11,49
Melbourne V,1992,4,13,5,11,45,40,5,44
Adelaide Utd,1992,5,11,6,11,37,40,-3,39
Brisbane,1992,6,10,5,13,33,42,-9,35
Western Sydn,1992,7,8,9,10,38,47,-9,33
Perth Glory,1992,8,10,2,15,37,50,-13,32
Wellington P,1992,9,5,6,16,31,55,-24,21
CC Mariners,1992,10,4,8,15,28,49,-21,20
Sydney FC,1993,1,21,4,3,65,22,43,67
N'castle Jet,1993,2,16,5,7,60,38,22,53
Melbourne C,1993,3,14,4,11,44,36,8,46
Melbourne V,1993,4,13,5,11,45,39,6,44
Adelaide Utd,1993,5,11,6,11,37,40,-3,39
Brisbane,1993,6,10,5,13,33,42,-9,35
Western Sydn,1993,7,8,9,10,38,47,-9,33
Perth Glory,1993,8,10,2,15,37,50,-13,32
Wellington P,1993,9,5,6,16,31,55,-24,21
CC Mariners,1993,10,4,8,15,28,49,-21,20
Sydney FC,1994,1,21,4,3,67,24,43,67
N'castle Jet,1994,2,15,5,8,58,39,19,50
Melbourne C,1994,3,15,4,10,45,34,11,49
Melbourne V,1994,4,13,5,11,47,41,6,44
Adelaide Utd,1994,5,11,6,11,37,40,-3,39
Brisbane,1994,6,10,5,13,33,42,-9,35
Western Sydn,1994,7,8,9,10,38,47,-9,33
Perth Glory,1994,8,10,2,15,37,50,-13,32
Wellington P,1994,9,5,6,16,31,55,-24,21
CC Mariners,1994,10,4,8,15,28,49,-21,20
Sydney FC,1995,1,20,5,3,65,23,42,65
N'castle Jet,1995,2,15,5,8,57,38,19,50
Melbourne C,1995,3,15,4,10,44,33,11,49
Melbourne V,1995,4,13,6,10,46,39,7,45
Adelaide Utd,1995,5,11,6,11,37,40,-3,39
Brisbane,1995,6,10,5,13,33,42,-9,35
Western Sydn,1995,7,8,9,10,38,47,-9,33
Perth Glory,1995,8,10,2,15,37,50,-13,32
Wellington P,1995,9,5,6,16,31,55,-24,21
CC Mariners,1995,10,4,8,15,28,49,-21,20
Sydney FC,1996,1,21,4,3,67,22,45,67
N'castle Jet,1996,2,15,6,7,58,38,20,51
Melbourne C,1996,3,14,5,10,44,34,10,47
Melbourne V,1996,4,13,5,11,45,41,4,44
Adelaide Utd,1996,5,11,6,11,37,40,-3,39
Brisbane,1996,6,10,5,13,33,42,-9,35
Western Sydn,1996,7,8,9,10,38,47,-9,33
Perth Glory,1996,8,10,2,15,37,50,-13,32
Wellington P,1996,9,5,6,16,31,55,-24,21
CC Mariners,1996,10,4,8,15,28,49,-21,20
Sydney FC,1997,1,21,4,3,68,22,46,67
N'castle Jet,1997,2,15,6,7,57,37,20,51
Melbourne C,1997,3,14,5,10,43,33,10,47
Melbourne V,1997,4,13,5,11,45,42,3,44
Adelaide Utd,1997,5,11,6,11,37,40,-3,39
Brisbane,1997,6,10,5,13,33,42,-9,35
Western Sydn,1997,7,8,9,10,38,47,-9,33
Perth Glory,1997,8,10,2,15,37,50,-13,32
Wellington P,1997,9,5,6,16,31,55,-24,21
CC Mariners,1997,10,4,8,15,28,49,-21,20
Sydney FC,1998,1,21,4,3,65,22,43,67
N'castle Jet,1998,2,16,5,7,60,37,23,53
Melbourne C,1998,3,14,4,11,43,36,7,46
Melbourne V,1998,4,13,5,11,45,39,6,44
Adelaide Utd,1998,5,11,6,11,37,40,-3,39
Brisbane,1998,6,10,5,13,33,42,-9,35
Western Sydn,1998,7,8,9,10,38,47,-9,33
Perth Glory,1998,8,10,2,15,37,50,-13,32
Wellington P,1998,9,5,6,16,31,55,-24,21
CC Mariners,1998,10,4,8,15,28,49,-21,20
Sydney FC,1999,1,21,4,3,67,23,44,67
N'castle Jet,1999,2,16,5,7,59,38,21,53
Melbourne C,1999,3,14,4,11,44,35,9,46
Melbourne V,1999,4,13,5,11,46,41,5,44
Adelaide Utd,1999,5,11,6,11,37,40,-3,39
Brisbane,1999,6,10,5,13,33,42,-9,35
Western Sydn,1999,7,8,9,10,38,47,-9,33
Perth Glory,1999,8,10,2,15,37,50,-13,32
Wellington P,1999,9,5,6,16,31,55,-24,21
CC Mariners,1999,10,4,8,15,28,49,-21,20
Sydney FC,2000,1,21,4,3,71,24,47,67
N'castle Jet,2000,2,16,5,7,61,40,21,53
Melbourne C,2000,3,14,4,11,46,37,9,46
Melbourne V,2000,4,13,5,11,47,45,2,44
Adelaide Utd,2000,5,11,6,11,37,40,-3,39
Brisbane,2000,6,10,5,13,33,42,-9,35
Western Sydn,2000,7,8,9,10,38,47,-9,33
Perth Glory,2000,8,10,2,15,37,50,-13,32
Wellington P,2000,9,5,6,16,31,55,-24,21
CC Mariners,2000,10,4,8,15,28,49,-21,20
Sydney FC,2001,1,20,5,3,64,22,42,65
N'castle Jet,2001,2,15,6,7,58,38,20,51
Melbourne C,2001,3,14,5,10,44,34,10,47
Melbourne V,2001,4,13,6,10,45,38,7,45
Adelaide Utd,2001,5,11,6,11,37,40,-3,39
Brisbane,2001,6,10,5,13,33,42,-9,35
Western Sydn,2001,7,8,9,10,38,47,-9,33
Perth Glory,2001,8,10,2,15,37,50,-13,32
Wellington P,2001,9,5,6,16,31,55,-24,21
CC Mariners,2001,10,4,8,15,28,49,-21,20
Sydney FC,2002,1,20,4,4,65,24,41,64
N'castle Jet,2002,2,15,6,7,58,38,20,51
Melbourne C,2002,3,14,5,10,44,34,10,47
Melbourne V,2002,4,14,5,10,47,39,8,47
Adelaide Utd,2002,5,11,6,11,37,40,-3,39
Brisbane,2002,6,10,5,13,33,42,-9,35
Western Sydn,2002,7,8,9,10,38,47,-9,33
Perth Glory,2002,8,10,2,15,37,50,-13,32
Wellington P,2002,9,5,6,16,31,55,-24,21
CC Mariners,2002,10,4,8,15,28,49,-21,20
Sydney FC,2003,1,21,4,3,75,22,53,67
N'castle Jet,2003,2,16,5,7,58,37,21,53
Melbourne C,2003,3,14,4,11,43,34,9,46
Melbourne V,2003,4,13,5,11,45,49,-4,44
Adelaide Utd,2003,5,11,6,11,37,40,-3,39
Brisbane,2003,6,10,5,13,33,42,-9,35
Western Sydn,2003,7,8,9,10,38,47,-9,33
Perth Glory,2003,8,10,2,15,37,50,-13,32
Wellington P,2003,9,5,6,16,31,55,-24,21
CC Mariners,2003,10,4,8,15,28,49,-21,20
Sydney FC,2004,1,21,4,3,67,22,45,67
N'castle Jet,2004,2,15,5,8,58,42,16,50
Melbourne C,2004,3,15,4,10,48,34,14,49
Melbourne V,2004,4,13,5,11,45,41,4,44
Adelaide Utd,2004,5,11,6,11,37,40,-3,39
Brisbane,2004,6,10,5,13,33,42,-9,35
Western Sydn,2004,7,8,9,10,38,47,-9,33
Perth Glory,2004,8,10,2,15,37,50,-13,32
Wellington P,2004,9,5,6,16,31,55,-24,21
CC Mariners,2004,10,4,8,15,28,49,-21,20
Sydney FC,2005,1,21,4,3,67,24,43,67
N'castle Jet,2005,2,15,6,7,58,38,20,51
Melbourne C,2005,3,14,5,10,44,34,10,47
Melbourne V,2005,4,13,5,11,47,41,6,44
Adelaide Utd,2005,5,11,6,11,37,40,-3,39
Brisbane,2005,6,10,5,13,33,42,-9,35
Western Sydn,2005,7,8,9,10,38,47,-9,33
Perth Glory,2005,8,10,2,15,37,50,-13,32
Wellington P,2005,9,5,6,16,31,55,-24,21
CC Mariners,2005,10,4,8,15,28,49,-21,20
Sydney FC,2006,1,21,4,3,67,22,45,67
N'castle Jet,2006,2,15,5,8,58,39,19,50
Melbourne C,2006,3,15,4,10,45,34,11,49
Melbourne V,2006,4,13,5,11,45,41,4,44
Adelaide Utd,2006,5,11,6,11,37,40,-3,39
Brisbane,2006,6,10,5,13,33,42,-9,35
Western Sydn,2006,7,8,9,10,38,47,-9,33
Perth Glory,2006,8,10,2,15,37,50,-13,32
Wellington P,2006,9,5,6,16,31,55,-24,21
CC Mariners,2006,10,4,8,15,28,49,-21,20
Sydney FC,2007,1,20,4,4,64,23,41,64
N'castle Jet,2007,2,15,5,8,57,40,17,50
Melbourne C,2007,3,15,4,10,46,33,13,49
Melbourne V,2007,4,14,5,10,46,38,8,47
Adelaide Utd,2007,5,11,6,11,37,40,-3,39
Brisbane,2007,6,10,5,13,33,42,-9,35
Western Sydn,2007,7,8,9,10,38,47,-9,33
Perth Glory,2007,8,10,2,15,37,50,-13,32
Wellington P,2007,9,5,6,16,31,55,-24,21
CC Mariners,2007,10,4,8,15,28,49,-21,20
Sydney FC,2008,1,21,4,3,66,22,44,67
N'castle Jet,2008,2,15,6,7,57,37,20,51
Melbourne C,2008,3,14,5,10,43,33,10,47
Melbourne V,2008,4,13,5,11,45,40,5,44
Adelaide Utd,2008,5,11,6,11,37,40,-3,39
Brisbane,2008,6,10,5,13,33,42,-9,35
Western Sydn,2008,7,8,9,10,38,47,-9,33
Perth Glory,2008,8,10,2,15,37,50,-13,32
Wellington P,2008,9,5,6,16,31,55,-24,21
CC Mariners,2008,10,4,8,15,28,49,-21,20
Sydney FC,2009,1,21,4,3,66,23,43,67
N'castle Jet,2009,2,16,5,7,60,38,22,53
Melbourne C,2009,3,14,4,11,44,36,8,46
Melbourne V,2009,4,13,5,11,46,40,6,44
Adelaide Utd,2009,5,11,6,11,37,40,-3,39
Brisbane,2009,6,10,5,13,33,42,-9,35
Western Sydn,2009,7,8,9,10,38,47,-9,33
Perth Glory,2009,8,10,2,15,37,50,-13,32
Wellington P,2009,9,5,6,16,31,55,-24,21
CC Mariners,2009,10,4,8,15,28,49,-21,20
Sydney FC,2010,1,20,5,3,65,23,42,65
N'castle Jet,2010,2,15,5,8,57,40,17,50
Melbourne C,2010,3,15,4,10,46,33,13,49
Melbourne V,2010,4,13,6,10,46,39,7,45
Adelaide Utd,2010,5,11,6,11,37,40,-3,39
Brisbane,2010,6,10,5,13,33,42,-9,35
Western Sydn,2010,7,8,9,10,38,47,-9,33
Perth Glory,2010,8,10,2,15,37,50,-13,32
Wellington P,2010,9,5,6,16,31,55,-24,21
CC Mariners,2010,10,4,8,15,28,49,-21,20
Sydney FC,2011,1,20,4,4,64,23,41,64
N'castle Jet,2011,2,15,5,8,57,39,18,50
Melbourne C,2011,3,15,4,10,45,33,12,49
Melbourne V,2011,4,14,5,10,46,38,8,47
Adelaide Utd,2011,5,11,6,11,37,40,-3,39
Brisbane,2011,6,10,5,13,33,42,-9,35
Western Sydn,2011,7,8,9,10,38,47,-9,33
Perth Glory,2011,8,10,2,15,37,50,-13,32
Wellington P,2011,9,5,6,16,31,55,-24,21
CC Mariners,2011,10,4,8,15,28,49,-21,20
Sydney FC,2012,1,20,5,3,65,23,42,65
N'castle Jet,2012,2,16,5,7,61,39,22,53
Melbourne C,2012,3,14,4,11,45,37,8,46
Melbourne V,2012,4,13,6,10,46,39,7,45
Adelaide Utd,2012,5,11,6,11,37,40,-3,39
Brisbane,2012,6,10,5,13,33,42,-9,35
Western Sydn,2012,7,8,9,10,38,47,-9,33
Perth Glory,2012,8,10,2,15,37,50,-13,32
Wellington P,2012,9,5,6,16,31,55,-24,21
CC Mariners,2012,10,4,8,15,28,49,-21,20
Sydney FC,2013,1,21,4,3,67,22,45,67
N'castle Jet,2013,2,15,6,7,58,38,20,51
Melbourne C,2013,3,14,5,10,44,34,10,47
Melbourne V,2013,4,13,5,11,45,41,4,44
Adelaide Utd,2013,5,11,6,11,37,40,-3,39
Brisbane,2013,6,10,5,13,33,42,-9,35
Western Sydn,2013,7,8,9,10,38,47,-9,33
Perth Glory,2013,8,10,2,15,37,50,-13,32
Wellington P,2013,9,5,6,16,31,55,-24,21
CC Mariners,2013,10,4,8,15,28,49,-21,20
Sydney FC,2014,1,21,4,3,65,22,43,67
N'castle Jet,2014,2,16,5,7,60,38,22,53
Melbourne C,2014,3,14,4,11,44,36,8,46
Melbourne V,2014,4,13,5,11,45,39,6,44
Adelaide Utd,2014,5,11,6,11,37,40,-3,39
Brisbane,2014,6,10,5,13,33,42,-9,35
Western Sydn,2014,7,8,9,10,38,47,-9,33
Perth Glory,2014,8,10,2,15,37,50,-13,32
Wellington P,2014,9,5,6,16,31,55,-24,21
CC Mariners,2014,10,4,8,15,28,49,-21,20
Sydney FC,2015,1,20,5,3,64,22,42,65
N'castle Jet,2015,2,15,5,8,59,40,19,50
Melbourne C,2015,3,15,4,10,46,35,11,49
Melbourne V,2015,4,13,6,10,45,38,7,45
Adelaide Utd,2015,5,11,6,11,37,40,-3,39
Brisbane,2015,6,10,5,13,33,42,-9,35
Western Sydn,2015,7,8,9,10,38,47,-9,33
Perth Glory,2015,8,10,2,15,37,50,-13,32
Wellington P,2015,9,5,6,16,31,55,-24,21
CC Mariners,2015,10,4,8,15,28,49,-21,20
Sydney FC,2016,1,21,4,3,68,23,45,67
N'castle Jet,2016,2,16,5,7,58,37,21,53
Melbourne C,2016,3,14,4,11,43,34,9,46
Melbourne V,2016,4,13,5,11,46,42,4,44
Adelaide Utd,2016,5,11,6,11,37,40,-3,39
Brisbane,2016,6,10,5,13,33,42,-9,35
Western Sydn,2016,7,8,9,10,38,47,-9,33
Perth Glory,2016,8,10,2,15,37,50,-13,32
Wellington P,2016,9,5,6,16,31,55,-24,21
CC Mariners,2016,10,4,8,15,28,49,-21,20
Sydney FC,2017,1,20,5,3,66,24,42,65
N'castle Jet,2017,2,15,5,8,58,40,18,50
Melbourne C,2017,3,15,4,10,46,34,12,49
Melbourne V,2017,4,13,6,10,47,40,7,45
Adelaide Utd,2017,5,11,6,11,37,40,-3,39
Brisbane,2017,6,10,5,13,33,42,-9,35
Western Sydn,2017,7,8,9,10,38,47,-9,33
Perth Glory,2017,8,10,2,15,37,50,-13,32
Wellington P,2017,9,5,6,16,31,55,-24,21
CC Mariners,2017,10,4,8,15,28,49,-21,20
Sydney FC,2018,1,20,5,3,67,25,42,65
N'castle Jet,2018,2,16,5,7,60,37,23,53
Melbourne C,2018,3,14,4,11,43,36,7,46
Melbourne V,2018,4,13,6,10,48,41,7,45
Adelaide Utd,2018,5,11,6,11,37,40,-3,39
Brisbane,2018,6,10,5,13,33,42,-9,35
Western Sydn,2018,7,8,9,10,38,47,-9,33
Perth Glory,2018,8,10,2,15,37,50,-13,32
Wellington P,2018,9,5,6,16,31,55,-24,21
CC Mariners,2018,10,4,8,15,28,49,-21,20
Sydney FC,2019,1,21,4,3,66,22,44,67
N'castle Jet,2019,2,16,5,7,60,38,22,53
Melbourne C,2019,3,14,4,11,44,36,8,46
Melbourne V,2019,4,13,5,11,45,40,5,44
Adelaide Utd,2019,5,11,6,11,37,40,-3,39
Brisbane,2019,6,10,5,13,33,42,-9,35
Western Sydn,2019,7,8,9,10,38,47,-9,33
Perth Glory,2019,8,10,2,15,37,50,-13,32
Wellington P,2019,9,5,6,16,31,55,-24,21
CC Mariners,2019,10,4,8,15,28,49,-21,20
Sydney FC,2020,1,21,4,3,67,22,45,67
N'castle Jet,2020,2,16,5,7,61,39,22,53
Melbourne C,2020,3,14,4,11,45,37,8,46
Melbourne V,2020,4,13,5,11,45,41,4,44
Adelaide Utd,2020,5,11,6,11,37,40,-3,39
Brisbane,2020,6,10,5,13,33,42,-9,35
Western Sydn,2020,7,8,9,10,38,47,-9,33
Perth Glory,2020,8,10,2,15,37,50,-13,32
Wellington P,2020,9,5,6,16,31,55,-24,21
CC Mariners,2020,10,4,8,15,28,49,-21,20
Sydney FC,2021,1,21,4,3,66,23,43,67
N'castle Jet,2021,2,16,5,7,58,37,21,53
Melbourne C,2021,3,14,4,11,43,34,9,46
Melbourne V,2021,4,13,5,11,46,40,6,44
Adelaide Utd,2021,5,11,6,11,37,40,-3,39
Brisbane,2021,6,10,5,13,33,42,-9,35
Western Sydn,2021,7,8,9,10,38,47,-9,33
Perth Glory,2021,8,10,2,15,37,50,-13,32
Wellington P,2021,9,5,6,16,31,55,-24,21
CC Mariners,2021,10,4,8,15,28,49,-21,20
Sydney FC,2022,1,21,4,3,67,23,44,67
N'castle Jet,2022,2,15,5,8,57,38,19,50
Melbourne C,2022,3,15,4,10,44,33,11,49
Melbourne V,2022,4,13,5,11,46,41,5,44
Adelaide Utd,2022,5,11,6,11,37,40,-3,39
Brisbane,2022,6,10,5,13,33,42,-9,35
Western Sydn,2022,7,8,9,10,38,47,-9,33
Perth Glory,2022,8,10,2,15,37,50,-13,32
Wellington P,2022,9,5,6,16,31,55,-24,21
CC Mariners,2022,10,4,8,15,28,49,-21,20
Sydney FC,2023,1,20,5,3,66,24,42,65
N'castle Jet,2023,2,15,5,8,58,40,18,50
Melbourne C,2023,3,15,4,10,46,34,12,49
Melbourne V,2023,4,13,6,10,47,40,7,45
Adelaide Utd,2023,5,11,6,11,37,40,-3,39
Brisbane,2023,6,10,5,13,33,42,-9,35
Western Sydn,2023,7,8,9,10,38,47,-9,33
Perth Glory,2023,8,10,2,15,37,50,-13,32
Wellington P,2023,9,5,6,16,31,55,-24,21
CC Mariners,2023,10,4,8,15,28,49,-21,20
Sydney FC,2024,1,20,4,4,65,25,40,64
N'castle Jet,2024,2,15,5,8,57,40,17,50
Melbourne C,2024,3,15,4,10,46,33,13,49
Melbourne V,2024,4,14,5,10,48,39,9,47
Adelaide Utd,2024,5,11,6,11,37,40,-3,39
Brisbane,2024,6,10,5,13,33,42,-9,35
Western Sydn,2024,7,8,9,10,38,47,-9,33
Perth Glory,2024,8,10,2,15,37,50,-13,32
Wellington P,2024,9,5,6,16,31,55,-24,21
CC Mariners,2024,10,4,8,15,28,49,-21,20
Sydney FC,2025,1,21,4,3,66,23,43,67
N'castle Jet,2025,2,16,5,7,58,37,21,53
Melbourne C,2025,3,14,4,11,43,34,9,46
Melbourne V,2025,4,13,5,11,46,40,6,44
Adelaide Utd,2025,5,11,6,11,37,40,-3,39
Brisbane,2025,6,10,5,13,33,42,-9,35
Western Sydn,2025,7,8,9,10,38,47,-9,33
Perth Glory,2025,8,10,2,15,37,50,-13,32
Wellington P,2025,9,5,6,16,31,55,-24,21
CC Mariners,2025,10,4,8,15,28,49,-21,20
Sydney FC,2026,1,20,5,3,66,24,42,65
N'castle Jet,2026,2,16,5,7,59,38,21,53
Melbourne C,2026,3,14,4,11,44,35,9,46
Melbourne V,2026,4,13,6,10,47,40,7,45
Adelaide Utd,2026,5,11,6,11,37,40,-3,39
Brisbane,2026,6,10,5,13,33,42,-9,35
Western Sydn,2026,7,8,9,10,38,47,-9,33
Perth Glory,2026,8,10,2,15,37,50,-13,32
Wellington P,2026,9,5,6,16,31,55,-24,21
CC Mariners,2026,10,4,8,15,28,49,-21,20
Sydney FC,2027,1,21,4,3,67,22,45,67
N'castle Jet,2027,2,16,5,7,62,39,23,53
Melbourne C,2027,3,14,4,11,45,38,7,46
Melbourne V,2027,4,13,5,11,45,41,4,44
Adelaide Utd,2027,5,11,6,11,37,40,-3,39
Brisbane,2027,6,10,5,13,33,42,-9,35
Western Sydn,2027,7,8,9,10,38,47,-9,33
Perth Glory,2027,8,10,2,15,37,50,-13,32
Wellington P,2027,9,5,6,16,31,55,-24,21
CC Mariners,2027,10,4,8,15,28,49,-21,20
Sydney FC,2028,1,20,4,4,64,23,41,64
N'castle Jet,2028,2,15,6,7,59,39,20,51
Melbourne C,2028,3,14,5,10,45,35,10,47
Melbourne V,2028,4,14,5,10,46,38,8,47
Adelaide Utd,2028,5,11,6,11,37,40,-3,39
Brisbane,2028,6,10,5,13,33,42,-9,35
Western Sydn,2028,7,8,9,10,38,47,-9,33
Perth Glory,2028,8,10,2,15,37,50,-13,32
Wellington P,2028,9,5,6,16,31,55,-24,21
CC Mariners,2028,10,4,8,15,28,49,-21,20
Sydney FC,2029,1,21,4,3,66,23,43,67
N'castle Jet,2029,2,16,5,7,64,38,26,53
Melbourne C,2029,3,14,4,11,44,40,4,46
Melbourne V,2029,4,13,5,11,46,40,6,44
Adelaide Utd,2029,5,11,6,11,37,40,-3,39
Brisbane,2029,6,10,5,13,33,42,-9,35
Western Sydn,2029,7,8,9,10,38,47,-9,33
Perth Glory,2029,8,10,2,15,37,50,-13,32
Wellington P,2029,9,5,6,16,31,55,-24,21
CC Mariners,2029,10,4,8,15,28,49,-21,20
Sydney FC,2030,1,20,5,3,66,24,42,65
N'castle Jet,2030,2,16,5,7,59,38,21,53
Melbourne C,2030,3,14,4,11,44,35,9,46
Melbourne V,2030,4,13,6,10,47,40,7,45
Adelaide Utd,2030,5,11,6,11,37,40,-3,39
Brisbane,2030,6,10,5,13,33,42,-9,35
Western Sydn,2030,7,8,9,10,38,47,-9,33
Perth Glory,2030,8,10,2,15,37,50,-13,32
Wellington P,2030,9,5,6,16,31,55,-24,21
CC Mariners,2030,10,4,8,15,28,49,-21,20
Sydney FC,2031,1,21,4,3,65,22,43,67
N'castle Jet,2031,2,16,5,7,59,38,21,53
Melbourne C,2031,3,14,4,11,44,35,9,46
Melbourne V,2031,4,13,5,11,45,39,6,44
Adelaide Utd,2031,5,11,6,11,37,40,-3,39
Brisbane,2031,6,10,5,13,33,42,-9,35
Western Sydn,2031,7,8,9,10,38,47,-9,33
Perth Glory,2031,8,10,2,15,37,50,-13,32
Wellington P,2031,9,5,6,16,31,55,-24,21
CC Mariners,2031,10,4,8,15,28,49,-21,20
Sydney FC,2032,1,21,4,3,66,23,43,67
N'castle Jet,2032,2,16,5,7,60,37,23,53
Melbourne C,2032,3,14,4,11,43,36,7,46
Melbourne V,2032,4,13,5,11,46,40,6,44
Adelaide Utd,2032,5,11,6,11,37,40,-3,39
Brisbane,2032,6,10,5,13,33,42,-9,35
Western Sydn,2032,7,8,9,10,38,47,-9,33
Perth Glory,2032,8,10,2,15,37,50,-13,32
Wellington P,2032,9,5,6,16,31,55,-24,21
CC Mariners,2032,10,4,8,15,28,49,-21,20
Sydney FC,2033,1,21,4,3,66,23,43,67
N'castle Jet,2033,2,15,5,8,57,38,19,50
Melbourne C,2033,3,15,4,10,44,33,11,49
Melbourne V,2033,4,13,5,11,46,40,6,44
Adelaide Utd,2033,5,11,6,11,37,40,-3,39
Brisbane,2033,6,10,5,13,33,42,-9,35
Western Sydn,2033,7,8,9,10,38,47,-9,33
Perth Glory,2033,8,10,2,15,37,50,-13,32
Wellington P,2033,9,5,6,16,31,55,-24,21
CC Mariners,2033,10,4,8,15,28,49,-21,20
Sydney FC,2034,1,21,4,3,65,22,43,67
N'castle Jet,2034,2,15,5,8,57,38,19,50
Melbourne C,2034,3,15,4,10,44,33,11,49
Melbourne V,2034,4,13,5,11,45,39,6,44
Adelaide Utd,2034,5,11,6,11,37,40,-3,39
Brisbane,2034,6,10,5,13,33,42,-9,35
Western Sydn,2034,7,8,9,10,38,47,-9,33
Perth Glory,2034,8,10,2,15,37,50,-13,32
Wellington P,2034,9,5,6,16,31,55,-24,21
CC Mariners,2034,10,4,8,15,28,49,-21,20
Sydney FC,2035,1,21,4,3,66,23,43,67
N'castle Jet,2035,2,15,6,7,58,38,20,51
Melbourne C,2035,3,14,5,10,44,34,10,47
Melbourne V,2035,4,13,5,11,46,40,6,44
Adelaide Utd,2035,5,11,6,11,37,40,-3,39
Brisbane,2035,6,10,5,13,33,42,-9,35
Western Sydn,2035,7,8,9,10,38,47,-9,33
Perth Glory,2035,8,10,2,15,37,50,-13,32
Wellington P,2035,9,5,6,16,31,55,-24,21
CC Mariners,2035,10,4,8,15,28,49,-21,20
Sydney FC,2036,1,21,4,3,68,22,46,67
N'castle Jet,2036,2,15,6,7,60,40,20,51
Melbourne C,2036,3,14,5,10,46,36,10,47
Melbourne V,2036,4,13,5,11,45,42,3,44
Adelaide Utd,2036,5,11,6,11,37,40,-3,39
Brisbane,2036,6,10,5,13,33,42,-9,35
Western Sydn,2036,7,8,9,10,38,47,-9,33
Perth Glory,2036,8,10,2,15,37,50,-13,32
Wellington P,2036,9,5,6,16,31,55,-24,21
CC Mariners,2036,10,4,8,15,28,49,-21,20
Sydney FC,2037,1,20,4,4,65,25,40,64
N'castle Jet,2037,2,16,5,7,61,38,23,53
Melbourne V,2037,3,14,5,10,48,39,9,47
Melbourne C,2037,4,14,4,11,44,37,7,46
Adelaide Utd,2037,5,11,6,11,37,40,-3,39
Brisbane,2037,6,10,5,13,33,42,-9,35
Western Sydn,2037,7,8,9,10,38,47,-9,33
Perth Glory,2037,8,10,2,15,37,50,-13,32
Wellington P,2037,9,5,6,16,31,55,-24,21
CC Mariners,2037,10,4,8,15,28,49,-21,20
Sydney FC,2038,1,21,4,3,66,23,43,67
N'castle Jet,2038,2,15,5,8,58,39,19,50
Melbourne C,2038,3,15,4,10,45,34,11,49
Melbourne V,2038,4,13,5,11,46,40,6,44
Adelaide Utd,2038,5,11,6,11,37,40,-3,39
Brisbane,2038,6,10,5,13,33,42,-9,35
Western Sydn,2038,7,8,9,10,38,47,-9,33
Perth Glory,2038,8,10,2,15,37,50,-13,32
Wellington P,2038,9,5,6,16,31,55,-24,21
CC Mariners,2038,10,4,8,15,28,49,-21,20
Sydney FC,2039,1,21,4,3,67,24,43,67
N'castle Jet,2039,2,16,5,7,60,39,21,53
Melbourne C,2039,3,14,4,11,45,36,9,46
Melbourne V,2039,4,13,5,11,47,41,6,44
Adelaide Utd,2039,5,11,6,11,37,40,-3,39
Brisbane,2039,6,10,5,13,33,42,-9,35
Western Sydn,2039,7,8,9,10,38,47,-9,33
Perth Glory,2039,8,10,2,15,37,50,-13,32
Wellington P,2039,9,5,6,16,31,55,-24,21
CC Mariners,2039,10,4,8,15,28,49,-21,20
Sydney FC,2040,1,20,5,3,65,23,42,65
N'castle Jet,2040,2,16,5,7,60,37,23,53
Melbourne C,2040,3,14,4,11,43,36,7,46
Melbourne V,2040,4,13,6,10,46,39,7,45
Adelaide Utd,2040,5,11,6,11,37,40,-3,39
Brisbane,2040,6,10,5,13,33,42,-9,35
Western Sydn,2040,7,8,9,10,38,47,-9,33
Perth Glory,2040,8,10,2,15,37,50,-13,32
Wellington P,2040,9,5,6,16,31,55,-24,21
CC Mariners,2040,10,4,8,15,28,49,-21,20
Sydney FC,2041,1,21,4,3,65,22,43,67
N'castle Jet,2041,2,16,5,7,60,38,22,53
Melbourne C,2041,3,14,4,11,44,36,8,46
Melbourne V,2041,4,13,5,11,45,39,6,44
Adelaide Utd,2041,5,11,6,11,37,40,-3,39
Brisbane,2041,6,10,5,13,33,42,-9,35
Western Sydn,2041,7,8,9,10,38,47,-9,33
Perth Glory,2041,8,10,2,15,37,50,-13,32
Wellington P,2041,9,5,6,16,31,55,-24,21
CC Mariners,2041,10,4,8,15,28,49,-21,20
Sydney FC,2042,1,21,4,3,66,23,43,67
N'castle Jet,2042,2,16,5,7,62,40,22,53
Melbourne C,2042,3,14,4,11,46,38,8,46
Melbourne V,2042,4,13,5,11,46,40,6,44
Adelaide Utd,2042,5,11,6,11,37,40,-3,39
Brisbane,2042,6,10,5,13,33,42,-9,35
Western Sydn,2042,7,8,9,10,38,47,-9,33
Perth Glory,2042,8,10,2,15,37,50,-13,32
Wellington P,2042,9,5,6,16,31,55,-24,21
CC Mariners,2042,10,4,8,15,28,49,-21,20
Sydney FC,2043,1,20,5,3,66,24,42,65
N'castle Jet,2043,2,15,6,7,59,39,20,51
Melbourne C,2043,3,14,5,10,45,35,10,47
Melbourne V,2043,4,13,6,10,47,40,7,45
Adelaide Utd,2043,5,11,6,11,37,40,-3,39
Brisbane,2043,6,10,5,13,33,42,-9,35
Western Sydn,2043,7,8,9,10,38,47,-9,33
Perth Glory,2043,8,10,2,15,37,50,-13,32
Wellington P,2043,9,5,6,16,31,55,-24,21
CC Mariners,2043,10,4,8,15,28,49,-21,20
Sydney FC,2044,1,20,5,3,65,23,42,65
N'castle Jet,2044,2,16,5,7,58,37,21,53
Melbourne C,2044,3,14,4,11,43,34,9,46
Melbourne V,2044,4,13,6,10,46,39,7,45
Adelaide Utd,2044,5,11,6,11,37,40,-3,39
Brisbane,2044,6,10,5,13,33,42,-9,35
Western Sydn,2044,7,8,9,10,38,47,-9,33
Perth Glory,2044,8,10,2,15,37,50,-13,32
Wellington P,2044,9,5,6,16,31,55,-24,21
CC Mariners,2044,10,4,8,15,28,49,-21,20
Sydney FC,2045,1,20,4,4,66,25,41,64
N'castle Jet,2045,2,15,5,8,57,40,17,50
Melbourne C,2045,3,15,4,10,46,33,13,49
Melbourne V,2045,4,14,5,10,48,40,8,47
Adelaide Utd,2045,5,11,6,11,37,40,-3,39
Brisbane,2045,6,10,5,13,33,42,-9,35
Western Sydn,2045,7,8,9,10,38,47,-9,33
Perth Glory,2045,8,10,2,15,37,50,-13,32
Wellington P,2045,9,5,6,16,31,55,-24,21
CC Mariners,2045,10,4,8,15,28,49,-21,20
Sydney FC,2046,1,21,4,3,69,23,46,67
N'castle Jet,2046,2,15,5,8,57,38,19,50
Melbourne C,2046,3,15,4,10,44,33,11,49
Melbourne V,2046,4,13,5,11,46,43,3,44
Adelaide Utd,2046,5,11,6,11,37,40,-3,39
Brisbane,2046,6,10,5,13,33,42,-9,35
Western Sydn,2046,7,8,9,10,38,47,-9,33
Perth Glory,2046,8,10,2,15,37,50,-13,32
Wellington P,2046,9,5,6,16,31,55,-24,21
CC Mariners,2046,10,4,8,15,28,49,-21,20
Sydney FC,2047,1,21,4,3,66,23,43,67
N'castle Jet,2047,2,16,5,7,62,38,24,53
Melbourne C,2047,3,14,4,11,44,38,6,46
Melbourne V,2047,4,13,5,11,46,40,6,44
Adelaide Utd,2047,5,11,6,11,37,40,-3,39
Brisbane,2047,6,10,5,13,33,42,-9,35
Western Sydn,2047,7,8,9,10,38,47,-9,33
Perth Glory,2047,8,10,2,15,37,50,-13,32
Wellington P,2047,9,5,6,16,31,55,-24,21
CC Mariners,2047,10,4,8,15,28,49,-21,20
Sydney FC,2048,1,20,5,3,66,24,42,65
N'castle Jet,2048,2,16,5,7,59,38,21,53
Melbourne C,2048,3,14,4,11,44,35,9,46
Melbourne V,2048,4,13,6,10,47,40,7,45
Adelaide Utd,2048,5,11,6,11,37,40,-3,39
Brisbane,2048,6,10,5,13,33,42,-9,35
Western Sydn,2048,7,8,9,10,38,47,-9,33
Perth Glory,2048,8,10,2,15,37,50,-13,32
Wellington P,2048,9,5,6,16,31,55,-24,21
CC Mariners,2048,10,4,8,15,28,49,-21,20
Sydney FC,2049,1,20,5,3,66,24,42,65
N'castle Jet,2049,2,15,6,7,57,37,20,51
Melbourne C,2049,3,14,5,10,43,33,10,47
Melbourne V,2049,4,13,6,10,47,40,7,45
Adelaide Utd,2049,5,11,6,11,37,40,-3,39
Brisbane,2049,6,10,5,13,33,42,-9,35
Western Sydn,2049,7,8,9,10,38,47,-9,33
Perth Glory,2049,8,10,2,15,37,50,-13,32
Wellington P,2049,9,5,6,16,31,55,-24,21
CC Mariners,2049,10,4,8,15,28,49,-21,20
Sydney FC,2050,1,21,4,3,66,22,44,67
N'castle Jet,2050,2,16,5,7,58,37,21,53
Melbourne C,2050,3,14,4,11,43,34,9,46
Melbourne V,2050,4,13,5,11,45,40,5,44
Adelaide Utd,2050,5,11,6,11,37,40,-3,39
Brisbane,2050,6,10,5,13,33,42,-9,35
Western Sydn,2050,7,8,9,10,38,47,-9,33
Perth Glory,2050,8,10,2,15,37,50,-13,32
Wellington P,2050,9,5,6,16,31,55,-24,21
CC Mariners,2050,10,4,8,15,28,49,-21,20
Sydney FC,2051,1,21,4,3,67,23,44,67
N'castle Jet,2051,2,16,5,7,62,37,25,53
Melbourne C,2051,3,14,4,11,43,38,5,46
Melbourne V,2051,4,13,5,11,46,41,5,44
Adelaide Utd,2051,5,11,6,11,37,40,-3,39
Brisbane,2051,6,10,5,13,33,42,-9,35
Western Sydn,2051,7,8,9,10,38,47,-9,33
Perth Glory,2051,8,10,2,15,37,50,-13,32
Wellington P,2051,9,5,6,16,31,55,-24,21
CC Mariners,2051,10,4,8,15,28,49,-21,20
Sydney FC,2052,1,21,4,3,66,22,44,67
N'castle Jet,2052,2,16,5,7,60,39,21,53
Melbourne C,2052,3,14,4,11,45,36,9,46
Melbourne V,2052,4,13,5,11,45,40,5,44
Adelaide Utd,2052,5,11,6,11,37,40,-3,39
Brisbane,2052,6,10,5,13,33,42,-9,35
Western Sydn,2052,7,8,9,10,38,47,-9,33
Perth Glory,2052,8,10,2,15,37,50,-13,32
Wellington P,2052,9,5,6,16,31,55,-24,21
CC Mariners,2052,10,4,8,15,28,49,-21,20
Sydney FC,2053,1,21,4,3,65,22,43,67
N'castle Jet,2053,2,16,5,7,59,37,22,53
Melbourne C,2053,3,14,4,11,43,35,8,46
Melbourne V,2053,4,13,5,11,45,39,6,44
Adelaide Utd,2053,5,11,6,11,37,40,-3,39
Brisbane,2053,6,10,5,13,33,42,-9,35
Western Sydn,2053,7,8,9,10,38,47,-9,33
Perth Glory,2053,8,10,2,15,37,50,-13,32
Wellington P,2053,9,5,6,16,31,55,-24,21
CC Mariners,2053,10,4,8,15,28,49,-21,20
Sydney FC,2054,1,21,4,3,69,23,46,67
N'castle Jet,2054,2,15,5,8,59,40,19,50
Melbourne C,2054,3,15,4,10,46,35,11,49
Melbourne V,2054,4,13,5,11,46,43,3,44
Adelaide Utd,2054,5,11,6,11,37,40,-3,39
Brisbane,2054,6,10,5,13,33,42,-9,35
Western Sydn,2054,7,8,9,10,38,47,-9,33
Perth Glory,2054,8,10,2,15,37,50,-13,32
Wellington P,2054,9,5,6,16,31,55,-24,21
CC Mariners,2054,10,4,8,15,28,49,-21,20
Sydney FC,2055,1,21,4,3,68,23,45,67
N'castle Jet,2055,2,16,5,7,59,38,21,53
Melbourne C,2055,3,14,4,11,44,35,9,46
Melbourne V,2055,4,13,5,11,46,42,4,44
Adelaide Utd,2055,5,11,6,11,37,40,-3,39
Brisbane,2055,6,10,5,13,33,42,-9,35
Western Sydn,2055,7,8,9,10,38,47,-9,33
Perth Glory,2055,8,10,2,15,37,50,-13,32
Wellington P,2055,9,5,6,16,31,55,-24,21
CC Mariners,2055,10,4,8,15,28,49,-21,20
Sydney FC,2056,1,21,4,3,67,23,44,67
N'castle Jet,2056,2,15,5,8,58,39,19,50
Melbourne C,2056,3,15,4,10,45,34,11,49
Melbourne V,2056,4,13,5,11,46,41,5,44
Adelaide Utd,2056,5,11,6,11,37,40,-3,39
Brisbane,2056,6,10,5,13,33,42,-9,35
Western Sydn,2056,7,8,9,10,38,47,-9,33
Perth Glory,2056,8,10,2,15,37,50,-13,32
Wellington P,2056,9,5,6,16,31,55,-24,21
CC Mariners,2056,10,4,8,15,28,49,-21,20
Sydney FC,2057,1,21,4,3,66,23,43,67
N'castle Jet,2057,2,15,5,8,58,40,18,50
Melbourne C,2057,3,15,4,10,46,34,12,49
Melbourne V,2057,4,13,5,11,46,40,6,44
Adelaide Utd,2057,5,11,6,11,37,40,-3,39
Brisbane,2057,6,10,5,13,33,42,-9,35
Western Sydn,2057,7,8,9,10,38,47,-9,33
Perth Glory,2057,8,10,2,15,37,50,-13,32
Wellington P,2057,9,5,6,16,31,55,-24,21
CC Mariners,2057,10,4,8,15,28,49,-21,20
Sydney FC,2058,1,21,4,3,66,23,43,67
N'castle Jet,2058,2,15,6,7,58,38,20,51
Melbourne C,2058,3,14,5,10,44,34,10,47
Melbourne V,2058,4,13,5,11,46,40,6,44
Adelaide Utd,2058,5,11,6,11,37,40,-3,39
Brisbane,2058,6,10,5,13,33,42,-9,35
Western Sydn,2058,7,8,9,10,38,47,-9,33
Perth Glory,2058,8,10,2,15,37,50,-13,32
Wellington P,2058,9,5,6,16,31,55,-24,21
CC Mariners,2058,10,4,8,15,28,49,-21,20
Sydney FC,2059,1,20,4,4,65,24,41,64
N'castle Jet,2059,2,15,5,8,58,39,19,50
Melbourne C,2059,3,15,4,10,45,34,11,49
Melbourne V,2059,4,14,5,10,47,39,8,47
Adelaide Utd,2059,5,11,6,11,37,40,-3,39
Brisbane,2059,6,10,5,13,33,42,-9,35
Western Sydn,2059,7,8,9,10,38,47,-9,33
Perth Glory,2059,8,10,2,15,37,50,-13,32
Wellington P,2059,9,5,6,16,31,55,-24,21
CC Mariners,2059,10,4,8,15,28,49,-21,20
Sydney FC,2060,1,21,4,3,66,23,43,67
N'castle Jet,2060,2,15,5,8,58,41,17,50
Melbourne C,2060,3,15,4,10,47,34,13,49
Melbourne V,2060,4,13,5,11,46,40,6,44
Adelaide Utd,2060,5,11,6,11,37,40,-3,39
Brisbane,2060,6,10,5,13,33,42,-9,35
Western Sydn,2060,7,8,9,10,38,47,-9,33
Perth Glory,2060,8,10,2,15,37,50,-13,32
Wellington P,2060,9,5,6,16,31,55,-24,21
CC Mariners,2060,10,4,8,15,28,49,-21,20
Sydney FC,2061,1,21,4,3,67,23,44,67
N'castle Jet,2061,2,16,5,7,60,39,21,53
Melbourne C,2061,3,14,4,11,45,36,9,46
Melbourne V,2061,4,13,5,11,46,41,5,44
Adelaide Utd,2061,5,11,6,11,37,40,-3,39
Brisbane,2061,6,10,5,13,33,42,-9,35
Western Sydn,2061,7,8,9,10,38,47,-9,33
Perth Glory,2061,8,10,2,15,37,50,-13,32
Wellington P,2061,9,5,6,16,31,55,-24,21
CC Mariners,2061,10,4,8,15,28,49,-21,20
Sydney FC,2062,1,21,4,3,69,24,45,67
N'castle Jet,2062,2,16,5,7,60,38,22,53
Melbourne C,2062,3,14,4,11,44,36,8,46
Melbourne V,2062,4,13,5,11,47,43,4,44
Adelaide Utd,2062,5,11,6,11,37,40,-3,39
Brisbane,2062,6,10,5,13,33,42,-9,35
Western Sydn,2062,7,8,9,10,38,47,-9,33
Perth Glory,2062,8,10,2,15,37,50,-13,32
Wellington P,2062,9,5,6,16,31,55,-24,21
CC Mariners,2062,10,4,8,15,28,49,-21,20
Sydney FC,2063,1,21,4,3,66,22,44,67
N'castle Jet,2063,2,16,5,7,60,38,22,53
Melbourne C,2063,3,14,4,11,44,36,8,46
Melbourne V,2063,4,13,5,11,45,40,5,44
Adelaide Utd,2063,5,11,6,11,37,40,-3,39
Brisbane,2063,6,10,5,13,33,42,-9,35
Western Sydn,2063,7,8,9,10,38,47,-9,33
Perth Glory,2063,8,10,2,15,37,50,-13,32
Wellington P,2063,9,5,6,16,31,55,-24,21
CC Mariners,2063,10,4,8,15,28,49,-21,20
Sydney FC,2064,1,21,4,3,66,23,43,67
N'castle Jet,2064,2,16,5,7,58,37,21,53
Melbourne C,2064,3,14,4,11,43,34,9,46
Melbourne V,2064,4,13,5,11,46,40,6,44
Adelaide Utd,2064,5,11,6,11,37,40,-3,39
Brisbane,2064,6,10,5,13,33,42,-9,35
Western Sydn,2064,7,8,9,10,38,47,-9,33
Perth Glory,2064,8,10,2,15,37,50,-13,32
Wellington P,2064,9,5,6,16,31,55,-24,21
CC Mariners,2064,10,4,8,15,28,49,-21,20
Sydney FC,2065,1,21,4,3,65,22,43,67
N'castle Jet,2065,2,15,5,8,57,38,19,50
Melbourne C,2065,3,15,4,10,44,33,11,49
Melbourne V,2065,4,13,5,11,45,39,6,44
Adelaide Utd,2065,5,11,6,11,37,40,-3,39
Brisbane,2065,6,10,5,13,33,42,-9,35
Western Sydn,2065,7,8,9,10,38,47,-9,33
Perth Glory,2065,8,10,2,15,37,50,-13,32
Wellington P,2065,9,5,6,16,31,55,-24,21
CC Mariners,2065,10,4,8,15,28,49,-21,20
Sydney FC,2066,1,21,4,3,66,23,43,67
N'castle Jet,2066,2,16,5,7,59,37,22,53
Melbourne C,2066,3,14,4,11,43,35,8,46
Melbourne V,2066,4,13,5,11,46,40,6,44
Adelaide Utd,2066,5,11,6,11,37,40,-3,39
Brisbane,2066,6,10,5,13,33,42,-9,35
Western Sydn,2066,7,8,9,10,38,47,-9,33
Perth Glory,2066,8,10,2,15,37,50,-13,32
Wellington P,2066,9,5,6,16,31,55,-24,21
CC Mariners,2066,10,4,8,15,28,49,-21,20
Sydney FC,2067,1,20,4,4,65,24,41,64
N'castle Jet,2067,2,15,5,8,58,39,19,50
Melbourne C,2067,3,15,4,10,45,34,11,49
Melbourne V,2067,4,14,5,10,47,39,8,47
Adelaide Utd,2067,5,11,6,11,37,40,-3,39
Brisbane,2067,6,10,5,13,33,42,-9,35
Western Sydn,2067,7,8,9,10,38,47,-9,33
Perth Glory,2067,8,10,2,15,37,50,-13,32
Wellington P,2067,9,5,6,16,31,55,-24,21
CC Mariners,2067,10,4,8,15,28,49,-21,20
Sydney FC,2068,1,21,4,3,67,22,45,67
N'castle Jet,2068,2,16,5,7,60,38,22,53
Melbourne C,2068,3,14,4,11,44,36,8,46
Melbourne V,2068,4,13,5,11,45,41,4,44
Adelaide Utd,2068,5,11,6,11,37,40,-3,39
Brisbane,2068,6,10,5,13,33,42,-9,35
Western Sydn,2068,7,8,9,10,38,47,-9,33
Perth Glory,2068,8,10,2,15,37,50,-13,32
Wellington P,2068,9,5,6,16,31,55,-24,21
CC Mariners,2068,10,4,8,15,28,49,-21,20
Sydney FC,2069,1,21,4,3,66,23,43,67
N'castle Jet,2069,2,15,6,7,58,38,20,51
Melbourne C,2069,3,14,5,10,44,34,10,47
Melbourne V,2069,4,13,5,11,46,40,6,44
Adelaide Utd,2069,5,11,6,11,37,40,-3,39
Brisbane,2069,6,10,5,13,33,42,-9,35
Western Sydn,2069,7,8,9,10,38,47,-9,33
Perth Glory,2069,8,10,2,15,37,50,-13,32
Wellington P,2069,9,5,6,16,31,55,-24,21
CC Mariners,2069,10,4,8,15,28,49,-21,20
Sydney FC,2070,1,21,4,3,69,23,46,67
N'castle Jet,2070,2,16,5,7,60,39,21,53
Melbourne C,2070,3,14,4,11,45,36,9,46
Melbourne V,2070,4,13,5,11,46,43,3,44
Adelaide Utd,2070,5,11,6,11,37,40,-3,39
Brisbane,2070,6,10,5,13,33,42,-9,35
Western Sydn,2070,7,8,9,10,38,47,-9,33
Perth Glory,2070,8,10,2,15,37,50,-13,32
Wellington P,2070,9,5,6,16,31,55,-24,21
CC Mariners,2070,10,4,8,15,28,49,-21,20
Sydney FC,2071,1,21,4,3,66,22,44,67
N'castle Jet,2071,2,15,6,7,59,39,20,51
Melbourne C,2071,3,14,5,10,45,35,10,47
Melbourne V,2071,4,13,5,11,45,40,5,44
Adelaide Utd,2071,5,11,6,11,37,40,-3,39
Brisbane,2071,6,10,5,13,33,42,-9,35
Western Sydn,2071,7,8,9,10,38,47,-9,33
Perth Glory,2071,8,10,2,15,37,50,-13,32
Wellington P,2071,9,5,6,16,31,55,-24,21
CC Mariners,2071,10,4,8,15,28,49,-21,20
Sydney FC,2072,1,20,5,3,65,23,42,65
N'castle Jet,2072,2,16,5,7,59,38,21,53
Melbourne C,2072,3,14,4,11,44,35,9,46
Melbourne V,2072,4,13,6,10,46,39,7,45
Adelaide Utd,2072,5,11,6,11,37,40,-3,39
Brisbane,2072,6,10,5,13,33,42,-9,35
Western Sydn,2072,7,8,9,10,38,47,-9,33
Perth Glory,2072,8,10,2,15,37,50,-13,32
Wellington P,2072,9,5,6,16,31,55,-24,21
CC Mariners,2072,10,4,8,15,28,49,-21,20
Sydney FC,2073,1,20,4,4,65,24,41,64
N'castle Jet,2073,2,15,5,8,58,39,19,50
Melbourne C,2073,3,15,4,10,45,34,11,49
Melbourne V,2073,4,14,5,10,47,39,8,47
Adelaide Utd,2073,5,11,6,11,37,40,-3,39
Brisbane,2073,6,10,5,13,33,42,-9,35
Western Sydn,2073,7,8,9,10,38,47,-9,33
Perth Glory,2073,8,10,2,15,37,50,-13,32
Wellington P,2073,9,5,6,16,31,55,-24,21
CC Mariners,2073,10,4,8,15,28,49,-21,20
Sydney FC,2074,1,21,4,3,66,22,44,67
N'castle Jet,2074,2,15,5,8,59,40,19,50
Melbourne C,2074,3,15,4,10,46,35,11,49
Melbourne V,2074,4,13,5,11,45,40,5,44
Adelaide Utd,2074,5,11,6,11,37,40,-3,39
Brisbane,2074,6,10,5,13,33,42,-9,35
Western Sydn,2074,7,8,9,10,38,47,-9,33
Perth Glory,2074,8,10,2,15,37,50,-13,32
Wellington P,2074,9,5,6,16,31,55,-24,21
CC Mariners,2074,10,4,8,15,28,49,-21,20
Sydney FC,2075,1,21,4,3,66,23,43,67
N'castle Jet,2075,2,15,6,7,58,38,20,51
Melbourne C,2075,3,14,5,10,44,34,10,47
Melbourne V,2075,4,13,5,11,46,40,6,44
Adelaide Utd,2075,5,11,6,11,37,40,-3,39
Brisbane,2075,6,10,5,13,33,42,-9,35
Western Sydn,2075,7,8,9,10,38,47,-9,33
Perth Glory,2075,8,10,2,15,37,50,-13,32
Wellington P,2075,9,5,6,16,31,55,-24,21
CC Mariners,2075,10,4,8,15,28,49,-21,20
Sydney FC,2076,1,21,4,3,67,23,44,67
N'castle Jet,2076,2,16,5,7,59,37,22,53
Melbourne C,2076,3,14,4,11,43,35,8,46
Melbourne V,2076,4,13,5,11,46,41,5,44
Adelaide Utd,2076,5,11,6,11,37,40,-3,39
Brisbane,2076,6,10,5,13,33,42,-9,35
Western Sydn,2076,7,8,9,10,38,47,-9,33
Perth Glory,2076,8,10,2,15,37,50,-13,32
Wellington P,2076,9,5,6,16,31,55,-24,21
CC Mariners,2076,10,4,8,15,28,49,-21,20
Sydney FC,2077,1,20,5,3,64,22,42,65
N'castle Jet,2077,2,16,5,7,59,38,21,53
Melbourne C,2077,3,14,4,11,44,35,9,46
Melbourne V,2077,4,13,6,10,45,38,7,45
Adelaide Utd,2077,5,11,6,11,37,40,-3,39
Brisbane,2077,6,10,5,13,33,42,-9,35
Western Sydn,2077,7,8,9,10,38,47,-9,33
Perth Glory,2077,8,10,2,15,37,50,-13,32
Wellington P,2077,9,5,6,16,31,55,-24,21
CC Mariners,2077,10,4,8,15,28,49,-21,20
Sydney FC,2078,1,20,4,4,65,24,41,64
N'castle Jet,2078,2,15,6,7,58,38,20,51
Melbourne C,2078,3,14,5,10,44,34,10,47
Melbourne V,2078,4,14,5,10,47,39,8,47
Adelaide Utd,2078,5,11,6,11,37,40,-3,39
Brisbane,2078,6,10,5,13,33,42,-9,35
Western Sydn,2078,7,8,9,10,38,47,-9,33
Perth Glory,2078,8,10,2,15,37,50,-13,32
Wellington P,2078,9,5,6,16,31,55,-24,21
CC Mariners,2078,10,4,8,15,28,49,-21,20
Sydney FC,2079,1,21,4,3,69,24,45,67
N'castle Jet,2079,2,15,6,7,59,39,20,51
Melbourne C,2079,3,14,5,10,45,35,10,47
Melbourne V,2079,4,13,5,11,47,43,4,44
Adelaide Utd,2079,5,11,6,11,37,40,-3,39
Brisbane,2079,6,10,5,13,33,42,-9,35
Western Sydn,2079,7,8,9,10,38,47,-9,33
Perth Glory,2079,8,10,2,15,37,50,-13,32
Wellington P,2079,9,5,6,16,31,55,-24,21
CC Mariners,2079,10,4,8,15,28,49,-21,20
Sydney FC,2080,1,21,4,3,65,22,43,67
N'castle Jet,2080,2,15,5,8,58,39,19,50
Melbourne C,2080,3,15,4,10,45,34,11,49
Melbourne V,2080,4,13,5,11,45,39,6,44
Adelaide Utd,2080,5,11,6,11,37,40,-3,39
Brisbane,2080,6,10,5,13,33,42,-9,35
Western Sydn,2080,7,8,9,10,38,47,-9,33
Perth Glory,2080,8,10,2,15,37,50,-13,32
Wellington P,2080,9,5,6,16,31,55,-24,21
CC Mariners,2080,10,4,8,15,28,49,-21,20
Sydney FC,2081,1,21,4,3,67,22,45,67
N'castle Jet,2081,2,15,5,8,57,38,19,50
Melbourne C,2081,3,15,4,10,44,33,11,49
Melbourne V,2081,4,13,5,11,45,41,4,44
Adelaide Utd,2081,5,11,6,11,37,40,-3,39
Brisbane,2081,6,10,5,13,33,42,-9,35
Western Sydn,2081,7,8,9,10,38,47,-9,33
Perth Glory,2081,8,10,2,15,37,50,-13,32
Wellington P,2081,9,5,6,16,31,55,-24,21
CC Mariners,2081,10,4,8,15,28,49,-21,20
Sydney FC,2082,1,21,4,3,65,22,43,67
N'castle Jet,2082,2,16,5,7,59,38,21,53
Melbourne C,2082,3,14,4,11,44,35,9,46
Melbourne V,2082,4,13,5,11,45,39,6,44
Adelaide Utd,2082,5,11,6,11,37,40,-3,39
Brisbane,2082,6,10,5,13,33,42,-9,35
Western Sydn,2082,7,8,9,10,38,47,-9,33
Perth Glory,2082,8,10,2,15,37,50,-13,32
Wellington P,2082,9,5,6,16,31,55,-24,21
CC Mariners,2082,10,4,8,15,28,49,-21,20
Sydney FC,2083,1,21,4,3,69,22,47,67
N'castle Jet,2083,2,15,6,7,58,38,20,51
Melbourne C,2083,3,14,5,10,44,34,10,47
Melbourne V,2083,4,13,5,11,45,43,2,44
Adelaide Utd,2083,5,11,6,11,37,40,-3,39
Brisbane,2083,6,10,5,13,33,42,-9,35
Western Sydn,2083,7,8,9,10,38,47,-9,33
Perth Glory,2083,8,10,2,15,37,50,-13,32
Wellington P,2083,9,5,6,16,31,55,-24,21
CC Mariners,2083,10,4,8,15,28,49,-21,20
Sydney FC,2084,1,20,4,4,65,24,41,64
N'castle Jet,2084,2,16,5,7,60,39,21,53
Melbourne V,2084,3,14,5,10,47,39,8,47
Melbourne C,2084,4,14,4,11,45,36,9,46
Adelaide Utd,2084,5,11,6,11,37,40,-3,39
Brisbane,2084,6,10,5,13,33,42,-9,35
Western Sydn,2084,7,8,9,10,38,47,-9,33
Perth Glory,2084,8,10,2,15,37,50,-13,32
Wellington P,2084,9,5,6,16,31,55,-24,21
CC Mariners,2084,10,4,8,15,28,49,-21,20
Sydney FC,2085,1,21,4,3,66,22,44,67
N'castle Jet,2085,2,16,5,7,59,38,21,53
Melbourne C,2085,3,14,4,11,44,35,9,46
Melbourne V,2085,4,13,5,11,45,40,5,44
Adelaide Utd,2085,5,11,6,11,37,40,-3,39
Brisbane,2085,6,10,5,13,33,42,-9,35
Western Sydn,2085,7,8,9,10,38,47,-9,33
Perth Glory,2085,8,10,2,15,37,50,-13,32
Wellington P,2085,9,5,6,16,31,55,-24,21
CC Mariners,2085,10,4,8,15,28,49,-21,20
Sydney FC,2086,1,21,4,3,69,24,45,67
N'castle Jet,2086,2,16,5,7,58,37,21,53
Melbourne C,2086,3,14,4,11,43,34,9,46
Melbourne V,2086,4,13,5,11,47,43,4,44
Adelaide Utd,2086,5,11,6,11,37,40,-3,39
Brisbane,2086,6,10,5,13,33,42,-9,35
Western Sydn,2086,7,8,9,10,38,47,-9,33
Perth Glory,2086,8,10,2,15,37,50,-13,32
Wellington P,2086,9,5,6,16,31,55,-24,21
CC Mariners,2086,10,4,8,15,28,49,-21,20
Sydney FC,2087,1,21,4,3,67,23,44,67
N'castle Jet,2087,2,15,6,7,60,40,20,51
Melbourne C,2087,3,14,5,10,46,36,10,47
Melbourne V,2087,4,13,5,11,46,41,5,44
Adelaide Utd,2087,5,11,6,11,37,40,-3,39
Brisbane,2087,6,10,5,13,33,42,-9,35
Western Sydn,2087,7,8,9,10,38,47,-9,33
Perth Glory,2087,8,10,2,15,37,50,-13,32
Wellington P,2087,9,5,6,16,31,55,-24,21
CC Mariners,2087,10,4,8,15,28,49,-21,20
Sydney FC,2088,1,21,4,3,66,23,43,67
N'castle Jet,2088,2,15,6,7,58,38,20,51
Melbourne C,2088,3,14,5,10,44,34,10,47
Melbourne V,2088,4,13,5,11,46,40,6,44
Adelaide Utd,2088,5,11,6,11,37,40,-3,39
Brisbane,2088,6,10,5,13,33,42,-9,35
Western Sydn,2088,7,8,9,10,38,47,-9,33
Perth Glory,2088,8,10,2,15,37,50,-13,32
Wellington P,2088,9,5,6,16,31,55,-24,21
CC Mariners,2088,10,4,8,15,28,49,-21,20
Sydney FC,2089,1,20,4,4,66,25,41,64
N'castle Jet,2089,2,15,6,7,58,38,20,51
Melbourne C,2089,3,14,5,10,44,34,10,47
Melbourne V,2089,4,14,5,10,48,40,8,47
Adelaide Utd,2089,5,11,6,11,37,40,-3,39
Brisbane,2089,6,10,5,13,33,42,-9,35
Western Sydn,2089,7,8,9,10,38,47,-9,33
Perth Glory,2089,8,10,2,15,37,50,-13,32
Wellington P,2089,9,5,6,16,31,55,-24,21
CC Mariners,2089,10,4,8,15,28,49,-21,20
Sydney FC,2090,1,20,5,3,64,22,42,65
N'castle Jet,2090,2,15,6,7,58,38,20,51
Melbourne C,2090,3,14,5,10,44,34,10,47
Melbourne V,2090,4,13,6,10,45,38,7,45
Adelaide Utd,2090,5,11,6,11,37,40,-3,39
Brisbane,2090,6,10,5,13,33,42,-9,35
Western Sydn,2090,7,8,9,10,38,47,-9,33
Perth Glory,2090,8,10,2,15,37,50,-13,32
Wellington P,2090,9,5,6,16,31,55,-24,21
CC Mariners,2090,10,4,8,15,28,49,-21,20
Sydney FC,2091,1,20,5,3,65,23,42,65
N'castle Jet,2091,2,16,5,7,60,37,23,53
Melbourne C,2091,3,14,4,11,43,36,7,46
Melbourne V,2091,4,13,6,10,46,39,7,45
Adelaide Utd,2091,5,11,6,11,37,40,-3,39
Brisbane,2091,6,10,5,13,33,42,-9,35
Western Sydn,2091,7,8,9,10,38,47,-9,33
Perth Glory,2091,8,10,2,15,37,50,-13,32
Wellington P,2091,9,5,6,16,31,55,-24,21
CC Mariners,2091,10,4,8,15,28,49,-21,20
Sydney FC,2092,1,21,4,3,68,23,45,67
N'castle Jet,2092,2,15,6,7,57,37,20,51
Melbourne C,2092,3,14,5,10,43,33,10,47
Melbourne V,2092,4,13,5,11,46,42,4,44
Adelaide Utd,2092,5,11,6,11,37,40,-3,39
Brisbane,2092,6,10,5,13,33,42,-9,35
Western Sydn,2092,7,8,9,10,38,47,-9,33
Perth Glory,2092,8,10,2,15,37,50,-13,32
Wellington P,2092,9,5,6,16,31,55,-24,21
CC Mariners,2092,10,4,8,15,28,49,-21,20
Sydney FC,2093,1,20,5,3,65,23,42,65
N'castle Jet,2093,2,16,5,7,58,37,21,53
Melbourne C,2093,3,14,4,11,43,34,9,46
Melbourne V,2093,4,13,6,10,46,39,7,45
Adelaide Utd,2093,5,11,6,11,37,40,-3,39
Brisbane,2093,6,10,5,13,33,42,-9,35
Western Sydn,2093,7,8,9,10,38,47,-9,33
Perth Glory,2093,8,10,2,15,37,50,-13,32
Wellington P,2093,9,5,6,16,31,55,-24,21
CC Mariners,2093,10,4,8,15,28,49,-21,20
Sydney FC,2094,1,20,4,4,64,23,41,64
N'castle Jet,2094,2,16,5,7,59,37,22,53
Melbourne V,2094,3,14,5,10,46,38,8,47
Melbourne C,2094,4,14,4,11,43,35,8,46
Adelaide Utd,2094,5,11,6,11,37,40,-3,39
Brisbane,2094,6,10,5,13,33,42,-9,35
Western Sydn,2094,7,8,9,10,38,47,-9,33
Perth Glory,2094,8,10,2,15,37,50,-13,32
Wellington P,2094,9,5,6,16,31,55,-24,21
CC Mariners,2094,10,4,8,15,28,49,-21,20
Sydney FC,2095,1,21,4,3,67,23,44,67
N'castle Jet,2095,2,15,5,8,58,39,19,50
Melbourne C,2095,3,15,4,10,45,34,11,49
Melbourne V,2095,4,13,5,11,46,41,5,44
Adelaide Utd,2095,5,11,6,11,37,40,-3,39
Brisbane,2095,6,10,5,13,33,42,-9,35
Western Sydn,2095,7,8,9,10,38,47,-9,33
Perth Glory,2095,8,10,2,15,37,50,-13,32
Wellington P,2095,9,5,6,16,31,55,-24,21
CC Mariners,2095,10,4,8,15,28,49,-21,20
Sydney FC,2096,1,20,5,3,67,25,42,65
N'castle Jet,2096,2,16,5,7,60,38,22,53
Melbourne C,2096,3,14,4,11,44,36,8,46
Melbourne V,2096,4,13,6,10,48,41,7,45
Adelaide Utd,2096,5,11,6,11,37,40,-3,39
Brisbane,2096,6,10,5,13,33,42,-9,35
Western Sydn,2096,7,8,9,10,38,47,-9,33
Perth Glory,2096,8,10,2,15,37,50,-13,32
Wellington P,2096,9,5,6,16,31,55,-24,21
CC Mariners,2096,10,4,8,15,28,49,-21,20
Sydney FC,2097,1,21,4,3,68,23,45,67
N'castle Jet,2097,2,16,5,7,61,38,23,53
Melbourne C,2097,3,14,4,11,44,37,7,46
Melbourne V,2097,4,13,5,11,46,42,4,44
Adelaide Utd,2097,5,11,6,11,37,40,-3,39
Brisbane,2097,6,10,5,13,33,42,-9,35
Western Sydn,2097,7,8,9,10,38,47,-9,33
Perth Glory,2097,8,10,2,15,37,50,-13,32
Wellington P,2097,9,5,6,16,31,55,-24,21
CC Mariners,2097,10,4,8,15,28,49,-21,20
Sydney FC,2098,1,20,4,4,64,24,40,64
N'castle Jet,2098,2,15,6,7,58,38,20,51
Melbourne C,2098,3,14,5,10,44,34,10,47
Melbourne V,2098,4,14,5,10,47,38,9,47
Adelaide Utd,2098,5,11,6,11,37,40,-3,39
Brisbane,2098,6,10,5,13,33,42,-9,35
Western Sydn,2098,7,8,9,10,38,47,-9,33
Perth Glory,2098,8,10,2,15,37,50,-13,32
Wellington P,2098,9,5,6,16,31,55,-24,21
CC Mariners,2098,10,4,8,15,28,49,-21,20
Sydney FC,2099,1,21,4,3,66,22,44,67
N'castle Jet,2099,2,16,5,7,58,37,21,53
Melbourne C,2099,3,14,4,11,43,34,9,46
Melbourne V,2099,4,13,5,11,45,40,5,44
Adelaide Utd,2099,5,11,6,11,37,40,-3,39
Brisbane,2099,6,10,5,13,33,42,-9,35
Western Sydn,2099,7,8,9,10,38,47,-9,33
Perth Glory,2099,8,10,2,15,37,50,-13,32
Wellington P,2099,9,5,6,16,31,55,-24,21
CC Mariners,2099,10,4,8,15,28,49,-21,20
Sydney FC,2100,1,20,4,4,66,25,41,64
N'castle Jet,2100,2,16,5,7,58,37,21,53
Melbourne V,2100,3,14,5,10,48,40,8,47
Melbourne C,2100,4,14,4,11,43,34,9,46
Adelaide Utd,2100,5,11,6,11,37,40,-3,39
Brisbane,2100,6,10,5,13,33,42,-9,35
Western Sydn,2100,7,8,9,10,38,47,-9,33
Perth Glory,2100,8,10,2,15,37,50,-13,32
Wellington P,2100,9,5,6,16,31,55,-24,21
CC Mariners,2100,10,4,8,15,28,49,-21,20
Sydney FC,2101,1,21,4,3,66,22,44,67
N'castle Jet,2101,2,16,5,7,60,38,22,53
Melbourne C,2101,3,14,4,11,44,36,8,46
Melbourne V,2101,4,13,5,11,45,40,5,44
Adelaide Utd,2101,5,11,6,11,37,40,-3,39
Brisbane,2101,6,10,5,13,33,42,-9,35
Western Sydn,2101,7,8,9,10,38,47,-9,33
Perth Glory,2101,8,10,2,15,37,50,-13,32
Wellington P,2101,9,5,6,16,31,55,-24,21
CC Mariners,2101,10,4,8,15,28,49,-21,20
Sydney FC,2102,1,20,5,3,65,23,42,65
N'castle Jet,2102,2,16,5,7,61,37,24,53
Melbourne C,2102,3,14,4,11,43,37,6,46
Melbourne V,2102,4,13,6,10,46,39,7,45
Adelaide Utd,2102,5,11,6,11,37,40,-3,39
Brisbane,2102,6,10,5,13,33,42,-9,35
Western Sydn,2102,7,8,9,10,38,47,-9,33
Perth Glory,2102,8,10,2,15,37,50,-13,32
Wellington P,2102,9,5,6,16,31,55,-24,21
CC Mariners,2102,10,4,8,15,28,49,-21,20
Sydney FC,2103,1,20,5,3,66,24,42,65
N'castle Jet,2103,2,15,5,8,57,39,18,50
Melbourne C,2103,3,15,4,10,45,33,12,49
Melbourne V,2103,4,13,6,10,47,40,7,45
Adelaide Utd,2103,5,11,6,11,37,40,-3,39
Brisbane,2103,6,10,5,13,33,42,-9,35
Western Sydn,2103,7,8,9,10,38,47,-9,33
Perth Glory,2103,8,10,2,15,37,50,-13,32
Wellington P,2103,9,5,6,16,31,55,-24,21
CC Mariners,2103,10,4,8,15,28,49,-21,20
Sydney FC,2104,1,21,4,3,67,23,44,67
N'castle Jet,2104,2,16,5,7,61,37,24,53
Melbourne C,2104,3,14,4,11,43,37,6,46
Melbourne V,2104,4,13,5,11,46,41,5,44
Adelaide Utd,2104,5,11,6,11,37,40,-3,39
Brisbane,2104,6,10,5,13,33,42,-9,35
Western Sydn,2104,7,8,9,10,38,47,-9,33
Perth Glory,2104,8,10,2,15,37,50,-13,32
Wellington P,2104,9,5,6,16,31,55,-24,21
CC Mariners,2104,10,4,8,15,28,49,-21,20
Sydney FC,2105,1,21,4,3,67,24,43,67
N'castle Jet,2105,2,16,5,7,61,38,23,53
Melbourne C,2105,3,14,4,11,44,37,7,46
Melbourne V,2105,4,13,5,11,47,41,6,44
Adelaide Utd,2105,5,11,6,11,37,40,-3,39
Brisbane,2105,6,10,5,13,33,42,-9,35
Western Sydn,2105,7,8,9,10,38,47,-9,33
Perth Glory,2105,8,10,2,15,37,50,-13,32
Wellington P,2105,9,5,6,16,31,55,-24,21
CC Mariners,2105,10,4,8,15,28,49,-21,20
Sydney FC,2106,1,20,4,4,65,26,39,64
N'castle Jet,2106,2,16,5,7,59,37,22,53
Melbourne V,2106,3,14,5,10,49,39,10,47
Melbourne C,2106,4,14,4,11,43,35,8,46
Adelaide Utd,2106,5,11,6,11,37,40,-3,39
Brisbane,2106,6,10,5,13,33,42,-9,35
Western Sydn,2106,7,8,9,10,38,47,-9,33
Perth Glory,2106,8,10,2,15,37,50,-13,32
Wellington P,2106,9,5,6,16,31,55,-24,21
CC Mariners,2106,10,4,8,15,28,49,-21,20
Sydney FC,2107,1,20,4,4,64,24,40,64
N'castle Jet,2107,2,15,6,7,58,38,20,51
Melbourne C,2107,3,14,5,10,44,34,10,47
Melbourne V,2107,4,14,5,10,47,38,9,47
Adelaide Utd,2107,5,11,6,11,37,40,-3,39
Brisbane,2107,6,10,5,13,33,42,-9,35
Western Sydn,2107,7,8,9,10,38,47,-9,33
Perth Glory,2107,8,10,2,15,37,50,-13,32
Wellington P,2107,9,5,6,16,31,55,-24,21
CC Mariners,2107,10,4,8,15,28,49,-21,20
Sydney FC,2108,1,21,4,3,66,22,44,67
N'castle Jet,2108,2,15,6,7,58,38,20,51
Melbourne C,2108,3,14,5,10,44,34,10,47
Melbourne V,2108,4,13,5,11,45,40,5,44
Adelaide Utd,2108,5,11,6,11,37,40,-3,39
Brisbane,2108,6,10,5,13,33,42,-9,35
Western Sydn,2108,7,8,9,10,38,47,-9,33
Perth Glory,2108,8,10,2,15,37,50,-13,32
Wellington P,2108,9,5,6,16,31,55,-24,21
CC Mariners,2108,10,4,8,15,28,49,-21,20
Sydney FC,2109,1,20,5,3,65,23,42,65
N'castle Jet,2109,2,15,5,8,58,43,15,50
Melbourne C,2109,3,15,4,10,49,34,15,49
Melbourne V,2109,4,13,6,10,46,39,7,45
Adelaide Utd,2109,5,11,6,11,37,40,-3,39
Brisbane,2109,6,10,5,13,33,42,-9,35
Western Sydn,2109,7,8,9,10,38,47,-9,33
Perth Glory,2109,8,10,2,15,37,50,-13,32
Wellington P,2109,9,5,6,16,31,55,-24,21
CC Mariners,2109,10,4,8,15,28,49,-21,20
Sydney FC,2110,1,21,4,3,66,23,43,67
N'castle Jet,2110,2,15,5,8,58,40,18,50
Melbourne C,2110,3,15,4,10,46,34,12,49
Melbourne V,2110,4,13,5,11,46,40,6,44
Adelaide Utd,2110,5,11,6,11,37,40,-3,39
Brisbane,2110,6,10,5,13,33,42,-9,35
Western Sydn,2110,7,8,9,10,38,47,-9,33
Perth Glory,2110,8,10,2,15,37,50,-13,32
Wellington P,2110,9,5,6,16,31,55,-24,21
CC Mariners,2110,10,4,8,15,28,49,-21,20
Sydney FC,2111,1,21,4,3,66,22,44,67
N'castle Jet,2111,2,15,6,7,58,38,20,51
Melbourne C,2111,3,14,5,10,44,34,10,47
Melbourne V,2111,4,13,5,11,45,40,5,44
Adelaide Utd,2111,5,11,6,11,37,40,-3,39
Brisbane,2111,6,10,5,13,33,42,-9,35
Western Sydn,2111,7,8,9,10,38,47,-9,33
Perth Glory,2111,8,10,2,15,37,50,-13,32
Wellington P,2111,9,5,6,16,31,55,-24,21
CC Mariners,2111,10,4,8,15,28,49,-21,20
Sydney FC,2112,1,21,4,3,65,22,43,67
N'castle Jet,2112,2,15,5,8,58,39,19,50
Melbourne C,2112,3,15,4,10,45,34,11,49
Melbourne V,2112,4,13,5,11,45,39,6,44
Adelaide Utd,2112,5,11,6,11,37,40,-3,39
Brisbane,2112,6,10,5,13,33,42,-9,35
Western Sydn,2112,7,8,9,10,38,47,-9,33
Perth Glory,2112,8,10,2,15,37,50,-13,32
Wellington P,2112,9,5,6,16,31,55,-24,21
CC Mariners,2112,10,4,8,15,28,49,-21,20
Sydney FC,2113,1,21,4,3,66,23,43,67
N'castle Jet,2113,2,15,5,8,58,39,19,50
Melbourne C,2113,3,15,4,10,45,34,11,49
Melbourne V,2113,4,13,5,11,46,40,6,44
Adelaide Utd,2113,5,11,6,11,37,40,-3,39
Brisbane,2113,6,10,5,13,33,42,-9,35
Western Sydn,2113,7,8,9,10,38,47,-9,33
Perth Glory,2113,8,10,2,15,37,50,-13,32
Wellington P,2113,9,5,6,16,31,55,-24,21
CC Mariners,2113,10,4,8,15,28,49,-21,20
Sydney FC,2114,1,20,5,3,65,23,42,65
N'castle Jet,2114,2,15,5,8,57,38,19,50
Melbourne C,2114,3,15,4,10,44,33,11,49
Melbourne V,2114,4,13,6,10,46,39,7,45
Adelaide Utd,2114,5,11,6,11,37,40,-3,39
Brisbane,2114,6,10,5,13,33,42,-9,35
Western Sydn,2114,7,8,9,10,38,47,-9,33
Perth Glory,2114,8,10,2,15,37,50,-13,32
Wellington P,2114,9,5,6,16,31,55,-24,21
CC Mariners,2114,10,4,8,15,28,49,-21,20
Sydney FC,2115,1,20,4,4,66,26,40,64
N'castle Jet,2115,2,15,5,8,57,38,19,50
Melbourne C,2115,3,15,4,10,44,33,11,49
Melbourne V,2115,4,14,5,10,49,40,9,47
Adelaide Utd,2115,5,11,6,11,37,40,-3,39
Brisbane,2115,6,10,5,13,33,42,-9,35
Western Sydn,2115,7,8,9,10,38,47,-9,33
Perth Glory,2115,8,10,2,15,37,50,-13,32
Wellington P,2115,9,5,6,16,31,55,-24,21
CC Mariners,2115,10,4,8,15,28,49,-21,20
Sydney FC,2116,1,21,4,3,66,23,43,67
N'castle Jet,2116,2,16,5,7,61,37,24,53
Melbourne C,2116,3,14,4,11,43,37,6,46
Melbourne V,2116,4,13,5,11,46,40,6,44
Adelaide Utd,2116,5,11,6,11,37,40,-3,39
Brisbane,2116,6,10,5,13,33,42,-9,35
Western Sydn,2116,7,8,9,10,38,47,-9,33
Perth Glory,2116,8,10,2,15,37,50,-13,32
Wellington P,2116,9,5,6,16,31,55,-24,21
CC Mariners,2116,10,4,8,15,28,49,-21,20
Sydney FC,2117,1,21,4,3,72,24,48,67
N'castle Jet,2117,2,15,6,7,58,38,20,51
Melbourne C,2117,3,14,5,10,44,34,10,47
Melbourne V,2117,4,13,5,11,47,46,1,44
Adelaide Utd,2117,5,11,6,11,37,40,-3,39
Brisbane,2117,6,10,5,13,33,42,-9,35
Western Sydn,2117,7,8,9,10,38,47,-9,33
Perth Glory,2117,8,10,2,15,37,50,-13,32
Wellington P,2117,9,5,6,16,31,55,-24,21
CC Mariners,2117,10,4,8,15,28,49,-21,20
Sydney FC,2118,1,21,4,3,66,23,43,67
N'castle Jet,2118,2,16,5,7,60,38,22,53
Melbourne C,2118,3,14,4,11,44,36,8,46
Melbourne V,2118,4,13,5,11,46,40,6,44
Adelaide Utd,2118,5,11,6,11,37,40,-3,39
Brisbane,2118,6,10,5,13,33,42,-9,35
Western Sydn,2118,7,8,9,10,38,47,-9,33
Perth Glory,2118,8,10,2,15,37,50,-13,32
Wellington P,2118,9,5,6,16,31,55,-24,21
CC Mariners,2118,10,4,8,15,28,49,-21,20
Sydney FC,2119,1,20,5,3,64,22,42,65
N'castle Jet,2119,2,16,5,7,60,37,23,53
Melbourne C,2119,3,14,4,11,43,36,7,46
Melbourne V,2119,4,13,6,10,45,38,7,45
Adelaide Utd,2119,5,11,6,11,37,40,-3,39
Brisbane,2119,6,10,5,13,33,42,-9,35
Western Sydn,2119,7,8,9,10,38,47,-9,33
Perth Glory,2119,8,10,2,15,37,50,-13,32
Wellington P,2119,9,5,6,16,31,55,-24,21
CC Mariners,2119,10,4,8,15,28,49,-21,20
Sydney FC,2120,1,21,4,3,67,23,44,67
N'castle Jet,2120,2,16,5,7,58,37,21,53
Melbourne C,2120,3,14,4,11,43,34,9,46
Melbourne V,2120,4,13,5,11,46,41,5,44
Adelaide Utd,2120,5,11,6,11,37,40,-3,39
Brisbane,2120,6,10,5,13,33,42,-9,35
Western Sydn,2120,7,8,9,10,38,47,-9,33
Perth Glory,2120,8,10,2,15,37,50,-13,32
Wellington P,2120,9,5,6,16,31,55,-24,21
CC Mariners,2120,10,4,8,15,28,49,-21,20
Sydney FC,2121,1,21,4,3,65,22,43,67
N'castle Jet,2121,2,15,5,8,57,38,19,50
Melbourne C,2121,3,15,4,10,44,33,11,49
Melbourne V,2121,4,13,5,11,45,39,6,44
Adelaide Utd,2121,5,11,6,11,37,40,-3,39
Brisbane,2121,6,10,5,13,33,42,-9,35
Western Sydn,2121,7,8,9,10,38,47,-9,33
Perth Glory,2121,8,10,2,15,37,50,-13,32
Wellington P,2121,9,5,6,16,31,55,-24,21
CC Mariners,2121,10,4,8,15,28,49,-21,20
Sydney FC,2122,1,21,4,3,65,22,43,67
N'castle Jet,2122,2,16,5,7,58,37,21,53
Melbourne C,2122,3,14,4,11,43,34,9,46
Melbourne V,2122,4,13,5,11,45,39,6,44
Adelaide Utd,2122,5,11,6,11,37,40,-3,39
Brisbane,2122,6,10,5,13,33,42,-9,35
Western Sydn,2122,7,8,9,10,38,47,-9,33
Perth Glory,2122,8,10,2,15,37,50,-13,32
Wellington P,2122,9,5,6,16,31,55,-24,21
CC Mariners,2122,10,4,8,15,28,49,-21,20
Sydney FC,2123,1,20,4,4,64,23,41,64
N'castle Jet,2123,2,16,5,7,58,37,21,53
Melbourne V,2123,3,14,5,10,46,38,8,47
Melbourne C,2123,4,14,4,11,43,34,9,46
Adelaide Utd,2123,5,11,6,11,37,40,-3,39
Brisbane,2123,6,10,5,13,33,42,-9,35
Western Sydn,2123,7,8,9,10,38,47,-9,33
Perth Glory,2123,8,10,2,15,37,50,-13,32
Wellington P,2123,9,5,6,16,31,55,-24,21
CC Mariners,2123,10,4,8,15,28,49,-21,20
Sydney FC,2124,1,21,4,3,67,23,44,67
N'castle Jet,2124,2,16,5,7,60,39,21,53
Melbourne C,2124,3,14,4,11,45,36,9,46
Melbourne V,2124,4,13,5,11,46,41,5,44
Adelaide Utd,2124,5,11,6,11,37,40,-3,39
Brisbane,2124,6,10,5,13,33,42,-9,35
Western Sydn,2124,7,8,9,10,38,47,-9,33
Perth Glory,2124,8,10,2,15,37,50,-13,32
Wellington P,2124,9,5,6,16,31,55,-24,21
CC Mariners,2124,10,4,8,15,28,49,-21,20
Sydney FC,2125,1,20,5,3,66,24,42,65
N'castle Jet,2125,2,16,5,7,58,37,21,53
Melbourne C,2125,3,14,4,11,43,34,9,46
Melbourne V,2125,4,13,6,10,47,40,7,45
Adelaide Utd,2125,5,11,6,11,37,40,-3,39
Brisbane,2125,6,10,5,13,33,42,-9,35
Western Sydn,2125,7,8,9,10,38,47,-9,33
Perth Glory,2125,8,10,2,15,37,50,-13,32
Wellington P,2125,9,5,6,16,31,55,-24,21
CC Mariners,2125,10,4,8,15,28,49,-21,20
Sydney FC,2126,1,21,4,3,68,24,44,67
N'castle Jet,2126,2,16,5,7,61,39,22,53
Melbourne C,2126,3,14,4,11,45,37,8,46
Melbourne V,2126,4,13,5,11,47,42,5,44
Adelaide Utd,2126,5,11,6,11,37,40,-3,39
Brisbane,2126,6,10,5,13,33,42,-9,35
Western Sydn,2126,7,8,9,10,38,47,-9,33
Perth Glory,2126,8,10,2,15,37,50,-13,32
Wellington P,2126,9,5,6,16,31,55,-24,21
CC Mariners,2126,10,4,8,15,28,49,-21,20
Sydney FC,2127,1,20,4,4,64,25,39,64
N'castle Jet,2127,2,15,5,8,57,38,19,50
Melbourne C,2127,3,15,4,10,44,33,11,49
Melbourne V,2127,4,14,5,10,48,38,10,47
Adelaide Utd,2127,5,11,6,11,37,40,-3,39
Brisbane,2127,6,10,5,13,33,42,-9,35
Western Sydn,2127,7,8,9,10,38,47,-9,33
Perth Glory,2127,8,10,2,15,37,50,-13,32
Wellington P,2127,9,5,6,16,31,55,-24,21
CC Mariners,2127,10,4,8,15,28,49,-21,20
Sydney FC,2128,1,20,4,4,65,24,41,64
N'castle Jet,2128,2,15,5,8,57,39,18,50
Melbourne C,2128,3,15,4,10,45,33,12,49
Melbourne V,2128,4,14,5,10,47,39,8,47
Adelaide Utd,2128,5,11,6,11,37,40,-3,39
Brisbane,2128,6,10,5,13,33,42,-9,35
Western Sydn,2128,7,8,9,10,38,47,-9,33
Perth Glory,2128,8,10,2,15,37,50,-13,32
Wellington P,2128,9,5,6,16,31,55,-24,21
CC Mariners,2128,10,4,8,15,28,49,-21,20
Sydney FC,2129,1,21,4,3,65,22,43,67
N'castle Jet,2129,2,16,5,7,58,37,21,53
Melbourne C,2129,3,14,4,11,43,34,9,46
Melbourne V,2129,4,13,5,11,45,39,6,44
Adelaide Utd,2129,5,11,6,11,37,40,-3,39
Brisbane,2129,6,10,5,13,33,42,-9,35
Western Sydn,2129,7,8,9,10,38,47,-9,33
Perth Glory,2129,8,10,2,15,37,50,-13,32
Wellington P,2129,9,5,6,16,31,55,-24,21
CC Mariners,2129,10,4,8,15,28,49,-21,20
Sydney FC,2130,1,21,4,3,66,22,44,67
N'castle Jet,2130,2,16,5,7,58,37,21,53
Melbourne C,2130,3,14,4,11,43,34,9,46
Melbourne V,2130,4,13,5,11,45,40,5,44
Adelaide Utd,2130,5,11,6,11,37,40,-3,39
Brisbane,2130,6,10,5,13,33,42,-9,35
Western Sydn,2130,7,8,9,10,38,47,-9,33
Perth Glory,2130,8,10,2,15,37,50,-13,32
Wellington P,2130,9,5,6,16,31,55,-24,21
CC Mariners,2130,10,4,8,15,28,49,-21,20
Sydney FC,2131,1,21,4,3,67,23,44,67
N'castle Jet,2131,2,16,5,7,59,38,21,53
Melbourne C,2131,3,14,4,11,44,35,9,46
Melbourne V,2131,4,13,5,11,46,41,5,44
Adelaide Utd,2131,5,11,6,11,37,40,-3,39
Brisbane,2131,6,10,5,13,33,42,-9,35
Western Sydn,2131,7,8,9,10,38,47,-9,33
Perth Glory,2131,8,10,2,15,37,50,-13,32
Wellington P,2131,9,5,6,16,31,55,-24,21
CC Mariners,2131,10,4,8,15,28,49,-21,20
Sydney FC,2132,1,20,5,3,65,23,42,65
N'castle Jet,2132,2,16,5,7,59,37,22,53
Melbourne C,2132,3,14,4,11,43,35,8,46
Melbourne V,2132,4,13,6,10,46,39,7,45
Adelaide Utd,2132,5,11,6,11,37,40,-3,39
Brisbane,2132,6,10,5,13,33,42,-9,35
Western Sydn,2132,7,8,9,10,38,47,-9,33
Perth Glory,2132,8,10,2,15,37,50,-13,32
Wellington P,2132,9,5,6,16,31,55,-24,21
CC Mariners,2132,10,4,8,15,28,49,-21,20
Sydney FC,2133,1,20,5,3,65,23,42,65
N'castle Jet,2133,2,15,6,7,58,38,20,51
Melbourne C,2133,3,14,5,10,44,34,10,47
Melbourne V,2133,4,13,6,10,46,39,7,45
Adelaide Utd,2133,5,11,6,11,37,40,-3,39
Brisbane,2133,6,10,5,13,33,42,-9,35
Western Sydn,2133,7,8,9,10,38,47,-9,33
Perth Glory,2133,8,10,2,15,37,50,-13,32
Wellington P,2133,9,5,6,16,31,55,-24,21
CC Mariners,2133,10,4,8,15,28,49,-21,20
Sydney FC,2134,1,21,4,3,68,23,45,67
N'castle Jet,2134,2,16,5,7,60,38,22,53
Melbourne C,2134,3,14,4,11,44,36,8,46
Melbourne V,2134,4,13,5,11,46,42,4,44
Adelaide Utd,2134,5,11,6,11,37,40,-3,39
Brisbane,2134,6,10,5,13,33,42,-9,35
Western Sydn,2134,7,8,9,10,38,47,-9,33
Perth Glory,2134,8,10,2,15,37,50,-13,32
Wellington P,2134,9,5,6,16,31,55,-24,21
CC Mariners,2134,10,4,8,15,28,49,-21,20
Sydney FC,2135,1,20,4,4,66,25,41,64
N'castle Jet,2135,2,16,5,7,61,39,22,53
Melbourne V,2135,3,14,5,10,48,40,8,47
Melbourne C,2135,4,14,4,11,45,37,8,46
Adelaide Utd,2135,5,11,6,11,37,40,-3,39
Brisbane,2135,6,10,5,13,33,42,-9,35
Western Sydn,2135,7,8,9,10,38,47,-9,33
Perth Glory,2135,8,10,2,15,37,50,-13,32
Wellington P,2135,9,5,6,16,31,55,-24,21
CC Mariners,2135,10,4,8,15,28,49,-21,20
Sydney FC,2136,1,21,4,3,67,23,44,67
N'castle Jet,2136,2,15,5,8,59,40,19,50
Melbourne C,2136,3,15,4,10,46,35,11,49
Melbourne V,2136,4,13,5,11,46,41,5,44
Adelaide Utd,2136,5,11,6,11,37,40,-3,39
Brisbane,2136,6,10,5,13,33,42,-9,35
Western Sydn,2136,7,8,9,10,38,47,-9,33
Perth Glory,2136,8,10,2,15,37,50,-13,32
Wellington P,2136,9,5,6,16,31,55,-24,21
CC Mariners,2136,10,4,8,15,28,49,-21,20
Sydney FC,2137,1,20,4,4,64,23,41,64
N'castle Jet,2137,2,15,5,8,57,38,19,50
Melbourne C,2137,3,15,4,10,44,33,11,49
Melbourne V,2137,4,14,5,10,46,38,8,47
Adelaide Utd,2137,5,11,6,11,37,40,-3,39
Brisbane,2137,6,10,5,13,33,42,-9,35
Western Sydn,2137,7,8,9,10,38,47,-9,33
Perth Glory,2137,8,10,2,15,37,50,-13,32
Wellington P,2137,9,5,6,16,31,55,-24,21
CC Mariners,2137,10,4,8,15,28,49,-21,20
Sydney FC,2138,1,21,4,3,67,22,45,67
N'castle Jet,2138,2,15,5,8,57,39,18,50
Melbourne C,2138,3,15,4,10,45,33,12,49
Melbourne V,2138,4,13,5,11,45,41,4,44
Adelaide Utd,2138,5,11,6,11,37,40,-3,39
Brisbane,2138,6,10,5,13,33,42,-9,35
Western Sydn,2138,7,8,9,10,38,47,-9,33
Perth Glory,2138,8,10,2,15,37,50,-13,32
Wellington P,2138,9,5,6,16,31,55,-24,21
CC Mariners,2138,10,4,8,15,28,49,-21,20
Sydney FC,2139,1,21,4,3,66,22,44,67
N'castle Jet,2139,2,16,5,7,62,39,23,53
Melbourne C,2139,3,14,4,11,45,38,7,46
Melbourne V,2139,4,13,5,11,45,40,5,44
Adelaide Utd,2139,5,11,6,11,37,40,-3,39
Brisbane,2139,6,10,5,13,33,42,-9,35
Western Sydn,2139,7,8,9,10,38,47,-9,33
Perth Glory,2139,8,10,2,15,37,50,-13,32
Wellington P,2139,9,5,6,16,31,55,-24,21
CC Mariners,2139,10,4,8,15,28,49,-21,20
Sydney FC,2140,1,21,4,3,65,22,43,67
N'castle Jet,2140,2,16,5,7,62,38,24,53
Melbourne C,2140,3,14,4,11,44,38,6,46
Melbourne V,2140,4,13,5,11,45,39,6,44
Adelaide Utd,2140,5,11,6,11,37,40,-3,39
Brisbane,2140,6,10,5,13,33,42,-9,35
Western Sydn,2140,7,8,9,10,38,47,-9,33
Perth Glory,2140,8,10,2,15,37,50,-13,32
Wellington P,2140,9,5,6,16,31,55,-24,21
CC Mariners,2140,10,4,8,15,28,49,-21,20
Sydney FC,2141,1,21,4,3,66,22,44,67
N'castle Jet,2141,2,15,5,8,57,40,17,50
Melbourne C,2141,3,15,4,10,46,33,13,49
Melbourne V,2141,4,13,5,11,45,40,5,44
Adelaide Utd,2141,5,11,6,11,37,40,-3,39
Brisbane,2141,6,10,5,13,33,42,-9,35
Western Sydn,2141,7,8,9,10,38,47,-9,33
Perth Glory,2141,8,10,2,15,37,50,-13,32
Wellington P,2141,9,5,6,16,31,55,-24,21
CC Mariners,2141,10,4,8,15,28,49,-21,20
Sydney FC,2142,1,21,4,3,66,23,43,67
N'castle Jet,2142,2,15,5,8,58,40,18,50
Melbourne C,2142,3,15,4,10,46,34,12,49
Melbourne V,2142,4,13,5,11,46,40,6,44
Adelaide Utd,2142,5,11,6,11,37,40,-3,39
Brisbane,2142,6,10,5,13,33,42,-9,35
Western Sydn,2142,7,8,9,10,38,47,-9,33
Perth Glory,2142,8,10,2,15,37,50,-13,32
Wellington P,2142,9,5,6,16,31,55,-24,21
CC Mariners,2142,10,4,8,15,28,49,-21,20
Sydney FC,2143,1,21,4,3,67,22,45,67
N'castle Jet,2143,2,16,5,7,59,37,22,53
Melbourne C,2143,3,14,4,11,43,35,8,46
Melbourne V,2143,4,13,5,11,45,41,4,44
Adelaide Utd,2143,5,11,6,11,37,40,-3,39
Brisbane,2143,6,10,5,13,33,42,-9,35
Western Sydn,2143,7,8,9,10,38,47,-9,33
Perth Glory,2143,8,10,2,15,37,50,-13,32
Wellington P,2143,9,5,6,16,31,55,-24,21
CC Mariners,2143,10,4,8,15,28,49,-21,20
Sydney FC,2144,1,20,5,3,65,23,42,65
N'castle Jet,2144,2,15,5,8,57,39,18,50
Melbourne C,2144,3,15,4,10,45,33,12,49
Melbourne V,2144,4,13,6,10,46,39,7,45
Adelaide Utd,2144,5,11,6,11,37,40,-3,39
Brisbane,2144,6,10,5,13,33,42,-9,35
Western Sydn,2144,7,8,9,10,38,47,-9,33
Perth Glory,2144,8,10,2,15,37,50,-13,32
Wellington P,2144,9,5,6,16,31,55,-24,21
CC Mariners,2144,10,4,8,15,28,49,-21,20
Sydney FC,2145,1,21,4,3,65,22,43,67
N'castle Jet,2145,2,15,5,8,57,38,19,50
Melbourne C,2145,3,15,4,10,44,33,11,49
Melbourne V,2145,4,13,5,11,45,39,6,44
Adelaide Utd,2145,5,11,6,11,37,40,-3,39
Brisbane,2145,6,10,5,13,33,42,-9,35
Western Sydn,2145,7,8,9,10,38,47,-9,33
Perth Glory,2145,8,10,2,15,37,50,-13,32
Wellington P,2145,9,5,6,16,31,55,-24,21
CC Mariners,2145,10,4,8,15,28,49,-21,20
Sydney FC,2146,1,20,5,3,65,23,42,65
N'castle Jet,2146,2,15,6,7,58,38,20,51
Melbourne C,2146,3,14,5,10,44,34,10,47
Melbourne V,2146,4,13,6,10,46,39,7,45
Adelaide Utd,2146,5,11,6,11,37,40,-3,39
Brisbane,2146,6,10,5,13,33,42,-9,35
Western Sydn,2146,7,8,9,10,38,47,-9,33
Perth Glory,2146,8,10,2,15,37,50,-13,32
Wellington P,2146,9,5,6,16,31,55,-24,21
CC Mariners,2146,10,4,8,15,28,49,-21,20
Sydney FC,2147,1,20,4,4,64,24,40,64
N'castle Jet,2147,2,16,5,7,59,38,21,53
Melbourne V,2147,3,14,5,10,47,38,9,47
Melbourne C,2147,4,14,4,11,44,35,9,46
Adelaide Utd,2147,5,11,6,11,37,40,-3,39
Brisbane,2147,6,10,5,13,33,42,-9,35
Western Sydn,2147,7,8,9,10,38,47,-9,33
Perth Glory,2147,8,10,2,15,37,50,-13,32
Wellington P,2147,9,5,6,16,31,55,-24,21
CC Mariners,2147,10,4,8,15,28,49,-21,20
Sydney FC,2148,1,20,5,3,68,26,42,65
N'castle Jet,2148,2,15,6,7,58,38,20,51
Melbourne C,2148,3,14,5,10,44,34,10,47
Melbourne V,2148,4,13,6,10,49,42,7,45
Adelaide Utd,2148,5,11,6,11,37,40,-3,39
Brisbane,2148,6,10,5,13,33,42,-9,35
Western Sydn,2148,7,8,9,10,38,47,-9,33
Perth Glory,2148,8,10,2,15,37,50,-13,32
Wellington P,2148,9,5,6,16,31,55,-24,21
CC Mariners,2148,10,4,8,15,28,49,-21,20
Sydney FC,2149,1,20,5,3,65,23,42,65
N'castle Jet,2149,2,15,6,7,58,38,20,51
Melbourne C,2149,3,14,5,10,44,34,10,47
Melbourne V,2149,4,13,6,10,46,39,7,45
Adelaide Utd,2149,5,11,6,11,37,40,-3,39
Brisbane,2149,6,10,5,13,33,42,-9,35
Western Sydn,2149,7,8,9,10,38,47,-9,33
Perth Glory,2149,8,10,2,15,37,50,-13,32
Wellington P,2149,9,5,6,16,31,55,-24,21
CC Mariners,2149,10,4,8,15,28,49,-21,20
Sydney FC,2150,1,20,5,3,65,23,42,65
N'castle Jet,2150,2,16,5,7,59,37,22,53
Melbourne C,2150,3,14,4,11,43,35,8,46
Melbourne V,2150,4,13,6,10,46,39,7,45
Adelaide Utd,2150,5,11,6,11,37,40,-3,39
Brisbane,2150,6,10,5,13,33,42,-9,35
Western Sydn,2150,7,8,9,10,38,47,-9,33
Perth Glory,2150,8,10,2,15,37,50,-13,32
Wellington P,2150,9,5,6,16,31,55,-24,21
CC Mariners,2150,10,4,8,15,28,49,-21,20
Sydney FC,2151,1,20,5,3,67,25,42,65
N'castle Jet,2151,2,15,5,8,58,40,18,50
Melbourne C,2151,3,15,4,10,46,34,12,49
Melbourne V,2151,4,13,6,10,48,41,7,45
Adelaide Utd,2151,5,11,6,11,37,40,-3,39
Brisbane,2151,6,10,5,13,33,42,-9,35
Western Sydn,2151,7,8,9,10,38,47,-9,33
Perth Glory,2151,8,10,2,15,37,50,-13,32
Wellington P,2151,9,5,6,16,31,55,-24,21
CC Mariners,2151,10,4,8,15,28,49,-21,20
Sydney FC,2152,1,20,5,3,67,25,42,65
N'castle Jet,2152,2,16,5,7,59,38,21,53
Melbourne C,2152,3,14,4,11,44,35,9,46
Melbourne V,2152,4,13,6,10,48,41,7,45
Adelaide Utd,2152,5,11,6,11,37,40,-3,39
Brisbane,2152,6,10,5,13,33,42,-9,35
Western Sydn,2152,7,8,9,10,38,47,-9,33
Perth Glory,2152,8,10,2,15,37,50,-13,32
Wellington P,2152,9,5,6,16,31,55,-24,21
CC Mariners,2152,10,4,8,15,28,49,-21,20
Sydney FC,2153,1,21,4,3,68,23,45,67
N'castle Jet,2153,2,16,5,7,62,37,25,53
Melbourne C,2153,3,14,4,11,43,38,5,46
Melbourne V,2153,4,13,5,11,46,42,4,44
Adelaide Utd,2153,5,11,6,11,37,40,-3,39
Brisbane,2153,6,10,5,13,33,42,-9,35
Western Sydn,2153,7,8,9,10,38,47,-9,33
Perth Glory,2153,8,10,2,15,37,50,-13,32
Wellington P,2153,9,5,6,16,31,55,-24,21
CC Mariners,2153,10,4,8,15,28,49,-21,20
Sydney FC,2154,1,21,4,3,66,23,43,67
N'castle Jet,2154,2,16,5,7,59,37,22,53
Melbourne C,2154,3,14,4,11,43,35,8,46
Melbourne V,2154,4,13,5,11,46,40,6,44
Adelaide Utd,2154,5,11,6,11,37,40,-3,39
Brisbane,2154,6,10,5,13,33,42,-9,35
Western Sydn,2154,7,8,9,10,38,47,-9,33
Perth Glory,2154,8,10,2,15,37,50,-13,32
Wellington P,2154,9,5,6,16,31,55,-24,21
CC Mariners,2154,10,4,8,15,28,49,-21,20
Sydney FC,2155,1,20,4,4,65,24,41,64
N'castle Jet,2155,2,15,5,8,57,38,19,50
Melbourne C,2155,3,15,4,10,44,33,11,49
Melbourne V,2155,4,14,5,10,47,39,8,47
Adelaide Utd,2155,5,11,6,11,37,40,-3,39
Brisbane,2155,6,10,5,13,33,42,-9,35
Western Sydn,2155,7,8,9,10,38,47,-9,33
Perth Glory,2155,8,10,2,15,37,50,-13,32
Wellington P,2155,9,5,6,16,31,55,-24,21
CC Mariners,2155,10,4,8,15,28,49,-21,20
Sydney FC,2156,1,21,4,3,65,22,43,67
N'castle Jet,2156,2,16,5,7,60,37,23,53
Melbourne C,2156,3,14,4,11,43,36,7,46
Melbourne V,2156,4,13,5,11,45,39,6,44
Adelaide Utd,2156,5,11,6,11,37,40,-3,39
Brisbane,2156,6,10,5,13,33,42,-9,35
Western Sydn,2156,7,8,9,10,38,47,-9,33
Perth Glory,2156,8,10,2,15,37,50,-13,32
Wellington P,2156,9,5,6,16,31,55,-24,21
CC Mariners,2156,10,4,8,15,28,49,-21,20
Sydney FC,2157,1,20,5,3,67,25,42,65
N'castle Jet,2157,2,16,5,7,58,37,21,53
Melbourne C,2157,3,14,4,11,43,34,9,46
Melbourne V,2157,4,13,6,10,48,41,7,45
Adelaide Utd,2157,5,11,6,11,37,40,-3,39
Brisbane,2157,6,10,5,13,33,42,-9,35
Western Sydn,2157,7,8,9,10,38,47,-9,33
Perth Glory,2157,8,10,2,15,37,50,-13,32
Wellington P,2157,9,5,6,16,31,55,-24,21
CC Mariners,2157,10,4,8,15,28,49,-21,20
Sydney FC,2158,1,20,5,3,65,23,42,65
N'castle Jet,2158,2,15,5,8,58,39,19,50
Melbourne C,2158,3,15,4,10,45,34,11,49
Melbourne V,2158,4,13,6,10,46,39,7,45
Adelaide Utd,2158,5,11,6,11,37,40,-3,39
Brisbane,2158,6,10,5,13,33,42,-9,35
Western Sydn,2158,7,8,9,10,38,47,-9,33
Perth Glory,2158,8,10,2,15,37,50,-13,32
Wellington P,2158,9,5,6,16,31,55,-24,21
CC Mariners,2158,10,4,8,15,28,49,-21,20
Sydney FC,2159,1,20,5,3,66,24,42,65
N'castle Jet,2159,2,16,5,7,58,37,21,53
Melbourne C,2159,3,14,4,11,43,34,9,46
Melbourne V,2159,4,13,6,10,47,40,7,45
Adelaide Utd,2159,5,11,6,11,37,40,-3,39
Brisbane,2159,6,10,5,13,33,42,-9,35
Western Sydn,2159,7,8,9,10,38,47,-9,33
Perth Glory,2159,8,10,2,15,37,50,-13,32
Wellington P,2159,9,5,6,16,31,55,-24,21
CC Mariners,2159,10,4,8,15,28,49,-21,20
Sydney FC,2160,1,21,4,3,68,23,45,67
N'castle Jet,2160,2,15,6,7,57,37,20,51
Melbourne C,2160,3,14,5,10,43,33,10,47
Melbourne V,2160,4,13,5,11,46,42,4,44
Adelaide Utd,2160,5,11,6,11,37,40,-3,39
Brisbane,2160,6,10,5,13,33,42,-9,35
Western Sydn,2160,7,8,9,10,38,47,-9,33
Perth Glory,2160,8,10,2,15,37,50,-13,32
Wellington P,2160,9,5,6,16,31,55,-24,21
CC Mariners,2160,10,4,8,15,28,49,-21,20
Sydney FC,2161,1,20,5,3,65,23,42,65
N'castle Jet,2161,2,16,5,7,59,38,21,53
Melbourne C,2161,3,14,4,11,44,35,9,46
Melbourne V,2161,4,13,6,10,46,39,7,45
Adelaide Utd,2161,5,11,6,11,37,40,-3,39
Brisbane,2161,6,10,5,13,33,42,-9,35
Western Sydn,2161,7,8,9,10,38,47,-9,33
Perth Glory,2161,8,10,2,15,37,50,-13,32
Wellington P,2161,9,5,6,16,31,55,-24,21
CC Mariners,2161,10,4,8,15,28,49,-21,20
Sydney FC,2162,1,21,4,3,66,23,43,67
N'castle Jet,2162,2,16,5,7,58,37,21,53
Melbourne C,2162,3,14,4,11,43,34,9,46
Melbourne V,2162,4,13,5,11,46,40,6,44
Adelaide Utd,2162,5,11,6,11,37,40,-3,39
Brisbane,2162,6,10,5,13,33,42,-9,35
Western Sydn,2162,7,8,9,10,38,47,-9,33
Perth Glory,2162,8,10,2,15,37,50,-13,32
Wellington P,2162,9,5,6,16,31,55,-24,21
CC Mariners,2162,10,4,8,15,28,49,-21,20
Sydney FC,2163,1,20,4,4,65,24,41,64
N'castle Jet,2163,2,16,5,7,59,37,22,53
Melbourne V,2163,3,14,5,10,47,39,8,47
Melbourne C,2163,4,14,4,11,43,35,8,46
Adelaide Utd,2163,5,11,6,11,37,40,-3,39
Brisbane,2163,6,10,5,13,33,42,-9,35
Western Sydn,2163,7,8,9,10,38,47,-9,33
Perth Glory,2163,8,10,2,15,37,50,-13,32
Wellington P,2163,9,5,6,16,31,55,-24,21
CC Mariners,2163,10,4,8,15,28,49,-21,20
Sydney FC,2164,1,21,4,3,65,22,43,67
N'castle Jet,2164,2,15,5,8,57,39,18,50
Melbourne C,2164,3,15,4,10,45,33,12,49
Melbourne V,2164,4,13,5,11,45,39,6,44
Adelaide Utd,2164,5,11,6,11,37,40,-3,39
Brisbane,2164,6,10,5,13,33,42,-9,35
Western Sydn,2164,7,8,9,10,38,47,-9,33
Perth Glory,2164,8,10,2,15,37,50,-13,32
Wellington P,2164,9,5,6,16,31,55,-24,21
CC Mariners,2164,10,4,8,15,28,49,-21,20
Sydney FC,2165,1,20,5,3,68,26,42,65
N'castle Jet,2165,2,16,5,7,60,38,22,53
Melbourne C,2165,3,14,4,11,44,36,8,46
Melbourne V,2165,4,13,6,10,49,42,7,45
Adelaide Utd,2165,5,11,6,11,37,40,-3,39
Brisbane,2165,6,10,5,13,33,42,-9,35
Western Sydn,2165,7,8,9,10,38,47,-9,33
Perth Glory,2165,8,10,2,15,37,50,-13,32
Wellington P,2165,9,5,6,16,31,55,-24,21
CC Mariners,2165,10,4,8,15,28,49,-21,20
Sydney FC,2166,1,21,4,3,69,23,46,67
N'castle Jet,2166,2,15,6,7,59,39,20,51
Melbourne C,2166,3,14,5,10,45,35,10,47
Melbourne V,2166,4,13,5,11,46,43,3,44
Adelaide Utd,2166,5,11,6,11,37,40,-3,39
Brisbane,2166,6,10,5,13,33,42,-9,35
Western Sydn,2166,7,8,9,10,38,47,-9,33
Perth Glory,2166,8,10,2,15,37,50,-13,32
Wellington P,2166,9,5,6,16,31,55,-24,21
CC Mariners,2166,10,4,8,15,28,49,-21,20
Sydney FC,2167,1,20,5,3,64,22,42,65
N'castle Jet,2167,2,15,6,7,59,39,20,51
Melbourne C,2167,3,14,5,10,45,35,10,47
Melbourne V,2167,4,13,6,10,45,38,7,45
Adelaide Utd,2167,5,11,6,11,37,40,-3,39
Brisbane,2167,6,10,5,13,33,42,-9,35
Western Sydn,2167,7,8,9,10,38,47,-9,33
Perth Glory,2167,8,10,2,15,37,50,-13,32
Wellington P,2167,9,5,6,16,31,55,-24,21
CC Mariners,2167,10,4,8,15,28,49,-21,20
Sydney FC,2168,1,21,4,3,66,23,43,67
N'castle Jet,2168,2,15,6,7,58,38,20,51
Melbourne C,2168,3,14,5,10,44,34,10,47
Melbourne V,2168,4,13,5,11,46,40,6,44
Adelaide Utd,2168,5,11,6,11,37,40,-3,39
Brisbane,2168,6,10,5,13,33,42,-9,35
Western Sydn,2168,7,8,9,10,38,47,-9,33
Perth Glory,2168,8,10,2,15,37,50,-13,32
Wellington P,2168,9,5,6,16,31,55,-24,21
CC Mariners,2168,10,4,8,15,28,49,-21,20
Sydney FC,2169,1,20,5,3,64,22,42,65
N'castle Jet,2169,2,16,5,7,58,37,21,53
Melbourne C,2169,3,14,4,11,43,34,9,46
Melbourne V,2169,4,13,6,10,45,38,7,45
Adelaide Utd,2169,5,11,6,11,37,40,-3,39
Brisbane,2169,6,10,5,13,33,42,-9,35
Western Sydn,2169,7,8,9,10,38,47,-9,33
Perth Glory,2169,8,10,2,15,37,50,-13,32
Wellington P,2169,9,5,6,16,31,55,-24,21
CC Mariners,2169,10,4,8,15,28,49,-21,20
Sydney FC,2170,1,21,4,3,66,23,43,67
N'castle Jet,2170,2,15,5,8,59,40,19,50
Melbourne C,2170,3,15,4,10,46,35,11,49
Melbourne V,2170,4,13,5,11,46,40,6,44
Adelaide Utd,2170,5,11,6,11,37,40,-3,39
Brisbane,2170,6,10,5,13,33,42,-9,35
Western Sydn,2170,7,8,9,10,38,47,-9,33
Perth Glory,2170,8,10,2,15,37,50,-13,32
Wellington P,2170,9,5,6,16,31,55,-24,21
CC Mariners,2170,10,4,8,15,28,49,-21,20
Sydney FC,2171,1,21,4,3,67,24,43,67
N'castle Jet,2171,2,15,5,8,58,39,19,50
Melbourne C,2171,3,15,4,10,45,34,11,49
Melbourne V,2171,4,13,5,11,47,41,6,44
Adelaide Utd,2171,5,11,6,11,37,40,-3,39
Brisbane,2171,6,10,5,13,33,42,-9,35
Western Sydn,2171,7,8,9,10,38,47,-9,33
Perth Glory,2171,8,10,2,15,37,50,-13,32
Wellington P,2171,9,5,6,16,31,55,-24,21
CC Mariners,2171,10,4,8,15,28,49,-21,20
Sydney FC,2172,1,21,4,3,65,22,43,67
N'castle Jet,2172,2,16,5,7,59,38,21,53
Melbourne C,2172,3,14,4,11,44,35,9,46
Melbourne V,2172,4,13,5,11,45,39,6,44
Adelaide Utd,2172,5,11,6,11,37,40,-3,39
Brisbane,2172,6,10,5,13,33,42,-9,35
Western Sydn,2172,7,8,9,10,38,47,-9,33
Perth Glory,2172,8,10,2,15,37,50,-13,32
Wellington P,2172,9,5,6,16,31,55,-24,21
CC Mariners,2172,10,4,8,15,28,49,-21,20
Sydney FC,2173,1,20,4,4,65,24,41,64
N'castle Jet,2173,2,16,5,7,61,37,24,53
Melbourne V,2173,3,14,5,10,47,39,8,47
Melbourne C,2173,4,14,4,11,43,37,6,46
Adelaide Utd,2173,5,11,6,11,37,40,-3,39
Brisbane,2173,6,10,5,13,33,42,-9,35
Western Sydn,2173,7,8,9,10,38,47,-9,33
Perth Glory,2173,8,10,2,15,37,50,-13,32
Wellington P,2173,9,5,6,16,31,55,-24,21
CC Mariners,2173,10,4,8,15,28,49,-21,20
Sydney FC,2174,1,20,4,4,64,24,40,64
N'castle Jet,2174,2,16,5,7,58,37,21,53
Melbourne V,2174,3,14,5,10,47,38,9,47
Melbourne C,2174,4,14,4,11,43,34,9,46
Adelaide Utd,2174,5,11,6,11,37,40,-3,39
Brisbane,2174,6,10,5,13,33,42,-9,35
Western Sydn,2174,7,8,9,10,38,47,-9,33
Perth Glory,2174,8,10,2,15,37,50,-13,32
Wellington P,2174,9,5,6,16,31,55,-24,21
CC Mariners,2174,10,4,8,15,28,49,-21,20
Sydney FC,2175,1,21,4,3,67,22,45,67
N'castle Jet,2175,2,15,6,7,59,39,20,51
Melbourne C,2175,3,14,5,10,45,35,10,47
Melbourne V,2175,4,13,5,11,45,41,4,44
Adelaide Utd,2175,5,11,6,11,37,40,-3,39
Brisbane,2175,6,10,5,13,33,42,-9,35
Western Sydn,2175,7,8,9,10,38,47,-9,33
Perth Glory,2175,8,10,2,15,37,50,-13,32
Wellington P,2175,9,5,6,16,31,55,-24,21
CC Mariners,2175,10,4,8,15,28,49,-21,20
Sydney FC,2176,1,21,4,3,66,22,44,67
N'castle Jet,2176,2,15,5,8,57,38,19,50
Melbourne C,2176,3,15,4,10,44,33,11,49
Melbourne V,2176,4,13,5,11,45,40,5,44
Adelaide Utd,2176,5,11,6,11,37,40,-3,39
Brisbane,2176,6,10,5,13,33,42,-9,35
Western Sydn,2176,7,8,9,10,38,47,-9,33
Perth Glory,2176,8,10,2,15,37,50,-13,32
Wellington P,2176,9,5,6,16,31,55,-24,21
CC Mariners,2176,10,4,8,15,28,49,-21,20
Sydney FC,2177,1,20,5,3,66,24,42,65
N'castle Jet,2177,2,16,5,7,61,38,23,53
Melbourne C,2177,3,14,4,11,44,37,7,46
Melbourne V,2177,4,13,6,10,47,40,7,45
Adelaide Utd,2177,5,11,6,11,37,40,-3,39
Brisbane,2177,6,10,5,13,33,42,-9,35
Western Sydn,2177,7,8,9,10,38,47,-9,33
Perth Glory,2177,8,10,2,15,37,50,-13,32
Wellington P,2177,9,5,6,16,31,55,-24,21
CC Mariners,2177,10,4,8,15,28,49,-21,20
Sydney FC,2178,1,21,4,3,69,22,47,67
N'castle Jet,2178,2,16,5,7,58,37,21,53
Melbourne C,2178,3,14,4,11,43,34,9,46
Melbourne V,2178,4,13,5,11,45,43,2,44
Adelaide Utd,2178,5,11,6,11,37,40,-3,39
Brisbane,2178,6,10,5,13,33,42,-9,35
Western Sydn,2178,7,8,9,10,38,47,-9,33
Perth Glory,2178,8,10,2,15,37,50,-13,32
Wellington P,2178,9,5,6,16,31,55,-24,21
CC Mariners,2178,10,4,8,15,28,49,-21,20
Sydney FC,2179,1,20,4,4,64,25,39,64
N'castle Jet,2179,2,15,6,7,57,37,20,51
Melbourne V,2179,3,14,5,10,48,38,10,47
Melbourne C,2179,4,14,5,10,43,33,10,47
Adelaide Utd,2179,5,11,6,11,37,40,-3,39
Brisbane,2179,6,10,5,13,33,42,-9,35
Western Sydn,2179,7,8,9,10,38,47,-9,33
Perth Glory,2179,8,10,2,15,37,50,-13,32
Wellington P,2179,9,5,6,16,31,55,-24,21
CC Mariners,2179,10,4,8,15,28,49,-21,20
Sydney FC,2180,1,21,4,3,67,23,44,67
N'castle Jet,2180,2,16,5,7,59,38,21,53
Melbourne C,2180,3,14,4,11,44,35,9,46
Melbourne V,2180,4,13,5,11,46,41,5,44
Adelaide Utd,2180,5,11,6,11,37,40,-3,39
Brisbane,2180,6,10,5,13,33,42,-9,35
Western Sydn,2180,7,8,9,10,38,47,-9,33
Perth Glory,2180,8,10,2,15,37,50,-13,32
Wellington P,2180,9,5,6,16,31,55,-24,21
CC Mariners,2180,10,4,8,15,28,49,-21,20
Sydney FC,2181,1,21,4,3,67,23,44,67
N'castle Jet,2181,2,15,5,8,58,39,19,50
Melbourne C,2181,3,15,4,10,45,34,11,49
Melbourne V,2181,4,13,5,11,46,41,5,44
Adelaide Utd,2181,5,11,6,11,37,40,-3,39
Brisbane,2181,6,10,5,13,33,42,-9,35
Western Sydn,2181,7,8,9,10,38,47,-9,33
Perth Glory,2181,8,10,2,15,37,50,-13,32
Wellington P,2181,9,5,6,16,31,55,-24,21
CC Mariners,2181,10,4,8,15,28,49,-21,20
Sydney FC,2182,1,20,4,4,65,26,39,64
N'castle Jet,2182,2,16,5,7,59,38,21,53
Melbourne V,2182,3,14,5,10,49,39,10,47
Melbourne C,2182,4,14,4,11,44,35,9,46
Adelaide Utd,2182,5,11,6,11,37,40,-3,39
Brisbane,2182,6,10,5,13,33,42,-9,35
Western Sydn,2182,7,8,9,10,38,47,-9,33
Perth Glory,2182,8,10,2,15,37,50,-13,32
Wellington P,2182,9,5,6,16,31,55,-24,21
CC Mariners,2182,10,4,8,15,28,49,-21,20
Sydney FC,2183,1,20,4,4,65,24,41,64
N'castle Jet,2183,2,16,5,7,59,37,22,53
Melbourne V,2183,3,14,5,10,47,39,8,47
Melbourne C,2183,4,14,4,11,43,35,8,46
Adelaide Utd,2183,5,11,6,11,37,40,-3,39
Brisbane,2183,6,10,5,13,33,42,-9,35
Western Sydn,2183,7,8,9,10,38,47,-9,33
Perth Glory,2183,8,10,2,15,37,50,-13,32
Wellington P,2183,9,5,6,16,31,55,-24,21
CC Mariners,2183,10,4,8,15,28,49,-21,20
Sydney FC,2184,1,21,4,3,68,22,46,67
N'castle Jet,2184,2,15,6,7,58,38,20,51
Melbourne C,2184,3,14,5,10,44,34,10,47
Melbourne V,2184,4,13,5,11,45,42,3,44
Adelaide Utd,2184,5,11,6,11,37,40,-3,39
Brisbane,2184,6,10,5,13,33,42,-9,35
Western Sydn,2184,7,8,9,10,38,47,-9,33
Perth Glory,2184,8,10,2,15,37,50,-13,32
Wellington P,2184,9,5,6,16,31,55,-24,21
CC Mariners,2184,10,4,8,15,28,49,-21,20
Sydney FC,2185,1,20,5,3,65,23,42,65
N'castle Jet,2185,2,16,5,7,58,37,21,53
Melbourne C,2185,3,14,4,11,43,34,9,46
Melbourne V,2185,4,13,6,10,46,39,7,45
Adelaide Utd,2185,5,11,6,11,37,40,-3,39
Brisbane,2185,6,10,5,13,33,42,-9,35
Western Sydn,2185,7,8,9,10,38,47,-9,33
Perth Glory,2185,8,10,2,15,37,50,-13,32
Wellington P,2185,9,5,6,16,31,55,-24,21
CC Mariners,2185,10,4,8,15,28,49,-21,20
Sydney FC,2186,1,21,4,3,69,22,47,67
N'castle Jet,2186,2,16,5,7,62,38,24,53
Melbourne C,2186,3,14,4,11,44,38,6,46
Melbourne V,2186,4,13,5,11,45,43,2,44
Adelaide Utd,2186,5,11,6,11,37,40,-3,39
Brisbane,2186,6,10,5,13,33,42,-9,35
Western Sydn,2186,7,8,9,10,38,47,-9,33
Perth Glory,2186,8,10,2,15,37,50,-13,32
Wellington P,2186,9,5,6,16,31,55,-24,21
CC Mariners,2186,10,4,8,15,28,49,-21,20
Sydney FC,2187,1,21,4,3,66,23,43,67
N'castle Jet,2187,2,16,5,7,59,37,22,53
Melbourne C,2187,3,14,4,11,43,35,8,46
Melbourne V,2187,4,13,5,11,46,40,6,44
Adelaide Utd,2187,5,11,6,11,37,40,-3,39
Brisbane,2187,6,10,5,13,33,42,-9,35
Western Sydn,2187,7,8,9,10,38,47,-9,33
Perth Glory,2187,8,10,2,15,37,50,-13,32
Wellington P,2187,9,5,6,16,31,55,-24,21
CC Mariners,2187,10,4,8,15,28,49,-21,20
Sydney FC,2188,1,21,4,3,69,22,47,67
N'castle Jet,2188,2,15,5,8,57,38,19,50
Melbourne C,2188,3,15,4,10,44,33,11,49
Melbourne V,2188,4,13,5,11,45,43,2,44
Adelaide Utd,2188,5,11,6,11,37,40,-3,39
Brisbane,2188,6,10,5,13,33,42,-9,35
Western Sydn,2188,7,8,9,10,38,47,-9,33
Perth Glory,2188,8,10,2,15,37,50,-13,32
Wellington P,2188,9,5,6,16,31,55,-24,21
CC Mariners,2188,10,4,8,15,28,49,-21,20
Sydney FC,2189,1,20,5,3,65,23,42,65
N'castle Jet,2189,2,16,5,7,58,37,21,53
Melbourne C,2189,3,14,4,11,43,34,9,46
Melbourne V,2189,4,13,6,10,46,39,7,45
Adelaide Utd,2189,5,11,6,11,37,40,-3,39
Brisbane,2189,6,10,5,13,33,42,-9,35
Western Sydn,2189,7,8,9,10,38,47,-9,33
Perth Glory,2189,8,10,2,15,37,50,-13,32
Wellington P,2189,9,5,6,16,31,55,-24,21
CC Mariners,2189,10,4,8,15,28,49,-21,20
Sydney FC,2190,1,20,5,3,65,23,42,65
N'castle Jet,2190,2,16,5,7,58,37,21,53
Melbourne C,2190,3,14,4,11,43,34,9,46
Melbourne V,2190,4,13,6,10,46,39,7,45
Adelaide Utd,2190,5,11,6,11,37,40,-3,39
Brisbane,2190,6,10,5,13,33,42,-9,35
Western Sydn,2190,7,8,9,10,38,47,-9,33
Perth Glory,2190,8,10,2,15,37,50,-13,32
Wellington P,2190,9,5,6,16,31,55,-24,21
CC Mariners,2190,10,4,8,15,28,49,-21,20
Sydney FC,2191,1,21,4,3,68,24,44,67
N'castle Jet,2191,2,16,5,7,59,38,21,53
Melbourne C,2191,3,14,4,11,44,35,9,46
Melbourne V,2191,4,13,5,11,47,42,5,44
Adelaide Utd,2191,5,11,6,11,37,40,-3,39
Brisbane,2191,6,10,5,13,33,42,-9,35
Western Sydn,2191,7,8,9,10,38,47,-9,33
Perth Glory,2191,8,10,2,15,37,50,-13,32
Wellington P,2191,9,5,6,16,31,55,-24,21
CC Mariners,2191,10,4,8,15,28,49,-21,20
Sydney FC,2192,1,21,4,3,67,22,45,67
N'castle Jet,2192,2,16,5,7,61,37,24,53
Melbourne C,2192,3,14,4,11,43,37,6,46
Melbourne V,2192,4,13,5,11,45,41,4,44
Adelaide Utd,2192,5,11,6,11,37,40,-3,39
Brisbane,2192,6,10,5,13,33,42,-9,35
Western Sydn,2192,7,8,9,10,38,47,-9,33
Perth Glory,2192,8,10,2,15,37,50,-13,32
Wellington P,2192,9,5,6,16,31,55,-24,21
CC Mariners,2192,10,4,8,15,28,49,-21,20
Sydney FC,2193,1,21,4,3,67,24,43,67
N'castle Jet,2193,2,16,5,7,60,39,21,53
Melbourne C,2193,3,14,4,11,45,36,9,46
Melbourne V,2193,4,13,5,11,47,41,6,44
Adelaide Utd,2193,5,11,6,11,37,40,-3,39
Brisbane,2193,6,10,5,13,33,42,-9,35
Western Sydn,2193,7,8,9,10,38,47,-9,33
Perth Glory,2193,8,10,2,15,37,50,-13,32
Wellington P,2193,9,5,6,16,31,55,-24,21
CC Mariners,2193,10,4,8,15,28,49,-21,20
Sydney FC,2194,1,20,5,3,65,23,42,65
N'castle Jet,2194,2,16,5,7,58,37,21,53
Melbourne C,2194,3,14,4,11,43,34,9,46
Melbourne V,2194,4,13,6,10,46,39,7,45
Adelaide Utd,2194,5,11,6,11,37,40,-3,39
Brisbane,2194,6,10,5,13,33,42,-9,35
Western Sydn,2194,7,8,9,10,38,47,-9,33
Perth Glory,2194,8,10,2,15,37,50,-13,32
Wellington P,2194,9,5,6,16,31,55,-24,21
CC Mariners,2194,10,4,8,15,28,49,-21,20
Sydney FC,2195,1,21,4,3,67,23,44,67
N'castle Jet,2195,2,15,6,7,58,38,20,51
Melbourne C,2195,3,14,5,10,44,34,10,47
Melbourne V,2195,4,13,5,11,46,41,5,44
Adelaide Utd,2195,5,11,6,11,37,40,-3,39
Brisbane,2195,6,10,5,13,33,42,-9,35
Western Sydn,2195,7,8,9,10,38,47,-9,33
Perth Glory,2195,8,10,2,15,37,50,-13,32
Wellington P,2195,9,5,6,16,31,55,-24,21
CC Mariners,2195,10,4,8,15,28,49,-21,20
Sydney FC,2196,1,20,5,3,65,23,42,65
N'castle Jet,2196,2,16,5,7,60,38,22,53
Melbourne C,2196,3,14,4,11,44,36,8,46
Melbourne V,2196,4,13,6,10,46,39,7,45
Adelaide Utd,2196,5,11,6,11,37,40,-3,39
Brisbane,2196,6,10,5,13,33,42,-9,35
Western Sydn,2196,7,8,9,10,38,47,-9,33
Perth Glory,2196,8,10,2,15,37,50,-13,32
Wellington P,2196,9,5,6,16,31,55,-24,21
CC Mariners,2196,10,4,8,15,28,49,-21,20
Sydney FC,2197,1,21,4,3,66,22,44,67
N'castle Jet,2197,2,16,5,7,58,37,21,53
Melbourne C,2197,3,14,4,11,43,34,9,46
Melbourne V,2197,4,13,5,11,45,40,5,44
Adelaide Utd,2197,5,11,6,11,37,40,-3,39
Brisbane,2197,6,10,5,13,33,42,-9,35
Western Sydn,2197,7,8,9,10,38,47,-9,33
Perth Glory,2197,8,10,2,15,37,50,-13,32
Wellington P,2197,9,5,6,16,31,55,-24,21
CC Mariners,2197,10,4,8,15,28,49,-21,20
Sydney FC,2198,1,21,4,3,70,22,48,67
N'castle Jet,2198,2,16,5,7,61,38,23,53
Melbourne C,2198,3,14,4,11,44,37,7,46
Melbourne V,2198,4,13,5,11,45,44,1,44
Adelaide Utd,2198,5,11,6,11,37,40,-3,39
Brisbane,2198,6,10,5,13,33,42,-9,35
Western Sydn,2198,7,8,9,10,38,47,-9,33
Perth Glory,2198,8,10,2,15,37,50,-13,32
Wellington P,2198,9,5,6,16,31,55,-24,21
CC Mariners,2198,10,4,8,15,28,49,-21,20
Sydney FC,2199,1,21,4,3,71,22,49,67
N'castle Jet,2199,2,15,6,7,59,39,20,51
Melbourne C,2199,3,14,5,10,45,35,10,47
Melbourne V,2199,4,13,5,11,45,45,0,44
Adelaide Utd,2199,5,11,6,11,37,40,-3,39
Brisbane,2199,6,10,5,13,33,42,-9,35
Western Sydn,2199,7,8,9,10,38,47,-9,33
Perth Glory,2199,8,10,2,15,37,50,-13,32
Wellington P,2199,9,5,6,16,31,55,-24,21
CC Mariners,2199,10,4,8,15,28,49,-21,20
Sydney FC,2200,1,20,4,4,65,24,41,64
N'castle Jet,2200,2,15,6,7,57,37,20,51
Melbourne C,2200,3,14,5,10,43,33,10,47
Melbourne V,2200,4,14,5,10,47,39,8,47
Adelaide Utd,2200,5,11,6,11,37,40,-3,39
Brisbane,2200,6,10,5,13,33,42,-9,35
Western Sydn,2200,7,8,9,10,38,47,-9,33
Perth Glory,2200,8,10,2,15,37,50,-13,32
Wellington P,2200,9,5,6,16,31,55,-24,21
CC Mariners,2200,10,4,8,15,28,49,-21,20
Sydney FC,2201,1,21,4,3,65,22,43,67
N'castle Jet,2201,2,15,5,8,58,39,19,50
Melbourne C,2201,3,15,4,10,45,34,11,49
Melbourne V,2201,4,13,5,11,45,39,6,44
Adelaide Utd,2201,5,11,6,11,37,40,-3,39
Brisbane,2201,6,10,5,13,33,42,-9,35
Western Sydn,2201,7,8,9,10,38,47,-9,33
Perth Glory,2201,8,10,2,15,37,50,-13,32
Wellington P,2201,9,5,6,16,31,55,-24,21
CC Mariners,2201,10,4,8,15,28,49,-21,20
Sydney FC,2202,1,21,4,3,66,23,43,67
N'castle Jet,2202,2,16,5,7,59,37,22,53
Melbourne C,2202,3,14,4,11,43,35,8,46
Melbourne V,2202,4,13,5,11,46,40,6,44
Adelaide Utd,2202,5,11,6,11,37,40,-3,39
Brisbane,2202,6,10,5,13,33,42,-9,35
Western Sydn,2202,7,8,9,10,38,47,-9,33
Perth Glory,2202,8,10,2,15,37,50,-13,32
Wellington P,2202,9,5,6,16,31,55,-24,21
CC Mariners,2202,10,4,8,15,28,49,-21,20
Sydney FC,2203,1,21,4,3,68,23,45,67
N'castle Jet,2203,2,15,5,8,59,40,19,50
Melbourne C,2203,3,15,4,10,46,35,11,49
Melbourne V,2203,4,13,5,11,46,42,4,44
Adelaide Utd,2203,5,11,6,11,37,40,-3,39
Brisbane,2203,6,10,5,13,33,42,-9,35
Western Sydn,2203,7,8,9,10,38,47,-9,33
Perth Glory,2203,8,10,2,15,37,50,-13,32
Wellington P,2203,9,5,6,16,31,55,-24,21
CC Mariners,2203,10,4,8,15,28,49,-21,20
Sydney FC,2204,1,21,4,3,68,22,46,67
N'castle Jet,2204,2,16,5,7,60,37,23,53
Melbourne C,2204,3,14,4,11,43,36,7,46
Melbourne V,2204,4,13,5,11,45,42,3,44
Adelaide Utd,2204,5,11,6,11,37,40,-3,39
Brisbane,2204,6,10,5,13,33,42,-9,35
Western Sydn,2204,7,8,9,10,38,47,-9,33
Perth Glory,2204,8,10,2,15,37,50,-13,32
Wellington P,2204,9,5,6,16,31,55,-24,21
CC Mariners,2204,10,4,8,15,28,49,-21,20
Sydney FC,2205,1,20,4,4,64,23,41,64
N'castle Jet,2205,2,16,5,7,61,39,22,53
Melbourne V,2205,3,14,5,10,46,38,8,47
Melbourne C,2205,4,14,4,11,45,37,8,46
Adelaide Utd,2205,5,11,6,11,37,40,-3,39
Brisbane,2205,6,10,5,13,33,42,-9,35
Western Sydn,2205,7,8,9,10,38,47,-9,33
Perth Glory,2205,8,10,2,15,37,50,-13,32
Wellington P,2205,9,5,6,16,31,55,-24,21
CC Mariners,2205,10,4,8,15,28,49,-21,20
Sydney FC,2206,1,20,5,3,64,22,42,65
N'castle Jet,2206,2,16,5,7,60,38,22,53
Melbourne C,2206,3,14,4,11,44,36,8,46
Melbourne V,2206,4,13,6,10,45,38,7,45
Adelaide Utd,2206,5,11,6,11,37,40,-3,39
Brisbane,2206,6,10,5,13,33,42,-9,35
Western Sydn,2206,7,8,9,10,38,47,-9,33
Perth Glory,2206,8,10,2,15,37,50,-13,32
Wellington P,2206,9,5,6,16,31,55,-24,21
CC Mariners,2206,10,4,8,15,28,49,-21,20
Sydney FC,2207,1,21,4,3,67,22,45,67
N'castle Jet,2207,2,15,6,7,57,37,20,51
Melbourne C,2207,3,14,5,10,43,33,10,47
Melbourne V,2207,4,13,5,11,45,41,4,44
Adelaide Utd,2207,5,11,6,11,37,40,-3,39
Brisbane,2207,6,10,5,13,33,42,-9,35
Western Sydn,2207,7,8,9,10,38,47,-9,33
Perth Glory,2207,8,10,2,15,37,50,-13,32
Wellington P,2207,9,5,6,16,31,55,-24,21
CC Mariners,2207,10,4,8,15,28,49,-21,20
Sydney FC,2208,1,20,5,3,64,22,42,65
N'castle Jet,2208,2,16,5,7,59,37,22,53
Melbourne C,2208,3,14,4,11,43,35,8,46
Melbourne V,2208,4,13,6,10,45,38,7,45
Adelaide Utd,2208,5,11,6,11,37,40,-3,39
Brisbane,2208,6,10,5,13,33,42,-9,35
Western Sydn,2208,7,8,9,10,38,47,-9,33
Perth Glory,2208,8,10,2,15,37,50,-13,32
Wellington P,2208,9,5,6,16,31,55,-24,21
CC Mariners,2208,10,4,8,15,28,49,-21,20
Sydney FC,2209,1,21,4,3,68,22,46,67
N'castle Jet,2209,2,16,5,7,59,37,22,53
Melbourne C,2209,3,14,4,11,43,35,8,46
Melbourne V,2209,4,13,5,11,45,42,3,44
Adelaide Utd,2209,5,11,6,11,37,40,-3,39
Brisbane,2209,6,10,5,13,33,42,-9,35
Western Sydn,2209,7,8,9,10,38,47,-9,33
Perth Glory,2209,8,10,2,15,37,50,-13,32
Wellington P,2209,9,5,6,16,31,55,-24,21
CC Mariners,2209,10,4,8,15,28,49,-21,20
Sydney FC,2210,1,21,4,3,66,22,44,67
N'castle Jet,2210,2,15,5,8,58,39,19,50
Melbourne C,2210,3,15,4,10,45,34,11,49
Melbourne V,2210,4,13,5,11,45,40,5,44
Adelaide Utd,2210,5,11,6,11,37,40,-3,39
Brisbane,2210,6,10,5,13,33,42,-9,35
Western Sydn,2210,7,8,9,10,38,47,-9,33
Perth Glory,2210,8,10,2,15,37,50,-13,32
Wellington P,2210,9,5,6,16,31,55,-24,21
CC Mariners,2210,10,4,8,15,28,49,-21,20
Sydney FC,2211,1,21,4,3,66,22,44,67
N'castle Jet,2211,2,16,5,7,58,37,21,53
Melbourne C,2211,3,14,4,11,43,34,9,46
Melbourne V,2211,4,13,5,11,45,40,5,44
Adelaide Utd,2211,5,11,6,11,37,40,-3,39
Brisbane,2211,6,10,5,13,33,42,-9,35
Western Sydn,2211,7,8,9,10,38,47,-9,33
Perth Glory,2211,8,10,2,15,37,50,-13,32
Wellington P,2211,9,5,6,16,31,55,-24,21
CC Mariners,2211,10,4,8,15,28,49,-21,20
Sydney FC,2212,1,20,4,4,64,23,41,64
N'castle Jet,2212,2,16,5,7,63,37,26,53
Melbourne V,2212,3,14,5,10,46,38,8,47
Melbourne C,2212,4,14,4,11,43,39,4,46
Adelaide Utd,2212,5,11,6,11,37,40,-3,39
Brisbane,2212,6,10,5,13,33,42,-9,35
Western Sydn,2212,7,8,9,10,38,47,-9,33
Perth Glory,2212,8,10,2,15,37,50,-13,32
Wellington P,2212,9,5,6,16,31,55,-24,21
CC Mariners,2212,10,4,8,15,28,49,-21,20
Sydney FC,2213,1,20,5,3,68,26,42,65
N'castle Jet,2213,2,16,5,7,60,37,23,53
Melbourne C,2213,3,14,4,11,43,36,7,46
Melbourne V,2213,4,13,6,10,49,42,7,45
Adelaide Utd,2213,5,11,6,11,37,40,-3,39
Brisbane,2213,6,10,5,13,33,42,-9,35
Western Sydn,2213,7,8,9,10,38,47,-9,33
Perth Glory,2213,8,10,2,15,37,50,-13,32
Wellington P,2213,9,5,6,16,31,55,-24,21
CC Mariners,2213,10,4,8,15,28,49,-21,20
Sydney FC,2214,1,21,4,3,66,23,43,67
N'castle Jet,2214,2,15,6,7,59,39,20,51
Melbourne C,2214,3,14,5,10,45,35,10,47
Melbourne V,2214,4,13,5,11,46,40,6,44
Adelaide Utd,2214,5,11,6,11,37,40,-3,39
Brisbane,2214,6,10,5,13,33,42,-9,35
Western Sydn,2214,7,8,9,10,38,47,-9,33
Perth Glory,2214,8,10,2,15,37,50,-13,32
Wellington P,2214,9,5,6,16,31,55,-24,21
CC Mariners,2214,10,4,8,15,28,49,-21,20
Sydney FC,2215,1,20,4,4,65,24,41,64
N'castle Jet,2215,2,16,5,7,60,37,23,53
Melbourne V,2215,3,14,5,10,47,39,8,47
Melbourne C,2215,4,14,4,11,43,36,7,46
Adelaide Utd,2215,5,11,6,11,37,40,-3,39
Brisbane,2215,6,10,5,13,33,42,-9,35
Western Sydn,2215,7,8,9,10,38,47,-9,33
Perth Glory,2215,8,10,2,15,37,50,-13,32
Wellington P,2215,9,5,6,16,31,55,-24,21
CC Mariners,2215,10,4,8,15,28,49,-21,20
Sydney FC,2216,1,20,5,3,64,22,42,65
N'castle Jet,2216,2,15,6,7,57,37,20,51
Melbourne C,2216,3,14,5,10,43,33,10,47
Melbourne V,2216,4,13,6,10,45,38,7,45
Adelaide Utd,2216,5,11,6,11,37,40,-3,39
Brisbane,2216,6,10,5,13,33,42,-9,35
Western Sydn,2216,7,8,9,10,38,47,-9,33
Perth Glory,2216,8,10,2,15,37,50,-13,32
Wellington P,2216,9,5,6,16,31,55,-24,21
CC Mariners,2216,10,4,8,15,28,49,-21,20
Sydney FC,2217,1,20,5,3,65,23,42,65
N'castle Jet,2217,2,16,5,7,60,38,22,53
Melbourne C,2217,3,14,4,11,44,36,8,46
Melbourne V,2217,4,13,6,10,46,39,7,45
Adelaide Utd,2217,5,11,6,11,37,40,-3,39
Brisbane,2217,6,10,5,13,33,42,-9,35
Western Sydn,2217,7,8,9,10,38,47,-9,33
Perth Glory,2217,8,10,2,15,37,50,-13,32
Wellington P,2217,9,5,6,16,31,55,-24,21
CC Mariners,2217,10,4,8,15,28,49,-21,20
Sydney FC,2218,1,21,4,3,65,22,43,67
N'castle Jet,2218,2,16,5,7,59,38,21,53
Melbourne C,2218,3,14,4,11,44,35,9,46
Melbourne V,2218,4,13,5,11,45,39,6,44
Adelaide Utd,2218,5,11,6,11,37,40,-3,39
Brisbane,2218,6,10,5,13,33,42,-9,35
Western Sydn,2218,7,8,9,10,38,47,-9,33
Perth Glory,2218,8,10,2,15,37,50,-13,32
Wellington P,2218,9,5,6,16,31,55,-24,21
CC Mariners,2218,10,4,8,15,28,49,-21,20
Sydney FC,2219,1,21,4,3,67,23,44,67
N'castle Jet,2219,2,15,5,8,58,39,19,50
Melbourne C,2219,3,15,4,10,45,34,11,49
Melbourne V,2219,4,13,5,11,46,41,5,44
Adelaide Utd,2219,5,11,6,11,37,40,-3,39
Brisbane,2219,6,10,5,13,33,42,-9,35
Western Sydn,2219,7,8,9,10,38,47,-9,33
Perth Glory,2219,8,10,2,15,37,50,-13,32
Wellington P,2219,9,5,6,16,31,55,-24,21
CC Mariners,2219,10,4,8,15,28,49,-21,20
Sydney FC,2220,1,21,4,3,66,23,43,67
N'castle Jet,2220,2,16,5,7,59,38,21,53
Melbourne C,2220,3,14,4,11,44,35,9,46
Melbourne V,2220,4,13,5,11,46,40,6,44
Adelaide Utd,2220,5,11,6,11,37,40,-3,39
Brisbane,2220,6,10,5,13,33,42,-9,35
Western Sydn,2220,7,8,9,10,38,47,-9,33
Perth Glory,2220,8,10,2,15,37,50,-13,32
Wellington P,2220,9,5,6,16,31,55,-24,21
CC Mariners,2220,10,4,8,15,28,49,-21,20
Sydney FC,2221,1,21,4,3,67,22,45,67
N'castle Jet,2221,2,16,5,7,61,38,23,53
Melbourne C,2221,3,14,4,11,44,37,7,46
Melbourne V,2221,4,13,5,11,45,41,4,44
Adelaide Utd,2221,5,11,6,11,37,40,-3,39
Brisbane,2221,6,10,5,13,33,42,-9,35
Western Sydn,2221,7,8,9,10,38,47,-9,33
Perth Glory,2221,8,10,2,15,37,50,-13,32
Wellington P,2221,9,5,6,16,31,55,-24,21
CC Mariners,2221,10,4,8,15,28,49,-21,20
Sydney FC,2222,1,21,4,3,67,22,45,67
N'castle Jet,2222,2,15,6,7,59,39,20,51
Melbourne C,2222,3,14,5,10,45,35,10,47
Melbourne V,2222,4,13,5,11,45,41,4,44
Adelaide Utd,2222,5,11,6,11,37,40,-3,39
Brisbane,2222,6,10,5,13,33,42,-9,35
Western Sydn,2222,7,8,9,10,38,47,-9,33
Perth Glory,2222,8,10,2,15,37,50,-13,32
Wellington P,2222,9,5,6,16,31,55,-24,21
CC Mariners,2222,10,4,8,15,28,49,-21,20
Sydney FC,2223,1,21,4,3,67,23,44,67
N'castle Jet,2223,2,15,5,8,57,38,19,50
Melbourne C,2223,3,15,4,10,44,33,11,49
Melbourne V,2223,4,13,5,11,46,41,5,44
Adelaide Utd,2223,5,11,6,11,37,40,-3,39
Brisbane,2223,6,10,5,13,33,42,-9,35
Western Sydn,2223,7,8,9,10,38,47,-9,33
Perth Glory,2223,8,10,2,15,37,50,-13,32
Wellington P,2223,9,5,6,16,31,55,-24,21
CC Mariners,2223,10,4,8,15,28,49,-21,20
Sydney FC,2224,1,21,4,3,67,23,44,67
N'castle Jet,2224,2,15,6,7,59,39,20,51
Melbourne C,2224,3,14,5,10,45,35,10,47
Melbourne V,2224,4,13,5,11,46,41,5,44
Adelaide Utd,2224,5,11,6,11,37,40,-3,39
Brisbane,2224,6,10,5,13,33,42,-9,35
Western Sydn,2224,7,8,9,10,38,47,-9,33
Perth Glory,2224,8,10,2,15,37,50,-13,32
Wellington P,2224,9,5,6,16,31,55,-24,21
CC Mariners,2224,10,4,8,15,28,49,-21,20
Sydney FC,2225,1,20,5,3,64,22,42,65
N'castle Jet,2225,2,16,5,7,60,37,23,53
Melbourne C,2225,3,14,4,11,43,36,7,46
Melbourne V,2225,4,13,6,10,45,38,7,45
Adelaide Utd,2225,5,11,6,11,37,40,-3,39
Brisbane,2225,6,10,5,13,33,42,-9,35
Western Sydn,2225,7,8,9,10,38,47,-9,33
Perth Glory,2225,8,10,2,15,37,50,-13,32
Wellington P,2225,9,5,6,16,31,55,-24,21
CC Mariners,2225,10,4,8,15,28,49,-21,20
Sydney FC,2226,1,21,4,3,67,24,43,67
N'castle Jet,2226,2,16,5,7,59,37,22,53
Melbourne C,2226,3,14,4,11,43,35,8,46
Melbourne V,2226,4,13,5,11,47,41,6,44
Adelaide Utd,2226,5,11,6,11,37,40,-3,39
Brisbane,2226,6,10,5,13,33,42,-9,35
Western Sydn,2226,7,8,9,10,38,47,-9,33
Perth Glory,2226,8,10,2,15,37,50,-13,32
Wellington P,2226,9,5,6,16,31,55,-24,21
CC Mariners,2226,10,4,8,15,28,49,-21,20
Sydney FC,2227,1,21,4,3,67,24,43,67
N'castle Jet,2227,2,16,5,7,58,37,21,53
Melbourne C,2227,3,14,4,11,43,34,9,46
Melbourne V,2227,4,13,5,11,47,41,6,44
Adelaide Utd,2227,5,11,6,11,37,40,-3,39
Brisbane,2227,6,10,5,13,33,42,-9,35
Western Sydn,2227,7,8,9,10,38,47,-9,33
Perth Glory,2227,8,10,2,15,37,50,-13,32
Wellington P,2227,9,5,6,16,31,55,-24,21
CC Mariners,2227,10,4,8,15,28,49,-21,20
Sydney FC,2228,1,21,4,3,66,22,44,67
N'castle Jet,2228,2,15,6,7,58,38,20,51
Melbourne C,2228,3,14,5,10,44,34,10,47
Melbourne V,2228,4,13,5,11,45,40,5,44
Adelaide Utd,2228,5,11,6,11,37,40,-3,39
Brisbane,2228,6,10,5,13,33,42,-9,35
Western Sydn,2228,7,8,9,10,38,47,-9,33
Perth Glory,2228,8,10,2,15,37,50,-13,32
Wellington P,2228,9,5,6,16,31,55,-24,21
CC Mariners,2228,10,4,8,15,28,49,-21,20
Sydney FC,2229,1,21,4,3,66,22,44,67
N'castle Jet,2229,2,16,5,7,60,38,22,53
Melbourne C,2229,3,14,4,11,44,36,8,46
Melbourne V,2229,4,13,5,11,45,40,5,44
Adelaide Utd,2229,5,11,6,11,37,40,-3,39
Brisbane,2229,6,10,5,13,33,42,-9,35
Western Sydn,2229,7,8,9,10,38,47,-9,33
Perth Glory,2229,8,10,2,15,37,50,-13,32
Wellington P,2229,9,5,6,16,31,55,-24,21
CC Mariners,2229,10,4,8,15,28,49,-21,20
Sydney FC,2230,1,21,4,3,67,23,44,67
N'castle Jet,2230,2,15,5,8,57,38,19,50
Melbourne C,2230,3,15,4,10,44,33,11,49
Melbourne V,2230,4,13,5,11,46,41,5,44
Adelaide Utd,2230,5,11,6,11,37,40,-3,39
Brisbane,2230,6,10,5,13,33,42,-9,35
Western Sydn,2230,7,8,9,10,38,47,-9,33
Perth Glory,2230,8,10,2,15,37,50,-13,32
Wellington P,2230,9,5,6,16,31,55,-24,21
CC Mariners,2230,10,4,8,15,28,49,-21,20
Sydney FC,2231,1,21,4,3,67,22,45,67
N'castle Jet,2231,2,16,5,7,61,39,22,53
Melbourne C,2231,3,14,4,11,45,37,8,46
Melbourne V,2231,4,13,5,11,45,41,4,44
Adelaide Utd,2231,5,11,6,11,37,40,-3,39
Brisbane,2231,6,10,5,13,33,42,-9,35
Western Sydn,2231,7,8,9,10,38,47,-9,33
Perth Glory,2231,8,10,2,15,37,50,-13,32
Wellington P,2231,9,5,6,16,31,55,-24,21
CC Mariners,2231,10,4,8,15,28,49,-21,20
Sydney FC,2232,1,21,4,3,66,22,44,67
N'castle Jet,2232,2,16,5,7,58,37,21,53
Melbourne C,2232,3,14,4,11,43,34,9,46
Melbourne V,2232,4,13,5,11,45,40,5,44
Adelaide Utd,2232,5,11,6,11,37,40,-3,39
Brisbane,2232,6,10,5,13,33,42,-9,35
Western Sydn,2232,7,8,9,10,38,47,-9,33
Perth Glory,2232,8,10,2,15,37,50,-13,32
Wellington P,2232,9,5,6,16,31,55,-24,21
CC Mariners,2232,10,4,8,15,28,49,-21,20
Sydney FC,2233,1,21,4,3,65,22,43,67
N'castle Jet,2233,2,15,6,7,61,41,20,51
Melbourne C,2233,3,14,5,10,47,37,10,47
Melbourne V,2233,4,13,5,11,45,39,6,44
Adelaide Utd,2233,5,11,6,11,37,40,-3,39
Brisbane,2233,6,10,5,13,33,42,-9,35
Western Sydn,2233,7,8,9,10,38,47,-9,33
Perth Glory,2233,8,10,2,15,37,50,-13,32
Wellington P,2233,9,5,6,16,31,55,-24,21
CC Mariners,2233,10,4,8,15,28,49,-21,20
Sydney FC,2234,1,21,4,3,66,23,43,67
N'castle Jet,2234,2,16,5,7,59,38,21,53
Melbourne C,2234,3,14,4,11,44,35,9,46
Melbourne V,2234,4,13,5,11,46,40,6,44
Adelaide Utd,2234,5,11,6,11,37,40,-3,39
Brisbane,2234,6,10,5,13,33,42,-9,35
Western Sydn,2234,7,8,9,10,38,47,-9,33
Perth Glory,2234,8,10,2,15,37,50,-13,32
Wellington P,2234,9,5,6,16,31,55,-24,21
CC Mariners,2234,10,4,8,15,28,49,-21,20
Sydney FC,2235,1,20,5,3,65,23,42,65
N'castle Jet,2235,2,16,5,7,61,39,22,53
Melbourne C,2235,3,14,4,11,45,37,8,46
Melbourne V,2235,4,13,6,10,46,39,7,45
Adelaide Utd,2235,5,11,6,11,37,40,-3,39
Brisbane,2235,6,10,5,13,33,42,-9,35
Western Sydn,2235,7,8,9,10,38,47,-9,33
Perth Glory,2235,8,10,2,15,37,50,-13,32
Wellington P,2235,9,5,6,16,31,55,-24,21
CC Mariners,2235,10,4,8,15,28,49,-21,20
Sydney FC,2236,1,20,4,4,64,25,39,64
N'castle Jet,2236,2,16,5,7,59,38,21,53
Melbourne V,2236,3,14,5,10,48,38,10,47
Melbourne C,2236,4,14,4,11,44,35,9,46
Adelaide Utd,2236,5,11,6,11,37,40,-3,39
Brisbane,2236,6,10,5,13,33,42,-9,35
Western Sydn,2236,7,8,9,10,38,47,-9,33
Perth Glory,2236,8,10,2,15,37,50,-13,32
Wellington P,2236,9,5,6,16,31,55,-24,21
CC Mariners,2236,10,4,8,15,28,49,-21,20
Sydney FC,2237,1,21,4,3,67,23,44,67
N'castle Jet,2237,2,16,5,7,60,37,23,53
Melbourne C,2237,3,14,4,11,43,36,7,46
Melbourne V,2237,4,13,5,11,46,41,5,44
Adelaide Utd,2237,5,11,6,11,37,40,-3,39
Brisbane,2237,6,10,5,13,33,42,-9,35
Western Sydn,2237,7,8,9,10,38,47,-9,33
Perth Glory,2237,8,10,2,15,37,50,-13,32
Wellington P,2237,9,5,6,16,31,55,-24,21
CC Mariners,2237,10,4,8,15,28,49,-21,20
Sydney FC,2238,1,21,4,3,68,24,44,67
N'castle Jet,2238,2,15,6,7,57,37,20,51
Melbourne C,2238,3,14,5,10,43,33,10,47
Melbourne V,2238,4,13,5,11,47,42,5,44
Adelaide Utd,2238,5,11,6,11,37,40,-3,39
Brisbane,2238,6,10,5,13,33,42,-9,35
Western Sydn,2238,7,8,9,10,38,47,-9,33
Perth Glory,2238,8,10,2,15,37,50,-13,32
Wellington P,2238,9,5,6,16,31,55,-24,21
CC Mariners,2238,10,4,8,15,28,49,-21,20
Sydney FC,2239,1,21,4,3,68,23,45,67
N'castle Jet,2239,2,15,5,8,57,38,19,50
Melbourne C,2239,3,15,4,10,44,33,11,49
Melbourne V,2239,4,13,5,11,46,42,4,44
Adelaide Utd,2239,5,11,6,11,37,40,-3,39
Brisbane,2239,6,10,5,13,33,42,-9,35
Western Sydn,2239,7,8,9,10,38,47,-9,33
Perth Glory,2239,8,10,2,15,37,50,-13,32
Wellington P,2239,9,5,6,16,31,55,-24,21
CC Mariners,2239,10,4,8,15,28,49,-21,20
Sydney FC,2240,1,21,4,3,69,24,45,67
N'castle Jet,2240,2,15,6,7,58,38,20,51
Melbourne C,2240,3,14,5,10,44,34,10,47
Melbourne V,2240,4,13,5,11,47,43,4,44
Adelaide Utd,2240,5,11,6,11,37,40,-3,39
Brisbane,2240,6,10,5,13,33,42,-9,35
Western Sydn,2240,7,8,9,10,38,47,-9,33
Perth Glory,2240,8,10,2,15,37,50,-13,32
Wellington P,2240,9,5,6,16,31,55,-24,21
CC Mariners,2240,10,4,8,15,28,49,-21,20
Sydney FC,2241,1,21,4,3,68,22,46,67
N'castle Jet,2241,2,16,5,7,58,37,21,53
Melbourne C,2241,3,14,4,11,43,34,9,46
Melbourne V,2241,4,13,5,11,45,42,3,44
Adelaide Utd,2241,5,11,6,11,37,40,-3,39
Brisbane,2241,6,10,5,13,33,42,-9,35
Western Sydn,2241,7,8,9,10,38,47,-9,33
Perth Glory,2241,8,10,2,15,37,50,-13,32
Wellington P,2241,9,5,6,16,31,55,-24,21
CC Mariners,2241,10,4,8,15,28,49,-21,20
Sydney FC,2242,1,21,4,3,67,23,44,67
N'castle Jet,2242,2,16,5,7,60,38,22,53
Melbourne C,2242,3,14,4,11,44,36,8,46
Melbourne V,2242,4,13,5,11,46,41,5,44
Adelaide Utd,2242,5,11,6,11,37,40,-3,39
Brisbane,2242,6,10,5,13,33,42,-9,35
Western Sydn,2242,7,8,9,10,38,47,-9,33
Perth Glory,2242,8,10,2,15,37,50,-13,32
Wellington P,2242,9,5,6,16,31,55,-24,21
CC Mariners,2242,10,4,8,15,28,49,-21,20
Sydney FC,2243,1,21,4,3,69,23,46,67
N'castle Jet,2243,2,16,5,7,60,39,21,53
Melbourne C,2243,3,14,4,11,45,36,9,46
Melbourne V,2243,4,13,5,11,46,43,3,44
Adelaide Utd,2243,5,11,6,11,37,40,-3,39
Brisbane,2243,6,10,5,13,33,42,-9,35
Western Sydn,2243,7,8,9,10,38,47,-9,33
Perth Glory,2243,8,10,2,15,37,50,-13,32
Wellington P,2243,9,5,6,16,31,55,-24,21
CC Mariners,2243,10,4,8,15,28,49,-21,20
Sydney FC,2244,1,20,4,4,65,26,39,64
N'castle Jet,2244,2,15,6,7,57,37,20,51
Melbourne V,2244,3,14,5,10,49,39,10,47
Melbourne C,2244,4,14,5,10,43,33,10,47
Adelaide Utd,2244,5,11,6,11,37,40,-3,39
Brisbane,2244,6,10,5,13,33,42,-9,35
Western Sydn,2244,7,8,9,10,38,47,-9,33
Perth Glory,2244,8,10,2,15,37,50,-13,32
Wellington P,2244,9,5,6,16,31,55,-24,21
CC Mariners,2244,10,4,8,15,28,49,-21,20
Sydney FC,2245,1,21,4,3,66,22,44,67
N'castle Jet,2245,2,16,5,7,59,37,22,53
Melbourne C,2245,3,14,4,11,43,35,8,46
Melbourne V,2245,4,13,5,11,45,40,5,44
Adelaide Utd,2245,5,11,6,11,37,40,-3,39
Brisbane,2245,6,10,5,13,33,42,-9,35
Western Sydn,2245,7,8,9,10,38,47,-9,33
Perth Glory,2245,8,10,2,15,37,50,-13,32
Wellington P,2245,9,5,6,16,31,55,-24,21
CC Mariners,2245,10,4,8,15,28,49,-21,20
Sydney FC,2246,1,21,4,3,67,22,45,67
N'castle Jet,2246,2,15,6,7,58,38,20,51
Melbourne C,2246,3,14,5,10,44,34,10,47
Melbourne V,2246,4,13,5,11,45,41,4,44
Adelaide Utd,2246,5,11,6,11,37,40,-3,39
Brisbane,2246,6,10,5,13,33,42,-9,35
Western Sydn,2246,7,8,9,10,38,47,-9,33
Perth Glory,2246,8,10,2,15,37,50,-13,32
Wellington P,2246,9,5,6,16,31,55,-24,21
CC Mariners,2246,10,4,8,15,28,49,-21,20
Sydney FC,2247,1,21,4,3,66,23,43,67
N'castle Jet,2247,2,16,5,7,60,37,23,53
Melbourne C,2247,3,14,4,11,43,36,7,46
Melbourne V,2247,4,13,5,11,46,40,6,44
Adelaide Utd,2247,5,11,6,11,37,40,-3,39
Brisbane,2247,6,10,5,13,33,42,-9,35
Western Sydn,2247,7,8,9,10,38,47,-9,33
Perth Glory,2247,8,10,2,15,37,50,-13,32
Wellington P,2247,9,5,6,16,31,55,-24,21
CC Mariners,2247,10,4,8,15,28,49,-21,20
Sydney FC,2248,1,21,4,3,65,22,43,67
N'castle Jet,2248,2,16,5,7,58,37,21,53
Melbourne C,2248,3,14,4,11,43,34,9,46
Melbourne V,2248,4,13,5,11,45,39,6,44
Adelaide Utd,2248,5,11,6,11,37,40,-3,39
Brisbane,2248,6,10,5,13,33,42,-9,35
Western Sydn,2248,7,8,9,10,38,47,-9,33
Perth Glory,2248,8,10,2,15,37,50,-13,32
Wellington P,2248,9,5,6,16,31,55,-24,21
CC Mariners,2248,10,4,8,15,28,49,-21,20
Sydney FC,2249,1,20,5,3,64,22,42,65
N'castle Jet,2249,2,16,5,7,59,38,21,53
Melbourne C,2249,3,14,4,11,44,35,9,46
Melbourne V,2249,4,13,6,10,45,38,7,45
Adelaide Utd,2249,5,11,6,11,37,40,-3,39
Brisbane,2249,6,10,5,13,33,42,-9,35
Western Sydn,2249,7,8,9,10,38,47,-9,33
Perth Glory,2249,8,10,2,15,37,50,-13,32
Wellington P,2249,9,5,6,16,31,55,-24,21
CC Mariners,2249,10,4,8,15,28,49,-21,20
Sydney FC,2250,1,21,4,3,68,24,44,67
N'castle Jet,2250,2,16,5,7,59,37,22,53
Melbourne C,2250,3,14,4,11,43,35,8,46
Melbourne V,2250,4,13,5,11,47,42,5,44
Adelaide Utd,2250,5,11,6,11,37,40,-3,39
Brisbane,2250,6,10,5,13,33,42,-9,35
Western Sydn,2250,7,8,9,10,38,47,-9,33
Perth Glory,2250,8,10,2,15,37,50,-13,32
Wellington P,2250,9,5,6,16,31,55,-24,21
CC Mariners,2250,10,4,8,15,28,49,-21,20
Sydney FC,2251,1,21,4,3,67,23,44,67
N'castle Jet,2251,2,15,5,8,59,40,19,50
Melbourne C,2251,3,15,4,10,46,35,11,49
Melbourne V,2251,4,13,5,11,46,41,5,44
Adelaide Utd,2251,5,11,6,11,37,40,-3,39
Brisbane,2251,6,10,5,13,33,42,-9,35
Western Sydn,2251,7,8,9,10,38,47,-9,33
Perth Glory,2251,8,10,2,15,37,50,-13,32
Wellington P,2251,9,5,6,16,31,55,-24,21
CC Mariners,2251,10,4,8,15,28,49,-21,20
Sydney FC,2252,1,21,4,3,71,23,48,67
N'castle Jet,2252,2,15,6,7,58,38,20,51
Melbourne C,2252,3,14,5,10,44,34,10,47
Melbourne V,2252,4,13,5,11,46,45,1,44
Adelaide Utd,2252,5,11,6,11,37,40,-3,39
Brisbane,2252,6,10,5,13,33,42,-9,35
Western Sydn,2252,7,8,9,10,38,47,-9,33
Perth Glory,2252,8,10,2,15,37,50,-13,32
Wellington P,2252,9,5,6,16,31,55,-24,21
CC Mariners,2252,10,4,8,15,28,49,-21,20
Sydney FC,2253,1,21,4,3,67,23,44,67
N'castle Jet,2253,2,16,5,7,62,37,25,53
Melbourne C,2253,3,14,4,11,43,38,5,46
Melbourne V,2253,4,13,5,11,46,41,5,44
Adelaide Utd,2253,5,11,6,11,37,40,-3,39
Brisbane,2253,6,10,5,13,33,42,-9,35
Western Sydn,2253,7,8,9,10,38,47,-9,33
Perth Glory,2253,8,10,2,15,37,50,-13,32
Wellington P,2253,9,5,6,16,31,55,-24,21
CC Mariners,2253,10,4,8,15,28,49,-21,20
Sydney FC,2254,1,21,4,3,66,22,44,67
N'castle Jet,2254,2,15,6,7,57,37,20,51
Melbourne C,2254,3,14,5,10,43,33,10,47
Melbourne V,2254,4,13,5,11,45,40,5,44
Adelaide Utd,2254,5,11,6,11,37,40,-3,39
Brisbane,2254,6,10,5,13,33,42,-9,35
Western Sydn,2254,7,8,9,10,38,47,-9,33
Perth Glory,2254,8,10,2,15,37,50,-13,32
Wellington P,2254,9,5,6,16,31,55,-24,21
CC Mariners,2254,10,4,8,15,28,49,-21,20
Sydney FC,2255,1,21,4,3,65,22,43,67
N'castle Jet,2255,2,15,6,7,60,40,20,51
Melbourne C,2255,3,14,5,10,46,36,10,47
Melbourne V,2255,4,13,5,11,45,39,6,44
Adelaide Utd,2255,5,11,6,11,37,40,-3,39
Brisbane,2255,6,10,5,13,33,42,-9,35
Western Sydn,2255,7,8,9,10,38,47,-9,33
Perth Glory,2255,8,10,2,15,37,50,-13,32
Wellington P,2255,9,5,6,16,31,55,-24,21
CC Mariners,2255,10,4,8,15,28,49,-21,20
Sydney FC,2256,1,21,4,3,67,22,45,67
N'castle Jet,2256,2,15,6,7,57,37,20,51
Melbourne C,2256,3,14,5,10,43,33,10,47
Melbourne V,2256,4,13,5,11,45,41,4,44
Adelaide Utd,2256,5,11,6,11,37,40,-3,39
Brisbane,2256,6,10,5,13,33,42,-9,35
Western Sydn,2256,7,8,9,10,38,47,-9,33
Perth Glory,2256,8,10,2,15,37,50,-13,32
Wellington P,2256,9,5,6,16,31,55,-24,21
CC Mariners,2256,10,4,8,15,28,49,-21,20
Sydney FC,2257,1,21,4,3,66,22,44,67
N'castle Jet,2257,2,16,5,7,59,38,21,53
Melbourne C,2257,3,14,4,11,44,35,9,46
Melbourne V,2257,4,13,5,11,45,40,5,44
Adelaide Utd,2257,5,11,6,11,37,40,-3,39
Brisbane,2257,6,10,5,13,33,42,-9,35
Western Sydn,2257,7,8,9,10,38,47,-9,33
Perth Glory,2257,8,10,2,15,37,50,-13,32
Wellington P,2257,9,5,6,16,31,55,-24,21
CC Mariners,2257,10,4,8,15,28,49,-21,20
Sydney FC,2258,1,20,4,4,66,26,40,64
N'castle Jet,2258,2,16,5,7,59,38,21,53
Melbourne V,2258,3,14,5,10,49,40,9,47
Melbourne C,2258,4,14,4,11,44,35,9,46
Adelaide Utd,2258,5,11,6,11,37,40,-3,39
Brisbane,2258,6,10,5,13,33,42,-9,35
Western Sydn,2258,7,8,9,10,38,47,-9,33
Perth Glory,2258,8,10,2,15,37,50,-13,32
Wellington P,2258,9,5,6,16,31,55,-24,21
CC Mariners,2258,10,4,8,15,28,49,-21,20
Sydney FC,2259,1,21,4,3,67,22,45,67
N'castle Jet,2259,2,15,5,8,59,41,18,50
Melbourne C,2259,3,15,4,10,47,35,12,49
Melbourne V,2259,4,13,5,11,45,41,4,44
Adelaide Utd,2259,5,11,6,11,37,40,-3,39
Brisbane,2259,6,10,5,13,33,42,-9,35
Western Sydn,2259,7,8,9,10,38,47,-9,33
Perth Glory,2259,8,10,2,15,37,50,-13,32
Wellington P,2259,9,5,6,16,31,55,-24,21
CC Mariners,2259,10,4,8,15,28,49,-21,20
Sydney FC,2260,1,21,4,3,65,22,43,67
N'castle Jet,2260,2,16,5,7,60,37,23,53
Melbourne C,2260,3,14,4,11,43,36,7,46
Melbourne V,2260,4,13,5,11,45,39,6,44
Adelaide Utd,2260,5,11,6,11,37,40,-3,39
Brisbane,2260,6,10,5,13,33,42,-9,35
Western Sydn,2260,7,8,9,10,38,47,-9,33
Perth Glory,2260,8,10,2,15,37,50,-13,32
Wellington P,2260,9,5,6,16,31,55,-24,21
CC Mariners,2260,10,4,8,15,28,49,-21,20
Sydney FC,2261,1,21,4,3,67,22,45,67
N'castle Jet,2261,2,16,5,7,58,37,21,53
Melbourne C,2261,3,14,4,11,43,34,9,46
Melbourne V,2261,4,13,5,11,45,41,4,44
Adelaide Utd,2261,5,11,6,11,37,40,-3,39
Brisbane,2261,6,10,5,13,33,42,-9,35
Western Sydn,2261,7,8,9,10,38,47,-9,33
Perth Glory,2261,8,10,2,15,37,50,-13,32
Wellington P,2261,9,5,6,16,31,55,-24,21
CC Mariners,2261,10,4,8,15,28,49,-21,20
Sydney FC,2262,1,21,4,3,68,23,45,67
N'castle Jet,2262,2,16,5,7,61,37,24,53
Melbourne C,2262,3,14,4,11,43,37,6,46
Melbourne V,2262,4,13,5,11,46,42,4,44
Adelaide Utd,2262,5,11,6,11,37,40,-3,39
Brisbane,2262,6,10,5,13,33,42,-9,35
Western Sydn,2262,7,8,9,10,38,47,-9,33
Perth Glory,2262,8,10,2,15,37,50,-13,32
Wellington P,2262,9,5,6,16,31,55,-24,21
CC Mariners,2262,10,4,8,15,28,49,-21,20
Sydney FC,2263,1,20,5,3,65,23,42,65
N'castle Jet,2263,2,16,5,7,60,38,22,53
Melbourne C,2263,3,14,4,11,44,36,8,46
Melbourne V,2263,4,13,6,10,46,39,7,45
Adelaide Utd,2263,5,11,6,11,37,40,-3,39
Brisbane,2263,6,10,5,13,33,42,-9,35
Western Sydn,2263,7,8,9,10,38,47,-9,33
Perth Glory,2263,8,10,2,15,37,50,-13,32
Wellington P,2263,9,5,6,16,31,55,-24,21
CC Mariners,2263,10,4,8,15,28,49,-21,20
Sydney FC,2264,1,20,4,4,65,25,40,64
N'castle Jet,2264,2,16,5,7,60,38,22,53
Melbourne V,2264,3,14,5,10,48,39,9,47
Melbourne C,2264,4,14,4,11,44,36,8,46
Adelaide Utd,2264,5,11,6,11,37,40,-3,39
Brisbane,2264,6,10,5,13,33,42,-9,35
Western Sydn,2264,7,8,9,10,38,47,-9,33
Perth Glory,2264,8,10,2,15,37,50,-13,32
Wellington P,2264,9,5,6,16,31,55,-24,21
CC Mariners,2264,10,4,8,15,28,49,-21,20
Sydney FC,2265,1,20,5,3,65,23,42,65
N'castle Jet,2265,2,16,5,7,60,38,22,53
Melbourne C,2265,3,14,4,11,44,36,8,46
Melbourne V,2265,4,13,6,10,46,39,7,45
Adelaide Utd,2265,5,11,6,11,37,40,-3,39
Brisbane,2265,6,10,5,13,33,42,-9,35
Western Sydn,2265,7,8,9,10,38,47,-9,33
Perth Glory,2265,8,10,2,15,37,50,-13,32
Wellington P,2265,9,5,6,16,31,55,-24,21
CC Mariners,2265,10,4,8,15,28,49,-21,20
Sydney FC,2266,1,21,4,3,67,22,45,67
N'castle Jet,2266,2,16,5,7,61,37,24,53
Melbourne C,2266,3,14,4,11,43,37,6,46
Melbourne V,2266,4,13,5,11,45,41,4,44
Adelaide Utd,2266,5,11,6,11,37,40,-3,39
Brisbane,2266,6,10,5,13,33,42,-9,35
Western Sydn,2266,7,8,9,10,38,47,-9,33
Perth Glory,2266,8,10,2,15,37,50,-13,32
Wellington P,2266,9,5,6,16,31,55,-24,21
CC Mariners,2266,10,4,8,15,28,49,-21,20
Sydney FC,2267,1,21,4,3,67,23,44,67
N'castle Jet,2267,2,16,5,7,59,37,22,53
Melbourne C,2267,3,14,4,11,43,35,8,46
Melbourne V,2267,4,13,5,11,46,41,5,44
Adelaide Utd,2267,5,11,6,11,37,40,-3,39
Brisbane,2267,6,10,5,13,33,42,-9,35
Western Sydn,2267,7,8,9,10,38,47,-9,33
Perth Glory,2267,8,10,2,15,37,50,-13,32
Wellington P,2267,9,5,6,16,31,55,-24,21
CC Mariners,2267,10,4,8,15,28,49,-21,20
Sydney FC,2268,1,21,4,3,67,23,44,67
N'castle Jet,2268,2,15,6,7,59,39,20,51
Melbourne C,2268,3,14,5,10,45,35,10,47
Melbourne V,2268,4,13,5,11,46,41,5,44
Adelaide Utd,2268,5,11,6,11,37,40,-3,39
Brisbane,2268,6,10,5,13,33,42,-9,35
Western Sydn,2268,7,8,9,10,38,47,-9,33
Perth Glory,2268,8,10,2,15,37,50,-13,32
Wellington P,2268,9,5,6,16,31,55,-24,21
CC Mariners,2268,10,4,8,15,28,49,-21,20
Sydney FC,2269,1,20,5,3,64,22,42,65
N'castle Jet,2269,2,15,5,8,58,40,18,50
Melbourne C,2269,3,15,4,10,46,34,12,49
Melbourne V,2269,4,13,6,10,45,38,7,45
Adelaide Utd,2269,5,11,6,11,37,40,-3,39
Brisbane,2269,6,10,5,13,33,42,-9,35
Western Sydn,2269,7,8,9,10,38,47,-9,33
Perth Glory,2269,8,10,2,15,37,50,-13,32
Wellington P,2269,9,5,6,16,31,55,-24,21
CC Mariners,2269,10,4,8,15,28,49,-21,20
Sydney FC,2270,1,21,4,3,67,22,45,67
N'castle Jet,2270,2,15,6,7,58,38,20,51
Melbourne C,2270,3,14,5,10,44,34,10,47
Melbourne V,2270,4,13,5,11,45,41,4,44
Adelaide Utd,2270,5,11,6,11,37,40,-3,39
Brisbane,2270,6,10,5,13,33,42,-9,35
Western Sydn,2270,7,8,9,10,38,47,-9,33
Perth Glory,2270,8,10,2,15,37,50,-13,32
Wellington P,2270,9,5,6,16,31,55,-24,21
CC Mariners,2270,10,4,8,15,28,49,-21,20
Sydney FC,2271,1,20,4,4,65,25,40,64
N'castle Jet,2271,2,16,5,7,61,38,23,53
Melbourne V,2271,3,14,5,10,48,39,9,47
Melbourne C,2271,4,14,4,11,44,37,7,46
Adelaide Utd,2271,5,11,6,11,37,40,-3,39
Brisbane,2271,6,10,5,13,33,42,-9,35
Western Sydn,2271,7,8,9,10,38,47,-9,33
Perth Glory,2271,8,10,2,15,37,50,-13,32
Wellington P,2271,9,5,6,16,31,55,-24,21
CC Mariners,2271,10,4,8,15,28,49,-21,20
Sydney FC,2272,1,21,4,3,66,22,44,67
N'castle Jet,2272,2,15,6,7,57,37,20,51
Melbourne C,2272,3,14,5,10,43,33,10,47
Melbourne V,2272,4,13,5,11,45,40,5,44
Adelaide Utd,2272,5,11,6,11,37,40,-3,39
Brisbane,2272,6,10,5,13,33,42,-9,35
Western Sydn,2272,7,8,9,10,38,47,-9,33
Perth Glory,2272,8,10,2,15,37,50,-13,32
Wellington P,2272,9,5,6,16,31,55,-24,21
CC Mariners,2272,10,4,8,15,28,49,-21,20
Sydney FC,2273,1,21,4,3,68,22,46,67
N'castle Jet,2273,2,15,6,7,60,40,20,51
Melbourne C,2273,3,14,5,10,46,36,10,47
Melbourne V,2273,4,13,5,11,45,42,3,44
Adelaide Utd,2273,5,11,6,11,37,40,-3,39
Brisbane,2273,6,10,5,13,33,42,-9,35
Western Sydn,2273,7,8,9,10,38,47,-9,33
Perth Glory,2273,8,10,2,15,37,50,-13,32
Wellington P,2273,9,5,6,16,31,55,-24,21
CC Mariners,2273,10,4,8,15,28,49,-21,20
Sydney FC,2274,1,21,4,3,66,22,44,67
N'castle Jet,2274,2,15,6,7,57,37,20,51
Melbourne C,2274,3,14,5,10,43,33,10,47
Melbourne V,2274,4,13,5,11,45,40,5,44
Adelaide Utd,2274,5,11,6,11,37,40,-3,39
Brisbane,2274,6,10,5,13,33,42,-9,35
Western Sydn,2274,7,8,9,10,38,47,-9,33
Perth Glory,2274,8,10,2,15,37,50,-13,32
Wellington P,2274,9,5,6,16,31,55,-24,21
CC Mariners,2274,10,4,8,15,28,49,-21,20
Sydney FC,2275,1,20,5,3,64,22,42,65
N'castle Jet,2275,2,15,6,7,59,39,20,51
Melbourne C,2275,3,14,5,10,45,35,10,47
Melbourne V,2275,4,13,6,10,45,38,7,45
Adelaide Utd,2275,5,11,6,11,37,40,-3,39
Brisbane,2275,6,10,5,13,33,42,-9,35
Western Sydn,2275,7,8,9,10,38,47,-9,33
Perth Glory,2275,8,10,2,15,37,50,-13,32
Wellington P,2275,9,5,6,16,31,55,-24,21
CC Mariners,2275,10,4,8,15,28,49,-21,20
Sydney FC,2276,1,20,5,3,65,23,42,65
N'castle Jet,2276,2,15,5,8,59,40,19,50
Melbourne C,2276,3,15,4,10,46,35,11,49
Melbourne V,2276,4,13,6,10,46,39,7,45
Adelaide Utd,2276,5,11,6,11,37,40,-3,39
Brisbane,2276,6,10,5,13,33,42,-9,35
Western Sydn,2276,7,8,9,10,38,47,-9,33
Perth Glory,2276,8,10,2,15,37,50,-13,32
Wellington P,2276,9,5,6,16,31,55,-24,21
CC Mariners,2276,10,4,8,15,28,49,-21,20
Sydney FC,2277,1,21,4,3,66,23,43,67
N'castle Jet,2277,2,15,6,7,57,37,20,51
Melbourne C,2277,3,14,5,10,43,33,10,47
Melbourne V,2277,4,13,5,11,46,40,6,44
Adelaide Utd,2277,5,11,6,11,37,40,-3,39
Brisbane,2277,6,10,5,13,33,42,-9,35
Western Sydn,2277,7,8,9,10,38,47,-9,33
Perth Glory,2277,8,10,2,15,37,50,-13,32
Wellington P,2277,9,5,6,16,31,55,-24,21
CC Mariners,2277,10,4,8,15,28,49,-21,20
Sydney FC,2278,1,21,4,3,67,22,45,67
N'castle Jet,2278,2,16,5,7,61,40,21,53
Melbourne C,2278,3,14,4,11,46,37,9,46
Melbourne V,2278,4,13,5,11,45,41,4,44
Adelaide Utd,2278,5,11,6,11,37,40,-3,39
Brisbane,2278,6,10,5,13,33,42,-9,35
Western Sydn,2278,7,8,9,10,38,47,-9,33
Perth Glory,2278,8,10,2,15,37,50,-13,32
Wellington P,2278,9,5,6,16,31,55,-24,21
CC Mariners,2278,10,4,8,15,28,49,-21,20
Sydney FC,2279,1,21,4,3,65,22,43,67
N'castle Jet,2279,2,16,5,7,59,37,22,53
Melbourne C,2279,3,14,4,11,43,35,8,46
Melbourne V,2279,4,13,5,11,45,39,6,44
Adelaide Utd,2279,5,11,6,11,37,40,-3,39
Brisbane,2279,6,10,5,13,33,42,-9,35
Western Sydn,2279,7,8,9,10,38,47,-9,33
Perth Glory,2279,8,10,2,15,37,50,-13,32
Wellington P,2279,9,5,6,16,31,55,-24,21
CC Mariners,2279,10,4,8,15,28,49,-21,20
Sydney FC,2280,1,20,5,3,65,23,42,65
N'castle Jet,2280,2,15,6,7,60,40,20,51
Melbourne C,2280,3,14,5,10,46,36,10,47
Melbourne V,2280,4,13,6,10,46,39,7,45
Adelaide Utd,2280,5,11,6,11,37,40,-3,39
Brisbane,2280,6,10,5,13,33,42,-9,35
Western Sydn,2280,7,8,9,10,38,47,-9,33
Perth Glory,2280,8,10,2,15,37,50,-13,32
Wellington P,2280,9,5,6,16,31,55,-24,21
CC Mariners,2280,10,4,8,15,28,49,-21,20
Sydney FC,2281,1,20,5,3,66,24,42,65
N'castle Jet,2281,2,16,5,7,60,38,22,53
Melbourne C,2281,3,14,4,11,44,36,8,46
Melbourne V,2281,4,13,6,10,47,40,7,45
Adelaide Utd,2281,5,11,6,11,37,40,-3,39
Brisbane,2281,6,10,5,13,33,42,-9,35
Western Sydn,2281,7,8,9,10,38,47,-9,33
Perth Glory,2281,8,10,2,15,37,50,-13,32
Wellington P,2281,9,5,6,16,31,55,-24,21
CC Mariners,2281,10,4,8,15,28,49,-21,20
Sydney FC,2282,1,20,5,3,65,23,42,65
N'castle Jet,2282,2,16,5,7,59,37,22,53
Melbourne C,2282,3,14,4,11,43,35,8,46
Melbourne V,2282,4,13,6,10,46,39,7,45
Adelaide Utd,2282,5,11,6,11,37,40,-3,39
Brisbane,2282,6,10,5,13,33,42,-9,35
Western Sydn,2282,7,8,9,10,38,47,-9,33
Perth Glory,2282,8,10,2,15,37,50,-13,32
Wellington P,2282,9,5,6,16,31,55,-24,21
CC Mariners,2282,10,4,8,15,28,49,-21,20
Sydney FC,2283,1,20,4,4,66,25,41,64
N'castle Jet,2283,2,15,5,8,58,39,19,50
Melbourne C,2283,3,15,4,10,45,34,11,49
Melbourne V,2283,4,14,5,10,48,40,8,47
Adelaide Utd,2283,5,11,6,11,37,40,-3,39
Brisbane,2283,6,10,5,13,33,42,-9,35
Western Sydn,2283,7,8,9,10,38,47,-9,33
Perth Glory,2283,8,10,2,15,37,50,-13,32
Wellington P,2283,9,5,6,16,31,55,-24,21
CC Mariners,2283,10,4,8,15,28,49,-21,20
Sydney FC,2284,1,21,4,3,65,22,43,67
N'castle Jet,2284,2,15,6,7,59,39,20,51
Melbourne C,2284,3,14,5,10,45,35,10,47
Melbourne V,2284,4,13,5,11,45,39,6,44
Adelaide Utd,2284,5,11,6,11,37,40,-3,39
Brisbane,2284,6,10,5,13,33,42,-9,35
Western Sydn,2284,7,8,9,10,38,47,-9,33
Perth Glory,2284,8,10,2,15,37,50,-13,32
Wellington P,2284,9,5,6,16,31,55,-24,21
CC Mariners,2284,10,4,8,15,28,49,-21,20
Sydney FC,2285,1,21,4,3,65,22,43,67
N'castle Jet,2285,2,16,5,7,60,39,21,53
Melbourne C,2285,3,14,4,11,45,36,9,46
Melbourne V,2285,4,13,5,11,45,39,6,44
Adelaide Utd,2285,5,11,6,11,37,40,-3,39
Brisbane,2285,6,10,5,13,33,42,-9,35
Western Sydn,2285,7,8,9,10,38,47,-9,33
Perth Glory,2285,8,10,2,15,37,50,-13,32
Wellington P,2285,9,5,6,16,31,55,-24,21
CC Mariners,2285,10,4,8,15,28,49,-21,20
Sydney FC,2286,1,21,4,3,68,23,45,67
N'castle Jet,2286,2,16,5,7,59,37,22,53
Melbourne C,2286,3,14,4,11,43,35,8,46
Melbourne V,2286,4,13,5,11,46,42,4,44
Adelaide Utd,2286,5,11,6,11,37,40,-3,39
Brisbane,2286,6,10,5,13,33,42,-9,35
Western Sydn,2286,7,8,9,10,38,47,-9,33
Perth Glory,2286,8,10,2,15,37,50,-13,32
Wellington P,2286,9,5,6,16,31,55,-24,21
CC Mariners,2286,10,4,8,15,28,49,-21,20
Sydney FC,2287,1,21,4,3,67,22,45,67
N'castle Jet,2287,2,16,5,7,58,37,21,53
Melbourne C,2287,3,14,4,11,43,34,9,46
Melbourne V,2287,4,13,5,11,45,41,4,44
Adelaide Utd,2287,5,11,6,11,37,40,-3,39
Brisbane,2287,6,10,5,13,33,42,-9,35
Western Sydn,2287,7,8,9,10,38,47,-9,33
Perth Glory,2287,8,10,2,15,37,50,-13,32
Wellington P,2287,9,5,6,16,31,55,-24,21
CC Mariners,2287,10,4,8,15,28,49,-21,20
Sydney FC,2288,1,21,4,3,67,22,45,67
N'castle Jet,2288,2,15,5,8,60,42,18,50
Melbourne C,2288,3,15,4,10,48,36,12,49
Melbourne V,2288,4,13,5,11,45,41,4,44
Adelaide Utd,2288,5,11,6,11,37,40,-3,39
Brisbane,2288,6,10,5,13,33,42,-9,35
Western Sydn,2288,7,8,9,10,38,47,-9,33
Perth Glory,2288,8,10,2,15,37,50,-13,32
Wellington P,2288,9,5,6,16,31,55,-24,21
CC Mariners,2288,10,4,8,15,28,49,-21,20
Sydney FC,2289,1,21,4,3,68,23,45,67
N'castle Jet,2289,2,15,6,7,58,38,20,51
Melbourne C,2289,3,14,5,10,44,34,10,47
Melbourne V,2289,4,13,5,11,46,42,4,44
Adelaide Utd,2289,5,11,6,11,37,40,-3,39
Brisbane,2289,6,10,5,13,33,42,-9,35
Western Sydn,2289,7,8,9,10,38,47,-9,33
Perth Glory,2289,8,10,2,15,37,50,-13,32
Wellington P,2289,9,5,6,16,31,55,-24,21
CC Mariners,2289,10,4,8,15,28,49,-21,20
Sydney FC,2290,1,21,4,3,67,22,45,67
N'castle Jet,2290,2,16,5,7,61,38,23,53
Melbourne C,2290,3,14,4,11,44,37,7,46
Melbourne V,2290,4,13,5,11,45,41,4,44
Adelaide Utd,2290,5,11,6,11,37,40,-3,39
Brisbane,2290,6,10,5,13,33,42,-9,35
Western Sydn,2290,7,8,9,10,38,47,-9,33
Perth Glory,2290,8,10,2,15,37,50,-13,32
Wellington P,2290,9,5,6,16,31,55,-24,21
CC Mariners,2290,10,4,8,15,28,49,-21,20
Sydney FC,2291,1,21,4,3,67,23,44,67
N'castle Jet,2291,2,15,6,7,58,38,20,51
Melbourne C,2291,3,14,5,10,44,34,10,47
Melbourne V,2291,4,13,5,11,46,41,5,44
Adelaide Utd,2291,5,11,6,11,37,40,-3,39
Brisbane,2291,6,10,5,13,33,42,-9,35
Western Sydn,2291,7,8,9,10,38,47,-9,33
Perth Glory,2291,8,10,2,15,37,50,-13,32
Wellington P,2291,9,5,6,16,31,55,-24,21
CC Mariners,2291,10,4,8,15,28,49,-21,20
Sydney FC,2292,1,20,5,3,65,23,42,65
N'castle Jet,2292,2,15,5,8,58,39,19,50
Melbourne C,2292,3,15,4,10,45,34,11,49
Melbourne V,2292,4,13,6,10,46,39,7,45
Adelaide Utd,2292,5,11,6,11,37,40,-3,39
Brisbane,2292,6,10,5,13,33,42,-9,35
Western Sydn,2292,7,8,9,10,38,47,-9,33
Perth Glory,2292,8,10,2,15,37,50,-13,32
Wellington P,2292,9,5,6,16,31,55,-24,21
CC Mariners,2292,10,4,8,15,28,49,-21,20
Sydney FC,2293,1,21,4,3,68,24,44,67
N'castle Jet,2293,2,16,5,7,61,37,24,53
Melbourne C,2293,3,14,4,11,43,37,6,46
Melbourne V,2293,4,13,5,11,47,42,5,44
Adelaide Utd,2293,5,11,6,11,37,40,-3,39
Brisbane,2293,6,10,5,13,33,42,-9,35
Western Sydn,2293,7,8,9,10,38,47,-9,33
Perth Glory,2293,8,10,2,15,37,50,-13,32
Wellington P,2293,9,5,6,16,31,55,-24,21
CC Mariners,2293,10,4,8,15,28,49,-21,20
Sydney FC,2294,1,21,4,3,67,23,44,67
N'castle Jet,2294,2,16,5,7,61,39,22,53
Melbourne C,2294,3,14,4,11,45,37,8,46
Melbourne V,2294,4,13,5,11,46,41,5,44
Adelaide Utd,2294,5,11,6,11,37,40,-3,39
Brisbane,2294,6,10,5,13,33,42,-9,35
Western Sydn,2294,7,8,9,10,38,47,-9,33
Perth Glory,2294,8,10,2,15,37,50,-13,32
Wellington P,2294,9,5,6,16,31,55,-24,21
CC Mariners,2294,10,4,8,15,28,49,-21,20
Sydney FC,2295,1,20,4,4,65,24,41,64
N'castle Jet,2295,2,16,5,7,60,39,21,53
Melbourne V,2295,3,14,5,10,47,39,8,47
Melbourne C,2295,4,14,4,11,45,36,9,46
Adelaide Utd,2295,5,11,6,11,37,40,-3,39
Brisbane,2295,6,10,5,13,33,42,-9,35
Western Sydn,2295,7,8,9,10,38,47,-9,33
Perth Glory,2295,8,10,2,15,37,50,-13,32
Wellington P,2295,9,5,6,16,31,55,-24,21
CC Mariners,2295,10,4,8,15,28,49,-21,20
Sydney FC,2296,1,21,4,3,67,23,44,67
N'castle Jet,2296,2,16,5,7,62,37,25,53
Melbourne C,2296,3,14,4,11,43,38,5,46
Melbourne V,2296,4,13,5,11,46,41,5,44
Adelaide Utd,2296,5,11,6,11,37,40,-3,39
Brisbane,2296,6,10,5,13,33,42,-9,35
Western Sydn,2296,7,8,9,10,38,47,-9,33
Perth Glory,2296,8,10,2,15,37,50,-13,32
Wellington P,2296,9,5,6,16,31,55,-24,21
CC Mariners,2296,10,4,8,15,28,49,-21,20
Sydney FC,2297,1,20,4,4,64,23,41,64
N'castle Jet,2297,2,15,6,7,58,38,20,51
Melbourne C,2297,3,14,5,10,44,34,10,47
Melbourne V,2297,4,14,5,10,46,38,8,47
Adelaide Utd,2297,5,11,6,11,37,40,-3,39
Brisbane,2297,6,10,5,13,33,42,-9,35
Western Sydn,2297,7,8,9,10,38,47,-9,33
Perth Glory,2297,8,10,2,15,37,50,-13,32
Wellington P,2297,9,5,6,16,31,55,-24,21
CC Mariners,2297,10,4,8,15,28,49,-21,20
Sydney FC,2298,1,21,4,3,67,23,44,67
N'castle Jet,2298,2,16,5,7,59,38,21,53
Melbourne C,2298,3,14,4,11,44,35,9,46
Melbourne V,2298,4,13,5,11,46,41,5,44
Adelaide Utd,2298,5,11,6,11,37,40,-3,39
Brisbane,2298,6,10,5,13,33,42,-9,35
Western Sydn,2298,7,8,9,10,38,47,-9,33
Perth Glory,2298,8,10,2,15,37,50,-13,32
Wellington P,2298,9,5,6,16,31,55,-24,21
CC Mariners,2298,10,4,8,15,28,49,-21,20
Sydney FC,2299,1,21,4,3,66,22,44,67
N'castle Jet,2299,2,16,5,7,60,39,21,53
Melbourne C,2299,3,14,4,11,45,36,9,46
Melbourne V,2299,4,13,5,11,45,40,5,44
Adelaide Utd,2299,5,11,6,11,37,40,-3,39
Brisbane,2299,6,10,5,13,33,42,-9,35
Western Sydn,2299,7,8,9,10,38,47,-9,33
Perth Glory,2299,8,10,2,15,37,50,-13,32
Wellington P,2299,9,5,6,16,31,55,-24,21
CC Mariners,2299,10,4,8,15,28,49,-21,20
Sydney FC,2300,1,21,4,3,66,22,44,67
N'castle Jet,2300,2,15,5,8,58,40,18,50
Melbourne C,2300,3,15,4,10,46,34,12,49
Melbourne V,2300,4,13,5,11,45,40,5,44
Adelaide Utd,2300,5,11,6,11,37,40,-3,39
Brisbane,2300,6,10,5,13,33,42,-9,35
Western Sydn,2300,7,8,9,10,38,47,-9,33
Perth Glory,2300,8,10,2,15,37,50,-13,32
Wellington P,2300,9,5,6,16,31,55,-24,21
CC Mariners,2300,10,4,8,15,28,49,-21,20
Sydney FC,2301,1,20,4,4,65,27,38,64
N'castle Jet,2301,2,15,6,7,60,40,20,51
Melbourne V,2301,3,14,5,10,50,39,11,47
Melbourne C,2301,4,14,5,10,46,36,10,47
Adelaide Utd,2301,5,11,6,11,37,40,-3,39
Brisbane,2301,6,10,5,13,33,42,-9,35
Western Sydn,2301,7,8,9,10,38,47,-9,33
Perth Glory,2301,8,10,2,15,37,50,-13,32
Wellington P,2301,9,5,6,16,31,55,-24,21
CC Mariners,2301,10,4,8,15,28,49,-21,20
Sydney FC,2302,1,21,4,3,68,25,43,67
N'castle Jet,2302,2,15,5,8,58,39,19,50
Melbourne C,2302,3,15,4,10,45,34,11,49
Melbourne V,2302,4,13,5,11,48,42,6,44
Adelaide Utd,2302,5,11,6,11,37,40,-3,39
Brisbane,2302,6,10,5,13,33,42,-9,35
Western Sydn,2302,7,8,9,10,38,47,-9,33
Perth Glory,2302,8,10,2,15,37,50,-13,32
Wellington P,2302,9,5,6,16,31,55,-24,21
CC Mariners,2302,10,4,8,15,28,49,-21,20
Sydney FC,2303,1,20,4,4,64,23,41,64
N'castle Jet,2303,2,15,5,8,57,38,19,50
Melbourne C,2303,3,15,4,10,44,33,11,49
Melbourne V,2303,4,14,5,10,46,38,8,47
Adelaide Utd,2303,5,11,6,11,37,40,-3,39
Brisbane,2303,6,10,5,13,33,42,-9,35
Western Sydn,2303,7,8,9,10,38,47,-9,33
Perth Glory,2303,8,10,2,15,37,50,-13,32
Wellington P,2303,9,5,6,16,31,55,-24,21
CC Mariners,2303,10,4,8,15,28,49,-21,20
Sydney FC,2304,1,20,5,3,66,24,42,65
N'castle Jet,2304,2,16,5,7,59,37,22,53
Melbourne C,2304,3,14,4,11,43,35,8,46
Melbourne V,2304,4,13,6,10,47,40,7,45
Adelaide Utd,2304,5,11,6,11,37,40,-3,39
Brisbane,2304,6,10,5,13,33,42,-9,35
Western Sydn,2304,7,8,9,10,38,47,-9,33
Perth Glory,2304,8,10,2,15,37,50,-13,32
Wellington P,2304,9,5,6,16,31,55,-24,21
CC Mariners,2304,10,4,8,15,28,49,-21,20
Sydney FC,2305,1,21,4,3,68,24,44,67
N'castle Jet,2305,2,16,5,7,58,37,21,53
Melbourne C,2305,3,14,4,11,43,34,9,46
Melbourne V,2305,4,13,5,11,47,42,5,44
Adelaide Utd,2305,5,11,6,11,37,40,-3,39
Brisbane,2305,6,10,5,13,33,42,-9,35
Western Sydn,2305,7,8,9,10,38,47,-9,33
Perth Glory,2305,8,10,2,15,37,50,-13,32
Wellington P,2305,9,5,6,16,31,55,-24,21
CC Mariners,2305,10,4,8,15,28,49,-21,20
Sydney FC,2306,1,21,4,3,66,22,44,67
N'castle Jet,2306,2,15,6,7,59,39,20,51
Melbourne C,2306,3,14,5,10,45,35,10,47
Melbourne V,2306,4,13,5,11,45,40,5,44
Adelaide Utd,2306,5,11,6,11,37,40,-3,39
Brisbane,2306,6,10,5,13,33,42,-9,35
Western Sydn,2306,7,8,9,10,38,47,-9,33
Perth Glory,2306,8,10,2,15,37,50,-13,32
Wellington P,2306,9,5,6,16,31,55,-24,21
CC Mariners,2306,10,4,8,15,28,49,-21,20
Sydney FC,2307,1,21,4,3,66,23,43,67
N'castle Jet,2307,2,16,5,7,59,37,22,53
Melbourne C,2307,3,14,4,11,43,35,8,46
Melbourne V,2307,4,13,5,11,46,40,6,44
Adelaide Utd,2307,5,11,6,11,37,40,-3,39
Brisbane,2307,6,10,5,13,33,42,-9,35
Western Sydn,2307,7,8,9,10,38,47,-9,33
Perth Glory,2307,8,10,2,15,37,50,-13,32
Wellington P,2307,9,5,6,16,31,55,-24,21
CC Mariners,2307,10,4,8,15,28,49,-21,20
Sydney FC,2308,1,21,4,3,66,23,43,67
N'castle Jet,2308,2,15,5,8,58,40,18,50
Melbourne C,2308,3,15,4,10,46,34,12,49
Melbourne V,2308,4,13,5,11,46,40,6,44
Adelaide Utd,2308,5,11,6,11,37,40,-3,39
Brisbane,2308,6,10,5,13,33,42,-9,35
Western Sydn,2308,7,8,9,10,38,47,-9,33
Perth Glory,2308,8,10,2,15,37,50,-13,32
Wellington P,2308,9,5,6,16,31,55,-24,21
CC Mariners,2308,10,4,8,15,28,49,-21,20
Sydney FC,2309,1,21,4,3,66,23,43,67
N'castle Jet,2309,2,16,5,7,59,37,22,53
Melbourne C,2309,3,14,4,11,43,35,8,46
Melbourne V,2309,4,13,5,11,46,40,6,44
Adelaide Utd,2309,5,11,6,11,37,40,-3,39
Brisbane,2309,6,10,5,13,33,42,-9,35
Western Sydn,2309,7,8,9,10,38,47,-9,33
Perth Glory,2309,8,10,2,15,37,50,-13,32
Wellington P,2309,9,5,6,16,31,55,-24,21
CC Mariners,2309,10,4,8,15,28,49,-21,20
Sydney FC,2310,1,21,4,3,68,22,46,67
N'castle Jet,2310,2,16,5,7,58,37,21,53
Melbourne C,2310,3,14,4,11,43,34,9,46
Melbourne V,2310,4,13,5,11,45,42,3,44
Adelaide Utd,2310,5,11,6,11,37,40,-3,39
Brisbane,2310,6,10,5,13,33,42,-9,35
Western Sydn,2310,7,8,9,10,38,47,-9,33
Perth Glory,2310,8,10,2,15,37,50,-13,32
Wellington P,2310,9,5,6,16,31,55,-24,21
CC Mariners,2310,10,4,8,15,28,49,-21,20
Sydney FC,2311,1,20,4,4,66,26,40,64
N'castle Jet,2311,2,15,5,8,59,40,19,50
Melbourne C,2311,3,15,4,10,46,35,11,49
Melbourne V,2311,4,14,5,10,49,40,9,47
Adelaide Utd,2311,5,11,6,11,37,40,-3,39
Brisbane,2311,6,10,5,13,33,42,-9,35
Western Sydn,2311,7,8,9,10,38,47,-9,33
Perth Glory,2311,8,10,2,15,37,50,-13,32
Wellington P,2311,9,5,6,16,31,55,-24,21
CC Mariners,2311,10,4,8,15,28,49,-21,20
Sydney FC,2312,1,20,5,3,64,22,42,65
N'castle Jet,2312,2,15,6,7,59,39,20,51
Melbourne C,2312,3,14,5,10,45,35,10,47
Melbourne V,2312,4,13,6,10,45,38,7,45
Adelaide Utd,2312,5,11,6,11,37,40,-3,39
Brisbane,2312,6,10,5,13,33,42,-9,35
Western Sydn,2312,7,8,9,10,38,47,-9,33
Perth Glory,2312,8,10,2,15,37,50,-13,32
Wellington P,2312,9,5,6,16,31,55,-24,21
CC Mariners,2312,10,4,8,15,28,49,-21,20
Sydney FC,2313,1,21,4,3,66,23,43,67
N'castle Jet,2313,2,15,5,8,59,41,18,50
Melbourne C,2313,3,15,4,10,47,35,12,49
Melbourne V,2313,4,13,5,11,46,40,6,44
Adelaide Utd,2313,5,11,6,11,37,40,-3,39
Brisbane,2313,6,10,5,13,33,42,-9,35
Western Sydn,2313,7,8,9,10,38,47,-9,33
Perth Glory,2313,8,10,2,15,37,50,-13,32
Wellington P,2313,9,5,6,16,31,55,-24,21
CC Mariners,2313,10,4,8,15,28,49,-21,20
Sydney FC,2314,1,20,5,3,67,25,42,65
N'castle Jet,2314,2,15,5,8,58,39,19,50
Melbourne C,2314,3,15,4,10,45,34,11,49
Melbourne V,2314,4,13,6,10,48,41,7,45
Adelaide Utd,2314,5,11,6,11,37,40,-3,39
Brisbane,2314,6,10,5,13,33,42,-9,35
Western Sydn,2314,7,8,9,10,38,47,-9,33
Perth Glory,2314,8,10,2,15,37,50,-13,32
Wellington P,2314,9,5,6,16,31,55,-24,21
CC Mariners,2314,10,4,8,15,28,49,-21,20
Sydney FC,2315,1,21,4,3,67,22,45,67
N'castle Jet,2315,2,15,5,8,58,39,19,50
Melbourne C,2315,3,15,4,10,45,34,11,49
Melbourne V,2315,4,13,5,11,45,41,4,44
Adelaide Utd,2315,5,11,6,11,37,40,-3,39
Brisbane,2315,6,10,5,13,33,42,-9,35
Western Sydn,2315,7,8,9,10,38,47,-9,33
Perth Glory,2315,8,10,2,15,37,50,-13,32
Wellington P,2315,9,5,6,16,31,55,-24,21
CC Mariners,2315,10,4,8,15,28,49,-21,20
Sydney FC,2316,1,21,4,3,67,24,43,67
N'castle Jet,2316,2,15,6,7,59,39,20,51
Melbourne C,2316,3,14,5,10,45,35,10,47
Melbourne V,2316,4,13,5,11,47,41,6,44
Adelaide Utd,2316,5,11,6,11,37,40,-3,39
Brisbane,2316,6,10,5,13,33,42,-9,35
Western Sydn,2316,7,8,9,10,38,47,-9,33
Perth Glory,2316,8,10,2,15,37,50,-13,32
Wellington P,2316,9,5,6,16,31,55,-24,21
CC Mariners,2316,10,4,8,15,28,49,-21,20
Sydney FC,2317,1,20,5,3,68,26,42,65
N'castle Jet,2317,2,16,5,7,60,38,22,53
Melbourne C,2317,3,14,4,11,44,36,8,46
Melbourne V,2317,4,13,6,10,49,42,7,45
Adelaide Utd,2317,5,11,6,11,37,40,-3,39
Brisbane,2317,6,10,5,13,33,42,-9,35
Western Sydn,2317,7,8,9,10,38,47,-9,33
Perth Glory,2317,8,10,2,15,37,50,-13,32
Wellington P,2317,9,5,6,16,31,55,-24,21
CC Mariners,2317,10,4,8,15,28,49,-21,20
Sydney FC,2318,1,20,4,4,64,23,41,64
N'castle Jet,2318,2,16,5,7,58,37,21,53
Melbourne V,2318,3,14,5,10,46,38,8,47
Melbourne C,2318,4,14,4,11,43,34,9,46
Adelaide Utd,2318,5,11,6,11,37,40,-3,39
Brisbane,2318,6,10,5,13,33,42,-9,35
Western Sydn,2318,7,8,9,10,38,47,-9,33
Perth Glory,2318,8,10,2,15,37,50,-13,32
Wellington P,2318,9,5,6,16,31,55,-24,21
CC Mariners,2318,10,4,8,15,28,49,-21,20
Sydney FC,2319,1,20,4,4,64,24,40,64
N'castle Jet,2319,2,15,5,8,58,41,17,50
Melbourne C,2319,3,15,4,10,47,34,13,49
Melbourne V,2319,4,14,5,10,47,38,9,47
Adelaide Utd,2319,5,11,6,11,37,40,-3,39
Brisbane,2319,6,10,5,13,33,42,-9,35
Western Sydn,2319,7,8,9,10,38,47,-9,33
Perth Glory,2319,8,10,2,15,37,50,-13,32
Wellington P,2319,9,5,6,16,31,55,-24,21
CC Mariners,2319,10,4,8,15,28,49,-21,20
Sydney FC,2320,1,21,4,3,65,22,43,67
N'castle Jet,2320,2,16,5,7,60,38,22,53
Melbourne C,2320,3,14,4,11,44,36,8,46
Melbourne V,2320,4,13,5,11,45,39,6,44
Adelaide Utd,2320,5,11,6,11,37,40,-3,39
Brisbane,2320,6,10,5,13,33,42,-9,35
Western Sydn,2320,7,8,9,10,38,47,-9,33
Perth Glory,2320,8,10,2,15,37,50,-13,32
Wellington P,2320,9,5,6,16,31,55,-24,21
CC Mariners,2320,10,4,8,15,28,49,-21,20
Sydney FC,2321,1,20,5,3,65,23,42,65
N'castle Jet,2321,2,16,5,7,59,38,21,53
Melbourne C,2321,3,14,4,11,44,35,9,46
Melbourne V,2321,4,13,6,10,46,39,7,45
Adelaide Utd,2321,5,11,6,11,37,40,-3,39
Brisbane,2321,6,10,5,13,33,42,-9,35
Western Sydn,2321,7,8,9,10,38,47,-9,33
Perth Glory,2321,8,10,2,15,37,50,-13,32
Wellington P,2321,9,5,6,16,31,55,-24,21
CC Mariners,2321,10,4,8,15,28,49,-21,20
Sydney FC,2322,1,21,4,3,69,23,46,67
N'castle Jet,2322,2,16,5,7,59,37,22,53
Melbourne C,2322,3,14,4,11,43,35,8,46
Melbourne V,2322,4,13,5,11,46,43,3,44
Adelaide Utd,2322,5,11,6,11,37,40,-3,39
Brisbane,2322,6,10,5,13,33,42,-9,35
Western Sydn,2322,7,8,9,10,38,47,-9,33
Perth Glory,2322,8,10,2,15,37,50,-13,32
Wellington P,2322,9,5,6,16,31,55,-24,21
CC Mariners,2322,10,4,8,15,28,49,-21,20
Sydney FC,2323,1,21,4,3,65,22,43,67
N'castle Jet,2323,2,16,5,7,59,37,22,53
Melbourne C,2323,3,14,4,11,43,35,8,46
Melbourne V,2323,4,13,5,11,45,39,6,44
Adelaide Utd,2323,5,11,6,11,37,40,-3,39
Brisbane,2323,6,10,5,13,33,42,-9,35
Western Sydn,2323,7,8,9,10,38,47,-9,33
Perth Glory,2323,8,10,2,15,37,50,-13,32
Wellington P,2323,9,5,6,16,31,55,-24,21
CC Mariners,2323,10,4,8,15,28,49,-21,20
Sydney FC,2324,1,20,5,3,64,22,42,65
N'castle Jet,2324,2,15,6,7,59,39,20,51
Melbourne C,2324,3,14,5,10,45,35,10,47
Melbourne V,2324,4,13,6,10,45,38,7,45
Adelaide Utd,2324,5,11,6,11,37,40,-3,39
Brisbane,2324,6,10,5,13,33,42,-9,35
Western Sydn,2324,7,8,9,10,38,47,-9,33
Perth Glory,2324,8,10,2,15,37,50,-13,32
Wellington P,2324,9,5,6,16,31,55,-24,21
CC Mariners,2324,10,4,8,15,28,49,-21,20
Sydney FC,2325,1,21,4,3,66,22,44,67
N'castle Jet,2325,2,16,5,7,60,37,23,53
Melbourne C,2325,3,14,4,11,43,36,7,46
Melbourne V,2325,4,13,5,11,45,40,5,44
Adelaide Utd,2325,5,11,6,11,37,40,-3,39
Brisbane,2325,6,10,5,13,33,42,-9,35
Western Sydn,2325,7,8,9,10,38,47,-9,33
Perth Glory,2325,8,10,2,15,37,50,-13,32
Wellington P,2325,9,5,6,16,31,55,-24,21
CC Mariners,2325,10,4,8,15,28,49,-21,20
Sydney FC,2326,1,21,4,3,68,23,45,67
N'castle Jet,2326,2,15,5,8,57,38,19,50
Melbourne C,2326,3,15,4,10,44,33,11,49
Melbourne V,2326,4,13,5,11,46,42,4,44
Adelaide Utd,2326,5,11,6,11,37,40,-3,39
Brisbane,2326,6,10,5,13,33,42,-9,35
Western Sydn,2326,7,8,9,10,38,47,-9,33
Perth Glory,2326,8,10,2,15,37,50,-13,32
Wellington P,2326,9,5,6,16,31,55,-24,21
CC Mariners,2326,10,4,8,15,28,49,-21,20
Sydney FC,2327,1,21,4,3,66,23,43,67
N'castle Jet,2327,2,16,5,7,58,37,21,53
Melbourne C,2327,3,14,4,11,43,34,9,46
Melbourne V,2327,4,13,5,11,46,40,6,44
Adelaide Utd,2327,5,11,6,11,37,40,-3,39
Brisbane,2327,6,10,5,13,33,42,-9,35
Western Sydn,2327,7,8,9,10,38,47,-9,33
Perth Glory,2327,8,10,2,15,37,50,-13,32
Wellington P,2327,9,5,6,16,31,55,-24,21
CC Mariners,2327,10,4,8,15,28,49,-21,20
Sydney FC,2328,1,21,4,3,66,22,44,67
N'castle Jet,2328,2,16,5,7,60,38,22,53
Melbourne C,2328,3,14,4,11,44,36,8,46
Melbourne V,2328,4,13,5,11,45,40,5,44
Adelaide Utd,2328,5,11,6,11,37,40,-3,39
Brisbane,2328,6,10,5,13,33,42,-9,35
Western Sydn,2328,7,8,9,10,38,47,-9,33
Perth Glory,2328,8,10,2,15,37,50,-13,32
Wellington P,2328,9,5,6,16,31,55,-24,21
CC Mariners,2328,10,4,8,15,28,49,-21,20
Sydney FC,2329,1,21,4,3,67,23,44,67
N'castle Jet,2329,2,16,5,7,59,38,21,53
Melbourne C,2329,3,14,4,11,44,35,9,46
Melbourne V,2329,4,13,5,11,46,41,5,44
Adelaide Utd,2329,5,11,6,11,37,40,-3,39
Brisbane,2329,6,10,5,13,33,42,-9,35
Western Sydn,2329,7,8,9,10,38,47,-9,33
Perth Glory,2329,8,10,2,15,37,50,-13,32
Wellington P,2329,9,5,6,16,31,55,-24,21
CC Mariners,2329,10,4,8,15,28,49,-21,20
Sydney FC,2330,1,20,5,3,65,23,42,65
N'castle Jet,2330,2,16,5,7,58,37,21,53
Melbourne C,2330,3,14,4,11,43,34,9,46
Melbourne V,2330,4,13,6,10,46,39,7,45
Adelaide Utd,2330,5,11,6,11,37,40,-3,39
Brisbane,2330,6,10,5,13,33,42,-9,35
Western Sydn,2330,7,8,9,10,38,47,-9,33
Perth Glory,2330,8,10,2,15,37,50,-13,32
Wellington P,2330,9,5,6,16,31,55,-24,21
CC Mariners,2330,10,4,8,15,28,49,-21,20
Sydney FC,2331,1,21,4,3,66,23,43,67
N'castle Jet,2331,2,16,5,7,58,37,21,53
Melbourne C,2331,3,14,4,11,43,34,9,46
Melbourne V,2331,4,13,5,11,46,40,6,44
Adelaide Utd,2331,5,11,6,11,37,40,-3,39
Brisbane,2331,6,10,5,13,33,42,-9,35
Western Sydn,2331,7,8,9,10,38,47,-9,33
Perth Glory,2331,8,10,2,15,37,50,-13,32
Wellington P,2331,9,5,6,16,31,55,-24,21
CC Mariners,2331,10,4,8,15,28,49,-21,20
Sydney FC,2332,1,21,4,3,70,24,46,67
N'castle Jet,2332,2,16,5,7,62,37,25,53
Melbourne C,2332,3,14,4,11,43,38,5,46
Melbourne V,2332,4,13,5,11,47,44,3,44
Adelaide Utd,2332,5,11,6,11,37,40,-3,39
Brisbane,2332,6,10,5,13,33,42,-9,35
Western Sydn,2332,7,8,9,10,38,47,-9,33
Perth Glory,2332,8,10,2,15,37,50,-13,32
Wellington P,2332,9,5,6,16,31,55,-24,21
CC Mariners,2332,10,4,8,15,28,49,-21,20
Sydney FC,2333,1,21,4,3,67,24,43,67
N'castle Jet,2333,2,16,5,7,59,37,22,53
Melbourne C,2333,3,14,4,11,43,35,8,46
Melbourne V,2333,4,13,5,11,47,41,6,44
Adelaide Utd,2333,5,11,6,11,37,40,-3,39
Brisbane,2333,6,10,5,13,33,42,-9,35
Western Sydn,2333,7,8,9,10,38,47,-9,33
Perth Glory,2333,8,10,2,15,37,50,-13,32
Wellington P,2333,9,5,6,16,31,55,-24,21
CC Mariners,2333,10,4,8,15,28,49,-21,20
Sydney FC,2334,1,21,4,3,66,23,43,67
N'castle Jet,2334,2,15,6,7,58,38,20,51
Melbourne C,2334,3,14,5,10,44,34,10,47
Melbourne V,2334,4,13,5,11,46,40,6,44
Adelaide Utd,2334,5,11,6,11,37,40,-3,39
Brisbane,2334,6,10,5,13,33,42,-9,35
Western Sydn,2334,7,8,9,10,38,47,-9,33
Perth Glory,2334,8,10,2,15,37,50,-13,32
Wellington P,2334,9,5,6,16,31,55,-24,21
CC Mariners,2334,10,4,8,15,28,49,-21,20
Sydney FC,2335,1,21,4,3,66,23,43,67
N'castle Jet,2335,2,15,6,7,57,37,20,51
Melbourne C,2335,3,14,5,10,43,33,10,47
Melbourne V,2335,4,13,5,11,46,40,6,44
Adelaide Utd,2335,5,11,6,11,37,40,-3,39
Brisbane,2335,6,10,5,13,33,42,-9,35
Western Sydn,2335,7,8,9,10,38,47,-9,33
Perth Glory,2335,8,10,2,15,37,50,-13,32
Wellington P,2335,9,5,6,16,31,55,-24,21
CC Mariners,2335,10,4,8,15,28,49,-21,20
Sydney FC,2336,1,21,4,3,67,23,44,67
N'castle Jet,2336,2,16,5,7,60,37,23,53
Melbourne C,2336,3,14,4,11,43,36,7,46
Melbourne V,2336,4,13,5,11,46,41,5,44
Adelaide Utd,2336,5,11,6,11,37,40,-3,39
Brisbane,2336,6,10,5,13,33,42,-9,35
Western Sydn,2336,7,8,9,10,38,47,-9,33
Perth Glory,2336,8,10,2,15,37,50,-13,32
Wellington P,2336,9,5,6,16,31,55,-24,21
CC Mariners,2336,10,4,8,15,28,49,-21,20
Sydney FC,2337,1,21,4,3,66,22,44,67
N'castle Jet,2337,2,16,5,7,58,37,21,53
Melbourne C,2337,3,14,4,11,43,34,9,46
Melbourne V,2337,4,13,5,11,45,40,5,44
Adelaide Utd,2337,5,11,6,11,37,40,-3,39
Brisbane,2337,6,10,5,13,33,42,-9,35
Western Sydn,2337,7,8,9,10,38,47,-9,33
Perth Glory,2337,8,10,2,15,37,50,-13,32
Wellington P,2337,9,5,6,16,31,55,-24,21
CC Mariners,2337,10,4,8,15,28,49,-21,20
Sydney FC,2338,1,21,4,3,65,22,43,67
N'castle Jet,2338,2,15,6,7,59,39,20,51
Melbourne C,2338,3,14,5,10,45,35,10,47
Melbourne V,2338,4,13,5,11,45,39,6,44
Adelaide Utd,2338,5,11,6,11,37,40,-3,39
Brisbane,2338,6,10,5,13,33,42,-9,35
Western Sydn,2338,7,8,9,10,38,47,-9,33
Perth Glory,2338,8,10,2,15,37,50,-13,32
Wellington P,2338,9,5,6,16,31,55,-24,21
CC Mariners,2338,10,4,8,15,28,49,-21,20
Sydney FC,2339,1,21,4,3,66,22,44,67
N'castle Jet,2339,2,15,6,7,58,38,20,51
Melbourne C,2339,3,14,5,10,44,34,10,47
Melbourne V,2339,4,13,5,11,45,40,5,44
Adelaide Utd,2339,5,11,6,11,37,40,-3,39
Brisbane,2339,6,10,5,13,33,42,-9,35
Western Sydn,2339,7,8,9,10,38,47,-9,33
Perth Glory,2339,8,10,2,15,37,50,-13,32
Wellington P,2339,9,5,6,16,31,55,-24,21
CC Mariners,2339,10,4,8,15,28,49,-21,20
Sydney FC,2340,1,21,4,3,67,24,43,67
N'castle Jet,2340,2,15,5,8,57,39,18,50
Melbourne C,2340,3,15,4,10,45,33,12,49
Melbourne V,2340,4,13,5,11,47,41,6,44
Adelaide Utd,2340,5,11,6,11,37,40,-3,39
Brisbane,2340,6,10,5,13,33,42,-9,35
Western Sydn,2340,7,8,9,10,38,47,-9,33
Perth Glory,2340,8,10,2,15,37,50,-13,32
Wellington P,2340,9,5,6,16,31,55,-24,21
CC Mariners,2340,10,4,8,15,28,49,-21,20
Sydney FC,2341,1,21,4,3,66,23,43,67
N'castle Jet,2341,2,15,6,7,58,38,20,51
Melbourne C,2341,3,14,5,10,44,34,10,47
Melbourne V,2341,4,13,5,11,46,40,6,44
Adelaide Utd,2341,5,11,6,11,37,40,-3,39
Brisbane,2341,6,10,5,13,33,42,-9,35
Western Sydn,2341,7,8,9,10,38,47,-9,33
Perth Glory,2341,8,10,2,15,37,50,-13,32
Wellington P,2341,9,5,6,16,31,55,-24,21
CC Mariners,2341,10,4,8,15,28,49,-21,20
Sydney FC,2342,1,21,4,3,66,22,44,67
N'castle Jet,2342,2,15,5,8,58,39,19,50
Melbourne C,2342,3,15,4,10,45,34,11,49
Melbourne V,2342,4,13,5,11,45,40,5,44
Adelaide Utd,2342,5,11,6,11,37,40,-3,39
Brisbane,2342,6,10,5,13,33,42,-9,35
Western Sydn,2342,7,8,9,10,38,47,-9,33
Perth Glory,2342,8,10,2,15,37,50,-13,32
Wellington P,2342,9,5,6,16,31,55,-24,21
CC Mariners,2342,10,4,8,15,28,49,-21,20
Sydney FC,2343,1,20,5,3,64,22,42,65
N'castle Jet,2343,2,15,6,7,57,37,20,51
Melbourne C,2343,3,14,5,10,43,33,10,47
Melbourne V,2343,4,13,6,10,45,38,7,45
Adelaide Utd,2343,5,11,6,11,37,40,-3,39
Brisbane,2343,6,10,5,13,33,42,-9,35
Western Sydn,2343,7,8,9,10,38,47,-9,33
Perth Glory,2343,8,10,2,15,37,50,-13,32
Wellington P,2343,9,5,6,16,31,55,-24,21
CC Mariners,2343,10,4,8,15,28,49,-21,20
Sydney FC,2344,1,21,4,3,65,22,43,67
N'castle Jet,2344,2,16,5,7,61,38,23,53
Melbourne C,2344,3,14,4,11,44,37,7,46
Melbourne V,2344,4,13,5,11,45,39,6,44
Adelaide Utd,2344,5,11,6,11,37,40,-3,39
Brisbane,2344,6,10,5,13,33,42,-9,35
Western Sydn,2344,7,8,9,10,38,47,-9,33
Perth Glory,2344,8,10,2,15,37,50,-13,32
Wellington P,2344,9,5,6,16,31,55,-24,21
CC Mariners,2344,10,4,8,15,28,49,-21,20
Sydney FC,2345,1,20,4,4,65,24,41,64
N'castle Jet,2345,2,15,5,8,59,41,18,50
Melbourne C,2345,3,15,4,10,47,35,12,49
Melbourne V,2345,4,14,5,10,47,39,8,47
Adelaide Utd,2345,5,11,6,11,37,40,-3,39
Brisbane,2345,6,10,5,13,33,42,-9,35
Western Sydn,2345,7,8,9,10,38,47,-9,33
Perth Glory,2345,8,10,2,15,37,50,-13,32
Wellington P,2345,9,5,6,16,31,55,-24,21
CC Mariners,2345,10,4,8,15,28,49,-21,20
Sydney FC,2346,1,20,4,4,65,24,41,64
N'castle Jet,2346,2,15,5,8,60,41,19,50
Melbourne C,2346,3,15,4,10,47,36,11,49
Melbourne V,2346,4,14,5,10,47,39,8,47
Adelaide Utd,2346,5,11,6,11,37,40,-3,39
Brisbane,2346,6,10,5,13,33,42,-9,35
Western Sydn,2346,7,8,9,10,38,47,-9,33
Perth Glory,2346,8,10,2,15,37,50,-13,32
Wellington P,2346,9,5,6,16,31,55,-24,21
CC Mariners,2346,10,4,8,15,28,49,-21,20
Sydney FC,2347,1,21,4,3,65,22,43,67
N'castle Jet,2347,2,15,6,7,57,37,20,51
Melbourne C,2347,3,14,5,10,43,33,10,47
Melbourne V,2347,4,13,5,11,45,39,6,44
Adelaide Utd,2347,5,11,6,11,37,40,-3,39
Brisbane,2347,6,10,5,13,33,42,-9,35
Western Sydn,2347,7,8,9,10,38,47,-9,33
Perth Glory,2347,8,10,2,15,37,50,-13,32
Wellington P,2347,9,5,6,16,31,55,-24,21
CC Mariners,2347,10,4,8,15,28,49,-21,20
Sydney FC,2348,1,21,4,3,69,24,45,67
N'castle Jet,2348,2,15,5,8,57,40,17,50
Melbourne C,2348,3,15,4,10,46,33,13,49
Melbourne V,2348,4,13,5,11,47,43,4,44
Adelaide Utd,2348,5,11,6,11,37,40,-3,39
Brisbane,2348,6,10,5,13,33,42,-9,35
Western Sydn,2348,7,8,9,10,38,47,-9,33
Perth Glory,2348,8,10,2,15,37,50,-13,32
Wellington P,2348,9,5,6,16,31,55,-24,21
CC Mariners,2348,10,4,8,15,28,49,-21,20
Sydney FC,2349,1,21,4,3,67,24,43,67
N'castle Jet,2349,2,16,5,7,59,37,22,53
Melbourne C,2349,3,14,4,11,43,35,8,46
Melbourne V,2349,4,13,5,11,47,41,6,44
Adelaide Utd,2349,5,11,6,11,37,40,-3,39
Brisbane,2349,6,10,5,13,33,42,-9,35
Western Sydn,2349,7,8,9,10,38,47,-9,33
Perth Glory,2349,8,10,2,15,37,50,-13,32
Wellington P,2349,9,5,6,16,31,55,-24,21
CC Mariners,2349,10,4,8,15,28,49,-21,20
Sydney FC,2350,1,21,4,3,68,23,45,67
N'castle Jet,2350,2,15,6,7,58,38,20,51
Melbourne C,2350,3,14,5,10,44,34,10,47
Melbourne V,2350,4,13,5,11,46,42,4,44
Adelaide Utd,2350,5,11,6,11,37,40,-3,39
Brisbane,2350,6,10,5,13,33,42,-9,35
Western Sydn,2350,7,8,9,10,38,47,-9,33
Perth Glory,2350,8,10,2,15,37,50,-13,32
Wellington P,2350,9,5,6,16,31,55,-24,21
CC Mariners,2350,10,4,8,15,28,49,-21,20
Sydney FC,2351,1,21,4,3,65,22,43,67
N'castle Jet,2351,2,16,5,7,59,38,21,53
Melbourne C,2351,3,14,4,11,44,35,9,46
Melbourne V,2351,4,13,5,11,45,39,6,44
Adelaide Utd,2351,5,11,6,11,37,40,-3,39
Brisbane,2351,6,10,5,13,33,42,-9,35
Western Sydn,2351,7,8,9,10,38,47,-9,33
Perth Glory,2351,8,10,2,15,37,50,-13,32
Wellington P,2351,9,5,6,16,31,55,-24,21
CC Mariners,2351,10,4,8,15,28,49,-21,20
Sydney FC,2352,1,21,4,3,68,23,45,67
N'castle Jet,2352,2,16,5,7,61,37,24,53
Melbourne C,2352,3,14,4,11,43,37,6,46
Melbourne V,2352,4,13,5,11,46,42,4,44
Adelaide Utd,2352,5,11,6,11,37,40,-3,39
Brisbane,2352,6,10,5,13,33,42,-9,35
Western Sydn,2352,7,8,9,10,38,47,-9,33
Perth Glory,2352,8,10,2,15,37,50,-13,32
Wellington P,2352,9,5,6,16,31,55,-24,21
CC Mariners,2352,10,4,8,15,28,49,-21,20
Sydney FC,2353,1,21,4,3,66,22,44,67
N'castle Jet,2353,2,15,6,7,58,38,20,51
Melbourne C,2353,3,14,5,10,44,34,10,47
Melbourne V,2353,4,13,5,11,45,40,5,44
Adelaide Utd,2353,5,11,6,11,37,40,-3,39
Brisbane,2353,6,10,5,13,33,42,-9,35
Western Sydn,2353,7,8,9,10,38,47,-9,33
Perth Glory,2353,8,10,2,15,37,50,-13,32
Wellington P,2353,9,5,6,16,31,55,-24,21
CC Mariners,2353,10,4,8,15,28,49,-21,20
Sydney FC,2354,1,21,4,3,66,22,44,67
N'castle Jet,2354,2,16,5,7,60,38,22,53
Melbourne C,2354,3,14,4,11,44,36,8,46
Melbourne V,2354,4,13,5,11,45,40,5,44
Adelaide Utd,2354,5,11,6,11,37,40,-3,39
Brisbane,2354,6,10,5,13,33,42,-9,35
Western Sydn,2354,7,8,9,10,38,47,-9,33
Perth Glory,2354,8,10,2,15,37,50,-13,32
Wellington P,2354,9,5,6,16,31,55,-24,21
CC Mariners,2354,10,4,8,15,28,49,-21,20
Sydney FC,2355,1,21,4,3,66,22,44,67
N'castle Jet,2355,2,16,5,7,62,37,25,53
Melbourne C,2355,3,14,4,11,43,38,5,46
Melbourne V,2355,4,13,5,11,45,40,5,44
Adelaide Utd,2355,5,11,6,11,37,40,-3,39
Brisbane,2355,6,10,5,13,33,42,-9,35
Western Sydn,2355,7,8,9,10,38,47,-9,33
Perth Glory,2355,8,10,2,15,37,50,-13,32
Wellington P,2355,9,5,6,16,31,55,-24,21
CC Mariners,2355,10,4,8,15,28,49,-21,20
Sydney FC,2356,1,21,4,3,67,23,44,67
N'castle Jet,2356,2,16,5,7,60,37,23,53
Melbourne C,2356,3,14,4,11,43,36,7,46
Melbourne V,2356,4,13,5,11,46,41,5,44
Adelaide Utd,2356,5,11,6,11,37,40,-3,39
Brisbane,2356,6,10,5,13,33,42,-9,35
Western Sydn,2356,7,8,9,10,38,47,-9,33
Perth Glory,2356,8,10,2,15,37,50,-13,32
Wellington P,2356,9,5,6,16,31,55,-24,21
CC Mariners,2356,10,4,8,15,28,49,-21,20
Sydney FC,2357,1,21,4,3,66,23,43,67
N'castle Jet,2357,2,16,5,7,59,38,21,53
Melbourne C,2357,3,14,4,11,44,35,9,46
Melbourne V,2357,4,13,5,11,46,40,6,44
Adelaide Utd,2357,5,11,6,11,37,40,-3,39
Brisbane,2357,6,10,5,13,33,42,-9,35
Western Sydn,2357,7,8,9,10,38,47,-9,33
Perth Glory,2357,8,10,2,15,37,50,-13,32
Wellington P,2357,9,5,6,16,31,55,-24,21
CC Mariners,2357,10,4,8,15,28,49,-21,20
Sydney FC,2358,1,20,4,4,66,25,41,64
N'castle Jet,2358,2,15,6,7,58,38,20,51
Melbourne C,2358,3,14,5,10,44,34,10,47
Melbourne V,2358,4,14,5,10,48,40,8,47
Adelaide Utd,2358,5,11,6,11,37,40,-3,39
Brisbane,2358,6,10,5,13,33,42,-9,35
Western Sydn,2358,7,8,9,10,38,47,-9,33
Perth Glory,2358,8,10,2,15,37,50,-13,32
Wellington P,2358,9,5,6,16,31,55,-24,21
CC Mariners,2358,10,4,8,15,28,49,-21,20
Sydney FC,2359,1,20,4,4,65,24,41,64
N'castle Jet,2359,2,16,5,7,59,38,21,53
Melbourne V,2359,3,14,5,10,47,39,8,47
Melbourne C,2359,4,14,4,11,44,35,9,46
Adelaide Utd,2359,5,11,6,11,37,40,-3,39
Brisbane,2359,6,10,5,13,33,42,-9,35
Western Sydn,2359,7,8,9,10,38,47,-9,33
Perth Glory,2359,8,10,2,15,37,50,-13,32
Wellington P,2359,9,5,6,16,31,55,-24,21
CC Mariners,2359,10,4,8,15,28,49,-21,20
Sydney FC,2360,1,21,4,3,66,23,43,67
N'castle Jet,2360,2,15,6,7,58,38,20,51
Melbourne C,2360,3,14,5,10,44,34,10,47
Melbourne V,2360,4,13,5,11,46,40,6,44
Adelaide Utd,2360,5,11,6,11,37,40,-3,39
Brisbane,2360,6,10,5,13,33,42,-9,35
Western Sydn,2360,7,8,9,10,38,47,-9,33
Perth Glory,2360,8,10,2,15,37,50,-13,32
Wellington P,2360,9,5,6,16,31,55,-24,21
CC Mariners,2360,10,4,8,15,28,49,-21,20
Sydney FC,2361,1,21,4,3,66,23,43,67
N'castle Jet,2361,2,16,5,7,59,37,22,53
Melbourne C,2361,3,14,4,11,43,35,8,46
Melbourne V,2361,4,13,5,11,46,40,6,44
Adelaide Utd,2361,5,11,6,11,37,40,-3,39
Brisbane,2361,6,10,5,13,33,42,-9,35
Western Sydn,2361,7,8,9,10,38,47,-9,33
Perth Glory,2361,8,10,2,15,37,50,-13,32
Wellington P,2361,9,5,6,16,31,55,-24,21
CC Mariners,2361,10,4,8,15,28,49,-21,20
Sydney FC,2362,1,21,4,3,67,22,45,67
N'castle Jet,2362,2,15,6,7,58,38,20,51
Melbourne C,2362,3,14,5,10,44,34,10,47
Melbourne V,2362,4,13,5,11,45,41,4,44
Adelaide Utd,2362,5,11,6,11,37,40,-3,39
Brisbane,2362,6,10,5,13,33,42,-9,35
Western Sydn,2362,7,8,9,10,38,47,-9,33
Perth Glory,2362,8,10,2,15,37,50,-13,32
Wellington P,2362,9,5,6,16,31,55,-24,21
CC Mariners,2362,10,4,8,15,28,49,-21,20
Sydney FC,2363,1,21,4,3,66,22,44,67
N'castle Jet,2363,2,16,5,7,61,38,23,53
Melbourne C,2363,3,14,4,11,44,37,7,46
Melbourne V,2363,4,13,5,11,45,40,5,44
Adelaide Utd,2363,5,11,6,11,37,40,-3,39
Brisbane,2363,6,10,5,13,33,42,-9,35
Western Sydn,2363,7,8,9,10,38,47,-9,33
Perth Glory,2363,8,10,2,15,37,50,-13,32
Wellington P,2363,9,5,6,16,31,55,-24,21
CC Mariners,2363,10,4,8,15,28,49,-21,20
Sydney FC,2364,1,21,4,3,66,23,43,67
N'castle Jet,2364,2,16,5,7,59,37,22,53
Melbourne C,2364,3,14,4,11,43,35,8,46
Melbourne V,2364,4,13,5,11,46,40,6,44
Adelaide Utd,2364,5,11,6,11,37,40,-3,39
Brisbane,2364,6,10,5,13,33,42,-9,35
Western Sydn,2364,7,8,9,10,38,47,-9,33
Perth Glory,2364,8,10,2,15,37,50,-13,32
Wellington P,2364,9,5,6,16,31,55,-24,21
CC Mariners,2364,10,4,8,15,28,49,-21,20
Sydney FC,2365,1,21,4,3,65,22,43,67
N'castle Jet,2365,2,16,5,7,61,39,22,53
Melbourne C,2365,3,14,4,11,45,37,8,46
Melbourne V,2365,4,13,5,11,45,39,6,44
Adelaide Utd,2365,5,11,6,11,37,40,-3,39
Brisbane,2365,6,10,5,13,33,42,-9,35
Western Sydn,2365,7,8,9,10,38,47,-9,33
Perth Glory,2365,8,10,2,15,37,50,-13,32
Wellington P,2365,9,5,6,16,31,55,-24,21
CC Mariners,2365,10,4,8,15,28,49,-21,20
Sydney FC,2366,1,21,4,3,66,23,43,67
N'castle Jet,2366,2,16,5,7,59,38,21,53
Melbourne C,2366,3,14,4,11,44,35,9,46
Melbourne V,2366,4,13,5,11,46,40,6,44
Adelaide Utd,2366,5,11,6,11,37,40,-3,39
Brisbane,2366,6,10,5,13,33,42,-9,35
Western Sydn,2366,7,8,9,10,38,47,-9,33
Perth Glory,2366,8,10,2,15,37,50,-13,32
Wellington P,2366,9,5,6,16,31,55,-24,21
CC Mariners,2366,10,4,8,15,28,49,-21,20
Sydney FC,2367,1,20,5,3,64,22,42,65
N'castle Jet,2367,2,15,5,8,58,39,19,50
Melbourne C,2367,3,15,4,10,45,34,11,49
Melbourne V,2367,4,13,6,10,45,38,7,45
Adelaide Utd,2367,5,11,6,11,37,40,-3,39
Brisbane,2367,6,10,5,13,33,42,-9,35
Western Sydn,2367,7,8,9,10,38,47,-9,33
Perth Glory,2367,8,10,2,15,37,50,-13,32
Wellington P,2367,9,5,6,16,31,55,-24,21
CC Mariners,2367,10,4,8,15,28,49,-21,20
Sydney FC,2368,1,20,5,3,66,24,42,65
N'castle Jet,2368,2,16,5,7,60,38,22,53
Melbourne C,2368,3,14,4,11,44,36,8,46
Melbourne V,2368,4,13,6,10,47,40,7,45
Adelaide Utd,2368,5,11,6,11,37,40,-3,39
Brisbane,2368,6,10,5,13,33,42,-9,35
Western Sydn,2368,7,8,9,10,38,47,-9,33
Perth Glory,2368,8,10,2,15,37,50,-13,32
Wellington P,2368,9,5,6,16,31,55,-24,21
CC Mariners,2368,10,4,8,15,28,49,-21,20
Sydney FC,2369,1,21,4,3,66,22,44,67
N'castle Jet,2369,2,15,5,8,57,38,19,50
Melbourne C,2369,3,15,4,10,44,33,11,49
Melbourne V,2369,4,13,5,11,45,40,5,44
Adelaide Utd,2369,5,11,6,11,37,40,-3,39
Brisbane,2369,6,10,5,13,33,42,-9,35
Western Sydn,2369,7,8,9,10,38,47,-9,33
Perth Glory,2369,8,10,2,15,37,50,-13,32
Wellington P,2369,9,5,6,16,31,55,-24,21
CC Mariners,2369,10,4,8,15,28,49,-21,20
Sydney FC,2370,1,21,4,3,67,22,45,67
N'castle Jet,2370,2,16,5,7,59,38,21,53
Melbourne C,2370,3,14,4,11,44,35,9,46
Melbourne V,2370,4,13,5,11,45,41,4,44
Adelaide Utd,2370,5,11,6,11,37,40,-3,39
Brisbane,2370,6,10,5,13,33,42,-9,35
Western Sydn,2370,7,8,9,10,38,47,-9,33
Perth Glory,2370,8,10,2,15,37,50,-13,32
Wellington P,2370,9,5,6,16,31,55,-24,21
CC Mariners,2370,10,4,8,15,28,49,-21,20
Sydney FC,2371,1,20,5,3,65,23,42,65
N'castle Jet,2371,2,15,5,8,57,38,19,50
Melbourne C,2371,3,15,4,10,44,33,11,49
Melbourne V,2371,4,13,6,10,46,39,7,45
Adelaide Utd,2371,5,11,6,11,37,40,-3,39
Brisbane,2371,6,10,5,13,33,42,-9,35
Western Sydn,2371,7,8,9,10,38,47,-9,33
Perth Glory,2371,8,10,2,15,37,50,-13,32
Wellington P,2371,9,5,6,16,31,55,-24,21
CC Mariners,2371,10,4,8,15,28,49,-21,20
Sydney FC,2372,1,21,4,3,68,24,44,67
N'castle Jet,2372,2,15,6,7,59,39,20,51
Melbourne C,2372,3,14,5,10,45,35,10,47
Melbourne V,2372,4,13,5,11,47,42,5,44
Adelaide Utd,2372,5,11,6,11,37,40,-3,39
Brisbane,2372,6,10,5,13,33,42,-9,35
Western Sydn,2372,7,8,9,10,38,47,-9,33
Perth Glory,2372,8,10,2,15,37,50,-13,32
Wellington P,2372,9,5,6,16,31,55,-24,21
CC Mariners,2372,10,4,8,15,28,49,-21,20
Sydney FC,2373,1,21,4,3,65,22,43,67
N'castle Jet,2373,2,16,5,7,60,38,22,53
Melbourne C,2373,3,14,4,11,44,36,8,46
Melbourne V,2373,4,13,5,11,45,39,6,44
Adelaide Utd,2373,5,11,6,11,37,40,-3,39
Brisbane,2373,6,10,5,13,33,42,-9,35
Western Sydn,2373,7,8,9,10,38,47,-9,33
Perth Glory,2373,8,10,2,15,37,50,-13,32
Wellington P,2373,9,5,6,16,31,55,-24,21
CC Mariners,2373,10,4,8,15,28,49,-21,20
Sydney FC,2374,1,21,4,3,67,23,44,67
N'castle Jet,2374,2,15,6,7,58,38,20,51
Melbourne C,2374,3,14,5,10,44,34,10,47
Melbourne V,2374,4,13,5,11,46,41,5,44
Adelaide Utd,2374,5,11,6,11,37,40,-3,39
Brisbane,2374,6,10,5,13,33,42,-9,35
Western Sydn,2374,7,8,9,10,38,47,-9,33
Perth Glory,2374,8,10,2,15,37,50,-13,32
Wellington P,2374,9,5,6,16,31,55,-24,21
CC Mariners,2374,10,4,8,15,28,49,-21,20
Sydney FC,2375,1,21,4,3,66,23,43,67
N'castle Jet,2375,2,16,5,7,58,37,21,53
Melbourne C,2375,3,14,4,11,43,34,9,46
Melbourne V,2375,4,13,5,11,46,40,6,44
Adelaide Utd,2375,5,11,6,11,37,40,-3,39
Brisbane,2375,6,10,5,13,33,42,-9,35
Western Sydn,2375,7,8,9,10,38,47,-9,33
Perth Glory,2375,8,10,2,15,37,50,-13,32
Wellington P,2375,9,5,6,16,31,55,-24,21
CC Mariners,2375,10,4,8,15,28,49,-21,20
Sydney FC,2376,1,21,4,3,67,22,45,67
N'castle Jet,2376,2,16,5,7,58,37,21,53
Melbourne C,2376,3,14,4,11,43,34,9,46
Melbourne V,2376,4,13,5,11,45,41,4,44
Adelaide Utd,2376,5,11,6,11,37,40,-3,39
Brisbane,2376,6,10,5,13,33,42,-9,35
Western Sydn,2376,7,8,9,10,38,47,-9,33
Perth Glory,2376,8,10,2,15,37,50,-13,32
Wellington P,2376,9,5,6,16,31,55,-24,21
CC Mariners,2376,10,4,8,15,28,49,-21,20
Sydney FC,2377,1,21,4,3,67,22,45,67
N'castle Jet,2377,2,16,5,7,61,37,24,53
Melbourne C,2377,3,14,4,11,43,37,6,46
Melbourne V,2377,4,13,5,11,45,41,4,44
Adelaide Utd,2377,5,11,6,11,37,40,-3,39
Brisbane,2377,6,10,5,13,33,42,-9,35
Western Sydn,2377,7,8,9,10,38,47,-9,33
Perth Glory,2377,8,10,2,15,37,50,-13,32
Wellington P,2377,9,5,6,16,31,55,-24,21
CC Mariners,2377,10,4,8,15,28,49,-21,20
Sydney FC,2378,1,21,4,3,68,23,45,67
N'castle Jet,2378,2,15,5,8,57,39,18,50
Melbourne C,2378,3,15,4,10,45,33,12,49
Melbourne V,2378,4,13,5,11,46,42,4,44
Adelaide Utd,2378,5,11,6,11,37,40,-3,39
Brisbane,2378,6,10,5,13,33,42,-9,35
Western Sydn,2378,7,8,9,10,38,47,-9,33
Perth Glory,2378,8,10,2,15,37,50,-13,32
Wellington P,2378,9,5,6,16,31,55,-24,21
CC Mariners,2378,10,4,8,15,28,49,-21,20
Sydney FC,2379,1,20,5,3,65,23,42,65
N'castle Jet,2379,2,15,6,7,59,39,20,51
Melbourne C,2379,3,14,5,10,45,35,10,47
Melbourne V,2379,4,13,6,10,46,39,7,45
Adelaide Utd,2379,5,11,6,11,37,40,-3,39
Brisbane,2379,6,10,5,13,33,42,-9,35
Western Sydn,2379,7,8,9,10,38,47,-9,33
Perth Glory,2379,8,10,2,15,37,50,-13,32
Wellington P,2379,9,5,6,16,31,55,-24,21
CC Mariners,2379,10,4,8,15,28,49,-21,20
Sydney FC,2380,1,20,5,3,64,22,42,65
N'castle Jet,2380,2,16,5,7,61,37,24,53
Melbourne C,2380,3,14,4,11,43,37,6,46
Melbourne V,2380,4,13,6,10,45,38,7,45
Adelaide Utd,2380,5,11,6,11,37,40,-3,39
Brisbane,2380,6,10,5,13,33,42,-9,35
Western Sydn,2380,7,8,9,10,38,47,-9,33
Perth Glory,2380,8,10,2,15,37,50,-13,32
Wellington P,2380,9,5,6,16,31,55,-24,21
CC Mariners,2380,10,4,8,15,28,49,-21,20
Sydney FC,2381,1,20,5,3,64,22,42,65
N'castle Jet,2381,2,15,5,8,57,38,19,50
Melbourne C,2381,3,15,4,10,44,33,11,49
Melbourne V,2381,4,13,6,10,45,38,7,45
Adelaide Utd,2381,5,11,6,11,37,40,-3,39
Brisbane,2381,6,10,5,13,33,42,-9,35
Western Sydn,2381,7,8,9,10,38,47,-9,33
Perth Glory,2381,8,10,2,15,37,50,-13,32
Wellington P,2381,9,5,6,16,31,55,-24,21
CC Mariners,2381,10,4,8,15,28,49,-21,20
Sydney FC,2382,1,20,5,3,65,23,42,65
N'castle Jet,2382,2,16,5,7,58,37,21,53
Melbourne C,2382,3,14,4,11,43,34,9,46
Melbourne V,2382,4,13,6,10,46,39,7,45
Adelaide Utd,2382,5,11,6,11,37,40,-3,39
Brisbane,2382,6,10,5,13,33,42,-9,35
Western Sydn,2382,7,8,9,10,38,47,-9,33
Perth Glory,2382,8,10,2,15,37,50,-13,32
Wellington P,2382,9,5,6,16,31,55,-24,21
CC Mariners,2382,10,4,8,15,28,49,-21,20
Sydney FC,2383,1,21,4,3,66,22,44,67
N'castle Jet,2383,2,15,5,8,57,39,18,50
Melbourne C,2383,3,15,4,10,45,33,12,49
Melbourne V,2383,4,13,5,11,45,40,5,44
Adelaide Utd,2383,5,11,6,11,37,40,-3,39
Brisbane,2383,6,10,5,13,33,42,-9,35
Western Sydn,2383,7,8,9,10,38,47,-9,33
Perth Glory,2383,8,10,2,15,37,50,-13,32
Wellington P,2383,9,5,6,16,31,55,-24,21
CC Mariners,2383,10,4,8,15,28,49,-21,20
Sydney FC,2384,1,21,4,3,69,23,46,67
N'castle Jet,2384,2,15,5,8,58,39,19,50
Melbourne C,2384,3,15,4,10,45,34,11,49
Melbourne V,2384,4,13,5,11,46,43,3,44
Adelaide Utd,2384,5,11,6,11,37,40,-3,39
Brisbane,2384,6,10,5,13,33,42,-9,35
Western Sydn,2384,7,8,9,10,38,47,-9,33
Perth Glory,2384,8,10,2,15,37,50,-13,32
Wellington P,2384,9,5,6,16,31,55,-24,21
CC Mariners,2384,10,4,8,15,28,49,-21,20
Sydney FC,2385,1,21,4,3,66,22,44,67
N'castle Jet,2385,2,15,5,8,57,38,19,50
Melbourne C,2385,3,15,4,10,44,33,11,49
Melbourne V,2385,4,13,5,11,45,40,5,44
Adelaide Utd,2385,5,11,6,11,37,40,-3,39
Brisbane,2385,6,10,5,13,33,42,-9,35
Western Sydn,2385,7,8,9,10,38,47,-9,33
Perth Glory,2385,8,10,2,15,37,50,-13,32
Wellington P,2385,9,5,6,16,31,55,-24,21
CC Mariners,2385,10,4,8,15,28,49,-21,20
Sydney FC,2386,1,21,4,3,69,22,47,67
N'castle Jet,2386,2,15,5,8,57,38,19,50
Melbourne C,2386,3,15,4,10,44,33,11,49
Melbourne V,2386,4,13,5,11,45,43,2,44
Adelaide Utd,2386,5,11,6,11,37,40,-3,39
Brisbane,2386,6,10,5,13,33,42,-9,35
Western Sydn,2386,7,8,9,10,38,47,-9,33
Perth Glory,2386,8,10,2,15,37,50,-13,32
Wellington P,2386,9,5,6,16,31,55,-24,21
CC Mariners,2386,10,4,8,15,28,49,-21,20
Sydney FC,2387,1,20,5,3,64,22,42,65
N'castle Jet,2387,2,16,5,7,61,38,23,53
Melbourne C,2387,3,14,4,11,44,37,7,46
Melbourne V,2387,4,13,6,10,45,38,7,45
Adelaide Utd,2387,5,11,6,11,37,40,-3,39
Brisbane,2387,6,10,5,13,33,42,-9,35
Western Sydn,2387,7,8,9,10,38,47,-9,33
Perth Glory,2387,8,10,2,15,37,50,-13,32
Wellington P,2387,9,5,6,16,31,55,-24,21
CC Mariners,2387,10,4,8,15,28,49,-21,20
Sydney FC,2388,1,21,4,3,66,22,44,67
N'castle Jet,2388,2,15,5,8,58,39,19,50
Melbourne C,2388,3,15,4,10,45,34,11,49
Melbourne V,2388,4,13,5,11,45,40,5,44
Adelaide Utd,2388,5,11,6,11,37,40,-3,39
Brisbane,2388,6,10,5,13,33,42,-9,35
Western Sydn,2388,7,8,9,10,38,47,-9,33
Perth Glory,2388,8,10,2,15,37,50,-13,32
Wellington P,2388,9,5,6,16,31,55,-24,21
CC Mariners,2388,10,4,8,15,28,49,-21,20
Sydney FC,2389,1,20,5,3,65,23,42,65
N'castle Jet,2389,2,15,5,8,57,39,18,50
Melbourne C,2389,3,15,4,10,45,33,12,49
Melbourne V,2389,4,13,6,10,46,39,7,45
Adelaide Utd,2389,5,11,6,11,37,40,-3,39
Brisbane,2389,6,10,5,13,33,42,-9,35
Western Sydn,2389,7,8,9,10,38,47,-9,33
Perth Glory,2389,8,10,2,15,37,50,-13,32
Wellington P,2389,9,5,6,16,31,55,-24,21
CC Mariners,2389,10,4,8,15,28,49,-21,20
Sydney FC,2390,1,20,4,4,67,26,41,64
N'castle Jet,2390,2,16,5,7,60,38,22,53
Melbourne V,2390,3,14,5,10,49,41,8,47
Melbourne C,2390,4,14,4,11,44,36,8,46
Adelaide Utd,2390,5,11,6,11,37,40,-3,39
Brisbane,2390,6,10,5,13,33,42,-9,35
Western Sydn,2390,7,8,9,10,38,47,-9,33
Perth Glory,2390,8,10,2,15,37,50,-13,32
Wellington P,2390,9,5,6,16,31,55,-24,21
CC Mariners,2390,10,4,8,15,28,49,-21,20
Sydney FC,2391,1,21,4,3,65,22,43,67
N'castle Jet,2391,2,16,5,7,58,37,21,53
Melbourne C,2391,3,14,4,11,43,34,9,46
Melbourne V,2391,4,13,5,11,45,39,6,44
Adelaide Utd,2391,5,11,6,11,37,40,-3,39
Brisbane,2391,6,10,5,13,33,42,-9,35
Western Sydn,2391,7,8,9,10,38,47,-9,33
Perth Glory,2391,8,10,2,15,37,50,-13,32
Wellington P,2391,9,5,6,16,31,55,-24,21
CC Mariners,2391,10,4,8,15,28,49,-21,20
Sydney FC,2392,1,20,4,4,64,23,41,64
N'castle Jet,2392,2,16,5,7,60,39,21,53
Melbourne V,2392,3,14,5,10,46,38,8,47
Melbourne C,2392,4,14,4,11,45,36,9,46
Adelaide Utd,2392,5,11,6,11,37,40,-3,39
Brisbane,2392,6,10,5,13,33,42,-9,35
Western Sydn,2392,7,8,9,10,38,47,-9,33
Perth Glory,2392,8,10,2,15,37,50,-13,32
Wellington P,2392,9,5,6,16,31,55,-24,21
CC Mariners,2392,10,4,8,15,28,49,-21,20
Sydney FC,2393,1,20,5,3,64,22,42,65
N'castle Jet,2393,2,15,5,8,58,39,19,50
Melbourne C,2393,3,15,4,10,45,34,11,49
Melbourne V,2393,4,13,6,10,45,38,7,45
Adelaide Utd,2393,5,11,6,11,37,40,-3,39
Brisbane,2393,6,10,5,13,33,42,-9,35
Western Sydn,2393,7,8,9,10,38,47,-9,33
Perth Glory,2393,8,10,2,15,37,50,-13,32
Wellington P,2393,9,5,6,16,31,55,-24,21
CC Mariners,2393,10,4,8,15,28,49,-21,20
Sydney FC,2394,1,20,5,3,65,23,42,65
N'castle Jet,2394,2,15,5,8,57,40,17,50
Melbourne C,2394,3,15,4,10,46,33,13,49
Melbourne V,2394,4,13,6,10,46,39,7,45
Adelaide Utd,2394,5,11,6,11,37,40,-3,39
Brisbane,2394,6,10,5,13,33,42,-9,35
Western Sydn,2394,7,8,9,10,38,47,-9,33
Perth Glory,2394,8,10,2,15,37,50,-13,32
Wellington P,2394,9,5,6,16,31,55,-24,21
CC Mariners,2394,10,4,8,15,28,49,-21,20
Sydney FC,2395,1,21,4,3,66,23,43,67
N'castle Jet,2395,2,16,5,7,58,37,21,53
Melbourne C,2395,3,14,4,11,43,34,9,46
Melbourne V,2395,4,13,5,11,46,40,6,44
Adelaide Utd,2395,5,11,6,11,37,40,-3,39
Brisbane,2395,6,10,5,13,33,42,-9,35
Western Sydn,2395,7,8,9,10,38,47,-9,33
Perth Glory,2395,8,10,2,15,37,50,-13,32
Wellington P,2395,9,5,6,16,31,55,-24,21
CC Mariners,2395,10,4,8,15,28,49,-21,20
Sydney FC,2396,1,20,4,4,65,24,41,64
N'castle Jet,2396,2,16,5,7,59,38,21,53
Melbourne V,2396,3,14,5,10,47,39,8,47
Melbourne C,2396,4,14,4,11,44,35,9,46
Adelaide Utd,2396,5,11,6,11,37,40,-3,39
Brisbane,2396,6,10,5,13,33,42,-9,35
Western Sydn,2396,7,8,9,10,38,47,-9,33
Perth Glory,2396,8,10,2,15,37,50,-13,32
Wellington P,2396,9,5,6,16,31,55,-24,21
CC Mariners,2396,10,4,8,15,28,49,-21,20
Sydney FC,2397,1,21,4,3,69,22,47,67
N'castle Jet,2397,2,15,5,8,57,38,19,50
Melbourne C,2397,3,15,4,10,44,33,11,49
Melbourne V,2397,4,13,5,11,45,43,2,44
Adelaide Utd,2397,5,11,6,11,37,40,-3,39
Brisbane,2397,6,10,5,13,33,42,-9,35
Western Sydn,2397,7,8,9,10,38,47,-9,33
Perth Glory,2397,8,10,2,15,37,50,-13,32
Wellington P,2397,9,5,6,16,31,55,-24,21
CC Mariners,2397,10,4,8,15,28,49,-21,20
Sydney FC,2398,1,21,4,3,65,22,43,67
N'castle Jet,2398,2,16,5,7,59,37,22,53
Melbourne C,2398,3,14,4,11,43,35,8,46
Melbourne V,2398,4,13,5,11,45,39,6,44
Adelaide Utd,2398,5,11,6,11,37,40,-3,39
Brisbane,2398,6,10,5,13,33,42,-9,35
Western Sydn,2398,7,8,9,10,38,47,-9,33
Perth Glory,2398,8,10,2,15,37,50,-13,32
Wellington P,2398,9,5,6,16,31,55,-24,21
CC Mariners,2398,10,4,8,15,28,49,-21,20
Sydney FC,2399,1,21,4,3,69,22,47,67
N'castle Jet,2399,2,16,5,7,59,37,22,53
Melbourne C,2399,3,14,4,11,43,35,8,46
Melbourne V,2399,4,13,5,11,45,43,2,44
Adelaide Utd,2399,5,11,6,11,37,40,-3,39
Brisbane,2399,6,10,5,13,33,42,-9,35
Western Sydn,2399,7,8,9,10,38,47,-9,33
Perth Glory,2399,8,10,2,15,37,50,-13,32
Wellington P,2399,9,5,6,16,31,55,-24,21
CC Mariners,2399,10,4,8,15,28,49,-21,20
Sydney FC,2400,1,21,4,3,66,22,44,67
N'castle Jet,2400,2,16,5,7,60,37,23,53
Melbourne C,2400,3,14,4,11,43,36,7,46
Melbourne V,2400,4,13,5,11,45,40,5,44
Adelaide Utd,2400,5,11,6,11,37,40,-3,39
Brisbane,2400,6,10,5,13,33,42,-9,35
Western Sydn,2400,7,8,9,10,38,47,-9,33
Perth Glory,2400,8,10,2,15,37,50,-13,32
Wellington P,2400,9,5,6,16,31,55,-24,21
CC Mariners,2400,10,4,8,15,28,49,-21,20
Sydney FC,2401,1,20,5,3,65,23,42,65
N'castle Jet,2401,2,16,5,7,62,38,24,53
Melbourne C,2401,3,14,4,11,44,38,6,46
Melbourne V,2401,4,13,6,10,46,39,7,45
Adelaide Utd,2401,5,11,6,11,37,40,-3,39
Brisbane,2401,6,10,5,13,33,42,-9,35
Western Sydn,2401,7,8,9,10,38,47,-9,33
Perth Glory,2401,8,10,2,15,37,50,-13,32
Wellington P,2401,9,5,6,16,31,55,-24,21
CC Mariners,2401,10,4,8,15,28,49,-21,20
Sydney FC,2402,1,20,4,4,64,23,41,64
N'castle Jet,2402,2,16,5,7,59,37,22,53
Melbourne V,2402,3,14,5,10,46,38,8,47
Melbourne C,2402,4,14,4,11,43,35,8,46
Adelaide Utd,2402,5,11,6,11,37,40,-3,39
Brisbane,2402,6,10,5,13,33,42,-9,35
Western Sydn,2402,7,8,9,10,38,47,-9,33
Perth Glory,2402,8,10,2,15,37,50,-13,32
Wellington P,2402,9,5,6,16,31,55,-24,21
CC Mariners,2402,10,4,8,15,28,49,-21,20
Sydney FC,2403,1,20,4,4,64,23,41,64
N'castle Jet,2403,2,15,5,8,58,42,16,50
Melbourne C,2403,3,15,4,10,48,34,14,49
Melbourne V,2403,4,14,5,10,46,38,8,47
Adelaide Utd,2403,5,11,6,11,37,40,-3,39
Brisbane,2403,6,10,5,13,33,42,-9,35
Western Sydn,2403,7,8,9,10,38,47,-9,33
Perth Glory,2403,8,10,2,15,37,50,-13,32
Wellington P,2403,9,5,6,16,31,55,-24,21
CC Mariners,2403,10,4,8,15,28,49,-21,20
Sydney FC,2404,1,20,5,3,65,23,42,65
N'castle Jet,2404,2,16,5,7,60,37,23,53
Melbourne C,2404,3,14,4,11,43,36,7,46
Melbourne V,2404,4,13,6,10,46,39,7,45
Adelaide Utd,2404,5,11,6,11,37,40,-3,39
Brisbane,2404,6,10,5,13,33,42,-9,35
Western Sydn,2404,7,8,9,10,38,47,-9,33
Perth Glory,2404,8,10,2,15,37,50,-13,32
Wellington P,2404,9,5,6,16,31,55,-24,21
CC Mariners,2404,10,4,8,15,28,49,-21,20
Sydney FC,2405,1,21,4,3,66,22,44,67
N'castle Jet,2405,2,16,5,7,59,37,22,53
Melbourne C,2405,3,14,4,11,43,35,8,46
Melbourne V,2405,4,13,5,11,45,40,5,44
Adelaide Utd,2405,5,11,6,11,37,40,-3,39
Brisbane,2405,6,10,5,13,33,42,-9,35
Western Sydn,2405,7,8,9,10,38,47,-9,33
Perth Glory,2405,8,10,2,15,37,50,-13,32
Wellington P,2405,9,5,6,16,31,55,-24,21
CC Mariners,2405,10,4,8,15,28,49,-21,20
Sydney FC,2406,1,20,4,4,64,23,41,64
N'castle Jet,2406,2,16,5,7,60,38,22,53
Melbourne V,2406,3,14,5,10,46,38,8,47
Melbourne C,2406,4,14,4,11,44,36,8,46
Adelaide Utd,2406,5,11,6,11,37,40,-3,39
Brisbane,2406,6,10,5,13,33,42,-9,35
Western Sydn,2406,7,8,9,10,38,47,-9,33
Perth Glory,2406,8,10,2,15,37,50,-13,32
Wellington P,2406,9,5,6,16,31,55,-24,21
CC Mariners,2406,10,4,8,15,28,49,-21,20
Sydney FC,2407,1,20,5,3,65,23,42,65
N'castle Jet,2407,2,16,5,7,59,38,21,53
Melbourne C,2407,3,14,4,11,44,35,9,46
Melbourne V,2407,4,13,6,10,46,39,7,45
Adelaide Utd,2407,5,11,6,11,37,40,-3,39
Brisbane,2407,6,10,5,13,33,42,-9,35
Western Sydn,2407,7,8,9,10,38,47,-9,33
Perth Glory,2407,8,10,2,15,37,50,-13,32
Wellington P,2407,9,5,6,16,31,55,-24,21
CC Mariners,2407,10,4,8,15,28,49,-21,20
Sydney FC,2408,1,21,4,3,65,22,43,67
N'castle Jet,2408,2,15,6,7,58,38,20,51
Melbourne C,2408,3,14,5,10,44,34,10,47
Melbourne V,2408,4,13,5,11,45,39,6,44
Adelaide Utd,2408,5,11,6,11,37,40,-3,39
Brisbane,2408,6,10,5,13,33,42,-9,35
Western Sydn,2408,7,8,9,10,38,47,-9,33
Perth Glory,2408,8,10,2,15,37,50,-13,32
Wellington P,2408,9,5,6,16,31,55,-24,21
CC Mariners,2408,10,4,8,15,28,49,-21,20
Sydney FC,2409,1,20,4,4,65,25,40,64
N'castle Jet,2409,2,15,6,7,60,40,20,51
Melbourne C,2409,3,14,5,10,46,36,10,47
Melbourne V,2409,4,14,5,10,48,39,9,47
Adelaide Utd,2409,5,11,6,11,37,40,-3,39
Brisbane,2409,6,10,5,13,33,42,-9,35
Western Sydn,2409,7,8,9,10,38,47,-9,33
Perth Glory,2409,8,10,2,15,37,50,-13,32
Wellington P,2409,9,5,6,16,31,55,-24,21
CC Mariners,2409,10,4,8,15,28,49,-21,20
Sydney FC,2410,1,21,4,3,66,22,44,67
N'castle Jet,2410,2,15,5,8,57,38,19,50
Melbourne C,2410,3,15,4,10,44,33,11,49
Melbourne V,2410,4,13,5,11,45,40,5,44
Adelaide Utd,2410,5,11,6,11,37,40,-3,39
Brisbane,2410,6,10,5,13,33,42,-9,35
Western Sydn,2410,7,8,9,10,38,47,-9,33
Perth Glory,2410,8,10,2,15,37,50,-13,32
Wellington P,2410,9,5,6,16,31,55,-24,21
CC Mariners,2410,10,4,8,15,28,49,-21,20
Sydney FC,2411,1,20,5,3,65,23,42,65
N'castle Jet,2411,2,15,6,7,59,39,20,51
Melbourne C,2411,3,14,5,10,45,35,10,47
Melbourne V,2411,4,13,6,10,46,39,7,45
Adelaide Utd,2411,5,11,6,11,37,40,-3,39
Brisbane,2411,6,10,5,13,33,42,-9,35
Western Sydn,2411,7,8,9,10,38,47,-9,33
Perth Glory,2411,8,10,2,15,37,50,-13,32
Wellington P,2411,9,5,6,16,31,55,-24,21
CC Mariners,2411,10,4,8,15,28,49,-21,20
Sydney FC,2412,1,20,5,3,65,23,42,65
N'castle Jet,2412,2,15,5,8,57,38,19,50
Melbourne C,2412,3,15,4,10,44,33,11,49
Melbourne V,2412,4,13,6,10,46,39,7,45
Adelaide Utd,2412,5,11,6,11,37,40,-3,39
Brisbane,2412,6,10,5,13,33,42,-9,35
Western Sydn,2412,7,8,9,10,38,47,-9,33
Perth Glory,2412,8,10,2,15,37,50,-13,32
Wellington P,2412,9,5,6,16,31,55,-24,21
CC Mariners,2412,10,4,8,15,28,49,-21,20
Sydney FC,2413,1,20,5,3,64,22,42,65
N'castle Jet,2413,2,15,6,7,60,40,20,51
Melbourne C,2413,3,14,5,10,46,36,10,47
Melbourne V,2413,4,13,6,10,45,38,7,45
Adelaide Utd,2413,5,11,6,11,37,40,-3,39
Brisbane,2413,6,10,5,13,33,42,-9,35
Western Sydn,2413,7,8,9,10,38,47,-9,33
Perth Glory,2413,8,10,2,15,37,50,-13,32
Wellington P,2413,9,5,6,16,31,55,-24,21
CC Mariners,2413,10,4,8,15,28,49,-21,20
Sydney FC,2414,1,20,5,3,65,23,42,65
N'castle Jet,2414,2,15,6,7,60,40,20,51
Melbourne C,2414,3,14,5,10,46,36,10,47
Melbourne V,2414,4,13,6,10,46,39,7,45
Adelaide Utd,2414,5,11,6,11,37,40,-3,39
Brisbane,2414,6,10,5,13,33,42,-9,35
Western Sydn,2414,7,8,9,10,38,47,-9,33
Perth Glory,2414,8,10,2,15,37,50,-13,32
Wellington P,2414,9,5,6,16,31,55,-24,21
CC Mariners,2414,10,4,8,15,28,49,-21,20
Sydney FC,2415,1,21,4,3,66,22,44,67
N'castle Jet,2415,2,15,6,7,57,37,20,51
Melbourne C,2415,3,14,5,10,43,33,10,47
Melbourne V,2415,4,13,5,11,45,40,5,44
Adelaide Utd,2415,5,11,6,11,37,40,-3,39
Brisbane,2415,6,10,5,13,33,42,-9,35
Western Sydn,2415,7,8,9,10,38,47,-9,33
Perth Glory,2415,8,10,2,15,37,50,-13,32
Wellington P,2415,9,5,6,16,31,55,-24,21
CC Mariners,2415,10,4,8,15,28,49,-21,20
Sydney FC,2416,1,20,5,3,64,22,42,65
N'castle Jet,2416,2,15,6,7,58,38,20,51
Melbourne C,2416,3,14,5,10,44,34,10,47
Melbourne V,2416,4,13,6,10,45,38,7,45
Adelaide Utd,2416,5,11,6,11,37,40,-3,39
Brisbane,2416,6,10,5,13,33,42,-9,35
Western Sydn,2416,7,8,9,10,38,47,-9,33
Perth Glory,2416,8,10,2,15,37,50,-13,32
Wellington P,2416,9,5,6,16,31,55,-24,21
CC Mariners,2416,10,4,8,15,28,49,-21,20
Sydney FC,2417,1,21,4,3,67,22,45,67
N'castle Jet,2417,2,15,5,8,57,38,19,50
Melbourne C,2417,3,15,4,10,44,33,11,49
Melbourne V,2417,4,13,5,11,45,41,4,44
Adelaide Utd,2417,5,11,6,11,37,40,-3,39
Brisbane,2417,6,10,5,13,33,42,-9,35
Western Sydn,2417,7,8,9,10,38,47,-9,33
Perth Glory,2417,8,10,2,15,37,50,-13,32
Wellington P,2417,9,5,6,16,31,55,-24,21
CC Mariners,2417,10,4,8,15,28,49,-21,20
Sydney FC,2418,1,21,4,3,68,24,44,67
N'castle Jet,2418,2,16,5,7,58,37,21,53
Melbourne C,2418,3,14,4,11,43,34,9,46
Melbourne V,2418,4,13,5,11,47,42,5,44
Adelaide Utd,2418,5,11,6,11,37,40,-3,39
Brisbane,2418,6,10,5,13,33,42,-9,35
Western Sydn,2418,7,8,9,10,38,47,-9,33
Perth Glory,2418,8,10,2,15,37,50,-13,32
Wellington P,2418,9,5,6,16,31,55,-24,21
CC Mariners,2418,10,4,8,15,28,49,-21,20
Sydney FC,2419,1,21,4,3,67,23,44,67
N'castle Jet,2419,2,16,5,7,60,37,23,53
Melbourne C,2419,3,14,4,11,43,36,7,46
Melbourne V,2419,4,13,5,11,46,41,5,44
Adelaide Utd,2419,5,11,6,11,37,40,-3,39
Brisbane,2419,6,10,5,13,33,42,-9,35
Western Sydn,2419,7,8,9,10,38,47,-9,33
Perth Glory,2419,8,10,2,15,37,50,-13,32
Wellington P,2419,9,5,6,16,31,55,-24,21
CC Mariners,2419,10,4,8,15,28,49,-21,20
Sydney FC,2420,1,21,4,3,66,22,44,67
N'castle Jet,2420,2,16,5,7,60,37,23,53
Melbourne C,2420,3,14,4,11,43,36,7,46
Melbourne V,2420,4,13,5,11,45,40,5,44
Adelaide Utd,2420,5,11,6,11,37,40,-3,39
Brisbane,2420,6,10,5,13,33,42,-9,35
Western Sydn,2420,7,8,9,10,38,47,-9,33
Perth Glory,2420,8,10,2,15,37,50,-13,32
Wellington P,2420,9,5,6,16,31,55,-24,21
CC Mariners,2420,10,4,8,15,28,49,-21,20
Sydney FC,2421,1,21,4,3,65,22,43,67
N'castle Jet,2421,2,15,6,7,59,39,20,51
Melbourne C,2421,3,14,5,10,45,35,10,47
Melbourne V,2421,4,13,5,11,45,39,6,44
Adelaide Utd,2421,5,11,6,11,37,40,-3,39
Brisbane,2421,6,10,5,13,33,42,-9,35
Western Sydn,2421,7,8,9,10,38,47,-9,33
Perth Glory,2421,8,10,2,15,37,50,-13,32
Wellington P,2421,9,5,6,16,31,55,-24,21
CC Mariners,2421,10,4,8,15,28,49,-21,20
Sydney FC,2422,1,21,4,3,65,22,43,67
N'castle Jet,2422,2,15,6,7,60,40,20,51
Melbourne C,2422,3,14,5,10,46,36,10,47
Melbourne V,2422,4,13,5,11,45,39,6,44
Adelaide Utd,2422,5,11,6,11,37,40,-3,39
Brisbane,2422,6,10,5,13,33,42,-9,35
Western Sydn,2422,7,8,9,10,38,47,-9,33
Perth Glory,2422,8,10,2,15,37,50,-13,32
Wellington P,2422,9,5,6,16,31,55,-24,21
CC Mariners,2422,10,4,8,15,28,49,-21,20
Sydney FC,2423,1,20,5,3,64,22,42,65
N'castle Jet,2423,2,16,5,7,58,37,21,53
Melbourne C,2423,3,14,4,11,43,34,9,46
Melbourne V,2423,4,13,6,10,45,38,7,45
Adelaide Utd,2423,5,11,6,11,37,40,-3,39
Brisbane,2423,6,10,5,13,33,42,-9,35
Western Sydn,2423,7,8,9,10,38,47,-9,33
Perth Glory,2423,8,10,2,15,37,50,-13,32
Wellington P,2423,9,5,6,16,31,55,-24,21
CC Mariners,2423,10,4,8,15,28,49,-21,20
Sydney FC,2424,1,20,5,3,66,24,42,65
N'castle Jet,2424,2,16,5,7,59,37,22,53
Melbourne C,2424,3,14,4,11,43,35,8,46
Melbourne V,2424,4,13,6,10,47,40,7,45
Adelaide Utd,2424,5,11,6,11,37,40,-3,39
Brisbane,2424,6,10,5,13,33,42,-9,35
Western Sydn,2424,7,8,9,10,38,47,-9,33
Perth Glory,2424,8,10,2,15,37,50,-13,32
Wellington P,2424,9,5,6,16,31,55,-24,21
CC Mariners,2424,10,4,8,15,28,49,-21,20
Sydney FC,2425,1,21,4,3,67,23,44,67
N'castle Jet,2425,2,15,5,8,57,40,17,50
Melbourne C,2425,3,15,4,10,46,33,13,49
Melbourne V,2425,4,13,5,11,46,41,5,44
Adelaide Utd,2425,5,11,6,11,37,40,-3,39
Brisbane,2425,6,10,5,13,33,42,-9,35
Western Sydn,2425,7,8,9,10,38,47,-9,33
Perth Glory,2425,8,10,2,15,37,50,-13,32
Wellington P,2425,9,5,6,16,31,55,-24,21
CC Mariners,2425,10,4,8,15,28,49,-21,20
Sydney FC,2426,1,21,4,3,67,23,44,67
N'castle Jet,2426,2,15,6,7,60,40,20,51
Melbourne C,2426,3,14,5,10,46,36,10,47
Melbourne V,2426,4,13,5,11,46,41,5,44
Adelaide Utd,2426,5,11,6,11,37,40,-3,39
Brisbane,2426,6,10,5,13,33,42,-9,35
Western Sydn,2426,7,8,9,10,38,47,-9,33
Perth Glory,2426,8,10,2,15,37,50,-13,32
Wellington P,2426,9,5,6,16,31,55,-24,21
CC Mariners,2426,10,4,8,15,28,49,-21,20
Sydney FC,2427,1,20,4,4,64,23,41,64
N'castle Jet,2427,2,15,5,8,57,38,19,50
Melbourne C,2427,3,15,4,10,44,33,11,49
Melbourne V,2427,4,14,5,10,46,38,8,47
Adelaide Utd,2427,5,11,6,11,37,40,-3,39
Brisbane,2427,6,10,5,13,33,42,-9,35
Western Sydn,2427,7,8,9,10,38,47,-9,33
Perth Glory,2427,8,10,2,15,37,50,-13,32
Wellington P,2427,9,5,6,16,31,55,-24,21
CC Mariners,2427,10,4,8,15,28,49,-21,20
Sydney FC,2428,1,20,4,4,64,25,39,64
N'castle Jet,2428,2,16,5,7,61,38,23,53
Melbourne V,2428,3,14,5,10,48,38,10,47
Melbourne C,2428,4,14,4,11,44,37,7,46
Adelaide Utd,2428,5,11,6,11,37,40,-3,39
Brisbane,2428,6,10,5,13,33,42,-9,35
Western Sydn,2428,7,8,9,10,38,47,-9,33
Perth Glory,2428,8,10,2,15,37,50,-13,32
Wellington P,2428,9,5,6,16,31,55,-24,21
CC Mariners,2428,10,4,8,15,28,49,-21,20
Sydney FC,2429,1,20,5,3,66,24,42,65
N'castle Jet,2429,2,15,5,8,58,40,18,50
Melbourne C,2429,3,15,4,10,46,34,12,49
Melbourne V,2429,4,13,6,10,47,40,7,45
Adelaide Utd,2429,5,11,6,11,37,40,-3,39
Brisbane,2429,6,10,5,13,33,42,-9,35
Western Sydn,2429,7,8,9,10,38,47,-9,33
Perth Glory,2429,8,10,2,15,37,50,-13,32
Wellington P,2429,9,5,6,16,31,55,-24,21
CC Mariners,2429,10,4,8,15,28,49,-21,20
Sydney FC,2430,1,21,4,3,68,24,44,67
N'castle Jet,2430,2,16,5,7,59,37,22,53
Melbourne C,2430,3,14,4,11,43,35,8,46
Melbourne V,2430,4,13,5,11,47,42,5,44
Adelaide Utd,2430,5,11,6,11,37,40,-3,39
Brisbane,2430,6,10,5,13,33,42,-9,35
Western Sydn,2430,7,8,9,10,38,47,-9,33
Perth Glory,2430,8,10,2,15,37,50,-13,32
Wellington P,2430,9,5,6,16,31,55,-24,21
CC Mariners,2430,10,4,8,15,28,49,-21,20
Sydney FC,2431,1,21,4,3,67,24,43,67
N'castle Jet,2431,2,16,5,7,60,37,23,53
Melbourne C,2431,3,14,4,11,43,36,7,46
Melbourne V,2431,4,13,5,11,47,41,6,44
Adelaide Utd,2431,5,11,6,11,37,40,-3,39
Brisbane,2431,6,10,5,13,33,42,-9,35
Western Sydn,2431,7,8,9,10,38,47,-9,33
Perth Glory,2431,8,10,2,15,37,50,-13,32
Wellington P,2431,9,5,6,16,31,55,-24,21
CC Mariners,2431,10,4,8,15,28,49,-21,20
Sydney FC,2432,1,20,4,4,66,25,41,64
N'castle Jet,2432,2,16,5,7,59,37,22,53
Melbourne V,2432,3,14,5,10,48,40,8,47
Melbourne C,2432,4,14,4,11,43,35,8,46
Adelaide Utd,2432,5,11,6,11,37,40,-3,39
Brisbane,2432,6,10,5,13,33,42,-9,35
Western Sydn,2432,7,8,9,10,38,47,-9,33
Perth Glory,2432,8,10,2,15,37,50,-13,32
Wellington P,2432,9,5,6,16,31,55,-24,21
CC Mariners,2432,10,4,8,15,28,49,-21,20
Sydney FC,2433,1,21,4,3,66,23,43,67
N'castle Jet,2433,2,16,5,7,59,38,21,53
Melbourne C,2433,3,14,4,11,44,35,9,46
Melbourne V,2433,4,13,5,11,46,40,6,44
Adelaide Utd,2433,5,11,6,11,37,40,-3,39
Brisbane,2433,6,10,5,13,33,42,-9,35
Western Sydn,2433,7,8,9,10,38,47,-9,33
Perth Glory,2433,8,10,2,15,37,50,-13,32
Wellington P,2433,9,5,6,16,31,55,-24,21
CC Mariners,2433,10,4,8,15,28,49,-21,20
Sydney FC,2434,1,20,4,4,66,25,41,64
N'castle Jet,2434,2,15,6,7,58,38,20,51
Melbourne C,2434,3,14,5,10,44,34,10,47
Melbourne V,2434,4,14,5,10,48,40,8,47
Adelaide Utd,2434,5,11,6,11,37,40,-3,39
Brisbane,2434,6,10,5,13,33,42,-9,35
Western Sydn,2434,7,8,9,10,38,47,-9,33
Perth Glory,2434,8,10,2,15,37,50,-13,32
Wellington P,2434,9,5,6,16,31,55,-24,21
CC Mariners,2434,10,4,8,15,28,49,-21,20
Sydney FC,2435,1,21,4,3,69,24,45,67
N'castle Jet,2435,2,15,6,7,57,37,20,51
Melbourne C,2435,3,14,5,10,43,33,10,47
Melbourne V,2435,4,13,5,11,47,43,4,44
Adelaide Utd,2435,5,11,6,11,37,40,-3,39
Brisbane,2435,6,10,5,13,33,42,-9,35
Western Sydn,2435,7,8,9,10,38,47,-9,33
Perth Glory,2435,8,10,2,15,37,50,-13,32
Wellington P,2435,9,5,6,16,31,55,-24,21
CC Mariners,2435,10,4,8,15,28,49,-21,20
Sydney FC,2436,1,21,4,3,65,22,43,67
N'castle Jet,2436,2,16,5,7,59,37,22,53
Melbourne C,2436,3,14,4,11,43,35,8,46
Melbourne V,2436,4,13,5,11,45,39,6,44
Adelaide Utd,2436,5,11,6,11,37,40,-3,39
Brisbane,2436,6,10,5,13,33,42,-9,35
Western Sydn,2436,7,8,9,10,38,47,-9,33
Perth Glory,2436,8,10,2,15,37,50,-13,32
Wellington P,2436,9,5,6,16,31,55,-24,21
CC Mariners,2436,10,4,8,15,28,49,-21,20
Sydney FC,2437,1,21,4,3,67,24,43,67
N'castle Jet,2437,2,16,5,7,60,38,22,53
Melbourne C,2437,3,14,4,11,44,36,8,46
Melbourne V,2437,4,13,5,11,47,41,6,44
Adelaide Utd,2437,5,11,6,11,37,40,-3,39
Brisbane,2437,6,10,5,13,33,42,-9,35
Western Sydn,2437,7,8,9,10,38,47,-9,33
Perth Glory,2437,8,10,2,15,37,50,-13,32
Wellington P,2437,9,5,6,16,31,55,-24,21
CC Mariners,2437,10,4,8,15,28,49,-21,20
Sydney FC,2438,1,20,5,3,66,24,42,65
N'castle Jet,2438,2,16,5,7,59,38,21,53
Melbourne C,2438,3,14,4,11,44,35,9,46
Melbourne V,2438,4,13,6,10,47,40,7,45
Adelaide Utd,2438,5,11,6,11,37,40,-3,39
Brisbane,2438,6,10,5,13,33,42,-9,35
Western Sydn,2438,7,8,9,10,38,47,-9,33
Perth Glory,2438,8,10,2,15,37,50,-13,32
Wellington P,2438,9,5,6,16,31,55,-24,21
CC Mariners,2438,10,4,8,15,28,49,-21,20
Sydney FC,2439,1,21,4,3,65,22,43,67
N'castle Jet,2439,2,15,5,8,57,40,17,50
Melbourne C,2439,3,15,4,10,46,33,13,49
Melbourne V,2439,4,13,5,11,45,39,6,44
Adelaide Utd,2439,5,11,6,11,37,40,-3,39
Brisbane,2439,6,10,5,13,33,42,-9,35
Western Sydn,2439,7,8,9,10,38,47,-9,33
Perth Glory,2439,8,10,2,15,37,50,-13,32
Wellington P,2439,9,5,6,16,31,55,-24,21
CC Mariners,2439,10,4,8,15,28,49,-21,20
Sydney FC,2440,1,21,4,3,67,23,44,67
N'castle Jet,2440,2,16,5,7,61,38,23,53
Melbourne C,2440,3,14,4,11,44,37,7,46
Melbourne V,2440,4,13,5,11,46,41,5,44
Adelaide Utd,2440,5,11,6,11,37,40,-3,39
Brisbane,2440,6,10,5,13,33,42,-9,35
Western Sydn,2440,7,8,9,10,38,47,-9,33
Perth Glory,2440,8,10,2,15,37,50,-13,32
Wellington P,2440,9,5,6,16,31,55,-24,21
CC Mariners,2440,10,4,8,15,28,49,-21,20
Sydney FC,2441,1,21,4,3,69,23,46,67
N'castle Jet,2441,2,15,5,8,59,40,19,50
Melbourne C,2441,3,15,4,10,46,35,11,49
Melbourne V,2441,4,13,5,11,46,43,3,44
Adelaide Utd,2441,5,11,6,11,37,40,-3,39
Brisbane,2441,6,10,5,13,33,42,-9,35
Western Sydn,2441,7,8,9,10,38,47,-9,33
Perth Glory,2441,8,10,2,15,37,50,-13,32
Wellington P,2441,9,5,6,16,31,55,-24,21
CC Mariners,2441,10,4,8,15,28,49,-21,20
Sydney FC,2442,1,21,4,3,67,24,43,67
N'castle Jet,2442,2,15,5,8,58,39,19,50
Melbourne C,2442,3,15,4,10,45,34,11,49
Melbourne V,2442,4,13,5,11,47,41,6,44
Adelaide Utd,2442,5,11,6,11,37,40,-3,39
Brisbane,2442,6,10,5,13,33,42,-9,35
Western Sydn,2442,7,8,9,10,38,47,-9,33
Perth Glory,2442,8,10,2,15,37,50,-13,32
Wellington P,2442,9,5,6,16,31,55,-24,21
CC Mariners,2442,10,4,8,15,28,49,-21,20
Sydney FC,2443,1,21,4,3,66,23,43,67
N'castle Jet,2443,2,15,5,8,57,41,16,50
Melbourne C,2443,3,15,4,10,47,33,14,49
Melbourne V,2443,4,13,5,11,46,40,6,44
Adelaide Utd,2443,5,11,6,11,37,40,-3,39
Brisbane,2443,6,10,5,13,33,42,-9,35
Western Sydn,2443,7,8,9,10,38,47,-9,33
Perth Glory,2443,8,10,2,15,37,50,-13,32
Wellington P,2443,9,5,6,16,31,55,-24,21
CC Mariners,2443,10,4,8,15,28,49,-21,20
Sydney FC,2444,1,21,4,3,68,22,46,67
N'castle Jet,2444,2,15,5,8,57,40,17,50
Melbourne C,2444,3,15,4,10,46,33,13,49
Melbourne V,2444,4,13,5,11,45,42,3,44
Adelaide Utd,2444,5,11,6,11,37,40,-3,39
Brisbane,2444,6,10,5,13,33,42,-9,35
Western Sydn,2444,7,8,9,10,38,47,-9,33
Perth Glory,2444,8,10,2,15,37,50,-13,32
Wellington P,2444,9,5,6,16,31,55,-24,21
CC Mariners,2444,10,4,8,15,28,49,-21,20
Sydney FC,2445,1,20,5,3,64,22,42,65
N'castle Jet,2445,2,16,5,7,58,37,21,53
Melbourne C,2445,3,14,4,11,43,34,9,46
Melbourne V,2445,4,13,6,10,45,38,7,45
Adelaide Utd,2445,5,11,6,11,37,40,-3,39
Brisbane,2445,6,10,5,13,33,42,-9,35
Western Sydn,2445,7,8,9,10,38,47,-9,33
Perth Glory,2445,8,10,2,15,37,50,-13,32
Wellington P,2445,9,5,6,16,31,55,-24,21
CC Mariners,2445,10,4,8,15,28,49,-21,20
Sydney FC,2446,1,21,4,3,67,22,45,67
N'castle Jet,2446,2,16,5,7,61,37,24,53
Melbourne C,2446,3,14,4,11,43,37,6,46
Melbourne V,2446,4,13,5,11,45,41,4,44
Adelaide Utd,2446,5,11,6,11,37,40,-3,39
Brisbane,2446,6,10,5,13,33,42,-9,35
Western Sydn,2446,7,8,9,10,38,47,-9,33
Perth Glory,2446,8,10,2,15,37,50,-13,32
Wellington P,2446,9,5,6,16,31,55,-24,21
CC Mariners,2446,10,4,8,15,28,49,-21,20
Sydney FC,2447,1,21,4,3,66,22,44,67
N'castle Jet,2447,2,15,6,7,57,37,20,51
Melbourne C,2447,3,14,5,10,43,33,10,47
Melbourne V,2447,4,13,5,11,45,40,5,44
Adelaide Utd,2447,5,11,6,11,37,40,-3,39
Brisbane,2447,6,10,5,13,33,42,-9,35
Western Sydn,2447,7,8,9,10,38,47,-9,33
Perth Glory,2447,8,10,2,15,37,50,-13,32
Wellington P,2447,9,5,6,16,31,55,-24,21
CC Mariners,2447,10,4,8,15,28,49,-21,20
Sydney FC,2448,1,21,4,3,66,22,44,67
N'castle Jet,2448,2,16,5,7,59,38,21,53
Melbourne C,2448,3,14,4,11,44,35,9,46
Melbourne V,2448,4,13,5,11,45,40,5,44
Adelaide Utd,2448,5,11,6,11,37,40,-3,39
Brisbane,2448,6,10,5,13,33,42,-9,35
Western Sydn,2448,7,8,9,10,38,47,-9,33
Perth Glory,2448,8,10,2,15,37,50,-13,32
Wellington P,2448,9,5,6,16,31,55,-24,21
CC Mariners,2448,10,4,8,15,28,49,-21,20
Sydney FC,2449,1,21,4,3,66,23,43,67
N'castle Jet,2449,2,16,5,7,58,37,21,53
Melbourne C,2449,3,14,4,11,43,34,9,46
Melbourne V,2449,4,13,5,11,46,40,6,44
Adelaide Utd,2449,5,11,6,11,37,40,-3,39
Brisbane,2449,6,10,5,13,33,42,-9,35
Western Sydn,2449,7,8,9,10,38,47,-9,33
Perth Glory,2449,8,10,2,15,37,50,-13,32
Wellington P,2449,9,5,6,16,31,55,-24,21
CC Mariners,2449,10,4,8,15,28,49,-21,20
Sydney FC,2450,1,20,4,4,65,25,40,64
N'castle Jet,2450,2,15,5,8,59,40,19,50
Melbourne C,2450,3,15,4,10,46,35,11,49
Melbourne V,2450,4,14,5,10,48,39,9,47
Adelaide Utd,2450,5,11,6,11,37,40,-3,39
Brisbane,2450,6,10,5,13,33,42,-9,35
Western Sydn,2450,7,8,9,10,38,47,-9,33
Perth Glory,2450,8,10,2,15,37,50,-13,32
Wellington P,2450,9,5,6,16,31,55,-24,21
CC Mariners,2450,10,4,8,15,28,49,-21,20
Sydney FC,2451,1,20,4,4,64,24,40,64
N'castle Jet,2451,2,15,6,7,57,37,20,51
Melbourne C,2451,3,14,5,10,43,33,10,47
Melbourne V,2451,4,14,5,10,47,38,9,47
Adelaide Utd,2451,5,11,6,11,37,40,-3,39
Brisbane,2451,6,10,5,13,33,42,-9,35
Western Sydn,2451,7,8,9,10,38,47,-9,33
Perth Glory,2451,8,10,2,15,37,50,-13,32
Wellington P,2451,9,5,6,16,31,55,-24,21
CC Mariners,2451,10,4,8,15,28,49,-21,20
Sydney FC,2452,1,20,4,4,66,25,41,64
N'castle Jet,2452,2,16,5,7,59,37,22,53
Melbourne V,2452,3,14,5,10,48,40,8,47
Melbourne C,2452,4,14,4,11,43,35,8,46
Adelaide Utd,2452,5,11,6,11,37,40,-3,39
Brisbane,2452,6,10,5,13,33,42,-9,35
Western Sydn,2452,7,8,9,10,38,47,-9,33
Perth Glory,2452,8,10,2,15,37,50,-13,32
Wellington P,2452,9,5,6,16,31,55,-24,21
CC Mariners,2452,10,4,8,15,28,49,-21,20
Sydney FC,2453,1,20,5,3,66,24,42,65
N'castle Jet,2453,2,15,6,7,60,40,20,51
Melbourne C,2453,3,14,5,10,46,36,10,47
Melbourne V,2453,4,13,6,10,47,40,7,45
Adelaide Utd,2453,5,11,6,11,37,40,-3,39
Brisbane,2453,6,10,5,13,33,42,-9,35
Western Sydn,2453,7,8,9,10,38,47,-9,33
Perth Glory,2453,8,10,2,15,37,50,-13,32
Wellington P,2453,9,5,6,16,31,55,-24,21
CC Mariners,2453,10,4,8,15,28,49,-21,20
Sydney FC,2454,1,21,4,3,69,24,45,67
N'castle Jet,2454,2,15,6,7,60,40,20,51
Melbourne C,2454,3,14,5,10,46,36,10,47
Melbourne V,2454,4,13,5,11,47,43,4,44
Adelaide Utd,2454,5,11,6,11,37,40,-3,39
Brisbane,2454,6,10,5,13,33,42,-9,35
Western Sydn,2454,7,8,9,10,38,47,-9,33
Perth Glory,2454,8,10,2,15,37,50,-13,32
Wellington P,2454,9,5,6,16,31,55,-24,21
CC Mariners,2454,10,4,8,15,28,49,-21,20
Sydney FC,2455,1,20,5,3,68,26,42,65
N'castle Jet,2455,2,15,5,8,57,38,19,50
Melbourne C,2455,3,15,4,10,44,33,11,49
Melbourne V,2455,4,13,6,10,49,42,7,45
Adelaide Utd,2455,5,11,6,11,37,40,-3,39
Brisbane,2455,6,10,5,13,33,42,-9,35
Western Sydn,2455,7,8,9,10,38,47,-9,33
Perth Glory,2455,8,10,2,15,37,50,-13,32
Wellington P,2455,9,5,6,16,31,55,-24,21
CC Mariners,2455,10,4,8,15,28,49,-21,20
Sydney FC,2456,1,21,4,3,67,24,43,67
N'castle Jet,2456,2,16,5,7,59,37,22,53
Melbourne C,2456,3,14,4,11,43,35,8,46
Melbourne V,2456,4,13,5,11,47,41,6,44
Adelaide Utd,2456,5,11,6,11,37,40,-3,39
Brisbane,2456,6,10,5,13,33,42,-9,35
Western Sydn,2456,7,8,9,10,38,47,-9,33
Perth Glory,2456,8,10,2,15,37,50,-13,32
Wellington P,2456,9,5,6,16,31,55,-24,21
CC Mariners,2456,10,4,8,15,28,49,-21,20
Sydney FC,2457,1,21,4,3,69,25,44,67
N'castle Jet,2457,2,15,6,7,58,38,20,51
Melbourne C,2457,3,14,5,10,44,34,10,47
Melbourne V,2457,4,13,5,11,48,43,5,44
Adelaide Utd,2457,5,11,6,11,37,40,-3,39
Brisbane,2457,6,10,5,13,33,42,-9,35
Western Sydn,2457,7,8,9,10,38,47,-9,33
Perth Glory,2457,8,10,2,15,37,50,-13,32
Wellington P,2457,9,5,6,16,31,55,-24,21
CC Mariners,2457,10,4,8,15,28,49,-21,20
Sydney FC,2458,1,20,4,4,64,24,40,64
N'castle Jet,2458,2,16,5,7,59,38,21,53
Melbourne V,2458,3,14,5,10,47,38,9,47
Melbourne C,2458,4,14,4,11,44,35,9,46
Adelaide Utd,2458,5,11,6,11,37,40,-3,39
Brisbane,2458,6,10,5,13,33,42,-9,35
Western Sydn,2458,7,8,9,10,38,47,-9,33
Perth Glory,2458,8,10,2,15,37,50,-13,32
Wellington P,2458,9,5,6,16,31,55,-24,21
CC Mariners,2458,10,4,8,15,28,49,-21,20
Sydney FC,2459,1,20,5,3,64,22,42,65
N'castle Jet,2459,2,16,5,7,60,38,22,53
Melbourne C,2459,3,14,4,11,44,36,8,46
Melbourne V,2459,4,13,6,10,45,38,7,45
Adelaide Utd,2459,5,11,6,11,37,40,-3,39
Brisbane,2459,6,10,5,13,33,42,-9,35
Western Sydn,2459,7,8,9,10,38,47,-9,33
Perth Glory,2459,8,10,2,15,37,50,-13,32
Wellington P,2459,9,5,6,16,31,55,-24,21
CC Mariners,2459,10,4,8,15,28,49,-21,20
Sydney FC,2460,1,21,4,3,68,24,44,67
N'castle Jet,2460,2,15,5,8,57,39,18,50
Melbourne C,2460,3,15,4,10,45,33,12,49
Melbourne V,2460,4,13,5,11,47,42,5,44
Adelaide Utd,2460,5,11,6,11,37,40,-3,39
Brisbane,2460,6,10,5,13,33,42,-9,35
Western Sydn,2460,7,8,9,10,38,47,-9,33
Perth Glory,2460,8,10,2,15,37,50,-13,32
Wellington P,2460,9,5,6,16,31,55,-24,21
CC Mariners,2460,10,4,8,15,28,49,-21,20
Sydney FC,2461,1,21,4,3,67,23,44,67
N'castle Jet,2461,2,16,5,7,59,37,22,53
Melbourne C,2461,3,14,4,11,43,35,8,46
Melbourne V,2461,4,13,5,11,46,41,5,44
Adelaide Utd,2461,5,11,6,11,37,40,-3,39
Brisbane,2461,6,10,5,13,33,42,-9,35
Western Sydn,2461,7,8,9,10,38,47,-9,33
Perth Glory,2461,8,10,2,15,37,50,-13,32
Wellington P,2461,9,5,6,16,31,55,-24,21
CC Mariners,2461,10,4,8,15,28,49,-21,20
Sydney FC,2462,1,21,4,3,66,22,44,67
N'castle Jet,2462,2,16,5,7,60,37,23,53
Melbourne C,2462,3,14,4,11,43,36,7,46
Melbourne V,2462,4,13,5,11,45,40,5,44
Adelaide Utd,2462,5,11,6,11,37,40,-3,39
Brisbane,2462,6,10,5,13,33,42,-9,35
Western Sydn,2462,7,8,9,10,38,47,-9,33
Perth Glory,2462,8,10,2,15,37,50,-13,32
Wellington P,2462,9,5,6,16,31,55,-24,21
CC Mariners,2462,10,4,8,15,28,49,-21,20
Sydney FC,2463,1,20,4,4,64,23,41,64
N'castle Jet,2463,2,16,5,7,59,38,21,53
Melbourne V,2463,3,14,5,10,46,38,8,47
Melbourne C,2463,4,14,4,11,44,35,9,46
Adelaide Utd,2463,5,11,6,11,37,40,-3,39
Brisbane,2463,6,10,5,13,33,42,-9,35
Western Sydn,2463,7,8,9,10,38,47,-9,33
Perth Glory,2463,8,10,2,15,37,50,-13,32
Wellington P,2463,9,5,6,16,31,55,-24,21
CC Mariners,2463,10,4,8,15,28,49,-21,20
Sydney FC,2464,1,21,4,3,67,22,45,67
N'castle Jet,2464,2,16,5,7,59,38,21,53
Melbourne C,2464,3,14,4,11,44,35,9,46
Melbourne V,2464,4,13,5,11,45,41,4,44
Adelaide Utd,2464,5,11,6,11,37,40,-3,39
Brisbane,2464,6,10,5,13,33,42,-9,35
Western Sydn,2464,7,8,9,10,38,47,-9,33
Perth Glory,2464,8,10,2,15,37,50,-13,32
Wellington P,2464,9,5,6,16,31,55,-24,21
CC Mariners,2464,10,4,8,15,28,49,-21,20
Sydney FC,2465,1,21,4,3,69,23,46,67
N'castle Jet,2465,2,15,5,8,57,38,19,50
Melbourne C,2465,3,15,4,10,44,33,11,49
Melbourne V,2465,4,13,5,11,46,43,3,44
Adelaide Utd,2465,5,11,6,11,37,40,-3,39
Brisbane,2465,6,10,5,13,33,42,-9,35
Western Sydn,2465,7,8,9,10,38,47,-9,33
Perth Glory,2465,8,10,2,15,37,50,-13,32
Wellington P,2465,9,5,6,16,31,55,-24,21
CC Mariners,2465,10,4,8,15,28,49,-21,20
Sydney FC,2466,1,20,4,4,64,23,41,64
N'castle Jet,2466,2,15,5,8,57,38,19,50
Melbourne C,2466,3,15,4,10,44,33,11,49
Melbourne V,2466,4,14,5,10,46,38,8,47
Adelaide Utd,2466,5,11,6,11,37,40,-3,39
Brisbane,2466,6,10,5,13,33,42,-9,35
Western Sydn,2466,7,8,9,10,38,47,-9,33
Perth Glory,2466,8,10,2,15,37,50,-13,32
Wellington P,2466,9,5,6,16,31,55,-24,21
CC Mariners,2466,10,4,8,15,28,49,-21,20
Sydney FC,2467,1,21,4,3,68,23,45,67
N'castle Jet,2467,2,16,5,7,61,38,23,53
Melbourne C,2467,3,14,4,11,44,37,7,46
Melbourne V,2467,4,13,5,11,46,42,4,44
Adelaide Utd,2467,5,11,6,11,37,40,-3,39
Brisbane,2467,6,10,5,13,33,42,-9,35
Western Sydn,2467,7,8,9,10,38,47,-9,33
Perth Glory,2467,8,10,2,15,37,50,-13,32
Wellington P,2467,9,5,6,16,31,55,-24,21
CC Mariners,2467,10,4,8,15,28,49,-21,20
Sydney FC,2468,1,21,4,3,67,22,45,67
N'castle Jet,2468,2,15,6,7,58,38,20,51
Melbourne C,2468,3,14,5,10,44,34,10,47
Melbourne V,2468,4,13,5,11,45,41,4,44
Adelaide Utd,2468,5,11,6,11,37,40,-3,39
Brisbane,2468,6,10,5,13,33,42,-9,35
Western Sydn,2468,7,8,9,10,38,47,-9,33
Perth Glory,2468,8,10,2,15,37,50,-13,32
Wellington P,2468,9,5,6,16,31,55,-24,21
CC Mariners,2468,10,4,8,15,28,49,-21,20
Sydney FC,2469,1,21,4,3,66,23,43,67
N'castle Jet,2469,2,15,6,7,59,39,20,51
Melbourne C,2469,3,14,5,10,45,35,10,47
Melbourne V,2469,4,13,5,11,46,40,6,44
Adelaide Utd,2469,5,11,6,11,37,40,-3,39
Brisbane,2469,6,10,5,13,33,42,-9,35
Western Sydn,2469,7,8,9,10,38,47,-9,33
Perth Glory,2469,8,10,2,15,37,50,-13,32
Wellington P,2469,9,5,6,16,31,55,-24,21
CC Mariners,2469,10,4,8,15,28,49,-21,20
Sydney FC,2470,1,21,4,3,68,22,46,67
N'castle Jet,2470,2,16,5,7,60,38,22,53
Melbourne C,2470,3,14,4,11,44,36,8,46
Melbourne V,2470,4,13,5,11,45,42,3,44
Adelaide Utd,2470,5,11,6,11,37,40,-3,39
Brisbane,2470,6,10,5,13,33,42,-9,35
Western Sydn,2470,7,8,9,10,38,47,-9,33
Perth Glory,2470,8,10,2,15,37,50,-13,32
Wellington P,2470,9,5,6,16,31,55,-24,21
CC Mariners,2470,10,4,8,15,28,49,-21,20
Sydney FC,2471,1,21,4,3,66,23,43,67
N'castle Jet,2471,2,15,5,8,58,39,19,50
Melbourne C,2471,3,15,4,10,45,34,11,49
Melbourne V,2471,4,13,5,11,46,40,6,44
Adelaide Utd,2471,5,11,6,11,37,40,-3,39
Brisbane,2471,6,10,5,13,33,42,-9,35
Western Sydn,2471,7,8,9,10,38,47,-9,33
Perth Glory,2471,8,10,2,15,37,50,-13,32
Wellington P,2471,9,5,6,16,31,55,-24,21
CC Mariners,2471,10,4,8,15,28,49,-21,20
Sydney FC,2472,1,21,4,3,68,22,46,67
N'castle Jet,2472,2,16,5,7,59,38,21,53
Melbourne C,2472,3,14,4,11,44,35,9,46
Melbourne V,2472,4,13,5,11,45,42,3,44
Adelaide Utd,2472,5,11,6,11,37,40,-3,39
Brisbane,2472,6,10,5,13,33,42,-9,35
Western Sydn,2472,7,8,9,10,38,47,-9,33
Perth Glory,2472,8,10,2,15,37,50,-13,32
Wellington P,2472,9,5,6,16,31,55,-24,21
CC Mariners,2472,10,4,8,15,28,49,-21,20
Sydney FC,2473,1,20,4,4,64,23,41,64
N'castle Jet,2473,2,16,5,7,61,38,23,53
Melbourne V,2473,3,14,5,10,46,38,8,47
Melbourne C,2473,4,14,4,11,44,37,7,46
Adelaide Utd,2473,5,11,6,11,37,40,-3,39
Brisbane,2473,6,10,5,13,33,42,-9,35
Western Sydn,2473,7,8,9,10,38,47,-9,33
Perth Glory,2473,8,10,2,15,37,50,-13,32
Wellington P,2473,9,5,6,16,31,55,-24,21
CC Mariners,2473,10,4,8,15,28,49,-21,20
Sydney FC,2474,1,20,4,4,64,24,40,64
N'castle Jet,2474,2,15,6,7,57,37,20,51
Melbourne C,2474,3,14,5,10,43,33,10,47
Melbourne V,2474,4,14,5,10,47,38,9,47
Adelaide Utd,2474,5,11,6,11,37,40,-3,39
Brisbane,2474,6,10,5,13,33,42,-9,35
Western Sydn,2474,7,8,9,10,38,47,-9,33
Perth Glory,2474,8,10,2,15,37,50,-13,32
Wellington P,2474,9,5,6,16,31,55,-24,21
CC Mariners,2474,10,4,8,15,28,49,-21,20
Sydney FC,2475,1,21,4,3,68,22,46,67
N'castle Jet,2475,2,15,6,7,58,38,20,51
Melbourne C,2475,3,14,5,10,44,34,10,47
Melbourne V,2475,4,13,5,11,45,42,3,44
Adelaide Utd,2475,5,11,6,11,37,40,-3,39
Brisbane,2475,6,10,5,13,33,42,-9,35
Western Sydn,2475,7,8,9,10,38,47,-9,33
Perth Glory,2475,8,10,2,15,37,50,-13,32
Wellington P,2475,9,5,6,16,31,55,-24,21
CC Mariners,2475,10,4,8,15,28,49,-21,20
Sydney FC,2476,1,21,4,3,65,22,43,67
N'castle Jet,2476,2,15,6,7,59,39,20,51
Melbourne C,2476,3,14,5,10,45,35,10,47
Melbourne V,2476,4,13,5,11,45,39,6,44
Adelaide Utd,2476,5,11,6,11,37,40,-3,39
Brisbane,2476,6,10,5,13,33,42,-9,35
Western Sydn,2476,7,8,9,10,38,47,-9,33
Perth Glory,2476,8,10,2,15,37,50,-13,32
Wellington P,2476,9,5,6,16,31,55,-24,21
CC Mariners,2476,10,4,8,15,28,49,-21,20
Sydney FC,2477,1,20,4,4,64,24,40,64
N'castle Jet,2477,2,16,5,7,59,38,21,53
Melbourne V,2477,3,14,5,10,47,38,9,47
Melbourne C,2477,4,14,4,11,44,35,9,46
Adelaide Utd,2477,5,11,6,11,37,40,-3,39
Brisbane,2477,6,10,5,13,33,42,-9,35
Western Sydn,2477,7,8,9,10,38,47,-9,33
Perth Glory,2477,8,10,2,15,37,50,-13,32
Wellington P,2477,9,5,6,16,31,55,-24,21
CC Mariners,2477,10,4,8,15,28,49,-21,20
Sydney FC,2478,1,21,4,3,66,22,44,67
N'castle Jet,2478,2,16,5,7,62,39,23,53
Melbourne C,2478,3,14,4,11,45,38,7,46
Melbourne V,2478,4,13,5,11,45,40,5,44
Adelaide Utd,2478,5,11,6,11,37,40,-3,39
Brisbane,2478,6,10,5,13,33,42,-9,35
Western Sydn,2478,7,8,9,10,38,47,-9,33
Perth Glory,2478,8,10,2,15,37,50,-13,32
Wellington P,2478,9,5,6,16,31,55,-24,21
CC Mariners,2478,10,4,8,15,28,49,-21,20
Sydney FC,2479,1,21,4,3,68,24,44,67
N'castle Jet,2479,2,16,5,7,58,37,21,53
Melbourne C,2479,3,14,4,11,43,34,9,46
Melbourne V,2479,4,13,5,11,47,42,5,44
Adelaide Utd,2479,5,11,6,11,37,40,-3,39
Brisbane,2479,6,10,5,13,33,42,-9,35
Western Sydn,2479,7,8,9,10,38,47,-9,33
Perth Glory,2479,8,10,2,15,37,50,-13,32
Wellington P,2479,9,5,6,16,31,55,-24,21
CC Mariners,2479,10,4,8,15,28,49,-21,20
Sydney FC,2480,1,20,5,3,65,23,42,65
N'castle Jet,2480,2,16,5,7,60,37,23,53
Melbourne C,2480,3,14,4,11,43,36,7,46
Melbourne V,2480,4,13,6,10,46,39,7,45
Adelaide Utd,2480,5,11,6,11,37,40,-3,39
Brisbane,2480,6,10,5,13,33,42,-9,35
Western Sydn,2480,7,8,9,10,38,47,-9,33
Perth Glory,2480,8,10,2,15,37,50,-13,32
Wellington P,2480,9,5,6,16,31,55,-24,21
CC Mariners,2480,10,4,8,15,28,49,-21,20
Sydney FC,2481,1,21,4,3,66,22,44,67
N'castle Jet,2481,2,15,5,8,58,41,17,50
Melbourne C,2481,3,15,4,10,47,34,13,49
Melbourne V,2481,4,13,5,11,45,40,5,44
Adelaide Utd,2481,5,11,6,11,37,40,-3,39
Brisbane,2481,6,10,5,13,33,42,-9,35
Western Sydn,2481,7,8,9,10,38,47,-9,33
Perth Glory,2481,8,10,2,15,37,50,-13,32
Wellington P,2481,9,5,6,16,31,55,-24,21
CC Mariners,2481,10,4,8,15,28,49,-21,20
Sydney FC,2482,1,20,4,4,64,23,41,64
N'castle Jet,2482,2,15,6,7,61,41,20,51
Melbourne C,2482,3,14,5,10,47,37,10,47
Melbourne V,2482,4,14,5,10,46,38,8,47
Adelaide Utd,2482,5,11,6,11,37,40,-3,39
Brisbane,2482,6,10,5,13,33,42,-9,35
Western Sydn,2482,7,8,9,10,38,47,-9,33
Perth Glory,2482,8,10,2,15,37,50,-13,32
Wellington P,2482,9,5,6,16,31,55,-24,21
CC Mariners,2482,10,4,8,15,28,49,-21,20
Sydney FC,2483,1,20,5,3,66,24,42,65
N'castle Jet,2483,2,16,5,7,59,38,21,53
Melbourne C,2483,3,14,4,11,44,35,9,46
Melbourne V,2483,4,13,6,10,47,40,7,45
Adelaide Utd,2483,5,11,6,11,37,40,-3,39
Brisbane,2483,6,10,5,13,33,42,-9,35
Western Sydn,2483,7,8,9,10,38,47,-9,33
Perth Glory,2483,8,10,2,15,37,50,-13,32
Wellington P,2483,9,5,6,16,31,55,-24,21
CC Mariners,2483,10,4,8,15,28,49,-21,20
Sydney FC,2484,1,20,5,3,64,22,42,65
N'castle Jet,2484,2,15,5,8,59,40,19,50
Melbourne C,2484,3,15,4,10,46,35,11,49
Melbourne V,2484,4,13,6,10,45,38,7,45
Adelaide Utd,2484,5,11,6,11,37,40,-3,39
Brisbane,2484,6,10,5,13,33,42,-9,35
Western Sydn,2484,7,8,9,10,38,47,-9,33
Perth Glory,2484,8,10,2,15,37,50,-13,32
Wellington P,2484,9,5,6,16,31,55,-24,21
CC Mariners,2484,10,4,8,15,28,49,-21,20
Sydney FC,2485,1,20,5,3,65,23,42,65
N'castle Jet,2485,2,15,6,7,58,38,20,51
Melbourne C,2485,3,14,5,10,44,34,10,47
Melbourne V,2485,4,13,6,10,46,39,7,45
Adelaide Utd,2485,5,11,6,11,37,40,-3,39
Brisbane,2485,6,10,5,13,33,42,-9,35
Western Sydn,2485,7,8,9,10,38,47,-9,33
Perth Glory,2485,8,10,2,15,37,50,-13,32
Wellington P,2485,9,5,6,16,31,55,-24,21
CC Mariners,2485,10,4,8,15,28,49,-21,20
Sydney FC,2486,1,21,4,3,66,23,43,67
N'castle Jet,2486,2,16,5,7,58,37,21,53
Melbourne C,2486,3,14,4,11,43,34,9,46
Melbourne V,2486,4,13,5,11,46,40,6,44
Adelaide Utd,2486,5,11,6,11,37,40,-3,39
Brisbane,2486,6,10,5,13,33,42,-9,35
Western Sydn,2486,7,8,9,10,38,47,-9,33
Perth Glory,2486,8,10,2,15,37,50,-13,32
Wellington P,2486,9,5,6,16,31,55,-24,21
CC Mariners,2486,10,4,8,15,28,49,-21,20
Sydney FC,2487,1,20,5,3,66,24,42,65
N'castle Jet,2487,2,16,5,7,60,38,22,53
Melbourne C,2487,3,14,4,11,44,36,8,46
Melbourne V,2487,4,13,6,10,47,40,7,45
Adelaide Utd,2487,5,11,6,11,37,40,-3,39
Brisbane,2487,6,10,5,13,33,42,-9,35
Western Sydn,2487,7,8,9,10,38,47,-9,33
Perth Glory,2487,8,10,2,15,37,50,-13,32
Wellington P,2487,9,5,6,16,31,55,-24,21
CC Mariners,2487,10,4,8,15,28,49,-21,20
Sydney FC,2488,1,20,5,3,66,24,42,65
N'castle Jet,2488,2,16,5,7,59,38,21,53
Melbourne C,2488,3,14,4,11,44,35,9,46
Melbourne V,2488,4,13,6,10,47,40,7,45
Adelaide Utd,2488,5,11,6,11,37,40,-3,39
Brisbane,2488,6,10,5,13,33,42,-9,35
Western Sydn,2488,7,8,9,10,38,47,-9,33
Perth Glory,2488,8,10,2,15,37,50,-13,32
Wellington P,2488,9,5,6,16,31,55,-24,21
CC Mariners,2488,10,4,8,15,28,49,-21,20
Sydney FC,2489,1,20,4,4,64,23,41,64
N'castle Jet,2489,2,15,5,8,59,40,19,50
Melbourne C,2489,3,15,4,10,46,35,11,49
Melbourne V,2489,4,14,5,10,46,38,8,47
Adelaide Utd,2489,5,11,6,11,37,40,-3,39
Brisbane,2489,6,10,5,13,33,42,-9,35
Western Sydn,2489,7,8,9,10,38,47,-9,33
Perth Glory,2489,8,10,2,15,37,50,-13,32
Wellington P,2489,9,5,6,16,31,55,-24,21
CC Mariners,2489,10,4,8,15,28,49,-21,20
Sydney FC,2490,1,20,5,3,66,24,42,65
N'castle Jet,2490,2,15,5,8,58,40,18,50
Melbourne C,2490,3,15,4,10,46,34,12,49
Melbourne V,2490,4,13,6,10,47,40,7,45
Adelaide Utd,2490,5,11,6,11,37,40,-3,39
Brisbane,2490,6,10,5,13,33,42,-9,35
Western Sydn,2490,7,8,9,10,38,47,-9,33
Perth Glory,2490,8,10,2,15,37,50,-13,32
Wellington P,2490,9,5,6,16,31,55,-24,21
CC Mariners,2490,10,4,8,15,28,49,-21,20
Sydney FC,2491,1,21,4,3,66,22,44,67
N'castle Jet,2491,2,16,5,7,59,38,21,53
Melbourne C,2491,3,14,4,11,44,35,9,46
Melbourne V,2491,4,13,5,11,45,40,5,44
Adelaide Utd,2491,5,11,6,11,37,40,-3,39
Brisbane,2491,6,10,5,13,33,42,-9,35
Western Sydn,2491,7,8,9,10,38,47,-9,33
Perth Glory,2491,8,10,2,15,37,50,-13,32
Wellington P,2491,9,5,6,16,31,55,-24,21
CC Mariners,2491,10,4,8,15,28,49,-21,20
Sydney FC,2492,1,21,4,3,67,23,44,67
N'castle Jet,2492,2,16,5,7,59,37,22,53
Melbourne C,2492,3,14,4,11,43,35,8,46
Melbourne V,2492,4,13,5,11,46,41,5,44
Adelaide Utd,2492,5,11,6,11,37,40,-3,39
Brisbane,2492,6,10,5,13,33,42,-9,35
Western Sydn,2492,7,8,9,10,38,47,-9,33
Perth Glory,2492,8,10,2,15,37,50,-13,32
Wellington P,2492,9,5,6,16,31,55,-24,21
CC Mariners,2492,10,4,8,15,28,49,-21,20
Sydney FC,2493,1,21,4,3,66,22,44,67
N'castle Jet,2493,2,15,6,7,59,39,20,51
Melbourne C,2493,3,14,5,10,45,35,10,47
Melbourne V,2493,4,13,5,11,45,40,5,44
Adelaide Utd,2493,5,11,6,11,37,40,-3,39
Brisbane,2493,6,10,5,13,33,42,-9,35
Western Sydn,2493,7,8,9,10,38,47,-9,33
Perth Glory,2493,8,10,2,15,37,50,-13,32
Wellington P,2493,9,5,6,16,31,55,-24,21
CC Mariners,2493,10,4,8,15,28,49,-21,20
Sydney FC,2494,1,20,4,4,66,25,41,64
N'castle Jet,2494,2,15,6,7,58,38,20,51
Melbourne C,2494,3,14,5,10,44,34,10,47
Melbourne V,2494,4,14,5,10,48,40,8,47
Adelaide Utd,2494,5,11,6,11,37,40,-3,39
Brisbane,2494,6,10,5,13,33,42,-9,35
Western Sydn,2494,7,8,9,10,38,47,-9,33
Perth Glory,2494,8,10,2,15,37,50,-13,32
Wellington P,2494,9,5,6,16,31,55,-24,21
CC Mariners,2494,10,4,8,15,28,49,-21,20
Sydney FC,2495,1,21,4,3,67,22,45,67
N'castle Jet,2495,2,15,6,7,58,38,20,51
Melbourne C,2495,3,14,5,10,44,34,10,47
Melbourne V,2495,4,13,5,11,45,41,4,44
Adelaide Utd,2495,5,11,6,11,37,40,-3,39
Brisbane,2495,6,10,5,13,33,42,-9,35
Western Sydn,2495,7,8,9,10,38,47,-9,33
Perth Glory,2495,8,10,2,15,37,50,-13,32
Wellington P,2495,9,5,6,16,31,55,-24,21
CC Mariners,2495,10,4,8,15,28,49,-21,20
Sydney FC,2496,1,21,4,3,66,22,44,67
N'castle Jet,2496,2,16,5,7,59,37,22,53
Melbourne C,2496,3,14,4,11,43,35,8,46
Melbourne V,2496,4,13,5,11,45,40,5,44
Adelaide Utd,2496,5,11,6,11,37,40,-3,39
Brisbane,2496,6,10,5,13,33,42,-9,35
Western Sydn,2496,7,8,9,10,38,47,-9,33
Perth Glory,2496,8,10,2,15,37,50,-13,32
Wellington P,2496,9,5,6,16,31,55,-24,21
CC Mariners,2496,10,4,8,15,28,49,-21,20
Sydney FC,2497,1,21,4,3,67,22,45,67
N'castle Jet,2497,2,16,5,7,62,38,24,53
Melbourne C,2497,3,14,4,11,44,38,6,46
Melbourne V,2497,4,13,5,11,45,41,4,44
Adelaide Utd,2497,5,11,6,11,37,40,-3,39
Brisbane,2497,6,10,5,13,33,42,-9,35
Western Sydn,2497,7,8,9,10,38,47,-9,33
Perth Glory,2497,8,10,2,15,37,50,-13,32
Wellington P,2497,9,5,6,16,31,55,-24,21
CC Mariners,2497,10,4,8,15,28,49,-21,20
Sydney FC,2498,1,21,4,3,66,22,44,67
N'castle Jet,2498,2,15,5,8,57,38,19,50
Melbourne C,2498,3,15,4,10,44,33,11,49
Melbourne V,2498,4,13,5,11,45,40,5,44
Adelaide Utd,2498,5,11,6,11,37,40,-3,39
Brisbane,2498,6,10,5,13,33,42,-9,35
Western Sydn,2498,7,8,9,10,38,47,-9,33
Perth Glory,2498,8,10,2,15,37,50,-13,32
Wellington P,2498,9,5,6,16,31,55,-24,21
CC Mariners,2498,10,4,8,15,28,49,-21,20
Sydney FC,2499,1,21,4,3,65,22,43,67
N'castle Jet,2499,2,15,6,7,57,37,20,51
Melbourne C,2499,3,14,5,10,43,33,10,47
Melbourne V,2499,4,13,5,11,45,39,6,44
Adelaide Utd,2499,5,11,6,11,37,40,-3,39
Brisbane,2499,6,10,5,13,33,42,-9,35
Western Sydn,2499,7,8,9,10,38,47,-9,33
Perth Glory,2499,8,10,2,15,37,50,-13,32
Wellington P,2499,9,5,6,16,31,55,-24,21
CC Mariners,2499,10,4,8,15,28,49,-21,20
Sydney FC,2500,1,21,4,3,68,22,46,67
N'castle Jet,2500,2,16,5,7,58,37,21,53
Melbourne C,2500,3,14,4,11,43,34,9,46
Melbourne V,2500,4,13,5,11,45,42,3,44
Adelaide Utd,2500,5,11,6,11,37,40,-3,39
Brisbane,2500,6,10,5,13,33,42,-9,35
Western Sydn,2500,7,8,9,10,38,47,-9,33
Perth Glory,2500,8,10,2,15,37,50,-13,32
Wellington P,2500,9,5,6,16,31,55,-24,21
CC Mariners,2500,10,4,8,15,28,49,-21,20
Sydney FC,2501,1,21,4,3,67,24,43,67
N'castle Jet,2501,2,15,6,7,60,40,20,51
Melbourne C,2501,3,14,5,10,46,36,10,47
Melbourne V,2501,4,13,5,11,47,41,6,44
Adelaide Utd,2501,5,11,6,11,37,40,-3,39
Brisbane,2501,6,10,5,13,33,42,-9,35
Western Sydn,2501,7,8,9,10,38,47,-9,33
Perth Glory,2501,8,10,2,15,37,50,-13,32
Wellington P,2501,9,5,6,16,31,55,-24,21
CC Mariners,2501,10,4,8,15,28,49,-21,20
Sydney FC,2502,1,21,4,3,65,22,43,67
N'castle Jet,2502,2,15,6,7,59,39,20,51
Melbourne C,2502,3,14,5,10,45,35,10,47
Melbourne V,2502,4,13,5,11,45,39,6,44
Adelaide Utd,2502,5,11,6,11,37,40,-3,39
Brisbane,2502,6,10,5,13,33,42,-9,35
Western Sydn,2502,7,8,9,10,38,47,-9,33
Perth Glory,2502,8,10,2,15,37,50,-13,32
Wellington P,2502,9,5,6,16,31,55,-24,21
CC Mariners,2502,10,4,8,15,28,49,-21,20
Sydney FC,2503,1,21,4,3,66,23,43,67
N'castle Jet,2503,2,15,6,7,58,38,20,51
Melbourne C,2503,3,14,5,10,44,34,10,47
Melbourne V,2503,4,13,5,11,46,40,6,44
Adelaide Utd,2503,5,11,6,11,37,40,-3,39
Brisbane,2503,6,10,5,13,33,42,-9,35
Western Sydn,2503,7,8,9,10,38,47,-9,33
Perth Glory,2503,8,10,2,15,37,50,-13,32
Wellington P,2503,9,5,6,16,31,55,-24,21
CC Mariners,2503,10,4,8,15,28,49,-21,20
Sydney FC,2504,1,20,5,3,66,24,42,65
N'castle Jet,2504,2,15,6,7,57,37,20,51
Melbourne C,2504,3,14,5,10,43,33,10,47
Melbourne V,2504,4,13,6,10,47,40,7,45
Adelaide Utd,2504,5,11,6,11,37,40,-3,39
Brisbane,2504,6,10,5,13,33,42,-9,35
Western Sydn,2504,7,8,9,10,38,47,-9,33
Perth Glory,2504,8,10,2,15,37,50,-13,32
Wellington P,2504,9,5,6,16,31,55,-24,21
CC Mariners,2504,10,4,8,15,28,49,-21,20
Sydney FC,2505,1,20,5,3,67,25,42,65
N'castle Jet,2505,2,15,5,8,58,41,17,50
Melbourne C,2505,3,15,4,10,47,34,13,49
Melbourne V,2505,4,13,6,10,48,41,7,45
Adelaide Utd,2505,5,11,6,11,37,40,-3,39
Brisbane,2505,6,10,5,13,33,42,-9,35
Western Sydn,2505,7,8,9,10,38,47,-9,33
Perth Glory,2505,8,10,2,15,37,50,-13,32
Wellington P,2505,9,5,6,16,31,55,-24,21
CC Mariners,2505,10,4,8,15,28,49,-21,20
Sydney FC,2506,1,21,4,3,66,22,44,67
N'castle Jet,2506,2,16,5,7,61,38,23,53
Melbourne C,2506,3,14,4,11,44,37,7,46
Melbourne V,2506,4,13,5,11,45,40,5,44
Adelaide Utd,2506,5,11,6,11,37,40,-3,39
Brisbane,2506,6,10,5,13,33,42,-9,35
Western Sydn,2506,7,8,9,10,38,47,-9,33
Perth Glory,2506,8,10,2,15,37,50,-13,32
Wellington P,2506,9,5,6,16,31,55,-24,21
CC Mariners,2506,10,4,8,15,28,49,-21,20
Sydney FC,2507,1,20,4,4,66,25,41,64
N'castle Jet,2507,2,16,5,7,58,37,21,53
Melbourne V,2507,3,14,5,10,48,40,8,47
Melbourne C,2507,4,14,4,11,43,34,9,46
Adelaide Utd,2507,5,11,6,11,37,40,-3,39
Brisbane,2507,6,10,5,13,33,42,-9,35
Western Sydn,2507,7,8,9,10,38,47,-9,33
Perth Glory,2507,8,10,2,15,37,50,-13,32
Wellington P,2507,9,5,6,16,31,55,-24,21
CC Mariners,2507,10,4,8,15,28,49,-21,20
Sydney FC,2508,1,20,4,4,64,24,40,64
N'castle Jet,2508,2,16,5,7,58,37,21,53
Melbourne V,2508,3,14,5,10,47,38,9,47
Melbourne C,2508,4,14,4,11,43,34,9,46
Adelaide Utd,2508,5,11,6,11,37,40,-3,39
Brisbane,2508,6,10,5,13,33,42,-9,35
Western Sydn,2508,7,8,9,10,38,47,-9,33
Perth Glory,2508,8,10,2,15,37,50,-13,32
Wellington P,2508,9,5,6,16,31,55,-24,21
CC Mariners,2508,10,4,8,15,28,49,-21,20
Sydney FC,2509,1,21,4,3,67,22,45,67
N'castle Jet,2509,2,15,6,7,58,38,20,51
Melbourne C,2509,3,14,5,10,44,34,10,47
Melbourne V,2509,4,13,5,11,45,41,4,44
Adelaide Utd,2509,5,11,6,11,37,40,-3,39
Brisbane,2509,6,10,5,13,33,42,-9,35
Western Sydn,2509,7,8,9,10,38,47,-9,33
Perth Glory,2509,8,10,2,15,37,50,-13,32
Wellington P,2509,9,5,6,16,31,55,-24,21
CC Mariners,2509,10,4,8,15,28,49,-21,20
Sydney FC,2510,1,21,4,3,66,23,43,67
N'castle Jet,2510,2,15,5,8,59,42,17,50
Melbourne C,2510,3,15,4,10,48,35,13,49
Melbourne V,2510,4,13,5,11,46,40,6,44
Adelaide Utd,2510,5,11,6,11,37,40,-3,39
Brisbane,2510,6,10,5,13,33,42,-9,35
Western Sydn,2510,7,8,9,10,38,47,-9,33
Perth Glory,2510,8,10,2,15,37,50,-13,32
Wellington P,2510,9,5,6,16,31,55,-24,21
CC Mariners,2510,10,4,8,15,28,49,-21,20
Sydney FC,2511,1,21,4,3,71,22,49,67
N'castle Jet,2511,2,16,5,7,59,38,21,53
Melbourne C,2511,3,14,4,11,44,35,9,46
Melbourne V,2511,4,13,5,11,45,45,0,44
Adelaide Utd,2511,5,11,6,11,37,40,-3,39
Brisbane,2511,6,10,5,13,33,42,-9,35
Western Sydn,2511,7,8,9,10,38,47,-9,33
Perth Glory,2511,8,10,2,15,37,50,-13,32
Wellington P,2511,9,5,6,16,31,55,-24,21
CC Mariners,2511,10,4,8,15,28,49,-21,20
Sydney FC,2512,1,20,4,4,65,25,40,64
N'castle Jet,2512,2,15,6,7,58,38,20,51
Melbourne C,2512,3,14,5,10,44,34,10,47
Melbourne V,2512,4,14,5,10,48,39,9,47
Adelaide Utd,2512,5,11,6,11,37,40,-3,39
Brisbane,2512,6,10,5,13,33,42,-9,35
Western Sydn,2512,7,8,9,10,38,47,-9,33
Perth Glory,2512,8,10,2,15,37,50,-13,32
Wellington P,2512,9,5,6,16,31,55,-24,21
CC Mariners,2512,10,4,8,15,28,49,-21,20
Sydney FC,2513,1,20,4,4,65,24,41,64
N'castle Jet,2513,2,15,5,8,60,41,19,50
Melbourne C,2513,3,15,4,10,47,36,11,49
Melbourne V,2513,4,14,5,10,47,39,8,47
Adelaide Utd,2513,5,11,6,11,37,40,-3,39
Brisbane,2513,6,10,5,13,33,42,-9,35
Western Sydn,2513,7,8,9,10,38,47,-9,33
Perth Glory,2513,8,10,2,15,37,50,-13,32
Wellington P,2513,9,5,6,16,31,55,-24,21
CC Mariners,2513,10,4,8,15,28,49,-21,20
Sydney FC,2514,1,21,4,3,66,23,43,67
N'castle Jet,2514,2,15,5,8,61,42,19,50
Melbourne C,2514,3,15,4,10,48,37,11,49
Melbourne V,2514,4,13,5,11,46,40,6,44
Adelaide Utd,2514,5,11,6,11,37,40,-3,39
Brisbane,2514,6,10,5,13,33,42,-9,35
Western Sydn,2514,7,8,9,10,38,47,-9,33
Perth Glory,2514,8,10,2,15,37,50,-13,32
Wellington P,2514,9,5,6,16,31,55,-24,21
CC Mariners,2514,10,4,8,15,28,49,-21,20
Sydney FC,2515,1,21,4,3,66,23,43,67
N'castle Jet,2515,2,15,6,7,58,38,20,51
Melbourne C,2515,3,14,5,10,44,34,10,47
Melbourne V,2515,4,13,5,11,46,40,6,44
Adelaide Utd,2515,5,11,6,11,37,40,-3,39
Brisbane,2515,6,10,5,13,33,42,-9,35
Western Sydn,2515,7,8,9,10,38,47,-9,33
Perth Glory,2515,8,10,2,15,37,50,-13,32
Wellington P,2515,9,5,6,16,31,55,-24,21
CC Mariners,2515,10,4,8,15,28,49,-21,20
Sydney FC,2516,1,21,4,3,67,24,43,67
N'castle Jet,2516,2,15,5,8,58,40,18,50
Melbourne C,2516,3,15,4,10,46,34,12,49
Melbourne V,2516,4,13,5,11,47,41,6,44
Adelaide Utd,2516,5,11,6,11,37,40,-3,39
Brisbane,2516,6,10,5,13,33,42,-9,35
Western Sydn,2516,7,8,9,10,38,47,-9,33
Perth Glory,2516,8,10,2,15,37,50,-13,32
Wellington P,2516,9,5,6,16,31,55,-24,21
CC Mariners,2516,10,4,8,15,28,49,-21,20
Sydney FC,2517,1,21,4,3,65,22,43,67
N'castle Jet,2517,2,16,5,7,58,37,21,53
Melbourne C,2517,3,14,4,11,43,34,9,46
Melbourne V,2517,4,13,5,11,45,39,6,44
Adelaide Utd,2517,5,11,6,11,37,40,-3,39
Brisbane,2517,6,10,5,13,33,42,-9,35
Western Sydn,2517,7,8,9,10,38,47,-9,33
Perth Glory,2517,8,10,2,15,37,50,-13,32
Wellington P,2517,9,5,6,16,31,55,-24,21
CC Mariners,2517,10,4,8,15,28,49,-21,20
Sydney FC,2518,1,20,5,3,64,22,42,65
N'castle Jet,2518,2,15,6,7,58,38,20,51
Melbourne C,2518,3,14,5,10,44,34,10,47
Melbourne V,2518,4,13,6,10,45,38,7,45
Adelaide Utd,2518,5,11,6,11,37,40,-3,39
Brisbane,2518,6,10,5,13,33,42,-9,35
Western Sydn,2518,7,8,9,10,38,47,-9,33
Perth Glory,2518,8,10,2,15,37,50,-13,32
Wellington P,2518,9,5,6,16,31,55,-24,21
CC Mariners,2518,10,4,8,15,28,49,-21,20
Sydney FC,2519,1,20,5,3,64,22,42,65
N'castle Jet,2519,2,15,6,7,59,39,20,51
Melbourne C,2519,3,14,5,10,45,35,10,47
Melbourne V,2519,4,13,6,10,45,38,7,45
Adelaide Utd,2519,5,11,6,11,37,40,-3,39
Brisbane,2519,6,10,5,13,33,42,-9,35
Western Sydn,2519,7,8,9,10,38,47,-9,33
Perth Glory,2519,8,10,2,15,37,50,-13,32
Wellington P,2519,9,5,6,16,31,55,-24,21
CC Mariners,2519,10,4,8,15,28,49,-21,20
Sydney FC,2520,1,21,4,3,66,23,43,67
N'castle Jet,2520,2,15,6,7,57,37,20,51
Melbourne C,2520,3,14,5,10,43,33,10,47
Melbourne V,2520,4,13,5,11,46,40,6,44
Adelaide Utd,2520,5,11,6,11,37,40,-3,39
Brisbane,2520,6,10,5,13,33,42,-9,35
Western Sydn,2520,7,8,9,10,38,47,-9,33
Perth Glory,2520,8,10,2,15,37,50,-13,32
Wellington P,2520,9,5,6,16,31,55,-24,21
CC Mariners,2520,10,4,8,15,28,49,-21,20
Sydney FC,2521,1,21,4,3,68,23,45,67
N'castle Jet,2521,2,16,5,7,60,38,22,53
Melbourne C,2521,3,14,4,11,44,36,8,46
Melbourne V,2521,4,13,5,11,46,42,4,44
Adelaide Utd,2521,5,11,6,11,37,40,-3,39
Brisbane,2521,6,10,5,13,33,42,-9,35
Western Sydn,2521,7,8,9,10,38,47,-9,33
Perth Glory,2521,8,10,2,15,37,50,-13,32
Wellington P,2521,9,5,6,16,31,55,-24,21
CC Mariners,2521,10,4,8,15,28,49,-21,20
Sydney FC,2522,1,20,4,4,65,24,41,64
N'castle Jet,2522,2,16,5,7,59,37,22,53
Melbourne V,2522,3,14,5,10,47,39,8,47
Melbourne C,2522,4,14,4,11,43,35,8,46
Adelaide Utd,2522,5,11,6,11,37,40,-3,39
Brisbane,2522,6,10,5,13,33,42,-9,35
Western Sydn,2522,7,8,9,10,38,47,-9,33
Perth Glory,2522,8,10,2,15,37,50,-13,32
Wellington P,2522,9,5,6,16,31,55,-24,21
CC Mariners,2522,10,4,8,15,28,49,-21,20
Sydney FC,2523,1,20,4,4,64,24,40,64
N'castle Jet,2523,2,16,5,7,58,37,21,53
Melbourne V,2523,3,14,5,10,47,38,9,47
Melbourne C,2523,4,14,4,11,43,34,9,46
Adelaide Utd,2523,5,11,6,11,37,40,-3,39
Brisbane,2523,6,10,5,13,33,42,-9,35
Western Sydn,2523,7,8,9,10,38,47,-9,33
Perth Glory,2523,8,10,2,15,37,50,-13,32
Wellington P,2523,9,5,6,16,31,55,-24,21
CC Mariners,2523,10,4,8,15,28,49,-21,20
Sydney FC,2524,1,21,4,3,65,22,43,67
N'castle Jet,2524,2,15,5,8,58,40,18,50
Melbourne C,2524,3,15,4,10,46,34,12,49
Melbourne V,2524,4,13,5,11,45,39,6,44
Adelaide Utd,2524,5,11,6,11,37,40,-3,39
Brisbane,2524,6,10,5,13,33,42,-9,35
Western Sydn,2524,7,8,9,10,38,47,-9,33
Perth Glory,2524,8,10,2,15,37,50,-13,32
Wellington P,2524,9,5,6,16,31,55,-24,21
CC Mariners,2524,10,4,8,15,28,49,-21,20
Sydney FC,2525,1,21,4,3,68,24,44,67
N'castle Jet,2525,2,15,5,8,57,38,19,50
Melbourne C,2525,3,15,4,10,44,33,11,49
Melbourne V,2525,4,13,5,11,47,42,5,44
Adelaide Utd,2525,5,11,6,11,37,40,-3,39
Brisbane,2525,6,10,5,13,33,42,-9,35
Western Sydn,2525,7,8,9,10,38,47,-9,33
Perth Glory,2525,8,10,2,15,37,50,-13,32
Wellington P,2525,9,5,6,16,31,55,-24,21
CC Mariners,2525,10,4,8,15,28,49,-21,20
Sydney FC,2526,1,21,4,3,66,23,43,67
N'castle Jet,2526,2,16,5,7,58,37,21,53
Melbourne C,2526,3,14,4,11,43,34,9,46
Melbourne V,2526,4,13,5,11,46,40,6,44
Adelaide Utd,2526,5,11,6,11,37,40,-3,39
Brisbane,2526,6,10,5,13,33,42,-9,35
Western Sydn,2526,7,8,9,10,38,47,-9,33
Perth Glory,2526,8,10,2,15,37,50,-13,32
Wellington P,2526,9,5,6,16,31,55,-24,21
CC Mariners,2526,10,4,8,15,28,49,-21,20
Sydney FC,2527,1,21,4,3,66,23,43,67
N'castle Jet,2527,2,15,5,8,57,38,19,50
Melbourne C,2527,3,15,4,10,44,33,11,49
Melbourne V,2527,4,13,5,11,46,40,6,44
Adelaide Utd,2527,5,11,6,11,37,40,-3,39
Brisbane,2527,6,10,5,13,33,42,-9,35
Western Sydn,2527,7,8,9,10,38,47,-9,33
Perth Glory,2527,8,10,2,15,37,50,-13,32
Wellington P,2527,9,5,6,16,31,55,-24,21
CC Mariners,2527,10,4,8,15,28,49,-21,20
Sydney FC,2528,1,20,5,3,66,24,42,65
N'castle Jet,2528,2,15,5,8,57,38,19,50
Melbourne C,2528,3,15,4,10,44,33,11,49
Melbourne V,2528,4,13,6,10,47,40,7,45
Adelaide Utd,2528,5,11,6,11,37,40,-3,39
Brisbane,2528,6,10,5,13,33,42,-9,35
Western Sydn,2528,7,8,9,10,38,47,-9,33
Perth Glory,2528,8,10,2,15,37,50,-13,32
Wellington P,2528,9,5,6,16,31,55,-24,21
CC Mariners,2528,10,4,8,15,28,49,-21,20
Sydney FC,2529,1,20,4,4,64,23,41,64
N'castle Jet,2529,2,16,5,7,60,37,23,53
Melbourne V,2529,3,14,5,10,46,38,8,47
Melbourne C,2529,4,14,4,11,43,36,7,46
Adelaide Utd,2529,5,11,6,11,37,40,-3,39
Brisbane,2529,6,10,5,13,33,42,-9,35
Western Sydn,2529,7,8,9,10,38,47,-9,33
Perth Glory,2529,8,10,2,15,37,50,-13,32
Wellington P,2529,9,5,6,16,31,55,-24,21
CC Mariners,2529,10,4,8,15,28,49,-21,20
Sydney FC,2530,1,21,4,3,66,23,43,67
N'castle Jet,2530,2,16,5,7,59,38,21,53
Melbourne C,2530,3,14,4,11,44,35,9,46
Melbourne V,2530,4,13,5,11,46,40,6,44
Adelaide Utd,2530,5,11,6,11,37,40,-3,39
Brisbane,2530,6,10,5,13,33,42,-9,35
Western Sydn,2530,7,8,9,10,38,47,-9,33
Perth Glory,2530,8,10,2,15,37,50,-13,32
Wellington P,2530,9,5,6,16,31,55,-24,21
CC Mariners,2530,10,4,8,15,28,49,-21,20
Sydney FC,2531,1,21,4,3,66,22,44,67
N'castle Jet,2531,2,15,5,8,59,41,18,50
Melbourne C,2531,3,15,4,10,47,35,12,49
Melbourne V,2531,4,13,5,11,45,40,5,44
Adelaide Utd,2531,5,11,6,11,37,40,-3,39
Brisbane,2531,6,10,5,13,33,42,-9,35
Western Sydn,2531,7,8,9,10,38,47,-9,33
Perth Glory,2531,8,10,2,15,37,50,-13,32
Wellington P,2531,9,5,6,16,31,55,-24,21
CC Mariners,2531,10,4,8,15,28,49,-21,20
Sydney FC,2532,1,20,5,3,65,23,42,65
N'castle Jet,2532,2,15,5,8,58,40,18,50
Melbourne C,2532,3,15,4,10,46,34,12,49
Melbourne V,2532,4,13,6,10,46,39,7,45
Adelaide Utd,2532,5,11,6,11,37,40,-3,39
Brisbane,2532,6,10,5,13,33,42,-9,35
Western Sydn,2532,7,8,9,10,38,47,-9,33
Perth Glory,2532,8,10,2,15,37,50,-13,32
Wellington P,2532,9,5,6,16,31,55,-24,21
CC Mariners,2532,10,4,8,15,28,49,-21,20
Sydney FC,2533,1,21,4,3,66,23,43,67
N'castle Jet,2533,2,15,5,8,59,40,19,50
Melbourne C,2533,3,15,4,10,46,35,11,49
Melbourne V,2533,4,13,5,11,46,40,6,44
Adelaide Utd,2533,5,11,6,11,37,40,-3,39
Brisbane,2533,6,10,5,13,33,42,-9,35
Western Sydn,2533,7,8,9,10,38,47,-9,33
Perth Glory,2533,8,10,2,15,37,50,-13,32
Wellington P,2533,9,5,6,16,31,55,-24,21
CC Mariners,2533,10,4,8,15,28,49,-21,20
Sydney FC,2534,1,21,4,3,67,22,45,67
N'castle Jet,2534,2,16,5,7,59,37,22,53
Melbourne C,2534,3,14,4,11,43,35,8,46
Melbourne V,2534,4,13,5,11,45,41,4,44
Adelaide Utd,2534,5,11,6,11,37,40,-3,39
Brisbane,2534,6,10,5,13,33,42,-9,35
Western Sydn,2534,7,8,9,10,38,47,-9,33
Perth Glory,2534,8,10,2,15,37,50,-13,32
Wellington P,2534,9,5,6,16,31,55,-24,21
CC Mariners,2534,10,4,8,15,28,49,-21,20
Sydney FC,2535,1,20,5,3,64,22,42,65
N'castle Jet,2535,2,15,6,7,58,38,20,51
Melbourne C,2535,3,14,5,10,44,34,10,47
Melbourne V,2535,4,13,6,10,45,38,7,45
Adelaide Utd,2535,5,11,6,11,37,40,-3,39
Brisbane,2535,6,10,5,13,33,42,-9,35
Western Sydn,2535,7,8,9,10,38,47,-9,33
Perth Glory,2535,8,10,2,15,37,50,-13,32
Wellington P,2535,9,5,6,16,31,55,-24,21
CC Mariners,2535,10,4,8,15,28,49,-21,20
Sydney FC,2536,1,20,5,3,65,23,42,65
N'castle Jet,2536,2,16,5,7,59,38,21,53
Melbourne C,2536,3,14,4,11,44,35,9,46
Melbourne V,2536,4,13,6,10,46,39,7,45
Adelaide Utd,2536,5,11,6,11,37,40,-3,39
Brisbane,2536,6,10,5,13,33,42,-9,35
Western Sydn,2536,7,8,9,10,38,47,-9,33
Perth Glory,2536,8,10,2,15,37,50,-13,32
Wellington P,2536,9,5,6,16,31,55,-24,21
CC Mariners,2536,10,4,8,15,28,49,-21,20
Sydney FC,2537,1,21,4,3,65,22,43,67
N'castle Jet,2537,2,16,5,7,60,38,22,53
Melbourne C,2537,3,14,4,11,44,36,8,46
Melbourne V,2537,4,13,5,11,45,39,6,44
Adelaide Utd,2537,5,11,6,11,37,40,-3,39
Brisbane,2537,6,10,5,13,33,42,-9,35
Western Sydn,2537,7,8,9,10,38,47,-9,33
Perth Glory,2537,8,10,2,15,37,50,-13,32
Wellington P,2537,9,5,6,16,31,55,-24,21
CC Mariners,2537,10,4,8,15,28,49,-21,20
Sydney FC,2538,1,20,5,3,64,22,42,65
N'castle Jet,2538,2,16,5,7,58,37,21,53
Melbourne C,2538,3,14,4,11,43,34,9,46
Melbourne V,2538,4,13,6,10,45,38,7,45
Adelaide Utd,2538,5,11,6,11,37,40,-3,39
Brisbane,2538,6,10,5,13,33,42,-9,35
Western Sydn,2538,7,8,9,10,38,47,-9,33
Perth Glory,2538,8,10,2,15,37,50,-13,32
Wellington P,2538,9,5,6,16,31,55,-24,21
CC Mariners,2538,10,4,8,15,28,49,-21,20
Sydney FC,2539,1,20,5,3,64,22,42,65
N'castle Jet,2539,2,16,5,7,58,37,21,53
Melbourne C,2539,3,14,4,11,43,34,9,46
Melbourne V,2539,4,13,6,10,45,38,7,45
Adelaide Utd,2539,5,11,6,11,37,40,-3,39
Brisbane,2539,6,10,5,13,33,42,-9,35
Western Sydn,2539,7,8,9,10,38,47,-9,33
Perth Glory,2539,8,10,2,15,37,50,-13,32
Wellington P,2539,9,5,6,16,31,55,-24,21
CC Mariners,2539,10,4,8,15,28,49,-21,20
Sydney FC,2540,1,21,4,3,65,22,43,67
N'castle Jet,2540,2,16,5,7,60,37,23,53
Melbourne C,2540,3,14,4,11,43,36,7,46
Melbourne V,2540,4,13,5,11,45,39,6,44
Adelaide Utd,2540,5,11,6,11,37,40,-3,39
Brisbane,2540,6,10,5,13,33,42,-9,35
Western Sydn,2540,7,8,9,10,38,47,-9,33
Perth Glory,2540,8,10,2,15,37,50,-13,32
Wellington P,2540,9,5,6,16,31,55,-24,21
CC Mariners,2540,10,4,8,15,28,49,-21,20
Sydney FC,2541,1,21,4,3,67,23,44,67
N'castle Jet,2541,2,15,6,7,57,37,20,51
Melbourne C,2541,3,14,5,10,43,33,10,47
Melbourne V,2541,4,13,5,11,46,41,5,44
Adelaide Utd,2541,5,11,6,11,37,40,-3,39
Brisbane,2541,6,10,5,13,33,42,-9,35
Western Sydn,2541,7,8,9,10,38,47,-9,33
Perth Glory,2541,8,10,2,15,37,50,-13,32
Wellington P,2541,9,5,6,16,31,55,-24,21
CC Mariners,2541,10,4,8,15,28,49,-21,20
Sydney FC,2542,1,21,4,3,65,22,43,67
N'castle Jet,2542,2,16,5,7,59,38,21,53
Melbourne C,2542,3,14,4,11,44,35,9,46
Melbourne V,2542,4,13,5,11,45,39,6,44
Adelaide Utd,2542,5,11,6,11,37,40,-3,39
Brisbane,2542,6,10,5,13,33,42,-9,35
Western Sydn,2542,7,8,9,10,38,47,-9,33
Perth Glory,2542,8,10,2,15,37,50,-13,32
Wellington P,2542,9,5,6,16,31,55,-24,21
CC Mariners,2542,10,4,8,15,28,49,-21,20
Sydney FC,2543,1,21,4,3,69,22,47,67
N'castle Jet,2543,2,16,5,7,59,38,21,53
Melbourne C,2543,3,14,4,11,44,35,9,46
Melbourne V,2543,4,13,5,11,45,43,2,44
Adelaide Utd,2543,5,11,6,11,37,40,-3,39
Brisbane,2543,6,10,5,13,33,42,-9,35
Western Sydn,2543,7,8,9,10,38,47,-9,33
Perth Glory,2543,8,10,2,15,37,50,-13,32
Wellington P,2543,9,5,6,16,31,55,-24,21
CC Mariners,2543,10,4,8,15,28,49,-21,20
Sydney FC,2544,1,21,4,3,69,23,46,67
N'castle Jet,2544,2,16,5,7,59,38,21,53
Melbourne C,2544,3,14,4,11,44,35,9,46
Melbourne V,2544,4,13,5,11,46,43,3,44
Adelaide Utd,2544,5,11,6,11,37,40,-3,39
Brisbane,2544,6,10,5,13,33,42,-9,35
Western Sydn,2544,7,8,9,10,38,47,-9,33
Perth Glory,2544,8,10,2,15,37,50,-13,32
Wellington P,2544,9,5,6,16,31,55,-24,21
CC Mariners,2544,10,4,8,15,28,49,-21,20
Sydney FC,2545,1,20,4,4,65,25,40,64
N'castle Jet,2545,2,16,5,7,59,38,21,53
Melbourne V,2545,3,14,5,10,48,39,9,47
Melbourne C,2545,4,14,4,11,44,35,9,46
Adelaide Utd,2545,5,11,6,11,37,40,-3,39
Brisbane,2545,6,10,5,13,33,42,-9,35
Western Sydn,2545,7,8,9,10,38,47,-9,33
Perth Glory,2545,8,10,2,15,37,50,-13,32
Wellington P,2545,9,5,6,16,31,55,-24,21
CC Mariners,2545,10,4,8,15,28,49,-21,20
Sydney FC,2546,1,21,4,3,66,23,43,67
N'castle Jet,2546,2,15,5,8,58,39,19,50
Melbourne C,2546,3,15,4,10,45,34,11,49
Melbourne V,2546,4,13,5,11,46,40,6,44
Adelaide Utd,2546,5,11,6,11,37,40,-3,39
Brisbane,2546,6,10,5,13,33,42,-9,35
Western Sydn,2546,7,8,9,10,38,47,-9,33
Perth Glory,2546,8,10,2,15,37,50,-13,32
Wellington P,2546,9,5,6,16,31,55,-24,21
CC Mariners,2546,10,4,8,15,28,49,-21,20
Sydney FC,2547,1,20,4,4,66,25,41,64
N'castle Jet,2547,2,15,6,7,58,38,20,51
Melbourne C,2547,3,14,5,10,44,34,10,47
Melbourne V,2547,4,14,5,10,48,40,8,47
Adelaide Utd,2547,5,11,6,11,37,40,-3,39
Brisbane,2547,6,10,5,13,33,42,-9,35
Western Sydn,2547,7,8,9,10,38,47,-9,33
Perth Glory,2547,8,10,2,15,37,50,-13,32
Wellington P,2547,9,5,6,16,31,55,-24,21
CC Mariners,2547,10,4,8,15,28,49,-21,20
Sydney FC,2548,1,21,4,3,65,22,43,67
N'castle Jet,2548,2,15,6,7,57,37,20,51
Melbourne C,2548,3,14,5,10,43,33,10,47
Melbourne V,2548,4,13,5,11,45,39,6,44
Adelaide Utd,2548,5,11,6,11,37,40,-3,39
Brisbane,2548,6,10,5,13,33,42,-9,35
Western Sydn,2548,7,8,9,10,38,47,-9,33
Perth Glory,2548,8,10,2,15,37,50,-13,32
Wellington P,2548,9,5,6,16,31,55,-24,21
CC Mariners,2548,10,4,8,15,28,49,-21,20
Sydney FC,2549,1,21,4,3,68,22,46,67
N'castle Jet,2549,2,15,6,7,59,39,20,51
Melbourne C,2549,3,14,5,10,45,35,10,47
Melbourne V,2549,4,13,5,11,45,42,3,44
Adelaide Utd,2549,5,11,6,11,37,40,-3,39
Brisbane,2549,6,10,5,13,33,42,-9,35
Western Sydn,2549,7,8,9,10,38,47,-9,33
Perth Glory,2549,8,10,2,15,37,50,-13,32
Wellington P,2549,9,5,6,16,31,55,-24,21
CC Mariners,2549,10,4,8,15,28,49,-21,20
Sydney FC,2550,1,21,4,3,68,22,46,67
N'castle Jet,2550,2,16,5,7,60,38,22,53
Melbourne C,2550,3,14,4,11,44,36,8,46
Melbourne V,2550,4,13,5,11,45,42,3,44
Adelaide Utd,2550,5,11,6,11,37,40,-3,39
Brisbane,2550,6,10,5,13,33,42,-9,35
Western Sydn,2550,7,8,9,10,38,47,-9,33
Perth Glory,2550,8,10,2,15,37,50,-13,32
Wellington P,2550,9,5,6,16,31,55,-24,21
CC Mariners,2550,10,4,8,15,28,49,-21,20
Sydney FC,2551,1,21,4,3,67,22,45,67
N'castle Jet,2551,2,15,6,7,60,40,20,51
Melbourne C,2551,3,14,5,10,46,36,10,47
Melbourne V,2551,4,13,5,11,45,41,4,44
Adelaide Utd,2551,5,11,6,11,37,40,-3,39
Brisbane,2551,6,10,5,13,33,42,-9,35
Western Sydn,2551,7,8,9,10,38,47,-9,33
Perth Glory,2551,8,10,2,15,37,50,-13,32
Wellington P,2551,9,5,6,16,31,55,-24,21
CC Mariners,2551,10,4,8,15,28,49,-21,20
Sydney FC,2552,1,20,5,3,65,23,42,65
N'castle Jet,2552,2,16,5,7,59,37,22,53
Melbourne C,2552,3,14,4,11,43,35,8,46
Melbourne V,2552,4,13,6,10,46,39,7,45
Adelaide Utd,2552,5,11,6,11,37,40,-3,39
Brisbane,2552,6,10,5,13,33,42,-9,35
Western Sydn,2552,7,8,9,10,38,47,-9,33
Perth Glory,2552,8,10,2,15,37,50,-13,32
Wellington P,2552,9,5,6,16,31,55,-24,21
CC Mariners,2552,10,4,8,15,28,49,-21,20
Sydney FC,2553,1,21,4,3,69,24,45,67
N'castle Jet,2553,2,15,5,8,57,38,19,50
Melbourne C,2553,3,15,4,10,44,33,11,49
Melbourne V,2553,4,13,5,11,47,43,4,44
Adelaide Utd,2553,5,11,6,11,37,40,-3,39
Brisbane,2553,6,10,5,13,33,42,-9,35
Western Sydn,2553,7,8,9,10,38,47,-9,33
Perth Glory,2553,8,10,2,15,37,50,-13,32
Wellington P,2553,9,5,6,16,31,55,-24,21
CC Mariners,2553,10,4,8,15,28,49,-21,20
Sydney FC,2554,1,21,4,3,67,24,43,67
N'castle Jet,2554,2,15,6,7,60,40,20,51
Melbourne C,2554,3,14,5,10,46,36,10,47
Melbourne V,2554,4,13,5,11,47,41,6,44
Adelaide Utd,2554,5,11,6,11,37,40,-3,39
Brisbane,2554,6,10,5,13,33,42,-9,35
Western Sydn,2554,7,8,9,10,38,47,-9,33
Perth Glory,2554,8,10,2,15,37,50,-13,32
Wellington P,2554,9,5,6,16,31,55,-24,21
CC Mariners,2554,10,4,8,15,28,49,-21,20
Sydney FC,2555,1,20,4,4,64,24,40,64
N'castle Jet,2555,2,16,5,7,59,38,21,53
Melbourne V,2555,3,14,5,10,47,38,9,47
Melbourne C,2555,4,14,4,11,44,35,9,46
Adelaide Utd,2555,5,11,6,11,37,40,-3,39
Brisbane,2555,6,10,5,13,33,42,-9,35
Western Sydn,2555,7,8,9,10,38,47,-9,33
Perth Glory,2555,8,10,2,15,37,50,-13,32
Wellington P,2555,9,5,6,16,31,55,-24,21
CC Mariners,2555,10,4,8,15,28,49,-21,20
Sydney FC,2556,1,21,4,3,67,22,45,67
N'castle Jet,2556,2,15,5,8,59,40,19,50
Melbourne C,2556,3,15,4,10,46,35,11,49
Melbourne V,2556,4,13,5,11,45,41,4,44
Adelaide Utd,2556,5,11,6,11,37,40,-3,39
Brisbane,2556,6,10,5,13,33,42,-9,35
Western Sydn,2556,7,8,9,10,38,47,-9,33
Perth Glory,2556,8,10,2,15,37,50,-13,32
Wellington P,2556,9,5,6,16,31,55,-24,21
CC Mariners,2556,10,4,8,15,28,49,-21,20
Sydney FC,2557,1,20,4,4,64,24,40,64
N'castle Jet,2557,2,16,5,7,59,37,22,53
Melbourne V,2557,3,14,5,10,47,38,9,47
Melbourne C,2557,4,14,4,11,43,35,8,46
Adelaide Utd,2557,5,11,6,11,37,40,-3,39
Brisbane,2557,6,10,5,13,33,42,-9,35
Western Sydn,2557,7,8,9,10,38,47,-9,33
Perth Glory,2557,8,10,2,15,37,50,-13,32
Wellington P,2557,9,5,6,16,31,55,-24,21
CC Mariners,2557,10,4,8,15,28,49,-21,20
Sydney FC,2558,1,20,4,4,67,26,41,64
N'castle Jet,2558,2,15,5,8,58,40,18,50
Melbourne C,2558,3,15,4,10,46,34,12,49
Melbourne V,2558,4,14,5,10,49,41,8,47
Adelaide Utd,2558,5,11,6,11,37,40,-3,39
Brisbane,2558,6,10,5,13,33,42,-9,35
Western Sydn,2558,7,8,9,10,38,47,-9,33
Perth Glory,2558,8,10,2,15,37,50,-13,32
Wellington P,2558,9,5,6,16,31,55,-24,21
CC Mariners,2558,10,4,8,15,28,49,-21,20
Sydney FC,2559,1,20,4,4,64,23,41,64
N'castle Jet,2559,2,15,5,8,57,38,19,50
Melbourne C,2559,3,15,4,10,44,33,11,49
Melbourne V,2559,4,14,5,10,46,38,8,47
Adelaide Utd,2559,5,11,6,11,37,40,-3,39
Brisbane,2559,6,10,5,13,33,42,-9,35
Western Sydn,2559,7,8,9,10,38,47,-9,33
Perth Glory,2559,8,10,2,15,37,50,-13,32
Wellington P,2559,9,5,6,16,31,55,-24,21
CC Mariners,2559,10,4,8,15,28,49,-21,20
Sydney FC,2560,1,21,4,3,65,22,43,67
N'castle Jet,2560,2,16,5,7,60,38,22,53
Melbourne C,2560,3,14,4,11,44,36,8,46
Melbourne V,2560,4,13,5,11,45,39,6,44
Adelaide Utd,2560,5,11,6,11,37,40,-3,39
Brisbane,2560,6,10,5,13,33,42,-9,35
Western Sydn,2560,7,8,9,10,38,47,-9,33
Perth Glory,2560,8,10,2,15,37,50,-13,32
Wellington P,2560,9,5,6,16,31,55,-24,21
CC Mariners,2560,10,4,8,15,28,49,-21,20
Sydney FC,2561,1,21,4,3,66,23,43,67
N'castle Jet,2561,2,16,5,7,61,37,24,53
Melbourne C,2561,3,14,4,11,43,37,6,46
Melbourne V,2561,4,13,5,11,46,40,6,44
Adelaide Utd,2561,5,11,6,11,37,40,-3,39
Brisbane,2561,6,10,5,13,33,42,-9,35
Western Sydn,2561,7,8,9,10,38,47,-9,33
Perth Glory,2561,8,10,2,15,37,50,-13,32
Wellington P,2561,9,5,6,16,31,55,-24,21
CC Mariners,2561,10,4,8,15,28,49,-21,20
Sydney FC,2562,1,21,4,3,67,23,44,67
N'castle Jet,2562,2,16,5,7,60,37,23,53
Melbourne C,2562,3,14,4,11,43,36,7,46
Melbourne V,2562,4,13,5,11,46,41,5,44
Adelaide Utd,2562,5,11,6,11,37,40,-3,39
Brisbane,2562,6,10,5,13,33,42,-9,35
Western Sydn,2562,7,8,9,10,38,47,-9,33
Perth Glory,2562,8,10,2,15,37,50,-13,32
Wellington P,2562,9,5,6,16,31,55,-24,21
CC Mariners,2562,10,4,8,15,28,49,-21,20
Sydney FC,2563,1,20,4,4,65,24,41,64
N'castle Jet,2563,2,15,6,7,58,38,20,51
Melbourne C,2563,3,14,5,10,44,34,10,47
Melbourne V,2563,4,14,5,10,47,39,8,47
Adelaide Utd,2563,5,11,6,11,37,40,-3,39
Brisbane,2563,6,10,5,13,33,42,-9,35
Western Sydn,2563,7,8,9,10,38,47,-9,33
Perth Glory,2563,8,10,2,15,37,50,-13,32
Wellington P,2563,9,5,6,16,31,55,-24,21
CC Mariners,2563,10,4,8,15,28,49,-21,20
Sydney FC,2564,1,20,4,4,64,23,41,64
N'castle Jet,2564,2,16,5,7,58,37,21,53
Melbourne V,2564,3,14,5,10,46,38,8,47
Melbourne C,2564,4,14,4,11,43,34,9,46
Adelaide Utd,2564,5,11,6,11,37,40,-3,39
Brisbane,2564,6,10,5,13,33,42,-9,35
Western Sydn,2564,7,8,9,10,38,47,-9,33
Perth Glory,2564,8,10,2,15,37,50,-13,32
Wellington P,2564,9,5,6,16,31,55,-24,21
CC Mariners,2564,10,4,8,15,28,49,-21,20
Sydney FC,2565,1,21,4,3,66,22,44,67
N'castle Jet,2565,2,15,5,8,58,39,19,50
Melbourne C,2565,3,15,4,10,45,34,11,49
Melbourne V,2565,4,13,5,11,45,40,5,44
Adelaide Utd,2565,5,11,6,11,37,40,-3,39
Brisbane,2565,6,10,5,13,33,42,-9,35
Western Sydn,2565,7,8,9,10,38,47,-9,33
Perth Glory,2565,8,10,2,15,37,50,-13,32
Wellington P,2565,9,5,6,16,31,55,-24,21
CC Mariners,2565,10,4,8,15,28,49,-21,20
Sydney FC,2566,1,21,4,3,67,23,44,67
N'castle Jet,2566,2,15,5,8,58,39,19,50
Melbourne C,2566,3,15,4,10,45,34,11,49
Melbourne V,2566,4,13,5,11,46,41,5,44
Adelaide Utd,2566,5,11,6,11,37,40,-3,39
Brisbane,2566,6,10,5,13,33,42,-9,35
Western Sydn,2566,7,8,9,10,38,47,-9,33
Perth Glory,2566,8,10,2,15,37,50,-13,32
Wellington P,2566,9,5,6,16,31,55,-24,21
CC Mariners,2566,10,4,8,15,28,49,-21,20
Sydney FC,2567,1,20,4,4,64,24,40,64
N'castle Jet,2567,2,16,5,7,60,38,22,53
Melbourne V,2567,3,14,5,10,47,38,9,47
Melbourne C,2567,4,14,4,11,44,36,8,46
Adelaide Utd,2567,5,11,6,11,37,40,-3,39
Brisbane,2567,6,10,5,13,33,42,-9,35
Western Sydn,2567,7,8,9,10,38,47,-9,33
Perth Glory,2567,8,10,2,15,37,50,-13,32
Wellington P,2567,9,5,6,16,31,55,-24,21
CC Mariners,2567,10,4,8,15,28,49,-21,20
Sydney FC,2568,1,21,4,3,65,22,43,67
N'castle Jet,2568,2,15,5,8,58,41,17,50
Melbourne C,2568,3,15,4,10,47,34,13,49
Melbourne V,2568,4,13,5,11,45,39,6,44
Adelaide Utd,2568,5,11,6,11,37,40,-3,39
Brisbane,2568,6,10,5,13,33,42,-9,35
Western Sydn,2568,7,8,9,10,38,47,-9,33
Perth Glory,2568,8,10,2,15,37,50,-13,32
Wellington P,2568,9,5,6,16,31,55,-24,21
CC Mariners,2568,10,4,8,15,28,49,-21,20
Sydney FC,2569,1,20,5,3,66,24,42,65
N'castle Jet,2569,2,15,5,8,57,38,19,50
Melbourne C,2569,3,15,4,10,44,33,11,49
Melbourne V,2569,4,13,6,10,47,40,7,45
Adelaide Utd,2569,5,11,6,11,37,40,-3,39
Brisbane,2569,6,10,5,13,33,42,-9,35
Western Sydn,2569,7,8,9,10,38,47,-9,33
Perth Glory,2569,8,10,2,15,37,50,-13,32
Wellington P,2569,9,5,6,16,31,55,-24,21
CC Mariners,2569,10,4,8,15,28,49,-21,20
Sydney FC,2570,1,21,4,3,67,23,44,67
N'castle Jet,2570,2,16,5,7,59,38,21,53
Melbourne C,2570,3,14,4,11,44,35,9,46
Melbourne V,2570,4,13,5,11,46,41,5,44
Adelaide Utd,2570,5,11,6,11,37,40,-3,39
Brisbane,2570,6,10,5,13,33,42,-9,35
Western Sydn,2570,7,8,9,10,38,47,-9,33
Perth Glory,2570,8,10,2,15,37,50,-13,32
Wellington P,2570,9,5,6,16,31,55,-24,21
CC Mariners,2570,10,4,8,15,28,49,-21,20
Sydney FC,2571,1,20,5,3,65,23,42,65
N'castle Jet,2571,2,16,5,7,60,39,21,53
Melbourne C,2571,3,14,4,11,45,36,9,46
Melbourne V,2571,4,13,6,10,46,39,7,45
Adelaide Utd,2571,5,11,6,11,37,40,-3,39
Brisbane,2571,6,10,5,13,33,42,-9,35
Western Sydn,2571,7,8,9,10,38,47,-9,33
Perth Glory,2571,8,10,2,15,37,50,-13,32
Wellington P,2571,9,5,6,16,31,55,-24,21
CC Mariners,2571,10,4,8,15,28,49,-21,20
Sydney FC,2572,1,20,4,4,64,23,41,64
N'castle Jet,2572,2,16,5,7,60,39,21,53
Melbourne V,2572,3,14,5,10,46,38,8,47
Melbourne C,2572,4,14,4,11,45,36,9,46
Adelaide Utd,2572,5,11,6,11,37,40,-3,39
Brisbane,2572,6,10,5,13,33,42,-9,35
Western Sydn,2572,7,8,9,10,38,47,-9,33
Perth Glory,2572,8,10,2,15,37,50,-13,32
Wellington P,2572,9,5,6,16,31,55,-24,21
CC Mariners,2572,10,4,8,15,28,49,-21,20
Sydney FC,2573,1,20,4,4,64,24,40,64
N'castle Jet,2573,2,15,5,8,58,39,19,50
Melbourne C,2573,3,15,4,10,45,34,11,49
Melbourne V,2573,4,14,5,10,47,38,9,47
Adelaide Utd,2573,5,11,6,11,37,40,-3,39
Brisbane,2573,6,10,5,13,33,42,-9,35
Western Sydn,2573,7,8,9,10,38,47,-9,33
Perth Glory,2573,8,10,2,15,37,50,-13,32
Wellington P,2573,9,5,6,16,31,55,-24,21
CC Mariners,2573,10,4,8,15,28,49,-21,20
Sydney FC,2574,1,21,4,3,66,23,43,67
N'castle Jet,2574,2,15,6,7,58,38,20,51
Melbourne C,2574,3,14,5,10,44,34,10,47
Melbourne V,2574,4,13,5,11,46,40,6,44
Adelaide Utd,2574,5,11,6,11,37,40,-3,39
Brisbane,2574,6,10,5,13,33,42,-9,35
Western Sydn,2574,7,8,9,10,38,47,-9,33
Perth Glory,2574,8,10,2,15,37,50,-13,32
Wellington P,2574,9,5,6,16,31,55,-24,21
CC Mariners,2574,10,4,8,15,28,49,-21,20
Sydney FC,2575,1,20,4,4,65,24,41,64
N'castle Jet,2575,2,16,5,7,59,37,22,53
Melbourne V,2575,3,14,5,10,47,39,8,47
Melbourne C,2575,4,14,4,11,43,35,8,46
Adelaide Utd,2575,5,11,6,11,37,40,-3,39
Brisbane,2575,6,10,5,13,33,42,-9,35
Western Sydn,2575,7,8,9,10,38,47,-9,33
Perth Glory,2575,8,10,2,15,37,50,-13,32
Wellington P,2575,9,5,6,16,31,55,-24,21
CC Mariners,2575,10,4,8,15,28,49,-21,20
Sydney FC,2576,1,20,4,4,64,23,41,64
N'castle Jet,2576,2,15,6,7,58,38,20,51
Melbourne C,2576,3,14,5,10,44,34,10,47
Melbourne V,2576,4,14,5,10,46,38,8,47
Adelaide Utd,2576,5,11,6,11,37,40,-3,39
Brisbane,2576,6,10,5,13,33,42,-9,35
Western Sydn,2576,7,8,9,10,38,47,-9,33
Perth Glory,2576,8,10,2,15,37,50,-13,32
Wellington P,2576,9,5,6,16,31,55,-24,21
CC Mariners,2576,10,4,8,15,28,49,-21,20
Sydney FC,2577,1,21,4,3,66,23,43,67
N'castle Jet,2577,2,16,5,7,60,39,21,53
Melbourne C,2577,3,14,4,11,45,36,9,46
Melbourne V,2577,4,13,5,11,46,40,6,44
Adelaide Utd,2577,5,11,6,11,37,40,-3,39
Brisbane,2577,6,10,5,13,33,42,-9,35
Western Sydn,2577,7,8,9,10,38,47,-9,33
Perth Glory,2577,8,10,2,15,37,50,-13,32
Wellington P,2577,9,5,6,16,31,55,-24,21
CC Mariners,2577,10,4,8,15,28,49,-21,20
Sydney FC,2578,1,21,4,3,67,23,44,67
N'castle Jet,2578,2,15,6,7,57,37,20,51
Melbourne C,2578,3,14,5,10,43,33,10,47
Melbourne V,2578,4,13,5,11,46,41,5,44
Adelaide Utd,2578,5,11,6,11,37,40,-3,39
Brisbane,2578,6,10,5,13,33,42,-9,35
Western Sydn,2578,7,8,9,10,38,47,-9,33
Perth Glory,2578,8,10,2,15,37,50,-13,32
Wellington P,2578,9,5,6,16,31,55,-24,21
CC Mariners,2578,10,4,8,15,28,49,-21,20
Sydney FC,2579,1,21,4,3,66,23,43,67
N'castle Jet,2579,2,16,5,7,61,37,24,53
Melbourne C,2579,3,14,4,11,43,37,6,46
Melbourne V,2579,4,13,5,11,46,40,6,44
Adelaide Utd,2579,5,11,6,11,37,40,-3,39
Brisbane,2579,6,10,5,13,33,42,-9,35
Western Sydn,2579,7,8,9,10,38,47,-9,33
Perth Glory,2579,8,10,2,15,37,50,-13,32
Wellington P,2579,9,5,6,16,31,55,-24,21
CC Mariners,2579,10,4,8,15,28,49,-21,20
Sydney FC,2580,1,20,5,3,66,24,42,65
N'castle Jet,2580,2,15,6,7,59,39,20,51
Melbourne C,2580,3,14,5,10,45,35,10,47
Melbourne V,2580,4,13,6,10,47,40,7,45
Adelaide Utd,2580,5,11,6,11,37,40,-3,39
Brisbane,2580,6,10,5,13,33,42,-9,35
Western Sydn,2580,7,8,9,10,38,47,-9,33
Perth Glory,2580,8,10,2,15,37,50,-13,32
Wellington P,2580,9,5,6,16,31,55,-24,21
CC Mariners,2580,10,4,8,15,28,49,-21,20
Sydney FC,2581,1,21,4,3,67,23,44,67
N'castle Jet,2581,2,16,5,7,63,37,26,53
Melbourne C,2581,3,14,4,11,43,39,4,46
Melbourne V,2581,4,13,5,11,46,41,5,44
Adelaide Utd,2581,5,11,6,11,37,40,-3,39
Brisbane,2581,6,10,5,13,33,42,-9,35
Western Sydn,2581,7,8,9,10,38,47,-9,33
Perth Glory,2581,8,10,2,15,37,50,-13,32
Wellington P,2581,9,5,6,16,31,55,-24,21
CC Mariners,2581,10,4,8,15,28,49,-21,20
Sydney FC,2582,1,21,4,3,66,22,44,67
N'castle Jet,2582,2,15,5,8,57,38,19,50
Melbourne C,2582,3,15,4,10,44,33,11,49
Melbourne V,2582,4,13,5,11,45,40,5,44
Adelaide Utd,2582,5,11,6,11,37,40,-3,39
Brisbane,2582,6,10,5,13,33,42,-9,35
Western Sydn,2582,7,8,9,10,38,47,-9,33
Perth Glory,2582,8,10,2,15,37,50,-13,32
Wellington P,2582,9,5,6,16,31,55,-24,21
CC Mariners,2582,10,4,8,15,28,49,-21,20
Sydney FC,2583,1,21,4,3,66,23,43,67
N'castle Jet,2583,2,16,5,7,60,38,22,53
Melbourne C,2583,3,14,4,11,44,36,8,46
Melbourne V,2583,4,13,5,11,46,40,6,44
Adelaide Utd,2583,5,11,6,11,37,40,-3,39
Brisbane,2583,6,10,5,13,33,42,-9,35
Western Sydn,2583,7,8,9,10,38,47,-9,33
Perth Glory,2583,8,10,2,15,37,50,-13,32
Wellington P,2583,9,5,6,16,31,55,-24,21
CC Mariners,2583,10,4,8,15,28,49,-21,20
Sydney FC,2584,1,20,5,3,67,25,42,65
N'castle Jet,2584,2,15,5,8,58,39,19,50
Melbourne C,2584,3,15,4,10,45,34,11,49
Melbourne V,2584,4,13,6,10,48,41,7,45
Adelaide Utd,2584,5,11,6,11,37,40,-3,39
Brisbane,2584,6,10,5,13,33,42,-9,35
Western Sydn,2584,7,8,9,10,38,47,-9,33
Perth Glory,2584,8,10,2,15,37,50,-13,32
Wellington P,2584,9,5,6,16,31,55,-24,21
CC Mariners,2584,10,4,8,15,28,49,-21,20
Sydney FC,2585,1,20,4,4,64,24,40,64
N'castle Jet,2585,2,15,5,8,57,40,17,50
Melbourne C,2585,3,15,4,10,46,33,13,49
Melbourne V,2585,4,14,5,10,47,38,9,47
Adelaide Utd,2585,5,11,6,11,37,40,-3,39
Brisbane,2585,6,10,5,13,33,42,-9,35
Western Sydn,2585,7,8,9,10,38,47,-9,33
Perth Glory,2585,8,10,2,15,37,50,-13,32
Wellington P,2585,9,5,6,16,31,55,-24,21
CC Mariners,2585,10,4,8,15,28,49,-21,20
Sydney FC,2586,1,21,4,3,66,23,43,67
N'castle Jet,2586,2,16,5,7,60,38,22,53
Melbourne C,2586,3,14,4,11,44,36,8,46
Melbourne V,2586,4,13,5,11,46,40,6,44
Adelaide Utd,2586,5,11,6,11,37,40,-3,39
Brisbane,2586,6,10,5,13,33,42,-9,35
Western Sydn,2586,7,8,9,10,38,47,-9,33
Perth Glory,2586,8,10,2,15,37,50,-13,32
Wellington P,2586,9,5,6,16,31,55,-24,21
CC Mariners,2586,10,4,8,15,28,49,-21,20
Sydney FC,2587,1,20,5,3,65,23,42,65
N'castle Jet,2587,2,16,5,7,60,37,23,53
Melbourne C,2587,3,14,4,11,43,36,7,46
Melbourne V,2587,4,13,6,10,46,39,7,45
Adelaide Utd,2587,5,11,6,11,37,40,-3,39
Brisbane,2587,6,10,5,13,33,42,-9,35
Western Sydn,2587,7,8,9,10,38,47,-9,33
Perth Glory,2587,8,10,2,15,37,50,-13,32
Wellington P,2587,9,5,6,16,31,55,-24,21
CC Mariners,2587,10,4,8,15,28,49,-21,20
Sydney FC,2588,1,21,4,3,66,22,44,67
N'castle Jet,2588,2,15,6,7,59,39,20,51
Melbourne C,2588,3,14,5,10,45,35,10,47
Melbourne V,2588,4,13,5,11,45,40,5,44
Adelaide Utd,2588,5,11,6,11,37,40,-3,39
Brisbane,2588,6,10,5,13,33,42,-9,35
Western Sydn,2588,7,8,9,10,38,47,-9,33
Perth Glory,2588,8,10,2,15,37,50,-13,32
Wellington P,2588,9,5,6,16,31,55,-24,21
CC Mariners,2588,10,4,8,15,28,49,-21,20
Sydney FC,2589,1,21,4,3,66,23,43,67
N'castle Jet,2589,2,16,5,7,59,37,22,53
Melbourne C,2589,3,14,4,11,43,35,8,46
Melbourne V,2589,4,13,5,11,46,40,6,44
Adelaide Utd,2589,5,11,6,11,37,40,-3,39
Brisbane,2589,6,10,5,13,33,42,-9,35
Western Sydn,2589,7,8,9,10,38,47,-9,33
Perth Glory,2589,8,10,2,15,37,50,-13,32
Wellington P,2589,9,5,6,16,31,55,-24,21
CC Mariners,2589,10,4,8,15,28,49,-21,20
Sydney FC,2590,1,21,4,3,67,22,45,67
N'castle Jet,2590,2,16,5,7,62,37,25,53
Melbourne C,2590,3,14,4,11,43,38,5,46
Melbourne V,2590,4,13,5,11,45,41,4,44
Adelaide Utd,2590,5,11,6,11,37,40,-3,39
Brisbane,2590,6,10,5,13,33,42,-9,35
Western Sydn,2590,7,8,9,10,38,47,-9,33
Perth Glory,2590,8,10,2,15,37,50,-13,32
Wellington P,2590,9,5,6,16,31,55,-24,21
CC Mariners,2590,10,4,8,15,28,49,-21,20
Sydney FC,2591,1,21,4,3,67,23,44,67
N'castle Jet,2591,2,15,6,7,58,38,20,51
Melbourne C,2591,3,14,5,10,44,34,10,47
Melbourne V,2591,4,13,5,11,46,41,5,44
Adelaide Utd,2591,5,11,6,11,37,40,-3,39
Brisbane,2591,6,10,5,13,33,42,-9,35
Western Sydn,2591,7,8,9,10,38,47,-9,33
Perth Glory,2591,8,10,2,15,37,50,-13,32
Wellington P,2591,9,5,6,16,31,55,-24,21
CC Mariners,2591,10,4,8,15,28,49,-21,20
Sydney FC,2592,1,21,4,3,66,22,44,67
N'castle Jet,2592,2,16,5,7,59,37,22,53
Melbourne C,2592,3,14,4,11,43,35,8,46
Melbourne V,2592,4,13,5,11,45,40,5,44
Adelaide Utd,2592,5,11,6,11,37,40,-3,39
Brisbane,2592,6,10,5,13,33,42,-9,35
Western Sydn,2592,7,8,9,10,38,47,-9,33
Perth Glory,2592,8,10,2,15,37,50,-13,32
Wellington P,2592,9,5,6,16,31,55,-24,21
CC Mariners,2592,10,4,8,15,28,49,-21,20
Sydney FC,2593,1,20,4,4,64,23,41,64
N'castle Jet,2593,2,16,5,7,59,37,22,53
Melbourne V,2593,3,14,5,10,46,38,8,47
Melbourne C,2593,4,14,4,11,43,35,8,46
Adelaide Utd,2593,5,11,6,11,37,40,-3,39
Brisbane,2593,6,10,5,13,33,42,-9,35
Western Sydn,2593,7,8,9,10,38,47,-9,33
Perth Glory,2593,8,10,2,15,37,50,-13,32
Wellington P,2593,9,5,6,16,31,55,-24,21
CC Mariners,2593,10,4,8,15,28,49,-21,20
Sydney FC,2594,1,21,4,3,67,23,44,67
N'castle Jet,2594,2,16,5,7,59,37,22,53
Melbourne C,2594,3,14,4,11,43,35,8,46
Melbourne V,2594,4,13,5,11,46,41,5,44
Adelaide Utd,2594,5,11,6,11,37,40,-3,39
Brisbane,2594,6,10,5,13,33,42,-9,35
Western Sydn,2594,7,8,9,10,38,47,-9,33
Perth Glory,2594,8,10,2,15,37,50,-13,32
Wellington P,2594,9,5,6,16,31,55,-24,21
CC Mariners,2594,10,4,8,15,28,49,-21,20
Sydney FC,2595,1,20,5,3,67,25,42,65
N'castle Jet,2595,2,15,5,8,57,40,17,50
Melbourne C,2595,3,15,4,10,46,33,13,49
Melbourne V,2595,4,13,6,10,48,41,7,45
Adelaide Utd,2595,5,11,6,11,37,40,-3,39
Brisbane,2595,6,10,5,13,33,42,-9,35
Western Sydn,2595,7,8,9,10,38,47,-9,33
Perth Glory,2595,8,10,2,15,37,50,-13,32
Wellington P,2595,9,5,6,16,31,55,-24,21
CC Mariners,2595,10,4,8,15,28,49,-21,20
Sydney FC,2596,1,21,4,3,66,22,44,67
N'castle Jet,2596,2,15,5,8,59,41,18,50
Melbourne C,2596,3,15,4,10,47,35,12,49
Melbourne V,2596,4,13,5,11,45,40,5,44
Adelaide Utd,2596,5,11,6,11,37,40,-3,39
Brisbane,2596,6,10,5,13,33,42,-9,35
Western Sydn,2596,7,8,9,10,38,47,-9,33
Perth Glory,2596,8,10,2,15,37,50,-13,32
Wellington P,2596,9,5,6,16,31,55,-24,21
CC Mariners,2596,10,4,8,15,28,49,-21,20
Sydney FC,2597,1,21,4,3,68,23,45,67
N'castle Jet,2597,2,15,6,7,60,40,20,51
Melbourne C,2597,3,14,5,10,46,36,10,47
Melbourne V,2597,4,13,5,11,46,42,4,44
Adelaide Utd,2597,5,11,6,11,37,40,-3,39
Brisbane,2597,6,10,5,13,33,42,-9,35
Western Sydn,2597,7,8,9,10,38,47,-9,33
Perth Glory,2597,8,10,2,15,37,50,-13,32
Wellington P,2597,9,5,6,16,31,55,-24,21
CC Mariners,2597,10,4,8,15,28,49,-21,20
Sydney FC,2598,1,20,5,3,67,25,42,65
N'castle Jet,2598,2,16,5,7,61,38,23,53
Melbourne C,2598,3,14,4,11,44,37,7,46
Melbourne V,2598,4,13,6,10,48,41,7,45
Adelaide Utd,2598,5,11,6,11,37,40,-3,39
Brisbane,2598,6,10,5,13,33,42,-9,35
Western Sydn,2598,7,8,9,10,38,47,-9,33
Perth Glory,2598,8,10,2,15,37,50,-13,32
Wellington P,2598,9,5,6,16,31,55,-24,21
CC Mariners,2598,10,4,8,15,28,49,-21,20
Sydney FC,2599,1,21,4,3,66,23,43,67
N'castle Jet,2599,2,16,5,7,61,38,23,53
Melbourne C,2599,3,14,4,11,44,37,7,46
Melbourne V,2599,4,13,5,11,46,40,6,44
Adelaide Utd,2599,5,11,6,11,37,40,-3,39
Brisbane,2599,6,10,5,13,33,42,-9,35
Western Sydn,2599,7,8,9,10,38,47,-9,33
Perth Glory,2599,8,10,2,15,37,50,-13,32
Wellington P,2599,9,5,6,16,31,55,-24,21
CC Mariners,2599,10,4,8,15,28,49,-21,20
Sydney FC,2600,1,20,4,4,66,25,41,64
N'castle Jet,2600,2,16,5,7,60,37,23,53
Melbourne V,2600,3,14,5,10,48,40,8,47
Melbourne C,2600,4,14,4,11,43,36,7,46
Adelaide Utd,2600,5,11,6,11,37,40,-3,39
Brisbane,2600,6,10,5,13,33,42,-9,35
Western Sydn,2600,7,8,9,10,38,47,-9,33
Perth Glory,2600,8,10,2,15,37,50,-13,32
Wellington P,2600,9,5,6,16,31,55,-24,21
CC Mariners,2600,10,4,8,15,28,49,-21,20
Sydney FC,2601,1,21,4,3,65,22,43,67
N'castle Jet,2601,2,15,5,8,58,39,19,50
Melbourne C,2601,3,15,4,10,45,34,11,49
Melbourne V,2601,4,13,5,11,45,39,6,44
Adelaide Utd,2601,5,11,6,11,37,40,-3,39
Brisbane,2601,6,10,5,13,33,42,-9,35
Western Sydn,2601,7,8,9,10,38,47,-9,33
Perth Glory,2601,8,10,2,15,37,50,-13,32
Wellington P,2601,9,5,6,16,31,55,-24,21
CC Mariners,2601,10,4,8,15,28,49,-21,20
Sydney FC,2602,1,20,4,4,65,24,41,64
N'castle Jet,2602,2,16,5,7,61,37,24,53
Melbourne V,2602,3,14,5,10,47,39,8,47
Melbourne C,2602,4,14,4,11,43,37,6,46
Adelaide Utd,2602,5,11,6,11,37,40,-3,39
Brisbane,2602,6,10,5,13,33,42,-9,35
Western Sydn,2602,7,8,9,10,38,47,-9,33
Perth Glory,2602,8,10,2,15,37,50,-13,32
Wellington P,2602,9,5,6,16,31,55,-24,21
CC Mariners,2602,10,4,8,15,28,49,-21,20
Sydney FC,2603,1,20,4,4,64,25,39,64
N'castle Jet,2603,2,16,5,7,59,38,21,53
Melbourne V,2603,3,14,5,10,48,38,10,47
Melbourne C,2603,4,14,4,11,44,35,9,46
Adelaide Utd,2603,5,11,6,11,37,40,-3,39
Brisbane,2603,6,10,5,13,33,42,-9,35
Western Sydn,2603,7,8,9,10,38,47,-9,33
Perth Glory,2603,8,10,2,15,37,50,-13,32
Wellington P,2603,9,5,6,16,31,55,-24,21
CC Mariners,2603,10,4,8,15,28,49,-21,20
Sydney FC,2604,1,21,4,3,67,24,43,67
N'castle Jet,2604,2,16,5,7,59,38,21,53
Melbourne C,2604,3,14,4,11,44,35,9,46
Melbourne V,2604,4,13,5,11,47,41,6,44
Adelaide Utd,2604,5,11,6,11,37,40,-3,39
Brisbane,2604,6,10,5,13,33,42,-9,35
Western Sydn,2604,7,8,9,10,38,47,-9,33
Perth Glory,2604,8,10,2,15,37,50,-13,32
Wellington P,2604,9,5,6,16,31,55,-24,21
CC Mariners,2604,10,4,8,15,28,49,-21,20
Sydney FC,2605,1,21,4,3,68,25,43,67
N'castle Jet,2605,2,16,5,7,60,37,23,53
Melbourne C,2605,3,14,4,11,43,36,7,46
Melbourne V,2605,4,13,5,11,48,42,6,44
Adelaide Utd,2605,5,11,6,11,37,40,-3,39
Brisbane,2605,6,10,5,13,33,42,-9,35
Western Sydn,2605,7,8,9,10,38,47,-9,33
Perth Glory,2605,8,10,2,15,37,50,-13,32
Wellington P,2605,9,5,6,16,31,55,-24,21
CC Mariners,2605,10,4,8,15,28,49,-21,20
Sydney FC,2606,1,20,5,3,66,24,42,65
N'castle Jet,2606,2,15,6,7,58,38,20,51
Melbourne C,2606,3,14,5,10,44,34,10,47
Melbourne V,2606,4,13,6,10,47,40,7,45
Adelaide Utd,2606,5,11,6,11,37,40,-3,39
Brisbane,2606,6,10,5,13,33,42,-9,35
Western Sydn,2606,7,8,9,10,38,47,-9,33
Perth Glory,2606,8,10,2,15,37,50,-13,32
Wellington P,2606,9,5,6,16,31,55,-24,21
CC Mariners,2606,10,4,8,15,28,49,-21,20
Sydney FC,2607,1,21,4,3,68,22,46,67
N'castle Jet,2607,2,16,5,7,59,37,22,53
Melbourne C,2607,3,14,4,11,43,35,8,46
Melbourne V,2607,4,13,5,11,45,42,3,44
Adelaide Utd,2607,5,11,6,11,37,40,-3,39
Brisbane,2607,6,10,5,13,33,42,-9,35
Western Sydn,2607,7,8,9,10,38,47,-9,33
Perth Glory,2607,8,10,2,15,37,50,-13,32
Wellington P,2607,9,5,6,16,31,55,-24,21
CC Mariners,2607,10,4,8,15,28,49,-21,20
Sydney FC,2608,1,20,5,3,64,22,42,65
N'castle Jet,2608,2,15,6,7,59,39,20,51
Melbourne C,2608,3,14,5,10,45,35,10,47
Melbourne V,2608,4,13,6,10,45,38,7,45
Adelaide Utd,2608,5,11,6,11,37,40,-3,39
Brisbane,2608,6,10,5,13,33,42,-9,35
Western Sydn,2608,7,8,9,10,38,47,-9,33
Perth Glory,2608,8,10,2,15,37,50,-13,32
Wellington P,2608,9,5,6,16,31,55,-24,21
CC Mariners,2608,10,4,8,15,28,49,-21,20
Sydney FC,2609,1,21,4,3,67,23,44,67
N'castle Jet,2609,2,16,5,7,62,40,22,53
Melbourne C,2609,3,14,4,11,46,38,8,46
Melbourne V,2609,4,13,5,11,46,41,5,44
Adelaide Utd,2609,5,11,6,11,37,40,-3,39
Brisbane,2609,6,10,5,13,33,42,-9,35
Western Sydn,2609,7,8,9,10,38,47,-9,33
Perth Glory,2609,8,10,2,15,37,50,-13,32
Wellington P,2609,9,5,6,16,31,55,-24,21
CC Mariners,2609,10,4,8,15,28,49,-21,20
Sydney FC,2610,1,21,4,3,67,23,44,67
N'castle Jet,2610,2,15,5,8,58,39,19,50
Melbourne C,2610,3,15,4,10,45,34,11,49
Melbourne V,2610,4,13,5,11,46,41,5,44
Adelaide Utd,2610,5,11,6,11,37,40,-3,39
Brisbane,2610,6,10,5,13,33,42,-9,35
Western Sydn,2610,7,8,9,10,38,47,-9,33
Perth Glory,2610,8,10,2,15,37,50,-13,32
Wellington P,2610,9,5,6,16,31,55,-24,21
CC Mariners,2610,10,4,8,15,28,49,-21,20
Sydney FC,2611,1,21,4,3,67,22,45,67
N'castle Jet,2611,2,15,5,8,57,39,18,50
Melbourne C,2611,3,15,4,10,45,33,12,49
Melbourne V,2611,4,13,5,11,45,41,4,44
Adelaide Utd,2611,5,11,6,11,37,40,-3,39
Brisbane,2611,6,10,5,13,33,42,-9,35
Western Sydn,2611,7,8,9,10,38,47,-9,33
Perth Glory,2611,8,10,2,15,37,50,-13,32
Wellington P,2611,9,5,6,16,31,55,-24,21
CC Mariners,2611,10,4,8,15,28,49,-21,20
Sydney FC,2612,1,21,4,3,68,22,46,67
N'castle Jet,2612,2,15,5,8,59,40,19,50
Melbourne C,2612,3,15,4,10,46,35,11,49
Melbourne V,2612,4,13,5,11,45,42,3,44
Adelaide Utd,2612,5,11,6,11,37,40,-3,39
Brisbane,2612,6,10,5,13,33,42,-9,35
Western Sydn,2612,7,8,9,10,38,47,-9,33
Perth Glory,2612,8,10,2,15,37,50,-13,32
Wellington P,2612,9,5,6,16,31,55,-24,21
CC Mariners,2612,10,4,8,15,28,49,-21,20
Sydney FC,2613,1,21,4,3,66,22,44,67
N'castle Jet,2613,2,16,5,7,59,38,21,53
Melbourne C,2613,3,14,4,11,44,35,9,46
Melbourne V,2613,4,13,5,11,45,40,5,44
Adelaide Utd,2613,5,11,6,11,37,40,-3,39
Brisbane,2613,6,10,5,13,33,42,-9,35
Western Sydn,2613,7,8,9,10,38,47,-9,33
Perth Glory,2613,8,10,2,15,37,50,-13,32
Wellington P,2613,9,5,6,16,31,55,-24,21
CC Mariners,2613,10,4,8,15,28,49,-21,20
Sydney FC,2614,1,21,4,3,70,22,48,67
N'castle Jet,2614,2,16,5,7,59,37,22,53
Melbourne C,2614,3,14,4,11,43,35,8,46
Melbourne V,2614,4,13,5,11,45,44,1,44
Adelaide Utd,2614,5,11,6,11,37,40,-3,39
Brisbane,2614,6,10,5,13,33,42,-9,35
Western Sydn,2614,7,8,9,10,38,47,-9,33
Perth Glory,2614,8,10,2,15,37,50,-13,32
Wellington P,2614,9,5,6,16,31,55,-24,21
CC Mariners,2614,10,4,8,15,28,49,-21,20
Sydney FC,2615,1,21,4,3,66,22,44,67
N'castle Jet,2615,2,15,6,7,59,39,20,51
Melbourne C,2615,3,14,5,10,45,35,10,47
Melbourne V,2615,4,13,5,11,45,40,5,44
Adelaide Utd,2615,5,11,6,11,37,40,-3,39
Brisbane,2615,6,10,5,13,33,42,-9,35
Western Sydn,2615,7,8,9,10,38,47,-9,33
Perth Glory,2615,8,10,2,15,37,50,-13,32
Wellington P,2615,9,5,6,16,31,55,-24,21
CC Mariners,2615,10,4,8,15,28,49,-21,20
Sydney FC,2616,1,21,4,3,65,22,43,67
N'castle Jet,2616,2,16,5,7,62,38,24,53
Melbourne C,2616,3,14,4,11,44,38,6,46
Melbourne V,2616,4,13,5,11,45,39,6,44
Adelaide Utd,2616,5,11,6,11,37,40,-3,39
Brisbane,2616,6,10,5,13,33,42,-9,35
Western Sydn,2616,7,8,9,10,38,47,-9,33
Perth Glory,2616,8,10,2,15,37,50,-13,32
Wellington P,2616,9,5,6,16,31,55,-24,21
CC Mariners,2616,10,4,8,15,28,49,-21,20
Sydney FC,2617,1,20,4,4,64,23,41,64
N'castle Jet,2617,2,16,5,7,60,38,22,53
Melbourne V,2617,3,14,5,10,46,38,8,47
Melbourne C,2617,4,14,4,11,44,36,8,46
Adelaide Utd,2617,5,11,6,11,37,40,-3,39
Brisbane,2617,6,10,5,13,33,42,-9,35
Western Sydn,2617,7,8,9,10,38,47,-9,33
Perth Glory,2617,8,10,2,15,37,50,-13,32
Wellington P,2617,9,5,6,16,31,55,-24,21
CC Mariners,2617,10,4,8,15,28,49,-21,20
Sydney FC,2618,1,21,4,3,68,23,45,67
N'castle Jet,2618,2,15,6,7,57,37,20,51
Melbourne C,2618,3,14,5,10,43,33,10,47
Melbourne V,2618,4,13,5,11,46,42,4,44
Adelaide Utd,2618,5,11,6,11,37,40,-3,39
Brisbane,2618,6,10,5,13,33,42,-9,35
Western Sydn,2618,7,8,9,10,38,47,-9,33
Perth Glory,2618,8,10,2,15,37,50,-13,32
Wellington P,2618,9,5,6,16,31,55,-24,21
CC Mariners,2618,10,4,8,15,28,49,-21,20
Sydney FC,2619,1,21,4,3,67,23,44,67
N'castle Jet,2619,2,16,5,7,62,37,25,53
Melbourne C,2619,3,14,4,11,43,38,5,46
Melbourne V,2619,4,13,5,11,46,41,5,44
Adelaide Utd,2619,5,11,6,11,37,40,-3,39
Brisbane,2619,6,10,5,13,33,42,-9,35
Western Sydn,2619,7,8,9,10,38,47,-9,33
Perth Glory,2619,8,10,2,15,37,50,-13,32
Wellington P,2619,9,5,6,16,31,55,-24,21
CC Mariners,2619,10,4,8,15,28,49,-21,20
Sydney FC,2620,1,20,4,4,64,23,41,64
N'castle Jet,2620,2,16,5,7,61,38,23,53
Melbourne V,2620,3,14,5,10,46,38,8,47
Melbourne C,2620,4,14,4,11,44,37,7,46
Adelaide Utd,2620,5,11,6,11,37,40,-3,39
Brisbane,2620,6,10,5,13,33,42,-9,35
Western Sydn,2620,7,8,9,10,38,47,-9,33
Perth Glory,2620,8,10,2,15,37,50,-13,32
Wellington P,2620,9,5,6,16,31,55,-24,21
CC Mariners,2620,10,4,8,15,28,49,-21,20
Sydney FC,2621,1,20,4,4,64,25,39,64
N'castle Jet,2621,2,16,5,7,60,38,22,53
Melbourne V,2621,3,14,5,10,48,38,10,47
Melbourne C,2621,4,14,4,11,44,36,8,46
Adelaide Utd,2621,5,11,6,11,37,40,-3,39
Brisbane,2621,6,10,5,13,33,42,-9,35
Western Sydn,2621,7,8,9,10,38,47,-9,33
Perth Glory,2621,8,10,2,15,37,50,-13,32
Wellington P,2621,9,5,6,16,31,55,-24,21
CC Mariners,2621,10,4,8,15,28,49,-21,20
Sydney FC,2622,1,21,4,3,67,22,45,67
N'castle Jet,2622,2,16,5,7,60,38,22,53
Melbourne C,2622,3,14,4,11,44,36,8,46
Melbourne V,2622,4,13,5,11,45,41,4,44
Adelaide Utd,2622,5,11,6,11,37,40,-3,39
Brisbane,2622,6,10,5,13,33,42,-9,35
Western Sydn,2622,7,8,9,10,38,47,-9,33
Perth Glory,2622,8,10,2,15,37,50,-13,32
Wellington P,2622,9,5,6,16,31,55,-24,21
CC Mariners,2622,10,4,8,15,28,49,-21,20
Sydney FC,2623,1,21,4,3,66,23,43,67
N'castle Jet,2623,2,15,5,8,57,38,19,50
Melbourne C,2623,3,15,4,10,44,33,11,49
Melbourne V,2623,4,13,5,11,46,40,6,44
Adelaide Utd,2623,5,11,6,11,37,40,-3,39
Brisbane,2623,6,10,5,13,33,42,-9,35
Western Sydn,2623,7,8,9,10,38,47,-9,33
Perth Glory,2623,8,10,2,15,37,50,-13,32
Wellington P,2623,9,5,6,16,31,55,-24,21
CC Mariners,2623,10,4,8,15,28,49,-21,20
Sydney FC,2624,1,20,5,3,65,23,42,65
N'castle Jet,2624,2,16,5,7,62,37,25,53
Melbourne C,2624,3,14,4,11,43,38,5,46
Melbourne V,2624,4,13,6,10,46,39,7,45
Adelaide Utd,2624,5,11,6,11,37,40,-3,39
Brisbane,2624,6,10,5,13,33,42,-9,35
Western Sydn,2624,7,8,9,10,38,47,-9,33
Perth Glory,2624,8,10,2,15,37,50,-13,32
Wellington P,2624,9,5,6,16,31,55,-24,21
CC Mariners,2624,10,4,8,15,28,49,-21,20
Sydney FC,2625,1,20,5,3,66,24,42,65
N'castle Jet,2625,2,15,5,8,58,39,19,50
Melbourne C,2625,3,15,4,10,45,34,11,49
Melbourne V,2625,4,13,6,10,47,40,7,45
Adelaide Utd,2625,5,11,6,11,37,40,-3,39
Brisbane,2625,6,10,5,13,33,42,-9,35
Western Sydn,2625,7,8,9,10,38,47,-9,33
Perth Glory,2625,8,10,2,15,37,50,-13,32
Wellington P,2625,9,5,6,16,31,55,-24,21
CC Mariners,2625,10,4,8,15,28,49,-21,20
Sydney FC,2626,1,21,4,3,66,23,43,67
N'castle Jet,2626,2,15,6,7,59,39,20,51
Melbourne C,2626,3,14,5,10,45,35,10,47
Melbourne V,2626,4,13,5,11,46,40,6,44
Adelaide Utd,2626,5,11,6,11,37,40,-3,39
Brisbane,2626,6,10,5,13,33,42,-9,35
Western Sydn,2626,7,8,9,10,38,47,-9,33
Perth Glory,2626,8,10,2,15,37,50,-13,32
Wellington P,2626,9,5,6,16,31,55,-24,21
CC Mariners,2626,10,4,8,15,28,49,-21,20
Sydney FC,2627,1,21,4,3,67,24,43,67
N'castle Jet,2627,2,15,5,8,58,39,19,50
Melbourne C,2627,3,15,4,10,45,34,11,49
Melbourne V,2627,4,13,5,11,47,41,6,44
Adelaide Utd,2627,5,11,6,11,37,40,-3,39
Brisbane,2627,6,10,5,13,33,42,-9,35
Western Sydn,2627,7,8,9,10,38,47,-9,33
Perth Glory,2627,8,10,2,15,37,50,-13,32
Wellington P,2627,9,5,6,16,31,55,-24,21
CC Mariners,2627,10,4,8,15,28,49,-21,20
Sydney FC,2628,1,21,4,3,69,23,46,67
N'castle Jet,2628,2,16,5,7,61,40,21,53
Melbourne C,2628,3,14,4,11,46,37,9,46
Melbourne V,2628,4,13,5,11,46,43,3,44
Adelaide Utd,2628,5,11,6,11,37,40,-3,39
Brisbane,2628,6,10,5,13,33,42,-9,35
Western Sydn,2628,7,8,9,10,38,47,-9,33
Perth Glory,2628,8,10,2,15,37,50,-13,32
Wellington P,2628,9,5,6,16,31,55,-24,21
CC Mariners,2628,10,4,8,15,28,49,-21,20
Sydney FC,2629,1,21,4,3,66,22,44,67
N'castle Jet,2629,2,15,6,7,59,39,20,51
Melbourne C,2629,3,14,5,10,45,35,10,47
Melbourne V,2629,4,13,5,11,45,40,5,44
Adelaide Utd,2629,5,11,6,11,37,40,-3,39
Brisbane,2629,6,10,5,13,33,42,-9,35
Western Sydn,2629,7,8,9,10,38,47,-9,33
Perth Glory,2629,8,10,2,15,37,50,-13,32
Wellington P,2629,9,5,6,16,31,55,-24,21
CC Mariners,2629,10,4,8,15,28,49,-21,20
Sydney FC,2630,1,20,5,3,65,23,42,65
N'castle Jet,2630,2,15,6,7,58,38,20,51
Melbourne C,2630,3,14,5,10,44,34,10,47
Melbourne V,2630,4,13,6,10,46,39,7,45
Adelaide Utd,2630,5,11,6,11,37,40,-3,39
Brisbane,2630,6,10,5,13,33,42,-9,35
Western Sydn,2630,7,8,9,10,38,47,-9,33
Perth Glory,2630,8,10,2,15,37,50,-13,32
Wellington P,2630,9,5,6,16,31,55,-24,21
CC Mariners,2630,10,4,8,15,28,49,-21,20
Sydney FC,2631,1,21,4,3,66,22,44,67
N'castle Jet,2631,2,15,6,7,57,37,20,51
Melbourne C,2631,3,14,5,10,43,33,10,47
Melbourne V,2631,4,13,5,11,45,40,5,44
Adelaide Utd,2631,5,11,6,11,37,40,-3,39
Brisbane,2631,6,10,5,13,33,42,-9,35
Western Sydn,2631,7,8,9,10,38,47,-9,33
Perth Glory,2631,8,10,2,15,37,50,-13,32
Wellington P,2631,9,5,6,16,31,55,-24,21
CC Mariners,2631,10,4,8,15,28,49,-21,20
Sydney FC,2632,1,21,4,3,67,23,44,67
N'castle Jet,2632,2,16,5,7,59,38,21,53
Melbourne C,2632,3,14,4,11,44,35,9,46
Melbourne V,2632,4,13,5,11,46,41,5,44
Adelaide Utd,2632,5,11,6,11,37,40,-3,39
Brisbane,2632,6,10,5,13,33,42,-9,35
Western Sydn,2632,7,8,9,10,38,47,-9,33
Perth Glory,2632,8,10,2,15,37,50,-13,32
Wellington P,2632,9,5,6,16,31,55,-24,21
CC Mariners,2632,10,4,8,15,28,49,-21,20
Sydney FC,2633,1,20,5,3,65,23,42,65
N'castle Jet,2633,2,15,5,8,57,38,19,50
Melbourne C,2633,3,15,4,10,44,33,11,49
Melbourne V,2633,4,13,6,10,46,39,7,45
Adelaide Utd,2633,5,11,6,11,37,40,-3,39
Brisbane,2633,6,10,5,13,33,42,-9,35
Western Sydn,2633,7,8,9,10,38,47,-9,33
Perth Glory,2633,8,10,2,15,37,50,-13,32
Wellington P,2633,9,5,6,16,31,55,-24,21
CC Mariners,2633,10,4,8,15,28,49,-21,20
Sydney FC,2634,1,20,5,3,65,23,42,65
N'castle Jet,2634,2,16,5,7,63,40,23,53
Melbourne C,2634,3,14,4,11,46,39,7,46
Melbourne V,2634,4,13,6,10,46,39,7,45
Adelaide Utd,2634,5,11,6,11,37,40,-3,39
Brisbane,2634,6,10,5,13,33,42,-9,35
Western Sydn,2634,7,8,9,10,38,47,-9,33
Perth Glory,2634,8,10,2,15,37,50,-13,32
Wellington P,2634,9,5,6,16,31,55,-24,21
CC Mariners,2634,10,4,8,15,28,49,-21,20
Sydney FC,2635,1,21,4,3,66,23,43,67
N'castle Jet,2635,2,16,5,7,60,39,21,53
Melbourne C,2635,3,14,4,11,45,36,9,46
Melbourne V,2635,4,13,5,11,46,40,6,44
Adelaide Utd,2635,5,11,6,11,37,40,-3,39
Brisbane,2635,6,10,5,13,33,42,-9,35
Western Sydn,2635,7,8,9,10,38,47,-9,33
Perth Glory,2635,8,10,2,15,37,50,-13,32
Wellington P,2635,9,5,6,16,31,55,-24,21
CC Mariners,2635,10,4,8,15,28,49,-21,20
Sydney FC,2636,1,21,4,3,68,24,44,67
N'castle Jet,2636,2,15,5,8,57,38,19,50
Melbourne C,2636,3,15,4,10,44,33,11,49
Melbourne V,2636,4,13,5,11,47,42,5,44
Adelaide Utd,2636,5,11,6,11,37,40,-3,39
Brisbane,2636,6,10,5,13,33,42,-9,35
Western Sydn,2636,7,8,9,10,38,47,-9,33
Perth Glory,2636,8,10,2,15,37,50,-13,32
Wellington P,2636,9,5,6,16,31,55,-24,21
CC Mariners,2636,10,4,8,15,28,49,-21,20
Sydney FC,2637,1,21,4,3,66,22,44,67
N'castle Jet,2637,2,16,5,7,61,37,24,53
Melbourne C,2637,3,14,4,11,43,37,6,46
Melbourne V,2637,4,13,5,11,45,40,5,44
Adelaide Utd,2637,5,11,6,11,37,40,-3,39
Brisbane,2637,6,10,5,13,33,42,-9,35
Western Sydn,2637,7,8,9,10,38,47,-9,33
Perth Glory,2637,8,10,2,15,37,50,-13,32
Wellington P,2637,9,5,6,16,31,55,-24,21
CC Mariners,2637,10,4,8,15,28,49,-21,20
Sydney FC,2638,1,21,4,3,65,22,43,67
N'castle Jet,2638,2,16,5,7,61,37,24,53
Melbourne C,2638,3,14,4,11,43,37,6,46
Melbourne V,2638,4,13,5,11,45,39,6,44
Adelaide Utd,2638,5,11,6,11,37,40,-3,39
Brisbane,2638,6,10,5,13,33,42,-9,35
Western Sydn,2638,7,8,9,10,38,47,-9,33
Perth Glory,2638,8,10,2,15,37,50,-13,32
Wellington P,2638,9,5,6,16,31,55,-24,21
CC Mariners,2638,10,4,8,15,28,49,-21,20
Sydney FC,2639,1,21,4,3,68,24,44,67
N'castle Jet,2639,2,16,5,7,59,37,22,53
Melbourne C,2639,3,14,4,11,43,35,8,46
Melbourne V,2639,4,13,5,11,47,42,5,44
Adelaide Utd,2639,5,11,6,11,37,40,-3,39
Brisbane,2639,6,10,5,13,33,42,-9,35
Western Sydn,2639,7,8,9,10,38,47,-9,33
Perth Glory,2639,8,10,2,15,37,50,-13,32
Wellington P,2639,9,5,6,16,31,55,-24,21
CC Mariners,2639,10,4,8,15,28,49,-21,20
Sydney FC,2640,1,20,4,4,65,25,40,64
N'castle Jet,2640,2,16,5,7,60,39,21,53
Melbourne V,2640,3,14,5,10,48,39,9,47
Melbourne C,2640,4,14,4,11,45,36,9,46
Adelaide Utd,2640,5,11,6,11,37,40,-3,39
Brisbane,2640,6,10,5,13,33,42,-9,35
Western Sydn,2640,7,8,9,10,38,47,-9,33
Perth Glory,2640,8,10,2,15,37,50,-13,32
Wellington P,2640,9,5,6,16,31,55,-24,21
CC Mariners,2640,10,4,8,15,28,49,-21,20
Sydney FC,2641,1,20,5,3,65,23,42,65
N'castle Jet,2641,2,15,5,8,57,38,19,50
Melbourne C,2641,3,15,4,10,44,33,11,49
Melbourne V,2641,4,13,6,10,46,39,7,45
Adelaide Utd,2641,5,11,6,11,37,40,-3,39
Brisbane,2641,6,10,5,13,33,42,-9,35
Western Sydn,2641,7,8,9,10,38,47,-9,33
Perth Glory,2641,8,10,2,15,37,50,-13,32
Wellington P,2641,9,5,6,16,31,55,-24,21
CC Mariners,2641,10,4,8,15,28,49,-21,20
Sydney FC,2642,1,21,4,3,69,23,46,67
N'castle Jet,2642,2,15,5,8,58,40,18,50
Melbourne C,2642,3,15,4,10,46,34,12,49
Melbourne V,2642,4,13,5,11,46,43,3,44
Adelaide Utd,2642,5,11,6,11,37,40,-3,39
Brisbane,2642,6,10,5,13,33,42,-9,35
Western Sydn,2642,7,8,9,10,38,47,-9,33
Perth Glory,2642,8,10,2,15,37,50,-13,32
Wellington P,2642,9,5,6,16,31,55,-24,21
CC Mariners,2642,10,4,8,15,28,49,-21,20
Sydney FC,2643,1,20,5,3,66,24,42,65
N'castle Jet,2643,2,16,5,7,59,38,21,53
Melbourne C,2643,3,14,4,11,44,35,9,46
Melbourne V,2643,4,13,6,10,47,40,7,45
Adelaide Utd,2643,5,11,6,11,37,40,-3,39
Brisbane,2643,6,10,5,13,33,42,-9,35
Western Sydn,2643,7,8,9,10,38,47,-9,33
Perth Glory,2643,8,10,2,15,37,50,-13,32
Wellington P,2643,9,5,6,16,31,55,-24,21
CC Mariners,2643,10,4,8,15,28,49,-21,20
Sydney FC,2644,1,21,4,3,68,23,45,67
N'castle Jet,2644,2,16,5,7,61,40,21,53
Melbourne C,2644,3,14,4,11,46,37,9,46
Melbourne V,2644,4,13,5,11,46,42,4,44
Adelaide Utd,2644,5,11,6,11,37,40,-3,39
Brisbane,2644,6,10,5,13,33,42,-9,35
Western Sydn,2644,7,8,9,10,38,47,-9,33
Perth Glory,2644,8,10,2,15,37,50,-13,32
Wellington P,2644,9,5,6,16,31,55,-24,21
CC Mariners,2644,10,4,8,15,28,49,-21,20
Sydney FC,2645,1,20,4,4,67,26,41,64
N'castle Jet,2645,2,15,5,8,57,38,19,50
Melbourne C,2645,3,15,4,10,44,33,11,49
Melbourne V,2645,4,14,5,10,49,41,8,47
Adelaide Utd,2645,5,11,6,11,37,40,-3,39
Brisbane,2645,6,10,5,13,33,42,-9,35
Western Sydn,2645,7,8,9,10,38,47,-9,33
Perth Glory,2645,8,10,2,15,37,50,-13,32
Wellington P,2645,9,5,6,16,31,55,-24,21
CC Mariners,2645,10,4,8,15,28,49,-21,20
Sydney FC,2646,1,20,5,3,66,24,42,65
N'castle Jet,2646,2,15,5,8,58,39,19,50
Melbourne C,2646,3,15,4,10,45,34,11,49
Melbourne V,2646,4,13,6,10,47,40,7,45
Adelaide Utd,2646,5,11,6,11,37,40,-3,39
Brisbane,2646,6,10,5,13,33,42,-9,35
Western Sydn,2646,7,8,9,10,38,47,-9,33
Perth Glory,2646,8,10,2,15,37,50,-13,32
Wellington P,2646,9,5,6,16,31,55,-24,21
CC Mariners,2646,10,4,8,15,28,49,-21,20
Sydney FC,2647,1,21,4,3,67,22,45,67
N'castle Jet,2647,2,15,6,7,57,37,20,51
Melbourne C,2647,3,14,5,10,43,33,10,47
Melbourne V,2647,4,13,5,11,45,41,4,44
Adelaide Utd,2647,5,11,6,11,37,40,-3,39
Brisbane,2647,6,10,5,13,33,42,-9,35
Western Sydn,2647,7,8,9,10,38,47,-9,33
Perth Glory,2647,8,10,2,15,37,50,-13,32
Wellington P,2647,9,5,6,16,31,55,-24,21
CC Mariners,2647,10,4,8,15,28,49,-21,20
Sydney FC,2648,1,21,4,3,66,22,44,67
N'castle Jet,2648,2,16,5,7,60,39,21,53
Melbourne C,2648,3,14,4,11,45,36,9,46
Melbourne V,2648,4,13,5,11,45,40,5,44
Adelaide Utd,2648,5,11,6,11,37,40,-3,39
Brisbane,2648,6,10,5,13,33,42,-9,35
Western Sydn,2648,7,8,9,10,38,47,-9,33
Perth Glory,2648,8,10,2,15,37,50,-13,32
Wellington P,2648,9,5,6,16,31,55,-24,21
CC Mariners,2648,10,4,8,15,28,49,-21,20
Sydney FC,2649,1,20,5,3,66,24,42,65
N'castle Jet,2649,2,16,5,7,59,38,21,53
Melbourne C,2649,3,14,4,11,44,35,9,46
Melbourne V,2649,4,13,6,10,47,40,7,45
Adelaide Utd,2649,5,11,6,11,37,40,-3,39
Brisbane,2649,6,10,5,13,33,42,-9,35
Western Sydn,2649,7,8,9,10,38,47,-9,33
Perth Glory,2649,8,10,2,15,37,50,-13,32
Wellington P,2649,9,5,6,16,31,55,-24,21
CC Mariners,2649,10,4,8,15,28,49,-21,20
Sydney FC,2650,1,21,4,3,65,22,43,67
N'castle Jet,2650,2,15,5,8,58,41,17,50
Melbourne C,2650,3,15,4,10,47,34,13,49
Melbourne V,2650,4,13,5,11,45,39,6,44
Adelaide Utd,2650,5,11,6,11,37,40,-3,39
Brisbane,2650,6,10,5,13,33,42,-9,35
Western Sydn,2650,7,8,9,10,38,47,-9,33
Perth Glory,2650,8,10,2,15,37,50,-13,32
Wellington P,2650,9,5,6,16,31,55,-24,21
CC Mariners,2650,10,4,8,15,28,49,-21,20
Sydney FC,2651,1,21,4,3,66,23,43,67
N'castle Jet,2651,2,15,6,7,58,38,20,51
Melbourne C,2651,3,14,5,10,44,34,10,47
Melbourne V,2651,4,13,5,11,46,40,6,44
Adelaide Utd,2651,5,11,6,11,37,40,-3,39
Brisbane,2651,6,10,5,13,33,42,-9,35
Western Sydn,2651,7,8,9,10,38,47,-9,33
Perth Glory,2651,8,10,2,15,37,50,-13,32
Wellington P,2651,9,5,6,16,31,55,-24,21
CC Mariners,2651,10,4,8,15,28,49,-21,20
Sydney FC,2652,1,21,4,3,69,23,46,67
N'castle Jet,2652,2,15,5,8,57,41,16,50
Melbourne C,2652,3,15,4,10,47,33,14,49
Melbourne V,2652,4,13,5,11,46,43,3,44
Adelaide Utd,2652,5,11,6,11,37,40,-3,39
Brisbane,2652,6,10,5,13,33,42,-9,35
Western Sydn,2652,7,8,9,10,38,47,-9,33
Perth Glory,2652,8,10,2,15,37,50,-13,32
Wellington P,2652,9,5,6,16,31,55,-24,21
CC Mariners,2652,10,4,8,15,28,49,-21,20
Sydney FC,2653,1,20,5,3,65,23,42,65
N'castle Jet,2653,2,15,5,8,58,40,18,50
Melbourne C,2653,3,15,4,10,46,34,12,49
Melbourne V,2653,4,13,6,10,46,39,7,45
Adelaide Utd,2653,5,11,6,11,37,40,-3,39
Brisbane,2653,6,10,5,13,33,42,-9,35
Western Sydn,2653,7,8,9,10,38,47,-9,33
Perth Glory,2653,8,10,2,15,37,50,-13,32
Wellington P,2653,9,5,6,16,31,55,-24,21
CC Mariners,2653,10,4,8,15,28,49,-21,20
Sydney FC,2654,1,21,4,3,67,23,44,67
N'castle Jet,2654,2,16,5,7,58,37,21,53
Melbourne C,2654,3,14,4,11,43,34,9,46
Melbourne V,2654,4,13,5,11,46,41,5,44
Adelaide Utd,2654,5,11,6,11,37,40,-3,39
Brisbane,2654,6,10,5,13,33,42,-9,35
Western Sydn,2654,7,8,9,10,38,47,-9,33
Perth Glory,2654,8,10,2,15,37,50,-13,32
Wellington P,2654,9,5,6,16,31,55,-24,21
CC Mariners,2654,10,4,8,15,28,49,-21,20
Sydney FC,2655,1,21,4,3,66,22,44,67
N'castle Jet,2655,2,16,5,7,59,37,22,53
Melbourne C,2655,3,14,4,11,43,35,8,46
Melbourne V,2655,4,13,5,11,45,40,5,44
Adelaide Utd,2655,5,11,6,11,37,40,-3,39
Brisbane,2655,6,10,5,13,33,42,-9,35
Western Sydn,2655,7,8,9,10,38,47,-9,33
Perth Glory,2655,8,10,2,15,37,50,-13,32
Wellington P,2655,9,5,6,16,31,55,-24,21
CC Mariners,2655,10,4,8,15,28,49,-21,20
Sydney FC,2656,1,21,4,3,67,22,45,67
N'castle Jet,2656,2,16,5,7,62,38,24,53
Melbourne C,2656,3,14,4,11,44,38,6,46
Melbourne V,2656,4,13,5,11,45,41,4,44
Adelaide Utd,2656,5,11,6,11,37,40,-3,39
Brisbane,2656,6,10,5,13,33,42,-9,35
Western Sydn,2656,7,8,9,10,38,47,-9,33
Perth Glory,2656,8,10,2,15,37,50,-13,32
Wellington P,2656,9,5,6,16,31,55,-24,21
CC Mariners,2656,10,4,8,15,28,49,-21,20
Sydney FC,2657,1,21,4,3,69,23,46,67
N'castle Jet,2657,2,16,5,7,62,39,23,53
Melbourne C,2657,3,14,4,11,45,38,7,46
Melbourne V,2657,4,13,5,11,46,43,3,44
Adelaide Utd,2657,5,11,6,11,37,40,-3,39
Brisbane,2657,6,10,5,13,33,42,-9,35
Western Sydn,2657,7,8,9,10,38,47,-9,33
Perth Glory,2657,8,10,2,15,37,50,-13,32
Wellington P,2657,9,5,6,16,31,55,-24,21
CC Mariners,2657,10,4,8,15,28,49,-21,20
Sydney FC,2658,1,21,4,3,65,22,43,67
N'castle Jet,2658,2,15,6,7,58,38,20,51
Melbourne C,2658,3,14,5,10,44,34,10,47
Melbourne V,2658,4,13,5,11,45,39,6,44
Adelaide Utd,2658,5,11,6,11,37,40,-3,39
Brisbane,2658,6,10,5,13,33,42,-9,35
Western Sydn,2658,7,8,9,10,38,47,-9,33
Perth Glory,2658,8,10,2,15,37,50,-13,32
Wellington P,2658,9,5,6,16,31,55,-24,21
CC Mariners,2658,10,4,8,15,28,49,-21,20
Sydney FC,2659,1,21,4,3,67,24,43,67
N'castle Jet,2659,2,15,5,8,57,38,19,50
Melbourne C,2659,3,15,4,10,44,33,11,49
Melbourne V,2659,4,13,5,11,47,41,6,44
Adelaide Utd,2659,5,11,6,11,37,40,-3,39
Brisbane,2659,6,10,5,13,33,42,-9,35
Western Sydn,2659,7,8,9,10,38,47,-9,33
Perth Glory,2659,8,10,2,15,37,50,-13,32
Wellington P,2659,9,5,6,16,31,55,-24,21
CC Mariners,2659,10,4,8,15,28,49,-21,20
Sydney FC,2660,1,20,4,4,64,23,41,64
N'castle Jet,2660,2,16,5,7,59,38,21,53
Melbourne V,2660,3,14,5,10,46,38,8,47
Melbourne C,2660,4,14,4,11,44,35,9,46
Adelaide Utd,2660,5,11,6,11,37,40,-3,39
Brisbane,2660,6,10,5,13,33,42,-9,35
Western Sydn,2660,7,8,9,10,38,47,-9,33
Perth Glory,2660,8,10,2,15,37,50,-13,32
Wellington P,2660,9,5,6,16,31,55,-24,21
CC Mariners,2660,10,4,8,15,28,49,-21,20
Sydney FC,2661,1,20,5,3,65,23,42,65
N'castle Jet,2661,2,16,5,7,61,40,21,53
Melbourne C,2661,3,14,4,11,46,37,9,46
Melbourne V,2661,4,13,6,10,46,39,7,45
Adelaide Utd,2661,5,11,6,11,37,40,-3,39
Brisbane,2661,6,10,5,13,33,42,-9,35
Western Sydn,2661,7,8,9,10,38,47,-9,33
Perth Glory,2661,8,10,2,15,37,50,-13,32
Wellington P,2661,9,5,6,16,31,55,-24,21
CC Mariners,2661,10,4,8,15,28,49,-21,20
Sydney FC,2662,1,21,4,3,68,22,46,67
N'castle Jet,2662,2,16,5,7,59,38,21,53
Melbourne C,2662,3,14,4,11,44,35,9,46
Melbourne V,2662,4,13,5,11,45,42,3,44
Adelaide Utd,2662,5,11,6,11,37,40,-3,39
Brisbane,2662,6,10,5,13,33,42,-9,35
Western Sydn,2662,7,8,9,10,38,47,-9,33
Perth Glory,2662,8,10,2,15,37,50,-13,32
Wellington P,2662,9,5,6,16,31,55,-24,21
CC Mariners,2662,10,4,8,15,28,49,-21,20
Sydney FC,2663,1,21,4,3,66,23,43,67
N'castle Jet,2663,2,15,6,7,58,38,20,51
Melbourne C,2663,3,14,5,10,44,34,10,47
Melbourne V,2663,4,13,5,11,46,40,6,44
Adelaide Utd,2663,5,11,6,11,37,40,-3,39
Brisbane,2663,6,10,5,13,33,42,-9,35
Western Sydn,2663,7,8,9,10,38,47,-9,33
Perth Glory,2663,8,10,2,15,37,50,-13,32
Wellington P,2663,9,5,6,16,31,55,-24,21
CC Mariners,2663,10,4,8,15,28,49,-21,20
Sydney FC,2664,1,20,4,4,64,23,41,64
N'castle Jet,2664,2,16,5,7,59,38,21,53
Melbourne V,2664,3,14,5,10,46,38,8,47
Melbourne C,2664,4,14,4,11,44,35,9,46
Adelaide Utd,2664,5,11,6,11,37,40,-3,39
Brisbane,2664,6,10,5,13,33,42,-9,35
Western Sydn,2664,7,8,9,10,38,47,-9,33
Perth Glory,2664,8,10,2,15,37,50,-13,32
Wellington P,2664,9,5,6,16,31,55,-24,21
CC Mariners,2664,10,4,8,15,28,49,-21,20
Sydney FC,2665,1,21,4,3,66,22,44,67
N'castle Jet,2665,2,15,5,8,57,38,19,50
Melbourne C,2665,3,15,4,10,44,33,11,49
Melbourne V,2665,4,13,5,11,45,40,5,44
Adelaide Utd,2665,5,11,6,11,37,40,-3,39
Brisbane,2665,6,10,5,13,33,42,-9,35
Western Sydn,2665,7,8,9,10,38,47,-9,33
Perth Glory,2665,8,10,2,15,37,50,-13,32
Wellington P,2665,9,5,6,16,31,55,-24,21
CC Mariners,2665,10,4,8,15,28,49,-21,20
Sydney FC,2666,1,21,4,3,67,24,43,67
N'castle Jet,2666,2,15,6,7,57,37,20,51
Melbourne C,2666,3,14,5,10,43,33,10,47
Melbourne V,2666,4,13,5,11,47,41,6,44
Adelaide Utd,2666,5,11,6,11,37,40,-3,39
Brisbane,2666,6,10,5,13,33,42,-9,35
Western Sydn,2666,7,8,9,10,38,47,-9,33
Perth Glory,2666,8,10,2,15,37,50,-13,32
Wellington P,2666,9,5,6,16,31,55,-24,21
CC Mariners,2666,10,4,8,15,28,49,-21,20
Sydney FC,2667,1,21,4,3,66,23,43,67
N'castle Jet,2667,2,15,6,7,58,38,20,51
Melbourne C,2667,3,14,5,10,44,34,10,47
Melbourne V,2667,4,13,5,11,46,40,6,44
Adelaide Utd,2667,5,11,6,11,37,40,-3,39
Brisbane,2667,6,10,5,13,33,42,-9,35
Western Sydn,2667,7,8,9,10,38,47,-9,33
Perth Glory,2667,8,10,2,15,37,50,-13,32
Wellington P,2667,9,5,6,16,31,55,-24,21
CC Mariners,2667,10,4,8,15,28,49,-21,20
Sydney FC,2668,1,20,4,4,64,23,41,64
N'castle Jet,2668,2,16,5,7,60,38,22,53
Melbourne V,2668,3,14,5,10,46,38,8,47
Melbourne C,2668,4,14,4,11,44,36,8,46
Adelaide Utd,2668,5,11,6,11,37,40,-3,39
Brisbane,2668,6,10,5,13,33,42,-9,35
Western Sydn,2668,7,8,9,10,38,47,-9,33
Perth Glory,2668,8,10,2,15,37,50,-13,32
Wellington P,2668,9,5,6,16,31,55,-24,21
CC Mariners,2668,10,4,8,15,28,49,-21,20
Sydney FC,2669,1,21,4,3,66,23,43,67
N'castle Jet,2669,2,15,6,7,58,38,20,51
Melbourne C,2669,3,14,5,10,44,34,10,47
Melbourne V,2669,4,13,5,11,46,40,6,44
Adelaide Utd,2669,5,11,6,11,37,40,-3,39
Brisbane,2669,6,10,5,13,33,42,-9,35
Western Sydn,2669,7,8,9,10,38,47,-9,33
Perth Glory,2669,8,10,2,15,37,50,-13,32
Wellington P,2669,9,5,6,16,31,55,-24,21
CC Mariners,2669,10,4,8,15,28,49,-21,20
Sydney FC,2670,1,21,4,3,66,22,44,67
N'castle Jet,2670,2,15,5,8,57,40,17,50
Melbourne C,2670,3,15,4,10,46,33,13,49
Melbourne V,2670,4,13,5,11,45,40,5,44
Adelaide Utd,2670,5,11,6,11,37,40,-3,39
Brisbane,2670,6,10,5,13,33,42,-9,35
Western Sydn,2670,7,8,9,10,38,47,-9,33
Perth Glory,2670,8,10,2,15,37,50,-13,32
Wellington P,2670,9,5,6,16,31,55,-24,21
CC Mariners,2670,10,4,8,15,28,49,-21,20
Sydney FC,2671,1,20,4,4,65,24,41,64
N'castle Jet,2671,2,16,5,7,62,37,25,53
Melbourne V,2671,3,14,5,10,47,39,8,47
Melbourne C,2671,4,14,4,11,43,38,5,46
Adelaide Utd,2671,5,11,6,11,37,40,-3,39
Brisbane,2671,6,10,5,13,33,42,-9,35
Western Sydn,2671,7,8,9,10,38,47,-9,33
Perth Glory,2671,8,10,2,15,37,50,-13,32
Wellington P,2671,9,5,6,16,31,55,-24,21
CC Mariners,2671,10,4,8,15,28,49,-21,20
Sydney FC,2672,1,20,5,3,65,23,42,65
N'castle Jet,2672,2,16,5,7,59,37,22,53
Melbourne C,2672,3,14,4,11,43,35,8,46
Melbourne V,2672,4,13,6,10,46,39,7,45
Adelaide Utd,2672,5,11,6,11,37,40,-3,39
Brisbane,2672,6,10,5,13,33,42,-9,35
Western Sydn,2672,7,8,9,10,38,47,-9,33
Perth Glory,2672,8,10,2,15,37,50,-13,32
Wellington P,2672,9,5,6,16,31,55,-24,21
CC Mariners,2672,10,4,8,15,28,49,-21,20
Sydney FC,2673,1,21,4,3,69,22,47,67
N'castle Jet,2673,2,16,5,7,61,38,23,53
Melbourne C,2673,3,14,4,11,44,37,7,46
Melbourne V,2673,4,13,5,11,45,43,2,44
Adelaide Utd,2673,5,11,6,11,37,40,-3,39
Brisbane,2673,6,10,5,13,33,42,-9,35
Western Sydn,2673,7,8,9,10,38,47,-9,33
Perth Glory,2673,8,10,2,15,37,50,-13,32
Wellington P,2673,9,5,6,16,31,55,-24,21
CC Mariners,2673,10,4,8,15,28,49,-21,20
Sydney FC,2674,1,21,4,3,68,23,45,67
N'castle Jet,2674,2,16,5,7,60,38,22,53
Melbourne C,2674,3,14,4,11,44,36,8,46
Melbourne V,2674,4,13,5,11,46,42,4,44
Adelaide Utd,2674,5,11,6,11,37,40,-3,39
Brisbane,2674,6,10,5,13,33,42,-9,35
Western Sydn,2674,7,8,9,10,38,47,-9,33
Perth Glory,2674,8,10,2,15,37,50,-13,32
Wellington P,2674,9,5,6,16,31,55,-24,21
CC Mariners,2674,10,4,8,15,28,49,-21,20
Sydney FC,2675,1,20,5,3,65,23,42,65
N'castle Jet,2675,2,15,5,8,57,40,17,50
Melbourne C,2675,3,15,4,10,46,33,13,49
Melbourne V,2675,4,13,6,10,46,39,7,45
Adelaide Utd,2675,5,11,6,11,37,40,-3,39
Brisbane,2675,6,10,5,13,33,42,-9,35
Western Sydn,2675,7,8,9,10,38,47,-9,33
Perth Glory,2675,8,10,2,15,37,50,-13,32
Wellington P,2675,9,5,6,16,31,55,-24,21
CC Mariners,2675,10,4,8,15,28,49,-21,20
Sydney FC,2676,1,20,5,3,65,23,42,65
N'castle Jet,2676,2,15,5,8,57,39,18,50
Melbourne C,2676,3,15,4,10,45,33,12,49
Melbourne V,2676,4,13,6,10,46,39,7,45
Adelaide Utd,2676,5,11,6,11,37,40,-3,39
Brisbane,2676,6,10,5,13,33,42,-9,35
Western Sydn,2676,7,8,9,10,38,47,-9,33
Perth Glory,2676,8,10,2,15,37,50,-13,32
Wellington P,2676,9,5,6,16,31,55,-24,21
CC Mariners,2676,10,4,8,15,28,49,-21,20
Sydney FC,2677,1,20,4,4,66,25,41,64
N'castle Jet,2677,2,15,6,7,59,39,20,51
Melbourne C,2677,3,14,5,10,45,35,10,47
Melbourne V,2677,4,14,5,10,48,40,8,47
Adelaide Utd,2677,5,11,6,11,37,40,-3,39
Brisbane,2677,6,10,5,13,33,42,-9,35
Western Sydn,2677,7,8,9,10,38,47,-9,33
Perth Glory,2677,8,10,2,15,37,50,-13,32
Wellington P,2677,9,5,6,16,31,55,-24,21
CC Mariners,2677,10,4,8,15,28,49,-21,20
Sydney FC,2678,1,21,4,3,67,24,43,67
N'castle Jet,2678,2,15,6,7,58,38,20,51
Melbourne C,2678,3,14,5,10,44,34,10,47
Melbourne V,2678,4,13,5,11,47,41,6,44
Adelaide Utd,2678,5,11,6,11,37,40,-3,39
Brisbane,2678,6,10,5,13,33,42,-9,35
Western Sydn,2678,7,8,9,10,38,47,-9,33
Perth Glory,2678,8,10,2,15,37,50,-13,32
Wellington P,2678,9,5,6,16,31,55,-24,21
CC Mariners,2678,10,4,8,15,28,49,-21,20
Sydney FC,2679,1,21,4,3,65,22,43,67
N'castle Jet,2679,2,16,5,7,59,37,22,53
Melbourne C,2679,3,14,4,11,43,35,8,46
Melbourne V,2679,4,13,5,11,45,39,6,44
Adelaide Utd,2679,5,11,6,11,37,40,-3,39
Brisbane,2679,6,10,5,13,33,42,-9,35
Western Sydn,2679,7,8,9,10,38,47,-9,33
Perth Glory,2679,8,10,2,15,37,50,-13,32
Wellington P,2679,9,5,6,16,31,55,-24,21
CC Mariners,2679,10,4,8,15,28,49,-21,20
Sydney FC,2680,1,21,4,3,66,22,44,67
N'castle Jet,2680,2,16,5,7,60,38,22,53
Melbourne C,2680,3,14,4,11,44,36,8,46
Melbourne V,2680,4,13,5,11,45,40,5,44
Adelaide Utd,2680,5,11,6,11,37,40,-3,39
Brisbane,2680,6,10,5,13,33,42,-9,35
Western Sydn,2680,7,8,9,10,38,47,-9,33
Perth Glory,2680,8,10,2,15,37,50,-13,32
Wellington P,2680,9,5,6,16,31,55,-24,21
CC Mariners,2680,10,4,8,15,28,49,-21,20
Sydney FC,2681,1,20,5,3,65,23,42,65
N'castle Jet,2681,2,16,5,7,62,37,25,53
Melbourne C,2681,3,14,4,11,43,38,5,46
Melbourne V,2681,4,13,6,10,46,39,7,45
Adelaide Utd,2681,5,11,6,11,37,40,-3,39
Brisbane,2681,6,10,5,13,33,42,-9,35
Western Sydn,2681,7,8,9,10,38,47,-9,33
Perth Glory,2681,8,10,2,15,37,50,-13,32
Wellington P,2681,9,5,6,16,31,55,-24,21
CC Mariners,2681,10,4,8,15,28,49,-21,20
Sydney FC,2682,1,21,4,3,66,23,43,67
N'castle Jet,2682,2,15,5,8,57,38,19,50
Melbourne C,2682,3,15,4,10,44,33,11,49
Melbourne V,2682,4,13,5,11,46,40,6,44
Adelaide Utd,2682,5,11,6,11,37,40,-3,39
Brisbane,2682,6,10,5,13,33,42,-9,35
Western Sydn,2682,7,8,9,10,38,47,-9,33
Perth Glory,2682,8,10,2,15,37,50,-13,32
Wellington P,2682,9,5,6,16,31,55,-24,21
CC Mariners,2682,10,4,8,15,28,49,-21,20
Sydney FC,2683,1,20,4,4,65,27,38,64
N'castle Jet,2683,2,16,5,7,60,38,22,53
Melbourne V,2683,3,14,5,10,50,39,11,47
Melbourne C,2683,4,14,4,11,44,36,8,46
Adelaide Utd,2683,5,11,6,11,37,40,-3,39
Brisbane,2683,6,10,5,13,33,42,-9,35
Western Sydn,2683,7,8,9,10,38,47,-9,33
Perth Glory,2683,8,10,2,15,37,50,-13,32
Wellington P,2683,9,5,6,16,31,55,-24,21
CC Mariners,2683,10,4,8,15,28,49,-21,20
Sydney FC,2684,1,20,4,4,64,23,41,64
N'castle Jet,2684,2,16,5,7,61,39,22,53
Melbourne V,2684,3,14,5,10,46,38,8,47
Melbourne C,2684,4,14,4,11,45,37,8,46
Adelaide Utd,2684,5,11,6,11,37,40,-3,39
Brisbane,2684,6,10,5,13,33,42,-9,35
Western Sydn,2684,7,8,9,10,38,47,-9,33
Perth Glory,2684,8,10,2,15,37,50,-13,32
Wellington P,2684,9,5,6,16,31,55,-24,21
CC Mariners,2684,10,4,8,15,28,49,-21,20
Sydney FC,2685,1,21,4,3,65,22,43,67
N'castle Jet,2685,2,15,5,8,58,39,19,50
Melbourne C,2685,3,15,4,10,45,34,11,49
Melbourne V,2685,4,13,5,11,45,39,6,44
Adelaide Utd,2685,5,11,6,11,37,40,-3,39
Brisbane,2685,6,10,5,13,33,42,-9,35
Western Sydn,2685,7,8,9,10,38,47,-9,33
Perth Glory,2685,8,10,2,15,37,50,-13,32
Wellington P,2685,9,5,6,16,31,55,-24,21
CC Mariners,2685,10,4,8,15,28,49,-21,20
Sydney FC,2686,1,20,4,4,64,23,41,64
N'castle Jet,2686,2,15,5,8,57,39,18,50
Melbourne C,2686,3,15,4,10,45,33,12,49
Melbourne V,2686,4,14,5,10,46,38,8,47
Adelaide Utd,2686,5,11,6,11,37,40,-3,39
Brisbane,2686,6,10,5,13,33,42,-9,35
Western Sydn,2686,7,8,9,10,38,47,-9,33
Perth Glory,2686,8,10,2,15,37,50,-13,32
Wellington P,2686,9,5,6,16,31,55,-24,21
CC Mariners,2686,10,4,8,15,28,49,-21,20
Sydney FC,2687,1,20,5,3,68,26,42,65
N'castle Jet,2687,2,15,6,7,59,39,20,51
Melbourne C,2687,3,14,5,10,45,35,10,47
Melbourne V,2687,4,13,6,10,49,42,7,45
Adelaide Utd,2687,5,11,6,11,37,40,-3,39
Brisbane,2687,6,10,5,13,33,42,-9,35
Western Sydn,2687,7,8,9,10,38,47,-9,33
Perth Glory,2687,8,10,2,15,37,50,-13,32
Wellington P,2687,9,5,6,16,31,55,-24,21
CC Mariners,2687,10,4,8,15,28,49,-21,20
Sydney FC,2688,1,20,5,3,64,22,42,65
N'castle Jet,2688,2,15,6,7,58,38,20,51
Melbourne C,2688,3,14,5,10,44,34,10,47
Melbourne V,2688,4,13,6,10,45,38,7,45
Adelaide Utd,2688,5,11,6,11,37,40,-3,39
Brisbane,2688,6,10,5,13,33,42,-9,35
Western Sydn,2688,7,8,9,10,38,47,-9,33
Perth Glory,2688,8,10,2,15,37,50,-13,32
Wellington P,2688,9,5,6,16,31,55,-24,21
CC Mariners,2688,10,4,8,15,28,49,-21,20
Sydney FC,2689,1,20,5,3,66,24,42,65
N'castle Jet,2689,2,16,5,7,59,37,22,53
Melbourne C,2689,3,14,4,11,43,35,8,46
Melbourne V,2689,4,13,6,10,47,40,7,45
Adelaide Utd,2689,5,11,6,11,37,40,-3,39
Brisbane,2689,6,10,5,13,33,42,-9,35
Western Sydn,2689,7,8,9,10,38,47,-9,33
Perth Glory,2689,8,10,2,15,37,50,-13,32
Wellington P,2689,9,5,6,16,31,55,-24,21
CC Mariners,2689,10,4,8,15,28,49,-21,20
Sydney FC,2690,1,20,5,3,64,22,42,65
N'castle Jet,2690,2,15,6,7,58,38,20,51
Melbourne C,2690,3,14,5,10,44,34,10,47
Melbourne V,2690,4,13,6,10,45,38,7,45
Adelaide Utd,2690,5,11,6,11,37,40,-3,39
Brisbane,2690,6,10,5,13,33,42,-9,35
Western Sydn,2690,7,8,9,10,38,47,-9,33
Perth Glory,2690,8,10,2,15,37,50,-13,32
Wellington P,2690,9,5,6,16,31,55,-24,21
CC Mariners,2690,10,4,8,15,28,49,-21,20
Sydney FC,2691,1,21,4,3,67,23,44,67
N'castle Jet,2691,2,16,5,7,58,37,21,53
Melbourne C,2691,3,14,4,11,43,34,9,46
Melbourne V,2691,4,13,5,11,46,41,5,44
Adelaide Utd,2691,5,11,6,11,37,40,-3,39
Brisbane,2691,6,10,5,13,33,42,-9,35
Western Sydn,2691,7,8,9,10,38,47,-9,33
Perth Glory,2691,8,10,2,15,37,50,-13,32
Wellington P,2691,9,5,6,16,31,55,-24,21
CC Mariners,2691,10,4,8,15,28,49,-21,20
Sydney FC,2692,1,21,4,3,67,22,45,67
N'castle Jet,2692,2,16,5,7,58,37,21,53
Melbourne C,2692,3,14,4,11,43,34,9,46
Melbourne V,2692,4,13,5,11,45,41,4,44
Adelaide Utd,2692,5,11,6,11,37,40,-3,39
Brisbane,2692,6,10,5,13,33,42,-9,35
Western Sydn,2692,7,8,9,10,38,47,-9,33
Perth Glory,2692,8,10,2,15,37,50,-13,32
Wellington P,2692,9,5,6,16,31,55,-24,21
CC Mariners,2692,10,4,8,15,28,49,-21,20
Sydney FC,2693,1,21,4,3,69,23,46,67
N'castle Jet,2693,2,16,5,7,59,38,21,53
Melbourne C,2693,3,14,4,11,44,35,9,46
Melbourne V,2693,4,13,5,11,46,43,3,44
Adelaide Utd,2693,5,11,6,11,37,40,-3,39
Brisbane,2693,6,10,5,13,33,42,-9,35
Western Sydn,2693,7,8,9,10,38,47,-9,33
Perth Glory,2693,8,10,2,15,37,50,-13,32
Wellington P,2693,9,5,6,16,31,55,-24,21
CC Mariners,2693,10,4,8,15,28,49,-21,20
Sydney FC,2694,1,20,4,4,65,25,40,64
N'castle Jet,2694,2,16,5,7,62,38,24,53
Melbourne V,2694,3,14,5,10,48,39,9,47
Melbourne C,2694,4,14,4,11,44,38,6,46
Adelaide Utd,2694,5,11,6,11,37,40,-3,39
Brisbane,2694,6,10,5,13,33,42,-9,35
Western Sydn,2694,7,8,9,10,38,47,-9,33
Perth Glory,2694,8,10,2,15,37,50,-13,32
Wellington P,2694,9,5,6,16,31,55,-24,21
CC Mariners,2694,10,4,8,15,28,49,-21,20
Sydney FC,2695,1,21,4,3,69,23,46,67
N'castle Jet,2695,2,16,5,7,59,37,22,53
Melbourne C,2695,3,14,4,11,43,35,8,46
Melbourne V,2695,4,13,5,11,46,43,3,44
Adelaide Utd,2695,5,11,6,11,37,40,-3,39
Brisbane,2695,6,10,5,13,33,42,-9,35
Western Sydn,2695,7,8,9,10,38,47,-9,33
Perth Glory,2695,8,10,2,15,37,50,-13,32
Wellington P,2695,9,5,6,16,31,55,-24,21
CC Mariners,2695,10,4,8,15,28,49,-21,20
Sydney FC,2696,1,20,4,4,64,24,40,64
N'castle Jet,2696,2,15,5,8,58,39,19,50
Melbourne C,2696,3,15,4,10,45,34,11,49
Melbourne V,2696,4,14,5,10,47,38,9,47
Adelaide Utd,2696,5,11,6,11,37,40,-3,39
Brisbane,2696,6,10,5,13,33,42,-9,35
Western Sydn,2696,7,8,9,10,38,47,-9,33
Perth Glory,2696,8,10,2,15,37,50,-13,32
Wellington P,2696,9,5,6,16,31,55,-24,21
CC Mariners,2696,10,4,8,15,28,49,-21,20
Sydney FC,2697,1,21,4,3,66,23,43,67
N'castle Jet,2697,2,15,6,7,57,37,20,51
Melbourne C,2697,3,14,5,10,43,33,10,47
Melbourne V,2697,4,13,5,11,46,40,6,44
Adelaide Utd,2697,5,11,6,11,37,40,-3,39
Brisbane,2697,6,10,5,13,33,42,-9,35
Western Sydn,2697,7,8,9,10,38,47,-9,33
Perth Glory,2697,8,10,2,15,37,50,-13,32
Wellington P,2697,9,5,6,16,31,55,-24,21
CC Mariners,2697,10,4,8,15,28,49,-21,20
Sydney FC,2698,1,21,4,3,65,22,43,67
N'castle Jet,2698,2,15,5,8,57,39,18,50
Melbourne C,2698,3,15,4,10,45,33,12,49
Melbourne V,2698,4,13,5,11,45,39,6,44
Adelaide Utd,2698,5,11,6,11,37,40,-3,39
Brisbane,2698,6,10,5,13,33,42,-9,35
Western Sydn,2698,7,8,9,10,38,47,-9,33
Perth Glory,2698,8,10,2,15,37,50,-13,32
Wellington P,2698,9,5,6,16,31,55,-24,21
CC Mariners,2698,10,4,8,15,28,49,-21,20
Sydney FC,2699,1,21,4,3,66,22,44,67
N'castle Jet,2699,2,16,5,7,58,37,21,53
Melbourne C,2699,3,14,4,11,43,34,9,46
Melbourne V,2699,4,13,5,11,45,40,5,44
Adelaide Utd,2699,5,11,6,11,37,40,-3,39
Brisbane,2699,6,10,5,13,33,42,-9,35
Western Sydn,2699,7,8,9,10,38,47,-9,33
Perth Glory,2699,8,10,2,15,37,50,-13,32
Wellington P,2699,9,5,6,16,31,55,-24,21
CC Mariners,2699,10,4,8,15,28,49,-21,20
Sydney FC,2700,1,20,4,4,64,23,41,64
N'castle Jet,2700,2,16,5,7,58,37,21,53
Melbourne V,2700,3,14,5,10,46,38,8,47
Melbourne C,2700,4,14,4,11,43,34,9,46
Adelaide Utd,2700,5,11,6,11,37,40,-3,39
Brisbane,2700,6,10,5,13,33,42,-9,35
Western Sydn,2700,7,8,9,10,38,47,-9,33
Perth Glory,2700,8,10,2,15,37,50,-13,32
Wellington P,2700,9,5,6,16,31,55,-24,21
CC Mariners,2700,10,4,8,15,28,49,-21,20
Sydney FC,2701,1,20,5,3,65,23,42,65
N'castle Jet,2701,2,15,5,8,58,40,18,50
Melbourne C,2701,3,15,4,10,46,34,12,49
Melbourne V,2701,4,13,6,10,46,39,7,45
Adelaide Utd,2701,5,11,6,11,37,40,-3,39
Brisbane,2701,6,10,5,13,33,42,-9,35
Western Sydn,2701,7,8,9,10,38,47,-9,33
Perth Glory,2701,8,10,2,15,37,50,-13,32
Wellington P,2701,9,5,6,16,31,55,-24,21
CC Mariners,2701,10,4,8,15,28,49,-21,20
Sydney FC,2702,1,21,4,3,66,22,44,67
N'castle Jet,2702,2,16,5,7,59,38,21,53
Melbourne C,2702,3,14,4,11,44,35,9,46
Melbourne V,2702,4,13,5,11,45,40,5,44
Adelaide Utd,2702,5,11,6,11,37,40,-3,39
Brisbane,2702,6,10,5,13,33,42,-9,35
Western Sydn,2702,7,8,9,10,38,47,-9,33
Perth Glory,2702,8,10,2,15,37,50,-13,32
Wellington P,2702,9,5,6,16,31,55,-24,21
CC Mariners,2702,10,4,8,15,28,49,-21,20
Sydney FC,2703,1,20,5,3,65,23,42,65
N'castle Jet,2703,2,16,5,7,61,38,23,53
Melbourne C,2703,3,14,4,11,44,37,7,46
Melbourne V,2703,4,13,6,10,46,39,7,45
Adelaide Utd,2703,5,11,6,11,37,40,-3,39
Brisbane,2703,6,10,5,13,33,42,-9,35
Western Sydn,2703,7,8,9,10,38,47,-9,33
Perth Glory,2703,8,10,2,15,37,50,-13,32
Wellington P,2703,9,5,6,16,31,55,-24,21
CC Mariners,2703,10,4,8,15,28,49,-21,20
Sydney FC,2704,1,20,5,3,65,23,42,65
N'castle Jet,2704,2,16,5,7,61,39,22,53
Melbourne C,2704,3,14,4,11,45,37,8,46
Melbourne V,2704,4,13,6,10,46,39,7,45
Adelaide Utd,2704,5,11,6,11,37,40,-3,39
Brisbane,2704,6,10,5,13,33,42,-9,35
Western Sydn,2704,7,8,9,10,38,47,-9,33
Perth Glory,2704,8,10,2,15,37,50,-13,32
Wellington P,2704,9,5,6,16,31,55,-24,21
CC Mariners,2704,10,4,8,15,28,49,-21,20
Sydney FC,2705,1,20,4,4,64,23,41,64
N'castle Jet,2705,2,16,5,7,62,38,24,53
Melbourne V,2705,3,14,5,10,46,38,8,47
Melbourne C,2705,4,14,4,11,44,38,6,46
Adelaide Utd,2705,5,11,6,11,37,40,-3,39
Brisbane,2705,6,10,5,13,33,42,-9,35
Western Sydn,2705,7,8,9,10,38,47,-9,33
Perth Glory,2705,8,10,2,15,37,50,-13,32
Wellington P,2705,9,5,6,16,31,55,-24,21
CC Mariners,2705,10,4,8,15,28,49,-21,20
Sydney FC,2706,1,21,4,3,66,23,43,67
N'castle Jet,2706,2,15,6,7,60,40,20,51
Melbourne C,2706,3,14,5,10,46,36,10,47
Melbourne V,2706,4,13,5,11,46,40,6,44
Adelaide Utd,2706,5,11,6,11,37,40,-3,39
Brisbane,2706,6,10,5,13,33,42,-9,35
Western Sydn,2706,7,8,9,10,38,47,-9,33
Perth Glory,2706,8,10,2,15,37,50,-13,32
Wellington P,2706,9,5,6,16,31,55,-24,21
CC Mariners,2706,10,4,8,15,28,49,-21,20
Sydney FC,2707,1,20,4,4,65,26,39,64
N'castle Jet,2707,2,15,6,7,61,41,20,51
Melbourne V,2707,3,14,5,10,49,39,10,47
Melbourne C,2707,4,14,5,10,47,37,10,47
Adelaide Utd,2707,5,11,6,11,37,40,-3,39
Brisbane,2707,6,10,5,13,33,42,-9,35
Western Sydn,2707,7,8,9,10,38,47,-9,33
Perth Glory,2707,8,10,2,15,37,50,-13,32
Wellington P,2707,9,5,6,16,31,55,-24,21
CC Mariners,2707,10,4,8,15,28,49,-21,20
Sydney FC,2708,1,21,4,3,65,22,43,67
N'castle Jet,2708,2,16,5,7,60,39,21,53
Melbourne C,2708,3,14,4,11,45,36,9,46
Melbourne V,2708,4,13,5,11,45,39,6,44
Adelaide Utd,2708,5,11,6,11,37,40,-3,39
Brisbane,2708,6,10,5,13,33,42,-9,35
Western Sydn,2708,7,8,9,10,38,47,-9,33
Perth Glory,2708,8,10,2,15,37,50,-13,32
Wellington P,2708,9,5,6,16,31,55,-24,21
CC Mariners,2708,10,4,8,15,28,49,-21,20
Sydney FC,2709,1,21,4,3,67,22,45,67
N'castle Jet,2709,2,16,5,7,59,38,21,53
Melbourne C,2709,3,14,4,11,44,35,9,46
Melbourne V,2709,4,13,5,11,45,41,4,44
Adelaide Utd,2709,5,11,6,11,37,40,-3,39
Brisbane,2709,6,10,5,13,33,42,-9,35
Western Sydn,2709,7,8,9,10,38,47,-9,33
Perth Glory,2709,8,10,2,15,37,50,-13,32
Wellington P,2709,9,5,6,16,31,55,-24,21
CC Mariners,2709,10,4,8,15,28,49,-21,20
Sydney FC,2710,1,21,4,3,67,23,44,67
N'castle Jet,2710,2,16,5,7,60,37,23,53
Melbourne C,2710,3,14,4,11,43,36,7,46
Melbourne V,2710,4,13,5,11,46,41,5,44
Adelaide Utd,2710,5,11,6,11,37,40,-3,39
Brisbane,2710,6,10,5,13,33,42,-9,35
Western Sydn,2710,7,8,9,10,38,47,-9,33
Perth Glory,2710,8,10,2,15,37,50,-13,32
Wellington P,2710,9,5,6,16,31,55,-24,21
CC Mariners,2710,10,4,8,15,28,49,-21,20
Sydney FC,2711,1,21,4,3,66,23,43,67
N'castle Jet,2711,2,16,5,7,60,37,23,53
Melbourne C,2711,3,14,4,11,43,36,7,46
Melbourne V,2711,4,13,5,11,46,40,6,44
Adelaide Utd,2711,5,11,6,11,37,40,-3,39
Brisbane,2711,6,10,5,13,33,42,-9,35
Western Sydn,2711,7,8,9,10,38,47,-9,33
Perth Glory,2711,8,10,2,15,37,50,-13,32
Wellington P,2711,9,5,6,16,31,55,-24,21
CC Mariners,2711,10,4,8,15,28,49,-21,20
Sydney FC,2712,1,20,4,4,64,23,41,64
N'castle Jet,2712,2,15,5,8,58,41,17,50
Melbourne C,2712,3,15,4,10,47,34,13,49
Melbourne V,2712,4,14,5,10,46,38,8,47
Adelaide Utd,2712,5,11,6,11,37,40,-3,39
Brisbane,2712,6,10,5,13,33,42,-9,35
Western Sydn,2712,7,8,9,10,38,47,-9,33
Perth Glory,2712,8,10,2,15,37,50,-13,32
Wellington P,2712,9,5,6,16,31,55,-24,21
CC Mariners,2712,10,4,8,15,28,49,-21,20
Sydney FC,2713,1,21,4,3,69,23,46,67
N'castle Jet,2713,2,16,5,7,58,37,21,53
Melbourne C,2713,3,14,4,11,43,34,9,46
Melbourne V,2713,4,13,5,11,46,43,3,44
Adelaide Utd,2713,5,11,6,11,37,40,-3,39
Brisbane,2713,6,10,5,13,33,42,-9,35
Western Sydn,2713,7,8,9,10,38,47,-9,33
Perth Glory,2713,8,10,2,15,37,50,-13,32
Wellington P,2713,9,5,6,16,31,55,-24,21
CC Mariners,2713,10,4,8,15,28,49,-21,20
Sydney FC,2714,1,21,4,3,67,22,45,67
N'castle Jet,2714,2,16,5,7,58,37,21,53
Melbourne C,2714,3,14,4,11,43,34,9,46
Melbourne V,2714,4,13,5,11,45,41,4,44
Adelaide Utd,2714,5,11,6,11,37,40,-3,39
Brisbane,2714,6,10,5,13,33,42,-9,35
Western Sydn,2714,7,8,9,10,38,47,-9,33
Perth Glory,2714,8,10,2,15,37,50,-13,32
Wellington P,2714,9,5,6,16,31,55,-24,21
CC Mariners,2714,10,4,8,15,28,49,-21,20
Sydney FC,2715,1,20,4,4,64,25,39,64
N'castle Jet,2715,2,15,5,8,57,38,19,50
Melbourne C,2715,3,15,4,10,44,33,11,49
Melbourne V,2715,4,14,5,10,48,38,10,47
Adelaide Utd,2715,5,11,6,11,37,40,-3,39
Brisbane,2715,6,10,5,13,33,42,-9,35
Western Sydn,2715,7,8,9,10,38,47,-9,33
Perth Glory,2715,8,10,2,15,37,50,-13,32
Wellington P,2715,9,5,6,16,31,55,-24,21
CC Mariners,2715,10,4,8,15,28,49,-21,20
Sydney FC,2716,1,20,4,4,65,25,40,64
N'castle Jet,2716,2,16,5,7,59,38,21,53
Melbourne V,2716,3,14,5,10,48,39,9,47
Melbourne C,2716,4,14,4,11,44,35,9,46
Adelaide Utd,2716,5,11,6,11,37,40,-3,39
Brisbane,2716,6,10,5,13,33,42,-9,35
Western Sydn,2716,7,8,9,10,38,47,-9,33
Perth Glory,2716,8,10,2,15,37,50,-13,32
Wellington P,2716,9,5,6,16,31,55,-24,21
CC Mariners,2716,10,4,8,15,28,49,-21,20
Sydney FC,2717,1,21,4,3,67,24,43,67
N'castle Jet,2717,2,16,5,7,60,39,21,53
Melbourne C,2717,3,14,4,11,45,36,9,46
Melbourne V,2717,4,13,5,11,47,41,6,44
Adelaide Utd,2717,5,11,6,11,37,40,-3,39
Brisbane,2717,6,10,5,13,33,42,-9,35
Western Sydn,2717,7,8,9,10,38,47,-9,33
Perth Glory,2717,8,10,2,15,37,50,-13,32
Wellington P,2717,9,5,6,16,31,55,-24,21
CC Mariners,2717,10,4,8,15,28,49,-21,20
Sydney FC,2718,1,20,5,3,65,23,42,65
N'castle Jet,2718,2,15,6,7,59,39,20,51
Melbourne C,2718,3,14,5,10,45,35,10,47
Melbourne V,2718,4,13,6,10,46,39,7,45
Adelaide Utd,2718,5,11,6,11,37,40,-3,39
Brisbane,2718,6,10,5,13,33,42,-9,35
Western Sydn,2718,7,8,9,10,38,47,-9,33
Perth Glory,2718,8,10,2,15,37,50,-13,32
Wellington P,2718,9,5,6,16,31,55,-24,21
CC Mariners,2718,10,4,8,15,28,49,-21,20
Sydney FC,2719,1,21,4,3,68,24,44,67
N'castle Jet,2719,2,15,5,8,58,39,19,50
Melbourne C,2719,3,15,4,10,45,34,11,49
Melbourne V,2719,4,13,5,11,47,42,5,44
Adelaide Utd,2719,5,11,6,11,37,40,-3,39
Brisbane,2719,6,10,5,13,33,42,-9,35
Western Sydn,2719,7,8,9,10,38,47,-9,33
Perth Glory,2719,8,10,2,15,37,50,-13,32
Wellington P,2719,9,5,6,16,31,55,-24,21
CC Mariners,2719,10,4,8,15,28,49,-21,20
Sydney FC,2720,1,21,4,3,65,22,43,67
N'castle Jet,2720,2,15,6,7,58,38,20,51
Melbourne C,2720,3,14,5,10,44,34,10,47
Melbourne V,2720,4,13,5,11,45,39,6,44
Adelaide Utd,2720,5,11,6,11,37,40,-3,39
Brisbane,2720,6,10,5,13,33,42,-9,35
Western Sydn,2720,7,8,9,10,38,47,-9,33
Perth Glory,2720,8,10,2,15,37,50,-13,32
Wellington P,2720,9,5,6,16,31,55,-24,21
CC Mariners,2720,10,4,8,15,28,49,-21,20
Sydney FC,2721,1,21,4,3,66,22,44,67
N'castle Jet,2721,2,16,5,7,61,37,24,53
Melbourne C,2721,3,14,4,11,43,37,6,46
Melbourne V,2721,4,13,5,11,45,40,5,44
Adelaide Utd,2721,5,11,6,11,37,40,-3,39
Brisbane,2721,6,10,5,13,33,42,-9,35
Western Sydn,2721,7,8,9,10,38,47,-9,33
Perth Glory,2721,8,10,2,15,37,50,-13,32
Wellington P,2721,9,5,6,16,31,55,-24,21
CC Mariners,2721,10,4,8,15,28,49,-21,20
Sydney FC,2722,1,21,4,3,65,22,43,67
N'castle Jet,2722,2,16,5,7,59,37,22,53
Melbourne C,2722,3,14,4,11,43,35,8,46
Melbourne V,2722,4,13,5,11,45,39,6,44
Adelaide Utd,2722,5,11,6,11,37,40,-3,39
Brisbane,2722,6,10,5,13,33,42,-9,35
Western Sydn,2722,7,8,9,10,38,47,-9,33
Perth Glory,2722,8,10,2,15,37,50,-13,32
Wellington P,2722,9,5,6,16,31,55,-24,21
CC Mariners,2722,10,4,8,15,28,49,-21,20
Sydney FC,2723,1,21,4,3,69,23,46,67
N'castle Jet,2723,2,15,5,8,58,39,19,50
Melbourne C,2723,3,15,4,10,45,34,11,49
Melbourne V,2723,4,13,5,11,46,43,3,44
Adelaide Utd,2723,5,11,6,11,37,40,-3,39
Brisbane,2723,6,10,5,13,33,42,-9,35
Western Sydn,2723,7,8,9,10,38,47,-9,33
Perth Glory,2723,8,10,2,15,37,50,-13,32
Wellington P,2723,9,5,6,16,31,55,-24,21
CC Mariners,2723,10,4,8,15,28,49,-21,20
Sydney FC,2724,1,21,4,3,67,23,44,67
N'castle Jet,2724,2,16,5,7,59,38,21,53
Melbourne C,2724,3,14,4,11,44,35,9,46
Melbourne V,2724,4,13,5,11,46,41,5,44
Adelaide Utd,2724,5,11,6,11,37,40,-3,39
Brisbane,2724,6,10,5,13,33,42,-9,35
Western Sydn,2724,7,8,9,10,38,47,-9,33
Perth Glory,2724,8,10,2,15,37,50,-13,32
Wellington P,2724,9,5,6,16,31,55,-24,21
CC Mariners,2724,10,4,8,15,28,49,-21,20
Sydney FC,2725,1,20,4,4,64,23,41,64
N'castle Jet,2725,2,16,5,7,59,38,21,53
Melbourne V,2725,3,14,5,10,46,38,8,47
Melbourne C,2725,4,14,4,11,44,35,9,46
Adelaide Utd,2725,5,11,6,11,37,40,-3,39
Brisbane,2725,6,10,5,13,33,42,-9,35
Western Sydn,2725,7,8,9,10,38,47,-9,33
Perth Glory,2725,8,10,2,15,37,50,-13,32
Wellington P,2725,9,5,6,16,31,55,-24,21
CC Mariners,2725,10,4,8,15,28,49,-21,20
Sydney FC,2726,1,21,4,3,67,23,44,67
N'castle Jet,2726,2,15,6,7,59,39,20,51
Melbourne C,2726,3,14,5,10,45,35,10,47
Melbourne V,2726,4,13,5,11,46,41,5,44
Adelaide Utd,2726,5,11,6,11,37,40,-3,39
Brisbane,2726,6,10,5,13,33,42,-9,35
Western Sydn,2726,7,8,9,10,38,47,-9,33
Perth Glory,2726,8,10,2,15,37,50,-13,32
Wellington P,2726,9,5,6,16,31,55,-24,21
CC Mariners,2726,10,4,8,15,28,49,-21,20
Sydney FC,2727,1,20,4,4,64,23,41,64
N'castle Jet,2727,2,15,6,7,59,39,20,51
Melbourne C,2727,3,14,5,10,45,35,10,47
Melbourne V,2727,4,14,5,10,46,38,8,47
Adelaide Utd,2727,5,11,6,11,37,40,-3,39
Brisbane,2727,6,10,5,13,33,42,-9,35
Western Sydn,2727,7,8,9,10,38,47,-9,33
Perth Glory,2727,8,10,2,15,37,50,-13,32
Wellington P,2727,9,5,6,16,31,55,-24,21
CC Mariners,2727,10,4,8,15,28,49,-21,20
Sydney FC,2728,1,20,4,4,65,24,41,64
N'castle Jet,2728,2,15,6,7,58,38,20,51
Melbourne C,2728,3,14,5,10,44,34,10,47
Melbourne V,2728,4,14,5,10,47,39,8,47
Adelaide Utd,2728,5,11,6,11,37,40,-3,39
Brisbane,2728,6,10,5,13,33,42,-9,35
Western Sydn,2728,7,8,9,10,38,47,-9,33
Perth Glory,2728,8,10,2,15,37,50,-13,32
Wellington P,2728,9,5,6,16,31,55,-24,21
CC Mariners,2728,10,4,8,15,28,49,-21,20
Sydney FC,2729,1,21,4,3,66,23,43,67
N'castle Jet,2729,2,16,5,7,58,37,21,53
Melbourne C,2729,3,14,4,11,43,34,9,46
Melbourne V,2729,4,13,5,11,46,40,6,44
Adelaide Utd,2729,5,11,6,11,37,40,-3,39
Brisbane,2729,6,10,5,13,33,42,-9,35
Western Sydn,2729,7,8,9,10,38,47,-9,33
Perth Glory,2729,8,10,2,15,37,50,-13,32
Wellington P,2729,9,5,6,16,31,55,-24,21
CC Mariners,2729,10,4,8,15,28,49,-21,20
Sydney FC,2730,1,21,4,3,67,22,45,67
N'castle Jet,2730,2,16,5,7,60,39,21,53
Melbourne C,2730,3,14,4,11,45,36,9,46
Melbourne V,2730,4,13,5,11,45,41,4,44
Adelaide Utd,2730,5,11,6,11,37,40,-3,39
Brisbane,2730,6,10,5,13,33,42,-9,35
Western Sydn,2730,7,8,9,10,38,47,-9,33
Perth Glory,2730,8,10,2,15,37,50,-13,32
Wellington P,2730,9,5,6,16,31,55,-24,21
CC Mariners,2730,10,4,8,15,28,49,-21,20
Sydney FC,2731,1,21,4,3,71,23,48,67
N'castle Jet,2731,2,15,5,8,57,39,18,50
Melbourne C,2731,3,15,4,10,45,33,12,49
Melbourne V,2731,4,13,5,11,46,45,1,44
Adelaide Utd,2731,5,11,6,11,37,40,-3,39
Brisbane,2731,6,10,5,13,33,42,-9,35
Western Sydn,2731,7,8,9,10,38,47,-9,33
Perth Glory,2731,8,10,2,15,37,50,-13,32
Wellington P,2731,9,5,6,16,31,55,-24,21
CC Mariners,2731,10,4,8,15,28,49,-21,20
Sydney FC,2732,1,20,4,4,66,25,41,64
N'castle Jet,2732,2,15,5,8,57,38,19,50
Melbourne C,2732,3,15,4,10,44,33,11,49
Melbourne V,2732,4,14,5,10,48,40,8,47
Adelaide Utd,2732,5,11,6,11,37,40,-3,39
Brisbane,2732,6,10,5,13,33,42,-9,35
Western Sydn,2732,7,8,9,10,38,47,-9,33
Perth Glory,2732,8,10,2,15,37,50,-13,32
Wellington P,2732,9,5,6,16,31,55,-24,21
CC Mariners,2732,10,4,8,15,28,49,-21,20
Sydney FC,2733,1,20,4,4,65,25,40,64
N'castle Jet,2733,2,16,5,7,59,37,22,53
Melbourne V,2733,3,14,5,10,48,39,9,47
Melbourne C,2733,4,14,4,11,43,35,8,46
Adelaide Utd,2733,5,11,6,11,37,40,-3,39
Brisbane,2733,6,10,5,13,33,42,-9,35
Western Sydn,2733,7,8,9,10,38,47,-9,33
Perth Glory,2733,8,10,2,15,37,50,-13,32
Wellington P,2733,9,5,6,16,31,55,-24,21
CC Mariners,2733,10,4,8,15,28,49,-21,20
Sydney FC,2734,1,20,5,3,65,23,42,65
N'castle Jet,2734,2,15,5,8,59,40,19,50
Melbourne C,2734,3,15,4,10,46,35,11,49
Melbourne V,2734,4,13,6,10,46,39,7,45
Adelaide Utd,2734,5,11,6,11,37,40,-3,39
Brisbane,2734,6,10,5,13,33,42,-9,35
Western Sydn,2734,7,8,9,10,38,47,-9,33
Perth Glory,2734,8,10,2,15,37,50,-13,32
Wellington P,2734,9,5,6,16,31,55,-24,21
CC Mariners,2734,10,4,8,15,28,49,-21,20
Sydney FC,2735,1,20,5,3,65,23,42,65
N'castle Jet,2735,2,15,6,7,60,40,20,51
Melbourne C,2735,3,14,5,10,46,36,10,47
Melbourne V,2735,4,13,6,10,46,39,7,45
Adelaide Utd,2735,5,11,6,11,37,40,-3,39
Brisbane,2735,6,10,5,13,33,42,-9,35
Western Sydn,2735,7,8,9,10,38,47,-9,33
Perth Glory,2735,8,10,2,15,37,50,-13,32
Wellington P,2735,9,5,6,16,31,55,-24,21
CC Mariners,2735,10,4,8,15,28,49,-21,20
Sydney FC,2736,1,21,4,3,67,23,44,67
N'castle Jet,2736,2,16,5,7,59,37,22,53
Melbourne C,2736,3,14,4,11,43,35,8,46
Melbourne V,2736,4,13,5,11,46,41,5,44
Adelaide Utd,2736,5,11,6,11,37,40,-3,39
Brisbane,2736,6,10,5,13,33,42,-9,35
Western Sydn,2736,7,8,9,10,38,47,-9,33
Perth Glory,2736,8,10,2,15,37,50,-13,32
Wellington P,2736,9,5,6,16,31,55,-24,21
CC Mariners,2736,10,4,8,15,28,49,-21,20
Sydney FC,2737,1,20,4,4,66,25,41,64
N'castle Jet,2737,2,16,5,7,58,37,21,53
Melbourne V,2737,3,14,5,10,48,40,8,47
Melbourne C,2737,4,14,4,11,43,34,9,46
Adelaide Utd,2737,5,11,6,11,37,40,-3,39
Brisbane,2737,6,10,5,13,33,42,-9,35
Western Sydn,2737,7,8,9,10,38,47,-9,33
Perth Glory,2737,8,10,2,15,37,50,-13,32
Wellington P,2737,9,5,6,16,31,55,-24,21
CC Mariners,2737,10,4,8,15,28,49,-21,20
Sydney FC,2738,1,21,4,3,66,22,44,67
N'castle Jet,2738,2,16,5,7,60,37,23,53
Melbourne C,2738,3,14,4,11,43,36,7,46
Melbourne V,2738,4,13,5,11,45,40,5,44
Adelaide Utd,2738,5,11,6,11,37,40,-3,39
Brisbane,2738,6,10,5,13,33,42,-9,35
Western Sydn,2738,7,8,9,10,38,47,-9,33
Perth Glory,2738,8,10,2,15,37,50,-13,32
Wellington P,2738,9,5,6,16,31,55,-24,21
CC Mariners,2738,10,4,8,15,28,49,-21,20
Sydney FC,2739,1,21,4,3,67,24,43,67
N'castle Jet,2739,2,15,6,7,58,38,20,51
Melbourne C,2739,3,14,5,10,44,34,10,47
Melbourne V,2739,4,13,5,11,47,41,6,44
Adelaide Utd,2739,5,11,6,11,37,40,-3,39
Brisbane,2739,6,10,5,13,33,42,-9,35
Western Sydn,2739,7,8,9,10,38,47,-9,33
Perth Glory,2739,8,10,2,15,37,50,-13,32
Wellington P,2739,9,5,6,16,31,55,-24,21
CC Mariners,2739,10,4,8,15,28,49,-21,20
Sydney FC,2740,1,21,4,3,70,24,46,67
N'castle Jet,2740,2,15,5,8,57,39,18,50
Melbourne C,2740,3,15,4,10,45,33,12,49
Melbourne V,2740,4,13,5,11,47,44,3,44
Adelaide Utd,2740,5,11,6,11,37,40,-3,39
Brisbane,2740,6,10,5,13,33,42,-9,35
Western Sydn,2740,7,8,9,10,38,47,-9,33
Perth Glory,2740,8,10,2,15,37,50,-13,32
Wellington P,2740,9,5,6,16,31,55,-24,21
CC Mariners,2740,10,4,8,15,28,49,-21,20
Sydney FC,2741,1,20,5,3,66,24,42,65
N'castle Jet,2741,2,15,5,8,59,40,19,50
Melbourne C,2741,3,15,4,10,46,35,11,49
Melbourne V,2741,4,13,6,10,47,40,7,45
Adelaide Utd,2741,5,11,6,11,37,40,-3,39
Brisbane,2741,6,10,5,13,33,42,-9,35
Western Sydn,2741,7,8,9,10,38,47,-9,33
Perth Glory,2741,8,10,2,15,37,50,-13,32
Wellington P,2741,9,5,6,16,31,55,-24,21
CC Mariners,2741,10,4,8,15,28,49,-21,20
Sydney FC,2742,1,21,4,3,66,23,43,67
N'castle Jet,2742,2,16,5,7,59,37,22,53
Melbourne C,2742,3,14,4,11,43,35,8,46
Melbourne V,2742,4,13,5,11,46,40,6,44
Adelaide Utd,2742,5,11,6,11,37,40,-3,39
Brisbane,2742,6,10,5,13,33,42,-9,35
Western Sydn,2742,7,8,9,10,38,47,-9,33
Perth Glory,2742,8,10,2,15,37,50,-13,32
Wellington P,2742,9,5,6,16,31,55,-24,21
CC Mariners,2742,10,4,8,15,28,49,-21,20
Sydney FC,2743,1,21,4,3,69,22,47,67
N'castle Jet,2743,2,15,5,8,58,39,19,50
Melbourne C,2743,3,15,4,10,45,34,11,49
Melbourne V,2743,4,13,5,11,45,43,2,44
Adelaide Utd,2743,5,11,6,11,37,40,-3,39
Brisbane,2743,6,10,5,13,33,42,-9,35
Western Sydn,2743,7,8,9,10,38,47,-9,33
Perth Glory,2743,8,10,2,15,37,50,-13,32
Wellington P,2743,9,5,6,16,31,55,-24,21
CC Mariners,2743,10,4,8,15,28,49,-21,20
Sydney FC,2744,1,21,4,3,66,23,43,67
N'castle Jet,2744,2,16,5,7,58,37,21,53
Melbourne C,2744,3,14,4,11,43,34,9,46
Melbourne V,2744,4,13,5,11,46,40,6,44
Adelaide Utd,2744,5,11,6,11,37,40,-3,39
Brisbane,2744,6,10,5,13,33,42,-9,35
Western Sydn,2744,7,8,9,10,38,47,-9,33
Perth Glory,2744,8,10,2,15,37,50,-13,32
Wellington P,2744,9,5,6,16,31,55,-24,21
CC Mariners,2744,10,4,8,15,28,49,-21,20
Sydney FC,2745,1,21,4,3,66,22,44,67
N'castle Jet,2745,2,16,5,7,59,37,22,53
Melbourne C,2745,3,14,4,11,43,35,8,46
Melbourne V,2745,4,13,5,11,45,40,5,44
Adelaide Utd,2745,5,11,6,11,37,40,-3,39
Brisbane,2745,6,10,5,13,33,42,-9,35
Western Sydn,2745,7,8,9,10,38,47,-9,33
Perth Glory,2745,8,10,2,15,37,50,-13,32
Wellington P,2745,9,5,6,16,31,55,-24,21
CC Mariners,2745,10,4,8,15,28,49,-21,20
Sydney FC,2746,1,21,4,3,69,24,45,67
N'castle Jet,2746,2,16,5,7,59,38,21,53
Melbourne C,2746,3,14,4,11,44,35,9,46
Melbourne V,2746,4,13,5,11,47,43,4,44
Adelaide Utd,2746,5,11,6,11,37,40,-3,39
Brisbane,2746,6,10,5,13,33,42,-9,35
Western Sydn,2746,7,8,9,10,38,47,-9,33
Perth Glory,2746,8,10,2,15,37,50,-13,32
Wellington P,2746,9,5,6,16,31,55,-24,21
CC Mariners,2746,10,4,8,15,28,49,-21,20
Sydney FC,2747,1,21,4,3,67,23,44,67
N'castle Jet,2747,2,16,5,7,59,38,21,53
Melbourne C,2747,3,14,4,11,44,35,9,46
Melbourne V,2747,4,13,5,11,46,41,5,44
Adelaide Utd,2747,5,11,6,11,37,40,-3,39
Brisbane,2747,6,10,5,13,33,42,-9,35
Western Sydn,2747,7,8,9,10,38,47,-9,33
Perth Glory,2747,8,10,2,15,37,50,-13,32
Wellington P,2747,9,5,6,16,31,55,-24,21
CC Mariners,2747,10,4,8,15,28,49,-21,20
Sydney FC,2748,1,21,4,3,69,22,47,67
N'castle Jet,2748,2,16,5,7,62,39,23,53
Melbourne C,2748,3,14,4,11,45,38,7,46
Melbourne V,2748,4,13,5,11,45,43,2,44
Adelaide Utd,2748,5,11,6,11,37,40,-3,39
Brisbane,2748,6,10,5,13,33,42,-9,35
Western Sydn,2748,7,8,9,10,38,47,-9,33
Perth Glory,2748,8,10,2,15,37,50,-13,32
Wellington P,2748,9,5,6,16,31,55,-24,21
CC Mariners,2748,10,4,8,15,28,49,-21,20
Sydney FC,2749,1,21,4,3,66,22,44,67
N'castle Jet,2749,2,15,5,8,58,40,18,50
Melbourne C,2749,3,15,4,10,46,34,12,49
Melbourne V,2749,4,13,5,11,45,40,5,44
Adelaide Utd,2749,5,11,6,11,37,40,-3,39
Brisbane,2749,6,10,5,13,33,42,-9,35
Western Sydn,2749,7,8,9,10,38,47,-9,33
Perth Glory,2749,8,10,2,15,37,50,-13,32
Wellington P,2749,9,5,6,16,31,55,-24,21
CC Mariners,2749,10,4,8,15,28,49,-21,20
Sydney FC,2750,1,21,4,3,67,23,44,67
N'castle Jet,2750,2,15,5,8,58,41,17,50
Melbourne C,2750,3,15,4,10,47,34,13,49
Melbourne V,2750,4,13,5,11,46,41,5,44
Adelaide Utd,2750,5,11,6,11,37,40,-3,39
Brisbane,2750,6,10,5,13,33,42,-9,35
Western Sydn,2750,7,8,9,10,38,47,-9,33
Perth Glory,2750,8,10,2,15,37,50,-13,32
Wellington P,2750,9,5,6,16,31,55,-24,21
CC Mariners,2750,10,4,8,15,28,49,-21,20
Sydney FC,2751,1,21,4,3,67,23,44,67
N'castle Jet,2751,2,15,6,7,59,39,20,51
Melbourne C,2751,3,14,5,10,45,35,10,47
Melbourne V,2751,4,13,5,11,46,41,5,44
Adelaide Utd,2751,5,11,6,11,37,40,-3,39
Brisbane,2751,6,10,5,13,33,42,-9,35
Western Sydn,2751,7,8,9,10,38,47,-9,33
Perth Glory,2751,8,10,2,15,37,50,-13,32
Wellington P,2751,9,5,6,16,31,55,-24,21
CC Mariners,2751,10,4,8,15,28,49,-21,20
Sydney FC,2752,1,20,4,4,64,25,39,64
N'castle Jet,2752,2,16,5,7,58,37,21,53
Melbourne V,2752,3,14,5,10,48,38,10,47
Melbourne C,2752,4,14,4,11,43,34,9,46
Adelaide Utd,2752,5,11,6,11,37,40,-3,39
Brisbane,2752,6,10,5,13,33,42,-9,35
Western Sydn,2752,7,8,9,10,38,47,-9,33
Perth Glory,2752,8,10,2,15,37,50,-13,32
Wellington P,2752,9,5,6,16,31,55,-24,21
CC Mariners,2752,10,4,8,15,28,49,-21,20
Sydney FC,2753,1,21,4,3,67,24,43,67
N'castle Jet,2753,2,16,5,7,58,37,21,53
Melbourne C,2753,3,14,4,11,43,34,9,46
Melbourne V,2753,4,13,5,11,47,41,6,44
Adelaide Utd,2753,5,11,6,11,37,40,-3,39
Brisbane,2753,6,10,5,13,33,42,-9,35
Western Sydn,2753,7,8,9,10,38,47,-9,33
Perth Glory,2753,8,10,2,15,37,50,-13,32
Wellington P,2753,9,5,6,16,31,55,-24,21
CC Mariners,2753,10,4,8,15,28,49,-21,20
Sydney FC,2754,1,21,4,3,65,22,43,67
N'castle Jet,2754,2,15,5,8,58,39,19,50
Melbourne C,2754,3,15,4,10,45,34,11,49
Melbourne V,2754,4,13,5,11,45,39,6,44
Adelaide Utd,2754,5,11,6,11,37,40,-3,39
Brisbane,2754,6,10,5,13,33,42,-9,35
Western Sydn,2754,7,8,9,10,38,47,-9,33
Perth Glory,2754,8,10,2,15,37,50,-13,32
Wellington P,2754,9,5,6,16,31,55,-24,21
CC Mariners,2754,10,4,8,15,28,49,-21,20
Sydney FC,2755,1,20,5,3,67,25,42,65
N'castle Jet,2755,2,15,5,8,57,38,19,50
Melbourne C,2755,3,15,4,10,44,33,11,49
Melbourne V,2755,4,13,6,10,48,41,7,45
Adelaide Utd,2755,5,11,6,11,37,40,-3,39
Brisbane,2755,6,10,5,13,33,42,-9,35
Western Sydn,2755,7,8,9,10,38,47,-9,33
Perth Glory,2755,8,10,2,15,37,50,-13,32
Wellington P,2755,9,5,6,16,31,55,-24,21
CC Mariners,2755,10,4,8,15,28,49,-21,20
Sydney FC,2756,1,21,4,3,66,23,43,67
N'castle Jet,2756,2,15,5,8,57,38,19,50
Melbourne C,2756,3,15,4,10,44,33,11,49
Melbourne V,2756,4,13,5,11,46,40,6,44
Adelaide Utd,2756,5,11,6,11,37,40,-3,39
Brisbane,2756,6,10,5,13,33,42,-9,35
Western Sydn,2756,7,8,9,10,38,47,-9,33
Perth Glory,2756,8,10,2,15,37,50,-13,32
Wellington P,2756,9,5,6,16,31,55,-24,21
CC Mariners,2756,10,4,8,15,28,49,-21,20
Sydney FC,2757,1,20,4,4,64,23,41,64
N'castle Jet,2757,2,16,5,7,61,38,23,53
Melbourne V,2757,3,14,5,10,46,38,8,47
Melbourne C,2757,4,14,4,11,44,37,7,46
Adelaide Utd,2757,5,11,6,11,37,40,-3,39
Brisbane,2757,6,10,5,13,33,42,-9,35
Western Sydn,2757,7,8,9,10,38,47,-9,33
Perth Glory,2757,8,10,2,15,37,50,-13,32
Wellington P,2757,9,5,6,16,31,55,-24,21
CC Mariners,2757,10,4,8,15,28,49,-21,20
Sydney FC,2758,1,20,5,3,66,24,42,65
N'castle Jet,2758,2,16,5,7,60,38,22,53
Melbourne C,2758,3,14,4,11,44,36,8,46
Melbourne V,2758,4,13,6,10,47,40,7,45
Adelaide Utd,2758,5,11,6,11,37,40,-3,39
Brisbane,2758,6,10,5,13,33,42,-9,35
Western Sydn,2758,7,8,9,10,38,47,-9,33
Perth Glory,2758,8,10,2,15,37,50,-13,32
Wellington P,2758,9,5,6,16,31,55,-24,21
CC Mariners,2758,10,4,8,15,28,49,-21,20
Sydney FC,2759,1,20,4,4,65,24,41,64
N'castle Jet,2759,2,15,6,7,58,38,20,51
Melbourne C,2759,3,14,5,10,44,34,10,47
Melbourne V,2759,4,14,5,10,47,39,8,47
Adelaide Utd,2759,5,11,6,11,37,40,-3,39
Brisbane,2759,6,10,5,13,33,42,-9,35
Western Sydn,2759,7,8,9,10,38,47,-9,33
Perth Glory,2759,8,10,2,15,37,50,-13,32
Wellington P,2759,9,5,6,16,31,55,-24,21
CC Mariners,2759,10,4,8,15,28,49,-21,20
Sydney FC,2760,1,21,4,3,66,23,43,67
N'castle Jet,2760,2,15,6,7,59,39,20,51
Melbourne C,2760,3,14,5,10,45,35,10,47
Melbourne V,2760,4,13,5,11,46,40,6,44
Adelaide Utd,2760,5,11,6,11,37,40,-3,39
Brisbane,2760,6,10,5,13,33,42,-9,35
Western Sydn,2760,7,8,9,10,38,47,-9,33
Perth Glory,2760,8,10,2,15,37,50,-13,32
Wellington P,2760,9,5,6,16,31,55,-24,21
CC Mariners,2760,10,4,8,15,28,49,-21,20
Sydney FC,2761,1,21,4,3,67,24,43,67
N'castle Jet,2761,2,16,5,7,60,38,22,53
Melbourne C,2761,3,14,4,11,44,36,8,46
Melbourne V,2761,4,13,5,11,47,41,6,44
Adelaide Utd,2761,5,11,6,11,37,40,-3,39
Brisbane,2761,6,10,5,13,33,42,-9,35
Western Sydn,2761,7,8,9,10,38,47,-9,33
Perth Glory,2761,8,10,2,15,37,50,-13,32
Wellington P,2761,9,5,6,16,31,55,-24,21
CC Mariners,2761,10,4,8,15,28,49,-21,20
Sydney FC,2762,1,20,4,4,65,24,41,64
N'castle Jet,2762,2,15,5,8,57,39,18,50
Melbourne C,2762,3,15,4,10,45,33,12,49
Melbourne V,2762,4,14,5,10,47,39,8,47
Adelaide Utd,2762,5,11,6,11,37,40,-3,39
Brisbane,2762,6,10,5,13,33,42,-9,35
Western Sydn,2762,7,8,9,10,38,47,-9,33
Perth Glory,2762,8,10,2,15,37,50,-13,32
Wellington P,2762,9,5,6,16,31,55,-24,21
CC Mariners,2762,10,4,8,15,28,49,-21,20
Sydney FC,2763,1,21,4,3,67,22,45,67
N'castle Jet,2763,2,16,5,7,59,38,21,53
Melbourne C,2763,3,14,4,11,44,35,9,46
Melbourne V,2763,4,13,5,11,45,41,4,44
Adelaide Utd,2763,5,11,6,11,37,40,-3,39
Brisbane,2763,6,10,5,13,33,42,-9,35
Western Sydn,2763,7,8,9,10,38,47,-9,33
Perth Glory,2763,8,10,2,15,37,50,-13,32
Wellington P,2763,9,5,6,16,31,55,-24,21
CC Mariners,2763,10,4,8,15,28,49,-21,20
Sydney FC,2764,1,20,5,3,67,25,42,65
N'castle Jet,2764,2,16,5,7,58,37,21,53
Melbourne C,2764,3,14,4,11,43,34,9,46
Melbourne V,2764,4,13,6,10,48,41,7,45
Adelaide Utd,2764,5,11,6,11,37,40,-3,39
Brisbane,2764,6,10,5,13,33,42,-9,35
Western Sydn,2764,7,8,9,10,38,47,-9,33
Perth Glory,2764,8,10,2,15,37,50,-13,32
Wellington P,2764,9,5,6,16,31,55,-24,21
CC Mariners,2764,10,4,8,15,28,49,-21,20
Sydney FC,2765,1,20,4,4,65,25,40,64
N'castle Jet,2765,2,16,5,7,60,37,23,53
Melbourne V,2765,3,14,5,10,48,39,9,47
Melbourne C,2765,4,14,4,11,43,36,7,46
Adelaide Utd,2765,5,11,6,11,37,40,-3,39
Brisbane,2765,6,10,5,13,33,42,-9,35
Western Sydn,2765,7,8,9,10,38,47,-9,33
Perth Glory,2765,8,10,2,15,37,50,-13,32
Wellington P,2765,9,5,6,16,31,55,-24,21
CC Mariners,2765,10,4,8,15,28,49,-21,20
Sydney FC,2766,1,21,4,3,67,22,45,67
N'castle Jet,2766,2,16,5,7,60,39,21,53
Melbourne C,2766,3,14,4,11,45,36,9,46
Melbourne V,2766,4,13,5,11,45,41,4,44
Adelaide Utd,2766,5,11,6,11,37,40,-3,39
Brisbane,2766,6,10,5,13,33,42,-9,35
Western Sydn,2766,7,8,9,10,38,47,-9,33
Perth Glory,2766,8,10,2,15,37,50,-13,32
Wellington P,2766,9,5,6,16,31,55,-24,21
CC Mariners,2766,10,4,8,15,28,49,-21,20
Sydney FC,2767,1,21,4,3,66,23,43,67
N'castle Jet,2767,2,15,6,7,58,38,20,51
Melbourne C,2767,3,14,5,10,44,34,10,47
Melbourne V,2767,4,13,5,11,46,40,6,44
Adelaide Utd,2767,5,11,6,11,37,40,-3,39
Brisbane,2767,6,10,5,13,33,42,-9,35
Western Sydn,2767,7,8,9,10,38,47,-9,33
Perth Glory,2767,8,10,2,15,37,50,-13,32
Wellington P,2767,9,5,6,16,31,55,-24,21
CC Mariners,2767,10,4,8,15,28,49,-21,20
Sydney FC,2768,1,20,5,3,64,22,42,65
N'castle Jet,2768,2,15,6,7,57,37,20,51
Melbourne C,2768,3,14,5,10,43,33,10,47
Melbourne V,2768,4,13,6,10,45,38,7,45
Adelaide Utd,2768,5,11,6,11,37,40,-3,39
Brisbane,2768,6,10,5,13,33,42,-9,35
Western Sydn,2768,7,8,9,10,38,47,-9,33
Perth Glory,2768,8,10,2,15,37,50,-13,32
Wellington P,2768,9,5,6,16,31,55,-24,21
CC Mariners,2768,10,4,8,15,28,49,-21,20
Sydney FC,2769,1,21,4,3,67,24,43,67
N'castle Jet,2769,2,15,6,7,58,38,20,51
Melbourne C,2769,3,14,5,10,44,34,10,47
Melbourne V,2769,4,13,5,11,47,41,6,44
Adelaide Utd,2769,5,11,6,11,37,40,-3,39
Brisbane,2769,6,10,5,13,33,42,-9,35
Western Sydn,2769,7,8,9,10,38,47,-9,33
Perth Glory,2769,8,10,2,15,37,50,-13,32
Wellington P,2769,9,5,6,16,31,55,-24,21
CC Mariners,2769,10,4,8,15,28,49,-21,20
Sydney FC,2770,1,21,4,3,66,23,43,67
N'castle Jet,2770,2,15,5,8,57,40,17,50
Melbourne C,2770,3,15,4,10,46,33,13,49
Melbourne V,2770,4,13,5,11,46,40,6,44
Adelaide Utd,2770,5,11,6,11,37,40,-3,39
Brisbane,2770,6,10,5,13,33,42,-9,35
Western Sydn,2770,7,8,9,10,38,47,-9,33
Perth Glory,2770,8,10,2,15,37,50,-13,32
Wellington P,2770,9,5,6,16,31,55,-24,21
CC Mariners,2770,10,4,8,15,28,49,-21,20
Sydney FC,2771,1,21,4,3,65,22,43,67
N'castle Jet,2771,2,16,5,7,59,37,22,53
Melbourne C,2771,3,14,4,11,43,35,8,46
Melbourne V,2771,4,13,5,11,45,39,6,44
Adelaide Utd,2771,5,11,6,11,37,40,-3,39
Brisbane,2771,6,10,5,13,33,42,-9,35
Western Sydn,2771,7,8,9,10,38,47,-9,33
Perth Glory,2771,8,10,2,15,37,50,-13,32
Wellington P,2771,9,5,6,16,31,55,-24,21
CC Mariners,2771,10,4,8,15,28,49,-21,20
Sydney FC,2772,1,21,4,3,66,22,44,67
N'castle Jet,2772,2,16,5,7,61,38,23,53
Melbourne C,2772,3,14,4,11,44,37,7,46
Melbourne V,2772,4,13,5,11,45,40,5,44
Adelaide Utd,2772,5,11,6,11,37,40,-3,39
Brisbane,2772,6,10,5,13,33,42,-9,35
Western Sydn,2772,7,8,9,10,38,47,-9,33
Perth Glory,2772,8,10,2,15,37,50,-13,32
Wellington P,2772,9,5,6,16,31,55,-24,21
CC Mariners,2772,10,4,8,15,28,49,-21,20
Sydney FC,2773,1,21,4,3,66,23,43,67
N'castle Jet,2773,2,16,5,7,59,38,21,53
Melbourne C,2773,3,14,4,11,44,35,9,46
Melbourne V,2773,4,13,5,11,46,40,6,44
Adelaide Utd,2773,5,11,6,11,37,40,-3,39
Brisbane,2773,6,10,5,13,33,42,-9,35
Western Sydn,2773,7,8,9,10,38,47,-9,33
Perth Glory,2773,8,10,2,15,37,50,-13,32
Wellington P,2773,9,5,6,16,31,55,-24,21
CC Mariners,2773,10,4,8,15,28,49,-21,20
Sydney FC,2774,1,20,5,3,64,22,42,65
N'castle Jet,2774,2,16,5,7,61,37,24,53
Melbourne C,2774,3,14,4,11,43,37,6,46
Melbourne V,2774,4,13,6,10,45,38,7,45
Adelaide Utd,2774,5,11,6,11,37,40,-3,39
Brisbane,2774,6,10,5,13,33,42,-9,35
Western Sydn,2774,7,8,9,10,38,47,-9,33
Perth Glory,2774,8,10,2,15,37,50,-13,32
Wellington P,2774,9,5,6,16,31,55,-24,21
CC Mariners,2774,10,4,8,15,28,49,-21,20
Sydney FC,2775,1,21,4,3,66,22,44,67
N'castle Jet,2775,2,16,5,7,59,37,22,53
Melbourne C,2775,3,14,4,11,43,35,8,46
Melbourne V,2775,4,13,5,11,45,40,5,44
Adelaide Utd,2775,5,11,6,11,37,40,-3,39
Brisbane,2775,6,10,5,13,33,42,-9,35
Western Sydn,2775,7,8,9,10,38,47,-9,33
Perth Glory,2775,8,10,2,15,37,50,-13,32
Wellington P,2775,9,5,6,16,31,55,-24,21
CC Mariners,2775,10,4,8,15,28,49,-21,20
Sydney FC,2776,1,21,4,3,67,23,44,67
N'castle Jet,2776,2,16,5,7,62,39,23,53
Melbourne C,2776,3,14,4,11,45,38,7,46
Melbourne V,2776,4,13,5,11,46,41,5,44
Adelaide Utd,2776,5,11,6,11,37,40,-3,39
Brisbane,2776,6,10,5,13,33,42,-9,35
Western Sydn,2776,7,8,9,10,38,47,-9,33
Perth Glory,2776,8,10,2,15,37,50,-13,32
Wellington P,2776,9,5,6,16,31,55,-24,21
CC Mariners,2776,10,4,8,15,28,49,-21,20
Sydney FC,2777,1,21,4,3,68,22,46,67
N'castle Jet,2777,2,16,5,7,59,38,21,53
Melbourne C,2777,3,14,4,11,44,35,9,46
Melbourne V,2777,4,13,5,11,45,42,3,44
Adelaide Utd,2777,5,11,6,11,37,40,-3,39
Brisbane,2777,6,10,5,13,33,42,-9,35
Western Sydn,2777,7,8,9,10,38,47,-9,33
Perth Glory,2777,8,10,2,15,37,50,-13,32
Wellington P,2777,9,5,6,16,31,55,-24,21
CC Mariners,2777,10,4,8,15,28,49,-21,20
Sydney FC,2778,1,21,4,3,67,24,43,67
N'castle Jet,2778,2,16,5,7,60,39,21,53
Melbourne C,2778,3,14,4,11,45,36,9,46
Melbourne V,2778,4,13,5,11,47,41,6,44
Adelaide Utd,2778,5,11,6,11,37,40,-3,39
Brisbane,2778,6,10,5,13,33,42,-9,35
Western Sydn,2778,7,8,9,10,38,47,-9,33
Perth Glory,2778,8,10,2,15,37,50,-13,32
Wellington P,2778,9,5,6,16,31,55,-24,21
CC Mariners,2778,10,4,8,15,28,49,-21,20
Sydney FC,2779,1,21,4,3,68,24,44,67
N'castle Jet,2779,2,15,5,8,57,38,19,50
Melbourne C,2779,3,15,4,10,44,33,11,49
Melbourne V,2779,4,13,5,11,47,42,5,44
Adelaide Utd,2779,5,11,6,11,37,40,-3,39
Brisbane,2779,6,10,5,13,33,42,-9,35
Western Sydn,2779,7,8,9,10,38,47,-9,33
Perth Glory,2779,8,10,2,15,37,50,-13,32
Wellington P,2779,9,5,6,16,31,55,-24,21
CC Mariners,2779,10,4,8,15,28,49,-21,20
Sydney FC,2780,1,21,4,3,65,22,43,67
N'castle Jet,2780,2,16,5,7,60,37,23,53
Melbourne C,2780,3,14,4,11,43,36,7,46
Melbourne V,2780,4,13,5,11,45,39,6,44
Adelaide Utd,2780,5,11,6,11,37,40,-3,39
Brisbane,2780,6,10,5,13,33,42,-9,35
Western Sydn,2780,7,8,9,10,38,47,-9,33
Perth Glory,2780,8,10,2,15,37,50,-13,32
Wellington P,2780,9,5,6,16,31,55,-24,21
CC Mariners,2780,10,4,8,15,28,49,-21,20
Sydney FC,2781,1,21,4,3,66,23,43,67
N'castle Jet,2781,2,16,5,7,59,38,21,53
Melbourne C,2781,3,14,4,11,44,35,9,46
Melbourne V,2781,4,13,5,11,46,40,6,44
Adelaide Utd,2781,5,11,6,11,37,40,-3,39
Brisbane,2781,6,10,5,13,33,42,-9,35
Western Sydn,2781,7,8,9,10,38,47,-9,33
Perth Glory,2781,8,10,2,15,37,50,-13,32
Wellington P,2781,9,5,6,16,31,55,-24,21
CC Mariners,2781,10,4,8,15,28,49,-21,20
Sydney FC,2782,1,20,5,3,67,25,42,65
N'castle Jet,2782,2,15,5,8,58,40,18,50
Melbourne C,2782,3,15,4,10,46,34,12,49
Melbourne V,2782,4,13,6,10,48,41,7,45
Adelaide Utd,2782,5,11,6,11,37,40,-3,39
Brisbane,2782,6,10,5,13,33,42,-9,35
Western Sydn,2782,7,8,9,10,38,47,-9,33
Perth Glory,2782,8,10,2,15,37,50,-13,32
Wellington P,2782,9,5,6,16,31,55,-24,21
CC Mariners,2782,10,4,8,15,28,49,-21,20
Sydney FC,2783,1,21,4,3,67,23,44,67
N'castle Jet,2783,2,15,5,8,57,39,18,50
Melbourne C,2783,3,15,4,10,45,33,12,49
Melbourne V,2783,4,13,5,11,46,41,5,44
Adelaide Utd,2783,5,11,6,11,37,40,-3,39
Brisbane,2783,6,10,5,13,33,42,-9,35
Western Sydn,2783,7,8,9,10,38,47,-9,33
Perth Glory,2783,8,10,2,15,37,50,-13,32
Wellington P,2783,9,5,6,16,31,55,-24,21
CC Mariners,2783,10,4,8,15,28,49,-21,20
Sydney FC,2784,1,21,4,3,66,22,44,67
N'castle Jet,2784,2,16,5,7,59,37,22,53
Melbourne C,2784,3,14,4,11,43,35,8,46
Melbourne V,2784,4,13,5,11,45,40,5,44
Adelaide Utd,2784,5,11,6,11,37,40,-3,39
Brisbane,2784,6,10,5,13,33,42,-9,35
Western Sydn,2784,7,8,9,10,38,47,-9,33
Perth Glory,2784,8,10,2,15,37,50,-13,32
Wellington P,2784,9,5,6,16,31,55,-24,21
CC Mariners,2784,10,4,8,15,28,49,-21,20
Sydney FC,2785,1,21,4,3,66,23,43,67
N'castle Jet,2785,2,16,5,7,59,38,21,53
Melbourne C,2785,3,14,4,11,44,35,9,46
Melbourne V,2785,4,13,5,11,46,40,6,44
Adelaide Utd,2785,5,11,6,11,37,40,-3,39
Brisbane,2785,6,10,5,13,33,42,-9,35
Western Sydn,2785,7,8,9,10,38,47,-9,33
Perth Glory,2785,8,10,2,15,37,50,-13,32
Wellington P,2785,9,5,6,16,31,55,-24,21
CC Mariners,2785,10,4,8,15,28,49,-21,20
Sydney FC,2786,1,21,4,3,66,22,44,67
N'castle Jet,2786,2,16,5,7,61,38,23,53
Melbourne C,2786,3,14,4,11,44,37,7,46
Melbourne V,2786,4,13,5,11,45,40,5,44
Adelaide Utd,2786,5,11,6,11,37,40,-3,39
Brisbane,2786,6,10,5,13,33,42,-9,35
Western Sydn,2786,7,8,9,10,38,47,-9,33
Perth Glory,2786,8,10,2,15,37,50,-13,32
Wellington P,2786,9,5,6,16,31,55,-24,21
CC Mariners,2786,10,4,8,15,28,49,-21,20
Sydney FC,2787,1,20,4,4,64,23,41,64
N'castle Jet,2787,2,15,6,7,57,37,20,51
Melbourne C,2787,3,14,5,10,43,33,10,47
Melbourne V,2787,4,14,5,10,46,38,8,47
Adelaide Utd,2787,5,11,6,11,37,40,-3,39
Brisbane,2787,6,10,5,13,33,42,-9,35
Western Sydn,2787,7,8,9,10,38,47,-9,33
Perth Glory,2787,8,10,2,15,37,50,-13,32
Wellington P,2787,9,5,6,16,31,55,-24,21
CC Mariners,2787,10,4,8,15,28,49,-21,20
Sydney FC,2788,1,20,4,4,64,25,39,64
N'castle Jet,2788,2,15,5,8,57,38,19,50
Melbourne C,2788,3,15,4,10,44,33,11,49
Melbourne V,2788,4,14,5,10,48,38,10,47
Adelaide Utd,2788,5,11,6,11,37,40,-3,39
Brisbane,2788,6,10,5,13,33,42,-9,35
Western Sydn,2788,7,8,9,10,38,47,-9,33
Perth Glory,2788,8,10,2,15,37,50,-13,32
Wellington P,2788,9,5,6,16,31,55,-24,21
CC Mariners,2788,10,4,8,15,28,49,-21,20
Sydney FC,2789,1,21,4,3,66,22,44,67
N'castle Jet,2789,2,16,5,7,59,38,21,53
Melbourne C,2789,3,14,4,11,44,35,9,46
Melbourne V,2789,4,13,5,11,45,40,5,44
Adelaide Utd,2789,5,11,6,11,37,40,-3,39
Brisbane,2789,6,10,5,13,33,42,-9,35
Western Sydn,2789,7,8,9,10,38,47,-9,33
Perth Glory,2789,8,10,2,15,37,50,-13,32
Wellington P,2789,9,5,6,16,31,55,-24,21
CC Mariners,2789,10,4,8,15,28,49,-21,20
Sydney FC,2790,1,21,4,3,67,24,43,67
N'castle Jet,2790,2,15,5,8,57,39,18,50
Melbourne C,2790,3,15,4,10,45,33,12,49
Melbourne V,2790,4,13,5,11,47,41,6,44
Adelaide Utd,2790,5,11,6,11,37,40,-3,39
Brisbane,2790,6,10,5,13,33,42,-9,35
Western Sydn,2790,7,8,9,10,38,47,-9,33
Perth Glory,2790,8,10,2,15,37,50,-13,32
Wellington P,2790,9,5,6,16,31,55,-24,21
CC Mariners,2790,10,4,8,15,28,49,-21,20
Sydney FC,2791,1,21,4,3,65,22,43,67
N'castle Jet,2791,2,16,5,7,61,40,21,53
Melbourne C,2791,3,14,4,11,46,37,9,46
Melbourne V,2791,4,13,5,11,45,39,6,44
Adelaide Utd,2791,5,11,6,11,37,40,-3,39
Brisbane,2791,6,10,5,13,33,42,-9,35
Western Sydn,2791,7,8,9,10,38,47,-9,33
Perth Glory,2791,8,10,2,15,37,50,-13,32
Wellington P,2791,9,5,6,16,31,55,-24,21
CC Mariners,2791,10,4,8,15,28,49,-21,20
Sydney FC,2792,1,21,4,3,65,22,43,67
N'castle Jet,2792,2,15,5,8,58,40,18,50
Melbourne C,2792,3,15,4,10,46,34,12,49
Melbourne V,2792,4,13,5,11,45,39,6,44
Adelaide Utd,2792,5,11,6,11,37,40,-3,39
Brisbane,2792,6,10,5,13,33,42,-9,35
Western Sydn,2792,7,8,9,10,38,47,-9,33
Perth Glory,2792,8,10,2,15,37,50,-13,32
Wellington P,2792,9,5,6,16,31,55,-24,21
CC Mariners,2792,10,4,8,15,28,49,-21,20
Sydney FC,2793,1,21,4,3,65,22,43,67
N'castle Jet,2793,2,15,5,8,58,39,19,50
Melbourne C,2793,3,15,4,10,45,34,11,49
Melbourne V,2793,4,13,5,11,45,39,6,44
Adelaide Utd,2793,5,11,6,11,37,40,-3,39
Brisbane,2793,6,10,5,13,33,42,-9,35
Western Sydn,2793,7,8,9,10,38,47,-9,33
Perth Glory,2793,8,10,2,15,37,50,-13,32
Wellington P,2793,9,5,6,16,31,55,-24,21
CC Mariners,2793,10,4,8,15,28,49,-21,20
Sydney FC,2794,1,21,4,3,67,23,44,67
N'castle Jet,2794,2,15,6,7,59,39,20,51
Melbourne C,2794,3,14,5,10,45,35,10,47
Melbourne V,2794,4,13,5,11,46,41,5,44
Adelaide Utd,2794,5,11,6,11,37,40,-3,39
Brisbane,2794,6,10,5,13,33,42,-9,35
Western Sydn,2794,7,8,9,10,38,47,-9,33
Perth Glory,2794,8,10,2,15,37,50,-13,32
Wellington P,2794,9,5,6,16,31,55,-24,21
CC Mariners,2794,10,4,8,15,28,49,-21,20
Sydney FC,2795,1,21,4,3,66,22,44,67
N'castle Jet,2795,2,15,5,8,57,39,18,50
Melbourne C,2795,3,15,4,10,45,33,12,49
Melbourne V,2795,4,13,5,11,45,40,5,44
Adelaide Utd,2795,5,11,6,11,37,40,-3,39
Brisbane,2795,6,10,5,13,33,42,-9,35
Western Sydn,2795,7,8,9,10,38,47,-9,33
Perth Glory,2795,8,10,2,15,37,50,-13,32
Wellington P,2795,9,5,6,16,31,55,-24,21
CC Mariners,2795,10,4,8,15,28,49,-21,20
Sydney FC,2796,1,21,4,3,68,22,46,67
N'castle Jet,2796,2,15,5,8,58,40,18,50
Melbourne C,2796,3,15,4,10,46,34,12,49
Melbourne V,2796,4,13,5,11,45,42,3,44
Adelaide Utd,2796,5,11,6,11,37,40,-3,39
Brisbane,2796,6,10,5,13,33,42,-9,35
Western Sydn,2796,7,8,9,10,38,47,-9,33
Perth Glory,2796,8,10,2,15,37,50,-13,32
Wellington P,2796,9,5,6,16,31,55,-24,21
CC Mariners,2796,10,4,8,15,28,49,-21,20
Sydney FC,2797,1,21,4,3,65,22,43,67
N'castle Jet,2797,2,15,5,8,57,39,18,50
Melbourne C,2797,3,15,4,10,45,33,12,49
Melbourne V,2797,4,13,5,11,45,39,6,44
Adelaide Utd,2797,5,11,6,11,37,40,-3,39
Brisbane,2797,6,10,5,13,33,42,-9,35
Western Sydn,2797,7,8,9,10,38,47,-9,33
Perth Glory,2797,8,10,2,15,37,50,-13,32
Wellington P,2797,9,5,6,16,31,55,-24,21
CC Mariners,2797,10,4,8,15,28,49,-21,20
Sydney FC,2798,1,21,4,3,67,23,44,67
N'castle Jet,2798,2,15,6,7,57,37,20,51
Melbourne C,2798,3,14,5,10,43,33,10,47
Melbourne V,2798,4,13,5,11,46,41,5,44
Adelaide Utd,2798,5,11,6,11,37,40,-3,39
Brisbane,2798,6,10,5,13,33,42,-9,35
Western Sydn,2798,7,8,9,10,38,47,-9,33
Perth Glory,2798,8,10,2,15,37,50,-13,32
Wellington P,2798,9,5,6,16,31,55,-24,21
CC Mariners,2798,10,4,8,15,28,49,-21,20
Sydney FC,2799,1,21,4,3,66,22,44,67
N'castle Jet,2799,2,16,5,7,58,37,21,53
Melbourne C,2799,3,14,4,11,43,34,9,46
Melbourne V,2799,4,13,5,11,45,40,5,44
Adelaide Utd,2799,5,11,6,11,37,40,-3,39
Brisbane,2799,6,10,5,13,33,42,-9,35
Western Sydn,2799,7,8,9,10,38,47,-9,33
Perth Glory,2799,8,10,2,15,37,50,-13,32
Wellington P,2799,9,5,6,16,31,55,-24,21
CC Mariners,2799,10,4,8,15,28,49,-21,20
Sydney FC,2800,1,20,4,4,65,24,41,64
N'castle Jet,2800,2,15,5,8,57,38,19,50
Melbourne C,2800,3,15,4,10,44,33,11,49
Melbourne V,2800,4,14,5,10,47,39,8,47
Adelaide Utd,2800,5,11,6,11,37,40,-3,39
Brisbane,2800,6,10,5,13,33,42,-9,35
Western Sydn,2800,7,8,9,10,38,47,-9,33
Perth Glory,2800,8,10,2,15,37,50,-13,32
Wellington P,2800,9,5,6,16,31,55,-24,21
CC Mariners,2800,10,4,8,15,28,49,-21,20
Sydney FC,2801,1,20,4,4,65,24,41,64
N'castle Jet,2801,2,15,5,8,58,39,19,50
Melbourne C,2801,3,15,4,10,45,34,11,49
Melbourne V,2801,4,14,5,10,47,39,8,47
Adelaide Utd,2801,5,11,6,11,37,40,-3,39
Brisbane,2801,6,10,5,13,33,42,-9,35
Western Sydn,2801,7,8,9,10,38,47,-9,33
Perth Glory,2801,8,10,2,15,37,50,-13,32
Wellington P,2801,9,5,6,16,31,55,-24,21
CC Mariners,2801,10,4,8,15,28,49,-21,20
Sydney FC,2802,1,20,4,4,64,23,41,64
N'castle Jet,2802,2,16,5,7,59,37,22,53
Melbourne V,2802,3,14,5,10,46,38,8,47
Melbourne C,2802,4,14,4,11,43,35,8,46
Adelaide Utd,2802,5,11,6,11,37,40,-3,39
Brisbane,2802,6,10,5,13,33,42,-9,35
Western Sydn,2802,7,8,9,10,38,47,-9,33
Perth Glory,2802,8,10,2,15,37,50,-13,32
Wellington P,2802,9,5,6,16,31,55,-24,21
CC Mariners,2802,10,4,8,15,28,49,-21,20
Sydney FC,2803,1,20,5,3,64,22,42,65
N'castle Jet,2803,2,16,5,7,61,37,24,53
Melbourne C,2803,3,14,4,11,43,37,6,46
Melbourne V,2803,4,13,6,10,45,38,7,45
Adelaide Utd,2803,5,11,6,11,37,40,-3,39
Brisbane,2803,6,10,5,13,33,42,-9,35
Western Sydn,2803,7,8,9,10,38,47,-9,33
Perth Glory,2803,8,10,2,15,37,50,-13,32
Wellington P,2803,9,5,6,16,31,55,-24,21
CC Mariners,2803,10,4,8,15,28,49,-21,20
Sydney FC,2804,1,21,4,3,69,22,47,67
N'castle Jet,2804,2,16,5,7,62,37,25,53
Melbourne C,2804,3,14,4,11,43,38,5,46
Melbourne V,2804,4,13,5,11,45,43,2,44
Adelaide Utd,2804,5,11,6,11,37,40,-3,39
Brisbane,2804,6,10,5,13,33,42,-9,35
Western Sydn,2804,7,8,9,10,38,47,-9,33
Perth Glory,2804,8,10,2,15,37,50,-13,32
Wellington P,2804,9,5,6,16,31,55,-24,21
CC Mariners,2804,10,4,8,15,28,49,-21,20
Sydney FC,2805,1,21,4,3,67,24,43,67
N'castle Jet,2805,2,16,5,7,60,39,21,53
Melbourne C,2805,3,14,4,11,45,36,9,46
Melbourne V,2805,4,13,5,11,47,41,6,44
Adelaide Utd,2805,5,11,6,11,37,40,-3,39
Brisbane,2805,6,10,5,13,33,42,-9,35
Western Sydn,2805,7,8,9,10,38,47,-9,33
Perth Glory,2805,8,10,2,15,37,50,-13,32
Wellington P,2805,9,5,6,16,31,55,-24,21
CC Mariners,2805,10,4,8,15,28,49,-21,20
Sydney FC,2806,1,21,4,3,67,23,44,67
N'castle Jet,2806,2,15,5,8,57,38,19,50
Melbourne C,2806,3,15,4,10,44,33,11,49
Melbourne V,2806,4,13,5,11,46,41,5,44
Adelaide Utd,2806,5,11,6,11,37,40,-3,39
Brisbane,2806,6,10,5,13,33,42,-9,35
Western Sydn,2806,7,8,9,10,38,47,-9,33
Perth Glory,2806,8,10,2,15,37,50,-13,32
Wellington P,2806,9,5,6,16,31,55,-24,21
CC Mariners,2806,10,4,8,15,28,49,-21,20
Sydney FC,2807,1,20,5,3,65,23,42,65
N'castle Jet,2807,2,16,5,7,59,37,22,53
Melbourne C,2807,3,14,4,11,43,35,8,46
Melbourne V,2807,4,13,6,10,46,39,7,45
Adelaide Utd,2807,5,11,6,11,37,40,-3,39
Brisbane,2807,6,10,5,13,33,42,-9,35
Western Sydn,2807,7,8,9,10,38,47,-9,33
Perth Glory,2807,8,10,2,15,37,50,-13,32
Wellington P,2807,9,5,6,16,31,55,-24,21
CC Mariners,2807,10,4,8,15,28,49,-21,20
Sydney FC,2808,1,21,4,3,67,23,44,67
N'castle Jet,2808,2,16,5,7,60,37,23,53
Melbourne C,2808,3,14,4,11,43,36,7,46
Melbourne V,2808,4,13,5,11,46,41,5,44
Adelaide Utd,2808,5,11,6,11,37,40,-3,39
Brisbane,2808,6,10,5,13,33,42,-9,35
Western Sydn,2808,7,8,9,10,38,47,-9,33
Perth Glory,2808,8,10,2,15,37,50,-13,32
Wellington P,2808,9,5,6,16,31,55,-24,21
CC Mariners,2808,10,4,8,15,28,49,-21,20
Sydney FC,2809,1,20,4,4,64,23,41,64
N'castle Jet,2809,2,16,5,7,60,39,21,53
Melbourne V,2809,3,14,5,10,46,38,8,47
Melbourne C,2809,4,14,4,11,45,36,9,46
Adelaide Utd,2809,5,11,6,11,37,40,-3,39
Brisbane,2809,6,10,5,13,33,42,-9,35
Western Sydn,2809,7,8,9,10,38,47,-9,33
Perth Glory,2809,8,10,2,15,37,50,-13,32
Wellington P,2809,9,5,6,16,31,55,-24,21
CC Mariners,2809,10,4,8,15,28,49,-21,20
Sydney FC,2810,1,20,4,4,64,25,39,64
N'castle Jet,2810,2,16,5,7,58,37,21,53
Melbourne V,2810,3,14,5,10,48,38,10,47
Melbourne C,2810,4,14,4,11,43,34,9,46
Adelaide Utd,2810,5,11,6,11,37,40,-3,39
Brisbane,2810,6,10,5,13,33,42,-9,35
Western Sydn,2810,7,8,9,10,38,47,-9,33
Perth Glory,2810,8,10,2,15,37,50,-13,32
Wellington P,2810,9,5,6,16,31,55,-24,21
CC Mariners,2810,10,4,8,15,28,49,-21,20
Sydney FC,2811,1,21,4,3,69,24,45,67
N'castle Jet,2811,2,16,5,7,60,37,23,53
Melbourne C,2811,3,14,4,11,43,36,7,46
Melbourne V,2811,4,13,5,11,47,43,4,44
Adelaide Utd,2811,5,11,6,11,37,40,-3,39
Brisbane,2811,6,10,5,13,33,42,-9,35
Western Sydn,2811,7,8,9,10,38,47,-9,33
Perth Glory,2811,8,10,2,15,37,50,-13,32
Wellington P,2811,9,5,6,16,31,55,-24,21
CC Mariners,2811,10,4,8,15,28,49,-21,20
Sydney FC,2812,1,20,4,4,65,25,40,64
N'castle Jet,2812,2,15,6,7,58,38,20,51
Melbourne C,2812,3,14,5,10,44,34,10,47
Melbourne V,2812,4,14,5,10,48,39,9,47
Adelaide Utd,2812,5,11,6,11,37,40,-3,39
Brisbane,2812,6,10,5,13,33,42,-9,35
Western Sydn,2812,7,8,9,10,38,47,-9,33
Perth Glory,2812,8,10,2,15,37,50,-13,32
Wellington P,2812,9,5,6,16,31,55,-24,21
CC Mariners,2812,10,4,8,15,28,49,-21,20
Sydney FC,2813,1,21,4,3,66,23,43,67
N'castle Jet,2813,2,15,6,7,58,38,20,51
Melbourne C,2813,3,14,5,10,44,34,10,47
Melbourne V,2813,4,13,5,11,46,40,6,44
Adelaide Utd,2813,5,11,6,11,37,40,-3,39
Brisbane,2813,6,10,5,13,33,42,-9,35
Western Sydn,2813,7,8,9,10,38,47,-9,33
Perth Glory,2813,8,10,2,15,37,50,-13,32
Wellington P,2813,9,5,6,16,31,55,-24,21
CC Mariners,2813,10,4,8,15,28,49,-21,20
Sydney FC,2814,1,21,4,3,65,22,43,67
N'castle Jet,2814,2,15,6,7,58,38,20,51
Melbourne C,2814,3,14,5,10,44,34,10,47
Melbourne V,2814,4,13,5,11,45,39,6,44
Adelaide Utd,2814,5,11,6,11,37,40,-3,39
Brisbane,2814,6,10,5,13,33,42,-9,35
Western Sydn,2814,7,8,9,10,38,47,-9,33
Perth Glory,2814,8,10,2,15,37,50,-13,32
Wellington P,2814,9,5,6,16,31,55,-24,21
CC Mariners,2814,10,4,8,15,28,49,-21,20
Sydney FC,2815,1,21,4,3,67,22,45,67
N'castle Jet,2815,2,16,5,7,61,38,23,53
Melbourne C,2815,3,14,4,11,44,37,7,46
Melbourne V,2815,4,13,5,11,45,41,4,44
Adelaide Utd,2815,5,11,6,11,37,40,-3,39
Brisbane,2815,6,10,5,13,33,42,-9,35
Western Sydn,2815,7,8,9,10,38,47,-9,33
Perth Glory,2815,8,10,2,15,37,50,-13,32
Wellington P,2815,9,5,6,16,31,55,-24,21
CC Mariners,2815,10,4,8,15,28,49,-21,20
Sydney FC,2816,1,21,4,3,70,24,46,67
N'castle Jet,2816,2,16,5,7,61,40,21,53
Melbourne C,2816,3,14,4,11,46,37,9,46
Melbourne V,2816,4,13,5,11,47,44,3,44
Adelaide Utd,2816,5,11,6,11,37,40,-3,39
Brisbane,2816,6,10,5,13,33,42,-9,35
Western Sydn,2816,7,8,9,10,38,47,-9,33
Perth Glory,2816,8,10,2,15,37,50,-13,32
Wellington P,2816,9,5,6,16,31,55,-24,21
CC Mariners,2816,10,4,8,15,28,49,-21,20
Sydney FC,2817,1,21,4,3,68,23,45,67
N'castle Jet,2817,2,15,5,8,57,39,18,50
Melbourne C,2817,3,15,4,10,45,33,12,49
Melbourne V,2817,4,13,5,11,46,42,4,44
Adelaide Utd,2817,5,11,6,11,37,40,-3,39
Brisbane,2817,6,10,5,13,33,42,-9,35
Western Sydn,2817,7,8,9,10,38,47,-9,33
Perth Glory,2817,8,10,2,15,37,50,-13,32
Wellington P,2817,9,5,6,16,31,55,-24,21
CC Mariners,2817,10,4,8,15,28,49,-21,20
Sydney FC,2818,1,20,4,4,64,24,40,64
N'castle Jet,2818,2,16,5,7,62,38,24,53
Melbourne V,2818,3,14,5,10,47,38,9,47
Melbourne C,2818,4,14,4,11,44,38,6,46
Adelaide Utd,2818,5,11,6,11,37,40,-3,39
Brisbane,2818,6,10,5,13,33,42,-9,35
Western Sydn,2818,7,8,9,10,38,47,-9,33
Perth Glory,2818,8,10,2,15,37,50,-13,32
Wellington P,2818,9,5,6,16,31,55,-24,21
CC Mariners,2818,10,4,8,15,28,49,-21,20
Sydney FC,2819,1,20,5,3,67,25,42,65
N'castle Jet,2819,2,15,5,8,57,38,19,50
Melbourne C,2819,3,15,4,10,44,33,11,49
Melbourne V,2819,4,13,6,10,48,41,7,45
Adelaide Utd,2819,5,11,6,11,37,40,-3,39
Brisbane,2819,6,10,5,13,33,42,-9,35
Western Sydn,2819,7,8,9,10,38,47,-9,33
Perth Glory,2819,8,10,2,15,37,50,-13,32
Wellington P,2819,9,5,6,16,31,55,-24,21
CC Mariners,2819,10,4,8,15,28,49,-21,20
Sydney FC,2820,1,21,4,3,70,23,47,67
N'castle Jet,2820,2,15,5,8,57,38,19,50
Melbourne C,2820,3,15,4,10,44,33,11,49
Melbourne V,2820,4,13,5,11,46,44,2,44
Adelaide Utd,2820,5,11,6,11,37,40,-3,39
Brisbane,2820,6,10,5,13,33,42,-9,35
Western Sydn,2820,7,8,9,10,38,47,-9,33
Perth Glory,2820,8,10,2,15,37,50,-13,32
Wellington P,2820,9,5,6,16,31,55,-24,21
CC Mariners,2820,10,4,8,15,28,49,-21,20
Sydney FC,2821,1,21,4,3,67,22,45,67
N'castle Jet,2821,2,15,5,8,57,38,19,50
Melbourne C,2821,3,15,4,10,44,33,11,49
Melbourne V,2821,4,13,5,11,45,41,4,44
Adelaide Utd,2821,5,11,6,11,37,40,-3,39
Brisbane,2821,6,10,5,13,33,42,-9,35
Western Sydn,2821,7,8,9,10,38,47,-9,33
Perth Glory,2821,8,10,2,15,37,50,-13,32
Wellington P,2821,9,5,6,16,31,55,-24,21
CC Mariners,2821,10,4,8,15,28,49,-21,20
Sydney FC,2822,1,20,4,4,65,25,40,64
N'castle Jet,2822,2,16,5,7,58,37,21,53
Melbourne V,2822,3,14,5,10,48,39,9,47
Melbourne C,2822,4,14,4,11,43,34,9,46
Adelaide Utd,2822,5,11,6,11,37,40,-3,39
Brisbane,2822,6,10,5,13,33,42,-9,35
Western Sydn,2822,7,8,9,10,38,47,-9,33
Perth Glory,2822,8,10,2,15,37,50,-13,32
Wellington P,2822,9,5,6,16,31,55,-24,21
CC Mariners,2822,10,4,8,15,28,49,-21,20
Sydney FC,2823,1,21,4,3,68,23,45,67
N'castle Jet,2823,2,15,5,8,58,39,19,50
Melbourne C,2823,3,15,4,10,45,34,11,49
Melbourne V,2823,4,13,5,11,46,42,4,44
Adelaide Utd,2823,5,11,6,11,37,40,-3,39
Brisbane,2823,6,10,5,13,33,42,-9,35
Western Sydn,2823,7,8,9,10,38,47,-9,33
Perth Glory,2823,8,10,2,15,37,50,-13,32
Wellington P,2823,9,5,6,16,31,55,-24,21
CC Mariners,2823,10,4,8,15,28,49,-21,20
Sydney FC,2824,1,21,4,3,65,22,43,67
N'castle Jet,2824,2,15,5,8,58,39,19,50
Melbourne C,2824,3,15,4,10,45,34,11,49
Melbourne V,2824,4,13,5,11,45,39,6,44
Adelaide Utd,2824,5,11,6,11,37,40,-3,39
Brisbane,2824,6,10,5,13,33,42,-9,35
Western Sydn,2824,7,8,9,10,38,47,-9,33
Perth Glory,2824,8,10,2,15,37,50,-13,32
Wellington P,2824,9,5,6,16,31,55,-24,21
CC Mariners,2824,10,4,8,15,28,49,-21,20
Sydney FC,2825,1,20,5,3,66,24,42,65
N'castle Jet,2825,2,16,5,7,58,37,21,53
Melbourne C,2825,3,14,4,11,43,34,9,46
Melbourne V,2825,4,13,6,10,47,40,7,45
Adelaide Utd,2825,5,11,6,11,37,40,-3,39
Brisbane,2825,6,10,5,13,33,42,-9,35
Western Sydn,2825,7,8,9,10,38,47,-9,33
Perth Glory,2825,8,10,2,15,37,50,-13,32
Wellington P,2825,9,5,6,16,31,55,-24,21
CC Mariners,2825,10,4,8,15,28,49,-21,20
Sydney FC,2826,1,20,5,3,65,23,42,65
N'castle Jet,2826,2,16,5,7,59,38,21,53
Melbourne C,2826,3,14,4,11,44,35,9,46
Melbourne V,2826,4,13,6,10,46,39,7,45
Adelaide Utd,2826,5,11,6,11,37,40,-3,39
Brisbane,2826,6,10,5,13,33,42,-9,35
Western Sydn,2826,7,8,9,10,38,47,-9,33
Perth Glory,2826,8,10,2,15,37,50,-13,32
Wellington P,2826,9,5,6,16,31,55,-24,21
CC Mariners,2826,10,4,8,15,28,49,-21,20
Sydney FC,2827,1,21,4,3,66,22,44,67
N'castle Jet,2827,2,15,6,7,59,39,20,51
Melbourne C,2827,3,14,5,10,45,35,10,47
Melbourne V,2827,4,13,5,11,45,40,5,44
Adelaide Utd,2827,5,11,6,11,37,40,-3,39
Brisbane,2827,6,10,5,13,33,42,-9,35
Western Sydn,2827,7,8,9,10,38,47,-9,33
Perth Glory,2827,8,10,2,15,37,50,-13,32
Wellington P,2827,9,5,6,16,31,55,-24,21
CC Mariners,2827,10,4,8,15,28,49,-21,20
Sydney FC,2828,1,20,5,3,64,22,42,65
N'castle Jet,2828,2,15,6,7,58,38,20,51
Melbourne C,2828,3,14,5,10,44,34,10,47
Melbourne V,2828,4,13,6,10,45,38,7,45
Adelaide Utd,2828,5,11,6,11,37,40,-3,39
Brisbane,2828,6,10,5,13,33,42,-9,35
Western Sydn,2828,7,8,9,10,38,47,-9,33
Perth Glory,2828,8,10,2,15,37,50,-13,32
Wellington P,2828,9,5,6,16,31,55,-24,21
CC Mariners,2828,10,4,8,15,28,49,-21,20
Sydney FC,2829,1,20,4,4,66,25,41,64
N'castle Jet,2829,2,16,5,7,62,39,23,53
Melbourne V,2829,3,14,5,10,48,40,8,47
Melbourne C,2829,4,14,4,11,45,38,7,46
Adelaide Utd,2829,5,11,6,11,37,40,-3,39
Brisbane,2829,6,10,5,13,33,42,-9,35
Western Sydn,2829,7,8,9,10,38,47,-9,33
Perth Glory,2829,8,10,2,15,37,50,-13,32
Wellington P,2829,9,5,6,16,31,55,-24,21
CC Mariners,2829,10,4,8,15,28,49,-21,20
Sydney FC,2830,1,21,4,3,66,22,44,67
N'castle Jet,2830,2,16,5,7,62,39,23,53
Melbourne C,2830,3,14,4,11,45,38,7,46
Melbourne V,2830,4,13,5,11,45,40,5,44
Adelaide Utd,2830,5,11,6,11,37,40,-3,39
Brisbane,2830,6,10,5,13,33,42,-9,35
Western Sydn,2830,7,8,9,10,38,47,-9,33
Perth Glory,2830,8,10,2,15,37,50,-13,32
Wellington P,2830,9,5,6,16,31,55,-24,21
CC Mariners,2830,10,4,8,15,28,49,-21,20
Sydney FC,2831,1,20,4,4,65,24,41,64
N'castle Jet,2831,2,16,5,7,64,39,25,53
Melbourne V,2831,3,14,5,10,47,39,8,47
Melbourne C,2831,4,14,4,11,45,40,5,46
Adelaide Utd,2831,5,11,6,11,37,40,-3,39
Brisbane,2831,6,10,5,13,33,42,-9,35
Western Sydn,2831,7,8,9,10,38,47,-9,33
Perth Glory,2831,8,10,2,15,37,50,-13,32
Wellington P,2831,9,5,6,16,31,55,-24,21
CC Mariners,2831,10,4,8,15,28,49,-21,20
Sydney FC,2832,1,21,4,3,67,24,43,67
N'castle Jet,2832,2,16,5,7,60,37,23,53
Melbourne C,2832,3,14,4,11,43,36,7,46
Melbourne V,2832,4,13,5,11,47,41,6,44
Adelaide Utd,2832,5,11,6,11,37,40,-3,39
Brisbane,2832,6,10,5,13,33,42,-9,35
Western Sydn,2832,7,8,9,10,38,47,-9,33
Perth Glory,2832,8,10,2,15,37,50,-13,32
Wellington P,2832,9,5,6,16,31,55,-24,21
CC Mariners,2832,10,4,8,15,28,49,-21,20
Sydney FC,2833,1,21,4,3,65,22,43,67
N'castle Jet,2833,2,16,5,7,60,39,21,53
Melbourne C,2833,3,14,4,11,45,36,9,46
Melbourne V,2833,4,13,5,11,45,39,6,44
Adelaide Utd,2833,5,11,6,11,37,40,-3,39
Brisbane,2833,6,10,5,13,33,42,-9,35
Western Sydn,2833,7,8,9,10,38,47,-9,33
Perth Glory,2833,8,10,2,15,37,50,-13,32
Wellington P,2833,9,5,6,16,31,55,-24,21
CC Mariners,2833,10,4,8,15,28,49,-21,20
Sydney FC,2834,1,20,4,4,66,25,41,64
N'castle Jet,2834,2,15,6,7,58,38,20,51
Melbourne C,2834,3,14,5,10,44,34,10,47
Melbourne V,2834,4,14,5,10,48,40,8,47
Adelaide Utd,2834,5,11,6,11,37,40,-3,39
Brisbane,2834,6,10,5,13,33,42,-9,35
Western Sydn,2834,7,8,9,10,38,47,-9,33
Perth Glory,2834,8,10,2,15,37,50,-13,32
Wellington P,2834,9,5,6,16,31,55,-24,21
CC Mariners,2834,10,4,8,15,28,49,-21,20
Sydney FC,2835,1,21,4,3,66,22,44,67
N'castle Jet,2835,2,16,5,7,59,38,21,53
Melbourne C,2835,3,14,4,11,44,35,9,46
Melbourne V,2835,4,13,5,11,45,40,5,44
Adelaide Utd,2835,5,11,6,11,37,40,-3,39
Brisbane,2835,6,10,5,13,33,42,-9,35
Western Sydn,2835,7,8,9,10,38,47,-9,33
Perth Glory,2835,8,10,2,15,37,50,-13,32
Wellington P,2835,9,5,6,16,31,55,-24,21
CC Mariners,2835,10,4,8,15,28,49,-21,20
Sydney FC,2836,1,20,4,4,66,25,41,64
N'castle Jet,2836,2,15,5,8,58,39,19,50
Melbourne C,2836,3,15,4,10,45,34,11,49
Melbourne V,2836,4,14,5,10,48,40,8,47
Adelaide Utd,2836,5,11,6,11,37,40,-3,39
Brisbane,2836,6,10,5,13,33,42,-9,35
Western Sydn,2836,7,8,9,10,38,47,-9,33
Perth Glory,2836,8,10,2,15,37,50,-13,32
Wellington P,2836,9,5,6,16,31,55,-24,21
CC Mariners,2836,10,4,8,15,28,49,-21,20
Sydney FC,2837,1,20,4,4,66,25,41,64
N'castle Jet,2837,2,15,6,7,59,39,20,51
Melbourne C,2837,3,14,5,10,45,35,10,47
Melbourne V,2837,4,14,5,10,48,40,8,47
Adelaide Utd,2837,5,11,6,11,37,40,-3,39
Brisbane,2837,6,10,5,13,33,42,-9,35
Western Sydn,2837,7,8,9,10,38,47,-9,33
Perth Glory,2837,8,10,2,15,37,50,-13,32
Wellington P,2837,9,5,6,16,31,55,-24,21
CC Mariners,2837,10,4,8,15,28,49,-21,20
Sydney FC,2838,1,20,5,3,65,23,42,65
N'castle Jet,2838,2,15,5,8,58,39,19,50
Melbourne C,2838,3,15,4,10,45,34,11,49
Melbourne V,2838,4,13,6,10,46,39,7,45
Adelaide Utd,2838,5,11,6,11,37,40,-3,39
Brisbane,2838,6,10,5,13,33,42,-9,35
Western Sydn,2838,7,8,9,10,38,47,-9,33
Perth Glory,2838,8,10,2,15,37,50,-13,32
Wellington P,2838,9,5,6,16,31,55,-24,21
CC Mariners,2838,10,4,8,15,28,49,-21,20
Sydney FC,2839,1,21,4,3,65,22,43,67
N'castle Jet,2839,2,15,6,7,58,38,20,51
Melbourne C,2839,3,14,5,10,44,34,10,47
Melbourne V,2839,4,13,5,11,45,39,6,44
Adelaide Utd,2839,5,11,6,11,37,40,-3,39
Brisbane,2839,6,10,5,13,33,42,-9,35
Western Sydn,2839,7,8,9,10,38,47,-9,33
Perth Glory,2839,8,10,2,15,37,50,-13,32
Wellington P,2839,9,5,6,16,31,55,-24,21
CC Mariners,2839,10,4,8,15,28,49,-21,20
Sydney FC,2840,1,21,4,3,66,22,44,67
N'castle Jet,2840,2,15,6,7,60,40,20,51
Melbourne C,2840,3,14,5,10,46,36,10,47
Melbourne V,2840,4,13,5,11,45,40,5,44
Adelaide Utd,2840,5,11,6,11,37,40,-3,39
Brisbane,2840,6,10,5,13,33,42,-9,35
Western Sydn,2840,7,8,9,10,38,47,-9,33
Perth Glory,2840,8,10,2,15,37,50,-13,32
Wellington P,2840,9,5,6,16,31,55,-24,21
CC Mariners,2840,10,4,8,15,28,49,-21,20
Sydney FC,2841,1,21,4,3,66,22,44,67
N'castle Jet,2841,2,16,5,7,63,37,26,53
Melbourne C,2841,3,14,4,11,43,39,4,46
Melbourne V,2841,4,13,5,11,45,40,5,44
Adelaide Utd,2841,5,11,6,11,37,40,-3,39
Brisbane,2841,6,10,5,13,33,42,-9,35
Western Sydn,2841,7,8,9,10,38,47,-9,33
Perth Glory,2841,8,10,2,15,37,50,-13,32
Wellington P,2841,9,5,6,16,31,55,-24,21
CC Mariners,2841,10,4,8,15,28,49,-21,20
Sydney FC,2842,1,20,4,4,65,25,40,64
N'castle Jet,2842,2,16,5,7,59,38,21,53
Melbourne V,2842,3,14,5,10,48,39,9,47
Melbourne C,2842,4,14,4,11,44,35,9,46
Adelaide Utd,2842,5,11,6,11,37,40,-3,39
Brisbane,2842,6,10,5,13,33,42,-9,35
Western Sydn,2842,7,8,9,10,38,47,-9,33
Perth Glory,2842,8,10,2,15,37,50,-13,32
Wellington P,2842,9,5,6,16,31,55,-24,21
CC Mariners,2842,10,4,8,15,28,49,-21,20
Sydney FC,2843,1,21,4,3,67,23,44,67
N'castle Jet,2843,2,15,5,8,58,39,19,50
Melbourne C,2843,3,15,4,10,45,34,11,49
Melbourne V,2843,4,13,5,11,46,41,5,44
Adelaide Utd,2843,5,11,6,11,37,40,-3,39
Brisbane,2843,6,10,5,13,33,42,-9,35
Western Sydn,2843,7,8,9,10,38,47,-9,33
Perth Glory,2843,8,10,2,15,37,50,-13,32
Wellington P,2843,9,5,6,16,31,55,-24,21
CC Mariners,2843,10,4,8,15,28,49,-21,20
Sydney FC,2844,1,21,4,3,67,23,44,67
N'castle Jet,2844,2,16,5,7,60,37,23,53
Melbourne C,2844,3,14,4,11,43,36,7,46
Melbourne V,2844,4,13,5,11,46,41,5,44
Adelaide Utd,2844,5,11,6,11,37,40,-3,39
Brisbane,2844,6,10,5,13,33,42,-9,35
Western Sydn,2844,7,8,9,10,38,47,-9,33
Perth Glory,2844,8,10,2,15,37,50,-13,32
Wellington P,2844,9,5,6,16,31,55,-24,21
CC Mariners,2844,10,4,8,15,28,49,-21,20
Sydney FC,2845,1,21,4,3,67,22,45,67
N'castle Jet,2845,2,16,5,7,60,38,22,53
Melbourne C,2845,3,14,4,11,44,36,8,46
Melbourne V,2845,4,13,5,11,45,41,4,44
Adelaide Utd,2845,5,11,6,11,37,40,-3,39
Brisbane,2845,6,10,5,13,33,42,-9,35
Western Sydn,2845,7,8,9,10,38,47,-9,33
Perth Glory,2845,8,10,2,15,37,50,-13,32
Wellington P,2845,9,5,6,16,31,55,-24,21
CC Mariners,2845,10,4,8,15,28,49,-21,20
Sydney FC,2846,1,20,4,4,65,25,40,64
N'castle Jet,2846,2,16,5,7,60,37,23,53
Melbourne V,2846,3,14,5,10,48,39,9,47
Melbourne C,2846,4,14,4,11,43,36,7,46
Adelaide Utd,2846,5,11,6,11,37,40,-3,39
Brisbane,2846,6,10,5,13,33,42,-9,35
Western Sydn,2846,7,8,9,10,38,47,-9,33
Perth Glory,2846,8,10,2,15,37,50,-13,32
Wellington P,2846,9,5,6,16,31,55,-24,21
CC Mariners,2846,10,4,8,15,28,49,-21,20
Sydney FC,2847,1,20,5,3,67,25,42,65
N'castle Jet,2847,2,15,6,7,58,38,20,51
Melbourne C,2847,3,14,5,10,44,34,10,47
Melbourne V,2847,4,13,6,10,48,41,7,45
Adelaide Utd,2847,5,11,6,11,37,40,-3,39
Brisbane,2847,6,10,5,13,33,42,-9,35
Western Sydn,2847,7,8,9,10,38,47,-9,33
Perth Glory,2847,8,10,2,15,37,50,-13,32
Wellington P,2847,9,5,6,16,31,55,-24,21
CC Mariners,2847,10,4,8,15,28,49,-21,20
Sydney FC,2848,1,21,4,3,66,23,43,67
N'castle Jet,2848,2,16,5,7,63,41,22,53
Melbourne C,2848,3,14,4,11,47,39,8,46
Melbourne V,2848,4,13,5,11,46,40,6,44
Adelaide Utd,2848,5,11,6,11,37,40,-3,39
Brisbane,2848,6,10,5,13,33,42,-9,35
Western Sydn,2848,7,8,9,10,38,47,-9,33
Perth Glory,2848,8,10,2,15,37,50,-13,32
Wellington P,2848,9,5,6,16,31,55,-24,21
CC Mariners,2848,10,4,8,15,28,49,-21,20
Sydney FC,2849,1,21,4,3,65,22,43,67
N'castle Jet,2849,2,15,5,8,60,41,19,50
Melbourne C,2849,3,15,4,10,47,36,11,49
Melbourne V,2849,4,13,5,11,45,39,6,44
Adelaide Utd,2849,5,11,6,11,37,40,-3,39
Brisbane,2849,6,10,5,13,33,42,-9,35
Western Sydn,2849,7,8,9,10,38,47,-9,33
Perth Glory,2849,8,10,2,15,37,50,-13,32
Wellington P,2849,9,5,6,16,31,55,-24,21
CC Mariners,2849,10,4,8,15,28,49,-21,20
Sydney FC,2850,1,21,4,3,66,23,43,67
N'castle Jet,2850,2,16,5,7,59,37,22,53
Melbourne C,2850,3,14,4,11,43,35,8,46
Melbourne V,2850,4,13,5,11,46,40,6,44
Adelaide Utd,2850,5,11,6,11,37,40,-3,39
Brisbane,2850,6,10,5,13,33,42,-9,35
Western Sydn,2850,7,8,9,10,38,47,-9,33
Perth Glory,2850,8,10,2,15,37,50,-13,32
Wellington P,2850,9,5,6,16,31,55,-24,21
CC Mariners,2850,10,4,8,15,28,49,-21,20
Sydney FC,2851,1,21,4,3,67,22,45,67
N'castle Jet,2851,2,16,5,7,62,37,25,53
Melbourne C,2851,3,14,4,11,43,38,5,46
Melbourne V,2851,4,13,5,11,45,41,4,44
Adelaide Utd,2851,5,11,6,11,37,40,-3,39
Brisbane,2851,6,10,5,13,33,42,-9,35
Western Sydn,2851,7,8,9,10,38,47,-9,33
Perth Glory,2851,8,10,2,15,37,50,-13,32
Wellington P,2851,9,5,6,16,31,55,-24,21
CC Mariners,2851,10,4,8,15,28,49,-21,20
Sydney FC,2852,1,21,4,3,72,23,49,67
N'castle Jet,2852,2,16,5,7,62,38,24,53
Melbourne C,2852,3,14,4,11,44,38,6,46
Melbourne V,2852,4,13,5,11,46,46,0,44
Adelaide Utd,2852,5,11,6,11,37,40,-3,39
Brisbane,2852,6,10,5,13,33,42,-9,35
Western Sydn,2852,7,8,9,10,38,47,-9,33
Perth Glory,2852,8,10,2,15,37,50,-13,32
Wellington P,2852,9,5,6,16,31,55,-24,21
CC Mariners,2852,10,4,8,15,28,49,-21,20
Sydney FC,2853,1,21,4,3,66,22,44,67
N'castle Jet,2853,2,16,5,7,61,38,23,53
Melbourne C,2853,3,14,4,11,44,37,7,46
Melbourne V,2853,4,13,5,11,45,40,5,44
Adelaide Utd,2853,5,11,6,11,37,40,-3,39
Brisbane,2853,6,10,5,13,33,42,-9,35
Western Sydn,2853,7,8,9,10,38,47,-9,33
Perth Glory,2853,8,10,2,15,37,50,-13,32
Wellington P,2853,9,5,6,16,31,55,-24,21
CC Mariners,2853,10,4,8,15,28,49,-21,20
Sydney FC,2854,1,20,5,3,65,23,42,65
N'castle Jet,2854,2,15,5,8,57,38,19,50
Melbourne C,2854,3,15,4,10,44,33,11,49
Melbourne V,2854,4,13,6,10,46,39,7,45
Adelaide Utd,2854,5,11,6,11,37,40,-3,39
Brisbane,2854,6,10,5,13,33,42,-9,35
Western Sydn,2854,7,8,9,10,38,47,-9,33
Perth Glory,2854,8,10,2,15,37,50,-13,32
Wellington P,2854,9,5,6,16,31,55,-24,21
CC Mariners,2854,10,4,8,15,28,49,-21,20
Sydney FC,2855,1,21,4,3,68,22,46,67
N'castle Jet,2855,2,16,5,7,61,40,21,53
Melbourne C,2855,3,14,4,11,46,37,9,46
Melbourne V,2855,4,13,5,11,45,42,3,44
Adelaide Utd,2855,5,11,6,11,37,40,-3,39
Brisbane,2855,6,10,5,13,33,42,-9,35
Western Sydn,2855,7,8,9,10,38,47,-9,33
Perth Glory,2855,8,10,2,15,37,50,-13,32
Wellington P,2855,9,5,6,16,31,55,-24,21
CC Mariners,2855,10,4,8,15,28,49,-21,20
Sydney FC,2856,1,21,4,3,68,24,44,67
N'castle Jet,2856,2,15,5,8,58,39,19,50
Melbourne C,2856,3,15,4,10,45,34,11,49
Melbourne V,2856,4,13,5,11,47,42,5,44
Adelaide Utd,2856,5,11,6,11,37,40,-3,39
Brisbane,2856,6,10,5,13,33,42,-9,35
Western Sydn,2856,7,8,9,10,38,47,-9,33
Perth Glory,2856,8,10,2,15,37,50,-13,32
Wellington P,2856,9,5,6,16,31,55,-24,21
CC Mariners,2856,10,4,8,15,28,49,-21,20
Sydney FC,2857,1,20,4,4,64,23,41,64
N'castle Jet,2857,2,16,5,7,58,37,21,53
Melbourne V,2857,3,14,5,10,46,38,8,47
Melbourne C,2857,4,14,4,11,43,34,9,46
Adelaide Utd,2857,5,11,6,11,37,40,-3,39
Brisbane,2857,6,10,5,13,33,42,-9,35
Western Sydn,2857,7,8,9,10,38,47,-9,33
Perth Glory,2857,8,10,2,15,37,50,-13,32
Wellington P,2857,9,5,6,16,31,55,-24,21
CC Mariners,2857,10,4,8,15,28,49,-21,20
Sydney FC,2858,1,20,5,3,66,24,42,65
N'castle Jet,2858,2,16,5,7,61,39,22,53
Melbourne C,2858,3,14,4,11,45,37,8,46
Melbourne V,2858,4,13,6,10,47,40,7,45
Adelaide Utd,2858,5,11,6,11,37,40,-3,39
Brisbane,2858,6,10,5,13,33,42,-9,35
Western Sydn,2858,7,8,9,10,38,47,-9,33
Perth Glory,2858,8,10,2,15,37,50,-13,32
Wellington P,2858,9,5,6,16,31,55,-24,21
CC Mariners,2858,10,4,8,15,28,49,-21,20
Sydney FC,2859,1,21,4,3,67,23,44,67
N'castle Jet,2859,2,15,6,7,59,39,20,51
Melbourne C,2859,3,14,5,10,45,35,10,47
Melbourne V,2859,4,13,5,11,46,41,5,44
Adelaide Utd,2859,5,11,6,11,37,40,-3,39
Brisbane,2859,6,10,5,13,33,42,-9,35
Western Sydn,2859,7,8,9,10,38,47,-9,33
Perth Glory,2859,8,10,2,15,37,50,-13,32
Wellington P,2859,9,5,6,16,31,55,-24,21
CC Mariners,2859,10,4,8,15,28,49,-21,20
Sydney FC,2860,1,21,4,3,68,23,45,67
N'castle Jet,2860,2,16,5,7,59,37,22,53
Melbourne C,2860,3,14,4,11,43,35,8,46
Melbourne V,2860,4,13,5,11,46,42,4,44
Adelaide Utd,2860,5,11,6,11,37,40,-3,39
Brisbane,2860,6,10,5,13,33,42,-9,35
Western Sydn,2860,7,8,9,10,38,47,-9,33
Perth Glory,2860,8,10,2,15,37,50,-13,32
Wellington P,2860,9,5,6,16,31,55,-24,21
CC Mariners,2860,10,4,8,15,28,49,-21,20
Sydney FC,2861,1,21,4,3,67,22,45,67
N'castle Jet,2861,2,15,5,8,59,41,18,50
Melbourne C,2861,3,15,4,10,47,35,12,49
Melbourne V,2861,4,13,5,11,45,41,4,44
Adelaide Utd,2861,5,11,6,11,37,40,-3,39
Brisbane,2861,6,10,5,13,33,42,-9,35
Western Sydn,2861,7,8,9,10,38,47,-9,33
Perth Glory,2861,8,10,2,15,37,50,-13,32
Wellington P,2861,9,5,6,16,31,55,-24,21
CC Mariners,2861,10,4,8,15,28,49,-21,20
Sydney FC,2862,1,20,5,3,66,24,42,65
N'castle Jet,2862,2,16,5,7,59,37,22,53
Melbourne C,2862,3,14,4,11,43,35,8,46
Melbourne V,2862,4,13,6,10,47,40,7,45
Adelaide Utd,2862,5,11,6,11,37,40,-3,39
Brisbane,2862,6,10,5,13,33,42,-9,35
Western Sydn,2862,7,8,9,10,38,47,-9,33
Perth Glory,2862,8,10,2,15,37,50,-13,32
Wellington P,2862,9,5,6,16,31,55,-24,21
CC Mariners,2862,10,4,8,15,28,49,-21,20
Sydney FC,2863,1,20,4,4,64,23,41,64
N'castle Jet,2863,2,16,5,7,61,38,23,53
Melbourne V,2863,3,14,5,10,46,38,8,47
Melbourne C,2863,4,14,4,11,44,37,7,46
Adelaide Utd,2863,5,11,6,11,37,40,-3,39
Brisbane,2863,6,10,5,13,33,42,-9,35
Western Sydn,2863,7,8,9,10,38,47,-9,33
Perth Glory,2863,8,10,2,15,37,50,-13,32
Wellington P,2863,9,5,6,16,31,55,-24,21
CC Mariners,2863,10,4,8,15,28,49,-21,20
Sydney FC,2864,1,20,5,3,66,24,42,65
N'castle Jet,2864,2,15,6,7,57,37,20,51
Melbourne C,2864,3,14,5,10,43,33,10,47
Melbourne V,2864,4,13,6,10,47,40,7,45
Adelaide Utd,2864,5,11,6,11,37,40,-3,39
Brisbane,2864,6,10,5,13,33,42,-9,35
Western Sydn,2864,7,8,9,10,38,47,-9,33
Perth Glory,2864,8,10,2,15,37,50,-13,32
Wellington P,2864,9,5,6,16,31,55,-24,21
CC Mariners,2864,10,4,8,15,28,49,-21,20
Sydney FC,2865,1,20,5,3,66,24,42,65
N'castle Jet,2865,2,15,5,8,57,38,19,50
Melbourne C,2865,3,15,4,10,44,33,11,49
Melbourne V,2865,4,13,6,10,47,40,7,45
Adelaide Utd,2865,5,11,6,11,37,40,-3,39
Brisbane,2865,6,10,5,13,33,42,-9,35
Western Sydn,2865,7,8,9,10,38,47,-9,33
Perth Glory,2865,8,10,2,15,37,50,-13,32
Wellington P,2865,9,5,6,16,31,55,-24,21
CC Mariners,2865,10,4,8,15,28,49,-21,20
Sydney FC,2866,1,21,4,3,66,23,43,67
N'castle Jet,2866,2,16,5,7,60,39,21,53
Melbourne C,2866,3,14,4,11,45,36,9,46
Melbourne V,2866,4,13,5,11,46,40,6,44
Adelaide Utd,2866,5,11,6,11,37,40,-3,39
Brisbane,2866,6,10,5,13,33,42,-9,35
Western Sydn,2866,7,8,9,10,38,47,-9,33
Perth Glory,2866,8,10,2,15,37,50,-13,32
Wellington P,2866,9,5,6,16,31,55,-24,21
CC Mariners,2866,10,4,8,15,28,49,-21,20
Sydney FC,2867,1,20,5,3,65,23,42,65
N'castle Jet,2867,2,16,5,7,58,37,21,53
Melbourne C,2867,3,14,4,11,43,34,9,46
Melbourne V,2867,4,13,6,10,46,39,7,45
Adelaide Utd,2867,5,11,6,11,37,40,-3,39
Brisbane,2867,6,10,5,13,33,42,-9,35
Western Sydn,2867,7,8,9,10,38,47,-9,33
Perth Glory,2867,8,10,2,15,37,50,-13,32
Wellington P,2867,9,5,6,16,31,55,-24,21
CC Mariners,2867,10,4,8,15,28,49,-21,20
Sydney FC,2868,1,20,5,3,65,23,42,65
N'castle Jet,2868,2,16,5,7,59,38,21,53
Melbourne C,2868,3,14,4,11,44,35,9,46
Melbourne V,2868,4,13,6,10,46,39,7,45
Adelaide Utd,2868,5,11,6,11,37,40,-3,39
Brisbane,2868,6,10,5,13,33,42,-9,35
Western Sydn,2868,7,8,9,10,38,47,-9,33
Perth Glory,2868,8,10,2,15,37,50,-13,32
Wellington P,2868,9,5,6,16,31,55,-24,21
CC Mariners,2868,10,4,8,15,28,49,-21,20
Sydney FC,2869,1,21,4,3,68,24,44,67
N'castle Jet,2869,2,16,5,7,59,38,21,53
Melbourne C,2869,3,14,4,11,44,35,9,46
Melbourne V,2869,4,13,5,11,47,42,5,44
Adelaide Utd,2869,5,11,6,11,37,40,-3,39
Brisbane,2869,6,10,5,13,33,42,-9,35
Western Sydn,2869,7,8,9,10,38,47,-9,33
Perth Glory,2869,8,10,2,15,37,50,-13,32
Wellington P,2869,9,5,6,16,31,55,-24,21
CC Mariners,2869,10,4,8,15,28,49,-21,20
Sydney FC,2870,1,21,4,3,67,22,45,67
N'castle Jet,2870,2,16,5,7,59,37,22,53
Melbourne C,2870,3,14,4,11,43,35,8,46
Melbourne V,2870,4,13,5,11,45,41,4,44
Adelaide Utd,2870,5,11,6,11,37,40,-3,39
Brisbane,2870,6,10,5,13,33,42,-9,35
Western Sydn,2870,7,8,9,10,38,47,-9,33
Perth Glory,2870,8,10,2,15,37,50,-13,32
Wellington P,2870,9,5,6,16,31,55,-24,21
CC Mariners,2870,10,4,8,15,28,49,-21,20
Sydney FC,2871,1,21,4,3,67,22,45,67
N'castle Jet,2871,2,15,5,8,59,40,19,50
Melbourne C,2871,3,15,4,10,46,35,11,49
Melbourne V,2871,4,13,5,11,45,41,4,44
Adelaide Utd,2871,5,11,6,11,37,40,-3,39
Brisbane,2871,6,10,5,13,33,42,-9,35
Western Sydn,2871,7,8,9,10,38,47,-9,33
Perth Glory,2871,8,10,2,15,37,50,-13,32
Wellington P,2871,9,5,6,16,31,55,-24,21
CC Mariners,2871,10,4,8,15,28,49,-21,20
Sydney FC,2872,1,21,4,3,66,23,43,67
N'castle Jet,2872,2,15,5,8,59,40,19,50
Melbourne C,2872,3,15,4,10,46,35,11,49
Melbourne V,2872,4,13,5,11,46,40,6,44
Adelaide Utd,2872,5,11,6,11,37,40,-3,39
Brisbane,2872,6,10,5,13,33,42,-9,35
Western Sydn,2872,7,8,9,10,38,47,-9,33
Perth Glory,2872,8,10,2,15,37,50,-13,32
Wellington P,2872,9,5,6,16,31,55,-24,21
CC Mariners,2872,10,4,8,15,28,49,-21,20
Sydney FC,2873,1,21,4,3,66,22,44,67
N'castle Jet,2873,2,15,5,8,58,41,17,50
Melbourne C,2873,3,15,4,10,47,34,13,49
Melbourne V,2873,4,13,5,11,45,40,5,44
Adelaide Utd,2873,5,11,6,11,37,40,-3,39
Brisbane,2873,6,10,5,13,33,42,-9,35
Western Sydn,2873,7,8,9,10,38,47,-9,33
Perth Glory,2873,8,10,2,15,37,50,-13,32
Wellington P,2873,9,5,6,16,31,55,-24,21
CC Mariners,2873,10,4,8,15,28,49,-21,20
Sydney FC,2874,1,21,4,3,67,22,45,67
N'castle Jet,2874,2,15,5,8,57,38,19,50
Melbourne C,2874,3,15,4,10,44,33,11,49
Melbourne V,2874,4,13,5,11,45,41,4,44
Adelaide Utd,2874,5,11,6,11,37,40,-3,39
Brisbane,2874,6,10,5,13,33,42,-9,35
Western Sydn,2874,7,8,9,10,38,47,-9,33
Perth Glory,2874,8,10,2,15,37,50,-13,32
Wellington P,2874,9,5,6,16,31,55,-24,21
CC Mariners,2874,10,4,8,15,28,49,-21,20
Sydney FC,2875,1,21,4,3,66,22,44,67
N'castle Jet,2875,2,16,5,7,60,39,21,53
Melbourne C,2875,3,14,4,11,45,36,9,46
Melbourne V,2875,4,13,5,11,45,40,5,44
Adelaide Utd,2875,5,11,6,11,37,40,-3,39
Brisbane,2875,6,10,5,13,33,42,-9,35
Western Sydn,2875,7,8,9,10,38,47,-9,33
Perth Glory,2875,8,10,2,15,37,50,-13,32
Wellington P,2875,9,5,6,16,31,55,-24,21
CC Mariners,2875,10,4,8,15,28,49,-21,20
Sydney FC,2876,1,20,5,3,65,23,42,65
N'castle Jet,2876,2,15,6,7,58,38,20,51
Melbourne C,2876,3,14,5,10,44,34,10,47
Melbourne V,2876,4,13,6,10,46,39,7,45
Adelaide Utd,2876,5,11,6,11,37,40,-3,39
Brisbane,2876,6,10,5,13,33,42,-9,35
Western Sydn,2876,7,8,9,10,38,47,-9,33
Perth Glory,2876,8,10,2,15,37,50,-13,32
Wellington P,2876,9,5,6,16,31,55,-24,21
CC Mariners,2876,10,4,8,15,28,49,-21,20
Sydney FC,2877,1,21,4,3,67,22,45,67
N'castle Jet,2877,2,16,5,7,59,38,21,53
Melbourne C,2877,3,14,4,11,44,35,9,46
Melbourne V,2877,4,13,5,11,45,41,4,44
Adelaide Utd,2877,5,11,6,11,37,40,-3,39
Brisbane,2877,6,10,5,13,33,42,-9,35
Western Sydn,2877,7,8,9,10,38,47,-9,33
Perth Glory,2877,8,10,2,15,37,50,-13,32
Wellington P,2877,9,5,6,16,31,55,-24,21
CC Mariners,2877,10,4,8,15,28,49,-21,20
Sydney FC,2878,1,21,4,3,65,22,43,67
N'castle Jet,2878,2,15,5,8,58,39,19,50
Melbourne C,2878,3,15,4,10,45,34,11,49
Melbourne V,2878,4,13,5,11,45,39,6,44
Adelaide Utd,2878,5,11,6,11,37,40,-3,39
Brisbane,2878,6,10,5,13,33,42,-9,35
Western Sydn,2878,7,8,9,10,38,47,-9,33
Perth Glory,2878,8,10,2,15,37,50,-13,32
Wellington P,2878,9,5,6,16,31,55,-24,21
CC Mariners,2878,10,4,8,15,28,49,-21,20
Sydney FC,2879,1,20,5,3,65,23,42,65
N'castle Jet,2879,2,15,6,7,59,39,20,51
Melbourne C,2879,3,14,5,10,45,35,10,47
Melbourne V,2879,4,13,6,10,46,39,7,45
Adelaide Utd,2879,5,11,6,11,37,40,-3,39
Brisbane,2879,6,10,5,13,33,42,-9,35
Western Sydn,2879,7,8,9,10,38,47,-9,33
Perth Glory,2879,8,10,2,15,37,50,-13,32
Wellington P,2879,9,5,6,16,31,55,-24,21
CC Mariners,2879,10,4,8,15,28,49,-21,20
Sydney FC,2880,1,20,4,4,65,25,40,64
N'castle Jet,2880,2,15,6,7,58,38,20,51
Melbourne C,2880,3,14,5,10,44,34,10,47
Melbourne V,2880,4,14,5,10,48,39,9,47
Adelaide Utd,2880,5,11,6,11,37,40,-3,39
Brisbane,2880,6,10,5,13,33,42,-9,35
Western Sydn,2880,7,8,9,10,38,47,-9,33
Perth Glory,2880,8,10,2,15,37,50,-13,32
Wellington P,2880,9,5,6,16,31,55,-24,21
CC Mariners,2880,10,4,8,15,28,49,-21,20
Sydney FC,2881,1,21,4,3,66,23,43,67
N'castle Jet,2881,2,15,6,7,57,37,20,51
Melbourne C,2881,3,14,5,10,43,33,10,47
Melbourne V,2881,4,13,5,11,46,40,6,44
Adelaide Utd,2881,5,11,6,11,37,40,-3,39
Brisbane,2881,6,10,5,13,33,42,-9,35
Western Sydn,2881,7,8,9,10,38,47,-9,33
Perth Glory,2881,8,10,2,15,37,50,-13,32
Wellington P,2881,9,5,6,16,31,55,-24,21
CC Mariners,2881,10,4,8,15,28,49,-21,20
Sydney FC,2882,1,21,4,3,66,22,44,67
N'castle Jet,2882,2,15,6,7,58,38,20,51
Melbourne C,2882,3,14,5,10,44,34,10,47
Melbourne V,2882,4,13,5,11,45,40,5,44
Adelaide Utd,2882,5,11,6,11,37,40,-3,39
Brisbane,2882,6,10,5,13,33,42,-9,35
Western Sydn,2882,7,8,9,10,38,47,-9,33
Perth Glory,2882,8,10,2,15,37,50,-13,32
Wellington P,2882,9,5,6,16,31,55,-24,21
CC Mariners,2882,10,4,8,15,28,49,-21,20
Sydney FC,2883,1,20,5,3,65,23,42,65
N'castle Jet,2883,2,15,5,8,58,40,18,50
Melbourne C,2883,3,15,4,10,46,34,12,49
Melbourne V,2883,4,13,6,10,46,39,7,45
Adelaide Utd,2883,5,11,6,11,37,40,-3,39
Brisbane,2883,6,10,5,13,33,42,-9,35
Western Sydn,2883,7,8,9,10,38,47,-9,33
Perth Glory,2883,8,10,2,15,37,50,-13,32
Wellington P,2883,9,5,6,16,31,55,-24,21
CC Mariners,2883,10,4,8,15,28,49,-21,20
Sydney FC,2884,1,21,4,3,66,23,43,67
N'castle Jet,2884,2,15,5,8,57,39,18,50
Melbourne C,2884,3,15,4,10,45,33,12,49
Melbourne V,2884,4,13,5,11,46,40,6,44
Adelaide Utd,2884,5,11,6,11,37,40,-3,39
Brisbane,2884,6,10,5,13,33,42,-9,35
Western Sydn,2884,7,8,9,10,38,47,-9,33
Perth Glory,2884,8,10,2,15,37,50,-13,32
Wellington P,2884,9,5,6,16,31,55,-24,21
CC Mariners,2884,10,4,8,15,28,49,-21,20
Sydney FC,2885,1,20,4,4,66,25,41,64
N'castle Jet,2885,2,15,5,8,58,41,17,50
Melbourne C,2885,3,15,4,10,47,34,13,49
Melbourne V,2885,4,14,5,10,48,40,8,47
Adelaide Utd,2885,5,11,6,11,37,40,-3,39
Brisbane,2885,6,10,5,13,33,42,-9,35
Western Sydn,2885,7,8,9,10,38,47,-9,33
Perth Glory,2885,8,10,2,15,37,50,-13,32
Wellington P,2885,9,5,6,16,31,55,-24,21
CC Mariners,2885,10,4,8,15,28,49,-21,20
Sydney FC,2886,1,20,4,4,65,24,41,64
N'castle Jet,2886,2,15,5,8,59,40,19,50
Melbourne C,2886,3,15,4,10,46,35,11,49
Melbourne V,2886,4,14,5,10,47,39,8,47
Adelaide Utd,2886,5,11,6,11,37,40,-3,39
Brisbane,2886,6,10,5,13,33,42,-9,35
Western Sydn,2886,7,8,9,10,38,47,-9,33
Perth Glory,2886,8,10,2,15,37,50,-13,32
Wellington P,2886,9,5,6,16,31,55,-24,21
CC Mariners,2886,10,4,8,15,28,49,-21,20
Sydney FC,2887,1,21,4,3,68,24,44,67
N'castle Jet,2887,2,16,5,7,59,38,21,53
Melbourne C,2887,3,14,4,11,44,35,9,46
Melbourne V,2887,4,13,5,11,47,42,5,44
Adelaide Utd,2887,5,11,6,11,37,40,-3,39
Brisbane,2887,6,10,5,13,33,42,-9,35
Western Sydn,2887,7,8,9,10,38,47,-9,33
Perth Glory,2887,8,10,2,15,37,50,-13,32
Wellington P,2887,9,5,6,16,31,55,-24,21
CC Mariners,2887,10,4,8,15,28,49,-21,20
Sydney FC,2888,1,20,4,4,65,25,40,64
N'castle Jet,2888,2,16,5,7,61,39,22,53
Melbourne V,2888,3,14,5,10,48,39,9,47
Melbourne C,2888,4,14,4,11,45,37,8,46
Adelaide Utd,2888,5,11,6,11,37,40,-3,39
Brisbane,2888,6,10,5,13,33,42,-9,35
Western Sydn,2888,7,8,9,10,38,47,-9,33
Perth Glory,2888,8,10,2,15,37,50,-13,32
Wellington P,2888,9,5,6,16,31,55,-24,21
CC Mariners,2888,10,4,8,15,28,49,-21,20
Sydney FC,2889,1,20,5,3,65,23,42,65
N'castle Jet,2889,2,15,5,8,57,40,17,50
Melbourne C,2889,3,15,4,10,46,33,13,49
Melbourne V,2889,4,13,6,10,46,39,7,45
Adelaide Utd,2889,5,11,6,11,37,40,-3,39
Brisbane,2889,6,10,5,13,33,42,-9,35
Western Sydn,2889,7,8,9,10,38,47,-9,33
Perth Glory,2889,8,10,2,15,37,50,-13,32
Wellington P,2889,9,5,6,16,31,55,-24,21
CC Mariners,2889,10,4,8,15,28,49,-21,20
Sydney FC,2890,1,20,4,4,65,24,41,64
N'castle Jet,2890,2,16,5,7,59,38,21,53
Melbourne V,2890,3,14,5,10,47,39,8,47
Melbourne C,2890,4,14,4,11,44,35,9,46
Adelaide Utd,2890,5,11,6,11,37,40,-3,39
Brisbane,2890,6,10,5,13,33,42,-9,35
Western Sydn,2890,7,8,9,10,38,47,-9,33
Perth Glory,2890,8,10,2,15,37,50,-13,32
Wellington P,2890,9,5,6,16,31,55,-24,21
CC Mariners,2890,10,4,8,15,28,49,-21,20
Sydney FC,2891,1,20,4,4,65,24,41,64
N'castle Jet,2891,2,15,5,8,58,39,19,50
Melbourne C,2891,3,15,4,10,45,34,11,49
Melbourne V,2891,4,14,5,10,47,39,8,47
Adelaide Utd,2891,5,11,6,11,37,40,-3,39
Brisbane,2891,6,10,5,13,33,42,-9,35
Western Sydn,2891,7,8,9,10,38,47,-9,33
Perth Glory,2891,8,10,2,15,37,50,-13,32
Wellington P,2891,9,5,6,16,31,55,-24,21
CC Mariners,2891,10,4,8,15,28,49,-21,20
Sydney FC,2892,1,21,4,3,65,22,43,67
N'castle Jet,2892,2,15,5,8,58,41,17,50
Melbourne C,2892,3,15,4,10,47,34,13,49
Melbourne V,2892,4,13,5,11,45,39,6,44
Adelaide Utd,2892,5,11,6,11,37,40,-3,39
Brisbane,2892,6,10,5,13,33,42,-9,35
Western Sydn,2892,7,8,9,10,38,47,-9,33
Perth Glory,2892,8,10,2,15,37,50,-13,32
Wellington P,2892,9,5,6,16,31,55,-24,21
CC Mariners,2892,10,4,8,15,28,49,-21,20
Sydney FC,2893,1,20,5,3,65,23,42,65
N'castle Jet,2893,2,16,5,7,59,38,21,53
Melbourne C,2893,3,14,4,11,44,35,9,46
Melbourne V,2893,4,13,6,10,46,39,7,45
Adelaide Utd,2893,5,11,6,11,37,40,-3,39
Brisbane,2893,6,10,5,13,33,42,-9,35
Western Sydn,2893,7,8,9,10,38,47,-9,33
Perth Glory,2893,8,10,2,15,37,50,-13,32
Wellington P,2893,9,5,6,16,31,55,-24,21
CC Mariners,2893,10,4,8,15,28,49,-21,20
Sydney FC,2894,1,20,5,3,64,22,42,65
N'castle Jet,2894,2,16,5,7,59,38,21,53
Melbourne C,2894,3,14,4,11,44,35,9,46
Melbourne V,2894,4,13,6,10,45,38,7,45
Adelaide Utd,2894,5,11,6,11,37,40,-3,39
Brisbane,2894,6,10,5,13,33,42,-9,35
Western Sydn,2894,7,8,9,10,38,47,-9,33
Perth Glory,2894,8,10,2,15,37,50,-13,32
Wellington P,2894,9,5,6,16,31,55,-24,21
CC Mariners,2894,10,4,8,15,28,49,-21,20
Sydney FC,2895,1,20,5,3,66,24,42,65
N'castle Jet,2895,2,16,5,7,59,37,22,53
Melbourne C,2895,3,14,4,11,43,35,8,46
Melbourne V,2895,4,13,6,10,47,40,7,45
Adelaide Utd,2895,5,11,6,11,37,40,-3,39
Brisbane,2895,6,10,5,13,33,42,-9,35
Western Sydn,2895,7,8,9,10,38,47,-9,33
Perth Glory,2895,8,10,2,15,37,50,-13,32
Wellington P,2895,9,5,6,16,31,55,-24,21
CC Mariners,2895,10,4,8,15,28,49,-21,20
Sydney FC,2896,1,20,4,4,64,23,41,64
N'castle Jet,2896,2,15,5,8,58,40,18,50
Melbourne C,2896,3,15,4,10,46,34,12,49
Melbourne V,2896,4,14,5,10,46,38,8,47
Adelaide Utd,2896,5,11,6,11,37,40,-3,39
Brisbane,2896,6,10,5,13,33,42,-9,35
Western Sydn,2896,7,8,9,10,38,47,-9,33
Perth Glory,2896,8,10,2,15,37,50,-13,32
Wellington P,2896,9,5,6,16,31,55,-24,21
CC Mariners,2896,10,4,8,15,28,49,-21,20
Sydney FC,2897,1,20,4,4,64,25,39,64
N'castle Jet,2897,2,15,5,8,58,41,17,50
Melbourne C,2897,3,15,4,10,47,34,13,49
Melbourne V,2897,4,14,5,10,48,38,10,47
Adelaide Utd,2897,5,11,6,11,37,40,-3,39
Brisbane,2897,6,10,5,13,33,42,-9,35
Western Sydn,2897,7,8,9,10,38,47,-9,33
Perth Glory,2897,8,10,2,15,37,50,-13,32
Wellington P,2897,9,5,6,16,31,55,-24,21
CC Mariners,2897,10,4,8,15,28,49,-21,20
Sydney FC,2898,1,21,4,3,66,22,44,67
N'castle Jet,2898,2,15,6,7,59,39,20,51
Melbourne C,2898,3,14,5,10,45,35,10,47
Melbourne V,2898,4,13,5,11,45,40,5,44
Adelaide Utd,2898,5,11,6,11,37,40,-3,39
Brisbane,2898,6,10,5,13,33,42,-9,35
Western Sydn,2898,7,8,9,10,38,47,-9,33
Perth Glory,2898,8,10,2,15,37,50,-13,32
Wellington P,2898,9,5,6,16,31,55,-24,21
CC Mariners,2898,10,4,8,15,28,49,-21,20
Sydney FC,2899,1,20,4,4,66,25,41,64
N'castle Jet,2899,2,16,5,7,60,39,21,53
Melbourne V,2899,3,14,5,10,48,40,8,47
Melbourne C,2899,4,14,4,11,45,36,9,46
Adelaide Utd,2899,5,11,6,11,37,40,-3,39
Brisbane,2899,6,10,5,13,33,42,-9,35
Western Sydn,2899,7,8,9,10,38,47,-9,33
Perth Glory,2899,8,10,2,15,37,50,-13,32
Wellington P,2899,9,5,6,16,31,55,-24,21
CC Mariners,2899,10,4,8,15,28,49,-21,20
Sydney FC,2900,1,21,4,3,66,22,44,67
N'castle Jet,2900,2,15,5,8,57,41,16,50
Melbourne C,2900,3,15,4,10,47,33,14,49
Melbourne V,2900,4,13,5,11,45,40,5,44
Adelaide Utd,2900,5,11,6,11,37,40,-3,39
Brisbane,2900,6,10,5,13,33,42,-9,35
Western Sydn,2900,7,8,9,10,38,47,-9,33
Perth Glory,2900,8,10,2,15,37,50,-13,32
Wellington P,2900,9,5,6,16,31,55,-24,21
CC Mariners,2900,10,4,8,15,28,49,-21,20
Sydney FC,2901,1,21,4,3,68,22,46,67
N'castle Jet,2901,2,15,5,8,59,42,17,50
Melbourne C,2901,3,15,4,10,48,35,13,49
Melbourne V,2901,4,13,5,11,45,42,3,44
Adelaide Utd,2901,5,11,6,11,37,40,-3,39
Brisbane,2901,6,10,5,13,33,42,-9,35
Western Sydn,2901,7,8,9,10,38,47,-9,33
Perth Glory,2901,8,10,2,15,37,50,-13,32
Wellington P,2901,9,5,6,16,31,55,-24,21
CC Mariners,2901,10,4,8,15,28,49,-21,20
Sydney FC,2902,1,21,4,3,66,22,44,67
N'castle Jet,2902,2,16,5,7,58,37,21,53
Melbourne C,2902,3,14,4,11,43,34,9,46
Melbourne V,2902,4,13,5,11,45,40,5,44
Adelaide Utd,2902,5,11,6,11,37,40,-3,39
Brisbane,2902,6,10,5,13,33,42,-9,35
Western Sydn,2902,7,8,9,10,38,47,-9,33
Perth Glory,2902,8,10,2,15,37,50,-13,32
Wellington P,2902,9,5,6,16,31,55,-24,21
CC Mariners,2902,10,4,8,15,28,49,-21,20
Sydney FC,2903,1,21,4,3,66,23,43,67
N'castle Jet,2903,2,16,5,7,60,38,22,53
Melbourne C,2903,3,14,4,11,44,36,8,46
Melbourne V,2903,4,13,5,11,46,40,6,44
Adelaide Utd,2903,5,11,6,11,37,40,-3,39
Brisbane,2903,6,10,5,13,33,42,-9,35
Western Sydn,2903,7,8,9,10,38,47,-9,33
Perth Glory,2903,8,10,2,15,37,50,-13,32
Wellington P,2903,9,5,6,16,31,55,-24,21
CC Mariners,2903,10,4,8,15,28,49,-21,20
Sydney FC,2904,1,21,4,3,66,23,43,67
N'castle Jet,2904,2,15,6,7,60,40,20,51
Melbourne C,2904,3,14,5,10,46,36,10,47
Melbourne V,2904,4,13,5,11,46,40,6,44
Adelaide Utd,2904,5,11,6,11,37,40,-3,39
Brisbane,2904,6,10,5,13,33,42,-9,35
Western Sydn,2904,7,8,9,10,38,47,-9,33
Perth Glory,2904,8,10,2,15,37,50,-13,32
Wellington P,2904,9,5,6,16,31,55,-24,21
CC Mariners,2904,10,4,8,15,28,49,-21,20
Sydney FC,2905,1,21,4,3,69,23,46,67
N'castle Jet,2905,2,16,5,7,60,38,22,53
Melbourne C,2905,3,14,4,11,44,36,8,46
Melbourne V,2905,4,13,5,11,46,43,3,44
Adelaide Utd,2905,5,11,6,11,37,40,-3,39
Brisbane,2905,6,10,5,13,33,42,-9,35
Western Sydn,2905,7,8,9,10,38,47,-9,33
Perth Glory,2905,8,10,2,15,37,50,-13,32
Wellington P,2905,9,5,6,16,31,55,-24,21
CC Mariners,2905,10,4,8,15,28,49,-21,20
Sydney FC,2906,1,21,4,3,68,22,46,67
N'castle Jet,2906,2,16,5,7,61,38,23,53
Melbourne C,2906,3,14,4,11,44,37,7,46
Melbourne V,2906,4,13,5,11,45,42,3,44
Adelaide Utd,2906,5,11,6,11,37,40,-3,39
Brisbane,2906,6,10,5,13,33,42,-9,35
Western Sydn,2906,7,8,9,10,38,47,-9,33
Perth Glory,2906,8,10,2,15,37,50,-13,32
Wellington P,2906,9,5,6,16,31,55,-24,21
CC Mariners,2906,10,4,8,15,28,49,-21,20
Sydney FC,2907,1,20,5,3,65,23,42,65
N'castle Jet,2907,2,15,6,7,58,38,20,51
Melbourne C,2907,3,14,5,10,44,34,10,47
Melbourne V,2907,4,13,6,10,46,39,7,45
Adelaide Utd,2907,5,11,6,11,37,40,-3,39
Brisbane,2907,6,10,5,13,33,42,-9,35
Western Sydn,2907,7,8,9,10,38,47,-9,33
Perth Glory,2907,8,10,2,15,37,50,-13,32
Wellington P,2907,9,5,6,16,31,55,-24,21
CC Mariners,2907,10,4,8,15,28,49,-21,20
Sydney FC,2908,1,21,4,3,66,23,43,67
N'castle Jet,2908,2,15,6,7,59,39,20,51
Melbourne C,2908,3,14,5,10,45,35,10,47
Melbourne V,2908,4,13,5,11,46,40,6,44
Adelaide Utd,2908,5,11,6,11,37,40,-3,39
Brisbane,2908,6,10,5,13,33,42,-9,35
Western Sydn,2908,7,8,9,10,38,47,-9,33
Perth Glory,2908,8,10,2,15,37,50,-13,32
Wellington P,2908,9,5,6,16,31,55,-24,21
CC Mariners,2908,10,4,8,15,28,49,-21,20
Sydney FC,2909,1,20,4,4,65,26,39,64
N'castle Jet,2909,2,15,5,8,58,40,18,50
Melbourne C,2909,3,15,4,10,46,34,12,49
Melbourne V,2909,4,14,5,10,49,39,10,47
Adelaide Utd,2909,5,11,6,11,37,40,-3,39
Brisbane,2909,6,10,5,13,33,42,-9,35
Western Sydn,2909,7,8,9,10,38,47,-9,33
Perth Glory,2909,8,10,2,15,37,50,-13,32
Wellington P,2909,9,5,6,16,31,55,-24,21
CC Mariners,2909,10,4,8,15,28,49,-21,20
Sydney FC,2910,1,21,4,3,67,22,45,67
N'castle Jet,2910,2,16,5,7,59,37,22,53
Melbourne C,2910,3,14,4,11,43,35,8,46
Melbourne V,2910,4,13,5,11,45,41,4,44
Adelaide Utd,2910,5,11,6,11,37,40,-3,39
Brisbane,2910,6,10,5,13,33,42,-9,35
Western Sydn,2910,7,8,9,10,38,47,-9,33
Perth Glory,2910,8,10,2,15,37,50,-13,32
Wellington P,2910,9,5,6,16,31,55,-24,21
CC Mariners,2910,10,4,8,15,28,49,-21,20
Sydney FC,2911,1,21,4,3,67,22,45,67
N'castle Jet,2911,2,16,5,7,59,37,22,53
Melbourne C,2911,3,14,4,11,43,35,8,46
Melbourne V,2911,4,13,5,11,45,41,4,44
Adelaide Utd,2911,5,11,6,11,37,40,-3,39
Brisbane,2911,6,10,5,13,33,42,-9,35
Western Sydn,2911,7,8,9,10,38,47,-9,33
Perth Glory,2911,8,10,2,15,37,50,-13,32
Wellington P,2911,9,5,6,16,31,55,-24,21
CC Mariners,2911,10,4,8,15,28,49,-21,20
Sydney FC,2912,1,21,4,3,65,22,43,67
N'castle Jet,2912,2,16,5,7,58,37,21,53
Melbourne C,2912,3,14,4,11,43,34,9,46
Melbourne V,2912,4,13,5,11,45,39,6,44
Adelaide Utd,2912,5,11,6,11,37,40,-3,39
Brisbane,2912,6,10,5,13,33,42,-9,35
Western Sydn,2912,7,8,9,10,38,47,-9,33
Perth Glory,2912,8,10,2,15,37,50,-13,32
Wellington P,2912,9,5,6,16,31,55,-24,21
CC Mariners,2912,10,4,8,15,28,49,-21,20
Sydney FC,2913,1,21,4,3,70,25,45,67
N'castle Jet,2913,2,15,5,8,60,41,19,50
Melbourne C,2913,3,15,4,10,47,36,11,49
Melbourne V,2913,4,13,5,11,48,44,4,44
Adelaide Utd,2913,5,11,6,11,37,40,-3,39
Brisbane,2913,6,10,5,13,33,42,-9,35
Western Sydn,2913,7,8,9,10,38,47,-9,33
Perth Glory,2913,8,10,2,15,37,50,-13,32
Wellington P,2913,9,5,6,16,31,55,-24,21
CC Mariners,2913,10,4,8,15,28,49,-21,20
Sydney FC,2914,1,20,5,3,67,25,42,65
N'castle Jet,2914,2,16,5,7,58,37,21,53
Melbourne C,2914,3,14,4,11,43,34,9,46
Melbourne V,2914,4,13,6,10,48,41,7,45
Adelaide Utd,2914,5,11,6,11,37,40,-3,39
Brisbane,2914,6,10,5,13,33,42,-9,35
Western Sydn,2914,7,8,9,10,38,47,-9,33
Perth Glory,2914,8,10,2,15,37,50,-13,32
Wellington P,2914,9,5,6,16,31,55,-24,21
CC Mariners,2914,10,4,8,15,28,49,-21,20
Sydney FC,2915,1,21,4,3,66,23,43,67
N'castle Jet,2915,2,16,5,7,61,38,23,53
Melbourne C,2915,3,14,4,11,44,37,7,46
Melbourne V,2915,4,13,5,11,46,40,6,44
Adelaide Utd,2915,5,11,6,11,37,40,-3,39
Brisbane,2915,6,10,5,13,33,42,-9,35
Western Sydn,2915,7,8,9,10,38,47,-9,33
Perth Glory,2915,8,10,2,15,37,50,-13,32
Wellington P,2915,9,5,6,16,31,55,-24,21
CC Mariners,2915,10,4,8,15,28,49,-21,20
Sydney FC,2916,1,21,4,3,68,22,46,67
N'castle Jet,2916,2,16,5,7,62,38,24,53
Melbourne C,2916,3,14,4,11,44,38,6,46
Melbourne V,2916,4,13,5,11,45,42,3,44
Adelaide Utd,2916,5,11,6,11,37,40,-3,39
Brisbane,2916,6,10,5,13,33,42,-9,35
Western Sydn,2916,7,8,9,10,38,47,-9,33
Perth Glory,2916,8,10,2,15,37,50,-13,32
Wellington P,2916,9,5,6,16,31,55,-24,21
CC Mariners,2916,10,4,8,15,28,49,-21,20
Sydney FC,2917,1,20,5,3,65,23,42,65
N'castle Jet,2917,2,16,5,7,59,37,22,53
Melbourne C,2917,3,14,4,11,43,35,8,46
Melbourne V,2917,4,13,6,10,46,39,7,45
Adelaide Utd,2917,5,11,6,11,37,40,-3,39
Brisbane,2917,6,10,5,13,33,42,-9,35
Western Sydn,2917,7,8,9,10,38,47,-9,33
Perth Glory,2917,8,10,2,15,37,50,-13,32
Wellington P,2917,9,5,6,16,31,55,-24,21
CC Mariners,2917,10,4,8,15,28,49,-21,20
Sydney FC,2918,1,20,4,4,64,24,40,64
N'castle Jet,2918,2,15,5,8,58,40,18,50
Melbourne C,2918,3,15,4,10,46,34,12,49
Melbourne V,2918,4,14,5,10,47,38,9,47
Adelaide Utd,2918,5,11,6,11,37,40,-3,39
Brisbane,2918,6,10,5,13,33,42,-9,35
Western Sydn,2918,7,8,9,10,38,47,-9,33
Perth Glory,2918,8,10,2,15,37,50,-13,32
Wellington P,2918,9,5,6,16,31,55,-24,21
CC Mariners,2918,10,4,8,15,28,49,-21,20
Sydney FC,2919,1,21,4,3,67,22,45,67
N'castle Jet,2919,2,16,5,7,59,37,22,53
Melbourne C,2919,3,14,4,11,43,35,8,46
Melbourne V,2919,4,13,5,11,45,41,4,44
Adelaide Utd,2919,5,11,6,11,37,40,-3,39
Brisbane,2919,6,10,5,13,33,42,-9,35
Western Sydn,2919,7,8,9,10,38,47,-9,33
Perth Glory,2919,8,10,2,15,37,50,-13,32
Wellington P,2919,9,5,6,16,31,55,-24,21
CC Mariners,2919,10,4,8,15,28,49,-21,20
Sydney FC,2920,1,21,4,3,66,23,43,67
N'castle Jet,2920,2,15,6,7,57,37,20,51
Melbourne C,2920,3,14,5,10,43,33,10,47
Melbourne V,2920,4,13,5,11,46,40,6,44
Adelaide Utd,2920,5,11,6,11,37,40,-3,39
Brisbane,2920,6,10,5,13,33,42,-9,35
Western Sydn,2920,7,8,9,10,38,47,-9,33
Perth Glory,2920,8,10,2,15,37,50,-13,32
Wellington P,2920,9,5,6,16,31,55,-24,21
CC Mariners,2920,10,4,8,15,28,49,-21,20
Sydney FC,2921,1,21,4,3,67,23,44,67
N'castle Jet,2921,2,16,5,7,58,37,21,53
Melbourne C,2921,3,14,4,11,43,34,9,46
Melbourne V,2921,4,13,5,11,46,41,5,44
Adelaide Utd,2921,5,11,6,11,37,40,-3,39
Brisbane,2921,6,10,5,13,33,42,-9,35
Western Sydn,2921,7,8,9,10,38,47,-9,33
Perth Glory,2921,8,10,2,15,37,50,-13,32
Wellington P,2921,9,5,6,16,31,55,-24,21
CC Mariners,2921,10,4,8,15,28,49,-21,20
Sydney FC,2922,1,20,5,3,65,23,42,65
N'castle Jet,2922,2,15,5,8,58,39,19,50
Melbourne C,2922,3,15,4,10,45,34,11,49
Melbourne V,2922,4,13,6,10,46,39,7,45
Adelaide Utd,2922,5,11,6,11,37,40,-3,39
Brisbane,2922,6,10,5,13,33,42,-9,35
Western Sydn,2922,7,8,9,10,38,47,-9,33
Perth Glory,2922,8,10,2,15,37,50,-13,32
Wellington P,2922,9,5,6,16,31,55,-24,21
CC Mariners,2922,10,4,8,15,28,49,-21,20
Sydney FC,2923,1,21,4,3,65,22,43,67
N'castle Jet,2923,2,16,5,7,58,37,21,53
Melbourne C,2923,3,14,4,11,43,34,9,46
Melbourne V,2923,4,13,5,11,45,39,6,44
Adelaide Utd,2923,5,11,6,11,37,40,-3,39
Brisbane,2923,6,10,5,13,33,42,-9,35
Western Sydn,2923,7,8,9,10,38,47,-9,33
Perth Glory,2923,8,10,2,15,37,50,-13,32
Wellington P,2923,9,5,6,16,31,55,-24,21
CC Mariners,2923,10,4,8,15,28,49,-21,20
Sydney FC,2924,1,20,4,4,64,23,41,64
N'castle Jet,2924,2,16,5,7,58,37,21,53
Melbourne V,2924,3,14,5,10,46,38,8,47
Melbourne C,2924,4,14,4,11,43,34,9,46
Adelaide Utd,2924,5,11,6,11,37,40,-3,39
Brisbane,2924,6,10,5,13,33,42,-9,35
Western Sydn,2924,7,8,9,10,38,47,-9,33
Perth Glory,2924,8,10,2,15,37,50,-13,32
Wellington P,2924,9,5,6,16,31,55,-24,21
CC Mariners,2924,10,4,8,15,28,49,-21,20
Sydney FC,2925,1,20,5,3,66,24,42,65
N'castle Jet,2925,2,15,6,7,58,38,20,51
Melbourne C,2925,3,14,5,10,44,34,10,47
Melbourne V,2925,4,13,6,10,47,40,7,45
Adelaide Utd,2925,5,11,6,11,37,40,-3,39
Brisbane,2925,6,10,5,13,33,42,-9,35
Western Sydn,2925,7,8,9,10,38,47,-9,33
Perth Glory,2925,8,10,2,15,37,50,-13,32
Wellington P,2925,9,5,6,16,31,55,-24,21
CC Mariners,2925,10,4,8,15,28,49,-21,20
Sydney FC,2926,1,20,5,3,65,23,42,65
N'castle Jet,2926,2,16,5,7,59,38,21,53
Melbourne C,2926,3,14,4,11,44,35,9,46
Melbourne V,2926,4,13,6,10,46,39,7,45
Adelaide Utd,2926,5,11,6,11,37,40,-3,39
Brisbane,2926,6,10,5,13,33,42,-9,35
Western Sydn,2926,7,8,9,10,38,47,-9,33
Perth Glory,2926,8,10,2,15,37,50,-13,32
Wellington P,2926,9,5,6,16,31,55,-24,21
CC Mariners,2926,10,4,8,15,28,49,-21,20
Sydney FC,2927,1,20,5,3,67,25,42,65
N'castle Jet,2927,2,15,6,7,58,38,20,51
Melbourne C,2927,3,14,5,10,44,34,10,47
Melbourne V,2927,4,13,6,10,48,41,7,45
Adelaide Utd,2927,5,11,6,11,37,40,-3,39
Brisbane,2927,6,10,5,13,33,42,-9,35
Western Sydn,2927,7,8,9,10,38,47,-9,33
Perth Glory,2927,8,10,2,15,37,50,-13,32
Wellington P,2927,9,5,6,16,31,55,-24,21
CC Mariners,2927,10,4,8,15,28,49,-21,20
Sydney FC,2928,1,20,5,3,65,23,42,65
N'castle Jet,2928,2,15,5,8,57,38,19,50
Melbourne C,2928,3,15,4,10,44,33,11,49
Melbourne V,2928,4,13,6,10,46,39,7,45
Adelaide Utd,2928,5,11,6,11,37,40,-3,39
Brisbane,2928,6,10,5,13,33,42,-9,35
Western Sydn,2928,7,8,9,10,38,47,-9,33
Perth Glory,2928,8,10,2,15,37,50,-13,32
Wellington P,2928,9,5,6,16,31,55,-24,21
CC Mariners,2928,10,4,8,15,28,49,-21,20
Sydney FC,2929,1,20,5,3,64,22,42,65
N'castle Jet,2929,2,16,5,7,61,37,24,53
Melbourne C,2929,3,14,4,11,43,37,6,46
Melbourne V,2929,4,13,6,10,45,38,7,45
Adelaide Utd,2929,5,11,6,11,37,40,-3,39
Brisbane,2929,6,10,5,13,33,42,-9,35
Western Sydn,2929,7,8,9,10,38,47,-9,33
Perth Glory,2929,8,10,2,15,37,50,-13,32
Wellington P,2929,9,5,6,16,31,55,-24,21
CC Mariners,2929,10,4,8,15,28,49,-21,20
Sydney FC,2930,1,21,4,3,66,23,43,67
N'castle Jet,2930,2,15,6,7,57,37,20,51
Melbourne C,2930,3,14,5,10,43,33,10,47
Melbourne V,2930,4,13,5,11,46,40,6,44
Adelaide Utd,2930,5,11,6,11,37,40,-3,39
Brisbane,2930,6,10,5,13,33,42,-9,35
Western Sydn,2930,7,8,9,10,38,47,-9,33
Perth Glory,2930,8,10,2,15,37,50,-13,32
Wellington P,2930,9,5,6,16,31,55,-24,21
CC Mariners,2930,10,4,8,15,28,49,-21,20
Sydney FC,2931,1,21,4,3,67,22,45,67
N'castle Jet,2931,2,16,5,7,61,38,23,53
Melbourne C,2931,3,14,4,11,44,37,7,46
Melbourne V,2931,4,13,5,11,45,41,4,44
Adelaide Utd,2931,5,11,6,11,37,40,-3,39
Brisbane,2931,6,10,5,13,33,42,-9,35
Western Sydn,2931,7,8,9,10,38,47,-9,33
Perth Glory,2931,8,10,2,15,37,50,-13,32
Wellington P,2931,9,5,6,16,31,55,-24,21
CC Mariners,2931,10,4,8,15,28,49,-21,20
Sydney FC,2932,1,20,4,4,65,24,41,64
N'castle Jet,2932,2,15,6,7,61,41,20,51
Melbourne C,2932,3,14,5,10,47,37,10,47
Melbourne V,2932,4,14,5,10,47,39,8,47
Adelaide Utd,2932,5,11,6,11,37,40,-3,39
Brisbane,2932,6,10,5,13,33,42,-9,35
Western Sydn,2932,7,8,9,10,38,47,-9,33
Perth Glory,2932,8,10,2,15,37,50,-13,32
Wellington P,2932,9,5,6,16,31,55,-24,21
CC Mariners,2932,10,4,8,15,28,49,-21,20
Sydney FC,2933,1,21,4,3,66,23,43,67
N'castle Jet,2933,2,16,5,7,60,38,22,53
Melbourne C,2933,3,14,4,11,44,36,8,46
Melbourne V,2933,4,13,5,11,46,40,6,44
Adelaide Utd,2933,5,11,6,11,37,40,-3,39
Brisbane,2933,6,10,5,13,33,42,-9,35
Western Sydn,2933,7,8,9,10,38,47,-9,33
Perth Glory,2933,8,10,2,15,37,50,-13,32
Wellington P,2933,9,5,6,16,31,55,-24,21
CC Mariners,2933,10,4,8,15,28,49,-21,20
Sydney FC,2934,1,20,4,4,64,24,40,64
N'castle Jet,2934,2,16,5,7,59,38,21,53
Melbourne V,2934,3,14,5,10,47,38,9,47
Melbourne C,2934,4,14,4,11,44,35,9,46
Adelaide Utd,2934,5,11,6,11,37,40,-3,39
Brisbane,2934,6,10,5,13,33,42,-9,35
Western Sydn,2934,7,8,9,10,38,47,-9,33
Perth Glory,2934,8,10,2,15,37,50,-13,32
Wellington P,2934,9,5,6,16,31,55,-24,21
CC Mariners,2934,10,4,8,15,28,49,-21,20
Sydney FC,2935,1,20,5,3,64,22,42,65
N'castle Jet,2935,2,16,5,7,61,38,23,53
Melbourne C,2935,3,14,4,11,44,37,7,46
Melbourne V,2935,4,13,6,10,45,38,7,45
Adelaide Utd,2935,5,11,6,11,37,40,-3,39
Brisbane,2935,6,10,5,13,33,42,-9,35
Western Sydn,2935,7,8,9,10,38,47,-9,33
Perth Glory,2935,8,10,2,15,37,50,-13,32
Wellington P,2935,9,5,6,16,31,55,-24,21
CC Mariners,2935,10,4,8,15,28,49,-21,20
Sydney FC,2936,1,20,4,4,64,23,41,64
N'castle Jet,2936,2,16,5,7,61,39,22,53
Melbourne V,2936,3,14,5,10,46,38,8,47
Melbourne C,2936,4,14,4,11,45,37,8,46
Adelaide Utd,2936,5,11,6,11,37,40,-3,39
Brisbane,2936,6,10,5,13,33,42,-9,35
Western Sydn,2936,7,8,9,10,38,47,-9,33
Perth Glory,2936,8,10,2,15,37,50,-13,32
Wellington P,2936,9,5,6,16,31,55,-24,21
CC Mariners,2936,10,4,8,15,28,49,-21,20
Sydney FC,2937,1,21,4,3,67,22,45,67
N'castle Jet,2937,2,15,5,8,58,39,19,50
Melbourne C,2937,3,15,4,10,45,34,11,49
Melbourne V,2937,4,13,5,11,45,41,4,44
Adelaide Utd,2937,5,11,6,11,37,40,-3,39
Brisbane,2937,6,10,5,13,33,42,-9,35
Western Sydn,2937,7,8,9,10,38,47,-9,33
Perth Glory,2937,8,10,2,15,37,50,-13,32
Wellington P,2937,9,5,6,16,31,55,-24,21
CC Mariners,2937,10,4,8,15,28,49,-21,20
Sydney FC,2938,1,20,5,3,67,25,42,65
N'castle Jet,2938,2,16,5,7,62,39,23,53
Melbourne C,2938,3,14,4,11,45,38,7,46
Melbourne V,2938,4,13,6,10,48,41,7,45
Adelaide Utd,2938,5,11,6,11,37,40,-3,39
Brisbane,2938,6,10,5,13,33,42,-9,35
Western Sydn,2938,7,8,9,10,38,47,-9,33
Perth Glory,2938,8,10,2,15,37,50,-13,32
Wellington P,2938,9,5,6,16,31,55,-24,21
CC Mariners,2938,10,4,8,15,28,49,-21,20
Sydney FC,2939,1,21,4,3,67,23,44,67
N'castle Jet,2939,2,15,5,8,58,39,19,50
Melbourne C,2939,3,15,4,10,45,34,11,49
Melbourne V,2939,4,13,5,11,46,41,5,44
Adelaide Utd,2939,5,11,6,11,37,40,-3,39
Brisbane,2939,6,10,5,13,33,42,-9,35
Western Sydn,2939,7,8,9,10,38,47,-9,33
Perth Glory,2939,8,10,2,15,37,50,-13,32
Wellington P,2939,9,5,6,16,31,55,-24,21
CC Mariners,2939,10,4,8,15,28,49,-21,20
Sydney FC,2940,1,20,4,4,64,23,41,64
N'castle Jet,2940,2,16,5,7,60,39,21,53
Melbourne V,2940,3,14,5,10,46,38,8,47
Melbourne C,2940,4,14,4,11,45,36,9,46
Adelaide Utd,2940,5,11,6,11,37,40,-3,39
Brisbane,2940,6,10,5,13,33,42,-9,35
Western Sydn,2940,7,8,9,10,38,47,-9,33
Perth Glory,2940,8,10,2,15,37,50,-13,32
Wellington P,2940,9,5,6,16,31,55,-24,21
CC Mariners,2940,10,4,8,15,28,49,-21,20
Sydney FC,2941,1,21,4,3,66,22,44,67
N'castle Jet,2941,2,16,5,7,60,39,21,53
Melbourne C,2941,3,14,4,11,45,36,9,46
Melbourne V,2941,4,13,5,11,45,40,5,44
Adelaide Utd,2941,5,11,6,11,37,40,-3,39
Brisbane,2941,6,10,5,13,33,42,-9,35
Western Sydn,2941,7,8,9,10,38,47,-9,33
Perth Glory,2941,8,10,2,15,37,50,-13,32
Wellington P,2941,9,5,6,16,31,55,-24,21
CC Mariners,2941,10,4,8,15,28,49,-21,20
Sydney FC,2942,1,21,4,3,67,22,45,67
N'castle Jet,2942,2,16,5,7,61,38,23,53
Melbourne C,2942,3,14,4,11,44,37,7,46
Melbourne V,2942,4,13,5,11,45,41,4,44
Adelaide Utd,2942,5,11,6,11,37,40,-3,39
Brisbane,2942,6,10,5,13,33,42,-9,35
Western Sydn,2942,7,8,9,10,38,47,-9,33
Perth Glory,2942,8,10,2,15,37,50,-13,32
Wellington P,2942,9,5,6,16,31,55,-24,21
CC Mariners,2942,10,4,8,15,28,49,-21,20
Sydney FC,2943,1,20,5,3,67,25,42,65
N'castle Jet,2943,2,15,5,8,58,42,16,50
Melbourne C,2943,3,15,4,10,48,34,14,49
Melbourne V,2943,4,13,6,10,48,41,7,45
Adelaide Utd,2943,5,11,6,11,37,40,-3,39
Brisbane,2943,6,10,5,13,33,42,-9,35
Western Sydn,2943,7,8,9,10,38,47,-9,33
Perth Glory,2943,8,10,2,15,37,50,-13,32
Wellington P,2943,9,5,6,16,31,55,-24,21
CC Mariners,2943,10,4,8,15,28,49,-21,20
Sydney FC,2944,1,20,5,3,66,24,42,65
N'castle Jet,2944,2,16,5,7,60,38,22,53
Melbourne C,2944,3,14,4,11,44,36,8,46
Melbourne V,2944,4,13,6,10,47,40,7,45
Adelaide Utd,2944,5,11,6,11,37,40,-3,39
Brisbane,2944,6,10,5,13,33,42,-9,35
Western Sydn,2944,7,8,9,10,38,47,-9,33
Perth Glory,2944,8,10,2,15,37,50,-13,32
Wellington P,2944,9,5,6,16,31,55,-24,21
CC Mariners,2944,10,4,8,15,28,49,-21,20
Sydney FC,2945,1,20,5,3,64,22,42,65
N'castle Jet,2945,2,16,5,7,60,38,22,53
Melbourne C,2945,3,14,4,11,44,36,8,46
Melbourne V,2945,4,13,6,10,45,38,7,45
Adelaide Utd,2945,5,11,6,11,37,40,-3,39
Brisbane,2945,6,10,5,13,33,42,-9,35
Western Sydn,2945,7,8,9,10,38,47,-9,33
Perth Glory,2945,8,10,2,15,37,50,-13,32
Wellington P,2945,9,5,6,16,31,55,-24,21
CC Mariners,2945,10,4,8,15,28,49,-21,20
Sydney FC,2946,1,20,4,4,65,24,41,64
N'castle Jet,2946,2,16,5,7,58,37,21,53
Melbourne V,2946,3,14,5,10,47,39,8,47
Melbourne C,2946,4,14,4,11,43,34,9,46
Adelaide Utd,2946,5,11,6,11,37,40,-3,39
Brisbane,2946,6,10,5,13,33,42,-9,35
Western Sydn,2946,7,8,9,10,38,47,-9,33
Perth Glory,2946,8,10,2,15,37,50,-13,32
Wellington P,2946,9,5,6,16,31,55,-24,21
CC Mariners,2946,10,4,8,15,28,49,-21,20
Sydney FC,2947,1,21,4,3,66,22,44,67
N'castle Jet,2947,2,15,6,7,58,38,20,51
Melbourne C,2947,3,14,5,10,44,34,10,47
Melbourne V,2947,4,13,5,11,45,40,5,44
Adelaide Utd,2947,5,11,6,11,37,40,-3,39
Brisbane,2947,6,10,5,13,33,42,-9,35
Western Sydn,2947,7,8,9,10,38,47,-9,33
Perth Glory,2947,8,10,2,15,37,50,-13,32
Wellington P,2947,9,5,6,16,31,55,-24,21
CC Mariners,2947,10,4,8,15,28,49,-21,20
Sydney FC,2948,1,21,4,3,67,23,44,67
N'castle Jet,2948,2,16,5,7,59,38,21,53
Melbourne C,2948,3,14,4,11,44,35,9,46
Melbourne V,2948,4,13,5,11,46,41,5,44
Adelaide Utd,2948,5,11,6,11,37,40,-3,39
Brisbane,2948,6,10,5,13,33,42,-9,35
Western Sydn,2948,7,8,9,10,38,47,-9,33
Perth Glory,2948,8,10,2,15,37,50,-13,32
Wellington P,2948,9,5,6,16,31,55,-24,21
CC Mariners,2948,10,4,8,15,28,49,-21,20
Sydney FC,2949,1,21,4,3,68,23,45,67
N'castle Jet,2949,2,15,5,8,59,42,17,50
Melbourne C,2949,3,15,4,10,48,35,13,49
Melbourne V,2949,4,13,5,11,46,42,4,44
Adelaide Utd,2949,5,11,6,11,37,40,-3,39
Brisbane,2949,6,10,5,13,33,42,-9,35
Western Sydn,2949,7,8,9,10,38,47,-9,33
Perth Glory,2949,8,10,2,15,37,50,-13,32
Wellington P,2949,9,5,6,16,31,55,-24,21
CC Mariners,2949,10,4,8,15,28,49,-21,20
Sydney FC,2950,1,21,4,3,66,22,44,67
N'castle Jet,2950,2,16,5,7,58,37,21,53
Melbourne C,2950,3,14,4,11,43,34,9,46
Melbourne V,2950,4,13,5,11,45,40,5,44
Adelaide Utd,2950,5,11,6,11,37,40,-3,39
Brisbane,2950,6,10,5,13,33,42,-9,35
Western Sydn,2950,7,8,9,10,38,47,-9,33
Perth Glory,2950,8,10,2,15,37,50,-13,32
Wellington P,2950,9,5,6,16,31,55,-24,21
CC Mariners,2950,10,4,8,15,28,49,-21,20
Sydney FC,2951,1,21,4,3,65,22,43,67
N'castle Jet,2951,2,16,5,7,59,37,22,53
Melbourne C,2951,3,14,4,11,43,35,8,46
Melbourne V,2951,4,13,5,11,45,39,6,44
Adelaide Utd,2951,5,11,6,11,37,40,-3,39
Brisbane,2951,6,10,5,13,33,42,-9,35
Western Sydn,2951,7,8,9,10,38,47,-9,33
Perth Glory,2951,8,10,2,15,37,50,-13,32
Wellington P,2951,9,5,6,16,31,55,-24,21
CC Mariners,2951,10,4,8,15,28,49,-21,20
Sydney FC,2952,1,20,4,4,66,25,41,64
N'castle Jet,2952,2,15,5,8,57,38,19,50
Melbourne C,2952,3,15,4,10,44,33,11,49
Melbourne V,2952,4,14,5,10,48,40,8,47
Adelaide Utd,2952,5,11,6,11,37,40,-3,39
Brisbane,2952,6,10,5,13,33,42,-9,35
Western Sydn,2952,7,8,9,10,38,47,-9,33
Perth Glory,2952,8,10,2,15,37,50,-13,32
Wellington P,2952,9,5,6,16,31,55,-24,21
CC Mariners,2952,10,4,8,15,28,49,-21,20
Sydney FC,2953,1,20,5,3,66,24,42,65
N'castle Jet,2953,2,15,5,8,59,40,19,50
Melbourne C,2953,3,15,4,10,46,35,11,49
Melbourne V,2953,4,13,6,10,47,40,7,45
Adelaide Utd,2953,5,11,6,11,37,40,-3,39
Brisbane,2953,6,10,5,13,33,42,-9,35
Western Sydn,2953,7,8,9,10,38,47,-9,33
Perth Glory,2953,8,10,2,15,37,50,-13,32
Wellington P,2953,9,5,6,16,31,55,-24,21
CC Mariners,2953,10,4,8,15,28,49,-21,20
Sydney FC,2954,1,21,4,3,66,22,44,67
N'castle Jet,2954,2,16,5,7,58,37,21,53
Melbourne C,2954,3,14,4,11,43,34,9,46
Melbourne V,2954,4,13,5,11,45,40,5,44
Adelaide Utd,2954,5,11,6,11,37,40,-3,39
Brisbane,2954,6,10,5,13,33,42,-9,35
Western Sydn,2954,7,8,9,10,38,47,-9,33
Perth Glory,2954,8,10,2,15,37,50,-13,32
Wellington P,2954,9,5,6,16,31,55,-24,21
CC Mariners,2954,10,4,8,15,28,49,-21,20
Sydney FC,2955,1,20,5,3,64,22,42,65
N'castle Jet,2955,2,16,5,7,62,39,23,53
Melbourne C,2955,3,14,4,11,45,38,7,46
Melbourne V,2955,4,13,6,10,45,38,7,45
Adelaide Utd,2955,5,11,6,11,37,40,-3,39
Brisbane,2955,6,10,5,13,33,42,-9,35
Western Sydn,2955,7,8,9,10,38,47,-9,33
Perth Glory,2955,8,10,2,15,37,50,-13,32
Wellington P,2955,9,5,6,16,31,55,-24,21
CC Mariners,2955,10,4,8,15,28,49,-21,20
Sydney FC,2956,1,20,4,4,66,25,41,64
N'castle Jet,2956,2,15,5,8,57,38,19,50
Melbourne C,2956,3,15,4,10,44,33,11,49
Melbourne V,2956,4,14,5,10,48,40,8,47
Adelaide Utd,2956,5,11,6,11,37,40,-3,39
Brisbane,2956,6,10,5,13,33,42,-9,35
Western Sydn,2956,7,8,9,10,38,47,-9,33
Perth Glory,2956,8,10,2,15,37,50,-13,32
Wellington P,2956,9,5,6,16,31,55,-24,21
CC Mariners,2956,10,4,8,15,28,49,-21,20
Sydney FC,2957,1,21,4,3,66,22,44,67
N'castle Jet,2957,2,16,5,7,61,37,24,53
Melbourne C,2957,3,14,4,11,43,37,6,46
Melbourne V,2957,4,13,5,11,45,40,5,44
Adelaide Utd,2957,5,11,6,11,37,40,-3,39
Brisbane,2957,6,10,5,13,33,42,-9,35
Western Sydn,2957,7,8,9,10,38,47,-9,33
Perth Glory,2957,8,10,2,15,37,50,-13,32
Wellington P,2957,9,5,6,16,31,55,-24,21
CC Mariners,2957,10,4,8,15,28,49,-21,20
Sydney FC,2958,1,21,4,3,66,23,43,67
N'castle Jet,2958,2,15,5,8,59,40,19,50
Melbourne C,2958,3,15,4,10,46,35,11,49
Melbourne V,2958,4,13,5,11,46,40,6,44
Adelaide Utd,2958,5,11,6,11,37,40,-3,39
Brisbane,2958,6,10,5,13,33,42,-9,35
Western Sydn,2958,7,8,9,10,38,47,-9,33
Perth Glory,2958,8,10,2,15,37,50,-13,32
Wellington P,2958,9,5,6,16,31,55,-24,21
CC Mariners,2958,10,4,8,15,28,49,-21,20
Sydney FC,2959,1,21,4,3,68,25,43,67
N'castle Jet,2959,2,15,5,8,57,39,18,50
Melbourne C,2959,3,15,4,10,45,33,12,49
Melbourne V,2959,4,13,5,11,48,42,6,44
Adelaide Utd,2959,5,11,6,11,37,40,-3,39
Brisbane,2959,6,10,5,13,33,42,-9,35
Western Sydn,2959,7,8,9,10,38,47,-9,33
Perth Glory,2959,8,10,2,15,37,50,-13,32
Wellington P,2959,9,5,6,16,31,55,-24,21
CC Mariners,2959,10,4,8,15,28,49,-21,20
Sydney FC,2960,1,20,5,3,64,22,42,65
N'castle Jet,2960,2,16,5,7,59,37,22,53
Melbourne C,2960,3,14,4,11,43,35,8,46
Melbourne V,2960,4,13,6,10,45,38,7,45
Adelaide Utd,2960,5,11,6,11,37,40,-3,39
Brisbane,2960,6,10,5,13,33,42,-9,35
Western Sydn,2960,7,8,9,10,38,47,-9,33
Perth Glory,2960,8,10,2,15,37,50,-13,32
Wellington P,2960,9,5,6,16,31,55,-24,21
CC Mariners,2960,10,4,8,15,28,49,-21,20
Sydney FC,2961,1,21,4,3,66,23,43,67
N'castle Jet,2961,2,15,6,7,59,39,20,51
Melbourne C,2961,3,14,5,10,45,35,10,47
Melbourne V,2961,4,13,5,11,46,40,6,44
Adelaide Utd,2961,5,11,6,11,37,40,-3,39
Brisbane,2961,6,10,5,13,33,42,-9,35
Western Sydn,2961,7,8,9,10,38,47,-9,33
Perth Glory,2961,8,10,2,15,37,50,-13,32
Wellington P,2961,9,5,6,16,31,55,-24,21
CC Mariners,2961,10,4,8,15,28,49,-21,20
Sydney FC,2962,1,20,4,4,64,23,41,64
N'castle Jet,2962,2,15,5,8,58,40,18,50
Melbourne C,2962,3,15,4,10,46,34,12,49
Melbourne V,2962,4,14,5,10,46,38,8,47
Adelaide Utd,2962,5,11,6,11,37,40,-3,39
Brisbane,2962,6,10,5,13,33,42,-9,35
Western Sydn,2962,7,8,9,10,38,47,-9,33
Perth Glory,2962,8,10,2,15,37,50,-13,32
Wellington P,2962,9,5,6,16,31,55,-24,21
CC Mariners,2962,10,4,8,15,28,49,-21,20
Sydney FC,2963,1,21,4,3,67,22,45,67
N'castle Jet,2963,2,15,5,8,57,38,19,50
Melbourne C,2963,3,15,4,10,44,33,11,49
Melbourne V,2963,4,13,5,11,45,41,4,44
Adelaide Utd,2963,5,11,6,11,37,40,-3,39
Brisbane,2963,6,10,5,13,33,42,-9,35
Western Sydn,2963,7,8,9,10,38,47,-9,33
Perth Glory,2963,8,10,2,15,37,50,-13,32
Wellington P,2963,9,5,6,16,31,55,-24,21
CC Mariners,2963,10,4,8,15,28,49,-21,20
Sydney FC,2964,1,20,5,3,64,22,42,65
N'castle Jet,2964,2,16,5,7,60,37,23,53
Melbourne C,2964,3,14,4,11,43,36,7,46
Melbourne V,2964,4,13,6,10,45,38,7,45
Adelaide Utd,2964,5,11,6,11,37,40,-3,39
Brisbane,2964,6,10,5,13,33,42,-9,35
Western Sydn,2964,7,8,9,10,38,47,-9,33
Perth Glory,2964,8,10,2,15,37,50,-13,32
Wellington P,2964,9,5,6,16,31,55,-24,21
CC Mariners,2964,10,4,8,15,28,49,-21,20
Sydney FC,2965,1,21,4,3,66,22,44,67
N'castle Jet,2965,2,15,5,8,58,39,19,50
Melbourne C,2965,3,15,4,10,45,34,11,49
Melbourne V,2965,4,13,5,11,45,40,5,44
Adelaide Utd,2965,5,11,6,11,37,40,-3,39
Brisbane,2965,6,10,5,13,33,42,-9,35
Western Sydn,2965,7,8,9,10,38,47,-9,33
Perth Glory,2965,8,10,2,15,37,50,-13,32
Wellington P,2965,9,5,6,16,31,55,-24,21
CC Mariners,2965,10,4,8,15,28,49,-21,20
Sydney FC,2966,1,20,5,3,65,23,42,65
N'castle Jet,2966,2,15,5,8,58,39,19,50
Melbourne C,2966,3,15,4,10,45,34,11,49
Melbourne V,2966,4,13,6,10,46,39,7,45
Adelaide Utd,2966,5,11,6,11,37,40,-3,39
Brisbane,2966,6,10,5,13,33,42,-9,35
Western Sydn,2966,7,8,9,10,38,47,-9,33
Perth Glory,2966,8,10,2,15,37,50,-13,32
Wellington P,2966,9,5,6,16,31,55,-24,21
CC Mariners,2966,10,4,8,15,28,49,-21,20
Sydney FC,2967,1,21,4,3,65,22,43,67
N'castle Jet,2967,2,16,5,7,62,37,25,53
Melbourne C,2967,3,14,4,11,43,38,5,46
Melbourne V,2967,4,13,5,11,45,39,6,44
Adelaide Utd,2967,5,11,6,11,37,40,-3,39
Brisbane,2967,6,10,5,13,33,42,-9,35
Western Sydn,2967,7,8,9,10,38,47,-9,33
Perth Glory,2967,8,10,2,15,37,50,-13,32
Wellington P,2967,9,5,6,16,31,55,-24,21
CC Mariners,2967,10,4,8,15,28,49,-21,20
Sydney FC,2968,1,20,4,4,65,25,40,64
N'castle Jet,2968,2,15,6,7,58,38,20,51
Melbourne C,2968,3,14,5,10,44,34,10,47
Melbourne V,2968,4,14,5,10,48,39,9,47
Adelaide Utd,2968,5,11,6,11,37,40,-3,39
Brisbane,2968,6,10,5,13,33,42,-9,35
Western Sydn,2968,7,8,9,10,38,47,-9,33
Perth Glory,2968,8,10,2,15,37,50,-13,32
Wellington P,2968,9,5,6,16,31,55,-24,21
CC Mariners,2968,10,4,8,15,28,49,-21,20
Sydney FC,2969,1,21,4,3,67,24,43,67
N'castle Jet,2969,2,16,5,7,59,38,21,53
Melbourne C,2969,3,14,4,11,44,35,9,46
Melbourne V,2969,4,13,5,11,47,41,6,44
Adelaide Utd,2969,5,11,6,11,37,40,-3,39
Brisbane,2969,6,10,5,13,33,42,-9,35
Western Sydn,2969,7,8,9,10,38,47,-9,33
Perth Glory,2969,8,10,2,15,37,50,-13,32
Wellington P,2969,9,5,6,16,31,55,-24,21
CC Mariners,2969,10,4,8,15,28,49,-21,20
Sydney FC,2970,1,21,4,3,65,22,43,67
N'castle Jet,2970,2,15,6,7,58,38,20,51
Melbourne C,2970,3,14,5,10,44,34,10,47
Melbourne V,2970,4,13,5,11,45,39,6,44
Adelaide Utd,2970,5,11,6,11,37,40,-3,39
Brisbane,2970,6,10,5,13,33,42,-9,35
Western Sydn,2970,7,8,9,10,38,47,-9,33
Perth Glory,2970,8,10,2,15,37,50,-13,32
Wellington P,2970,9,5,6,16,31,55,-24,21
CC Mariners,2970,10,4,8,15,28,49,-21,20
Sydney FC,2971,1,21,4,3,67,24,43,67
N'castle Jet,2971,2,15,5,8,58,42,16,50
Melbourne C,2971,3,15,4,10,48,34,14,49
Melbourne V,2971,4,13,5,11,47,41,6,44
Adelaide Utd,2971,5,11,6,11,37,40,-3,39
Brisbane,2971,6,10,5,13,33,42,-9,35
Western Sydn,2971,7,8,9,10,38,47,-9,33
Perth Glory,2971,8,10,2,15,37,50,-13,32
Wellington P,2971,9,5,6,16,31,55,-24,21
CC Mariners,2971,10,4,8,15,28,49,-21,20
Sydney FC,2972,1,21,4,3,67,22,45,67
N'castle Jet,2972,2,15,6,7,59,39,20,51
Melbourne C,2972,3,14,5,10,45,35,10,47
Melbourne V,2972,4,13,5,11,45,41,4,44
Adelaide Utd,2972,5,11,6,11,37,40,-3,39
Brisbane,2972,6,10,5,13,33,42,-9,35
Western Sydn,2972,7,8,9,10,38,47,-9,33
Perth Glory,2972,8,10,2,15,37,50,-13,32
Wellington P,2972,9,5,6,16,31,55,-24,21
CC Mariners,2972,10,4,8,15,28,49,-21,20
Sydney FC,2973,1,21,4,3,67,22,45,67
N'castle Jet,2973,2,15,5,8,57,38,19,50
Melbourne C,2973,3,15,4,10,44,33,11,49
Melbourne V,2973,4,13,5,11,45,41,4,44
Adelaide Utd,2973,5,11,6,11,37,40,-3,39
Brisbane,2973,6,10,5,13,33,42,-9,35
Western Sydn,2973,7,8,9,10,38,47,-9,33
Perth Glory,2973,8,10,2,15,37,50,-13,32
Wellington P,2973,9,5,6,16,31,55,-24,21
CC Mariners,2973,10,4,8,15,28,49,-21,20
Sydney FC,2974,1,20,5,3,66,24,42,65
N'castle Jet,2974,2,16,5,7,63,37,26,53
Melbourne C,2974,3,14,4,11,43,39,4,46
Melbourne V,2974,4,13,6,10,47,40,7,45
Adelaide Utd,2974,5,11,6,11,37,40,-3,39
Brisbane,2974,6,10,5,13,33,42,-9,35
Western Sydn,2974,7,8,9,10,38,47,-9,33
Perth Glory,2974,8,10,2,15,37,50,-13,32
Wellington P,2974,9,5,6,16,31,55,-24,21
CC Mariners,2974,10,4,8,15,28,49,-21,20
Sydney FC,2975,1,21,4,3,66,23,43,67
N'castle Jet,2975,2,16,5,7,63,38,25,53
Melbourne C,2975,3,14,4,11,44,39,5,46
Melbourne V,2975,4,13,5,11,46,40,6,44
Adelaide Utd,2975,5,11,6,11,37,40,-3,39
Brisbane,2975,6,10,5,13,33,42,-9,35
Western Sydn,2975,7,8,9,10,38,47,-9,33
Perth Glory,2975,8,10,2,15,37,50,-13,32
Wellington P,2975,9,5,6,16,31,55,-24,21
CC Mariners,2975,10,4,8,15,28,49,-21,20
Sydney FC,2976,1,20,4,4,64,24,40,64
N'castle Jet,2976,2,15,5,8,57,38,19,50
Melbourne C,2976,3,15,4,10,44,33,11,49
Melbourne V,2976,4,14,5,10,47,38,9,47
Adelaide Utd,2976,5,11,6,11,37,40,-3,39
Brisbane,2976,6,10,5,13,33,42,-9,35
Western Sydn,2976,7,8,9,10,38,47,-9,33
Perth Glory,2976,8,10,2,15,37,50,-13,32
Wellington P,2976,9,5,6,16,31,55,-24,21
CC Mariners,2976,10,4,8,15,28,49,-21,20
Sydney FC,2977,1,21,4,3,66,22,44,67
N'castle Jet,2977,2,15,6,7,57,37,20,51
Melbourne C,2977,3,14,5,10,43,33,10,47
Melbourne V,2977,4,13,5,11,45,40,5,44
Adelaide Utd,2977,5,11,6,11,37,40,-3,39
Brisbane,2977,6,10,5,13,33,42,-9,35
Western Sydn,2977,7,8,9,10,38,47,-9,33
Perth Glory,2977,8,10,2,15,37,50,-13,32
Wellington P,2977,9,5,6,16,31,55,-24,21
CC Mariners,2977,10,4,8,15,28,49,-21,20
Sydney FC,2978,1,21,4,3,67,24,43,67
N'castle Jet,2978,2,15,5,8,58,40,18,50
Melbourne C,2978,3,15,4,10,46,34,12,49
Melbourne V,2978,4,13,5,11,47,41,6,44
Adelaide Utd,2978,5,11,6,11,37,40,-3,39
Brisbane,2978,6,10,5,13,33,42,-9,35
Western Sydn,2978,7,8,9,10,38,47,-9,33
Perth Glory,2978,8,10,2,15,37,50,-13,32
Wellington P,2978,9,5,6,16,31,55,-24,21
CC Mariners,2978,10,4,8,15,28,49,-21,20
Sydney FC,2979,1,20,4,4,64,24,40,64
N'castle Jet,2979,2,16,5,7,60,38,22,53
Melbourne V,2979,3,14,5,10,47,38,9,47
Melbourne C,2979,4,14,4,11,44,36,8,46
Adelaide Utd,2979,5,11,6,11,37,40,-3,39
Brisbane,2979,6,10,5,13,33,42,-9,35
Western Sydn,2979,7,8,9,10,38,47,-9,33
Perth Glory,2979,8,10,2,15,37,50,-13,32
Wellington P,2979,9,5,6,16,31,55,-24,21
CC Mariners,2979,10,4,8,15,28,49,-21,20
Sydney FC,2980,1,21,4,3,69,22,47,67
N'castle Jet,2980,2,15,5,8,57,39,18,50
Melbourne C,2980,3,15,4,10,45,33,12,49
Melbourne V,2980,4,13,5,11,45,43,2,44
Adelaide Utd,2980,5,11,6,11,37,40,-3,39
Brisbane,2980,6,10,5,13,33,42,-9,35
Western Sydn,2980,7,8,9,10,38,47,-9,33
Perth Glory,2980,8,10,2,15,37,50,-13,32
Wellington P,2980,9,5,6,16,31,55,-24,21
CC Mariners,2980,10,4,8,15,28,49,-21,20
Sydney FC,2981,1,20,4,4,64,24,40,64
N'castle Jet,2981,2,15,6,7,58,38,20,51
Melbourne C,2981,3,14,5,10,44,34,10,47
Melbourne V,2981,4,14,5,10,47,38,9,47
Adelaide Utd,2981,5,11,6,11,37,40,-3,39
Brisbane,2981,6,10,5,13,33,42,-9,35
Western Sydn,2981,7,8,9,10,38,47,-9,33
Perth Glory,2981,8,10,2,15,37,50,-13,32
Wellington P,2981,9,5,6,16,31,55,-24,21
CC Mariners,2981,10,4,8,15,28,49,-21,20
Sydney FC,2982,1,20,4,4,64,23,41,64
N'castle Jet,2982,2,15,5,8,59,40,19,50
Melbourne C,2982,3,15,4,10,46,35,11,49
Melbourne V,2982,4,14,5,10,46,38,8,47
Adelaide Utd,2982,5,11,6,11,37,40,-3,39
Brisbane,2982,6,10,5,13,33,42,-9,35
Western Sydn,2982,7,8,9,10,38,47,-9,33
Perth Glory,2982,8,10,2,15,37,50,-13,32
Wellington P,2982,9,5,6,16,31,55,-24,21
CC Mariners,2982,10,4,8,15,28,49,-21,20
Sydney FC,2983,1,21,4,3,66,22,44,67
N'castle Jet,2983,2,15,6,7,59,39,20,51
Melbourne C,2983,3,14,5,10,45,35,10,47
Melbourne V,2983,4,13,5,11,45,40,5,44
Adelaide Utd,2983,5,11,6,11,37,40,-3,39
Brisbane,2983,6,10,5,13,33,42,-9,35
Western Sydn,2983,7,8,9,10,38,47,-9,33
Perth Glory,2983,8,10,2,15,37,50,-13,32
Wellington P,2983,9,5,6,16,31,55,-24,21
CC Mariners,2983,10,4,8,15,28,49,-21,20
Sydney FC,2984,1,21,4,3,67,23,44,67
N'castle Jet,2984,2,16,5,7,59,38,21,53
Melbourne C,2984,3,14,4,11,44,35,9,46
Melbourne V,2984,4,13,5,11,46,41,5,44
Adelaide Utd,2984,5,11,6,11,37,40,-3,39
Brisbane,2984,6,10,5,13,33,42,-9,35
Western Sydn,2984,7,8,9,10,38,47,-9,33
Perth Glory,2984,8,10,2,15,37,50,-13,32
Wellington P,2984,9,5,6,16,31,55,-24,21
CC Mariners,2984,10,4,8,15,28,49,-21,20
Sydney FC,2985,1,20,4,4,66,25,41,64
N'castle Jet,2985,2,15,5,8,58,39,19,50
Melbourne C,2985,3,15,4,10,45,34,11,49
Melbourne V,2985,4,14,5,10,48,40,8,47
Adelaide Utd,2985,5,11,6,11,37,40,-3,39
Brisbane,2985,6,10,5,13,33,42,-9,35
Western Sydn,2985,7,8,9,10,38,47,-9,33
Perth Glory,2985,8,10,2,15,37,50,-13,32
Wellington P,2985,9,5,6,16,31,55,-24,21
CC Mariners,2985,10,4,8,15,28,49,-21,20
Sydney FC,2986,1,21,4,3,66,22,44,67
N'castle Jet,2986,2,15,6,7,59,39,20,51
Melbourne C,2986,3,14,5,10,45,35,10,47
Melbourne V,2986,4,13,5,11,45,40,5,44
Adelaide Utd,2986,5,11,6,11,37,40,-3,39
Brisbane,2986,6,10,5,13,33,42,-9,35
Western Sydn,2986,7,8,9,10,38,47,-9,33
Perth Glory,2986,8,10,2,15,37,50,-13,32
Wellington P,2986,9,5,6,16,31,55,-24,21
CC Mariners,2986,10,4,8,15,28,49,-21,20
Sydney FC,2987,1,20,5,3,65,23,42,65
N'castle Jet,2987,2,16,5,7,60,37,23,53
Melbourne C,2987,3,14,4,11,43,36,7,46
Melbourne V,2987,4,13,6,10,46,39,7,45
Adelaide Utd,2987,5,11,6,11,37,40,-3,39
Brisbane,2987,6,10,5,13,33,42,-9,35
Western Sydn,2987,7,8,9,10,38,47,-9,33
Perth Glory,2987,8,10,2,15,37,50,-13,32
Wellington P,2987,9,5,6,16,31,55,-24,21
CC Mariners,2987,10,4,8,15,28,49,-21,20
Sydney FC,2988,1,20,4,4,65,24,41,64
N'castle Jet,2988,2,15,5,8,58,39,19,50
Melbourne C,2988,3,15,4,10,45,34,11,49
Melbourne V,2988,4,14,5,10,47,39,8,47
Adelaide Utd,2988,5,11,6,11,37,40,-3,39
Brisbane,2988,6,10,5,13,33,42,-9,35
Western Sydn,2988,7,8,9,10,38,47,-9,33
Perth Glory,2988,8,10,2,15,37,50,-13,32
Wellington P,2988,9,5,6,16,31,55,-24,21
CC Mariners,2988,10,4,8,15,28,49,-21,20
Sydney FC,2989,1,20,4,4,65,24,41,64
N'castle Jet,2989,2,15,5,8,58,39,19,50
Melbourne C,2989,3,15,4,10,45,34,11,49
Melbourne V,2989,4,14,5,10,47,39,8,47
Adelaide Utd,2989,5,11,6,11,37,40,-3,39
Brisbane,2989,6,10,5,13,33,42,-9,35
Western Sydn,2989,7,8,9,10,38,47,-9,33
Perth Glory,2989,8,10,2,15,37,50,-13,32
Wellington P,2989,9,5,6,16,31,55,-24,21
CC Mariners,2989,10,4,8,15,28,49,-21,20
Sydney FC,2990,1,21,4,3,68,23,45,67
N'castle Jet,2990,2,15,6,7,58,38,20,51
Melbourne C,2990,3,14,5,10,44,34,10,47
Melbourne V,2990,4,13,5,11,46,42,4,44
Adelaide Utd,2990,5,11,6,11,37,40,-3,39
Brisbane,2990,6,10,5,13,33,42,-9,35
Western Sydn,2990,7,8,9,10,38,47,-9,33
Perth Glory,2990,8,10,2,15,37,50,-13,32
Wellington P,2990,9,5,6,16,31,55,-24,21
CC Mariners,2990,10,4,8,15,28,49,-21,20
Sydney FC,2991,1,21,4,3,67,22,45,67
N'castle Jet,2991,2,15,5,8,58,39,19,50
Melbourne C,2991,3,15,4,10,45,34,11,49
Melbourne V,2991,4,13,5,11,45,41,4,44
Adelaide Utd,2991,5,11,6,11,37,40,-3,39
Brisbane,2991,6,10,5,13,33,42,-9,35
Western Sydn,2991,7,8,9,10,38,47,-9,33
Perth Glory,2991,8,10,2,15,37,50,-13,32
Wellington P,2991,9,5,6,16,31,55,-24,21
CC Mariners,2991,10,4,8,15,28,49,-21,20
Sydney FC,2992,1,21,4,3,66,23,43,67
N'castle Jet,2992,2,16,5,7,59,37,22,53
Melbourne C,2992,3,14,4,11,43,35,8,46
Melbourne V,2992,4,13,5,11,46,40,6,44
Adelaide Utd,2992,5,11,6,11,37,40,-3,39
Brisbane,2992,6,10,5,13,33,42,-9,35
Western Sydn,2992,7,8,9,10,38,47,-9,33
Perth Glory,2992,8,10,2,15,37,50,-13,32
Wellington P,2992,9,5,6,16,31,55,-24,21
CC Mariners,2992,10,4,8,15,28,49,-21,20
Sydney FC,2993,1,20,5,3,66,24,42,65
N'castle Jet,2993,2,15,6,7,58,38,20,51
Melbourne C,2993,3,14,5,10,44,34,10,47
Melbourne V,2993,4,13,6,10,47,40,7,45
Adelaide Utd,2993,5,11,6,11,37,40,-3,39
Brisbane,2993,6,10,5,13,33,42,-9,35
Western Sydn,2993,7,8,9,10,38,47,-9,33
Perth Glory,2993,8,10,2,15,37,50,-13,32
Wellington P,2993,9,5,6,16,31,55,-24,21
CC Mariners,2993,10,4,8,15,28,49,-21,20
Sydney FC,2994,1,21,4,3,67,23,44,67
N'castle Jet,2994,2,16,5,7,61,38,23,53
Melbourne C,2994,3,14,4,11,44,37,7,46
Melbourne V,2994,4,13,5,11,46,41,5,44
Adelaide Utd,2994,5,11,6,11,37,40,-3,39
Brisbane,2994,6,10,5,13,33,42,-9,35
Western Sydn,2994,7,8,9,10,38,47,-9,33
Perth Glory,2994,8,10,2,15,37,50,-13,32
Wellington P,2994,9,5,6,16,31,55,-24,21
CC Mariners,2994,10,4,8,15,28,49,-21,20
Sydney FC,2995,1,20,5,3,66,24,42,65
N'castle Jet,2995,2,16,5,7,59,37,22,53
Melbourne C,2995,3,14,4,11,43,35,8,46
Melbourne V,2995,4,13,6,10,47,40,7,45
Adelaide Utd,2995,5,11,6,11,37,40,-3,39
Brisbane,2995,6,10,5,13,33,42,-9,35
Western Sydn,2995,7,8,9,10,38,47,-9,33
Perth Glory,2995,8,10,2,15,37,50,-13,32
Wellington P,2995,9,5,6,16,31,55,-24,21
CC Mariners,2995,10,4,8,15,28,49,-21,20
Sydney FC,2996,1,20,5,3,64,22,42,65
N'castle Jet,2996,2,16,5,7,61,37,24,53
Melbourne C,2996,3,14,4,11,43,37,6,46
Melbourne V,2996,4,13,6,10,45,38,7,45
Adelaide Utd,2996,5,11,6,11,37,40,-3,39
Brisbane,2996,6,10,5,13,33,42,-9,35
Western Sydn,2996,7,8,9,10,38,47,-9,33
Perth Glory,2996,8,10,2,15,37,50,-13,32
Wellington P,2996,9,5,6,16,31,55,-24,21
CC Mariners,2996,10,4,8,15,28,49,-21,20
Sydney FC,2997,1,20,5,3,65,23,42,65
N'castle Jet,2997,2,16,5,7,59,38,21,53
Melbourne C,2997,3,14,4,11,44,35,9,46
Melbourne V,2997,4,13,6,10,46,39,7,45
Adelaide Utd,2997,5,11,6,11,37,40,-3,39
Brisbane,2997,6,10,5,13,33,42,-9,35
Western Sydn,2997,7,8,9,10,38,47,-9,33
Perth Glory,2997,8,10,2,15,37,50,-13,32
Wellington P,2997,9,5,6,16,31,55,-24,21
CC Mariners,2997,10,4,8,15,28,49,-21,20
Sydney FC,2998,1,21,4,3,67,23,44,67
N'castle Jet,2998,2,16,5,7,59,38,21,53
Melbourne C,2998,3,14,4,11,44,35,9,46
Melbourne V,2998,4,13,5,11,46,41,5,44
Adelaide Utd,2998,5,11,6,11,37,40,-3,39
Brisbane,2998,6,10,5,13,33,42,-9,35
Western Sydn,2998,7,8,9,10,38,47,-9,33
Perth Glory,2998,8,10,2,15,37,50,-13,32
Wellington P,2998,9,5,6,16,31,55,-24,21
CC Mariners,2998,10,4,8,15,28,49,-21,20
Sydney FC,2999,1,21,4,3,68,23,45,67
N'castle Jet,2999,2,15,5,8,57,38,19,50
Melbourne C,2999,3,15,4,10,44,33,11,49
Melbourne V,2999,4,13,5,11,46,42,4,44
Adelaide Utd,2999,5,11,6,11,37,40,-3,39
Brisbane,2999,6,10,5,13,33,42,-9,35
Western Sydn,2999,7,8,9,10,38,47,-9,33
Perth Glory,2999,8,10,2,15,37,50,-13,32
Wellington P,2999,9,5,6,16,31,55,-24,21
CC Mariners,2999,10,4,8,15,28,49,-21,20
Sydney FC,3000,1,21,4,3,66,22,44,67
N'castle Jet,3000,2,15,6,7,59,39,20,51
Melbourne C,3000,3,14,5,10,45,35,10,47
Melbourne V,3000,4,13,5,11,45,40,5,44
Adelaide Utd,3000,5,11,6,11,37,40,-3,39
Brisbane,3000,6,10,5,13,33,42,-9,35
Western Sydn,3000,7,8,9,10,38,47,-9,33
Perth Glory,3000,8,10,2,15,37,50,-13,32
Wellington P,3000,9,5,6,16,31,55,-24,21
CC Mariners,3000,10,4,8,15,28,49,-21,20
Sydney FC,3001,1,20,5,3,66,24,42,65
N'castle Jet,3001,2,16,5,7,60,38,22,53
Melbourne C,3001,3,14,4,11,44,36,8,46
Melbourne V,3001,4,13,6,10,47,40,7,45
Adelaide Utd,3001,5,11,6,11,37,40,-3,39
Brisbane,3001,6,10,5,13,33,42,-9,35
Western Sydn,3001,7,8,9,10,38,47,-9,33
Perth Glory,3001,8,10,2,15,37,50,-13,32
Wellington P,3001,9,5,6,16,31,55,-24,21
CC Mariners,3001,10,4,8,15,28,49,-21,20
Sydney FC,3002,1,20,5,3,64,22,42,65
N'castle Jet,3002,2,16,5,7,58,37,21,53
Melbourne C,3002,3,14,4,11,43,34,9,46
Melbourne V,3002,4,13,6,10,45,38,7,45
Adelaide Utd,3002,5,11,6,11,37,40,-3,39
Brisbane,3002,6,10,5,13,33,42,-9,35
Western Sydn,3002,7,8,9,10,38,47,-9,33
Perth Glory,3002,8,10,2,15,37,50,-13,32
Wellington P,3002,9,5,6,16,31,55,-24,21
CC Mariners,3002,10,4,8,15,28,49,-21,20
Sydney FC,3003,1,21,4,3,67,24,43,67
N'castle Jet,3003,2,16,5,7,60,38,22,53
Melbourne C,3003,3,14,4,11,44,36,8,46
Melbourne V,3003,4,13,5,11,47,41,6,44
Adelaide Utd,3003,5,11,6,11,37,40,-3,39
Brisbane,3003,6,10,5,13,33,42,-9,35
Western Sydn,3003,7,8,9,10,38,47,-9,33
Perth Glory,3003,8,10,2,15,37,50,-13,32
Wellington P,3003,9,5,6,16,31,55,-24,21
CC Mariners,3003,10,4,8,15,28,49,-21,20
Sydney FC,3004,1,21,4,3,67,22,45,67
N'castle Jet,3004,2,16,5,7,60,37,23,53
Melbourne C,3004,3,14,4,11,43,36,7,46
Melbourne V,3004,4,13,5,11,45,41,4,44
Adelaide Utd,3004,5,11,6,11,37,40,-3,39
Brisbane,3004,6,10,5,13,33,42,-9,35
Western Sydn,3004,7,8,9,10,38,47,-9,33
Perth Glory,3004,8,10,2,15,37,50,-13,32
Wellington P,3004,9,5,6,16,31,55,-24,21
CC Mariners,3004,10,4,8,15,28,49,-21,20
Sydney FC,3005,1,20,4,4,65,25,40,64
N'castle Jet,3005,2,15,5,8,58,41,17,50
Melbourne C,3005,3,15,4,10,47,34,13,49
Melbourne V,3005,4,14,5,10,48,39,9,47
Adelaide Utd,3005,5,11,6,11,37,40,-3,39
Brisbane,3005,6,10,5,13,33,42,-9,35
Western Sydn,3005,7,8,9,10,38,47,-9,33
Perth Glory,3005,8,10,2,15,37,50,-13,32
Wellington P,3005,9,5,6,16,31,55,-24,21
CC Mariners,3005,10,4,8,15,28,49,-21,20
Sydney FC,3006,1,20,5,3,67,25,42,65
N'castle Jet,3006,2,15,6,7,60,40,20,51
Melbourne C,3006,3,14,5,10,46,36,10,47
Melbourne V,3006,4,13,6,10,48,41,7,45
Adelaide Utd,3006,5,11,6,11,37,40,-3,39
Brisbane,3006,6,10,5,13,33,42,-9,35
Western Sydn,3006,7,8,9,10,38,47,-9,33
Perth Glory,3006,8,10,2,15,37,50,-13,32
Wellington P,3006,9,5,6,16,31,55,-24,21
CC Mariners,3006,10,4,8,15,28,49,-21,20
Sydney FC,3007,1,20,5,3,66,24,42,65
N'castle Jet,3007,2,15,6,7,57,37,20,51
Melbourne C,3007,3,14,5,10,43,33,10,47
Melbourne V,3007,4,13,6,10,47,40,7,45
Adelaide Utd,3007,5,11,6,11,37,40,-3,39
Brisbane,3007,6,10,5,13,33,42,-9,35
Western Sydn,3007,7,8,9,10,38,47,-9,33
Perth Glory,3007,8,10,2,15,37,50,-13,32
Wellington P,3007,9,5,6,16,31,55,-24,21
CC Mariners,3007,10,4,8,15,28,49,-21,20
Sydney FC,3008,1,21,4,3,66,22,44,67
N'castle Jet,3008,2,15,5,8,58,39,19,50
Melbourne C,3008,3,15,4,10,45,34,11,49
Melbourne V,3008,4,13,5,11,45,40,5,44
Adelaide Utd,3008,5,11,6,11,37,40,-3,39
Brisbane,3008,6,10,5,13,33,42,-9,35
Western Sydn,3008,7,8,9,10,38,47,-9,33
Perth Glory,3008,8,10,2,15,37,50,-13,32
Wellington P,3008,9,5,6,16,31,55,-24,21
CC Mariners,3008,10,4,8,15,28,49,-21,20
Sydney FC,3009,1,20,4,4,65,24,41,64
N'castle Jet,3009,2,16,5,7,59,38,21,53
Melbourne V,3009,3,14,5,10,47,39,8,47
Melbourne C,3009,4,14,4,11,44,35,9,46
Adelaide Utd,3009,5,11,6,11,37,40,-3,39
Brisbane,3009,6,10,5,13,33,42,-9,35
Western Sydn,3009,7,8,9,10,38,47,-9,33
Perth Glory,3009,8,10,2,15,37,50,-13,32
Wellington P,3009,9,5,6,16,31,55,-24,21
CC Mariners,3009,10,4,8,15,28,49,-21,20
Sydney FC,3010,1,21,4,3,67,22,45,67
N'castle Jet,3010,2,15,6,7,58,38,20,51
Melbourne C,3010,3,14,5,10,44,34,10,47
Melbourne V,3010,4,13,5,11,45,41,4,44
Adelaide Utd,3010,5,11,6,11,37,40,-3,39
Brisbane,3010,6,10,5,13,33,42,-9,35
Western Sydn,3010,7,8,9,10,38,47,-9,33
Perth Glory,3010,8,10,2,15,37,50,-13,32
Wellington P,3010,9,5,6,16,31,55,-24,21
CC Mariners,3010,10,4,8,15,28,49,-21,20
Sydney FC,3011,1,21,4,3,66,22,44,67
N'castle Jet,3011,2,15,6,7,58,38,20,51
Melbourne C,3011,3,14,5,10,44,34,10,47
Melbourne V,3011,4,13,5,11,45,40,5,44
Adelaide Utd,3011,5,11,6,11,37,40,-3,39
Brisbane,3011,6,10,5,13,33,42,-9,35
Western Sydn,3011,7,8,9,10,38,47,-9,33
Perth Glory,3011,8,10,2,15,37,50,-13,32
Wellington P,3011,9,5,6,16,31,55,-24,21
CC Mariners,3011,10,4,8,15,28,49,-21,20
Sydney FC,3012,1,21,4,3,69,23,46,67
N'castle Jet,3012,2,15,5,8,57,41,16,50
Melbourne C,3012,3,15,4,10,47,33,14,49
Melbourne V,3012,4,13,5,11,46,43,3,44
Adelaide Utd,3012,5,11,6,11,37,40,-3,39
Brisbane,3012,6,10,5,13,33,42,-9,35
Western Sydn,3012,7,8,9,10,38,47,-9,33
Perth Glory,3012,8,10,2,15,37,50,-13,32
Wellington P,3012,9,5,6,16,31,55,-24,21
CC Mariners,3012,10,4,8,15,28,49,-21,20
Sydney FC,3013,1,20,4,4,64,25,39,64
N'castle Jet,3013,2,16,5,7,59,38,21,53
Melbourne V,3013,3,14,5,10,48,38,10,47
Melbourne C,3013,4,14,4,11,44,35,9,46
Adelaide Utd,3013,5,11,6,11,37,40,-3,39
Brisbane,3013,6,10,5,13,33,42,-9,35
Western Sydn,3013,7,8,9,10,38,47,-9,33
Perth Glory,3013,8,10,2,15,37,50,-13,32
Wellington P,3013,9,5,6,16,31,55,-24,21
CC Mariners,3013,10,4,8,15,28,49,-21,20
Sydney FC,3014,1,21,4,3,66,22,44,67
N'castle Jet,3014,2,15,6,7,59,39,20,51
Melbourne C,3014,3,14,5,10,45,35,10,47
Melbourne V,3014,4,13,5,11,45,40,5,44
Adelaide Utd,3014,5,11,6,11,37,40,-3,39
Brisbane,3014,6,10,5,13,33,42,-9,35
Western Sydn,3014,7,8,9,10,38,47,-9,33
Perth Glory,3014,8,10,2,15,37,50,-13,32
Wellington P,3014,9,5,6,16,31,55,-24,21
CC Mariners,3014,10,4,8,15,28,49,-21,20
Sydney FC,3015,1,21,4,3,66,22,44,67
N'castle Jet,3015,2,15,5,8,58,40,18,50
Melbourne C,3015,3,15,4,10,46,34,12,49
Melbourne V,3015,4,13,5,11,45,40,5,44
Adelaide Utd,3015,5,11,6,11,37,40,-3,39
Brisbane,3015,6,10,5,13,33,42,-9,35
Western Sydn,3015,7,8,9,10,38,47,-9,33
Perth Glory,3015,8,10,2,15,37,50,-13,32
Wellington P,3015,9,5,6,16,31,55,-24,21
CC Mariners,3015,10,4,8,15,28,49,-21,20
Sydney FC,3016,1,20,5,3,65,23,42,65
N'castle Jet,3016,2,16,5,7,59,37,22,53
Melbourne C,3016,3,14,4,11,43,35,8,46
Melbourne V,3016,4,13,6,10,46,39,7,45
Adelaide Utd,3016,5,11,6,11,37,40,-3,39
Brisbane,3016,6,10,5,13,33,42,-9,35
Western Sydn,3016,7,8,9,10,38,47,-9,33
Perth Glory,3016,8,10,2,15,37,50,-13,32
Wellington P,3016,9,5,6,16,31,55,-24,21
CC Mariners,3016,10,4,8,15,28,49,-21,20
Sydney FC,3017,1,21,4,3,65,22,43,67
N'castle Jet,3017,2,15,6,7,57,37,20,51
Melbourne C,3017,3,14,5,10,43,33,10,47
Melbourne V,3017,4,13,5,11,45,39,6,44
Adelaide Utd,3017,5,11,6,11,37,40,-3,39
Brisbane,3017,6,10,5,13,33,42,-9,35
Western Sydn,3017,7,8,9,10,38,47,-9,33
Perth Glory,3017,8,10,2,15,37,50,-13,32
Wellington P,3017,9,5,6,16,31,55,-24,21
CC Mariners,3017,10,4,8,15,28,49,-21,20
Sydney FC,3018,1,20,5,3,64,22,42,65
N'castle Jet,3018,2,15,5,8,57,43,14,50
Melbourne C,3018,3,15,4,10,49,33,16,49
Melbourne V,3018,4,13,6,10,45,38,7,45
Adelaide Utd,3018,5,11,6,11,37,40,-3,39
Brisbane,3018,6,10,5,13,33,42,-9,35
Western Sydn,3018,7,8,9,10,38,47,-9,33
Perth Glory,3018,8,10,2,15,37,50,-13,32
Wellington P,3018,9,5,6,16,31,55,-24,21
CC Mariners,3018,10,4,8,15,28,49,-21,20
Sydney FC,3019,1,20,4,4,65,24,41,64
N'castle Jet,3019,2,15,5,8,58,39,19,50
Melbourne C,3019,3,15,4,10,45,34,11,49
Melbourne V,3019,4,14,5,10,47,39,8,47
Adelaide Utd,3019,5,11,6,11,37,40,-3,39
Brisbane,3019,6,10,5,13,33,42,-9,35
Western Sydn,3019,7,8,9,10,38,47,-9,33
Perth Glory,3019,8,10,2,15,37,50,-13,32
Wellington P,3019,9,5,6,16,31,55,-24,21
CC Mariners,3019,10,4,8,15,28,49,-21,20
Sydney FC,3020,1,21,4,3,66,23,43,67
N'castle Jet,3020,2,15,6,7,58,38,20,51
Melbourne C,3020,3,14,5,10,44,34,10,47
Melbourne V,3020,4,13,5,11,46,40,6,44
Adelaide Utd,3020,5,11,6,11,37,40,-3,39
Brisbane,3020,6,10,5,13,33,42,-9,35
Western Sydn,3020,7,8,9,10,38,47,-9,33
Perth Glory,3020,8,10,2,15,37,50,-13,32
Wellington P,3020,9,5,6,16,31,55,-24,21
CC Mariners,3020,10,4,8,15,28,49,-21,20
Sydney FC,3021,1,20,4,4,64,25,39,64
N'castle Jet,3021,2,16,5,7,60,38,22,53
Melbourne V,3021,3,14,5,10,48,38,10,47
Melbourne C,3021,4,14,4,11,44,36,8,46
Adelaide Utd,3021,5,11,6,11,37,40,-3,39
Brisbane,3021,6,10,5,13,33,42,-9,35
Western Sydn,3021,7,8,9,10,38,47,-9,33
Perth Glory,3021,8,10,2,15,37,50,-13,32
Wellington P,3021,9,5,6,16,31,55,-24,21
CC Mariners,3021,10,4,8,15,28,49,-21,20
Sydney FC,3022,1,20,5,3,65,23,42,65
N'castle Jet,3022,2,15,5,8,59,40,19,50
Melbourne C,3022,3,15,4,10,46,35,11,49
Melbourne V,3022,4,13,6,10,46,39,7,45
Adelaide Utd,3022,5,11,6,11,37,40,-3,39
Brisbane,3022,6,10,5,13,33,42,-9,35
Western Sydn,3022,7,8,9,10,38,47,-9,33
Perth Glory,3022,8,10,2,15,37,50,-13,32
Wellington P,3022,9,5,6,16,31,55,-24,21
CC Mariners,3022,10,4,8,15,28,49,-21,20
Sydney FC,3023,1,21,4,3,65,22,43,67
N'castle Jet,3023,2,15,5,8,59,40,19,50
Melbourne C,3023,3,15,4,10,46,35,11,49
Melbourne V,3023,4,13,5,11,45,39,6,44
Adelaide Utd,3023,5,11,6,11,37,40,-3,39
Brisbane,3023,6,10,5,13,33,42,-9,35
Western Sydn,3023,7,8,9,10,38,47,-9,33
Perth Glory,3023,8,10,2,15,37,50,-13,32
Wellington P,3023,9,5,6,16,31,55,-24,21
CC Mariners,3023,10,4,8,15,28,49,-21,20
Sydney FC,3024,1,20,4,4,65,25,40,64
N'castle Jet,3024,2,15,6,7,58,38,20,51
Melbourne C,3024,3,14,5,10,44,34,10,47
Melbourne V,3024,4,14,5,10,48,39,9,47
Adelaide Utd,3024,5,11,6,11,37,40,-3,39
Brisbane,3024,6,10,5,13,33,42,-9,35
Western Sydn,3024,7,8,9,10,38,47,-9,33
Perth Glory,3024,8,10,2,15,37,50,-13,32
Wellington P,3024,9,5,6,16,31,55,-24,21
CC Mariners,3024,10,4,8,15,28,49,-21,20
Sydney FC,3025,1,20,5,3,65,23,42,65
N'castle Jet,3025,2,15,5,8,57,42,15,50
Melbourne C,3025,3,15,4,10,48,33,15,49
Melbourne V,3025,4,13,6,10,46,39,7,45
Adelaide Utd,3025,5,11,6,11,37,40,-3,39
Brisbane,3025,6,10,5,13,33,42,-9,35
Western Sydn,3025,7,8,9,10,38,47,-9,33
Perth Glory,3025,8,10,2,15,37,50,-13,32
Wellington P,3025,9,5,6,16,31,55,-24,21
CC Mariners,3025,10,4,8,15,28,49,-21,20
Sydney FC,3026,1,20,5,3,65,23,42,65
N'castle Jet,3026,2,16,5,7,60,37,23,53
Melbourne C,3026,3,14,4,11,43,36,7,46
Melbourne V,3026,4,13,6,10,46,39,7,45
Adelaide Utd,3026,5,11,6,11,37,40,-3,39
Brisbane,3026,6,10,5,13,33,42,-9,35
Western Sydn,3026,7,8,9,10,38,47,-9,33
Perth Glory,3026,8,10,2,15,37,50,-13,32
Wellington P,3026,9,5,6,16,31,55,-24,21
CC Mariners,3026,10,4,8,15,28,49,-21,20
Sydney FC,3027,1,21,4,3,68,23,45,67
N'castle Jet,3027,2,16,5,7,61,38,23,53
Melbourne C,3027,3,14,4,11,44,37,7,46
Melbourne V,3027,4,13,5,11,46,42,4,44
Adelaide Utd,3027,5,11,6,11,37,40,-3,39
Brisbane,3027,6,10,5,13,33,42,-9,35
Western Sydn,3027,7,8,9,10,38,47,-9,33
Perth Glory,3027,8,10,2,15,37,50,-13,32
Wellington P,3027,9,5,6,16,31,55,-24,21
CC Mariners,3027,10,4,8,15,28,49,-21,20
Sydney FC,3028,1,20,4,4,65,24,41,64
N'castle Jet,3028,2,16,5,7,58,37,21,53
Melbourne V,3028,3,14,5,10,47,39,8,47
Melbourne C,3028,4,14,4,11,43,34,9,46
Adelaide Utd,3028,5,11,6,11,37,40,-3,39
Brisbane,3028,6,10,5,13,33,42,-9,35
Western Sydn,3028,7,8,9,10,38,47,-9,33
Perth Glory,3028,8,10,2,15,37,50,-13,32
Wellington P,3028,9,5,6,16,31,55,-24,21
CC Mariners,3028,10,4,8,15,28,49,-21,20
Sydney FC,3029,1,21,4,3,67,23,44,67
N'castle Jet,3029,2,15,5,8,57,40,17,50
Melbourne C,3029,3,15,4,10,46,33,13,49
Melbourne V,3029,4,13,5,11,46,41,5,44
Adelaide Utd,3029,5,11,6,11,37,40,-3,39
Brisbane,3029,6,10,5,13,33,42,-9,35
Western Sydn,3029,7,8,9,10,38,47,-9,33
Perth Glory,3029,8,10,2,15,37,50,-13,32
Wellington P,3029,9,5,6,16,31,55,-24,21
CC Mariners,3029,10,4,8,15,28,49,-21,20
Sydney FC,3030,1,21,4,3,67,22,45,67
N'castle Jet,3030,2,15,6,7,58,38,20,51
Melbourne C,3030,3,14,5,10,44,34,10,47
Melbourne V,3030,4,13,5,11,45,41,4,44
Adelaide Utd,3030,5,11,6,11,37,40,-3,39
Brisbane,3030,6,10,5,13,33,42,-9,35
Western Sydn,3030,7,8,9,10,38,47,-9,33
Perth Glory,3030,8,10,2,15,37,50,-13,32
Wellington P,3030,9,5,6,16,31,55,-24,21
CC Mariners,3030,10,4,8,15,28,49,-21,20
Sydney FC,3031,1,21,4,3,66,22,44,67
N'castle Jet,3031,2,16,5,7,58,37,21,53
Melbourne C,3031,3,14,4,11,43,34,9,46
Melbourne V,3031,4,13,5,11,45,40,5,44
Adelaide Utd,3031,5,11,6,11,37,40,-3,39
Brisbane,3031,6,10,5,13,33,42,-9,35
Western Sydn,3031,7,8,9,10,38,47,-9,33
Perth Glory,3031,8,10,2,15,37,50,-13,32
Wellington P,3031,9,5,6,16,31,55,-24,21
CC Mariners,3031,10,4,8,15,28,49,-21,20
Sydney FC,3032,1,20,5,3,65,23,42,65
N'castle Jet,3032,2,16,5,7,58,37,21,53
Melbourne C,3032,3,14,4,11,43,34,9,46
Melbourne V,3032,4,13,6,10,46,39,7,45
Adelaide Utd,3032,5,11,6,11,37,40,-3,39
Brisbane,3032,6,10,5,13,33,42,-9,35
Western Sydn,3032,7,8,9,10,38,47,-9,33
Perth Glory,3032,8,10,2,15,37,50,-13,32
Wellington P,3032,9,5,6,16,31,55,-24,21
CC Mariners,3032,10,4,8,15,28,49,-21,20
Sydney FC,3033,1,21,4,3,67,23,44,67
N'castle Jet,3033,2,15,6,7,58,38,20,51
Melbourne C,3033,3,14,5,10,44,34,10,47
Melbourne V,3033,4,13,5,11,46,41,5,44
Adelaide Utd,3033,5,11,6,11,37,40,-3,39
Brisbane,3033,6,10,5,13,33,42,-9,35
Western Sydn,3033,7,8,9,10,38,47,-9,33
Perth Glory,3033,8,10,2,15,37,50,-13,32
Wellington P,3033,9,5,6,16,31,55,-24,21
CC Mariners,3033,10,4,8,15,28,49,-21,20
Sydney FC,3034,1,21,4,3,66,23,43,67
N'castle Jet,3034,2,15,5,8,58,39,19,50
Melbourne C,3034,3,15,4,10,45,34,11,49
Melbourne V,3034,4,13,5,11,46,40,6,44
Adelaide Utd,3034,5,11,6,11,37,40,-3,39
Brisbane,3034,6,10,5,13,33,42,-9,35
Western Sydn,3034,7,8,9,10,38,47,-9,33
Perth Glory,3034,8,10,2,15,37,50,-13,32
Wellington P,3034,9,5,6,16,31,55,-24,21
CC Mariners,3034,10,4,8,15,28,49,-21,20
Sydney FC,3035,1,20,5,3,64,22,42,65
N'castle Jet,3035,2,16,5,7,59,38,21,53
Melbourne C,3035,3,14,4,11,44,35,9,46
Melbourne V,3035,4,13,6,10,45,38,7,45
Adelaide Utd,3035,5,11,6,11,37,40,-3,39
Brisbane,3035,6,10,5,13,33,42,-9,35
Western Sydn,3035,7,8,9,10,38,47,-9,33
Perth Glory,3035,8,10,2,15,37,50,-13,32
Wellington P,3035,9,5,6,16,31,55,-24,21
CC Mariners,3035,10,4,8,15,28,49,-21,20
Sydney FC,3036,1,20,5,3,65,23,42,65
N'castle Jet,3036,2,15,5,8,57,38,19,50
Melbourne C,3036,3,15,4,10,44,33,11,49
Melbourne V,3036,4,13,6,10,46,39,7,45
Adelaide Utd,3036,5,11,6,11,37,40,-3,39
Brisbane,3036,6,10,5,13,33,42,-9,35
Western Sydn,3036,7,8,9,10,38,47,-9,33
Perth Glory,3036,8,10,2,15,37,50,-13,32
Wellington P,3036,9,5,6,16,31,55,-24,21
CC Mariners,3036,10,4,8,15,28,49,-21,20
Sydney FC,3037,1,21,4,3,67,22,45,67
N'castle Jet,3037,2,15,5,8,58,39,19,50
Melbourne C,3037,3,15,4,10,45,34,11,49
Melbourne V,3037,4,13,5,11,45,41,4,44
Adelaide Utd,3037,5,11,6,11,37,40,-3,39
Brisbane,3037,6,10,5,13,33,42,-9,35
Western Sydn,3037,7,8,9,10,38,47,-9,33
Perth Glory,3037,8,10,2,15,37,50,-13,32
Wellington P,3037,9,5,6,16,31,55,-24,21
CC Mariners,3037,10,4,8,15,28,49,-21,20
Sydney FC,3038,1,21,4,3,66,23,43,67
N'castle Jet,3038,2,15,5,8,57,38,19,50
Melbourne C,3038,3,15,4,10,44,33,11,49
Melbourne V,3038,4,13,5,11,46,40,6,44
Adelaide Utd,3038,5,11,6,11,37,40,-3,39
Brisbane,3038,6,10,5,13,33,42,-9,35
Western Sydn,3038,7,8,9,10,38,47,-9,33
Perth Glory,3038,8,10,2,15,37,50,-13,32
Wellington P,3038,9,5,6,16,31,55,-24,21
CC Mariners,3038,10,4,8,15,28,49,-21,20
Sydney FC,3039,1,21,4,3,67,23,44,67
N'castle Jet,3039,2,15,5,8,57,39,18,50
Melbourne C,3039,3,15,4,10,45,33,12,49
Melbourne V,3039,4,13,5,11,46,41,5,44
Adelaide Utd,3039,5,11,6,11,37,40,-3,39
Brisbane,3039,6,10,5,13,33,42,-9,35
Western Sydn,3039,7,8,9,10,38,47,-9,33
Perth Glory,3039,8,10,2,15,37,50,-13,32
Wellington P,3039,9,5,6,16,31,55,-24,21
CC Mariners,3039,10,4,8,15,28,49,-21,20
Sydney FC,3040,1,21,4,3,72,22,50,67
N'castle Jet,3040,2,16,5,7,63,38,25,53
Melbourne C,3040,3,14,4,11,44,39,5,46
Melbourne V,3040,4,13,5,11,45,46,-1,44
Adelaide Utd,3040,5,11,6,11,37,40,-3,39
Brisbane,3040,6,10,5,13,33,42,-9,35
Western Sydn,3040,7,8,9,10,38,47,-9,33
Perth Glory,3040,8,10,2,15,37,50,-13,32
Wellington P,3040,9,5,6,16,31,55,-24,21
CC Mariners,3040,10,4,8,15,28,49,-21,20
Sydney FC,3041,1,21,4,3,66,23,43,67
N'castle Jet,3041,2,16,5,7,61,38,23,53
Melbourne C,3041,3,14,4,11,44,37,7,46
Melbourne V,3041,4,13,5,11,46,40,6,44
Adelaide Utd,3041,5,11,6,11,37,40,-3,39
Brisbane,3041,6,10,5,13,33,42,-9,35
Western Sydn,3041,7,8,9,10,38,47,-9,33
Perth Glory,3041,8,10,2,15,37,50,-13,32
Wellington P,3041,9,5,6,16,31,55,-24,21
CC Mariners,3041,10,4,8,15,28,49,-21,20
Sydney FC,3042,1,21,4,3,67,22,45,67
N'castle Jet,3042,2,15,6,7,58,38,20,51
Melbourne C,3042,3,14,5,10,44,34,10,47
Melbourne V,3042,4,13,5,11,45,41,4,44
Adelaide Utd,3042,5,11,6,11,37,40,-3,39
Brisbane,3042,6,10,5,13,33,42,-9,35
Western Sydn,3042,7,8,9,10,38,47,-9,33
Perth Glory,3042,8,10,2,15,37,50,-13,32
Wellington P,3042,9,5,6,16,31,55,-24,21
CC Mariners,3042,10,4,8,15,28,49,-21,20
Sydney FC,3043,1,21,4,3,67,22,45,67
N'castle Jet,3043,2,16,5,7,62,38,24,53
Melbourne C,3043,3,14,4,11,44,38,6,46
Melbourne V,3043,4,13,5,11,45,41,4,44
Adelaide Utd,3043,5,11,6,11,37,40,-3,39
Brisbane,3043,6,10,5,13,33,42,-9,35
Western Sydn,3043,7,8,9,10,38,47,-9,33
Perth Glory,3043,8,10,2,15,37,50,-13,32
Wellington P,3043,9,5,6,16,31,55,-24,21
CC Mariners,3043,10,4,8,15,28,49,-21,20
Sydney FC,3044,1,21,4,3,65,22,43,67
N'castle Jet,3044,2,16,5,7,61,38,23,53
Melbourne C,3044,3,14,4,11,44,37,7,46
Melbourne V,3044,4,13,5,11,45,39,6,44
Adelaide Utd,3044,5,11,6,11,37,40,-3,39
Brisbane,3044,6,10,5,13,33,42,-9,35
Western Sydn,3044,7,8,9,10,38,47,-9,33
Perth Glory,3044,8,10,2,15,37,50,-13,32
Wellington P,3044,9,5,6,16,31,55,-24,21
CC Mariners,3044,10,4,8,15,28,49,-21,20
Sydney FC,3045,1,21,4,3,68,23,45,67
N'castle Jet,3045,2,16,5,7,60,38,22,53
Melbourne C,3045,3,14,4,11,44,36,8,46
Melbourne V,3045,4,13,5,11,46,42,4,44
Adelaide Utd,3045,5,11,6,11,37,40,-3,39
Brisbane,3045,6,10,5,13,33,42,-9,35
Western Sydn,3045,7,8,9,10,38,47,-9,33
Perth Glory,3045,8,10,2,15,37,50,-13,32
Wellington P,3045,9,5,6,16,31,55,-24,21
CC Mariners,3045,10,4,8,15,28,49,-21,20
Sydney FC,3046,1,21,4,3,69,24,45,67
N'castle Jet,3046,2,15,6,7,58,38,20,51
Melbourne C,3046,3,14,5,10,44,34,10,47
Melbourne V,3046,4,13,5,11,47,43,4,44
Adelaide Utd,3046,5,11,6,11,37,40,-3,39
Brisbane,3046,6,10,5,13,33,42,-9,35
Western Sydn,3046,7,8,9,10,38,47,-9,33
Perth Glory,3046,8,10,2,15,37,50,-13,32
Wellington P,3046,9,5,6,16,31,55,-24,21
CC Mariners,3046,10,4,8,15,28,49,-21,20
Sydney FC,3047,1,21,4,3,68,22,46,67
N'castle Jet,3047,2,15,6,7,57,37,20,51
Melbourne C,3047,3,14,5,10,43,33,10,47
Melbourne V,3047,4,13,5,11,45,42,3,44
Adelaide Utd,3047,5,11,6,11,37,40,-3,39
Brisbane,3047,6,10,5,13,33,42,-9,35
Western Sydn,3047,7,8,9,10,38,47,-9,33
Perth Glory,3047,8,10,2,15,37,50,-13,32
Wellington P,3047,9,5,6,16,31,55,-24,21
CC Mariners,3047,10,4,8,15,28,49,-21,20
Sydney FC,3048,1,21,4,3,68,22,46,67
N'castle Jet,3048,2,15,5,8,57,38,19,50
Melbourne C,3048,3,15,4,10,44,33,11,49
Melbourne V,3048,4,13,5,11,45,42,3,44
Adelaide Utd,3048,5,11,6,11,37,40,-3,39
Brisbane,3048,6,10,5,13,33,42,-9,35
Western Sydn,3048,7,8,9,10,38,47,-9,33
Perth Glory,3048,8,10,2,15,37,50,-13,32
Wellington P,3048,9,5,6,16,31,55,-24,21
CC Mariners,3048,10,4,8,15,28,49,-21,20
Sydney FC,3049,1,21,4,3,65,22,43,67
N'castle Jet,3049,2,15,5,8,58,39,19,50
Melbourne C,3049,3,15,4,10,45,34,11,49
Melbourne V,3049,4,13,5,11,45,39,6,44
Adelaide Utd,3049,5,11,6,11,37,40,-3,39
Brisbane,3049,6,10,5,13,33,42,-9,35
Western Sydn,3049,7,8,9,10,38,47,-9,33
Perth Glory,3049,8,10,2,15,37,50,-13,32
Wellington P,3049,9,5,6,16,31,55,-24,21
CC Mariners,3049,10,4,8,15,28,49,-21,20
Sydney FC,3050,1,20,4,4,65,24,41,64
N'castle Jet,3050,2,15,5,8,57,38,19,50
Melbourne C,3050,3,15,4,10,44,33,11,49
Melbourne V,3050,4,14,5,10,47,39,8,47
Adelaide Utd,3050,5,11,6,11,37,40,-3,39
Brisbane,3050,6,10,5,13,33,42,-9,35
Western Sydn,3050,7,8,9,10,38,47,-9,33
Perth Glory,3050,8,10,2,15,37,50,-13,32
Wellington P,3050,9,5,6,16,31,55,-24,21
CC Mariners,3050,10,4,8,15,28,49,-21,20
Sydney FC,3051,1,20,4,4,64,23,41,64
N'castle Jet,3051,2,15,6,7,59,39,20,51
Melbourne C,3051,3,14,5,10,45,35,10,47
Melbourne V,3051,4,14,5,10,46,38,8,47
Adelaide Utd,3051,5,11,6,11,37,40,-3,39
Brisbane,3051,6,10,5,13,33,42,-9,35
Western Sydn,3051,7,8,9,10,38,47,-9,33
Perth Glory,3051,8,10,2,15,37,50,-13,32
Wellington P,3051,9,5,6,16,31,55,-24,21
CC Mariners,3051,10,4,8,15,28,49,-21,20
Sydney FC,3052,1,20,4,4,64,23,41,64
N'castle Jet,3052,2,16,5,7,59,37,22,53
Melbourne V,3052,3,14,5,10,46,38,8,47
Melbourne C,3052,4,14,4,11,43,35,8,46
Adelaide Utd,3052,5,11,6,11,37,40,-3,39
Brisbane,3052,6,10,5,13,33,42,-9,35
Western Sydn,3052,7,8,9,10,38,47,-9,33
Perth Glory,3052,8,10,2,15,37,50,-13,32
Wellington P,3052,9,5,6,16,31,55,-24,21
CC Mariners,3052,10,4,8,15,28,49,-21,20
Sydney FC,3053,1,21,4,3,66,23,43,67
N'castle Jet,3053,2,16,5,7,59,37,22,53
Melbourne C,3053,3,14,4,11,43,35,8,46
Melbourne V,3053,4,13,5,11,46,40,6,44
Adelaide Utd,3053,5,11,6,11,37,40,-3,39
Brisbane,3053,6,10,5,13,33,42,-9,35
Western Sydn,3053,7,8,9,10,38,47,-9,33
Perth Glory,3053,8,10,2,15,37,50,-13,32
Wellington P,3053,9,5,6,16,31,55,-24,21
CC Mariners,3053,10,4,8,15,28,49,-21,20
Sydney FC,3054,1,20,4,4,65,24,41,64
N'castle Jet,3054,2,15,5,8,57,38,19,50
Melbourne C,3054,3,15,4,10,44,33,11,49
Melbourne V,3054,4,14,5,10,47,39,8,47
Adelaide Utd,3054,5,11,6,11,37,40,-3,39
Brisbane,3054,6,10,5,13,33,42,-9,35
Western Sydn,3054,7,8,9,10,38,47,-9,33
Perth Glory,3054,8,10,2,15,37,50,-13,32
Wellington P,3054,9,5,6,16,31,55,-24,21
CC Mariners,3054,10,4,8,15,28,49,-21,20
Sydney FC,3055,1,20,5,3,65,23,42,65
N'castle Jet,3055,2,15,5,8,57,38,19,50
Melbourne C,3055,3,15,4,10,44,33,11,49
Melbourne V,3055,4,13,6,10,46,39,7,45
Adelaide Utd,3055,5,11,6,11,37,40,-3,39
Brisbane,3055,6,10,5,13,33,42,-9,35
Western Sydn,3055,7,8,9,10,38,47,-9,33
Perth Glory,3055,8,10,2,15,37,50,-13,32
Wellington P,3055,9,5,6,16,31,55,-24,21
CC Mariners,3055,10,4,8,15,28,49,-21,20
Sydney FC,3056,1,21,4,3,66,23,43,67
N'castle Jet,3056,2,16,5,7,59,37,22,53
Melbourne C,3056,3,14,4,11,43,35,8,46
Melbourne V,3056,4,13,5,11,46,40,6,44
Adelaide Utd,3056,5,11,6,11,37,40,-3,39
Brisbane,3056,6,10,5,13,33,42,-9,35
Western Sydn,3056,7,8,9,10,38,47,-9,33
Perth Glory,3056,8,10,2,15,37,50,-13,32
Wellington P,3056,9,5,6,16,31,55,-24,21
CC Mariners,3056,10,4,8,15,28,49,-21,20
Sydney FC,3057,1,20,5,3,64,22,42,65
N'castle Jet,3057,2,16,5,7,62,39,23,53
Melbourne C,3057,3,14,4,11,45,38,7,46
Melbourne V,3057,4,13,6,10,45,38,7,45
Adelaide Utd,3057,5,11,6,11,37,40,-3,39
Brisbane,3057,6,10,5,13,33,42,-9,35
Western Sydn,3057,7,8,9,10,38,47,-9,33
Perth Glory,3057,8,10,2,15,37,50,-13,32
Wellington P,3057,9,5,6,16,31,55,-24,21
CC Mariners,3057,10,4,8,15,28,49,-21,20
Sydney FC,3058,1,21,4,3,67,22,45,67
N'castle Jet,3058,2,15,5,8,59,40,19,50
Melbourne C,3058,3,15,4,10,46,35,11,49
Melbourne V,3058,4,13,5,11,45,41,4,44
Adelaide Utd,3058,5,11,6,11,37,40,-3,39
Brisbane,3058,6,10,5,13,33,42,-9,35
Western Sydn,3058,7,8,9,10,38,47,-9,33
Perth Glory,3058,8,10,2,15,37,50,-13,32
Wellington P,3058,9,5,6,16,31,55,-24,21
CC Mariners,3058,10,4,8,15,28,49,-21,20
Sydney FC,3059,1,20,5,3,65,23,42,65
N'castle Jet,3059,2,15,6,7,59,39,20,51
Melbourne C,3059,3,14,5,10,45,35,10,47
Melbourne V,3059,4,13,6,10,46,39,7,45
Adelaide Utd,3059,5,11,6,11,37,40,-3,39
Brisbane,3059,6,10,5,13,33,42,-9,35
Western Sydn,3059,7,8,9,10,38,47,-9,33
Perth Glory,3059,8,10,2,15,37,50,-13,32
Wellington P,3059,9,5,6,16,31,55,-24,21
CC Mariners,3059,10,4,8,15,28,49,-21,20
Sydney FC,3060,1,20,4,4,65,24,41,64
N'castle Jet,3060,2,15,6,7,58,38,20,51
Melbourne C,3060,3,14,5,10,44,34,10,47
Melbourne V,3060,4,14,5,10,47,39,8,47
Adelaide Utd,3060,5,11,6,11,37,40,-3,39
Brisbane,3060,6,10,5,13,33,42,-9,35
Western Sydn,3060,7,8,9,10,38,47,-9,33
Perth Glory,3060,8,10,2,15,37,50,-13,32
Wellington P,3060,9,5,6,16,31,55,-24,21
CC Mariners,3060,10,4,8,15,28,49,-21,20
Sydney FC,3061,1,21,4,3,67,23,44,67
N'castle Jet,3061,2,16,5,7,58,37,21,53
Melbourne C,3061,3,14,4,11,43,34,9,46
Melbourne V,3061,4,13,5,11,46,41,5,44
Adelaide Utd,3061,5,11,6,11,37,40,-3,39
Brisbane,3061,6,10,5,13,33,42,-9,35
Western Sydn,3061,7,8,9,10,38,47,-9,33
Perth Glory,3061,8,10,2,15,37,50,-13,32
Wellington P,3061,9,5,6,16,31,55,-24,21
CC Mariners,3061,10,4,8,15,28,49,-21,20
Sydney FC,3062,1,21,4,3,66,22,44,67
N'castle Jet,3062,2,16,5,7,60,38,22,53
Melbourne C,3062,3,14,4,11,44,36,8,46
Melbourne V,3062,4,13,5,11,45,40,5,44
Adelaide Utd,3062,5,11,6,11,37,40,-3,39
Brisbane,3062,6,10,5,13,33,42,-9,35
Western Sydn,3062,7,8,9,10,38,47,-9,33
Perth Glory,3062,8,10,2,15,37,50,-13,32
Wellington P,3062,9,5,6,16,31,55,-24,21
CC Mariners,3062,10,4,8,15,28,49,-21,20
Sydney FC,3063,1,21,4,3,70,22,48,67
N'castle Jet,3063,2,16,5,7,62,39,23,53
Melbourne C,3063,3,14,4,11,45,38,7,46
Melbourne V,3063,4,13,5,11,45,44,1,44
Adelaide Utd,3063,5,11,6,11,37,40,-3,39
Brisbane,3063,6,10,5,13,33,42,-9,35
Western Sydn,3063,7,8,9,10,38,47,-9,33
Perth Glory,3063,8,10,2,15,37,50,-13,32
Wellington P,3063,9,5,6,16,31,55,-24,21
CC Mariners,3063,10,4,8,15,28,49,-21,20
Sydney FC,3064,1,21,4,3,71,23,48,67
N'castle Jet,3064,2,16,5,7,60,37,23,53
Melbourne C,3064,3,14,4,11,43,36,7,46
Melbourne V,3064,4,13,5,11,46,45,1,44
Adelaide Utd,3064,5,11,6,11,37,40,-3,39
Brisbane,3064,6,10,5,13,33,42,-9,35
Western Sydn,3064,7,8,9,10,38,47,-9,33
Perth Glory,3064,8,10,2,15,37,50,-13,32
Wellington P,3064,9,5,6,16,31,55,-24,21
CC Mariners,3064,10,4,8,15,28,49,-21,20
Sydney FC,3065,1,20,4,4,65,24,41,64
N'castle Jet,3065,2,15,6,7,58,38,20,51
Melbourne C,3065,3,14,5,10,44,34,10,47
Melbourne V,3065,4,14,5,10,47,39,8,47
Adelaide Utd,3065,5,11,6,11,37,40,-3,39
Brisbane,3065,6,10,5,13,33,42,-9,35
Western Sydn,3065,7,8,9,10,38,47,-9,33
Perth Glory,3065,8,10,2,15,37,50,-13,32
Wellington P,3065,9,5,6,16,31,55,-24,21
CC Mariners,3065,10,4,8,15,28,49,-21,20
Sydney FC,3066,1,21,4,3,68,22,46,67
N'castle Jet,3066,2,15,6,7,59,39,20,51
Melbourne C,3066,3,14,5,10,45,35,10,47
Melbourne V,3066,4,13,5,11,45,42,3,44
Adelaide Utd,3066,5,11,6,11,37,40,-3,39
Brisbane,3066,6,10,5,13,33,42,-9,35
Western Sydn,3066,7,8,9,10,38,47,-9,33
Perth Glory,3066,8,10,2,15,37,50,-13,32
Wellington P,3066,9,5,6,16,31,55,-24,21
CC Mariners,3066,10,4,8,15,28,49,-21,20
Sydney FC,3067,1,21,4,3,67,22,45,67
N'castle Jet,3067,2,16,5,7,58,37,21,53
Melbourne C,3067,3,14,4,11,43,34,9,46
Melbourne V,3067,4,13,5,11,45,41,4,44
Adelaide Utd,3067,5,11,6,11,37,40,-3,39
Brisbane,3067,6,10,5,13,33,42,-9,35
Western Sydn,3067,7,8,9,10,38,47,-9,33
Perth Glory,3067,8,10,2,15,37,50,-13,32
Wellington P,3067,9,5,6,16,31,55,-24,21
CC Mariners,3067,10,4,8,15,28,49,-21,20
Sydney FC,3068,1,20,4,4,64,23,41,64
N'castle Jet,3068,2,15,5,8,59,41,18,50
Melbourne C,3068,3,15,4,10,47,35,12,49
Melbourne V,3068,4,14,5,10,46,38,8,47
Adelaide Utd,3068,5,11,6,11,37,40,-3,39
Brisbane,3068,6,10,5,13,33,42,-9,35
Western Sydn,3068,7,8,9,10,38,47,-9,33
Perth Glory,3068,8,10,2,15,37,50,-13,32
Wellington P,3068,9,5,6,16,31,55,-24,21
CC Mariners,3068,10,4,8,15,28,49,-21,20
Sydney FC,3069,1,20,5,3,65,23,42,65
N'castle Jet,3069,2,16,5,7,60,39,21,53
Melbourne C,3069,3,14,4,11,45,36,9,46
Melbourne V,3069,4,13,6,10,46,39,7,45
Adelaide Utd,3069,5,11,6,11,37,40,-3,39
Brisbane,3069,6,10,5,13,33,42,-9,35
Western Sydn,3069,7,8,9,10,38,47,-9,33
Perth Glory,3069,8,10,2,15,37,50,-13,32
Wellington P,3069,9,5,6,16,31,55,-24,21
CC Mariners,3069,10,4,8,15,28,49,-21,20
Sydney FC,3070,1,21,4,3,67,22,45,67
N'castle Jet,3070,2,16,5,7,59,37,22,53
Melbourne C,3070,3,14,4,11,43,35,8,46
Melbourne V,3070,4,13,5,11,45,41,4,44
Adelaide Utd,3070,5,11,6,11,37,40,-3,39
Brisbane,3070,6,10,5,13,33,42,-9,35
Western Sydn,3070,7,8,9,10,38,47,-9,33
Perth Glory,3070,8,10,2,15,37,50,-13,32
Wellington P,3070,9,5,6,16,31,55,-24,21
CC Mariners,3070,10,4,8,15,28,49,-21,20
Sydney FC,3071,1,21,4,3,67,23,44,67
N'castle Jet,3071,2,15,5,8,57,38,19,50
Melbourne C,3071,3,15,4,10,44,33,11,49
Melbourne V,3071,4,13,5,11,46,41,5,44
Adelaide Utd,3071,5,11,6,11,37,40,-3,39
Brisbane,3071,6,10,5,13,33,42,-9,35
Western Sydn,3071,7,8,9,10,38,47,-9,33
Perth Glory,3071,8,10,2,15,37,50,-13,32
Wellington P,3071,9,5,6,16,31,55,-24,21
CC Mariners,3071,10,4,8,15,28,49,-21,20
Sydney FC,3072,1,21,4,3,65,22,43,67
N'castle Jet,3072,2,16,5,7,58,37,21,53
Melbourne C,3072,3,14,4,11,43,34,9,46
Melbourne V,3072,4,13,5,11,45,39,6,44
Adelaide Utd,3072,5,11,6,11,37,40,-3,39
Brisbane,3072,6,10,5,13,33,42,-9,35
Western Sydn,3072,7,8,9,10,38,47,-9,33
Perth Glory,3072,8,10,2,15,37,50,-13,32
Wellington P,3072,9,5,6,16,31,55,-24,21
CC Mariners,3072,10,4,8,15,28,49,-21,20
Sydney FC,3073,1,20,5,3,65,23,42,65
N'castle Jet,3073,2,15,5,8,58,39,19,50
Melbourne C,3073,3,15,4,10,45,34,11,49
Melbourne V,3073,4,13,6,10,46,39,7,45
Adelaide Utd,3073,5,11,6,11,37,40,-3,39
Brisbane,3073,6,10,5,13,33,42,-9,35
Western Sydn,3073,7,8,9,10,38,47,-9,33
Perth Glory,3073,8,10,2,15,37,50,-13,32
Wellington P,3073,9,5,6,16,31,55,-24,21
CC Mariners,3073,10,4,8,15,28,49,-21,20
Sydney FC,3074,1,20,5,3,66,24,42,65
N'castle Jet,3074,2,15,5,8,58,39,19,50
Melbourne C,3074,3,15,4,10,45,34,11,49
Melbourne V,3074,4,13,6,10,47,40,7,45
Adelaide Utd,3074,5,11,6,11,37,40,-3,39
Brisbane,3074,6,10,5,13,33,42,-9,35
Western Sydn,3074,7,8,9,10,38,47,-9,33
Perth Glory,3074,8,10,2,15,37,50,-13,32
Wellington P,3074,9,5,6,16,31,55,-24,21
CC Mariners,3074,10,4,8,15,28,49,-21,20
Sydney FC,3075,1,20,5,3,65,23,42,65
N'castle Jet,3075,2,15,5,8,57,39,18,50
Melbourne C,3075,3,15,4,10,45,33,12,49
Melbourne V,3075,4,13,6,10,46,39,7,45
Adelaide Utd,3075,5,11,6,11,37,40,-3,39
Brisbane,3075,6,10,5,13,33,42,-9,35
Western Sydn,3075,7,8,9,10,38,47,-9,33
Perth Glory,3075,8,10,2,15,37,50,-13,32
Wellington P,3075,9,5,6,16,31,55,-24,21
CC Mariners,3075,10,4,8,15,28,49,-21,20
Sydney FC,3076,1,21,4,3,67,23,44,67
N'castle Jet,3076,2,15,5,8,57,39,18,50
Melbourne C,3076,3,15,4,10,45,33,12,49
Melbourne V,3076,4,13,5,11,46,41,5,44
Adelaide Utd,3076,5,11,6,11,37,40,-3,39
Brisbane,3076,6,10,5,13,33,42,-9,35
Western Sydn,3076,7,8,9,10,38,47,-9,33
Perth Glory,3076,8,10,2,15,37,50,-13,32
Wellington P,3076,9,5,6,16,31,55,-24,21
CC Mariners,3076,10,4,8,15,28,49,-21,20
Sydney FC,3077,1,21,4,3,67,23,44,67
N'castle Jet,3077,2,16,5,7,60,38,22,53
Melbourne C,3077,3,14,4,11,44,36,8,46
Melbourne V,3077,4,13,5,11,46,41,5,44
Adelaide Utd,3077,5,11,6,11,37,40,-3,39
Brisbane,3077,6,10,5,13,33,42,-9,35
Western Sydn,3077,7,8,9,10,38,47,-9,33
Perth Glory,3077,8,10,2,15,37,50,-13,32
Wellington P,3077,9,5,6,16,31,55,-24,21
CC Mariners,3077,10,4,8,15,28,49,-21,20
Sydney FC,3078,1,20,5,3,65,23,42,65
N'castle Jet,3078,2,16,5,7,61,37,24,53
Melbourne C,3078,3,14,4,11,43,37,6,46
Melbourne V,3078,4,13,6,10,46,39,7,45
Adelaide Utd,3078,5,11,6,11,37,40,-3,39
Brisbane,3078,6,10,5,13,33,42,-9,35
Western Sydn,3078,7,8,9,10,38,47,-9,33
Perth Glory,3078,8,10,2,15,37,50,-13,32
Wellington P,3078,9,5,6,16,31,55,-24,21
CC Mariners,3078,10,4,8,15,28,49,-21,20
Sydney FC,3079,1,20,4,4,65,24,41,64
N'castle Jet,3079,2,16,5,7,59,38,21,53
Melbourne V,3079,3,14,5,10,47,39,8,47
Melbourne C,3079,4,14,4,11,44,35,9,46
Adelaide Utd,3079,5,11,6,11,37,40,-3,39
Brisbane,3079,6,10,5,13,33,42,-9,35
Western Sydn,3079,7,8,9,10,38,47,-9,33
Perth Glory,3079,8,10,2,15,37,50,-13,32
Wellington P,3079,9,5,6,16,31,55,-24,21
CC Mariners,3079,10,4,8,15,28,49,-21,20
Sydney FC,3080,1,21,4,3,65,22,43,67
N'castle Jet,3080,2,16,5,7,59,38,21,53
Melbourne C,3080,3,14,4,11,44,35,9,46
Melbourne V,3080,4,13,5,11,45,39,6,44
Adelaide Utd,3080,5,11,6,11,37,40,-3,39
Brisbane,3080,6,10,5,13,33,42,-9,35
Western Sydn,3080,7,8,9,10,38,47,-9,33
Perth Glory,3080,8,10,2,15,37,50,-13,32
Wellington P,3080,9,5,6,16,31,55,-24,21
CC Mariners,3080,10,4,8,15,28,49,-21,20
Sydney FC,3081,1,21,4,3,66,23,43,67
N'castle Jet,3081,2,15,6,7,58,38,20,51
Melbourne C,3081,3,14,5,10,44,34,10,47
Melbourne V,3081,4,13,5,11,46,40,6,44
Adelaide Utd,3081,5,11,6,11,37,40,-3,39
Brisbane,3081,6,10,5,13,33,42,-9,35
Western Sydn,3081,7,8,9,10,38,47,-9,33
Perth Glory,3081,8,10,2,15,37,50,-13,32
Wellington P,3081,9,5,6,16,31,55,-24,21
CC Mariners,3081,10,4,8,15,28,49,-21,20
Sydney FC,3082,1,21,4,3,67,23,44,67
N'castle Jet,3082,2,16,5,7,61,37,24,53
Melbourne C,3082,3,14,4,11,43,37,6,46
Melbourne V,3082,4,13,5,11,46,41,5,44
Adelaide Utd,3082,5,11,6,11,37,40,-3,39
Brisbane,3082,6,10,5,13,33,42,-9,35
Western Sydn,3082,7,8,9,10,38,47,-9,33
Perth Glory,3082,8,10,2,15,37,50,-13,32
Wellington P,3082,9,5,6,16,31,55,-24,21
CC Mariners,3082,10,4,8,15,28,49,-21,20
Sydney FC,3083,1,21,4,3,69,23,46,67
N'castle Jet,3083,2,15,5,8,58,41,17,50
Melbourne C,3083,3,15,4,10,47,34,13,49
Melbourne V,3083,4,13,5,11,46,43,3,44
Adelaide Utd,3083,5,11,6,11,37,40,-3,39
Brisbane,3083,6,10,5,13,33,42,-9,35
Western Sydn,3083,7,8,9,10,38,47,-9,33
Perth Glory,3083,8,10,2,15,37,50,-13,32
Wellington P,3083,9,5,6,16,31,55,-24,21
CC Mariners,3083,10,4,8,15,28,49,-21,20
Sydney FC,3084,1,20,5,3,66,24,42,65
N'castle Jet,3084,2,16,5,7,60,39,21,53
Melbourne C,3084,3,14,4,11,45,36,9,46
Melbourne V,3084,4,13,6,10,47,40,7,45
Adelaide Utd,3084,5,11,6,11,37,40,-3,39
Brisbane,3084,6,10,5,13,33,42,-9,35
Western Sydn,3084,7,8,9,10,38,47,-9,33
Perth Glory,3084,8,10,2,15,37,50,-13,32
Wellington P,3084,9,5,6,16,31,55,-24,21
CC Mariners,3084,10,4,8,15,28,49,-21,20
Sydney FC,3085,1,21,4,3,65,22,43,67
N'castle Jet,3085,2,15,5,8,58,39,19,50
Melbourne C,3085,3,15,4,10,45,34,11,49
Melbourne V,3085,4,13,5,11,45,39,6,44
Adelaide Utd,3085,5,11,6,11,37,40,-3,39
Brisbane,3085,6,10,5,13,33,42,-9,35
Western Sydn,3085,7,8,9,10,38,47,-9,33
Perth Glory,3085,8,10,2,15,37,50,-13,32
Wellington P,3085,9,5,6,16,31,55,-24,21
CC Mariners,3085,10,4,8,15,28,49,-21,20
Sydney FC,3086,1,20,4,4,65,24,41,64
N'castle Jet,3086,2,15,6,7,57,37,20,51
Melbourne C,3086,3,14,5,10,43,33,10,47
Melbourne V,3086,4,14,5,10,47,39,8,47
Adelaide Utd,3086,5,11,6,11,37,40,-3,39
Brisbane,3086,6,10,5,13,33,42,-9,35
Western Sydn,3086,7,8,9,10,38,47,-9,33
Perth Glory,3086,8,10,2,15,37,50,-13,32
Wellington P,3086,9,5,6,16,31,55,-24,21
CC Mariners,3086,10,4,8,15,28,49,-21,20
Sydney FC,3087,1,21,4,3,65,22,43,67
N'castle Jet,3087,2,15,5,8,60,42,18,50
Melbourne C,3087,3,15,4,10,48,36,12,49
Melbourne V,3087,4,13,5,11,45,39,6,44
Adelaide Utd,3087,5,11,6,11,37,40,-3,39
Brisbane,3087,6,10,5,13,33,42,-9,35
Western Sydn,3087,7,8,9,10,38,47,-9,33
Perth Glory,3087,8,10,2,15,37,50,-13,32
Wellington P,3087,9,5,6,16,31,55,-24,21
CC Mariners,3087,10,4,8,15,28,49,-21,20
Sydney FC,3088,1,21,4,3,65,22,43,67
N'castle Jet,3088,2,16,5,7,60,38,22,53
Melbourne C,3088,3,14,4,11,44,36,8,46
Melbourne V,3088,4,13,5,11,45,39,6,44
Adelaide Utd,3088,5,11,6,11,37,40,-3,39
Brisbane,3088,6,10,5,13,33,42,-9,35
Western Sydn,3088,7,8,9,10,38,47,-9,33
Perth Glory,3088,8,10,2,15,37,50,-13,32
Wellington P,3088,9,5,6,16,31,55,-24,21
CC Mariners,3088,10,4,8,15,28,49,-21,20
Sydney FC,3089,1,21,4,3,67,24,43,67
N'castle Jet,3089,2,15,6,7,58,38,20,51
Melbourne C,3089,3,14,5,10,44,34,10,47
Melbourne V,3089,4,13,5,11,47,41,6,44
Adelaide Utd,3089,5,11,6,11,37,40,-3,39
Brisbane,3089,6,10,5,13,33,42,-9,35
Western Sydn,3089,7,8,9,10,38,47,-9,33
Perth Glory,3089,8,10,2,15,37,50,-13,32
Wellington P,3089,9,5,6,16,31,55,-24,21
CC Mariners,3089,10,4,8,15,28,49,-21,20
Sydney FC,3090,1,21,4,3,68,23,45,67
N'castle Jet,3090,2,15,5,8,57,39,18,50
Melbourne C,3090,3,15,4,10,45,33,12,49
Melbourne V,3090,4,13,5,11,46,42,4,44
Adelaide Utd,3090,5,11,6,11,37,40,-3,39
Brisbane,3090,6,10,5,13,33,42,-9,35
Western Sydn,3090,7,8,9,10,38,47,-9,33
Perth Glory,3090,8,10,2,15,37,50,-13,32
Wellington P,3090,9,5,6,16,31,55,-24,21
CC Mariners,3090,10,4,8,15,28,49,-21,20
Sydney FC,3091,1,21,4,3,69,22,47,67
N'castle Jet,3091,2,15,6,7,57,37,20,51
Melbourne C,3091,3,14,5,10,43,33,10,47
Melbourne V,3091,4,13,5,11,45,43,2,44
Adelaide Utd,3091,5,11,6,11,37,40,-3,39
Brisbane,3091,6,10,5,13,33,42,-9,35
Western Sydn,3091,7,8,9,10,38,47,-9,33
Perth Glory,3091,8,10,2,15,37,50,-13,32
Wellington P,3091,9,5,6,16,31,55,-24,21
CC Mariners,3091,10,4,8,15,28,49,-21,20
Sydney FC,3092,1,21,4,3,67,22,45,67
N'castle Jet,3092,2,16,5,7,60,37,23,53
Melbourne C,3092,3,14,4,11,43,36,7,46
Melbourne V,3092,4,13,5,11,45,41,4,44
Adelaide Utd,3092,5,11,6,11,37,40,-3,39
Brisbane,3092,6,10,5,13,33,42,-9,35
Western Sydn,3092,7,8,9,10,38,47,-9,33
Perth Glory,3092,8,10,2,15,37,50,-13,32
Wellington P,3092,9,5,6,16,31,55,-24,21
CC Mariners,3092,10,4,8,15,28,49,-21,20
Sydney FC,3093,1,21,4,3,65,22,43,67
N'castle Jet,3093,2,15,6,7,57,37,20,51
Melbourne C,3093,3,14,5,10,43,33,10,47
Melbourne V,3093,4,13,5,11,45,39,6,44
Adelaide Utd,3093,5,11,6,11,37,40,-3,39
Brisbane,3093,6,10,5,13,33,42,-9,35
Western Sydn,3093,7,8,9,10,38,47,-9,33
Perth Glory,3093,8,10,2,15,37,50,-13,32
Wellington P,3093,9,5,6,16,31,55,-24,21
CC Mariners,3093,10,4,8,15,28,49,-21,20
Sydney FC,3094,1,20,5,3,65,23,42,65
N'castle Jet,3094,2,15,5,8,59,40,19,50
Melbourne C,3094,3,15,4,10,46,35,11,49
Melbourne V,3094,4,13,6,10,46,39,7,45
Adelaide Utd,3094,5,11,6,11,37,40,-3,39
Brisbane,3094,6,10,5,13,33,42,-9,35
Western Sydn,3094,7,8,9,10,38,47,-9,33
Perth Glory,3094,8,10,2,15,37,50,-13,32
Wellington P,3094,9,5,6,16,31,55,-24,21
CC Mariners,3094,10,4,8,15,28,49,-21,20
Sydney FC,3095,1,21,4,3,70,23,47,67
N'castle Jet,3095,2,15,5,8,59,41,18,50
Melbourne C,3095,3,15,4,10,47,35,12,49
Melbourne V,3095,4,13,5,11,46,44,2,44
Adelaide Utd,3095,5,11,6,11,37,40,-3,39
Brisbane,3095,6,10,5,13,33,42,-9,35
Western Sydn,3095,7,8,9,10,38,47,-9,33
Perth Glory,3095,8,10,2,15,37,50,-13,32
Wellington P,3095,9,5,6,16,31,55,-24,21
CC Mariners,3095,10,4,8,15,28,49,-21,20
Sydney FC,3096,1,20,4,4,67,26,41,64
N'castle Jet,3096,2,16,5,7,60,38,22,53
Melbourne V,3096,3,14,5,10,49,41,8,47
Melbourne C,3096,4,14,4,11,44,36,8,46
Adelaide Utd,3096,5,11,6,11,37,40,-3,39
Brisbane,3096,6,10,5,13,33,42,-9,35
Western Sydn,3096,7,8,9,10,38,47,-9,33
Perth Glory,3096,8,10,2,15,37,50,-13,32
Wellington P,3096,9,5,6,16,31,55,-24,21
CC Mariners,3096,10,4,8,15,28,49,-21,20
Sydney FC,3097,1,20,5,3,67,25,42,65
N'castle Jet,3097,2,16,5,7,60,38,22,53
Melbourne C,3097,3,14,4,11,44,36,8,46
Melbourne V,3097,4,13,6,10,48,41,7,45
Adelaide Utd,3097,5,11,6,11,37,40,-3,39
Brisbane,3097,6,10,5,13,33,42,-9,35
Western Sydn,3097,7,8,9,10,38,47,-9,33
Perth Glory,3097,8,10,2,15,37,50,-13,32
Wellington P,3097,9,5,6,16,31,55,-24,21
CC Mariners,3097,10,4,8,15,28,49,-21,20
Sydney FC,3098,1,20,4,4,66,28,38,64
N'castle Jet,3098,2,16,5,7,60,37,23,53
Melbourne V,3098,3,14,5,10,51,40,11,47
Melbourne C,3098,4,14,4,11,43,36,7,46
Adelaide Utd,3098,5,11,6,11,37,40,-3,39
Brisbane,3098,6,10,5,13,33,42,-9,35
Western Sydn,3098,7,8,9,10,38,47,-9,33
Perth Glory,3098,8,10,2,15,37,50,-13,32
Wellington P,3098,9,5,6,16,31,55,-24,21
CC Mariners,3098,10,4,8,15,28,49,-21,20
Sydney FC,3099,1,21,4,3,67,23,44,67
N'castle Jet,3099,2,16,5,7,59,37,22,53
Melbourne C,3099,3,14,4,11,43,35,8,46
Melbourne V,3099,4,13,5,11,46,41,5,44
Adelaide Utd,3099,5,11,6,11,37,40,-3,39
Brisbane,3099,6,10,5,13,33,42,-9,35
Western Sydn,3099,7,8,9,10,38,47,-9,33
Perth Glory,3099,8,10,2,15,37,50,-13,32
Wellington P,3099,9,5,6,16,31,55,-24,21
CC Mariners,3099,10,4,8,15,28,49,-21,20
Sydney FC,3100,1,20,4,4,64,23,41,64
N'castle Jet,3100,2,16,5,7,59,38,21,53
Melbourne V,3100,3,14,5,10,46,38,8,47
Melbourne C,3100,4,14,4,11,44,35,9,46
Adelaide Utd,3100,5,11,6,11,37,40,-3,39
Brisbane,3100,6,10,5,13,33,42,-9,35
Western Sydn,3100,7,8,9,10,38,47,-9,33
Perth Glory,3100,8,10,2,15,37,50,-13,32
Wellington P,3100,9,5,6,16,31,55,-24,21
CC Mariners,3100,10,4,8,15,28,49,-21,20
Sydney FC,3101,1,21,4,3,66,22,44,67
N'castle Jet,3101,2,15,5,8,60,43,17,50
Melbourne C,3101,3,15,4,10,49,36,13,49
Melbourne V,3101,4,13,5,11,45,40,5,44
Adelaide Utd,3101,5,11,6,11,37,40,-3,39
Brisbane,3101,6,10,5,13,33,42,-9,35
Western Sydn,3101,7,8,9,10,38,47,-9,33
Perth Glory,3101,8,10,2,15,37,50,-13,32
Wellington P,3101,9,5,6,16,31,55,-24,21
CC Mariners,3101,10,4,8,15,28,49,-21,20
Sydney FC,3102,1,21,4,3,66,23,43,67
N'castle Jet,3102,2,15,6,7,59,39,20,51
Melbourne C,3102,3,14,5,10,45,35,10,47
Melbourne V,3102,4,13,5,11,46,40,6,44
Adelaide Utd,3102,5,11,6,11,37,40,-3,39
Brisbane,3102,6,10,5,13,33,42,-9,35
Western Sydn,3102,7,8,9,10,38,47,-9,33
Perth Glory,3102,8,10,2,15,37,50,-13,32
Wellington P,3102,9,5,6,16,31,55,-24,21
CC Mariners,3102,10,4,8,15,28,49,-21,20
Sydney FC,3103,1,21,4,3,69,22,47,67
N'castle Jet,3103,2,15,6,7,58,38,20,51
Melbourne C,3103,3,14,5,10,44,34,10,47
Melbourne V,3103,4,13,5,11,45,43,2,44
Adelaide Utd,3103,5,11,6,11,37,40,-3,39
Brisbane,3103,6,10,5,13,33,42,-9,35
Western Sydn,3103,7,8,9,10,38,47,-9,33
Perth Glory,3103,8,10,2,15,37,50,-13,32
Wellington P,3103,9,5,6,16,31,55,-24,21
CC Mariners,3103,10,4,8,15,28,49,-21,20
Sydney FC,3104,1,20,4,4,64,26,38,64
N'castle Jet,3104,2,16,5,7,61,39,22,53
Melbourne V,3104,3,14,5,10,49,38,11,47
Melbourne C,3104,4,14,4,11,45,37,8,46
Adelaide Utd,3104,5,11,6,11,37,40,-3,39
Brisbane,3104,6,10,5,13,33,42,-9,35
Western Sydn,3104,7,8,9,10,38,47,-9,33
Perth Glory,3104,8,10,2,15,37,50,-13,32
Wellington P,3104,9,5,6,16,31,55,-24,21
CC Mariners,3104,10,4,8,15,28,49,-21,20
Sydney FC,3105,1,20,4,4,64,24,40,64
N'castle Jet,3105,2,16,5,7,60,38,22,53
Melbourne V,3105,3,14,5,10,47,38,9,47
Melbourne C,3105,4,14,4,11,44,36,8,46
Adelaide Utd,3105,5,11,6,11,37,40,-3,39
Brisbane,3105,6,10,5,13,33,42,-9,35
Western Sydn,3105,7,8,9,10,38,47,-9,33
Perth Glory,3105,8,10,2,15,37,50,-13,32
Wellington P,3105,9,5,6,16,31,55,-24,21
CC Mariners,3105,10,4,8,15,28,49,-21,20
Sydney FC,3106,1,21,4,3,67,23,44,67
N'castle Jet,3106,2,16,5,7,58,37,21,53
Melbourne C,3106,3,14,4,11,43,34,9,46
Melbourne V,3106,4,13,5,11,46,41,5,44
Adelaide Utd,3106,5,11,6,11,37,40,-3,39
Brisbane,3106,6,10,5,13,33,42,-9,35
Western Sydn,3106,7,8,9,10,38,47,-9,33
Perth Glory,3106,8,10,2,15,37,50,-13,32
Wellington P,3106,9,5,6,16,31,55,-24,21
CC Mariners,3106,10,4,8,15,28,49,-21,20
Sydney FC,3107,1,21,4,3,68,23,45,67
N'castle Jet,3107,2,15,6,7,58,38,20,51
Melbourne C,3107,3,14,5,10,44,34,10,47
Melbourne V,3107,4,13,5,11,46,42,4,44
Adelaide Utd,3107,5,11,6,11,37,40,-3,39
Brisbane,3107,6,10,5,13,33,42,-9,35
Western Sydn,3107,7,8,9,10,38,47,-9,33
Perth Glory,3107,8,10,2,15,37,50,-13,32
Wellington P,3107,9,5,6,16,31,55,-24,21
CC Mariners,3107,10,4,8,15,28,49,-21,20
Sydney FC,3108,1,21,4,3,66,22,44,67
N'castle Jet,3108,2,15,5,8,58,39,19,50
Melbourne C,3108,3,15,4,10,45,34,11,49
Melbourne V,3108,4,13,5,11,45,40,5,44
Adelaide Utd,3108,5,11,6,11,37,40,-3,39
Brisbane,3108,6,10,5,13,33,42,-9,35
Western Sydn,3108,7,8,9,10,38,47,-9,33
Perth Glory,3108,8,10,2,15,37,50,-13,32
Wellington P,3108,9,5,6,16,31,55,-24,21
CC Mariners,3108,10,4,8,15,28,49,-21,20
Sydney FC,3109,1,21,4,3,68,22,46,67
N'castle Jet,3109,2,16,5,7,59,38,21,53
Melbourne C,3109,3,14,4,11,44,35,9,46
Melbourne V,3109,4,13,5,11,45,42,3,44
Adelaide Utd,3109,5,11,6,11,37,40,-3,39
Brisbane,3109,6,10,5,13,33,42,-9,35
Western Sydn,3109,7,8,9,10,38,47,-9,33
Perth Glory,3109,8,10,2,15,37,50,-13,32
Wellington P,3109,9,5,6,16,31,55,-24,21
CC Mariners,3109,10,4,8,15,28,49,-21,20
Sydney FC,3110,1,21,4,3,65,22,43,67
N'castle Jet,3110,2,16,5,7,58,37,21,53
Melbourne C,3110,3,14,4,11,43,34,9,46
Melbourne V,3110,4,13,5,11,45,39,6,44
Adelaide Utd,3110,5,11,6,11,37,40,-3,39
Brisbane,3110,6,10,5,13,33,42,-9,35
Western Sydn,3110,7,8,9,10,38,47,-9,33
Perth Glory,3110,8,10,2,15,37,50,-13,32
Wellington P,3110,9,5,6,16,31,55,-24,21
CC Mariners,3110,10,4,8,15,28,49,-21,20
Sydney FC,3111,1,20,4,4,65,24,41,64
N'castle Jet,3111,2,16,5,7,61,38,23,53
Melbourne V,3111,3,14,5,10,47,39,8,47
Melbourne C,3111,4,14,4,11,44,37,7,46
Adelaide Utd,3111,5,11,6,11,37,40,-3,39
Brisbane,3111,6,10,5,13,33,42,-9,35
Western Sydn,3111,7,8,9,10,38,47,-9,33
Perth Glory,3111,8,10,2,15,37,50,-13,32
Wellington P,3111,9,5,6,16,31,55,-24,21
CC Mariners,3111,10,4,8,15,28,49,-21,20
Sydney FC,3112,1,21,4,3,70,22,48,67
N'castle Jet,3112,2,16,5,7,58,37,21,53
Melbourne C,3112,3,14,4,11,43,34,9,46
Melbourne V,3112,4,13,5,11,45,44,1,44
Adelaide Utd,3112,5,11,6,11,37,40,-3,39
Brisbane,3112,6,10,5,13,33,42,-9,35
Western Sydn,3112,7,8,9,10,38,47,-9,33
Perth Glory,3112,8,10,2,15,37,50,-13,32
Wellington P,3112,9,5,6,16,31,55,-24,21
CC Mariners,3112,10,4,8,15,28,49,-21,20
Sydney FC,3113,1,21,4,3,67,23,44,67
N'castle Jet,3113,2,15,5,8,58,40,18,50
Melbourne C,3113,3,15,4,10,46,34,12,49
Melbourne V,3113,4,13,5,11,46,41,5,44
Adelaide Utd,3113,5,11,6,11,37,40,-3,39
Brisbane,3113,6,10,5,13,33,42,-9,35
Western Sydn,3113,7,8,9,10,38,47,-9,33
Perth Glory,3113,8,10,2,15,37,50,-13,32
Wellington P,3113,9,5,6,16,31,55,-24,21
CC Mariners,3113,10,4,8,15,28,49,-21,20
Sydney FC,3114,1,20,4,4,65,24,41,64
N'castle Jet,3114,2,15,5,8,59,40,19,50
Melbourne C,3114,3,15,4,10,46,35,11,49
Melbourne V,3114,4,14,5,10,47,39,8,47
Adelaide Utd,3114,5,11,6,11,37,40,-3,39
Brisbane,3114,6,10,5,13,33,42,-9,35
Western Sydn,3114,7,8,9,10,38,47,-9,33
Perth Glory,3114,8,10,2,15,37,50,-13,32
Wellington P,3114,9,5,6,16,31,55,-24,21
CC Mariners,3114,10,4,8,15,28,49,-21,20
Sydney FC,3115,1,21,4,3,66,22,44,67
N'castle Jet,3115,2,16,5,7,60,39,21,53
Melbourne C,3115,3,14,4,11,45,36,9,46
Melbourne V,3115,4,13,5,11,45,40,5,44
Adelaide Utd,3115,5,11,6,11,37,40,-3,39
Brisbane,3115,6,10,5,13,33,42,-9,35
Western Sydn,3115,7,8,9,10,38,47,-9,33
Perth Glory,3115,8,10,2,15,37,50,-13,32
Wellington P,3115,9,5,6,16,31,55,-24,21
CC Mariners,3115,10,4,8,15,28,49,-21,20
Sydney FC,3116,1,20,4,4,64,23,41,64
N'castle Jet,3116,2,16,5,7,60,38,22,53
Melbourne V,3116,3,14,5,10,46,38,8,47
Melbourne C,3116,4,14,4,11,44,36,8,46
Adelaide Utd,3116,5,11,6,11,37,40,-3,39
Brisbane,3116,6,10,5,13,33,42,-9,35
Western Sydn,3116,7,8,9,10,38,47,-9,33
Perth Glory,3116,8,10,2,15,37,50,-13,32
Wellington P,3116,9,5,6,16,31,55,-24,21
CC Mariners,3116,10,4,8,15,28,49,-21,20
Sydney FC,3117,1,20,5,3,65,23,42,65
N'castle Jet,3117,2,16,5,7,62,38,24,53
Melbourne C,3117,3,14,4,11,44,38,6,46
Melbourne V,3117,4,13,6,10,46,39,7,45
Adelaide Utd,3117,5,11,6,11,37,40,-3,39
Brisbane,3117,6,10,5,13,33,42,-9,35
Western Sydn,3117,7,8,9,10,38,47,-9,33
Perth Glory,3117,8,10,2,15,37,50,-13,32
Wellington P,3117,9,5,6,16,31,55,-24,21
CC Mariners,3117,10,4,8,15,28,49,-21,20
Sydney FC,3118,1,21,4,3,67,24,43,67
N'castle Jet,3118,2,16,5,7,59,37,22,53
Melbourne C,3118,3,14,4,11,43,35,8,46
Melbourne V,3118,4,13,5,11,47,41,6,44
Adelaide Utd,3118,5,11,6,11,37,40,-3,39
Brisbane,3118,6,10,5,13,33,42,-9,35
Western Sydn,3118,7,8,9,10,38,47,-9,33
Perth Glory,3118,8,10,2,15,37,50,-13,32
Wellington P,3118,9,5,6,16,31,55,-24,21
CC Mariners,3118,10,4,8,15,28,49,-21,20
Sydney FC,3119,1,20,4,4,64,23,41,64
N'castle Jet,3119,2,15,5,8,57,39,18,50
Melbourne C,3119,3,15,4,10,45,33,12,49
Melbourne V,3119,4,14,5,10,46,38,8,47
Adelaide Utd,3119,5,11,6,11,37,40,-3,39
Brisbane,3119,6,10,5,13,33,42,-9,35
Western Sydn,3119,7,8,9,10,38,47,-9,33
Perth Glory,3119,8,10,2,15,37,50,-13,32
Wellington P,3119,9,5,6,16,31,55,-24,21
CC Mariners,3119,10,4,8,15,28,49,-21,20
Sydney FC,3120,1,21,4,3,66,23,43,67
N'castle Jet,3120,2,16,5,7,60,38,22,53
Melbourne C,3120,3,14,4,11,44,36,8,46
Melbourne V,3120,4,13,5,11,46,40,6,44
Adelaide Utd,3120,5,11,6,11,37,40,-3,39
Brisbane,3120,6,10,5,13,33,42,-9,35
Western Sydn,3120,7,8,9,10,38,47,-9,33
Perth Glory,3120,8,10,2,15,37,50,-13,32
Wellington P,3120,9,5,6,16,31,55,-24,21
CC Mariners,3120,10,4,8,15,28,49,-21,20
Sydney FC,3121,1,21,4,3,66,22,44,67
N'castle Jet,3121,2,15,5,8,57,39,18,50
Melbourne C,3121,3,15,4,10,45,33,12,49
Melbourne V,3121,4,13,5,11,45,40,5,44
Adelaide Utd,3121,5,11,6,11,37,40,-3,39
Brisbane,3121,6,10,5,13,33,42,-9,35
Western Sydn,3121,7,8,9,10,38,47,-9,33
Perth Glory,3121,8,10,2,15,37,50,-13,32
Wellington P,3121,9,5,6,16,31,55,-24,21
CC Mariners,3121,10,4,8,15,28,49,-21,20
Sydney FC,3122,1,20,5,3,65,23,42,65
N'castle Jet,3122,2,16,5,7,58,37,21,53
Melbourne C,3122,3,14,4,11,43,34,9,46
Melbourne V,3122,4,13,6,10,46,39,7,45
Adelaide Utd,3122,5,11,6,11,37,40,-3,39
Brisbane,3122,6,10,5,13,33,42,-9,35
Western Sydn,3122,7,8,9,10,38,47,-9,33
Perth Glory,3122,8,10,2,15,37,50,-13,32
Wellington P,3122,9,5,6,16,31,55,-24,21
CC Mariners,3122,10,4,8,15,28,49,-21,20
Sydney FC,3123,1,20,5,3,65,23,42,65
N'castle Jet,3123,2,16,5,7,58,37,21,53
Melbourne C,3123,3,14,4,11,43,34,9,46
Melbourne V,3123,4,13,6,10,46,39,7,45
Adelaide Utd,3123,5,11,6,11,37,40,-3,39
Brisbane,3123,6,10,5,13,33,42,-9,35
Western Sydn,3123,7,8,9,10,38,47,-9,33
Perth Glory,3123,8,10,2,15,37,50,-13,32
Wellington P,3123,9,5,6,16,31,55,-24,21
CC Mariners,3123,10,4,8,15,28,49,-21,20
Sydney FC,3124,1,20,5,3,65,23,42,65
N'castle Jet,3124,2,15,6,7,59,39,20,51
Melbourne C,3124,3,14,5,10,45,35,10,47
Melbourne V,3124,4,13,6,10,46,39,7,45
Adelaide Utd,3124,5,11,6,11,37,40,-3,39
Brisbane,3124,6,10,5,13,33,42,-9,35
Western Sydn,3124,7,8,9,10,38,47,-9,33
Perth Glory,3124,8,10,2,15,37,50,-13,32
Wellington P,3124,9,5,6,16,31,55,-24,21
CC Mariners,3124,10,4,8,15,28,49,-21,20
Sydney FC,3125,1,20,5,3,64,22,42,65
N'castle Jet,3125,2,16,5,7,61,37,24,53
Melbourne C,3125,3,14,4,11,43,37,6,46
Melbourne V,3125,4,13,6,10,45,38,7,45
Adelaide Utd,3125,5,11,6,11,37,40,-3,39
Brisbane,3125,6,10,5,13,33,42,-9,35
Western Sydn,3125,7,8,9,10,38,47,-9,33
Perth Glory,3125,8,10,2,15,37,50,-13,32
Wellington P,3125,9,5,6,16,31,55,-24,21
CC Mariners,3125,10,4,8,15,28,49,-21,20
Sydney FC,3126,1,21,4,3,67,24,43,67
N'castle Jet,3126,2,15,5,8,57,39,18,50
Melbourne C,3126,3,15,4,10,45,33,12,49
Melbourne V,3126,4,13,5,11,47,41,6,44
Adelaide Utd,3126,5,11,6,11,37,40,-3,39
Brisbane,3126,6,10,5,13,33,42,-9,35
Western Sydn,3126,7,8,9,10,38,47,-9,33
Perth Glory,3126,8,10,2,15,37,50,-13,32
Wellington P,3126,9,5,6,16,31,55,-24,21
CC Mariners,3126,10,4,8,15,28,49,-21,20
Sydney FC,3127,1,21,4,3,68,23,45,67
N'castle Jet,3127,2,15,5,8,58,40,18,50
Melbourne C,3127,3,15,4,10,46,34,12,49
Melbourne V,3127,4,13,5,11,46,42,4,44
Adelaide Utd,3127,5,11,6,11,37,40,-3,39
Brisbane,3127,6,10,5,13,33,42,-9,35
Western Sydn,3127,7,8,9,10,38,47,-9,33
Perth Glory,3127,8,10,2,15,37,50,-13,32
Wellington P,3127,9,5,6,16,31,55,-24,21
CC Mariners,3127,10,4,8,15,28,49,-21,20
Sydney FC,3128,1,21,4,3,65,22,43,67
N'castle Jet,3128,2,15,5,8,57,39,18,50
Melbourne C,3128,3,15,4,10,45,33,12,49
Melbourne V,3128,4,13,5,11,45,39,6,44
Adelaide Utd,3128,5,11,6,11,37,40,-3,39
Brisbane,3128,6,10,5,13,33,42,-9,35
Western Sydn,3128,7,8,9,10,38,47,-9,33
Perth Glory,3128,8,10,2,15,37,50,-13,32
Wellington P,3128,9,5,6,16,31,55,-24,21
CC Mariners,3128,10,4,8,15,28,49,-21,20
Sydney FC,3129,1,21,4,3,68,23,45,67
N'castle Jet,3129,2,15,5,8,59,41,18,50
Melbourne C,3129,3,15,4,10,47,35,12,49
Melbourne V,3129,4,13,5,11,46,42,4,44
Adelaide Utd,3129,5,11,6,11,37,40,-3,39
Brisbane,3129,6,10,5,13,33,42,-9,35
Western Sydn,3129,7,8,9,10,38,47,-9,33
Perth Glory,3129,8,10,2,15,37,50,-13,32
Wellington P,3129,9,5,6,16,31,55,-24,21
CC Mariners,3129,10,4,8,15,28,49,-21,20
Sydney FC,3130,1,21,4,3,70,22,48,67
N'castle Jet,3130,2,16,5,7,59,37,22,53
Melbourne C,3130,3,14,4,11,43,35,8,46
Melbourne V,3130,4,13,5,11,45,44,1,44
Adelaide Utd,3130,5,11,6,11,37,40,-3,39
Brisbane,3130,6,10,5,13,33,42,-9,35
Western Sydn,3130,7,8,9,10,38,47,-9,33
Perth Glory,3130,8,10,2,15,37,50,-13,32
Wellington P,3130,9,5,6,16,31,55,-24,21
CC Mariners,3130,10,4,8,15,28,49,-21,20
Sydney FC,3131,1,21,4,3,65,22,43,67
N'castle Jet,3131,2,15,6,7,58,38,20,51
Melbourne C,3131,3,14,5,10,44,34,10,47
Melbourne V,3131,4,13,5,11,45,39,6,44
Adelaide Utd,3131,5,11,6,11,37,40,-3,39
Brisbane,3131,6,10,5,13,33,42,-9,35
Western Sydn,3131,7,8,9,10,38,47,-9,33
Perth Glory,3131,8,10,2,15,37,50,-13,32
Wellington P,3131,9,5,6,16,31,55,-24,21
CC Mariners,3131,10,4,8,15,28,49,-21,20
Sydney FC,3132,1,20,5,3,66,24,42,65
N'castle Jet,3132,2,15,5,8,58,39,19,50
Melbourne C,3132,3,15,4,10,45,34,11,49
Melbourne V,3132,4,13,6,10,47,40,7,45
Adelaide Utd,3132,5,11,6,11,37,40,-3,39
Brisbane,3132,6,10,5,13,33,42,-9,35
Western Sydn,3132,7,8,9,10,38,47,-9,33
Perth Glory,3132,8,10,2,15,37,50,-13,32
Wellington P,3132,9,5,6,16,31,55,-24,21
CC Mariners,3132,10,4,8,15,28,49,-21,20
Sydney FC,3133,1,21,4,3,68,23,45,67
N'castle Jet,3133,2,15,5,8,57,38,19,50
Melbourne C,3133,3,15,4,10,44,33,11,49
Melbourne V,3133,4,13,5,11,46,42,4,44
Adelaide Utd,3133,5,11,6,11,37,40,-3,39
Brisbane,3133,6,10,5,13,33,42,-9,35
Western Sydn,3133,7,8,9,10,38,47,-9,33
Perth Glory,3133,8,10,2,15,37,50,-13,32
Wellington P,3133,9,5,6,16,31,55,-24,21
CC Mariners,3133,10,4,8,15,28,49,-21,20
Sydney FC,3134,1,21,4,3,68,23,45,67
N'castle Jet,3134,2,15,6,7,58,38,20,51
Melbourne C,3134,3,14,5,10,44,34,10,47
Melbourne V,3134,4,13,5,11,46,42,4,44
Adelaide Utd,3134,5,11,6,11,37,40,-3,39
Brisbane,3134,6,10,5,13,33,42,-9,35
Western Sydn,3134,7,8,9,10,38,47,-9,33
Perth Glory,3134,8,10,2,15,37,50,-13,32
Wellington P,3134,9,5,6,16,31,55,-24,21
CC Mariners,3134,10,4,8,15,28,49,-21,20
Sydney FC,3135,1,21,4,3,66,23,43,67
N'castle Jet,3135,2,16,5,7,58,37,21,53
Melbourne C,3135,3,14,4,11,43,34,9,46
Melbourne V,3135,4,13,5,11,46,40,6,44
Adelaide Utd,3135,5,11,6,11,37,40,-3,39
Brisbane,3135,6,10,5,13,33,42,-9,35
Western Sydn,3135,7,8,9,10,38,47,-9,33
Perth Glory,3135,8,10,2,15,37,50,-13,32
Wellington P,3135,9,5,6,16,31,55,-24,21
CC Mariners,3135,10,4,8,15,28,49,-21,20
Sydney FC,3136,1,21,4,3,66,23,43,67
N'castle Jet,3136,2,15,5,8,57,38,19,50
Melbourne C,3136,3,15,4,10,44,33,11,49
Melbourne V,3136,4,13,5,11,46,40,6,44
Adelaide Utd,3136,5,11,6,11,37,40,-3,39
Brisbane,3136,6,10,5,13,33,42,-9,35
Western Sydn,3136,7,8,9,10,38,47,-9,33
Perth Glory,3136,8,10,2,15,37,50,-13,32
Wellington P,3136,9,5,6,16,31,55,-24,21
CC Mariners,3136,10,4,8,15,28,49,-21,20
Sydney FC,3137,1,20,4,4,65,24,41,64
N'castle Jet,3137,2,15,5,8,57,38,19,50
Melbourne C,3137,3,15,4,10,44,33,11,49
Melbourne V,3137,4,14,5,10,47,39,8,47
Adelaide Utd,3137,5,11,6,11,37,40,-3,39
Brisbane,3137,6,10,5,13,33,42,-9,35
Western Sydn,3137,7,8,9,10,38,47,-9,33
Perth Glory,3137,8,10,2,15,37,50,-13,32
Wellington P,3137,9,5,6,16,31,55,-24,21
CC Mariners,3137,10,4,8,15,28,49,-21,20
Sydney FC,3138,1,21,4,3,65,22,43,67
N'castle Jet,3138,2,15,6,7,57,37,20,51
Melbourne C,3138,3,14,5,10,43,33,10,47
Melbourne V,3138,4,13,5,11,45,39,6,44
Adelaide Utd,3138,5,11,6,11,37,40,-3,39
Brisbane,3138,6,10,5,13,33,42,-9,35
Western Sydn,3138,7,8,9,10,38,47,-9,33
Perth Glory,3138,8,10,2,15,37,50,-13,32
Wellington P,3138,9,5,6,16,31,55,-24,21
CC Mariners,3138,10,4,8,15,28,49,-21,20
Sydney FC,3139,1,20,5,3,66,24,42,65
N'castle Jet,3139,2,16,5,7,62,39,23,53
Melbourne C,3139,3,14,4,11,45,38,7,46
Melbourne V,3139,4,13,6,10,47,40,7,45
Adelaide Utd,3139,5,11,6,11,37,40,-3,39
Brisbane,3139,6,10,5,13,33,42,-9,35
Western Sydn,3139,7,8,9,10,38,47,-9,33
Perth Glory,3139,8,10,2,15,37,50,-13,32
Wellington P,3139,9,5,6,16,31,55,-24,21
CC Mariners,3139,10,4,8,15,28,49,-21,20
Sydney FC,3140,1,20,4,4,65,24,41,64
N'castle Jet,3140,2,16,5,7,60,39,21,53
Melbourne V,3140,3,14,5,10,47,39,8,47
Melbourne C,3140,4,14,4,11,45,36,9,46
Adelaide Utd,3140,5,11,6,11,37,40,-3,39
Brisbane,3140,6,10,5,13,33,42,-9,35
Western Sydn,3140,7,8,9,10,38,47,-9,33
Perth Glory,3140,8,10,2,15,37,50,-13,32
Wellington P,3140,9,5,6,16,31,55,-24,21
CC Mariners,3140,10,4,8,15,28,49,-21,20
Sydney FC,3141,1,21,4,3,66,22,44,67
N'castle Jet,3141,2,15,5,8,57,40,17,50
Melbourne C,3141,3,15,4,10,46,33,13,49
Melbourne V,3141,4,13,5,11,45,40,5,44
Adelaide Utd,3141,5,11,6,11,37,40,-3,39
Brisbane,3141,6,10,5,13,33,42,-9,35
Western Sydn,3141,7,8,9,10,38,47,-9,33
Perth Glory,3141,8,10,2,15,37,50,-13,32
Wellington P,3141,9,5,6,16,31,55,-24,21
CC Mariners,3141,10,4,8,15,28,49,-21,20
Sydney FC,3142,1,21,4,3,68,22,46,67
N'castle Jet,3142,2,16,5,7,59,38,21,53
Melbourne C,3142,3,14,4,11,44,35,9,46
Melbourne V,3142,4,13,5,11,45,42,3,44
Adelaide Utd,3142,5,11,6,11,37,40,-3,39
Brisbane,3142,6,10,5,13,33,42,-9,35
Western Sydn,3142,7,8,9,10,38,47,-9,33
Perth Glory,3142,8,10,2,15,37,50,-13,32
Wellington P,3142,9,5,6,16,31,55,-24,21
CC Mariners,3142,10,4,8,15,28,49,-21,20
Sydney FC,3143,1,20,5,3,64,22,42,65
N'castle Jet,3143,2,15,5,8,57,39,18,50
Melbourne C,3143,3,15,4,10,45,33,12,49
Melbourne V,3143,4,13,6,10,45,38,7,45
Adelaide Utd,3143,5,11,6,11,37,40,-3,39
Brisbane,3143,6,10,5,13,33,42,-9,35
Western Sydn,3143,7,8,9,10,38,47,-9,33
Perth Glory,3143,8,10,2,15,37,50,-13,32
Wellington P,3143,9,5,6,16,31,55,-24,21
CC Mariners,3143,10,4,8,15,28,49,-21,20
Sydney FC,3144,1,21,4,3,66,22,44,67
N'castle Jet,3144,2,16,5,7,58,37,21,53
Melbourne C,3144,3,14,4,11,43,34,9,46
Melbourne V,3144,4,13,5,11,45,40,5,44
Adelaide Utd,3144,5,11,6,11,37,40,-3,39
Brisbane,3144,6,10,5,13,33,42,-9,35
Western Sydn,3144,7,8,9,10,38,47,-9,33
Perth Glory,3144,8,10,2,15,37,50,-13,32
Wellington P,3144,9,5,6,16,31,55,-24,21
CC Mariners,3144,10,4,8,15,28,49,-21,20
Sydney FC,3145,1,21,4,3,66,23,43,67
N'castle Jet,3145,2,16,5,7,59,38,21,53
Melbourne C,3145,3,14,4,11,44,35,9,46
Melbourne V,3145,4,13,5,11,46,40,6,44
Adelaide Utd,3145,5,11,6,11,37,40,-3,39
Brisbane,3145,6,10,5,13,33,42,-9,35
Western Sydn,3145,7,8,9,10,38,47,-9,33
Perth Glory,3145,8,10,2,15,37,50,-13,32
Wellington P,3145,9,5,6,16,31,55,-24,21
CC Mariners,3145,10,4,8,15,28,49,-21,20
Sydney FC,3146,1,21,4,3,65,22,43,67
N'castle Jet,3146,2,16,5,7,60,37,23,53
Melbourne C,3146,3,14,4,11,43,36,7,46
Melbourne V,3146,4,13,5,11,45,39,6,44
Adelaide Utd,3146,5,11,6,11,37,40,-3,39
Brisbane,3146,6,10,5,13,33,42,-9,35
Western Sydn,3146,7,8,9,10,38,47,-9,33
Perth Glory,3146,8,10,2,15,37,50,-13,32
Wellington P,3146,9,5,6,16,31,55,-24,21
CC Mariners,3146,10,4,8,15,28,49,-21,20
Sydney FC,3147,1,21,4,3,65,22,43,67
N'castle Jet,3147,2,16,5,7,59,38,21,53
Melbourne C,3147,3,14,4,11,44,35,9,46
Melbourne V,3147,4,13,5,11,45,39,6,44
Adelaide Utd,3147,5,11,6,11,37,40,-3,39
Brisbane,3147,6,10,5,13,33,42,-9,35
Western Sydn,3147,7,8,9,10,38,47,-9,33
Perth Glory,3147,8,10,2,15,37,50,-13,32
Wellington P,3147,9,5,6,16,31,55,-24,21
CC Mariners,3147,10,4,8,15,28,49,-21,20
Sydney FC,3148,1,21,4,3,65,22,43,67
N'castle Jet,3148,2,16,5,7,59,37,22,53
Melbourne C,3148,3,14,4,11,43,35,8,46
Melbourne V,3148,4,13,5,11,45,39,6,44
Adelaide Utd,3148,5,11,6,11,37,40,-3,39
Brisbane,3148,6,10,5,13,33,42,-9,35
Western Sydn,3148,7,8,9,10,38,47,-9,33
Perth Glory,3148,8,10,2,15,37,50,-13,32
Wellington P,3148,9,5,6,16,31,55,-24,21
CC Mariners,3148,10,4,8,15,28,49,-21,20
Sydney FC,3149,1,20,4,4,68,27,41,64
N'castle Jet,3149,2,15,5,8,57,40,17,50
Melbourne C,3149,3,15,4,10,46,33,13,49
Melbourne V,3149,4,14,5,10,50,42,8,47
Adelaide Utd,3149,5,11,6,11,37,40,-3,39
Brisbane,3149,6,10,5,13,33,42,-9,35
Western Sydn,3149,7,8,9,10,38,47,-9,33
Perth Glory,3149,8,10,2,15,37,50,-13,32
Wellington P,3149,9,5,6,16,31,55,-24,21
CC Mariners,3149,10,4,8,15,28,49,-21,20
Sydney FC,3150,1,21,4,3,65,22,43,67
N'castle Jet,3150,2,16,5,7,59,37,22,53
Melbourne C,3150,3,14,4,11,43,35,8,46
Melbourne V,3150,4,13,5,11,45,39,6,44
Adelaide Utd,3150,5,11,6,11,37,40,-3,39
Brisbane,3150,6,10,5,13,33,42,-9,35
Western Sydn,3150,7,8,9,10,38,47,-9,33
Perth Glory,3150,8,10,2,15,37,50,-13,32
Wellington P,3150,9,5,6,16,31,55,-24,21
CC Mariners,3150,10,4,8,15,28,49,-21,20
Sydney FC,3151,1,21,4,3,68,23,45,67
N'castle Jet,3151,2,15,5,8,57,38,19,50
Melbourne C,3151,3,15,4,10,44,33,11,49
Melbourne V,3151,4,13,5,11,46,42,4,44
Adelaide Utd,3151,5,11,6,11,37,40,-3,39
Brisbane,3151,6,10,5,13,33,42,-9,35
Western Sydn,3151,7,8,9,10,38,47,-9,33
Perth Glory,3151,8,10,2,15,37,50,-13,32
Wellington P,3151,9,5,6,16,31,55,-24,21
CC Mariners,3151,10,4,8,15,28,49,-21,20
Sydney FC,3152,1,20,5,3,64,22,42,65
N'castle Jet,3152,2,15,6,7,57,37,20,51
Melbourne C,3152,3,14,5,10,43,33,10,47
Melbourne V,3152,4,13,6,10,45,38,7,45
Adelaide Utd,3152,5,11,6,11,37,40,-3,39
Brisbane,3152,6,10,5,13,33,42,-9,35
Western Sydn,3152,7,8,9,10,38,47,-9,33
Perth Glory,3152,8,10,2,15,37,50,-13,32
Wellington P,3152,9,5,6,16,31,55,-24,21
CC Mariners,3152,10,4,8,15,28,49,-21,20
Sydney FC,3153,1,21,4,3,67,24,43,67
N'castle Jet,3153,2,15,5,8,58,39,19,50
Melbourne C,3153,3,15,4,10,45,34,11,49
Melbourne V,3153,4,13,5,11,47,41,6,44
Adelaide Utd,3153,5,11,6,11,37,40,-3,39
Brisbane,3153,6,10,5,13,33,42,-9,35
Western Sydn,3153,7,8,9,10,38,47,-9,33
Perth Glory,3153,8,10,2,15,37,50,-13,32
Wellington P,3153,9,5,6,16,31,55,-24,21
CC Mariners,3153,10,4,8,15,28,49,-21,20
Sydney FC,3154,1,21,4,3,67,23,44,67
N'castle Jet,3154,2,16,5,7,59,37,22,53
Melbourne C,3154,3,14,4,11,43,35,8,46
Melbourne V,3154,4,13,5,11,46,41,5,44
Adelaide Utd,3154,5,11,6,11,37,40,-3,39
Brisbane,3154,6,10,5,13,33,42,-9,35
Western Sydn,3154,7,8,9,10,38,47,-9,33
Perth Glory,3154,8,10,2,15,37,50,-13,32
Wellington P,3154,9,5,6,16,31,55,-24,21
CC Mariners,3154,10,4,8,15,28,49,-21,20
Sydney FC,3155,1,21,4,3,66,23,43,67
N'castle Jet,3155,2,16,5,7,60,37,23,53
Melbourne C,3155,3,14,4,11,43,36,7,46
Melbourne V,3155,4,13,5,11,46,40,6,44
Adelaide Utd,3155,5,11,6,11,37,40,-3,39
Brisbane,3155,6,10,5,13,33,42,-9,35
Western Sydn,3155,7,8,9,10,38,47,-9,33
Perth Glory,3155,8,10,2,15,37,50,-13,32
Wellington P,3155,9,5,6,16,31,55,-24,21
CC Mariners,3155,10,4,8,15,28,49,-21,20
Sydney FC,3156,1,21,4,3,67,24,43,67
N'castle Jet,3156,2,15,6,7,59,39,20,51
Melbourne C,3156,3,14,5,10,45,35,10,47
Melbourne V,3156,4,13,5,11,47,41,6,44
Adelaide Utd,3156,5,11,6,11,37,40,-3,39
Brisbane,3156,6,10,5,13,33,42,-9,35
Western Sydn,3156,7,8,9,10,38,47,-9,33
Perth Glory,3156,8,10,2,15,37,50,-13,32
Wellington P,3156,9,5,6,16,31,55,-24,21
CC Mariners,3156,10,4,8,15,28,49,-21,20
Sydney FC,3157,1,21,4,3,69,22,47,67
N'castle Jet,3157,2,16,5,7,59,37,22,53
Melbourne C,3157,3,14,4,11,43,35,8,46
Melbourne V,3157,4,13,5,11,45,43,2,44
Adelaide Utd,3157,5,11,6,11,37,40,-3,39
Brisbane,3157,6,10,5,13,33,42,-9,35
Western Sydn,3157,7,8,9,10,38,47,-9,33
Perth Glory,3157,8,10,2,15,37,50,-13,32
Wellington P,3157,9,5,6,16,31,55,-24,21
CC Mariners,3157,10,4,8,15,28,49,-21,20
Sydney FC,3158,1,21,4,3,66,23,43,67
N'castle Jet,3158,2,16,5,7,58,37,21,53
Melbourne C,3158,3,14,4,11,43,34,9,46
Melbourne V,3158,4,13,5,11,46,40,6,44
Adelaide Utd,3158,5,11,6,11,37,40,-3,39
Brisbane,3158,6,10,5,13,33,42,-9,35
Western Sydn,3158,7,8,9,10,38,47,-9,33
Perth Glory,3158,8,10,2,15,37,50,-13,32
Wellington P,3158,9,5,6,16,31,55,-24,21
CC Mariners,3158,10,4,8,15,28,49,-21,20
Sydney FC,3159,1,21,4,3,67,24,43,67
N'castle Jet,3159,2,15,6,7,60,40,20,51
Melbourne C,3159,3,14,5,10,46,36,10,47
Melbourne V,3159,4,13,5,11,47,41,6,44
Adelaide Utd,3159,5,11,6,11,37,40,-3,39
Brisbane,3159,6,10,5,13,33,42,-9,35
Western Sydn,3159,7,8,9,10,38,47,-9,33
Perth Glory,3159,8,10,2,15,37,50,-13,32
Wellington P,3159,9,5,6,16,31,55,-24,21
CC Mariners,3159,10,4,8,15,28,49,-21,20
Sydney FC,3160,1,20,4,4,65,24,41,64
N'castle Jet,3160,2,15,6,7,59,39,20,51
Melbourne C,3160,3,14,5,10,45,35,10,47
Melbourne V,3160,4,14,5,10,47,39,8,47
Adelaide Utd,3160,5,11,6,11,37,40,-3,39
Brisbane,3160,6,10,5,13,33,42,-9,35
Western Sydn,3160,7,8,9,10,38,47,-9,33
Perth Glory,3160,8,10,2,15,37,50,-13,32
Wellington P,3160,9,5,6,16,31,55,-24,21
CC Mariners,3160,10,4,8,15,28,49,-21,20
Sydney FC,3161,1,21,4,3,66,22,44,67
N'castle Jet,3161,2,15,5,8,58,39,19,50
Melbourne C,3161,3,15,4,10,45,34,11,49
Melbourne V,3161,4,13,5,11,45,40,5,44
Adelaide Utd,3161,5,11,6,11,37,40,-3,39
Brisbane,3161,6,10,5,13,33,42,-9,35
Western Sydn,3161,7,8,9,10,38,47,-9,33
Perth Glory,3161,8,10,2,15,37,50,-13,32
Wellington P,3161,9,5,6,16,31,55,-24,21
CC Mariners,3161,10,4,8,15,28,49,-21,20
Sydney FC,3162,1,20,5,3,65,23,42,65
N'castle Jet,3162,2,15,5,8,58,39,19,50
Melbourne C,3162,3,15,4,10,45,34,11,49
Melbourne V,3162,4,13,6,10,46,39,7,45
Adelaide Utd,3162,5,11,6,11,37,40,-3,39
Brisbane,3162,6,10,5,13,33,42,-9,35
Western Sydn,3162,7,8,9,10,38,47,-9,33
Perth Glory,3162,8,10,2,15,37,50,-13,32
Wellington P,3162,9,5,6,16,31,55,-24,21
CC Mariners,3162,10,4,8,15,28,49,-21,20
Sydney FC,3163,1,21,4,3,67,22,45,67
N'castle Jet,3163,2,16,5,7,59,37,22,53
Melbourne C,3163,3,14,4,11,43,35,8,46
Melbourne V,3163,4,13,5,11,45,41,4,44
Adelaide Utd,3163,5,11,6,11,37,40,-3,39
Brisbane,3163,6,10,5,13,33,42,-9,35
Western Sydn,3163,7,8,9,10,38,47,-9,33
Perth Glory,3163,8,10,2,15,37,50,-13,32
Wellington P,3163,9,5,6,16,31,55,-24,21
CC Mariners,3163,10,4,8,15,28,49,-21,20
Sydney FC,3164,1,21,4,3,65,22,43,67
N'castle Jet,3164,2,15,5,8,57,39,18,50
Melbourne C,3164,3,15,4,10,45,33,12,49
Melbourne V,3164,4,13,5,11,45,39,6,44
Adelaide Utd,3164,5,11,6,11,37,40,-3,39
Brisbane,3164,6,10,5,13,33,42,-9,35
Western Sydn,3164,7,8,9,10,38,47,-9,33
Perth Glory,3164,8,10,2,15,37,50,-13,32
Wellington P,3164,9,5,6,16,31,55,-24,21
CC Mariners,3164,10,4,8,15,28,49,-21,20
Sydney FC,3165,1,21,4,3,67,23,44,67
N'castle Jet,3165,2,15,6,7,57,37,20,51
Melbourne C,3165,3,14,5,10,43,33,10,47
Melbourne V,3165,4,13,5,11,46,41,5,44
Adelaide Utd,3165,5,11,6,11,37,40,-3,39
Brisbane,3165,6,10,5,13,33,42,-9,35
Western Sydn,3165,7,8,9,10,38,47,-9,33
Perth Glory,3165,8,10,2,15,37,50,-13,32
Wellington P,3165,9,5,6,16,31,55,-24,21
CC Mariners,3165,10,4,8,15,28,49,-21,20
Sydney FC,3166,1,21,4,3,68,23,45,67
N'castle Jet,3166,2,16,5,7,61,37,24,53
Melbourne C,3166,3,14,4,11,43,37,6,46
Melbourne V,3166,4,13,5,11,46,42,4,44
Adelaide Utd,3166,5,11,6,11,37,40,-3,39
Brisbane,3166,6,10,5,13,33,42,-9,35
Western Sydn,3166,7,8,9,10,38,47,-9,33
Perth Glory,3166,8,10,2,15,37,50,-13,32
Wellington P,3166,9,5,6,16,31,55,-24,21
CC Mariners,3166,10,4,8,15,28,49,-21,20
Sydney FC,3167,1,20,5,3,65,23,42,65
N'castle Jet,3167,2,15,5,8,57,38,19,50
Melbourne C,3167,3,15,4,10,44,33,11,49
Melbourne V,3167,4,13,6,10,46,39,7,45
Adelaide Utd,3167,5,11,6,11,37,40,-3,39
Brisbane,3167,6,10,5,13,33,42,-9,35
Western Sydn,3167,7,8,9,10,38,47,-9,33
Perth Glory,3167,8,10,2,15,37,50,-13,32
Wellington P,3167,9,5,6,16,31,55,-24,21
CC Mariners,3167,10,4,8,15,28,49,-21,20
Sydney FC,3168,1,21,4,3,67,24,43,67
N'castle Jet,3168,2,15,5,8,57,38,19,50
Melbourne C,3168,3,15,4,10,44,33,11,49
Melbourne V,3168,4,13,5,11,47,41,6,44
Adelaide Utd,3168,5,11,6,11,37,40,-3,39
Brisbane,3168,6,10,5,13,33,42,-9,35
Western Sydn,3168,7,8,9,10,38,47,-9,33
Perth Glory,3168,8,10,2,15,37,50,-13,32
Wellington P,3168,9,5,6,16,31,55,-24,21
CC Mariners,3168,10,4,8,15,28,49,-21,20
Sydney FC,3169,1,21,4,3,67,24,43,67
N'castle Jet,3169,2,16,5,7,62,39,23,53
Melbourne C,3169,3,14,4,11,45,38,7,46
Melbourne V,3169,4,13,5,11,47,41,6,44
Adelaide Utd,3169,5,11,6,11,37,40,-3,39
Brisbane,3169,6,10,5,13,33,42,-9,35
Western Sydn,3169,7,8,9,10,38,47,-9,33
Perth Glory,3169,8,10,2,15,37,50,-13,32
Wellington P,3169,9,5,6,16,31,55,-24,21
CC Mariners,3169,10,4,8,15,28,49,-21,20
Sydney FC,3170,1,20,5,3,65,23,42,65
N'castle Jet,3170,2,16,5,7,58,37,21,53
Melbourne C,3170,3,14,4,11,43,34,9,46
Melbourne V,3170,4,13,6,10,46,39,7,45
Adelaide Utd,3170,5,11,6,11,37,40,-3,39
Brisbane,3170,6,10,5,13,33,42,-9,35
Western Sydn,3170,7,8,9,10,38,47,-9,33
Perth Glory,3170,8,10,2,15,37,50,-13,32
Wellington P,3170,9,5,6,16,31,55,-24,21
CC Mariners,3170,10,4,8,15,28,49,-21,20
Sydney FC,3171,1,20,4,4,64,24,40,64
N'castle Jet,3171,2,16,5,7,61,38,23,53
Melbourne V,3171,3,14,5,10,47,38,9,47
Melbourne C,3171,4,14,4,11,44,37,7,46
Adelaide Utd,3171,5,11,6,11,37,40,-3,39
Brisbane,3171,6,10,5,13,33,42,-9,35
Western Sydn,3171,7,8,9,10,38,47,-9,33
Perth Glory,3171,8,10,2,15,37,50,-13,32
Wellington P,3171,9,5,6,16,31,55,-24,21
CC Mariners,3171,10,4,8,15,28,49,-21,20
Sydney FC,3172,1,20,5,3,65,23,42,65
N'castle Jet,3172,2,15,5,8,57,38,19,50
Melbourne C,3172,3,15,4,10,44,33,11,49
Melbourne V,3172,4,13,6,10,46,39,7,45
Adelaide Utd,3172,5,11,6,11,37,40,-3,39
Brisbane,3172,6,10,5,13,33,42,-9,35
Western Sydn,3172,7,8,9,10,38,47,-9,33
Perth Glory,3172,8,10,2,15,37,50,-13,32
Wellington P,3172,9,5,6,16,31,55,-24,21
CC Mariners,3172,10,4,8,15,28,49,-21,20
Sydney FC,3173,1,20,5,3,65,23,42,65
N'castle Jet,3173,2,16,5,7,59,38,21,53
Melbourne C,3173,3,14,4,11,44,35,9,46
Melbourne V,3173,4,13,6,10,46,39,7,45
Adelaide Utd,3173,5,11,6,11,37,40,-3,39
Brisbane,3173,6,10,5,13,33,42,-9,35
Western Sydn,3173,7,8,9,10,38,47,-9,33
Perth Glory,3173,8,10,2,15,37,50,-13,32
Wellington P,3173,9,5,6,16,31,55,-24,21
CC Mariners,3173,10,4,8,15,28,49,-21,20
Sydney FC,3174,1,21,4,3,67,23,44,67
N'castle Jet,3174,2,15,5,8,57,39,18,50
Melbourne C,3174,3,15,4,10,45,33,12,49
Melbourne V,3174,4,13,5,11,46,41,5,44
Adelaide Utd,3174,5,11,6,11,37,40,-3,39
Brisbane,3174,6,10,5,13,33,42,-9,35
Western Sydn,3174,7,8,9,10,38,47,-9,33
Perth Glory,3174,8,10,2,15,37,50,-13,32
Wellington P,3174,9,5,6,16,31,55,-24,21
CC Mariners,3174,10,4,8,15,28,49,-21,20
Sydney FC,3175,1,20,4,4,64,23,41,64
N'castle Jet,3175,2,16,5,7,61,38,23,53
Melbourne V,3175,3,14,5,10,46,38,8,47
Melbourne C,3175,4,14,4,11,44,37,7,46
Adelaide Utd,3175,5,11,6,11,37,40,-3,39
Brisbane,3175,6,10,5,13,33,42,-9,35
Western Sydn,3175,7,8,9,10,38,47,-9,33
Perth Glory,3175,8,10,2,15,37,50,-13,32
Wellington P,3175,9,5,6,16,31,55,-24,21
CC Mariners,3175,10,4,8,15,28,49,-21,20
Sydney FC,3176,1,21,4,3,66,22,44,67
N'castle Jet,3176,2,15,6,7,59,39,20,51
Melbourne C,3176,3,14,5,10,45,35,10,47
Melbourne V,3176,4,13,5,11,45,40,5,44
Adelaide Utd,3176,5,11,6,11,37,40,-3,39
Brisbane,3176,6,10,5,13,33,42,-9,35
Western Sydn,3176,7,8,9,10,38,47,-9,33
Perth Glory,3176,8,10,2,15,37,50,-13,32
Wellington P,3176,9,5,6,16,31,55,-24,21
CC Mariners,3176,10,4,8,15,28,49,-21,20
Sydney FC,3177,1,20,4,4,64,24,40,64
N'castle Jet,3177,2,15,5,8,58,41,17,50
Melbourne C,3177,3,15,4,10,47,34,13,49
Melbourne V,3177,4,14,5,10,47,38,9,47
Adelaide Utd,3177,5,11,6,11,37,40,-3,39
Brisbane,3177,6,10,5,13,33,42,-9,35
Western Sydn,3177,7,8,9,10,38,47,-9,33
Perth Glory,3177,8,10,2,15,37,50,-13,32
Wellington P,3177,9,5,6,16,31,55,-24,21
CC Mariners,3177,10,4,8,15,28,49,-21,20
Sydney FC,3178,1,20,5,3,65,23,42,65
N'castle Jet,3178,2,15,6,7,58,38,20,51
Melbourne C,3178,3,14,5,10,44,34,10,47
Melbourne V,3178,4,13,6,10,46,39,7,45
Adelaide Utd,3178,5,11,6,11,37,40,-3,39
Brisbane,3178,6,10,5,13,33,42,-9,35
Western Sydn,3178,7,8,9,10,38,47,-9,33
Perth Glory,3178,8,10,2,15,37,50,-13,32
Wellington P,3178,9,5,6,16,31,55,-24,21
CC Mariners,3178,10,4,8,15,28,49,-21,20
Sydney FC,3179,1,21,4,3,68,23,45,67
N'castle Jet,3179,2,15,6,7,57,37,20,51
Melbourne C,3179,3,14,5,10,43,33,10,47
Melbourne V,3179,4,13,5,11,46,42,4,44
Adelaide Utd,3179,5,11,6,11,37,40,-3,39
Brisbane,3179,6,10,5,13,33,42,-9,35
Western Sydn,3179,7,8,9,10,38,47,-9,33
Perth Glory,3179,8,10,2,15,37,50,-13,32
Wellington P,3179,9,5,6,16,31,55,-24,21
CC Mariners,3179,10,4,8,15,28,49,-21,20
Sydney FC,3180,1,21,4,3,69,24,45,67
N'castle Jet,3180,2,16,5,7,60,39,21,53
Melbourne C,3180,3,14,4,11,45,36,9,46
Melbourne V,3180,4,13,5,11,47,43,4,44
Adelaide Utd,3180,5,11,6,11,37,40,-3,39
Brisbane,3180,6,10,5,13,33,42,-9,35
Western Sydn,3180,7,8,9,10,38,47,-9,33
Perth Glory,3180,8,10,2,15,37,50,-13,32
Wellington P,3180,9,5,6,16,31,55,-24,21
CC Mariners,3180,10,4,8,15,28,49,-21,20
Sydney FC,3181,1,21,4,3,67,22,45,67
N'castle Jet,3181,2,15,6,7,58,38,20,51
Melbourne C,3181,3,14,5,10,44,34,10,47
Melbourne V,3181,4,13,5,11,45,41,4,44
Adelaide Utd,3181,5,11,6,11,37,40,-3,39
Brisbane,3181,6,10,5,13,33,42,-9,35
Western Sydn,3181,7,8,9,10,38,47,-9,33
Perth Glory,3181,8,10,2,15,37,50,-13,32
Wellington P,3181,9,5,6,16,31,55,-24,21
CC Mariners,3181,10,4,8,15,28,49,-21,20
Sydney FC,3182,1,21,4,3,68,25,43,67
N'castle Jet,3182,2,16,5,7,60,39,21,53
Melbourne C,3182,3,14,4,11,45,36,9,46
Melbourne V,3182,4,13,5,11,48,42,6,44
Adelaide Utd,3182,5,11,6,11,37,40,-3,39
Brisbane,3182,6,10,5,13,33,42,-9,35
Western Sydn,3182,7,8,9,10,38,47,-9,33
Perth Glory,3182,8,10,2,15,37,50,-13,32
Wellington P,3182,9,5,6,16,31,55,-24,21
CC Mariners,3182,10,4,8,15,28,49,-21,20
Sydney FC,3183,1,20,4,4,65,26,39,64
N'castle Jet,3183,2,16,5,7,60,38,22,53
Melbourne V,3183,3,14,5,10,49,39,10,47
Melbourne C,3183,4,14,4,11,44,36,8,46
Adelaide Utd,3183,5,11,6,11,37,40,-3,39
Brisbane,3183,6,10,5,13,33,42,-9,35
Western Sydn,3183,7,8,9,10,38,47,-9,33
Perth Glory,3183,8,10,2,15,37,50,-13,32
Wellington P,3183,9,5,6,16,31,55,-24,21
CC Mariners,3183,10,4,8,15,28,49,-21,20
Sydney FC,3184,1,20,4,4,64,24,40,64
N'castle Jet,3184,2,16,5,7,59,37,22,53
Melbourne V,3184,3,14,5,10,47,38,9,47
Melbourne C,3184,4,14,4,11,43,35,8,46
Adelaide Utd,3184,5,11,6,11,37,40,-3,39
Brisbane,3184,6,10,5,13,33,42,-9,35
Western Sydn,3184,7,8,9,10,38,47,-9,33
Perth Glory,3184,8,10,2,15,37,50,-13,32
Wellington P,3184,9,5,6,16,31,55,-24,21
CC Mariners,3184,10,4,8,15,28,49,-21,20
Sydney FC,3185,1,21,4,3,65,22,43,67
N'castle Jet,3185,2,16,5,7,59,37,22,53
Melbourne C,3185,3,14,4,11,43,35,8,46
Melbourne V,3185,4,13,5,11,45,39,6,44
Adelaide Utd,3185,5,11,6,11,37,40,-3,39
Brisbane,3185,6,10,5,13,33,42,-9,35
Western Sydn,3185,7,8,9,10,38,47,-9,33
Perth Glory,3185,8,10,2,15,37,50,-13,32
Wellington P,3185,9,5,6,16,31,55,-24,21
CC Mariners,3185,10,4,8,15,28,49,-21,20
Sydney FC,3186,1,21,4,3,67,22,45,67
N'castle Jet,3186,2,16,5,7,58,37,21,53
Melbourne C,3186,3,14,4,11,43,34,9,46
Melbourne V,3186,4,13,5,11,45,41,4,44
Adelaide Utd,3186,5,11,6,11,37,40,-3,39
Brisbane,3186,6,10,5,13,33,42,-9,35
Western Sydn,3186,7,8,9,10,38,47,-9,33
Perth Glory,3186,8,10,2,15,37,50,-13,32
Wellington P,3186,9,5,6,16,31,55,-24,21
CC Mariners,3186,10,4,8,15,28,49,-21,20
Sydney FC,3187,1,21,4,3,66,22,44,67
N'castle Jet,3187,2,16,5,7,59,38,21,53
Melbourne C,3187,3,14,4,11,44,35,9,46
Melbourne V,3187,4,13,5,11,45,40,5,44
Adelaide Utd,3187,5,11,6,11,37,40,-3,39
Brisbane,3187,6,10,5,13,33,42,-9,35
Western Sydn,3187,7,8,9,10,38,47,-9,33
Perth Glory,3187,8,10,2,15,37,50,-13,32
Wellington P,3187,9,5,6,16,31,55,-24,21
CC Mariners,3187,10,4,8,15,28,49,-21,20
Sydney FC,3188,1,21,4,3,65,22,43,67
N'castle Jet,3188,2,15,5,8,57,38,19,50
Melbourne C,3188,3,15,4,10,44,33,11,49
Melbourne V,3188,4,13,5,11,45,39,6,44
Adelaide Utd,3188,5,11,6,11,37,40,-3,39
Brisbane,3188,6,10,5,13,33,42,-9,35
Western Sydn,3188,7,8,9,10,38,47,-9,33
Perth Glory,3188,8,10,2,15,37,50,-13,32
Wellington P,3188,9,5,6,16,31,55,-24,21
CC Mariners,3188,10,4,8,15,28,49,-21,20
Sydney FC,3189,1,20,5,3,65,23,42,65
N'castle Jet,3189,2,16,5,7,60,38,22,53
Melbourne C,3189,3,14,4,11,44,36,8,46
Melbourne V,3189,4,13,6,10,46,39,7,45
Adelaide Utd,3189,5,11,6,11,37,40,-3,39
Brisbane,3189,6,10,5,13,33,42,-9,35
Western Sydn,3189,7,8,9,10,38,47,-9,33
Perth Glory,3189,8,10,2,15,37,50,-13,32
Wellington P,3189,9,5,6,16,31,55,-24,21
CC Mariners,3189,10,4,8,15,28,49,-21,20
Sydney FC,3190,1,21,4,3,67,23,44,67
N'castle Jet,3190,2,15,5,8,58,40,18,50
Melbourne C,3190,3,15,4,10,46,34,12,49
Melbourne V,3190,4,13,5,11,46,41,5,44
Adelaide Utd,3190,5,11,6,11,37,40,-3,39
Brisbane,3190,6,10,5,13,33,42,-9,35
Western Sydn,3190,7,8,9,10,38,47,-9,33
Perth Glory,3190,8,10,2,15,37,50,-13,32
Wellington P,3190,9,5,6,16,31,55,-24,21
CC Mariners,3190,10,4,8,15,28,49,-21,20
Sydney FC,3191,1,21,4,3,67,22,45,67
N'castle Jet,3191,2,16,5,7,60,38,22,53
Melbourne C,3191,3,14,4,11,44,36,8,46
Melbourne V,3191,4,13,5,11,45,41,4,44
Adelaide Utd,3191,5,11,6,11,37,40,-3,39
Brisbane,3191,6,10,5,13,33,42,-9,35
Western Sydn,3191,7,8,9,10,38,47,-9,33
Perth Glory,3191,8,10,2,15,37,50,-13,32
Wellington P,3191,9,5,6,16,31,55,-24,21
CC Mariners,3191,10,4,8,15,28,49,-21,20
Sydney FC,3192,1,20,4,4,64,23,41,64
N'castle Jet,3192,2,16,5,7,59,38,21,53
Melbourne V,3192,3,14,5,10,46,38,8,47
Melbourne C,3192,4,14,4,11,44,35,9,46
Adelaide Utd,3192,5,11,6,11,37,40,-3,39
Brisbane,3192,6,10,5,13,33,42,-9,35
Western Sydn,3192,7,8,9,10,38,47,-9,33
Perth Glory,3192,8,10,2,15,37,50,-13,32
Wellington P,3192,9,5,6,16,31,55,-24,21
CC Mariners,3192,10,4,8,15,28,49,-21,20
Sydney FC,3193,1,21,4,3,66,22,44,67
N'castle Jet,3193,2,16,5,7,58,37,21,53
Melbourne C,3193,3,14,4,11,43,34,9,46
Melbourne V,3193,4,13,5,11,45,40,5,44
Adelaide Utd,3193,5,11,6,11,37,40,-3,39
Brisbane,3193,6,10,5,13,33,42,-9,35
Western Sydn,3193,7,8,9,10,38,47,-9,33
Perth Glory,3193,8,10,2,15,37,50,-13,32
Wellington P,3193,9,5,6,16,31,55,-24,21
CC Mariners,3193,10,4,8,15,28,49,-21,20
Sydney FC,3194,1,21,4,3,67,22,45,67
N'castle Jet,3194,2,16,5,7,59,38,21,53
Melbourne C,3194,3,14,4,11,44,35,9,46
Melbourne V,3194,4,13,5,11,45,41,4,44
Adelaide Utd,3194,5,11,6,11,37,40,-3,39
Brisbane,3194,6,10,5,13,33,42,-9,35
Western Sydn,3194,7,8,9,10,38,47,-9,33
Perth Glory,3194,8,10,2,15,37,50,-13,32
Wellington P,3194,9,5,6,16,31,55,-24,21
CC Mariners,3194,10,4,8,15,28,49,-21,20
Sydney FC,3195,1,21,4,3,68,23,45,67
N'castle Jet,3195,2,15,6,7,58,38,20,51
Melbourne C,3195,3,14,5,10,44,34,10,47
Melbourne V,3195,4,13,5,11,46,42,4,44
Adelaide Utd,3195,5,11,6,11,37,40,-3,39
Brisbane,3195,6,10,5,13,33,42,-9,35
Western Sydn,3195,7,8,9,10,38,47,-9,33
Perth Glory,3195,8,10,2,15,37,50,-13,32
Wellington P,3195,9,5,6,16,31,55,-24,21
CC Mariners,3195,10,4,8,15,28,49,-21,20
Sydney FC,3196,1,20,5,3,65,23,42,65
N'castle Jet,3196,2,15,6,7,58,38,20,51
Melbourne C,3196,3,14,5,10,44,34,10,47
Melbourne V,3196,4,13,6,10,46,39,7,45
Adelaide Utd,3196,5,11,6,11,37,40,-3,39
Brisbane,3196,6,10,5,13,33,42,-9,35
Western Sydn,3196,7,8,9,10,38,47,-9,33
Perth Glory,3196,8,10,2,15,37,50,-13,32
Wellington P,3196,9,5,6,16,31,55,-24,21
CC Mariners,3196,10,4,8,15,28,49,-21,20
Sydney FC,3197,1,20,5,3,65,23,42,65
N'castle Jet,3197,2,15,5,8,58,39,19,50
Melbourne C,3197,3,15,4,10,45,34,11,49
Melbourne V,3197,4,13,6,10,46,39,7,45
Adelaide Utd,3197,5,11,6,11,37,40,-3,39
Brisbane,3197,6,10,5,13,33,42,-9,35
Western Sydn,3197,7,8,9,10,38,47,-9,33
Perth Glory,3197,8,10,2,15,37,50,-13,32
Wellington P,3197,9,5,6,16,31,55,-24,21
CC Mariners,3197,10,4,8,15,28,49,-21,20
Sydney FC,3198,1,20,4,4,65,24,41,64
N'castle Jet,3198,2,15,5,8,57,39,18,50
Melbourne C,3198,3,15,4,10,45,33,12,49
Melbourne V,3198,4,14,5,10,47,39,8,47
Adelaide Utd,3198,5,11,6,11,37,40,-3,39
Brisbane,3198,6,10,5,13,33,42,-9,35
Western Sydn,3198,7,8,9,10,38,47,-9,33
Perth Glory,3198,8,10,2,15,37,50,-13,32
Wellington P,3198,9,5,6,16,31,55,-24,21
CC Mariners,3198,10,4,8,15,28,49,-21,20
Sydney FC,3199,1,21,4,3,67,22,45,67
N'castle Jet,3199,2,16,5,7,61,38,23,53
Melbourne C,3199,3,14,4,11,44,37,7,46
Melbourne V,3199,4,13,5,11,45,41,4,44
Adelaide Utd,3199,5,11,6,11,37,40,-3,39
Brisbane,3199,6,10,5,13,33,42,-9,35
Western Sydn,3199,7,8,9,10,38,47,-9,33
Perth Glory,3199,8,10,2,15,37,50,-13,32
Wellington P,3199,9,5,6,16,31,55,-24,21
CC Mariners,3199,10,4,8,15,28,49,-21,20
Sydney FC,3200,1,21,4,3,67,24,43,67
N'castle Jet,3200,2,15,6,7,58,38,20,51
Melbourne C,3200,3,14,5,10,44,34,10,47
Melbourne V,3200,4,13,5,11,47,41,6,44
Adelaide Utd,3200,5,11,6,11,37,40,-3,39
Brisbane,3200,6,10,5,13,33,42,-9,35
Western Sydn,3200,7,8,9,10,38,47,-9,33
Perth Glory,3200,8,10,2,15,37,50,-13,32
Wellington P,3200,9,5,6,16,31,55,-24,21
CC Mariners,3200,10,4,8,15,28,49,-21,20
Sydney FC,3201,1,20,5,3,66,24,42,65
N'castle Jet,3201,2,16,5,7,58,37,21,53
Melbourne C,3201,3,14,4,11,43,34,9,46
Melbourne V,3201,4,13,6,10,47,40,7,45
Adelaide Utd,3201,5,11,6,11,37,40,-3,39
Brisbane,3201,6,10,5,13,33,42,-9,35
Western Sydn,3201,7,8,9,10,38,47,-9,33
Perth Glory,3201,8,10,2,15,37,50,-13,32
Wellington P,3201,9,5,6,16,31,55,-24,21
CC Mariners,3201,10,4,8,15,28,49,-21,20
Sydney FC,3202,1,21,4,3,69,23,46,67
N'castle Jet,3202,2,15,5,8,58,40,18,50
Melbourne C,3202,3,15,4,10,46,34,12,49
Melbourne V,3202,4,13,5,11,46,43,3,44
Adelaide Utd,3202,5,11,6,11,37,40,-3,39
Brisbane,3202,6,10,5,13,33,42,-9,35
Western Sydn,3202,7,8,9,10,38,47,-9,33
Perth Glory,3202,8,10,2,15,37,50,-13,32
Wellington P,3202,9,5,6,16,31,55,-24,21
CC Mariners,3202,10,4,8,15,28,49,-21,20
Sydney FC,3203,1,20,5,3,66,24,42,65
N'castle Jet,3203,2,16,5,7,58,37,21,53
Melbourne C,3203,3,14,4,11,43,34,9,46
Melbourne V,3203,4,13,6,10,47,40,7,45
Adelaide Utd,3203,5,11,6,11,37,40,-3,39
Brisbane,3203,6,10,5,13,33,42,-9,35
Western Sydn,3203,7,8,9,10,38,47,-9,33
Perth Glory,3203,8,10,2,15,37,50,-13,32
Wellington P,3203,9,5,6,16,31,55,-24,21
CC Mariners,3203,10,4,8,15,28,49,-21,20
Sydney FC,3204,1,21,4,3,67,23,44,67
N'castle Jet,3204,2,16,5,7,58,37,21,53
Melbourne C,3204,3,14,4,11,43,34,9,46
Melbourne V,3204,4,13,5,11,46,41,5,44
Adelaide Utd,3204,5,11,6,11,37,40,-3,39
Brisbane,3204,6,10,5,13,33,42,-9,35
Western Sydn,3204,7,8,9,10,38,47,-9,33
Perth Glory,3204,8,10,2,15,37,50,-13,32
Wellington P,3204,9,5,6,16,31,55,-24,21
CC Mariners,3204,10,4,8,15,28,49,-21,20
Sydney FC,3205,1,21,4,3,68,23,45,67
N'castle Jet,3205,2,15,5,8,57,38,19,50
Melbourne C,3205,3,15,4,10,44,33,11,49
Melbourne V,3205,4,13,5,11,46,42,4,44
Adelaide Utd,3205,5,11,6,11,37,40,-3,39
Brisbane,3205,6,10,5,13,33,42,-9,35
Western Sydn,3205,7,8,9,10,38,47,-9,33
Perth Glory,3205,8,10,2,15,37,50,-13,32
Wellington P,3205,9,5,6,16,31,55,-24,21
CC Mariners,3205,10,4,8,15,28,49,-21,20
Sydney FC,3206,1,20,4,4,64,24,40,64
N'castle Jet,3206,2,15,6,7,60,40,20,51
Melbourne C,3206,3,14,5,10,46,36,10,47
Melbourne V,3206,4,14,5,10,47,38,9,47
Adelaide Utd,3206,5,11,6,11,37,40,-3,39
Brisbane,3206,6,10,5,13,33,42,-9,35
Western Sydn,3206,7,8,9,10,38,47,-9,33
Perth Glory,3206,8,10,2,15,37,50,-13,32
Wellington P,3206,9,5,6,16,31,55,-24,21
CC Mariners,3206,10,4,8,15,28,49,-21,20
Sydney FC,3207,1,21,4,3,66,22,44,67
N'castle Jet,3207,2,16,5,7,60,37,23,53
Melbourne C,3207,3,14,4,11,43,36,7,46
Melbourne V,3207,4,13,5,11,45,40,5,44
Adelaide Utd,3207,5,11,6,11,37,40,-3,39
Brisbane,3207,6,10,5,13,33,42,-9,35
Western Sydn,3207,7,8,9,10,38,47,-9,33
Perth Glory,3207,8,10,2,15,37,50,-13,32
Wellington P,3207,9,5,6,16,31,55,-24,21
CC Mariners,3207,10,4,8,15,28,49,-21,20
Sydney FC,3208,1,21,4,3,67,22,45,67
N'castle Jet,3208,2,16,5,7,61,38,23,53
Melbourne C,3208,3,14,4,11,44,37,7,46
Melbourne V,3208,4,13,5,11,45,41,4,44
Adelaide Utd,3208,5,11,6,11,37,40,-3,39
Brisbane,3208,6,10,5,13,33,42,-9,35
Western Sydn,3208,7,8,9,10,38,47,-9,33
Perth Glory,3208,8,10,2,15,37,50,-13,32
Wellington P,3208,9,5,6,16,31,55,-24,21
CC Mariners,3208,10,4,8,15,28,49,-21,20
Sydney FC,3209,1,21,4,3,68,22,46,67
N'castle Jet,3209,2,15,5,8,58,39,19,50
Melbourne C,3209,3,15,4,10,45,34,11,49
Melbourne V,3209,4,13,5,11,45,42,3,44
Adelaide Utd,3209,5,11,6,11,37,40,-3,39
Brisbane,3209,6,10,5,13,33,42,-9,35
Western Sydn,3209,7,8,9,10,38,47,-9,33
Perth Glory,3209,8,10,2,15,37,50,-13,32
Wellington P,3209,9,5,6,16,31,55,-24,21
CC Mariners,3209,10,4,8,15,28,49,-21,20
Sydney FC,3210,1,21,4,3,65,22,43,67
N'castle Jet,3210,2,16,5,7,60,38,22,53
Melbourne C,3210,3,14,4,11,44,36,8,46
Melbourne V,3210,4,13,5,11,45,39,6,44
Adelaide Utd,3210,5,11,6,11,37,40,-3,39
Brisbane,3210,6,10,5,13,33,42,-9,35
Western Sydn,3210,7,8,9,10,38,47,-9,33
Perth Glory,3210,8,10,2,15,37,50,-13,32
Wellington P,3210,9,5,6,16,31,55,-24,21
CC Mariners,3210,10,4,8,15,28,49,-21,20
Sydney FC,3211,1,21,4,3,65,22,43,67
N'castle Jet,3211,2,15,5,8,58,39,19,50
Melbourne C,3211,3,15,4,10,45,34,11,49
Melbourne V,3211,4,13,5,11,45,39,6,44
Adelaide Utd,3211,5,11,6,11,37,40,-3,39
Brisbane,3211,6,10,5,13,33,42,-9,35
Western Sydn,3211,7,8,9,10,38,47,-9,33
Perth Glory,3211,8,10,2,15,37,50,-13,32
Wellington P,3211,9,5,6,16,31,55,-24,21
CC Mariners,3211,10,4,8,15,28,49,-21,20
Sydney FC,3212,1,20,5,3,65,23,42,65
N'castle Jet,3212,2,15,5,8,57,38,19,50
Melbourne C,3212,3,15,4,10,44,33,11,49
Melbourne V,3212,4,13,6,10,46,39,7,45
Adelaide Utd,3212,5,11,6,11,37,40,-3,39
Brisbane,3212,6,10,5,13,33,42,-9,35
Western Sydn,3212,7,8,9,10,38,47,-9,33
Perth Glory,3212,8,10,2,15,37,50,-13,32
Wellington P,3212,9,5,6,16,31,55,-24,21
CC Mariners,3212,10,4,8,15,28,49,-21,20
Sydney FC,3213,1,21,4,3,66,23,43,67
N'castle Jet,3213,2,15,5,8,57,39,18,50
Melbourne C,3213,3,15,4,10,45,33,12,49
Melbourne V,3213,4,13,5,11,46,40,6,44
Adelaide Utd,3213,5,11,6,11,37,40,-3,39
Brisbane,3213,6,10,5,13,33,42,-9,35
Western Sydn,3213,7,8,9,10,38,47,-9,33
Perth Glory,3213,8,10,2,15,37,50,-13,32
Wellington P,3213,9,5,6,16,31,55,-24,21
CC Mariners,3213,10,4,8,15,28,49,-21,20
Sydney FC,3214,1,20,5,3,65,23,42,65
N'castle Jet,3214,2,16,5,7,59,37,22,53
Melbourne C,3214,3,14,4,11,43,35,8,46
Melbourne V,3214,4,13,6,10,46,39,7,45
Adelaide Utd,3214,5,11,6,11,37,40,-3,39
Brisbane,3214,6,10,5,13,33,42,-9,35
Western Sydn,3214,7,8,9,10,38,47,-9,33
Perth Glory,3214,8,10,2,15,37,50,-13,32
Wellington P,3214,9,5,6,16,31,55,-24,21
CC Mariners,3214,10,4,8,15,28,49,-21,20
Sydney FC,3215,1,21,4,3,66,22,44,67
N'castle Jet,3215,2,16,5,7,60,39,21,53
Melbourne C,3215,3,14,4,11,45,36,9,46
Melbourne V,3215,4,13,5,11,45,40,5,44
Adelaide Utd,3215,5,11,6,11,37,40,-3,39
Brisbane,3215,6,10,5,13,33,42,-9,35
Western Sydn,3215,7,8,9,10,38,47,-9,33
Perth Glory,3215,8,10,2,15,37,50,-13,32
Wellington P,3215,9,5,6,16,31,55,-24,21
CC Mariners,3215,10,4,8,15,28,49,-21,20
Sydney FC,3216,1,21,4,3,65,22,43,67
N'castle Jet,3216,2,15,5,8,58,39,19,50
Melbourne C,3216,3,15,4,10,45,34,11,49
Melbourne V,3216,4,13,5,11,45,39,6,44
Adelaide Utd,3216,5,11,6,11,37,40,-3,39
Brisbane,3216,6,10,5,13,33,42,-9,35
Western Sydn,3216,7,8,9,10,38,47,-9,33
Perth Glory,3216,8,10,2,15,37,50,-13,32
Wellington P,3216,9,5,6,16,31,55,-24,21
CC Mariners,3216,10,4,8,15,28,49,-21,20
Sydney FC,3217,1,21,4,3,67,23,44,67
N'castle Jet,3217,2,15,6,7,60,40,20,51
Melbourne C,3217,3,14,5,10,46,36,10,47
Melbourne V,3217,4,13,5,11,46,41,5,44
Adelaide Utd,3217,5,11,6,11,37,40,-3,39
Brisbane,3217,6,10,5,13,33,42,-9,35
Western Sydn,3217,7,8,9,10,38,47,-9,33
Perth Glory,3217,8,10,2,15,37,50,-13,32
Wellington P,3217,9,5,6,16,31,55,-24,21
CC Mariners,3217,10,4,8,15,28,49,-21,20
Sydney FC,3218,1,21,4,3,68,25,43,67
N'castle Jet,3218,2,16,5,7,59,37,22,53
Melbourne C,3218,3,14,4,11,43,35,8,46
Melbourne V,3218,4,13,5,11,48,42,6,44
Adelaide Utd,3218,5,11,6,11,37,40,-3,39
Brisbane,3218,6,10,5,13,33,42,-9,35
Western Sydn,3218,7,8,9,10,38,47,-9,33
Perth Glory,3218,8,10,2,15,37,50,-13,32
Wellington P,3218,9,5,6,16,31,55,-24,21
CC Mariners,3218,10,4,8,15,28,49,-21,20
Sydney FC,3219,1,21,4,3,65,22,43,67
N'castle Jet,3219,2,16,5,7,60,38,22,53
Melbourne C,3219,3,14,4,11,44,36,8,46
Melbourne V,3219,4,13,5,11,45,39,6,44
Adelaide Utd,3219,5,11,6,11,37,40,-3,39
Brisbane,3219,6,10,5,13,33,42,-9,35
Western Sydn,3219,7,8,9,10,38,47,-9,33
Perth Glory,3219,8,10,2,15,37,50,-13,32
Wellington P,3219,9,5,6,16,31,55,-24,21
CC Mariners,3219,10,4,8,15,28,49,-21,20
Sydney FC,3220,1,21,4,3,67,23,44,67
N'castle Jet,3220,2,16,5,7,60,39,21,53
Melbourne C,3220,3,14,4,11,45,36,9,46
Melbourne V,3220,4,13,5,11,46,41,5,44
Adelaide Utd,3220,5,11,6,11,37,40,-3,39
Brisbane,3220,6,10,5,13,33,42,-9,35
Western Sydn,3220,7,8,9,10,38,47,-9,33
Perth Glory,3220,8,10,2,15,37,50,-13,32
Wellington P,3220,9,5,6,16,31,55,-24,21
CC Mariners,3220,10,4,8,15,28,49,-21,20
Sydney FC,3221,1,20,4,4,66,25,41,64
N'castle Jet,3221,2,16,5,7,58,37,21,53
Melbourne V,3221,3,14,5,10,48,40,8,47
Melbourne C,3221,4,14,4,11,43,34,9,46
Adelaide Utd,3221,5,11,6,11,37,40,-3,39
Brisbane,3221,6,10,5,13,33,42,-9,35
Western Sydn,3221,7,8,9,10,38,47,-9,33
Perth Glory,3221,8,10,2,15,37,50,-13,32
Wellington P,3221,9,5,6,16,31,55,-24,21
CC Mariners,3221,10,4,8,15,28,49,-21,20
Sydney FC,3222,1,20,5,3,65,23,42,65
N'castle Jet,3222,2,16,5,7,60,38,22,53
Melbourne C,3222,3,14,4,11,44,36,8,46
Melbourne V,3222,4,13,6,10,46,39,7,45
Adelaide Utd,3222,5,11,6,11,37,40,-3,39
Brisbane,3222,6,10,5,13,33,42,-9,35
Western Sydn,3222,7,8,9,10,38,47,-9,33
Perth Glory,3222,8,10,2,15,37,50,-13,32
Wellington P,3222,9,5,6,16,31,55,-24,21
CC Mariners,3222,10,4,8,15,28,49,-21,20
Sydney FC,3223,1,21,4,3,66,23,43,67
N'castle Jet,3223,2,16,5,7,59,38,21,53
Melbourne C,3223,3,14,4,11,44,35,9,46
Melbourne V,3223,4,13,5,11,46,40,6,44
Adelaide Utd,3223,5,11,6,11,37,40,-3,39
Brisbane,3223,6,10,5,13,33,42,-9,35
Western Sydn,3223,7,8,9,10,38,47,-9,33
Perth Glory,3223,8,10,2,15,37,50,-13,32
Wellington P,3223,9,5,6,16,31,55,-24,21
CC Mariners,3223,10,4,8,15,28,49,-21,20
Sydney FC,3224,1,21,4,3,67,22,45,67
N'castle Jet,3224,2,15,6,7,59,39,20,51
Melbourne C,3224,3,14,5,10,45,35,10,47
Melbourne V,3224,4,13,5,11,45,41,4,44
Adelaide Utd,3224,5,11,6,11,37,40,-3,39
Brisbane,3224,6,10,5,13,33,42,-9,35
Western Sydn,3224,7,8,9,10,38,47,-9,33
Perth Glory,3224,8,10,2,15,37,50,-13,32
Wellington P,3224,9,5,6,16,31,55,-24,21
CC Mariners,3224,10,4,8,15,28,49,-21,20
Sydney FC,3225,1,20,5,3,65,23,42,65
N'castle Jet,3225,2,16,5,7,59,38,21,53
Melbourne C,3225,3,14,4,11,44,35,9,46
Melbourne V,3225,4,13,6,10,46,39,7,45
Adelaide Utd,3225,5,11,6,11,37,40,-3,39
Brisbane,3225,6,10,5,13,33,42,-9,35
Western Sydn,3225,7,8,9,10,38,47,-9,33
Perth Glory,3225,8,10,2,15,37,50,-13,32
Wellington P,3225,9,5,6,16,31,55,-24,21
CC Mariners,3225,10,4,8,15,28,49,-21,20
Sydney FC,3226,1,21,4,3,66,23,43,67
N'castle Jet,3226,2,16,5,7,60,39,21,53
Melbourne C,3226,3,14,4,11,45,36,9,46
Melbourne V,3226,4,13,5,11,46,40,6,44
Adelaide Utd,3226,5,11,6,11,37,40,-3,39
Brisbane,3226,6,10,5,13,33,42,-9,35
Western Sydn,3226,7,8,9,10,38,47,-9,33
Perth Glory,3226,8,10,2,15,37,50,-13,32
Wellington P,3226,9,5,6,16,31,55,-24,21
CC Mariners,3226,10,4,8,15,28,49,-21,20
Sydney FC,3227,1,20,5,3,65,23,42,65
N'castle Jet,3227,2,15,5,8,58,39,19,50
Melbourne C,3227,3,15,4,10,45,34,11,49
Melbourne V,3227,4,13,6,10,46,39,7,45
Adelaide Utd,3227,5,11,6,11,37,40,-3,39
Brisbane,3227,6,10,5,13,33,42,-9,35
Western Sydn,3227,7,8,9,10,38,47,-9,33
Perth Glory,3227,8,10,2,15,37,50,-13,32
Wellington P,3227,9,5,6,16,31,55,-24,21
CC Mariners,3227,10,4,8,15,28,49,-21,20
Sydney FC,3228,1,21,4,3,65,22,43,67
N'castle Jet,3228,2,16,5,7,59,38,21,53
Melbourne C,3228,3,14,4,11,44,35,9,46
Melbourne V,3228,4,13,5,11,45,39,6,44
Adelaide Utd,3228,5,11,6,11,37,40,-3,39
Brisbane,3228,6,10,5,13,33,42,-9,35
Western Sydn,3228,7,8,9,10,38,47,-9,33
Perth Glory,3228,8,10,2,15,37,50,-13,32
Wellington P,3228,9,5,6,16,31,55,-24,21
CC Mariners,3228,10,4,8,15,28,49,-21,20
Sydney FC,3229,1,20,5,3,66,24,42,65
N'castle Jet,3229,2,15,5,8,59,40,19,50
Melbourne C,3229,3,15,4,10,46,35,11,49
Melbourne V,3229,4,13,6,10,47,40,7,45
Adelaide Utd,3229,5,11,6,11,37,40,-3,39
Brisbane,3229,6,10,5,13,33,42,-9,35
Western Sydn,3229,7,8,9,10,38,47,-9,33
Perth Glory,3229,8,10,2,15,37,50,-13,32
Wellington P,3229,9,5,6,16,31,55,-24,21
CC Mariners,3229,10,4,8,15,28,49,-21,20
Sydney FC,3230,1,20,5,3,64,22,42,65
N'castle Jet,3230,2,16,5,7,59,38,21,53
Melbourne C,3230,3,14,4,11,44,35,9,46
Melbourne V,3230,4,13,6,10,45,38,7,45
Adelaide Utd,3230,5,11,6,11,37,40,-3,39
Brisbane,3230,6,10,5,13,33,42,-9,35
Western Sydn,3230,7,8,9,10,38,47,-9,33
Perth Glory,3230,8,10,2,15,37,50,-13,32
Wellington P,3230,9,5,6,16,31,55,-24,21
CC Mariners,3230,10,4,8,15,28,49,-21,20
Sydney FC,3231,1,20,4,4,65,25,40,64
N'castle Jet,3231,2,16,5,7,59,37,22,53
Melbourne V,3231,3,14,5,10,48,39,9,47
Melbourne C,3231,4,14,4,11,43,35,8,46
Adelaide Utd,3231,5,11,6,11,37,40,-3,39
Brisbane,3231,6,10,5,13,33,42,-9,35
Western Sydn,3231,7,8,9,10,38,47,-9,33
Perth Glory,3231,8,10,2,15,37,50,-13,32
Wellington P,3231,9,5,6,16,31,55,-24,21
CC Mariners,3231,10,4,8,15,28,49,-21,20
Sydney FC,3232,1,20,4,4,64,25,39,64
N'castle Jet,3232,2,16,5,7,61,38,23,53
Melbourne V,3232,3,14,5,10,48,38,10,47
Melbourne C,3232,4,14,4,11,44,37,7,46
Adelaide Utd,3232,5,11,6,11,37,40,-3,39
Brisbane,3232,6,10,5,13,33,42,-9,35
Western Sydn,3232,7,8,9,10,38,47,-9,33
Perth Glory,3232,8,10,2,15,37,50,-13,32
Wellington P,3232,9,5,6,16,31,55,-24,21
CC Mariners,3232,10,4,8,15,28,49,-21,20
Sydney FC,3233,1,20,5,3,64,22,42,65
N'castle Jet,3233,2,16,5,7,59,38,21,53
Melbourne C,3233,3,14,4,11,44,35,9,46
Melbourne V,3233,4,13,6,10,45,38,7,45
Adelaide Utd,3233,5,11,6,11,37,40,-3,39
Brisbane,3233,6,10,5,13,33,42,-9,35
Western Sydn,3233,7,8,9,10,38,47,-9,33
Perth Glory,3233,8,10,2,15,37,50,-13,32
Wellington P,3233,9,5,6,16,31,55,-24,21
CC Mariners,3233,10,4,8,15,28,49,-21,20
Sydney FC,3234,1,20,4,4,64,24,40,64
N'castle Jet,3234,2,16,5,7,60,39,21,53
Melbourne V,3234,3,14,5,10,47,38,9,47
Melbourne C,3234,4,14,4,11,45,36,9,46
Adelaide Utd,3234,5,11,6,11,37,40,-3,39
Brisbane,3234,6,10,5,13,33,42,-9,35
Western Sydn,3234,7,8,9,10,38,47,-9,33
Perth Glory,3234,8,10,2,15,37,50,-13,32
Wellington P,3234,9,5,6,16,31,55,-24,21
CC Mariners,3234,10,4,8,15,28,49,-21,20
Sydney FC,3235,1,20,4,4,66,26,40,64
N'castle Jet,3235,2,15,5,8,57,38,19,50
Melbourne C,3235,3,15,4,10,44,33,11,49
Melbourne V,3235,4,14,5,10,49,40,9,47
Adelaide Utd,3235,5,11,6,11,37,40,-3,39
Brisbane,3235,6,10,5,13,33,42,-9,35
Western Sydn,3235,7,8,9,10,38,47,-9,33
Perth Glory,3235,8,10,2,15,37,50,-13,32
Wellington P,3235,9,5,6,16,31,55,-24,21
CC Mariners,3235,10,4,8,15,28,49,-21,20
Sydney FC,3236,1,20,5,3,67,25,42,65
N'castle Jet,3236,2,16,5,7,59,37,22,53
Melbourne C,3236,3,14,4,11,43,35,8,46
Melbourne V,3236,4,13,6,10,48,41,7,45
Adelaide Utd,3236,5,11,6,11,37,40,-3,39
Brisbane,3236,6,10,5,13,33,42,-9,35
Western Sydn,3236,7,8,9,10,38,47,-9,33
Perth Glory,3236,8,10,2,15,37,50,-13,32
Wellington P,3236,9,5,6,16,31,55,-24,21
CC Mariners,3236,10,4,8,15,28,49,-21,20
Sydney FC,3237,1,20,4,4,64,23,41,64
N'castle Jet,3237,2,16,5,7,58,37,21,53
Melbourne V,3237,3,14,5,10,46,38,8,47
Melbourne C,3237,4,14,4,11,43,34,9,46
Adelaide Utd,3237,5,11,6,11,37,40,-3,39
Brisbane,3237,6,10,5,13,33,42,-9,35
Western Sydn,3237,7,8,9,10,38,47,-9,33
Perth Glory,3237,8,10,2,15,37,50,-13,32
Wellington P,3237,9,5,6,16,31,55,-24,21
CC Mariners,3237,10,4,8,15,28,49,-21,20
Sydney FC,3238,1,20,4,4,64,23,41,64
N'castle Jet,3238,2,16,5,7,61,38,23,53
Melbourne V,3238,3,14,5,10,46,38,8,47
Melbourne C,3238,4,14,4,11,44,37,7,46
Adelaide Utd,3238,5,11,6,11,37,40,-3,39
Brisbane,3238,6,10,5,13,33,42,-9,35
Western Sydn,3238,7,8,9,10,38,47,-9,33
Perth Glory,3238,8,10,2,15,37,50,-13,32
Wellington P,3238,9,5,6,16,31,55,-24,21
CC Mariners,3238,10,4,8,15,28,49,-21,20
Sydney FC,3239,1,21,4,3,66,22,44,67
N'castle Jet,3239,2,16,5,7,61,37,24,53
Melbourne C,3239,3,14,4,11,43,37,6,46
Melbourne V,3239,4,13,5,11,45,40,5,44
Adelaide Utd,3239,5,11,6,11,37,40,-3,39
Brisbane,3239,6,10,5,13,33,42,-9,35
Western Sydn,3239,7,8,9,10,38,47,-9,33
Perth Glory,3239,8,10,2,15,37,50,-13,32
Wellington P,3239,9,5,6,16,31,55,-24,21
CC Mariners,3239,10,4,8,15,28,49,-21,20
Sydney FC,3240,1,21,4,3,66,22,44,67
N'castle Jet,3240,2,16,5,7,58,37,21,53
Melbourne C,3240,3,14,4,11,43,34,9,46
Melbourne V,3240,4,13,5,11,45,40,5,44
Adelaide Utd,3240,5,11,6,11,37,40,-3,39
Brisbane,3240,6,10,5,13,33,42,-9,35
Western Sydn,3240,7,8,9,10,38,47,-9,33
Perth Glory,3240,8,10,2,15,37,50,-13,32
Wellington P,3240,9,5,6,16,31,55,-24,21
CC Mariners,3240,10,4,8,15,28,49,-21,20
Sydney FC,3241,1,21,4,3,65,22,43,67
N'castle Jet,3241,2,15,5,8,58,39,19,50
Melbourne C,3241,3,15,4,10,45,34,11,49
Melbourne V,3241,4,13,5,11,45,39,6,44
Adelaide Utd,3241,5,11,6,11,37,40,-3,39
Brisbane,3241,6,10,5,13,33,42,-9,35
Western Sydn,3241,7,8,9,10,38,47,-9,33
Perth Glory,3241,8,10,2,15,37,50,-13,32
Wellington P,3241,9,5,6,16,31,55,-24,21
CC Mariners,3241,10,4,8,15,28,49,-21,20
Sydney FC,3242,1,21,4,3,66,23,43,67
N'castle Jet,3242,2,15,5,8,58,40,18,50
Melbourne C,3242,3,15,4,10,46,34,12,49
Melbourne V,3242,4,13,5,11,46,40,6,44
Adelaide Utd,3242,5,11,6,11,37,40,-3,39
Brisbane,3242,6,10,5,13,33,42,-9,35
Western Sydn,3242,7,8,9,10,38,47,-9,33
Perth Glory,3242,8,10,2,15,37,50,-13,32
Wellington P,3242,9,5,6,16,31,55,-24,21
CC Mariners,3242,10,4,8,15,28,49,-21,20
Sydney FC,3243,1,21,4,3,66,23,43,67
N'castle Jet,3243,2,16,5,7,60,38,22,53
Melbourne C,3243,3,14,4,11,44,36,8,46
Melbourne V,3243,4,13,5,11,46,40,6,44
Adelaide Utd,3243,5,11,6,11,37,40,-3,39
Brisbane,3243,6,10,5,13,33,42,-9,35
Western Sydn,3243,7,8,9,10,38,47,-9,33
Perth Glory,3243,8,10,2,15,37,50,-13,32
Wellington P,3243,9,5,6,16,31,55,-24,21
CC Mariners,3243,10,4,8,15,28,49,-21,20
Sydney FC,3244,1,21,4,3,72,25,47,67
N'castle Jet,3244,2,16,5,7,59,38,21,53
Melbourne C,3244,3,14,4,11,44,35,9,46
Melbourne V,3244,4,13,5,11,48,46,2,44
Adelaide Utd,3244,5,11,6,11,37,40,-3,39
Brisbane,3244,6,10,5,13,33,42,-9,35
Western Sydn,3244,7,8,9,10,38,47,-9,33
Perth Glory,3244,8,10,2,15,37,50,-13,32
Wellington P,3244,9,5,6,16,31,55,-24,21
CC Mariners,3244,10,4,8,15,28,49,-21,20
Sydney FC,3245,1,20,5,3,64,22,42,65
N'castle Jet,3245,2,15,6,7,58,38,20,51
Melbourne C,3245,3,14,5,10,44,34,10,47
Melbourne V,3245,4,13,6,10,45,38,7,45
Adelaide Utd,3245,5,11,6,11,37,40,-3,39
Brisbane,3245,6,10,5,13,33,42,-9,35
Western Sydn,3245,7,8,9,10,38,47,-9,33
Perth Glory,3245,8,10,2,15,37,50,-13,32
Wellington P,3245,9,5,6,16,31,55,-24,21
CC Mariners,3245,10,4,8,15,28,49,-21,20
Sydney FC,3246,1,21,4,3,67,22,45,67
N'castle Jet,3246,2,15,6,7,59,39,20,51
Melbourne C,3246,3,14,5,10,45,35,10,47
Melbourne V,3246,4,13,5,11,45,41,4,44
Adelaide Utd,3246,5,11,6,11,37,40,-3,39
Brisbane,3246,6,10,5,13,33,42,-9,35
Western Sydn,3246,7,8,9,10,38,47,-9,33
Perth Glory,3246,8,10,2,15,37,50,-13,32
Wellington P,3246,9,5,6,16,31,55,-24,21
CC Mariners,3246,10,4,8,15,28,49,-21,20
Sydney FC,3247,1,21,4,3,67,22,45,67
N'castle Jet,3247,2,15,5,8,59,40,19,50
Melbourne C,3247,3,15,4,10,46,35,11,49
Melbourne V,3247,4,13,5,11,45,41,4,44
Adelaide Utd,3247,5,11,6,11,37,40,-3,39
Brisbane,3247,6,10,5,13,33,42,-9,35
Western Sydn,3247,7,8,9,10,38,47,-9,33
Perth Glory,3247,8,10,2,15,37,50,-13,32
Wellington P,3247,9,5,6,16,31,55,-24,21
CC Mariners,3247,10,4,8,15,28,49,-21,20
Sydney FC,3248,1,21,4,3,66,22,44,67
N'castle Jet,3248,2,15,5,8,59,41,18,50
Melbourne C,3248,3,15,4,10,47,35,12,49
Melbourne V,3248,4,13,5,11,45,40,5,44
Adelaide Utd,3248,5,11,6,11,37,40,-3,39
Brisbane,3248,6,10,5,13,33,42,-9,35
Western Sydn,3248,7,8,9,10,38,47,-9,33
Perth Glory,3248,8,10,2,15,37,50,-13,32
Wellington P,3248,9,5,6,16,31,55,-24,21
CC Mariners,3248,10,4,8,15,28,49,-21,20
Sydney FC,3249,1,21,4,3,67,22,45,67
N'castle Jet,3249,2,15,5,8,58,39,19,50
Melbourne C,3249,3,15,4,10,45,34,11,49
Melbourne V,3249,4,13,5,11,45,41,4,44
Adelaide Utd,3249,5,11,6,11,37,40,-3,39
Brisbane,3249,6,10,5,13,33,42,-9,35
Western Sydn,3249,7,8,9,10,38,47,-9,33
Perth Glory,3249,8,10,2,15,37,50,-13,32
Wellington P,3249,9,5,6,16,31,55,-24,21
CC Mariners,3249,10,4,8,15,28,49,-21,20
Sydney FC,3250,1,20,5,3,65,23,42,65
N'castle Jet,3250,2,15,6,7,58,38,20,51
Melbourne C,3250,3,14,5,10,44,34,10,47
Melbourne V,3250,4,13,6,10,46,39,7,45
Adelaide Utd,3250,5,11,6,11,37,40,-3,39
Brisbane,3250,6,10,5,13,33,42,-9,35
Western Sydn,3250,7,8,9,10,38,47,-9,33
Perth Glory,3250,8,10,2,15,37,50,-13,32
Wellington P,3250,9,5,6,16,31,55,-24,21
CC Mariners,3250,10,4,8,15,28,49,-21,20
Sydney FC,3251,1,20,5,3,67,25,42,65
N'castle Jet,3251,2,16,5,7,60,37,23,53
Melbourne C,3251,3,14,4,11,43,36,7,46
Melbourne V,3251,4,13,6,10,48,41,7,45
Adelaide Utd,3251,5,11,6,11,37,40,-3,39
Brisbane,3251,6,10,5,13,33,42,-9,35
Western Sydn,3251,7,8,9,10,38,47,-9,33
Perth Glory,3251,8,10,2,15,37,50,-13,32
Wellington P,3251,9,5,6,16,31,55,-24,21
CC Mariners,3251,10,4,8,15,28,49,-21,20
Sydney FC,3252,1,20,4,4,65,24,41,64
N'castle Jet,3252,2,15,5,8,58,39,19,50
Melbourne C,3252,3,15,4,10,45,34,11,49
Melbourne V,3252,4,14,5,10,47,39,8,47
Adelaide Utd,3252,5,11,6,11,37,40,-3,39
Brisbane,3252,6,10,5,13,33,42,-9,35
Western Sydn,3252,7,8,9,10,38,47,-9,33
Perth Glory,3252,8,10,2,15,37,50,-13,32
Wellington P,3252,9,5,6,16,31,55,-24,21
CC Mariners,3252,10,4,8,15,28,49,-21,20
Sydney FC,3253,1,21,4,3,66,23,43,67
N'castle Jet,3253,2,16,5,7,60,39,21,53
Melbourne C,3253,3,14,4,11,45,36,9,46
Melbourne V,3253,4,13,5,11,46,40,6,44
Adelaide Utd,3253,5,11,6,11,37,40,-3,39
Brisbane,3253,6,10,5,13,33,42,-9,35
Western Sydn,3253,7,8,9,10,38,47,-9,33
Perth Glory,3253,8,10,2,15,37,50,-13,32
Wellington P,3253,9,5,6,16,31,55,-24,21
CC Mariners,3253,10,4,8,15,28,49,-21,20
Sydney FC,3254,1,21,4,3,66,23,43,67
N'castle Jet,3254,2,16,5,7,60,38,22,53
Melbourne C,3254,3,14,4,11,44,36,8,46
Melbourne V,3254,4,13,5,11,46,40,6,44
Adelaide Utd,3254,5,11,6,11,37,40,-3,39
Brisbane,3254,6,10,5,13,33,42,-9,35
Western Sydn,3254,7,8,9,10,38,47,-9,33
Perth Glory,3254,8,10,2,15,37,50,-13,32
Wellington P,3254,9,5,6,16,31,55,-24,21
CC Mariners,3254,10,4,8,15,28,49,-21,20
Sydney FC,3255,1,20,4,4,66,25,41,64
N'castle Jet,3255,2,16,5,7,62,38,24,53
Melbourne V,3255,3,14,5,10,48,40,8,47
Melbourne C,3255,4,14,4,11,44,38,6,46
Adelaide Utd,3255,5,11,6,11,37,40,-3,39
Brisbane,3255,6,10,5,13,33,42,-9,35
Western Sydn,3255,7,8,9,10,38,47,-9,33
Perth Glory,3255,8,10,2,15,37,50,-13,32
Wellington P,3255,9,5,6,16,31,55,-24,21
CC Mariners,3255,10,4,8,15,28,49,-21,20
Sydney FC,3256,1,21,4,3,67,24,43,67
N'castle Jet,3256,2,15,5,8,57,39,18,50
Melbourne C,3256,3,15,4,10,45,33,12,49
Melbourne V,3256,4,13,5,11,47,41,6,44
Adelaide Utd,3256,5,11,6,11,37,40,-3,39
Brisbane,3256,6,10,5,13,33,42,-9,35
Western Sydn,3256,7,8,9,10,38,47,-9,33
Perth Glory,3256,8,10,2,15,37,50,-13,32
Wellington P,3256,9,5,6,16,31,55,-24,21
CC Mariners,3256,10,4,8,15,28,49,-21,20
Sydney FC,3257,1,20,4,4,64,24,40,64
N'castle Jet,3257,2,16,5,7,59,38,21,53
Melbourne V,3257,3,14,5,10,47,38,9,47
Melbourne C,3257,4,14,4,11,44,35,9,46
Adelaide Utd,3257,5,11,6,11,37,40,-3,39
Brisbane,3257,6,10,5,13,33,42,-9,35
Western Sydn,3257,7,8,9,10,38,47,-9,33
Perth Glory,3257,8,10,2,15,37,50,-13,32
Wellington P,3257,9,5,6,16,31,55,-24,21
CC Mariners,3257,10,4,8,15,28,49,-21,20
Sydney FC,3258,1,20,4,4,66,25,41,64
N'castle Jet,3258,2,16,5,7,60,39,21,53
Melbourne V,3258,3,14,5,10,48,40,8,47
Melbourne C,3258,4,14,4,11,45,36,9,46
Adelaide Utd,3258,5,11,6,11,37,40,-3,39
Brisbane,3258,6,10,5,13,33,42,-9,35
Western Sydn,3258,7,8,9,10,38,47,-9,33
Perth Glory,3258,8,10,2,15,37,50,-13,32
Wellington P,3258,9,5,6,16,31,55,-24,21
CC Mariners,3258,10,4,8,15,28,49,-21,20
Sydney FC,3259,1,21,4,3,68,22,46,67
N'castle Jet,3259,2,16,5,7,59,38,21,53
Melbourne C,3259,3,14,4,11,44,35,9,46
Melbourne V,3259,4,13,5,11,45,42,3,44
Adelaide Utd,3259,5,11,6,11,37,40,-3,39
Brisbane,3259,6,10,5,13,33,42,-9,35
Western Sydn,3259,7,8,9,10,38,47,-9,33
Perth Glory,3259,8,10,2,15,37,50,-13,32
Wellington P,3259,9,5,6,16,31,55,-24,21
CC Mariners,3259,10,4,8,15,28,49,-21,20
Sydney FC,3260,1,20,5,3,67,25,42,65
N'castle Jet,3260,2,15,5,8,57,38,19,50
Melbourne C,3260,3,15,4,10,44,33,11,49
Melbourne V,3260,4,13,6,10,48,41,7,45
Adelaide Utd,3260,5,11,6,11,37,40,-3,39
Brisbane,3260,6,10,5,13,33,42,-9,35
Western Sydn,3260,7,8,9,10,38,47,-9,33
Perth Glory,3260,8,10,2,15,37,50,-13,32
Wellington P,3260,9,5,6,16,31,55,-24,21
CC Mariners,3260,10,4,8,15,28,49,-21,20
Sydney FC,3261,1,21,4,3,66,23,43,67
N'castle Jet,3261,2,15,6,7,57,37,20,51
Melbourne C,3261,3,14,5,10,43,33,10,47
Melbourne V,3261,4,13,5,11,46,40,6,44
Adelaide Utd,3261,5,11,6,11,37,40,-3,39
Brisbane,3261,6,10,5,13,33,42,-9,35
Western Sydn,3261,7,8,9,10,38,47,-9,33
Perth Glory,3261,8,10,2,15,37,50,-13,32
Wellington P,3261,9,5,6,16,31,55,-24,21
CC Mariners,3261,10,4,8,15,28,49,-21,20
Sydney FC,3262,1,21,4,3,67,22,45,67
N'castle Jet,3262,2,16,5,7,58,37,21,53
Melbourne C,3262,3,14,4,11,43,34,9,46
Melbourne V,3262,4,13,5,11,45,41,4,44
Adelaide Utd,3262,5,11,6,11,37,40,-3,39
Brisbane,3262,6,10,5,13,33,42,-9,35
Western Sydn,3262,7,8,9,10,38,47,-9,33
Perth Glory,3262,8,10,2,15,37,50,-13,32
Wellington P,3262,9,5,6,16,31,55,-24,21
CC Mariners,3262,10,4,8,15,28,49,-21,20
Sydney FC,3263,1,21,4,3,67,24,43,67
N'castle Jet,3263,2,15,5,8,59,40,19,50
Melbourne C,3263,3,15,4,10,46,35,11,49
Melbourne V,3263,4,13,5,11,47,41,6,44
Adelaide Utd,3263,5,11,6,11,37,40,-3,39
Brisbane,3263,6,10,5,13,33,42,-9,35
Western Sydn,3263,7,8,9,10,38,47,-9,33
Perth Glory,3263,8,10,2,15,37,50,-13,32
Wellington P,3263,9,5,6,16,31,55,-24,21
CC Mariners,3263,10,4,8,15,28,49,-21,20
Sydney FC,3264,1,21,4,3,66,22,44,67
N'castle Jet,3264,2,16,5,7,60,39,21,53
Melbourne C,3264,3,14,4,11,45,36,9,46
Melbourne V,3264,4,13,5,11,45,40,5,44
Adelaide Utd,3264,5,11,6,11,37,40,-3,39
Brisbane,3264,6,10,5,13,33,42,-9,35
Western Sydn,3264,7,8,9,10,38,47,-9,33
Perth Glory,3264,8,10,2,15,37,50,-13,32
Wellington P,3264,9,5,6,16,31,55,-24,21
CC Mariners,3264,10,4,8,15,28,49,-21,20
Sydney FC,3265,1,20,4,4,65,24,41,64
N'castle Jet,3265,2,16,5,7,58,37,21,53
Melbourne V,3265,3,14,5,10,47,39,8,47
Melbourne C,3265,4,14,4,11,43,34,9,46
Adelaide Utd,3265,5,11,6,11,37,40,-3,39
Brisbane,3265,6,10,5,13,33,42,-9,35
Western Sydn,3265,7,8,9,10,38,47,-9,33
Perth Glory,3265,8,10,2,15,37,50,-13,32
Wellington P,3265,9,5,6,16,31,55,-24,21
CC Mariners,3265,10,4,8,15,28,49,-21,20
Sydney FC,3266,1,20,5,3,64,22,42,65
N'castle Jet,3266,2,15,5,8,58,40,18,50
Melbourne C,3266,3,15,4,10,46,34,12,49
Melbourne V,3266,4,13,6,10,45,38,7,45
Adelaide Utd,3266,5,11,6,11,37,40,-3,39
Brisbane,3266,6,10,5,13,33,42,-9,35
Western Sydn,3266,7,8,9,10,38,47,-9,33
Perth Glory,3266,8,10,2,15,37,50,-13,32
Wellington P,3266,9,5,6,16,31,55,-24,21
CC Mariners,3266,10,4,8,15,28,49,-21,20
Sydney FC,3267,1,20,4,4,64,24,40,64
N'castle Jet,3267,2,15,5,8,57,38,19,50
Melbourne C,3267,3,15,4,10,44,33,11,49
Melbourne V,3267,4,14,5,10,47,38,9,47
Adelaide Utd,3267,5,11,6,11,37,40,-3,39
Brisbane,3267,6,10,5,13,33,42,-9,35
Western Sydn,3267,7,8,9,10,38,47,-9,33
Perth Glory,3267,8,10,2,15,37,50,-13,32
Wellington P,3267,9,5,6,16,31,55,-24,21
CC Mariners,3267,10,4,8,15,28,49,-21,20
Sydney FC,3268,1,21,4,3,67,23,44,67
N'castle Jet,3268,2,15,5,8,57,39,18,50
Melbourne C,3268,3,15,4,10,45,33,12,49
Melbourne V,3268,4,13,5,11,46,41,5,44
Adelaide Utd,3268,5,11,6,11,37,40,-3,39
Brisbane,3268,6,10,5,13,33,42,-9,35
Western Sydn,3268,7,8,9,10,38,47,-9,33
Perth Glory,3268,8,10,2,15,37,50,-13,32
Wellington P,3268,9,5,6,16,31,55,-24,21
CC Mariners,3268,10,4,8,15,28,49,-21,20
Sydney FC,3269,1,21,4,3,67,24,43,67
N'castle Jet,3269,2,15,5,8,57,38,19,50
Melbourne C,3269,3,15,4,10,44,33,11,49
Melbourne V,3269,4,13,5,11,47,41,6,44
Adelaide Utd,3269,5,11,6,11,37,40,-3,39
Brisbane,3269,6,10,5,13,33,42,-9,35
Western Sydn,3269,7,8,9,10,38,47,-9,33
Perth Glory,3269,8,10,2,15,37,50,-13,32
Wellington P,3269,9,5,6,16,31,55,-24,21
CC Mariners,3269,10,4,8,15,28,49,-21,20
Sydney FC,3270,1,21,4,3,66,22,44,67
N'castle Jet,3270,2,15,5,8,57,39,18,50
Melbourne C,3270,3,15,4,10,45,33,12,49
Melbourne V,3270,4,13,5,11,45,40,5,44
Adelaide Utd,3270,5,11,6,11,37,40,-3,39
Brisbane,3270,6,10,5,13,33,42,-9,35
Western Sydn,3270,7,8,9,10,38,47,-9,33
Perth Glory,3270,8,10,2,15,37,50,-13,32
Wellington P,3270,9,5,6,16,31,55,-24,21
CC Mariners,3270,10,4,8,15,28,49,-21,20
Sydney FC,3271,1,21,4,3,67,23,44,67
N'castle Jet,3271,2,16,5,7,60,38,22,53
Melbourne C,3271,3,14,4,11,44,36,8,46
Melbourne V,3271,4,13,5,11,46,41,5,44
Adelaide Utd,3271,5,11,6,11,37,40,-3,39
Brisbane,3271,6,10,5,13,33,42,-9,35
Western Sydn,3271,7,8,9,10,38,47,-9,33
Perth Glory,3271,8,10,2,15,37,50,-13,32
Wellington P,3271,9,5,6,16,31,55,-24,21
CC Mariners,3271,10,4,8,15,28,49,-21,20
Sydney FC,3272,1,20,4,4,64,23,41,64
N'castle Jet,3272,2,15,5,8,59,40,19,50
Melbourne C,3272,3,15,4,10,46,35,11,49
Melbourne V,3272,4,14,5,10,46,38,8,47
Adelaide Utd,3272,5,11,6,11,37,40,-3,39
Brisbane,3272,6,10,5,13,33,42,-9,35
Western Sydn,3272,7,8,9,10,38,47,-9,33
Perth Glory,3272,8,10,2,15,37,50,-13,32
Wellington P,3272,9,5,6,16,31,55,-24,21
CC Mariners,3272,10,4,8,15,28,49,-21,20
Sydney FC,3273,1,21,4,3,66,23,43,67
N'castle Jet,3273,2,16,5,7,59,37,22,53
Melbourne C,3273,3,14,4,11,43,35,8,46
Melbourne V,3273,4,13,5,11,46,40,6,44
Adelaide Utd,3273,5,11,6,11,37,40,-3,39
Brisbane,3273,6,10,5,13,33,42,-9,35
Western Sydn,3273,7,8,9,10,38,47,-9,33
Perth Glory,3273,8,10,2,15,37,50,-13,32
Wellington P,3273,9,5,6,16,31,55,-24,21
CC Mariners,3273,10,4,8,15,28,49,-21,20
Sydney FC,3274,1,21,4,3,66,23,43,67
N'castle Jet,3274,2,16,5,7,59,38,21,53
Melbourne C,3274,3,14,4,11,44,35,9,46
Melbourne V,3274,4,13,5,11,46,40,6,44
Adelaide Utd,3274,5,11,6,11,37,40,-3,39
Brisbane,3274,6,10,5,13,33,42,-9,35
Western Sydn,3274,7,8,9,10,38,47,-9,33
Perth Glory,3274,8,10,2,15,37,50,-13,32
Wellington P,3274,9,5,6,16,31,55,-24,21
CC Mariners,3274,10,4,8,15,28,49,-21,20
Sydney FC,3275,1,21,4,3,68,23,45,67
N'castle Jet,3275,2,16,5,7,60,39,21,53
Melbourne C,3275,3,14,4,11,45,36,9,46
Melbourne V,3275,4,13,5,11,46,42,4,44
Adelaide Utd,3275,5,11,6,11,37,40,-3,39
Brisbane,3275,6,10,5,13,33,42,-9,35
Western Sydn,3275,7,8,9,10,38,47,-9,33
Perth Glory,3275,8,10,2,15,37,50,-13,32
Wellington P,3275,9,5,6,16,31,55,-24,21
CC Mariners,3275,10,4,8,15,28,49,-21,20
Sydney FC,3276,1,21,4,3,67,22,45,67
N'castle Jet,3276,2,16,5,7,59,38,21,53
Melbourne C,3276,3,14,4,11,44,35,9,46
Melbourne V,3276,4,13,5,11,45,41,4,44
Adelaide Utd,3276,5,11,6,11,37,40,-3,39
Brisbane,3276,6,10,5,13,33,42,-9,35
Western Sydn,3276,7,8,9,10,38,47,-9,33
Perth Glory,3276,8,10,2,15,37,50,-13,32
Wellington P,3276,9,5,6,16,31,55,-24,21
CC Mariners,3276,10,4,8,15,28,49,-21,20
Sydney FC,3277,1,21,4,3,68,22,46,67
N'castle Jet,3277,2,16,5,7,58,37,21,53
Melbourne C,3277,3,14,4,11,43,34,9,46
Melbourne V,3277,4,13,5,11,45,42,3,44
Adelaide Utd,3277,5,11,6,11,37,40,-3,39
Brisbane,3277,6,10,5,13,33,42,-9,35
Western Sydn,3277,7,8,9,10,38,47,-9,33
Perth Glory,3277,8,10,2,15,37,50,-13,32
Wellington P,3277,9,5,6,16,31,55,-24,21
CC Mariners,3277,10,4,8,15,28,49,-21,20
Sydney FC,3278,1,21,4,3,67,22,45,67
N'castle Jet,3278,2,15,5,8,58,42,16,50
Melbourne C,3278,3,15,4,10,48,34,14,49
Melbourne V,3278,4,13,5,11,45,41,4,44
Adelaide Utd,3278,5,11,6,11,37,40,-3,39
Brisbane,3278,6,10,5,13,33,42,-9,35
Western Sydn,3278,7,8,9,10,38,47,-9,33
Perth Glory,3278,8,10,2,15,37,50,-13,32
Wellington P,3278,9,5,6,16,31,55,-24,21
CC Mariners,3278,10,4,8,15,28,49,-21,20
Sydney FC,3279,1,21,4,3,68,23,45,67
N'castle Jet,3279,2,15,6,7,58,38,20,51
Melbourne C,3279,3,14,5,10,44,34,10,47
Melbourne V,3279,4,13,5,11,46,42,4,44
Adelaide Utd,3279,5,11,6,11,37,40,-3,39
Brisbane,3279,6,10,5,13,33,42,-9,35
Western Sydn,3279,7,8,9,10,38,47,-9,33
Perth Glory,3279,8,10,2,15,37,50,-13,32
Wellington P,3279,9,5,6,16,31,55,-24,21
CC Mariners,3279,10,4,8,15,28,49,-21,20
Sydney FC,3280,1,20,5,3,65,23,42,65
N'castle Jet,3280,2,15,5,8,57,38,19,50
Melbourne C,3280,3,15,4,10,44,33,11,49
Melbourne V,3280,4,13,6,10,46,39,7,45
Adelaide Utd,3280,5,11,6,11,37,40,-3,39
Brisbane,3280,6,10,5,13,33,42,-9,35
Western Sydn,3280,7,8,9,10,38,47,-9,33
Perth Glory,3280,8,10,2,15,37,50,-13,32
Wellington P,3280,9,5,6,16,31,55,-24,21
CC Mariners,3280,10,4,8,15,28,49,-21,20
Sydney FC,3281,1,20,5,3,66,24,42,65
N'castle Jet,3281,2,15,6,7,59,39,20,51
Melbourne C,3281,3,14,5,10,45,35,10,47
Melbourne V,3281,4,13,6,10,47,40,7,45
Adelaide Utd,3281,5,11,6,11,37,40,-3,39
Brisbane,3281,6,10,5,13,33,42,-9,35
Western Sydn,3281,7,8,9,10,38,47,-9,33
Perth Glory,3281,8,10,2,15,37,50,-13,32
Wellington P,3281,9,5,6,16,31,55,-24,21
CC Mariners,3281,10,4,8,15,28,49,-21,20
Sydney FC,3282,1,21,4,3,65,22,43,67
N'castle Jet,3282,2,15,6,7,58,38,20,51
Melbourne C,3282,3,14,5,10,44,34,10,47
Melbourne V,3282,4,13,5,11,45,39,6,44
Adelaide Utd,3282,5,11,6,11,37,40,-3,39
Brisbane,3282,6,10,5,13,33,42,-9,35
Western Sydn,3282,7,8,9,10,38,47,-9,33
Perth Glory,3282,8,10,2,15,37,50,-13,32
Wellington P,3282,9,5,6,16,31,55,-24,21
CC Mariners,3282,10,4,8,15,28,49,-21,20
Sydney FC,3283,1,21,4,3,67,23,44,67
N'castle Jet,3283,2,16,5,7,60,39,21,53
Melbourne C,3283,3,14,4,11,45,36,9,46
Melbourne V,3283,4,13,5,11,46,41,5,44
Adelaide Utd,3283,5,11,6,11,37,40,-3,39
Brisbane,3283,6,10,5,13,33,42,-9,35
Western Sydn,3283,7,8,9,10,38,47,-9,33
Perth Glory,3283,8,10,2,15,37,50,-13,32
Wellington P,3283,9,5,6,16,31,55,-24,21
CC Mariners,3283,10,4,8,15,28,49,-21,20
Sydney FC,3284,1,21,4,3,65,22,43,67
N'castle Jet,3284,2,16,5,7,61,38,23,53
Melbourne C,3284,3,14,4,11,44,37,7,46
Melbourne V,3284,4,13,5,11,45,39,6,44
Adelaide Utd,3284,5,11,6,11,37,40,-3,39
Brisbane,3284,6,10,5,13,33,42,-9,35
Western Sydn,3284,7,8,9,10,38,47,-9,33
Perth Glory,3284,8,10,2,15,37,50,-13,32
Wellington P,3284,9,5,6,16,31,55,-24,21
CC Mariners,3284,10,4,8,15,28,49,-21,20
Sydney FC,3285,1,21,4,3,69,22,47,67
N'castle Jet,3285,2,15,5,8,58,39,19,50
Melbourne C,3285,3,15,4,10,45,34,11,49
Melbourne V,3285,4,13,5,11,45,43,2,44
Adelaide Utd,3285,5,11,6,11,37,40,-3,39
Brisbane,3285,6,10,5,13,33,42,-9,35
Western Sydn,3285,7,8,9,10,38,47,-9,33
Perth Glory,3285,8,10,2,15,37,50,-13,32
Wellington P,3285,9,5,6,16,31,55,-24,21
CC Mariners,3285,10,4,8,15,28,49,-21,20
Sydney FC,3286,1,21,4,3,66,22,44,67
N'castle Jet,3286,2,15,6,7,59,39,20,51
Melbourne C,3286,3,14,5,10,45,35,10,47
Melbourne V,3286,4,13,5,11,45,40,5,44
Adelaide Utd,3286,5,11,6,11,37,40,-3,39
Brisbane,3286,6,10,5,13,33,42,-9,35
Western Sydn,3286,7,8,9,10,38,47,-9,33
Perth Glory,3286,8,10,2,15,37,50,-13,32
Wellington P,3286,9,5,6,16,31,55,-24,21
CC Mariners,3286,10,4,8,15,28,49,-21,20
Sydney FC,3287,1,21,4,3,65,22,43,67
N'castle Jet,3287,2,16,5,7,60,38,22,53
Melbourne C,3287,3,14,4,11,44,36,8,46
Melbourne V,3287,4,13,5,11,45,39,6,44
Adelaide Utd,3287,5,11,6,11,37,40,-3,39
Brisbane,3287,6,10,5,13,33,42,-9,35
Western Sydn,3287,7,8,9,10,38,47,-9,33
Perth Glory,3287,8,10,2,15,37,50,-13,32
Wellington P,3287,9,5,6,16,31,55,-24,21
CC Mariners,3287,10,4,8,15,28,49,-21,20
Sydney FC,3288,1,21,4,3,66,22,44,67
N'castle Jet,3288,2,15,5,8,57,38,19,50
Melbourne C,3288,3,15,4,10,44,33,11,49
Melbourne V,3288,4,13,5,11,45,40,5,44
Adelaide Utd,3288,5,11,6,11,37,40,-3,39
Brisbane,3288,6,10,5,13,33,42,-9,35
Western Sydn,3288,7,8,9,10,38,47,-9,33
Perth Glory,3288,8,10,2,15,37,50,-13,32
Wellington P,3288,9,5,6,16,31,55,-24,21
CC Mariners,3288,10,4,8,15,28,49,-21,20
Sydney FC,3289,1,21,4,3,67,23,44,67
N'castle Jet,3289,2,15,6,7,60,40,20,51
Melbourne C,3289,3,14,5,10,46,36,10,47
Melbourne V,3289,4,13,5,11,46,41,5,44
Adelaide Utd,3289,5,11,6,11,37,40,-3,39
Brisbane,3289,6,10,5,13,33,42,-9,35
Western Sydn,3289,7,8,9,10,38,47,-9,33
Perth Glory,3289,8,10,2,15,37,50,-13,32
Wellington P,3289,9,5,6,16,31,55,-24,21
CC Mariners,3289,10,4,8,15,28,49,-21,20
Sydney FC,3290,1,21,4,3,67,23,44,67
N'castle Jet,3290,2,16,5,7,59,37,22,53
Melbourne C,3290,3,14,4,11,43,35,8,46
Melbourne V,3290,4,13,5,11,46,41,5,44
Adelaide Utd,3290,5,11,6,11,37,40,-3,39
Brisbane,3290,6,10,5,13,33,42,-9,35
Western Sydn,3290,7,8,9,10,38,47,-9,33
Perth Glory,3290,8,10,2,15,37,50,-13,32
Wellington P,3290,9,5,6,16,31,55,-24,21
CC Mariners,3290,10,4,8,15,28,49,-21,20
Sydney FC,3291,1,20,5,3,66,24,42,65
N'castle Jet,3291,2,15,6,7,59,39,20,51
Melbourne C,3291,3,14,5,10,45,35,10,47
Melbourne V,3291,4,13,6,10,47,40,7,45
Adelaide Utd,3291,5,11,6,11,37,40,-3,39
Brisbane,3291,6,10,5,13,33,42,-9,35
Western Sydn,3291,7,8,9,10,38,47,-9,33
Perth Glory,3291,8,10,2,15,37,50,-13,32
Wellington P,3291,9,5,6,16,31,55,-24,21
CC Mariners,3291,10,4,8,15,28,49,-21,20
Sydney FC,3292,1,21,4,3,66,23,43,67
N'castle Jet,3292,2,15,6,7,58,38,20,51
Melbourne C,3292,3,14,5,10,44,34,10,47
Melbourne V,3292,4,13,5,11,46,40,6,44
Adelaide Utd,3292,5,11,6,11,37,40,-3,39
Brisbane,3292,6,10,5,13,33,42,-9,35
Western Sydn,3292,7,8,9,10,38,47,-9,33
Perth Glory,3292,8,10,2,15,37,50,-13,32
Wellington P,3292,9,5,6,16,31,55,-24,21
CC Mariners,3292,10,4,8,15,28,49,-21,20
Sydney FC,3293,1,21,4,3,66,23,43,67
N'castle Jet,3293,2,15,5,8,57,39,18,50
Melbourne C,3293,3,15,4,10,45,33,12,49
Melbourne V,3293,4,13,5,11,46,40,6,44
Adelaide Utd,3293,5,11,6,11,37,40,-3,39
Brisbane,3293,6,10,5,13,33,42,-9,35
Western Sydn,3293,7,8,9,10,38,47,-9,33
Perth Glory,3293,8,10,2,15,37,50,-13,32
Wellington P,3293,9,5,6,16,31,55,-24,21
CC Mariners,3293,10,4,8,15,28,49,-21,20
Sydney FC,3294,1,21,4,3,68,23,45,67
N'castle Jet,3294,2,15,6,7,59,39,20,51
Melbourne C,3294,3,14,5,10,45,35,10,47
Melbourne V,3294,4,13,5,11,46,42,4,44
Adelaide Utd,3294,5,11,6,11,37,40,-3,39
Brisbane,3294,6,10,5,13,33,42,-9,35
Western Sydn,3294,7,8,9,10,38,47,-9,33
Perth Glory,3294,8,10,2,15,37,50,-13,32
Wellington P,3294,9,5,6,16,31,55,-24,21
CC Mariners,3294,10,4,8,15,28,49,-21,20
Sydney FC,3295,1,21,4,3,68,24,44,67
N'castle Jet,3295,2,16,5,7,60,38,22,53
Melbourne C,3295,3,14,4,11,44,36,8,46
Melbourne V,3295,4,13,5,11,47,42,5,44
Adelaide Utd,3295,5,11,6,11,37,40,-3,39
Brisbane,3295,6,10,5,13,33,42,-9,35
Western Sydn,3295,7,8,9,10,38,47,-9,33
Perth Glory,3295,8,10,2,15,37,50,-13,32
Wellington P,3295,9,5,6,16,31,55,-24,21
CC Mariners,3295,10,4,8,15,28,49,-21,20
Sydney FC,3296,1,21,4,3,66,23,43,67
N'castle Jet,3296,2,16,5,7,59,37,22,53
Melbourne C,3296,3,14,4,11,43,35,8,46
Melbourne V,3296,4,13,5,11,46,40,6,44
Adelaide Utd,3296,5,11,6,11,37,40,-3,39
Brisbane,3296,6,10,5,13,33,42,-9,35
Western Sydn,3296,7,8,9,10,38,47,-9,33
Perth Glory,3296,8,10,2,15,37,50,-13,32
Wellington P,3296,9,5,6,16,31,55,-24,21
CC Mariners,3296,10,4,8,15,28,49,-21,20
Sydney FC,3297,1,20,4,4,65,25,40,64
N'castle Jet,3297,2,15,5,8,58,39,19,50
Melbourne C,3297,3,15,4,10,45,34,11,49
Melbourne V,3297,4,14,5,10,48,39,9,47
Adelaide Utd,3297,5,11,6,11,37,40,-3,39
Brisbane,3297,6,10,5,13,33,42,-9,35
Western Sydn,3297,7,8,9,10,38,47,-9,33
Perth Glory,3297,8,10,2,15,37,50,-13,32
Wellington P,3297,9,5,6,16,31,55,-24,21
CC Mariners,3297,10,4,8,15,28,49,-21,20
Sydney FC,3298,1,21,4,3,65,22,43,67
N'castle Jet,3298,2,16,5,7,60,38,22,53
Melbourne C,3298,3,14,4,11,44,36,8,46
Melbourne V,3298,4,13,5,11,45,39,6,44
Adelaide Utd,3298,5,11,6,11,37,40,-3,39
Brisbane,3298,6,10,5,13,33,42,-9,35
Western Sydn,3298,7,8,9,10,38,47,-9,33
Perth Glory,3298,8,10,2,15,37,50,-13,32
Wellington P,3298,9,5,6,16,31,55,-24,21
CC Mariners,3298,10,4,8,15,28,49,-21,20
Sydney FC,3299,1,21,4,3,66,22,44,67
N'castle Jet,3299,2,15,6,7,59,39,20,51
Melbourne C,3299,3,14,5,10,45,35,10,47
Melbourne V,3299,4,13,5,11,45,40,5,44
Adelaide Utd,3299,5,11,6,11,37,40,-3,39
Brisbane,3299,6,10,5,13,33,42,-9,35
Western Sydn,3299,7,8,9,10,38,47,-9,33
Perth Glory,3299,8,10,2,15,37,50,-13,32
Wellington P,3299,9,5,6,16,31,55,-24,21
CC Mariners,3299,10,4,8,15,28,49,-21,20
Sydney FC,3300,1,20,4,4,66,25,41,64
N'castle Jet,3300,2,16,5,7,63,37,26,53
Melbourne V,3300,3,14,5,10,48,40,8,47
Melbourne C,3300,4,14,4,11,43,39,4,46
Adelaide Utd,3300,5,11,6,11,37,40,-3,39
Brisbane,3300,6,10,5,13,33,42,-9,35
Western Sydn,3300,7,8,9,10,38,47,-9,33
Perth Glory,3300,8,10,2,15,37,50,-13,32
Wellington P,3300,9,5,6,16,31,55,-24,21
CC Mariners,3300,10,4,8,15,28,49,-21,20
Sydney FC,3301,1,21,4,3,66,23,43,67
N'castle Jet,3301,2,15,6,7,58,38,20,51
Melbourne C,3301,3,14,5,10,44,34,10,47
Melbourne V,3301,4,13,5,11,46,40,6,44
Adelaide Utd,3301,5,11,6,11,37,40,-3,39
Brisbane,3301,6,10,5,13,33,42,-9,35
Western Sydn,3301,7,8,9,10,38,47,-9,33
Perth Glory,3301,8,10,2,15,37,50,-13,32
Wellington P,3301,9,5,6,16,31,55,-24,21
CC Mariners,3301,10,4,8,15,28,49,-21,20
Sydney FC,3302,1,21,4,3,67,23,44,67
N'castle Jet,3302,2,16,5,7,60,39,21,53
Melbourne C,3302,3,14,4,11,45,36,9,46
Melbourne V,3302,4,13,5,11,46,41,5,44
Adelaide Utd,3302,5,11,6,11,37,40,-3,39
Brisbane,3302,6,10,5,13,33,42,-9,35
Western Sydn,3302,7,8,9,10,38,47,-9,33
Perth Glory,3302,8,10,2,15,37,50,-13,32
Wellington P,3302,9,5,6,16,31,55,-24,21
CC Mariners,3302,10,4,8,15,28,49,-21,20
Sydney FC,3303,1,20,4,4,64,23,41,64
N'castle Jet,3303,2,15,6,7,59,39,20,51
Melbourne C,3303,3,14,5,10,45,35,10,47
Melbourne V,3303,4,14,5,10,46,38,8,47
Adelaide Utd,3303,5,11,6,11,37,40,-3,39
Brisbane,3303,6,10,5,13,33,42,-9,35
Western Sydn,3303,7,8,9,10,38,47,-9,33
Perth Glory,3303,8,10,2,15,37,50,-13,32
Wellington P,3303,9,5,6,16,31,55,-24,21
CC Mariners,3303,10,4,8,15,28,49,-21,20
Sydney FC,3304,1,21,4,3,68,23,45,67
N'castle Jet,3304,2,15,5,8,58,39,19,50
Melbourne C,3304,3,15,4,10,45,34,11,49
Melbourne V,3304,4,13,5,11,46,42,4,44
Adelaide Utd,3304,5,11,6,11,37,40,-3,39
Brisbane,3304,6,10,5,13,33,42,-9,35
Western Sydn,3304,7,8,9,10,38,47,-9,33
Perth Glory,3304,8,10,2,15,37,50,-13,32
Wellington P,3304,9,5,6,16,31,55,-24,21
CC Mariners,3304,10,4,8,15,28,49,-21,20
Sydney FC,3305,1,21,4,3,66,22,44,67
N'castle Jet,3305,2,15,5,8,57,39,18,50
Melbourne C,3305,3,15,4,10,45,33,12,49
Melbourne V,3305,4,13,5,11,45,40,5,44
Adelaide Utd,3305,5,11,6,11,37,40,-3,39
Brisbane,3305,6,10,5,13,33,42,-9,35
Western Sydn,3305,7,8,9,10,38,47,-9,33
Perth Glory,3305,8,10,2,15,37,50,-13,32
Wellington P,3305,9,5,6,16,31,55,-24,21
CC Mariners,3305,10,4,8,15,28,49,-21,20
Sydney FC,3306,1,21,4,3,66,23,43,67
N'castle Jet,3306,2,16,5,7,60,38,22,53
Melbourne C,3306,3,14,4,11,44,36,8,46
Melbourne V,3306,4,13,5,11,46,40,6,44
Adelaide Utd,3306,5,11,6,11,37,40,-3,39
Brisbane,3306,6,10,5,13,33,42,-9,35
Western Sydn,3306,7,8,9,10,38,47,-9,33
Perth Glory,3306,8,10,2,15,37,50,-13,32
Wellington P,3306,9,5,6,16,31,55,-24,21
CC Mariners,3306,10,4,8,15,28,49,-21,20
Sydney FC,3307,1,20,5,3,65,23,42,65
N'castle Jet,3307,2,15,5,8,57,38,19,50
Melbourne C,3307,3,15,4,10,44,33,11,49
Melbourne V,3307,4,13,6,10,46,39,7,45
Adelaide Utd,3307,5,11,6,11,37,40,-3,39
Brisbane,3307,6,10,5,13,33,42,-9,35
Western Sydn,3307,7,8,9,10,38,47,-9,33
Perth Glory,3307,8,10,2,15,37,50,-13,32
Wellington P,3307,9,5,6,16,31,55,-24,21
CC Mariners,3307,10,4,8,15,28,49,-21,20
Sydney FC,3308,1,21,4,3,68,22,46,67
N'castle Jet,3308,2,15,5,8,58,40,18,50
Melbourne C,3308,3,15,4,10,46,34,12,49
Melbourne V,3308,4,13,5,11,45,42,3,44
Adelaide Utd,3308,5,11,6,11,37,40,-3,39
Brisbane,3308,6,10,5,13,33,42,-9,35
Western Sydn,3308,7,8,9,10,38,47,-9,33
Perth Glory,3308,8,10,2,15,37,50,-13,32
Wellington P,3308,9,5,6,16,31,55,-24,21
CC Mariners,3308,10,4,8,15,28,49,-21,20
Sydney FC,3309,1,21,4,3,65,22,43,67
N'castle Jet,3309,2,16,5,7,61,40,21,53
Melbourne C,3309,3,14,4,11,46,37,9,46
Melbourne V,3309,4,13,5,11,45,39,6,44
Adelaide Utd,3309,5,11,6,11,37,40,-3,39
Brisbane,3309,6,10,5,13,33,42,-9,35
Western Sydn,3309,7,8,9,10,38,47,-9,33
Perth Glory,3309,8,10,2,15,37,50,-13,32
Wellington P,3309,9,5,6,16,31,55,-24,21
CC Mariners,3309,10,4,8,15,28,49,-21,20
Sydney FC,3310,1,20,4,4,65,25,40,64
N'castle Jet,3310,2,15,5,8,58,39,19,50
Melbourne C,3310,3,15,4,10,45,34,11,49
Melbourne V,3310,4,14,5,10,48,39,9,47
Adelaide Utd,3310,5,11,6,11,37,40,-3,39
Brisbane,3310,6,10,5,13,33,42,-9,35
Western Sydn,3310,7,8,9,10,38,47,-9,33
Perth Glory,3310,8,10,2,15,37,50,-13,32
Wellington P,3310,9,5,6,16,31,55,-24,21
CC Mariners,3310,10,4,8,15,28,49,-21,20
Sydney FC,3311,1,21,4,3,65,22,43,67
N'castle Jet,3311,2,16,5,7,61,38,23,53
Melbourne C,3311,3,14,4,11,44,37,7,46
Melbourne V,3311,4,13,5,11,45,39,6,44
Adelaide Utd,3311,5,11,6,11,37,40,-3,39
Brisbane,3311,6,10,5,13,33,42,-9,35
Western Sydn,3311,7,8,9,10,38,47,-9,33
Perth Glory,3311,8,10,2,15,37,50,-13,32
Wellington P,3311,9,5,6,16,31,55,-24,21
CC Mariners,3311,10,4,8,15,28,49,-21,20
Sydney FC,3312,1,20,4,4,65,24,41,64
N'castle Jet,3312,2,16,5,7,58,37,21,53
Melbourne V,3312,3,14,5,10,47,39,8,47
Melbourne C,3312,4,14,4,11,43,34,9,46
Adelaide Utd,3312,5,11,6,11,37,40,-3,39
Brisbane,3312,6,10,5,13,33,42,-9,35
Western Sydn,3312,7,8,9,10,38,47,-9,33
Perth Glory,3312,8,10,2,15,37,50,-13,32
Wellington P,3312,9,5,6,16,31,55,-24,21
CC Mariners,3312,10,4,8,15,28,49,-21,20
Sydney FC,3313,1,21,4,3,67,22,45,67
N'castle Jet,3313,2,16,5,7,58,37,21,53
Melbourne C,3313,3,14,4,11,43,34,9,46
Melbourne V,3313,4,13,5,11,45,41,4,44
Adelaide Utd,3313,5,11,6,11,37,40,-3,39
Brisbane,3313,6,10,5,13,33,42,-9,35
Western Sydn,3313,7,8,9,10,38,47,-9,33
Perth Glory,3313,8,10,2,15,37,50,-13,32
Wellington P,3313,9,5,6,16,31,55,-24,21
CC Mariners,3313,10,4,8,15,28,49,-21,20
Sydney FC,3314,1,20,5,3,65,23,42,65
N'castle Jet,3314,2,16,5,7,59,37,22,53
Melbourne C,3314,3,14,4,11,43,35,8,46
Melbourne V,3314,4,13,6,10,46,39,7,45
Adelaide Utd,3314,5,11,6,11,37,40,-3,39
Brisbane,3314,6,10,5,13,33,42,-9,35
Western Sydn,3314,7,8,9,10,38,47,-9,33
Perth Glory,3314,8,10,2,15,37,50,-13,32
Wellington P,3314,9,5,6,16,31,55,-24,21
CC Mariners,3314,10,4,8,15,28,49,-21,20
Sydney FC,3315,1,21,4,3,67,23,44,67
N'castle Jet,3315,2,16,5,7,60,38,22,53
Melbourne C,3315,3,14,4,11,44,36,8,46
Melbourne V,3315,4,13,5,11,46,41,5,44
Adelaide Utd,3315,5,11,6,11,37,40,-3,39
Brisbane,3315,6,10,5,13,33,42,-9,35
Western Sydn,3315,7,8,9,10,38,47,-9,33
Perth Glory,3315,8,10,2,15,37,50,-13,32
Wellington P,3315,9,5,6,16,31,55,-24,21
CC Mariners,3315,10,4,8,15,28,49,-21,20
Sydney FC,3316,1,21,4,3,67,22,45,67
N'castle Jet,3316,2,15,6,7,57,37,20,51
Melbourne C,3316,3,14,5,10,43,33,10,47
Melbourne V,3316,4,13,5,11,45,41,4,44
Adelaide Utd,3316,5,11,6,11,37,40,-3,39
Brisbane,3316,6,10,5,13,33,42,-9,35
Western Sydn,3316,7,8,9,10,38,47,-9,33
Perth Glory,3316,8,10,2,15,37,50,-13,32
Wellington P,3316,9,5,6,16,31,55,-24,21
CC Mariners,3316,10,4,8,15,28,49,-21,20
Sydney FC,3317,1,20,5,3,66,24,42,65
N'castle Jet,3317,2,16,5,7,58,37,21,53
Melbourne C,3317,3,14,4,11,43,34,9,46
Melbourne V,3317,4,13,6,10,47,40,7,45
Adelaide Utd,3317,5,11,6,11,37,40,-3,39
Brisbane,3317,6,10,5,13,33,42,-9,35
Western Sydn,3317,7,8,9,10,38,47,-9,33
Perth Glory,3317,8,10,2,15,37,50,-13,32
Wellington P,3317,9,5,6,16,31,55,-24,21
CC Mariners,3317,10,4,8,15,28,49,-21,20
Sydney FC,3318,1,21,4,3,65,22,43,67
N'castle Jet,3318,2,16,5,7,59,38,21,53
Melbourne C,3318,3,14,4,11,44,35,9,46
Melbourne V,3318,4,13,5,11,45,39,6,44
Adelaide Utd,3318,5,11,6,11,37,40,-3,39
Brisbane,3318,6,10,5,13,33,42,-9,35
Western Sydn,3318,7,8,9,10,38,47,-9,33
Perth Glory,3318,8,10,2,15,37,50,-13,32
Wellington P,3318,9,5,6,16,31,55,-24,21
CC Mariners,3318,10,4,8,15,28,49,-21,20
Sydney FC,3319,1,21,4,3,66,23,43,67
N'castle Jet,3319,2,16,5,7,60,37,23,53
Melbourne C,3319,3,14,4,11,43,36,7,46
Melbourne V,3319,4,13,5,11,46,40,6,44
Adelaide Utd,3319,5,11,6,11,37,40,-3,39
Brisbane,3319,6,10,5,13,33,42,-9,35
Western Sydn,3319,7,8,9,10,38,47,-9,33
Perth Glory,3319,8,10,2,15,37,50,-13,32
Wellington P,3319,9,5,6,16,31,55,-24,21
CC Mariners,3319,10,4,8,15,28,49,-21,20
Sydney FC,3320,1,21,4,3,67,22,45,67
N'castle Jet,3320,2,16,5,7,60,39,21,53
Melbourne C,3320,3,14,4,11,45,36,9,46
Melbourne V,3320,4,13,5,11,45,41,4,44
Adelaide Utd,3320,5,11,6,11,37,40,-3,39
Brisbane,3320,6,10,5,13,33,42,-9,35
Western Sydn,3320,7,8,9,10,38,47,-9,33
Perth Glory,3320,8,10,2,15,37,50,-13,32
Wellington P,3320,9,5,6,16,31,55,-24,21
CC Mariners,3320,10,4,8,15,28,49,-21,20
Sydney FC,3321,1,21,4,3,67,23,44,67
N'castle Jet,3321,2,16,5,7,61,38,23,53
Melbourne C,3321,3,14,4,11,44,37,7,46
Melbourne V,3321,4,13,5,11,46,41,5,44
Adelaide Utd,3321,5,11,6,11,37,40,-3,39
Brisbane,3321,6,10,5,13,33,42,-9,35
Western Sydn,3321,7,8,9,10,38,47,-9,33
Perth Glory,3321,8,10,2,15,37,50,-13,32
Wellington P,3321,9,5,6,16,31,55,-24,21
CC Mariners,3321,10,4,8,15,28,49,-21,20
Sydney FC,3322,1,20,5,3,65,23,42,65
N'castle Jet,3322,2,16,5,7,60,38,22,53
Melbourne C,3322,3,14,4,11,44,36,8,46
Melbourne V,3322,4,13,6,10,46,39,7,45
Adelaide Utd,3322,5,11,6,11,37,40,-3,39
Brisbane,3322,6,10,5,13,33,42,-9,35
Western Sydn,3322,7,8,9,10,38,47,-9,33
Perth Glory,3322,8,10,2,15,37,50,-13,32
Wellington P,3322,9,5,6,16,31,55,-24,21
CC Mariners,3322,10,4,8,15,28,49,-21,20
Sydney FC,3323,1,21,4,3,67,23,44,67
N'castle Jet,3323,2,16,5,7,61,38,23,53
Melbourne C,3323,3,14,4,11,44,37,7,46
Melbourne V,3323,4,13,5,11,46,41,5,44
Adelaide Utd,3323,5,11,6,11,37,40,-3,39
Brisbane,3323,6,10,5,13,33,42,-9,35
Western Sydn,3323,7,8,9,10,38,47,-9,33
Perth Glory,3323,8,10,2,15,37,50,-13,32
Wellington P,3323,9,5,6,16,31,55,-24,21
CC Mariners,3323,10,4,8,15,28,49,-21,20
Sydney FC,3324,1,20,5,3,65,23,42,65
N'castle Jet,3324,2,16,5,7,59,37,22,53
Melbourne C,3324,3,14,4,11,43,35,8,46
Melbourne V,3324,4,13,6,10,46,39,7,45
Adelaide Utd,3324,5,11,6,11,37,40,-3,39
Brisbane,3324,6,10,5,13,33,42,-9,35
Western Sydn,3324,7,8,9,10,38,47,-9,33
Perth Glory,3324,8,10,2,15,37,50,-13,32
Wellington P,3324,9,5,6,16,31,55,-24,21
CC Mariners,3324,10,4,8,15,28,49,-21,20
Sydney FC,3325,1,21,4,3,69,23,46,67
N'castle Jet,3325,2,16,5,7,58,37,21,53
Melbourne C,3325,3,14,4,11,43,34,9,46
Melbourne V,3325,4,13,5,11,46,43,3,44
Adelaide Utd,3325,5,11,6,11,37,40,-3,39
Brisbane,3325,6,10,5,13,33,42,-9,35
Western Sydn,3325,7,8,9,10,38,47,-9,33
Perth Glory,3325,8,10,2,15,37,50,-13,32
Wellington P,3325,9,5,6,16,31,55,-24,21
CC Mariners,3325,10,4,8,15,28,49,-21,20
Sydney FC,3326,1,21,4,3,67,24,43,67
N'castle Jet,3326,2,15,6,7,60,40,20,51
Melbourne C,3326,3,14,5,10,46,36,10,47
Melbourne V,3326,4,13,5,11,47,41,6,44
Adelaide Utd,3326,5,11,6,11,37,40,-3,39
Brisbane,3326,6,10,5,13,33,42,-9,35
Western Sydn,3326,7,8,9,10,38,47,-9,33
Perth Glory,3326,8,10,2,15,37,50,-13,32
Wellington P,3326,9,5,6,16,31,55,-24,21
CC Mariners,3326,10,4,8,15,28,49,-21,20
Sydney FC,3327,1,21,4,3,66,22,44,67
N'castle Jet,3327,2,16,5,7,59,38,21,53
Melbourne C,3327,3,14,4,11,44,35,9,46
Melbourne V,3327,4,13,5,11,45,40,5,44
Adelaide Utd,3327,5,11,6,11,37,40,-3,39
Brisbane,3327,6,10,5,13,33,42,-9,35
Western Sydn,3327,7,8,9,10,38,47,-9,33
Perth Glory,3327,8,10,2,15,37,50,-13,32
Wellington P,3327,9,5,6,16,31,55,-24,21
CC Mariners,3327,10,4,8,15,28,49,-21,20
Sydney FC,3328,1,20,5,3,67,25,42,65
N'castle Jet,3328,2,15,5,8,58,43,15,50
Melbourne C,3328,3,15,4,10,49,34,15,49
Melbourne V,3328,4,13,6,10,48,41,7,45
Adelaide Utd,3328,5,11,6,11,37,40,-3,39
Brisbane,3328,6,10,5,13,33,42,-9,35
Western Sydn,3328,7,8,9,10,38,47,-9,33
Perth Glory,3328,8,10,2,15,37,50,-13,32
Wellington P,3328,9,5,6,16,31,55,-24,21
CC Mariners,3328,10,4,8,15,28,49,-21,20
Sydney FC,3329,1,20,5,3,65,23,42,65
N'castle Jet,3329,2,16,5,7,60,37,23,53
Melbourne C,3329,3,14,4,11,43,36,7,46
Melbourne V,3329,4,13,6,10,46,39,7,45
Adelaide Utd,3329,5,11,6,11,37,40,-3,39
Brisbane,3329,6,10,5,13,33,42,-9,35
Western Sydn,3329,7,8,9,10,38,47,-9,33
Perth Glory,3329,8,10,2,15,37,50,-13,32
Wellington P,3329,9,5,6,16,31,55,-24,21
CC Mariners,3329,10,4,8,15,28,49,-21,20
Sydney FC,3330,1,21,4,3,67,24,43,67
N'castle Jet,3330,2,15,6,7,57,37,20,51
Melbourne C,3330,3,14,5,10,43,33,10,47
Melbourne V,3330,4,13,5,11,47,41,6,44
Adelaide Utd,3330,5,11,6,11,37,40,-3,39
Brisbane,3330,6,10,5,13,33,42,-9,35
Western Sydn,3330,7,8,9,10,38,47,-9,33
Perth Glory,3330,8,10,2,15,37,50,-13,32
Wellington P,3330,9,5,6,16,31,55,-24,21
CC Mariners,3330,10,4,8,15,28,49,-21,20
Sydney FC,3331,1,20,5,3,66,24,42,65
N'castle Jet,3331,2,15,6,7,57,37,20,51
Melbourne C,3331,3,14,5,10,43,33,10,47
Melbourne V,3331,4,13,6,10,47,40,7,45
Adelaide Utd,3331,5,11,6,11,37,40,-3,39
Brisbane,3331,6,10,5,13,33,42,-9,35
Western Sydn,3331,7,8,9,10,38,47,-9,33
Perth Glory,3331,8,10,2,15,37,50,-13,32
Wellington P,3331,9,5,6,16,31,55,-24,21
CC Mariners,3331,10,4,8,15,28,49,-21,20
Sydney FC,3332,1,21,4,3,65,22,43,67
N'castle Jet,3332,2,16,5,7,61,38,23,53
Melbourne C,3332,3,14,4,11,44,37,7,46
Melbourne V,3332,4,13,5,11,45,39,6,44
Adelaide Utd,3332,5,11,6,11,37,40,-3,39
Brisbane,3332,6,10,5,13,33,42,-9,35
Western Sydn,3332,7,8,9,10,38,47,-9,33
Perth Glory,3332,8,10,2,15,37,50,-13,32
Wellington P,3332,9,5,6,16,31,55,-24,21
CC Mariners,3332,10,4,8,15,28,49,-21,20
Sydney FC,3333,1,21,4,3,65,22,43,67
N'castle Jet,3333,2,15,5,8,57,38,19,50
Melbourne C,3333,3,15,4,10,44,33,11,49
Melbourne V,3333,4,13,5,11,45,39,6,44
Adelaide Utd,3333,5,11,6,11,37,40,-3,39
Brisbane,3333,6,10,5,13,33,42,-9,35
Western Sydn,3333,7,8,9,10,38,47,-9,33
Perth Glory,3333,8,10,2,15,37,50,-13,32
Wellington P,3333,9,5,6,16,31,55,-24,21
CC Mariners,3333,10,4,8,15,28,49,-21,20
Sydney FC,3334,1,21,4,3,65,22,43,67
N'castle Jet,3334,2,16,5,7,58,37,21,53
Melbourne C,3334,3,14,4,11,43,34,9,46
Melbourne V,3334,4,13,5,11,45,39,6,44
Adelaide Utd,3334,5,11,6,11,37,40,-3,39
Brisbane,3334,6,10,5,13,33,42,-9,35
Western Sydn,3334,7,8,9,10,38,47,-9,33
Perth Glory,3334,8,10,2,15,37,50,-13,32
Wellington P,3334,9,5,6,16,31,55,-24,21
CC Mariners,3334,10,4,8,15,28,49,-21,20
Sydney FC,3335,1,20,4,4,64,23,41,64
N'castle Jet,3335,2,16,5,7,58,37,21,53
Melbourne V,3335,3,14,5,10,46,38,8,47
Melbourne C,3335,4,14,4,11,43,34,9,46
Adelaide Utd,3335,5,11,6,11,37,40,-3,39
Brisbane,3335,6,10,5,13,33,42,-9,35
Western Sydn,3335,7,8,9,10,38,47,-9,33
Perth Glory,3335,8,10,2,15,37,50,-13,32
Wellington P,3335,9,5,6,16,31,55,-24,21
CC Mariners,3335,10,4,8,15,28,49,-21,20
Sydney FC,3336,1,21,4,3,67,23,44,67
N'castle Jet,3336,2,16,5,7,59,38,21,53
Melbourne C,3336,3,14,4,11,44,35,9,46
Melbourne V,3336,4,13,5,11,46,41,5,44
Adelaide Utd,3336,5,11,6,11,37,40,-3,39
Brisbane,3336,6,10,5,13,33,42,-9,35
Western Sydn,3336,7,8,9,10,38,47,-9,33
Perth Glory,3336,8,10,2,15,37,50,-13,32
Wellington P,3336,9,5,6,16,31,55,-24,21
CC Mariners,3336,10,4,8,15,28,49,-21,20
Sydney FC,3337,1,21,4,3,65,22,43,67
N'castle Jet,3337,2,16,5,7,58,37,21,53
Melbourne C,3337,3,14,4,11,43,34,9,46
Melbourne V,3337,4,13,5,11,45,39,6,44
Adelaide Utd,3337,5,11,6,11,37,40,-3,39
Brisbane,3337,6,10,5,13,33,42,-9,35
Western Sydn,3337,7,8,9,10,38,47,-9,33
Perth Glory,3337,8,10,2,15,37,50,-13,32
Wellington P,3337,9,5,6,16,31,55,-24,21
CC Mariners,3337,10,4,8,15,28,49,-21,20
Sydney FC,3338,1,21,4,3,65,22,43,67
N'castle Jet,3338,2,16,5,7,59,37,22,53
Melbourne C,3338,3,14,4,11,43,35,8,46
Melbourne V,3338,4,13,5,11,45,39,6,44
Adelaide Utd,3338,5,11,6,11,37,40,-3,39
Brisbane,3338,6,10,5,13,33,42,-9,35
Western Sydn,3338,7,8,9,10,38,47,-9,33
Perth Glory,3338,8,10,2,15,37,50,-13,32
Wellington P,3338,9,5,6,16,31,55,-24,21
CC Mariners,3338,10,4,8,15,28,49,-21,20
Sydney FC,3339,1,21,4,3,66,23,43,67
N'castle Jet,3339,2,16,5,7,59,38,21,53
Melbourne C,3339,3,14,4,11,44,35,9,46
Melbourne V,3339,4,13,5,11,46,40,6,44
Adelaide Utd,3339,5,11,6,11,37,40,-3,39
Brisbane,3339,6,10,5,13,33,42,-9,35
Western Sydn,3339,7,8,9,10,38,47,-9,33
Perth Glory,3339,8,10,2,15,37,50,-13,32
Wellington P,3339,9,5,6,16,31,55,-24,21
CC Mariners,3339,10,4,8,15,28,49,-21,20
Sydney FC,3340,1,21,4,3,66,22,44,67
N'castle Jet,3340,2,15,5,8,58,39,19,50
Melbourne C,3340,3,15,4,10,45,34,11,49
Melbourne V,3340,4,13,5,11,45,40,5,44
Adelaide Utd,3340,5,11,6,11,37,40,-3,39
Brisbane,3340,6,10,5,13,33,42,-9,35
Western Sydn,3340,7,8,9,10,38,47,-9,33
Perth Glory,3340,8,10,2,15,37,50,-13,32
Wellington P,3340,9,5,6,16,31,55,-24,21
CC Mariners,3340,10,4,8,15,28,49,-21,20
Sydney FC,3341,1,20,4,4,65,24,41,64
N'castle Jet,3341,2,16,5,7,59,38,21,53
Melbourne V,3341,3,14,5,10,47,39,8,47
Melbourne C,3341,4,14,4,11,44,35,9,46
Adelaide Utd,3341,5,11,6,11,37,40,-3,39
Brisbane,3341,6,10,5,13,33,42,-9,35
Western Sydn,3341,7,8,9,10,38,47,-9,33
Perth Glory,3341,8,10,2,15,37,50,-13,32
Wellington P,3341,9,5,6,16,31,55,-24,21
CC Mariners,3341,10,4,8,15,28,49,-21,20
Sydney FC,3342,1,21,4,3,65,22,43,67
N'castle Jet,3342,2,15,5,8,58,39,19,50
Melbourne C,3342,3,15,4,10,45,34,11,49
Melbourne V,3342,4,13,5,11,45,39,6,44
Adelaide Utd,3342,5,11,6,11,37,40,-3,39
Brisbane,3342,6,10,5,13,33,42,-9,35
Western Sydn,3342,7,8,9,10,38,47,-9,33
Perth Glory,3342,8,10,2,15,37,50,-13,32
Wellington P,3342,9,5,6,16,31,55,-24,21
CC Mariners,3342,10,4,8,15,28,49,-21,20
Sydney FC,3343,1,21,4,3,66,22,44,67
N'castle Jet,3343,2,16,5,7,60,37,23,53
Melbourne C,3343,3,14,4,11,43,36,7,46
Melbourne V,3343,4,13,5,11,45,40,5,44
Adelaide Utd,3343,5,11,6,11,37,40,-3,39
Brisbane,3343,6,10,5,13,33,42,-9,35
Western Sydn,3343,7,8,9,10,38,47,-9,33
Perth Glory,3343,8,10,2,15,37,50,-13,32
Wellington P,3343,9,5,6,16,31,55,-24,21
CC Mariners,3343,10,4,8,15,28,49,-21,20
Sydney FC,3344,1,21,4,3,66,23,43,67
N'castle Jet,3344,2,16,5,7,61,37,24,53
Melbourne C,3344,3,14,4,11,43,37,6,46
Melbourne V,3344,4,13,5,11,46,40,6,44
Adelaide Utd,3344,5,11,6,11,37,40,-3,39
Brisbane,3344,6,10,5,13,33,42,-9,35
Western Sydn,3344,7,8,9,10,38,47,-9,33
Perth Glory,3344,8,10,2,15,37,50,-13,32
Wellington P,3344,9,5,6,16,31,55,-24,21
CC Mariners,3344,10,4,8,15,28,49,-21,20
Sydney FC,3345,1,21,4,3,68,23,45,67
N'castle Jet,3345,2,16,5,7,60,37,23,53
Melbourne C,3345,3,14,4,11,43,36,7,46
Melbourne V,3345,4,13,5,11,46,42,4,44
Adelaide Utd,3345,5,11,6,11,37,40,-3,39
Brisbane,3345,6,10,5,13,33,42,-9,35
Western Sydn,3345,7,8,9,10,38,47,-9,33
Perth Glory,3345,8,10,2,15,37,50,-13,32
Wellington P,3345,9,5,6,16,31,55,-24,21
CC Mariners,3345,10,4,8,15,28,49,-21,20
Sydney FC,3346,1,20,5,3,65,23,42,65
N'castle Jet,3346,2,15,6,7,59,39,20,51
Melbourne C,3346,3,14,5,10,45,35,10,47
Melbourne V,3346,4,13,6,10,46,39,7,45
Adelaide Utd,3346,5,11,6,11,37,40,-3,39
Brisbane,3346,6,10,5,13,33,42,-9,35
Western Sydn,3346,7,8,9,10,38,47,-9,33
Perth Glory,3346,8,10,2,15,37,50,-13,32
Wellington P,3346,9,5,6,16,31,55,-24,21
CC Mariners,3346,10,4,8,15,28,49,-21,20
Sydney FC,3347,1,20,5,3,67,25,42,65
N'castle Jet,3347,2,16,5,7,60,39,21,53
Melbourne C,3347,3,14,4,11,45,36,9,46
Melbourne V,3347,4,13,6,10,48,41,7,45
Adelaide Utd,3347,5,11,6,11,37,40,-3,39
Brisbane,3347,6,10,5,13,33,42,-9,35
Western Sydn,3347,7,8,9,10,38,47,-9,33
Perth Glory,3347,8,10,2,15,37,50,-13,32
Wellington P,3347,9,5,6,16,31,55,-24,21
CC Mariners,3347,10,4,8,15,28,49,-21,20
Sydney FC,3348,1,21,4,3,65,22,43,67
N'castle Jet,3348,2,16,5,7,60,37,23,53
Melbourne C,3348,3,14,4,11,43,36,7,46
Melbourne V,3348,4,13,5,11,45,39,6,44
Adelaide Utd,3348,5,11,6,11,37,40,-3,39
Brisbane,3348,6,10,5,13,33,42,-9,35
Western Sydn,3348,7,8,9,10,38,47,-9,33
Perth Glory,3348,8,10,2,15,37,50,-13,32
Wellington P,3348,9,5,6,16,31,55,-24,21
CC Mariners,3348,10,4,8,15,28,49,-21,20
Sydney FC,3349,1,21,4,3,65,22,43,67
N'castle Jet,3349,2,15,6,7,59,39,20,51
Melbourne C,3349,3,14,5,10,45,35,10,47
Melbourne V,3349,4,13,5,11,45,39,6,44
Adelaide Utd,3349,5,11,6,11,37,40,-3,39
Brisbane,3349,6,10,5,13,33,42,-9,35
Western Sydn,3349,7,8,9,10,38,47,-9,33
Perth Glory,3349,8,10,2,15,37,50,-13,32
Wellington P,3349,9,5,6,16,31,55,-24,21
CC Mariners,3349,10,4,8,15,28,49,-21,20
Sydney FC,3350,1,21,4,3,65,22,43,67
N'castle Jet,3350,2,15,6,7,59,39,20,51
Melbourne C,3350,3,14,5,10,45,35,10,47
Melbourne V,3350,4,13,5,11,45,39,6,44
Adelaide Utd,3350,5,11,6,11,37,40,-3,39
Brisbane,3350,6,10,5,13,33,42,-9,35
Western Sydn,3350,7,8,9,10,38,47,-9,33
Perth Glory,3350,8,10,2,15,37,50,-13,32
Wellington P,3350,9,5,6,16,31,55,-24,21
CC Mariners,3350,10,4,8,15,28,49,-21,20
Sydney FC,3351,1,20,5,3,65,23,42,65
N'castle Jet,3351,2,15,5,8,60,42,18,50
Melbourne C,3351,3,15,4,10,48,36,12,49
Melbourne V,3351,4,13,6,10,46,39,7,45
Adelaide Utd,3351,5,11,6,11,37,40,-3,39
Brisbane,3351,6,10,5,13,33,42,-9,35
Western Sydn,3351,7,8,9,10,38,47,-9,33
Perth Glory,3351,8,10,2,15,37,50,-13,32
Wellington P,3351,9,5,6,16,31,55,-24,21
CC Mariners,3351,10,4,8,15,28,49,-21,20
Sydney FC,3352,1,21,4,3,69,23,46,67
N'castle Jet,3352,2,16,5,7,58,37,21,53
Melbourne C,3352,3,14,4,11,43,34,9,46
Melbourne V,3352,4,13,5,11,46,43,3,44
Adelaide Utd,3352,5,11,6,11,37,40,-3,39
Brisbane,3352,6,10,5,13,33,42,-9,35
Western Sydn,3352,7,8,9,10,38,47,-9,33
Perth Glory,3352,8,10,2,15,37,50,-13,32
Wellington P,3352,9,5,6,16,31,55,-24,21
CC Mariners,3352,10,4,8,15,28,49,-21,20
Sydney FC,3353,1,20,4,4,65,24,41,64
N'castle Jet,3353,2,15,6,7,59,39,20,51
Melbourne C,3353,3,14,5,10,45,35,10,47
Melbourne V,3353,4,14,5,10,47,39,8,47
Adelaide Utd,3353,5,11,6,11,37,40,-3,39
Brisbane,3353,6,10,5,13,33,42,-9,35
Western Sydn,3353,7,8,9,10,38,47,-9,33
Perth Glory,3353,8,10,2,15,37,50,-13,32
Wellington P,3353,9,5,6,16,31,55,-24,21
CC Mariners,3353,10,4,8,15,28,49,-21,20
Sydney FC,3354,1,20,4,4,65,26,39,64
N'castle Jet,3354,2,15,6,7,59,39,20,51
Melbourne V,3354,3,14,5,10,49,39,10,47
Melbourne C,3354,4,14,5,10,45,35,10,47
Adelaide Utd,3354,5,11,6,11,37,40,-3,39
Brisbane,3354,6,10,5,13,33,42,-9,35
Western Sydn,3354,7,8,9,10,38,47,-9,33
Perth Glory,3354,8,10,2,15,37,50,-13,32
Wellington P,3354,9,5,6,16,31,55,-24,21
CC Mariners,3354,10,4,8,15,28,49,-21,20
Sydney FC,3355,1,20,4,4,64,24,40,64
N'castle Jet,3355,2,15,6,7,58,38,20,51
Melbourne C,3355,3,14,5,10,44,34,10,47
Melbourne V,3355,4,14,5,10,47,38,9,47
Adelaide Utd,3355,5,11,6,11,37,40,-3,39
Brisbane,3355,6,10,5,13,33,42,-9,35
Western Sydn,3355,7,8,9,10,38,47,-9,33
Perth Glory,3355,8,10,2,15,37,50,-13,32
Wellington P,3355,9,5,6,16,31,55,-24,21
CC Mariners,3355,10,4,8,15,28,49,-21,20
Sydney FC,3356,1,21,4,3,68,22,46,67
N'castle Jet,3356,2,16,5,7,61,37,24,53
Melbourne C,3356,3,14,4,11,43,37,6,46
Melbourne V,3356,4,13,5,11,45,42,3,44
Adelaide Utd,3356,5,11,6,11,37,40,-3,39
Brisbane,3356,6,10,5,13,33,42,-9,35
Western Sydn,3356,7,8,9,10,38,47,-9,33
Perth Glory,3356,8,10,2,15,37,50,-13,32
Wellington P,3356,9,5,6,16,31,55,-24,21
CC Mariners,3356,10,4,8,15,28,49,-21,20
Sydney FC,3357,1,21,4,3,65,22,43,67
N'castle Jet,3357,2,16,5,7,59,38,21,53
Melbourne C,3357,3,14,4,11,44,35,9,46
Melbourne V,3357,4,13,5,11,45,39,6,44
Adelaide Utd,3357,5,11,6,11,37,40,-3,39
Brisbane,3357,6,10,5,13,33,42,-9,35
Western Sydn,3357,7,8,9,10,38,47,-9,33
Perth Glory,3357,8,10,2,15,37,50,-13,32
Wellington P,3357,9,5,6,16,31,55,-24,21
CC Mariners,3357,10,4,8,15,28,49,-21,20
Sydney FC,3358,1,20,4,4,64,24,40,64
N'castle Jet,3358,2,16,5,7,61,39,22,53
Melbourne V,3358,3,14,5,10,47,38,9,47
Melbourne C,3358,4,14,4,11,45,37,8,46
Adelaide Utd,3358,5,11,6,11,37,40,-3,39
Brisbane,3358,6,10,5,13,33,42,-9,35
Western Sydn,3358,7,8,9,10,38,47,-9,33
Perth Glory,3358,8,10,2,15,37,50,-13,32
Wellington P,3358,9,5,6,16,31,55,-24,21
CC Mariners,3358,10,4,8,15,28,49,-21,20
Sydney FC,3359,1,20,5,3,66,24,42,65
N'castle Jet,3359,2,15,5,8,57,39,18,50
Melbourne C,3359,3,15,4,10,45,33,12,49
Melbourne V,3359,4,13,6,10,47,40,7,45
Adelaide Utd,3359,5,11,6,11,37,40,-3,39
Brisbane,3359,6,10,5,13,33,42,-9,35
Western Sydn,3359,7,8,9,10,38,47,-9,33
Perth Glory,3359,8,10,2,15,37,50,-13,32
Wellington P,3359,9,5,6,16,31,55,-24,21
CC Mariners,3359,10,4,8,15,28,49,-21,20
Sydney FC,3360,1,20,4,4,64,24,40,64
N'castle Jet,3360,2,16,5,7,59,37,22,53
Melbourne V,3360,3,14,5,10,47,38,9,47
Melbourne C,3360,4,14,4,11,43,35,8,46
Adelaide Utd,3360,5,11,6,11,37,40,-3,39
Brisbane,3360,6,10,5,13,33,42,-9,35
Western Sydn,3360,7,8,9,10,38,47,-9,33
Perth Glory,3360,8,10,2,15,37,50,-13,32
Wellington P,3360,9,5,6,16,31,55,-24,21
CC Mariners,3360,10,4,8,15,28,49,-21,20
Sydney FC,3361,1,21,4,3,68,22,46,67
N'castle Jet,3361,2,16,5,7,58,37,21,53
Melbourne C,3361,3,14,4,11,43,34,9,46
Melbourne V,3361,4,13,5,11,45,42,3,44
Adelaide Utd,3361,5,11,6,11,37,40,-3,39
Brisbane,3361,6,10,5,13,33,42,-9,35
Western Sydn,3361,7,8,9,10,38,47,-9,33
Perth Glory,3361,8,10,2,15,37,50,-13,32
Wellington P,3361,9,5,6,16,31,55,-24,21
CC Mariners,3361,10,4,8,15,28,49,-21,20
Sydney FC,3362,1,21,4,3,68,22,46,67
N'castle Jet,3362,2,15,6,7,59,39,20,51
Melbourne C,3362,3,14,5,10,45,35,10,47
Melbourne V,3362,4,13,5,11,45,42,3,44
Adelaide Utd,3362,5,11,6,11,37,40,-3,39
Brisbane,3362,6,10,5,13,33,42,-9,35
Western Sydn,3362,7,8,9,10,38,47,-9,33
Perth Glory,3362,8,10,2,15,37,50,-13,32
Wellington P,3362,9,5,6,16,31,55,-24,21
CC Mariners,3362,10,4,8,15,28,49,-21,20
Sydney FC,3363,1,21,4,3,65,22,43,67
N'castle Jet,3363,2,16,5,7,58,37,21,53
Melbourne C,3363,3,14,4,11,43,34,9,46
Melbourne V,3363,4,13,5,11,45,39,6,44
Adelaide Utd,3363,5,11,6,11,37,40,-3,39
Brisbane,3363,6,10,5,13,33,42,-9,35
Western Sydn,3363,7,8,9,10,38,47,-9,33
Perth Glory,3363,8,10,2,15,37,50,-13,32
Wellington P,3363,9,5,6,16,31,55,-24,21
CC Mariners,3363,10,4,8,15,28,49,-21,20
Sydney FC,3364,1,21,4,3,66,22,44,67
N'castle Jet,3364,2,16,5,7,61,38,23,53
Melbourne C,3364,3,14,4,11,44,37,7,46
Melbourne V,3364,4,13,5,11,45,40,5,44
Adelaide Utd,3364,5,11,6,11,37,40,-3,39
Brisbane,3364,6,10,5,13,33,42,-9,35
Western Sydn,3364,7,8,9,10,38,47,-9,33
Perth Glory,3364,8,10,2,15,37,50,-13,32
Wellington P,3364,9,5,6,16,31,55,-24,21
CC Mariners,3364,10,4,8,15,28,49,-21,20
Sydney FC,3365,1,20,5,3,64,22,42,65
N'castle Jet,3365,2,15,5,8,58,39,19,50
Melbourne C,3365,3,15,4,10,45,34,11,49
Melbourne V,3365,4,13,6,10,45,38,7,45
Adelaide Utd,3365,5,11,6,11,37,40,-3,39
Brisbane,3365,6,10,5,13,33,42,-9,35
Western Sydn,3365,7,8,9,10,38,47,-9,33
Perth Glory,3365,8,10,2,15,37,50,-13,32
Wellington P,3365,9,5,6,16,31,55,-24,21
CC Mariners,3365,10,4,8,15,28,49,-21,20
Sydney FC,3366,1,20,5,3,64,22,42,65
N'castle Jet,3366,2,16,5,7,60,39,21,53
Melbourne C,3366,3,14,4,11,45,36,9,46
Melbourne V,3366,4,13,6,10,45,38,7,45
Adelaide Utd,3366,5,11,6,11,37,40,-3,39
Brisbane,3366,6,10,5,13,33,42,-9,35
Western Sydn,3366,7,8,9,10,38,47,-9,33
Perth Glory,3366,8,10,2,15,37,50,-13,32
Wellington P,3366,9,5,6,16,31,55,-24,21
CC Mariners,3366,10,4,8,15,28,49,-21,20
Sydney FC,3367,1,20,4,4,64,24,40,64
N'castle Jet,3367,2,15,6,7,59,39,20,51
Melbourne C,3367,3,14,5,10,45,35,10,47
Melbourne V,3367,4,14,5,10,47,38,9,47
Adelaide Utd,3367,5,11,6,11,37,40,-3,39
Brisbane,3367,6,10,5,13,33,42,-9,35
Western Sydn,3367,7,8,9,10,38,47,-9,33
Perth Glory,3367,8,10,2,15,37,50,-13,32
Wellington P,3367,9,5,6,16,31,55,-24,21
CC Mariners,3367,10,4,8,15,28,49,-21,20
Sydney FC,3368,1,21,4,3,66,22,44,67
N'castle Jet,3368,2,15,6,7,59,39,20,51
Melbourne C,3368,3,14,5,10,45,35,10,47
Melbourne V,3368,4,13,5,11,45,40,5,44
Adelaide Utd,3368,5,11,6,11,37,40,-3,39
Brisbane,3368,6,10,5,13,33,42,-9,35
Western Sydn,3368,7,8,9,10,38,47,-9,33
Perth Glory,3368,8,10,2,15,37,50,-13,32
Wellington P,3368,9,5,6,16,31,55,-24,21
CC Mariners,3368,10,4,8,15,28,49,-21,20
Sydney FC,3369,1,21,4,3,66,23,43,67
N'castle Jet,3369,2,15,5,8,58,39,19,50
Melbourne C,3369,3,15,4,10,45,34,11,49
Melbourne V,3369,4,13,5,11,46,40,6,44
Adelaide Utd,3369,5,11,6,11,37,40,-3,39
Brisbane,3369,6,10,5,13,33,42,-9,35
Western Sydn,3369,7,8,9,10,38,47,-9,33
Perth Glory,3369,8,10,2,15,37,50,-13,32
Wellington P,3369,9,5,6,16,31,55,-24,21
CC Mariners,3369,10,4,8,15,28,49,-21,20
Sydney FC,3370,1,21,4,3,65,22,43,67
N'castle Jet,3370,2,16,5,7,60,38,22,53
Melbourne C,3370,3,14,4,11,44,36,8,46
Melbourne V,3370,4,13,5,11,45,39,6,44
Adelaide Utd,3370,5,11,6,11,37,40,-3,39
Brisbane,3370,6,10,5,13,33,42,-9,35
Western Sydn,3370,7,8,9,10,38,47,-9,33
Perth Glory,3370,8,10,2,15,37,50,-13,32
Wellington P,3370,9,5,6,16,31,55,-24,21
CC Mariners,3370,10,4,8,15,28,49,-21,20
Sydney FC,3371,1,21,4,3,66,23,43,67
N'castle Jet,3371,2,15,5,8,59,40,19,50
Melbourne C,3371,3,15,4,10,46,35,11,49
Melbourne V,3371,4,13,5,11,46,40,6,44
Adelaide Utd,3371,5,11,6,11,37,40,-3,39
Brisbane,3371,6,10,5,13,33,42,-9,35
Western Sydn,3371,7,8,9,10,38,47,-9,33
Perth Glory,3371,8,10,2,15,37,50,-13,32
Wellington P,3371,9,5,6,16,31,55,-24,21
CC Mariners,3371,10,4,8,15,28,49,-21,20
Sydney FC,3372,1,21,4,3,68,22,46,67
N'castle Jet,3372,2,15,6,7,59,39,20,51
Melbourne C,3372,3,14,5,10,45,35,10,47
Melbourne V,3372,4,13,5,11,45,42,3,44
Adelaide Utd,3372,5,11,6,11,37,40,-3,39
Brisbane,3372,6,10,5,13,33,42,-9,35
Western Sydn,3372,7,8,9,10,38,47,-9,33
Perth Glory,3372,8,10,2,15,37,50,-13,32
Wellington P,3372,9,5,6,16,31,55,-24,21
CC Mariners,3372,10,4,8,15,28,49,-21,20
Sydney FC,3373,1,21,4,3,66,22,44,67
N'castle Jet,3373,2,15,5,8,57,38,19,50
Melbourne C,3373,3,15,4,10,44,33,11,49
Melbourne V,3373,4,13,5,11,45,40,5,44
Adelaide Utd,3373,5,11,6,11,37,40,-3,39
Brisbane,3373,6,10,5,13,33,42,-9,35
Western Sydn,3373,7,8,9,10,38,47,-9,33
Perth Glory,3373,8,10,2,15,37,50,-13,32
Wellington P,3373,9,5,6,16,31,55,-24,21
CC Mariners,3373,10,4,8,15,28,49,-21,20
Sydney FC,3374,1,20,4,4,64,23,41,64
N'castle Jet,3374,2,15,5,8,58,39,19,50
Melbourne C,3374,3,15,4,10,45,34,11,49
Melbourne V,3374,4,14,5,10,46,38,8,47
Adelaide Utd,3374,5,11,6,11,37,40,-3,39
Brisbane,3374,6,10,5,13,33,42,-9,35
Western Sydn,3374,7,8,9,10,38,47,-9,33
Perth Glory,3374,8,10,2,15,37,50,-13,32
Wellington P,3374,9,5,6,16,31,55,-24,21
CC Mariners,3374,10,4,8,15,28,49,-21,20
Sydney FC,3375,1,21,4,3,67,24,43,67
N'castle Jet,3375,2,16,5,7,61,39,22,53
Melbourne C,3375,3,14,4,11,45,37,8,46
Melbourne V,3375,4,13,5,11,47,41,6,44
Adelaide Utd,3375,5,11,6,11,37,40,-3,39
Brisbane,3375,6,10,5,13,33,42,-9,35
Western Sydn,3375,7,8,9,10,38,47,-9,33
Perth Glory,3375,8,10,2,15,37,50,-13,32
Wellington P,3375,9,5,6,16,31,55,-24,21
CC Mariners,3375,10,4,8,15,28,49,-21,20
Sydney FC,3376,1,21,4,3,67,22,45,67
N'castle Jet,3376,2,15,5,8,57,38,19,50
Melbourne C,3376,3,15,4,10,44,33,11,49
Melbourne V,3376,4,13,5,11,45,41,4,44
Adelaide Utd,3376,5,11,6,11,37,40,-3,39
Brisbane,3376,6,10,5,13,33,42,-9,35
Western Sydn,3376,7,8,9,10,38,47,-9,33
Perth Glory,3376,8,10,2,15,37,50,-13,32
Wellington P,3376,9,5,6,16,31,55,-24,21
CC Mariners,3376,10,4,8,15,28,49,-21,20
Sydney FC,3377,1,20,5,3,65,23,42,65
N'castle Jet,3377,2,15,6,7,58,38,20,51
Melbourne C,3377,3,14,5,10,44,34,10,47
Melbourne V,3377,4,13,6,10,46,39,7,45
Adelaide Utd,3377,5,11,6,11,37,40,-3,39
Brisbane,3377,6,10,5,13,33,42,-9,35
Western Sydn,3377,7,8,9,10,38,47,-9,33
Perth Glory,3377,8,10,2,15,37,50,-13,32
Wellington P,3377,9,5,6,16,31,55,-24,21
CC Mariners,3377,10,4,8,15,28,49,-21,20
Sydney FC,3378,1,21,4,3,67,24,43,67
N'castle Jet,3378,2,15,5,8,58,39,19,50
Melbourne C,3378,3,15,4,10,45,34,11,49
Melbourne V,3378,4,13,5,11,47,41,6,44
Adelaide Utd,3378,5,11,6,11,37,40,-3,39
Brisbane,3378,6,10,5,13,33,42,-9,35
Western Sydn,3378,7,8,9,10,38,47,-9,33
Perth Glory,3378,8,10,2,15,37,50,-13,32
Wellington P,3378,9,5,6,16,31,55,-24,21
CC Mariners,3378,10,4,8,15,28,49,-21,20
Sydney FC,3379,1,20,4,4,64,24,40,64
N'castle Jet,3379,2,16,5,7,60,39,21,53
Melbourne V,3379,3,14,5,10,47,38,9,47
Melbourne C,3379,4,14,4,11,45,36,9,46
Adelaide Utd,3379,5,11,6,11,37,40,-3,39
Brisbane,3379,6,10,5,13,33,42,-9,35
Western Sydn,3379,7,8,9,10,38,47,-9,33
Perth Glory,3379,8,10,2,15,37,50,-13,32
Wellington P,3379,9,5,6,16,31,55,-24,21
CC Mariners,3379,10,4,8,15,28,49,-21,20
Sydney FC,3380,1,20,4,4,65,25,40,64
N'castle Jet,3380,2,15,5,8,58,39,19,50
Melbourne C,3380,3,15,4,10,45,34,11,49
Melbourne V,3380,4,14,5,10,48,39,9,47
Adelaide Utd,3380,5,11,6,11,37,40,-3,39
Brisbane,3380,6,10,5,13,33,42,-9,35
Western Sydn,3380,7,8,9,10,38,47,-9,33
Perth Glory,3380,8,10,2,15,37,50,-13,32
Wellington P,3380,9,5,6,16,31,55,-24,21
CC Mariners,3380,10,4,8,15,28,49,-21,20
Sydney FC,3381,1,21,4,3,67,24,43,67
N'castle Jet,3381,2,15,6,7,57,37,20,51
Melbourne C,3381,3,14,5,10,43,33,10,47
Melbourne V,3381,4,13,5,11,47,41,6,44
Adelaide Utd,3381,5,11,6,11,37,40,-3,39
Brisbane,3381,6,10,5,13,33,42,-9,35
Western Sydn,3381,7,8,9,10,38,47,-9,33
Perth Glory,3381,8,10,2,15,37,50,-13,32
Wellington P,3381,9,5,6,16,31,55,-24,21
CC Mariners,3381,10,4,8,15,28,49,-21,20
Sydney FC,3382,1,20,4,4,64,23,41,64
N'castle Jet,3382,2,16,5,7,60,38,22,53
Melbourne V,3382,3,14,5,10,46,38,8,47
Melbourne C,3382,4,14,4,11,44,36,8,46
Adelaide Utd,3382,5,11,6,11,37,40,-3,39
Brisbane,3382,6,10,5,13,33,42,-9,35
Western Sydn,3382,7,8,9,10,38,47,-9,33
Perth Glory,3382,8,10,2,15,37,50,-13,32
Wellington P,3382,9,5,6,16,31,55,-24,21
CC Mariners,3382,10,4,8,15,28,49,-21,20
Sydney FC,3383,1,21,4,3,67,24,43,67
N'castle Jet,3383,2,15,5,8,58,42,16,50
Melbourne C,3383,3,15,4,10,48,34,14,49
Melbourne V,3383,4,13,5,11,47,41,6,44
Adelaide Utd,3383,5,11,6,11,37,40,-3,39
Brisbane,3383,6,10,5,13,33,42,-9,35
Western Sydn,3383,7,8,9,10,38,47,-9,33
Perth Glory,3383,8,10,2,15,37,50,-13,32
Wellington P,3383,9,5,6,16,31,55,-24,21
CC Mariners,3383,10,4,8,15,28,49,-21,20
Sydney FC,3384,1,21,4,3,70,25,45,67
N'castle Jet,3384,2,16,5,7,58,37,21,53
Melbourne C,3384,3,14,4,11,43,34,9,46
Melbourne V,3384,4,13,5,11,48,44,4,44
Adelaide Utd,3384,5,11,6,11,37,40,-3,39
Brisbane,3384,6,10,5,13,33,42,-9,35
Western Sydn,3384,7,8,9,10,38,47,-9,33
Perth Glory,3384,8,10,2,15,37,50,-13,32
Wellington P,3384,9,5,6,16,31,55,-24,21
CC Mariners,3384,10,4,8,15,28,49,-21,20
Sydney FC,3385,1,20,5,3,64,22,42,65
N'castle Jet,3385,2,15,5,8,57,38,19,50
Melbourne C,3385,3,15,4,10,44,33,11,49
Melbourne V,3385,4,13,6,10,45,38,7,45
Adelaide Utd,3385,5,11,6,11,37,40,-3,39
Brisbane,3385,6,10,5,13,33,42,-9,35
Western Sydn,3385,7,8,9,10,38,47,-9,33
Perth Glory,3385,8,10,2,15,37,50,-13,32
Wellington P,3385,9,5,6,16,31,55,-24,21
CC Mariners,3385,10,4,8,15,28,49,-21,20
Sydney FC,3386,1,20,4,4,64,24,40,64
N'castle Jet,3386,2,16,5,7,60,38,22,53
Melbourne V,3386,3,14,5,10,47,38,9,47
Melbourne C,3386,4,14,4,11,44,36,8,46
Adelaide Utd,3386,5,11,6,11,37,40,-3,39
Brisbane,3386,6,10,5,13,33,42,-9,35
Western Sydn,3386,7,8,9,10,38,47,-9,33
Perth Glory,3386,8,10,2,15,37,50,-13,32
Wellington P,3386,9,5,6,16,31,55,-24,21
CC Mariners,3386,10,4,8,15,28,49,-21,20
Sydney FC,3387,1,20,5,3,65,23,42,65
N'castle Jet,3387,2,15,6,7,57,37,20,51
Melbourne C,3387,3,14,5,10,43,33,10,47
Melbourne V,3387,4,13,6,10,46,39,7,45
Adelaide Utd,3387,5,11,6,11,37,40,-3,39
Brisbane,3387,6,10,5,13,33,42,-9,35
Western Sydn,3387,7,8,9,10,38,47,-9,33
Perth Glory,3387,8,10,2,15,37,50,-13,32
Wellington P,3387,9,5,6,16,31,55,-24,21
CC Mariners,3387,10,4,8,15,28,49,-21,20
Sydney FC,3388,1,21,4,3,67,22,45,67
N'castle Jet,3388,2,15,5,8,58,39,19,50
Melbourne C,3388,3,15,4,10,45,34,11,49
Melbourne V,3388,4,13,5,11,45,41,4,44
Adelaide Utd,3388,5,11,6,11,37,40,-3,39
Brisbane,3388,6,10,5,13,33,42,-9,35
Western Sydn,3388,7,8,9,10,38,47,-9,33
Perth Glory,3388,8,10,2,15,37,50,-13,32
Wellington P,3388,9,5,6,16,31,55,-24,21
CC Mariners,3388,10,4,8,15,28,49,-21,20
Sydney FC,3389,1,20,4,4,66,25,41,64
N'castle Jet,3389,2,15,5,8,58,39,19,50
Melbourne C,3389,3,15,4,10,45,34,11,49
Melbourne V,3389,4,14,5,10,48,40,8,47
Adelaide Utd,3389,5,11,6,11,37,40,-3,39
Brisbane,3389,6,10,5,13,33,42,-9,35
Western Sydn,3389,7,8,9,10,38,47,-9,33
Perth Glory,3389,8,10,2,15,37,50,-13,32
Wellington P,3389,9,5,6,16,31,55,-24,21
CC Mariners,3389,10,4,8,15,28,49,-21,20
Sydney FC,3390,1,20,5,3,64,22,42,65
N'castle Jet,3390,2,16,5,7,58,37,21,53
Melbourne C,3390,3,14,4,11,43,34,9,46
Melbourne V,3390,4,13,6,10,45,38,7,45
Adelaide Utd,3390,5,11,6,11,37,40,-3,39
Brisbane,3390,6,10,5,13,33,42,-9,35
Western Sydn,3390,7,8,9,10,38,47,-9,33
Perth Glory,3390,8,10,2,15,37,50,-13,32
Wellington P,3390,9,5,6,16,31,55,-24,21
CC Mariners,3390,10,4,8,15,28,49,-21,20
Sydney FC,3391,1,21,4,3,65,22,43,67
N'castle Jet,3391,2,16,5,7,62,41,21,53
Melbourne C,3391,3,14,4,11,47,38,9,46
Melbourne V,3391,4,13,5,11,45,39,6,44
Adelaide Utd,3391,5,11,6,11,37,40,-3,39
Brisbane,3391,6,10,5,13,33,42,-9,35
Western Sydn,3391,7,8,9,10,38,47,-9,33
Perth Glory,3391,8,10,2,15,37,50,-13,32
Wellington P,3391,9,5,6,16,31,55,-24,21
CC Mariners,3391,10,4,8,15,28,49,-21,20
Sydney FC,3392,1,20,5,3,66,24,42,65
N'castle Jet,3392,2,16,5,7,59,37,22,53
Melbourne C,3392,3,14,4,11,43,35,8,46
Melbourne V,3392,4,13,6,10,47,40,7,45
Adelaide Utd,3392,5,11,6,11,37,40,-3,39
Brisbane,3392,6,10,5,13,33,42,-9,35
Western Sydn,3392,7,8,9,10,38,47,-9,33
Perth Glory,3392,8,10,2,15,37,50,-13,32
Wellington P,3392,9,5,6,16,31,55,-24,21
CC Mariners,3392,10,4,8,15,28,49,-21,20
Sydney FC,3393,1,21,4,3,67,24,43,67
N'castle Jet,3393,2,15,5,8,58,40,18,50
Melbourne C,3393,3,15,4,10,46,34,12,49
Melbourne V,3393,4,13,5,11,47,41,6,44
Adelaide Utd,3393,5,11,6,11,37,40,-3,39
Brisbane,3393,6,10,5,13,33,42,-9,35
Western Sydn,3393,7,8,9,10,38,47,-9,33
Perth Glory,3393,8,10,2,15,37,50,-13,32
Wellington P,3393,9,5,6,16,31,55,-24,21
CC Mariners,3393,10,4,8,15,28,49,-21,20
Sydney FC,3394,1,21,4,3,66,22,44,67
N'castle Jet,3394,2,15,6,7,58,38,20,51
Melbourne C,3394,3,14,5,10,44,34,10,47
Melbourne V,3394,4,13,5,11,45,40,5,44
Adelaide Utd,3394,5,11,6,11,37,40,-3,39
Brisbane,3394,6,10,5,13,33,42,-9,35
Western Sydn,3394,7,8,9,10,38,47,-9,33
Perth Glory,3394,8,10,2,15,37,50,-13,32
Wellington P,3394,9,5,6,16,31,55,-24,21
CC Mariners,3394,10,4,8,15,28,49,-21,20
Sydney FC,3395,1,21,4,3,67,23,44,67
N'castle Jet,3395,2,16,5,7,59,37,22,53
Melbourne C,3395,3,14,4,11,43,35,8,46
Melbourne V,3395,4,13,5,11,46,41,5,44
Adelaide Utd,3395,5,11,6,11,37,40,-3,39
Brisbane,3395,6,10,5,13,33,42,-9,35
Western Sydn,3395,7,8,9,10,38,47,-9,33
Perth Glory,3395,8,10,2,15,37,50,-13,32
Wellington P,3395,9,5,6,16,31,55,-24,21
CC Mariners,3395,10,4,8,15,28,49,-21,20
Sydney FC,3396,1,21,4,3,66,23,43,67
N'castle Jet,3396,2,15,5,8,57,39,18,50
Melbourne C,3396,3,15,4,10,45,33,12,49
Melbourne V,3396,4,13,5,11,46,40,6,44
Adelaide Utd,3396,5,11,6,11,37,40,-3,39
Brisbane,3396,6,10,5,13,33,42,-9,35
Western Sydn,3396,7,8,9,10,38,47,-9,33
Perth Glory,3396,8,10,2,15,37,50,-13,32
Wellington P,3396,9,5,6,16,31,55,-24,21
CC Mariners,3396,10,4,8,15,28,49,-21,20
Sydney FC,3397,1,21,4,3,67,22,45,67
N'castle Jet,3397,2,16,5,7,58,37,21,53
Melbourne C,3397,3,14,4,11,43,34,9,46
Melbourne V,3397,4,13,5,11,45,41,4,44
Adelaide Utd,3397,5,11,6,11,37,40,-3,39
Brisbane,3397,6,10,5,13,33,42,-9,35
Western Sydn,3397,7,8,9,10,38,47,-9,33
Perth Glory,3397,8,10,2,15,37,50,-13,32
Wellington P,3397,9,5,6,16,31,55,-24,21
CC Mariners,3397,10,4,8,15,28,49,-21,20
Sydney FC,3398,1,21,4,3,69,22,47,67
N'castle Jet,3398,2,15,5,8,57,38,19,50
Melbourne C,3398,3,15,4,10,44,33,11,49
Melbourne V,3398,4,13,5,11,45,43,2,44
Adelaide Utd,3398,5,11,6,11,37,40,-3,39
Brisbane,3398,6,10,5,13,33,42,-9,35
Western Sydn,3398,7,8,9,10,38,47,-9,33
Perth Glory,3398,8,10,2,15,37,50,-13,32
Wellington P,3398,9,5,6,16,31,55,-24,21
CC Mariners,3398,10,4,8,15,28,49,-21,20
Sydney FC,3399,1,21,4,3,67,24,43,67
N'castle Jet,3399,2,16,5,7,59,38,21,53
Melbourne C,3399,3,14,4,11,44,35,9,46
Melbourne V,3399,4,13,5,11,47,41,6,44
Adelaide Utd,3399,5,11,6,11,37,40,-3,39
Brisbane,3399,6,10,5,13,33,42,-9,35
Western Sydn,3399,7,8,9,10,38,47,-9,33
Perth Glory,3399,8,10,2,15,37,50,-13,32
Wellington P,3399,9,5,6,16,31,55,-24,21
CC Mariners,3399,10,4,8,15,28,49,-21,20
Sydney FC,3400,1,21,4,3,67,22,45,67
N'castle Jet,3400,2,15,5,8,57,40,17,50
Melbourne C,3400,3,15,4,10,46,33,13,49
Melbourne V,3400,4,13,5,11,45,41,4,44
Adelaide Utd,3400,5,11,6,11,37,40,-3,39
Brisbane,3400,6,10,5,13,33,42,-9,35
Western Sydn,3400,7,8,9,10,38,47,-9,33
Perth Glory,3400,8,10,2,15,37,50,-13,32
Wellington P,3400,9,5,6,16,31,55,-24,21
CC Mariners,3400,10,4,8,15,28,49,-21,20
Sydney FC,3401,1,21,4,3,66,22,44,67
N'castle Jet,3401,2,16,5,7,58,37,21,53
Melbourne C,3401,3,14,4,11,43,34,9,46
Melbourne V,3401,4,13,5,11,45,40,5,44
Adelaide Utd,3401,5,11,6,11,37,40,-3,39
Brisbane,3401,6,10,5,13,33,42,-9,35
Western Sydn,3401,7,8,9,10,38,47,-9,33
Perth Glory,3401,8,10,2,15,37,50,-13,32
Wellington P,3401,9,5,6,16,31,55,-24,21
CC Mariners,3401,10,4,8,15,28,49,-21,20
Sydney FC,3402,1,21,4,3,67,23,44,67
N'castle Jet,3402,2,15,5,8,57,38,19,50
Melbourne C,3402,3,15,4,10,44,33,11,49
Melbourne V,3402,4,13,5,11,46,41,5,44
Adelaide Utd,3402,5,11,6,11,37,40,-3,39
Brisbane,3402,6,10,5,13,33,42,-9,35
Western Sydn,3402,7,8,9,10,38,47,-9,33
Perth Glory,3402,8,10,2,15,37,50,-13,32
Wellington P,3402,9,5,6,16,31,55,-24,21
CC Mariners,3402,10,4,8,15,28,49,-21,20
Sydney FC,3403,1,21,4,3,66,22,44,67
N'castle Jet,3403,2,15,6,7,58,38,20,51
Melbourne C,3403,3,14,5,10,44,34,10,47
Melbourne V,3403,4,13,5,11,45,40,5,44
Adelaide Utd,3403,5,11,6,11,37,40,-3,39
Brisbane,3403,6,10,5,13,33,42,-9,35
Western Sydn,3403,7,8,9,10,38,47,-9,33
Perth Glory,3403,8,10,2,15,37,50,-13,32
Wellington P,3403,9,5,6,16,31,55,-24,21
CC Mariners,3403,10,4,8,15,28,49,-21,20
Sydney FC,3404,1,21,4,3,67,24,43,67
N'castle Jet,3404,2,16,5,7,59,37,22,53
Melbourne C,3404,3,14,4,11,43,35,8,46
Melbourne V,3404,4,13,5,11,47,41,6,44
Adelaide Utd,3404,5,11,6,11,37,40,-3,39
Brisbane,3404,6,10,5,13,33,42,-9,35
Western Sydn,3404,7,8,9,10,38,47,-9,33
Perth Glory,3404,8,10,2,15,37,50,-13,32
Wellington P,3404,9,5,6,16,31,55,-24,21
CC Mariners,3404,10,4,8,15,28,49,-21,20
Sydney FC,3405,1,20,4,4,64,23,41,64
N'castle Jet,3405,2,15,5,8,57,39,18,50
Melbourne C,3405,3,15,4,10,45,33,12,49
Melbourne V,3405,4,14,5,10,46,38,8,47
Adelaide Utd,3405,5,11,6,11,37,40,-3,39
Brisbane,3405,6,10,5,13,33,42,-9,35
Western Sydn,3405,7,8,9,10,38,47,-9,33
Perth Glory,3405,8,10,2,15,37,50,-13,32
Wellington P,3405,9,5,6,16,31,55,-24,21
CC Mariners,3405,10,4,8,15,28,49,-21,20
Sydney FC,3406,1,21,4,3,66,23,43,67
N'castle Jet,3406,2,15,6,7,58,38,20,51
Melbourne C,3406,3,14,5,10,44,34,10,47
Melbourne V,3406,4,13,5,11,46,40,6,44
Adelaide Utd,3406,5,11,6,11,37,40,-3,39
Brisbane,3406,6,10,5,13,33,42,-9,35
Western Sydn,3406,7,8,9,10,38,47,-9,33
Perth Glory,3406,8,10,2,15,37,50,-13,32
Wellington P,3406,9,5,6,16,31,55,-24,21
CC Mariners,3406,10,4,8,15,28,49,-21,20
Sydney FC,3407,1,20,4,4,64,23,41,64
N'castle Jet,3407,2,16,5,7,60,38,22,53
Melbourne V,3407,3,14,5,10,46,38,8,47
Melbourne C,3407,4,14,4,11,44,36,8,46
Adelaide Utd,3407,5,11,6,11,37,40,-3,39
Brisbane,3407,6,10,5,13,33,42,-9,35
Western Sydn,3407,7,8,9,10,38,47,-9,33
Perth Glory,3407,8,10,2,15,37,50,-13,32
Wellington P,3407,9,5,6,16,31,55,-24,21
CC Mariners,3407,10,4,8,15,28,49,-21,20
Sydney FC,3408,1,21,4,3,66,23,43,67
N'castle Jet,3408,2,15,5,8,57,39,18,50
Melbourne C,3408,3,15,4,10,45,33,12,49
Melbourne V,3408,4,13,5,11,46,40,6,44
Adelaide Utd,3408,5,11,6,11,37,40,-3,39
Brisbane,3408,6,10,5,13,33,42,-9,35
Western Sydn,3408,7,8,9,10,38,47,-9,33
Perth Glory,3408,8,10,2,15,37,50,-13,32
Wellington P,3408,9,5,6,16,31,55,-24,21
CC Mariners,3408,10,4,8,15,28,49,-21,20
Sydney FC,3409,1,21,4,3,66,22,44,67
N'castle Jet,3409,2,16,5,7,59,38,21,53
Melbourne C,3409,3,14,4,11,44,35,9,46
Melbourne V,3409,4,13,5,11,45,40,5,44
Adelaide Utd,3409,5,11,6,11,37,40,-3,39
Brisbane,3409,6,10,5,13,33,42,-9,35
Western Sydn,3409,7,8,9,10,38,47,-9,33
Perth Glory,3409,8,10,2,15,37,50,-13,32
Wellington P,3409,9,5,6,16,31,55,-24,21
CC Mariners,3409,10,4,8,15,28,49,-21,20
Sydney FC,3410,1,20,4,4,64,26,38,64
N'castle Jet,3410,2,15,5,8,57,38,19,50
Melbourne C,3410,3,15,4,10,44,33,11,49
Melbourne V,3410,4,14,5,10,49,38,11,47
Adelaide Utd,3410,5,11,6,11,37,40,-3,39
Brisbane,3410,6,10,5,13,33,42,-9,35
Western Sydn,3410,7,8,9,10,38,47,-9,33
Perth Glory,3410,8,10,2,15,37,50,-13,32
Wellington P,3410,9,5,6,16,31,55,-24,21
CC Mariners,3410,10,4,8,15,28,49,-21,20
Sydney FC,3411,1,20,4,4,64,23,41,64
N'castle Jet,3411,2,15,5,8,58,39,19,50
Melbourne C,3411,3,15,4,10,45,34,11,49
Melbourne V,3411,4,14,5,10,46,38,8,47
Adelaide Utd,3411,5,11,6,11,37,40,-3,39
Brisbane,3411,6,10,5,13,33,42,-9,35
Western Sydn,3411,7,8,9,10,38,47,-9,33
Perth Glory,3411,8,10,2,15,37,50,-13,32
Wellington P,3411,9,5,6,16,31,55,-24,21
CC Mariners,3411,10,4,8,15,28,49,-21,20
Sydney FC,3412,1,21,4,3,65,22,43,67
N'castle Jet,3412,2,16,5,7,61,39,22,53
Melbourne C,3412,3,14,4,11,45,37,8,46
Melbourne V,3412,4,13,5,11,45,39,6,44
Adelaide Utd,3412,5,11,6,11,37,40,-3,39
Brisbane,3412,6,10,5,13,33,42,-9,35
Western Sydn,3412,7,8,9,10,38,47,-9,33
Perth Glory,3412,8,10,2,15,37,50,-13,32
Wellington P,3412,9,5,6,16,31,55,-24,21
CC Mariners,3412,10,4,8,15,28,49,-21,20
Sydney FC,3413,1,21,4,3,68,22,46,67
N'castle Jet,3413,2,15,5,8,57,38,19,50
Melbourne C,3413,3,15,4,10,44,33,11,49
Melbourne V,3413,4,13,5,11,45,42,3,44
Adelaide Utd,3413,5,11,6,11,37,40,-3,39
Brisbane,3413,6,10,5,13,33,42,-9,35
Western Sydn,3413,7,8,9,10,38,47,-9,33
Perth Glory,3413,8,10,2,15,37,50,-13,32
Wellington P,3413,9,5,6,16,31,55,-24,21
CC Mariners,3413,10,4,8,15,28,49,-21,20
Sydney FC,3414,1,20,4,4,64,23,41,64
N'castle Jet,3414,2,15,6,7,58,38,20,51
Melbourne C,3414,3,14,5,10,44,34,10,47
Melbourne V,3414,4,14,5,10,46,38,8,47
Adelaide Utd,3414,5,11,6,11,37,40,-3,39
Brisbane,3414,6,10,5,13,33,42,-9,35
Western Sydn,3414,7,8,9,10,38,47,-9,33
Perth Glory,3414,8,10,2,15,37,50,-13,32
Wellington P,3414,9,5,6,16,31,55,-24,21
CC Mariners,3414,10,4,8,15,28,49,-21,20
Sydney FC,3415,1,21,4,3,67,24,43,67
N'castle Jet,3415,2,16,5,7,58,37,21,53
Melbourne C,3415,3,14,4,11,43,34,9,46
Melbourne V,3415,4,13,5,11,47,41,6,44
Adelaide Utd,3415,5,11,6,11,37,40,-3,39
Brisbane,3415,6,10,5,13,33,42,-9,35
Western Sydn,3415,7,8,9,10,38,47,-9,33
Perth Glory,3415,8,10,2,15,37,50,-13,32
Wellington P,3415,9,5,6,16,31,55,-24,21
CC Mariners,3415,10,4,8,15,28,49,-21,20
Sydney FC,3416,1,21,4,3,70,22,48,67
N'castle Jet,3416,2,15,6,7,58,38,20,51
Melbourne C,3416,3,14,5,10,44,34,10,47
Melbourne V,3416,4,13,5,11,45,44,1,44
Adelaide Utd,3416,5,11,6,11,37,40,-3,39
Brisbane,3416,6,10,5,13,33,42,-9,35
Western Sydn,3416,7,8,9,10,38,47,-9,33
Perth Glory,3416,8,10,2,15,37,50,-13,32
Wellington P,3416,9,5,6,16,31,55,-24,21
CC Mariners,3416,10,4,8,15,28,49,-21,20
Sydney FC,3417,1,21,4,3,67,24,43,67
N'castle Jet,3417,2,16,5,7,59,38,21,53
Melbourne C,3417,3,14,4,11,44,35,9,46
Melbourne V,3417,4,13,5,11,47,41,6,44
Adelaide Utd,3417,5,11,6,11,37,40,-3,39
Brisbane,3417,6,10,5,13,33,42,-9,35
Western Sydn,3417,7,8,9,10,38,47,-9,33
Perth Glory,3417,8,10,2,15,37,50,-13,32
Wellington P,3417,9,5,6,16,31,55,-24,21
CC Mariners,3417,10,4,8,15,28,49,-21,20
Sydney FC,3418,1,20,4,4,65,25,40,64
N'castle Jet,3418,2,16,5,7,60,38,22,53
Melbourne V,3418,3,14,5,10,48,39,9,47
Melbourne C,3418,4,14,4,11,44,36,8,46
Adelaide Utd,3418,5,11,6,11,37,40,-3,39
Brisbane,3418,6,10,5,13,33,42,-9,35
Western Sydn,3418,7,8,9,10,38,47,-9,33
Perth Glory,3418,8,10,2,15,37,50,-13,32
Wellington P,3418,9,5,6,16,31,55,-24,21
CC Mariners,3418,10,4,8,15,28,49,-21,20
Sydney FC,3419,1,20,4,4,64,24,40,64
N'castle Jet,3419,2,16,5,7,60,37,23,53
Melbourne V,3419,3,14,5,10,47,38,9,47
Melbourne C,3419,4,14,4,11,43,36,7,46
Adelaide Utd,3419,5,11,6,11,37,40,-3,39
Brisbane,3419,6,10,5,13,33,42,-9,35
Western Sydn,3419,7,8,9,10,38,47,-9,33
Perth Glory,3419,8,10,2,15,37,50,-13,32
Wellington P,3419,9,5,6,16,31,55,-24,21
CC Mariners,3419,10,4,8,15,28,49,-21,20
Sydney FC,3420,1,20,4,4,64,24,40,64
N'castle Jet,3420,2,16,5,7,60,38,22,53
Melbourne V,3420,3,14,5,10,47,38,9,47
Melbourne C,3420,4,14,4,11,44,36,8,46
Adelaide Utd,3420,5,11,6,11,37,40,-3,39
Brisbane,3420,6,10,5,13,33,42,-9,35
Western Sydn,3420,7,8,9,10,38,47,-9,33
Perth Glory,3420,8,10,2,15,37,50,-13,32
Wellington P,3420,9,5,6,16,31,55,-24,21
CC Mariners,3420,10,4,8,15,28,49,-21,20
Sydney FC,3421,1,21,4,3,66,23,43,67
N'castle Jet,3421,2,15,5,8,57,38,19,50
Melbourne C,3421,3,15,4,10,44,33,11,49
Melbourne V,3421,4,13,5,11,46,40,6,44
Adelaide Utd,3421,5,11,6,11,37,40,-3,39
Brisbane,3421,6,10,5,13,33,42,-9,35
Western Sydn,3421,7,8,9,10,38,47,-9,33
Perth Glory,3421,8,10,2,15,37,50,-13,32
Wellington P,3421,9,5,6,16,31,55,-24,21
CC Mariners,3421,10,4,8,15,28,49,-21,20
Sydney FC,3422,1,21,4,3,65,22,43,67
N'castle Jet,3422,2,16,5,7,59,38,21,53
Melbourne C,3422,3,14,4,11,44,35,9,46
Melbourne V,3422,4,13,5,11,45,39,6,44
Adelaide Utd,3422,5,11,6,11,37,40,-3,39
Brisbane,3422,6,10,5,13,33,42,-9,35
Western Sydn,3422,7,8,9,10,38,47,-9,33
Perth Glory,3422,8,10,2,15,37,50,-13,32
Wellington P,3422,9,5,6,16,31,55,-24,21
CC Mariners,3422,10,4,8,15,28,49,-21,20
Sydney FC,3423,1,21,4,3,65,22,43,67
N'castle Jet,3423,2,16,5,7,60,38,22,53
Melbourne C,3423,3,14,4,11,44,36,8,46
Melbourne V,3423,4,13,5,11,45,39,6,44
Adelaide Utd,3423,5,11,6,11,37,40,-3,39
Brisbane,3423,6,10,5,13,33,42,-9,35
Western Sydn,3423,7,8,9,10,38,47,-9,33
Perth Glory,3423,8,10,2,15,37,50,-13,32
Wellington P,3423,9,5,6,16,31,55,-24,21
CC Mariners,3423,10,4,8,15,28,49,-21,20
Sydney FC,3424,1,21,4,3,68,23,45,67
N'castle Jet,3424,2,15,5,8,58,39,19,50
Melbourne C,3424,3,15,4,10,45,34,11,49
Melbourne V,3424,4,13,5,11,46,42,4,44
Adelaide Utd,3424,5,11,6,11,37,40,-3,39
Brisbane,3424,6,10,5,13,33,42,-9,35
Western Sydn,3424,7,8,9,10,38,47,-9,33
Perth Glory,3424,8,10,2,15,37,50,-13,32
Wellington P,3424,9,5,6,16,31,55,-24,21
CC Mariners,3424,10,4,8,15,28,49,-21,20
Sydney FC,3425,1,21,4,3,67,23,44,67
N'castle Jet,3425,2,15,6,7,58,38,20,51
Melbourne C,3425,3,14,5,10,44,34,10,47
Melbourne V,3425,4,13,5,11,46,41,5,44
Adelaide Utd,3425,5,11,6,11,37,40,-3,39
Brisbane,3425,6,10,5,13,33,42,-9,35
Western Sydn,3425,7,8,9,10,38,47,-9,33
Perth Glory,3425,8,10,2,15,37,50,-13,32
Wellington P,3425,9,5,6,16,31,55,-24,21
CC Mariners,3425,10,4,8,15,28,49,-21,20
Sydney FC,3426,1,21,4,3,69,22,47,67
N'castle Jet,3426,2,16,5,7,59,38,21,53
Melbourne C,3426,3,14,4,11,44,35,9,46
Melbourne V,3426,4,13,5,11,45,43,2,44
Adelaide Utd,3426,5,11,6,11,37,40,-3,39
Brisbane,3426,6,10,5,13,33,42,-9,35
Western Sydn,3426,7,8,9,10,38,47,-9,33
Perth Glory,3426,8,10,2,15,37,50,-13,32
Wellington P,3426,9,5,6,16,31,55,-24,21
CC Mariners,3426,10,4,8,15,28,49,-21,20
Sydney FC,3427,1,20,4,4,65,25,40,64
N'castle Jet,3427,2,16,5,7,59,37,22,53
Melbourne V,3427,3,14,5,10,48,39,9,47
Melbourne C,3427,4,14,4,11,43,35,8,46
Adelaide Utd,3427,5,11,6,11,37,40,-3,39
Brisbane,3427,6,10,5,13,33,42,-9,35
Western Sydn,3427,7,8,9,10,38,47,-9,33
Perth Glory,3427,8,10,2,15,37,50,-13,32
Wellington P,3427,9,5,6,16,31,55,-24,21
CC Mariners,3427,10,4,8,15,28,49,-21,20
Sydney FC,3428,1,20,5,3,65,23,42,65
N'castle Jet,3428,2,16,5,7,61,38,23,53
Melbourne C,3428,3,14,4,11,44,37,7,46
Melbourne V,3428,4,13,6,10,46,39,7,45
Adelaide Utd,3428,5,11,6,11,37,40,-3,39
Brisbane,3428,6,10,5,13,33,42,-9,35
Western Sydn,3428,7,8,9,10,38,47,-9,33
Perth Glory,3428,8,10,2,15,37,50,-13,32
Wellington P,3428,9,5,6,16,31,55,-24,21
CC Mariners,3428,10,4,8,15,28,49,-21,20
Sydney FC,3429,1,21,4,3,65,22,43,67
N'castle Jet,3429,2,16,5,7,58,37,21,53
Melbourne C,3429,3,14,4,11,43,34,9,46
Melbourne V,3429,4,13,5,11,45,39,6,44
Adelaide Utd,3429,5,11,6,11,37,40,-3,39
Brisbane,3429,6,10,5,13,33,42,-9,35
Western Sydn,3429,7,8,9,10,38,47,-9,33
Perth Glory,3429,8,10,2,15,37,50,-13,32
Wellington P,3429,9,5,6,16,31,55,-24,21
CC Mariners,3429,10,4,8,15,28,49,-21,20
Sydney FC,3430,1,21,4,3,66,23,43,67
N'castle Jet,3430,2,16,5,7,58,37,21,53
Melbourne C,3430,3,14,4,11,43,34,9,46
Melbourne V,3430,4,13,5,11,46,40,6,44
Adelaide Utd,3430,5,11,6,11,37,40,-3,39
Brisbane,3430,6,10,5,13,33,42,-9,35
Western Sydn,3430,7,8,9,10,38,47,-9,33
Perth Glory,3430,8,10,2,15,37,50,-13,32
Wellington P,3430,9,5,6,16,31,55,-24,21
CC Mariners,3430,10,4,8,15,28,49,-21,20
Sydney FC,3431,1,20,4,4,64,24,40,64
N'castle Jet,3431,2,15,5,8,58,39,19,50
Melbourne C,3431,3,15,4,10,45,34,11,49
Melbourne V,3431,4,14,5,10,47,38,9,47
Adelaide Utd,3431,5,11,6,11,37,40,-3,39
Brisbane,3431,6,10,5,13,33,42,-9,35
Western Sydn,3431,7,8,9,10,38,47,-9,33
Perth Glory,3431,8,10,2,15,37,50,-13,32
Wellington P,3431,9,5,6,16,31,55,-24,21
CC Mariners,3431,10,4,8,15,28,49,-21,20
Sydney FC,3432,1,21,4,3,68,22,46,67
N'castle Jet,3432,2,15,5,8,57,38,19,50
Melbourne C,3432,3,15,4,10,44,33,11,49
Melbourne V,3432,4,13,5,11,45,42,3,44
Adelaide Utd,3432,5,11,6,11,37,40,-3,39
Brisbane,3432,6,10,5,13,33,42,-9,35
Western Sydn,3432,7,8,9,10,38,47,-9,33
Perth Glory,3432,8,10,2,15,37,50,-13,32
Wellington P,3432,9,5,6,16,31,55,-24,21
CC Mariners,3432,10,4,8,15,28,49,-21,20
Sydney FC,3433,1,20,5,3,66,24,42,65
N'castle Jet,3433,2,16,5,7,58,37,21,53
Melbourne C,3433,3,14,4,11,43,34,9,46
Melbourne V,3433,4,13,6,10,47,40,7,45
Adelaide Utd,3433,5,11,6,11,37,40,-3,39
Brisbane,3433,6,10,5,13,33,42,-9,35
Western Sydn,3433,7,8,9,10,38,47,-9,33
Perth Glory,3433,8,10,2,15,37,50,-13,32
Wellington P,3433,9,5,6,16,31,55,-24,21
CC Mariners,3433,10,4,8,15,28,49,-21,20
Sydney FC,3434,1,21,4,3,66,23,43,67
N'castle Jet,3434,2,16,5,7,60,38,22,53
Melbourne C,3434,3,14,4,11,44,36,8,46
Melbourne V,3434,4,13,5,11,46,40,6,44
Adelaide Utd,3434,5,11,6,11,37,40,-3,39
Brisbane,3434,6,10,5,13,33,42,-9,35
Western Sydn,3434,7,8,9,10,38,47,-9,33
Perth Glory,3434,8,10,2,15,37,50,-13,32
Wellington P,3434,9,5,6,16,31,55,-24,21
CC Mariners,3434,10,4,8,15,28,49,-21,20
Sydney FC,3435,1,21,4,3,66,23,43,67
N'castle Jet,3435,2,16,5,7,58,37,21,53
Melbourne C,3435,3,14,4,11,43,34,9,46
Melbourne V,3435,4,13,5,11,46,40,6,44
Adelaide Utd,3435,5,11,6,11,37,40,-3,39
Brisbane,3435,6,10,5,13,33,42,-9,35
Western Sydn,3435,7,8,9,10,38,47,-9,33
Perth Glory,3435,8,10,2,15,37,50,-13,32
Wellington P,3435,9,5,6,16,31,55,-24,21
CC Mariners,3435,10,4,8,15,28,49,-21,20
Sydney FC,3436,1,20,5,3,69,27,42,65
N'castle Jet,3436,2,16,5,7,59,38,21,53
Melbourne C,3436,3,14,4,11,44,35,9,46
Melbourne V,3436,4,13,6,10,50,43,7,45
Adelaide Utd,3436,5,11,6,11,37,40,-3,39
Brisbane,3436,6,10,5,13,33,42,-9,35
Western Sydn,3436,7,8,9,10,38,47,-9,33
Perth Glory,3436,8,10,2,15,37,50,-13,32
Wellington P,3436,9,5,6,16,31,55,-24,21
CC Mariners,3436,10,4,8,15,28,49,-21,20
Sydney FC,3437,1,20,5,3,65,23,42,65
N'castle Jet,3437,2,16,5,7,59,38,21,53
Melbourne C,3437,3,14,4,11,44,35,9,46
Melbourne V,3437,4,13,6,10,46,39,7,45
Adelaide Utd,3437,5,11,6,11,37,40,-3,39
Brisbane,3437,6,10,5,13,33,42,-9,35
Western Sydn,3437,7,8,9,10,38,47,-9,33
Perth Glory,3437,8,10,2,15,37,50,-13,32
Wellington P,3437,9,5,6,16,31,55,-24,21
CC Mariners,3437,10,4,8,15,28,49,-21,20
Sydney FC,3438,1,21,4,3,69,23,46,67
N'castle Jet,3438,2,16,5,7,61,39,22,53
Melbourne C,3438,3,14,4,11,45,37,8,46
Melbourne V,3438,4,13,5,11,46,43,3,44
Adelaide Utd,3438,5,11,6,11,37,40,-3,39
Brisbane,3438,6,10,5,13,33,42,-9,35
Western Sydn,3438,7,8,9,10,38,47,-9,33
Perth Glory,3438,8,10,2,15,37,50,-13,32
Wellington P,3438,9,5,6,16,31,55,-24,21
CC Mariners,3438,10,4,8,15,28,49,-21,20
Sydney FC,3439,1,21,4,3,67,22,45,67
N'castle Jet,3439,2,16,5,7,58,37,21,53
Melbourne C,3439,3,14,4,11,43,34,9,46
Melbourne V,3439,4,13,5,11,45,41,4,44
Adelaide Utd,3439,5,11,6,11,37,40,-3,39
Brisbane,3439,6,10,5,13,33,42,-9,35
Western Sydn,3439,7,8,9,10,38,47,-9,33
Perth Glory,3439,8,10,2,15,37,50,-13,32
Wellington P,3439,9,5,6,16,31,55,-24,21
CC Mariners,3439,10,4,8,15,28,49,-21,20
Sydney FC,3440,1,21,4,3,67,24,43,67
N'castle Jet,3440,2,16,5,7,59,38,21,53
Melbourne C,3440,3,14,4,11,44,35,9,46
Melbourne V,3440,4,13,5,11,47,41,6,44
Adelaide Utd,3440,5,11,6,11,37,40,-3,39
Brisbane,3440,6,10,5,13,33,42,-9,35
Western Sydn,3440,7,8,9,10,38,47,-9,33
Perth Glory,3440,8,10,2,15,37,50,-13,32
Wellington P,3440,9,5,6,16,31,55,-24,21
CC Mariners,3440,10,4,8,15,28,49,-21,20
Sydney FC,3441,1,20,5,3,66,24,42,65
N'castle Jet,3441,2,16,5,7,61,39,22,53
Melbourne C,3441,3,14,4,11,45,37,8,46
Melbourne V,3441,4,13,6,10,47,40,7,45
Adelaide Utd,3441,5,11,6,11,37,40,-3,39
Brisbane,3441,6,10,5,13,33,42,-9,35
Western Sydn,3441,7,8,9,10,38,47,-9,33
Perth Glory,3441,8,10,2,15,37,50,-13,32
Wellington P,3441,9,5,6,16,31,55,-24,21
CC Mariners,3441,10,4,8,15,28,49,-21,20
Sydney FC,3442,1,21,4,3,66,23,43,67
N'castle Jet,3442,2,15,5,8,58,39,19,50
Melbourne C,3442,3,15,4,10,45,34,11,49
Melbourne V,3442,4,13,5,11,46,40,6,44
Adelaide Utd,3442,5,11,6,11,37,40,-3,39
Brisbane,3442,6,10,5,13,33,42,-9,35
Western Sydn,3442,7,8,9,10,38,47,-9,33
Perth Glory,3442,8,10,2,15,37,50,-13,32
Wellington P,3442,9,5,6,16,31,55,-24,21
CC Mariners,3442,10,4,8,15,28,49,-21,20
Sydney FC,3443,1,20,4,4,66,25,41,64
N'castle Jet,3443,2,15,5,8,57,38,19,50
Melbourne C,3443,3,15,4,10,44,33,11,49
Melbourne V,3443,4,14,5,10,48,40,8,47
Adelaide Utd,3443,5,11,6,11,37,40,-3,39
Brisbane,3443,6,10,5,13,33,42,-9,35
Western Sydn,3443,7,8,9,10,38,47,-9,33
Perth Glory,3443,8,10,2,15,37,50,-13,32
Wellington P,3443,9,5,6,16,31,55,-24,21
CC Mariners,3443,10,4,8,15,28,49,-21,20
Sydney FC,3444,1,21,4,3,68,22,46,67
N'castle Jet,3444,2,15,5,8,57,39,18,50
Melbourne C,3444,3,15,4,10,45,33,12,49
Melbourne V,3444,4,13,5,11,45,42,3,44
Adelaide Utd,3444,5,11,6,11,37,40,-3,39
Brisbane,3444,6,10,5,13,33,42,-9,35
Western Sydn,3444,7,8,9,10,38,47,-9,33
Perth Glory,3444,8,10,2,15,37,50,-13,32
Wellington P,3444,9,5,6,16,31,55,-24,21
CC Mariners,3444,10,4,8,15,28,49,-21,20
Sydney FC,3445,1,20,4,4,65,24,41,64
N'castle Jet,3445,2,15,6,7,58,38,20,51
Melbourne C,3445,3,14,5,10,44,34,10,47
Melbourne V,3445,4,14,5,10,47,39,8,47
Adelaide Utd,3445,5,11,6,11,37,40,-3,39
Brisbane,3445,6,10,5,13,33,42,-9,35
Western Sydn,3445,7,8,9,10,38,47,-9,33
Perth Glory,3445,8,10,2,15,37,50,-13,32
Wellington P,3445,9,5,6,16,31,55,-24,21
CC Mariners,3445,10,4,8,15,28,49,-21,20
Sydney FC,3446,1,21,4,3,69,23,46,67
N'castle Jet,3446,2,16,5,7,62,38,24,53
Melbourne C,3446,3,14,4,11,44,38,6,46
Melbourne V,3446,4,13,5,11,46,43,3,44
Adelaide Utd,3446,5,11,6,11,37,40,-3,39
Brisbane,3446,6,10,5,13,33,42,-9,35
Western Sydn,3446,7,8,9,10,38,47,-9,33
Perth Glory,3446,8,10,2,15,37,50,-13,32
Wellington P,3446,9,5,6,16,31,55,-24,21
CC Mariners,3446,10,4,8,15,28,49,-21,20
Sydney FC,3447,1,21,4,3,66,23,43,67
N'castle Jet,3447,2,16,5,7,59,38,21,53
Melbourne C,3447,3,14,4,11,44,35,9,46
Melbourne V,3447,4,13,5,11,46,40,6,44
Adelaide Utd,3447,5,11,6,11,37,40,-3,39
Brisbane,3447,6,10,5,13,33,42,-9,35
Western Sydn,3447,7,8,9,10,38,47,-9,33
Perth Glory,3447,8,10,2,15,37,50,-13,32
Wellington P,3447,9,5,6,16,31,55,-24,21
CC Mariners,3447,10,4,8,15,28,49,-21,20
Sydney FC,3448,1,20,5,3,65,23,42,65
N'castle Jet,3448,2,16,5,7,60,38,22,53
Melbourne C,3448,3,14,4,11,44,36,8,46
Melbourne V,3448,4,13,6,10,46,39,7,45
Adelaide Utd,3448,5,11,6,11,37,40,-3,39
Brisbane,3448,6,10,5,13,33,42,-9,35
Western Sydn,3448,7,8,9,10,38,47,-9,33
Perth Glory,3448,8,10,2,15,37,50,-13,32
Wellington P,3448,9,5,6,16,31,55,-24,21
CC Mariners,3448,10,4,8,15,28,49,-21,20
Sydney FC,3449,1,20,4,4,66,25,41,64
N'castle Jet,3449,2,15,6,7,58,38,20,51
Melbourne C,3449,3,14,5,10,44,34,10,47
Melbourne V,3449,4,14,5,10,48,40,8,47
Adelaide Utd,3449,5,11,6,11,37,40,-3,39
Brisbane,3449,6,10,5,13,33,42,-9,35
Western Sydn,3449,7,8,9,10,38,47,-9,33
Perth Glory,3449,8,10,2,15,37,50,-13,32
Wellington P,3449,9,5,6,16,31,55,-24,21
CC Mariners,3449,10,4,8,15,28,49,-21,20
Sydney FC,3450,1,20,5,3,65,23,42,65
N'castle Jet,3450,2,15,5,8,57,38,19,50
Melbourne C,3450,3,15,4,10,44,33,11,49
Melbourne V,3450,4,13,6,10,46,39,7,45
Adelaide Utd,3450,5,11,6,11,37,40,-3,39
Brisbane,3450,6,10,5,13,33,42,-9,35
Western Sydn,3450,7,8,9,10,38,47,-9,33
Perth Glory,3450,8,10,2,15,37,50,-13,32
Wellington P,3450,9,5,6,16,31,55,-24,21
CC Mariners,3450,10,4,8,15,28,49,-21,20
Sydney FC,3451,1,21,4,3,66,23,43,67
N'castle Jet,3451,2,15,5,8,57,38,19,50
Melbourne C,3451,3,15,4,10,44,33,11,49
Melbourne V,3451,4,13,5,11,46,40,6,44
Adelaide Utd,3451,5,11,6,11,37,40,-3,39
Brisbane,3451,6,10,5,13,33,42,-9,35
Western Sydn,3451,7,8,9,10,38,47,-9,33
Perth Glory,3451,8,10,2,15,37,50,-13,32
Wellington P,3451,9,5,6,16,31,55,-24,21
CC Mariners,3451,10,4,8,15,28,49,-21,20
Sydney FC,3452,1,20,4,4,64,23,41,64
N'castle Jet,3452,2,16,5,7,58,37,21,53
Melbourne V,3452,3,14,5,10,46,38,8,47
Melbourne C,3452,4,14,4,11,43,34,9,46
Adelaide Utd,3452,5,11,6,11,37,40,-3,39
Brisbane,3452,6,10,5,13,33,42,-9,35
Western Sydn,3452,7,8,9,10,38,47,-9,33
Perth Glory,3452,8,10,2,15,37,50,-13,32
Wellington P,3452,9,5,6,16,31,55,-24,21
CC Mariners,3452,10,4,8,15,28,49,-21,20
Sydney FC,3453,1,21,4,3,66,22,44,67
N'castle Jet,3453,2,15,6,7,59,39,20,51
Melbourne C,3453,3,14,5,10,45,35,10,47
Melbourne V,3453,4,13,5,11,45,40,5,44
Adelaide Utd,3453,5,11,6,11,37,40,-3,39
Brisbane,3453,6,10,5,13,33,42,-9,35
Western Sydn,3453,7,8,9,10,38,47,-9,33
Perth Glory,3453,8,10,2,15,37,50,-13,32
Wellington P,3453,9,5,6,16,31,55,-24,21
CC Mariners,3453,10,4,8,15,28,49,-21,20
Sydney FC,3454,1,20,5,3,65,23,42,65
N'castle Jet,3454,2,16,5,7,62,38,24,53
Melbourne C,3454,3,14,4,11,44,38,6,46
Melbourne V,3454,4,13,6,10,46,39,7,45
Adelaide Utd,3454,5,11,6,11,37,40,-3,39
Brisbane,3454,6,10,5,13,33,42,-9,35
Western Sydn,3454,7,8,9,10,38,47,-9,33
Perth Glory,3454,8,10,2,15,37,50,-13,32
Wellington P,3454,9,5,6,16,31,55,-24,21
CC Mariners,3454,10,4,8,15,28,49,-21,20
Sydney FC,3455,1,21,4,3,68,23,45,67
N'castle Jet,3455,2,16,5,7,58,37,21,53
Melbourne C,3455,3,14,4,11,43,34,9,46
Melbourne V,3455,4,13,5,11,46,42,4,44
Adelaide Utd,3455,5,11,6,11,37,40,-3,39
Brisbane,3455,6,10,5,13,33,42,-9,35
Western Sydn,3455,7,8,9,10,38,47,-9,33
Perth Glory,3455,8,10,2,15,37,50,-13,32
Wellington P,3455,9,5,6,16,31,55,-24,21
CC Mariners,3455,10,4,8,15,28,49,-21,20
Sydney FC,3456,1,21,4,3,67,22,45,67
N'castle Jet,3456,2,16,5,7,59,37,22,53
Melbourne C,3456,3,14,4,11,43,35,8,46
Melbourne V,3456,4,13,5,11,45,41,4,44
Adelaide Utd,3456,5,11,6,11,37,40,-3,39
Brisbane,3456,6,10,5,13,33,42,-9,35
Western Sydn,3456,7,8,9,10,38,47,-9,33
Perth Glory,3456,8,10,2,15,37,50,-13,32
Wellington P,3456,9,5,6,16,31,55,-24,21
CC Mariners,3456,10,4,8,15,28,49,-21,20
Sydney FC,3457,1,20,5,3,64,22,42,65
N'castle Jet,3457,2,15,5,8,57,38,19,50
Melbourne C,3457,3,15,4,10,44,33,11,49
Melbourne V,3457,4,13,6,10,45,38,7,45
Adelaide Utd,3457,5,11,6,11,37,40,-3,39
Brisbane,3457,6,10,5,13,33,42,-9,35
Western Sydn,3457,7,8,9,10,38,47,-9,33
Perth Glory,3457,8,10,2,15,37,50,-13,32
Wellington P,3457,9,5,6,16,31,55,-24,21
CC Mariners,3457,10,4,8,15,28,49,-21,20
Sydney FC,3458,1,20,5,3,65,23,42,65
N'castle Jet,3458,2,16,5,7,59,37,22,53
Melbourne C,3458,3,14,4,11,43,35,8,46
Melbourne V,3458,4,13,6,10,46,39,7,45
Adelaide Utd,3458,5,11,6,11,37,40,-3,39
Brisbane,3458,6,10,5,13,33,42,-9,35
Western Sydn,3458,7,8,9,10,38,47,-9,33
Perth Glory,3458,8,10,2,15,37,50,-13,32
Wellington P,3458,9,5,6,16,31,55,-24,21
CC Mariners,3458,10,4,8,15,28,49,-21,20
Sydney FC,3459,1,20,5,3,65,23,42,65
N'castle Jet,3459,2,15,5,8,60,41,19,50
Melbourne C,3459,3,15,4,10,47,36,11,49
Melbourne V,3459,4,13,6,10,46,39,7,45
Adelaide Utd,3459,5,11,6,11,37,40,-3,39
Brisbane,3459,6,10,5,13,33,42,-9,35
Western Sydn,3459,7,8,9,10,38,47,-9,33
Perth Glory,3459,8,10,2,15,37,50,-13,32
Wellington P,3459,9,5,6,16,31,55,-24,21
CC Mariners,3459,10,4,8,15,28,49,-21,20
Sydney FC,3460,1,21,4,3,67,22,45,67
N'castle Jet,3460,2,15,6,7,57,37,20,51
Melbourne C,3460,3,14,5,10,43,33,10,47
Melbourne V,3460,4,13,5,11,45,41,4,44
Adelaide Utd,3460,5,11,6,11,37,40,-3,39
Brisbane,3460,6,10,5,13,33,42,-9,35
Western Sydn,3460,7,8,9,10,38,47,-9,33
Perth Glory,3460,8,10,2,15,37,50,-13,32
Wellington P,3460,9,5,6,16,31,55,-24,21
CC Mariners,3460,10,4,8,15,28,49,-21,20
Sydney FC,3461,1,20,5,3,65,23,42,65
N'castle Jet,3461,2,15,6,7,58,38,20,51
Melbourne C,3461,3,14,5,10,44,34,10,47
Melbourne V,3461,4,13,6,10,46,39,7,45
Adelaide Utd,3461,5,11,6,11,37,40,-3,39
Brisbane,3461,6,10,5,13,33,42,-9,35
Western Sydn,3461,7,8,9,10,38,47,-9,33
Perth Glory,3461,8,10,2,15,37,50,-13,32
Wellington P,3461,9,5,6,16,31,55,-24,21
CC Mariners,3461,10,4,8,15,28,49,-21,20
Sydney FC,3462,1,21,4,3,70,23,47,67
N'castle Jet,3462,2,15,6,7,59,39,20,51
Melbourne C,3462,3,14,5,10,45,35,10,47
Melbourne V,3462,4,13,5,11,46,44,2,44
Adelaide Utd,3462,5,11,6,11,37,40,-3,39
Brisbane,3462,6,10,5,13,33,42,-9,35
Western Sydn,3462,7,8,9,10,38,47,-9,33
Perth Glory,3462,8,10,2,15,37,50,-13,32
Wellington P,3462,9,5,6,16,31,55,-24,21
CC Mariners,3462,10,4,8,15,28,49,-21,20
Sydney FC,3463,1,21,4,3,66,23,43,67
N'castle Jet,3463,2,16,5,7,59,38,21,53
Melbourne C,3463,3,14,4,11,44,35,9,46
Melbourne V,3463,4,13,5,11,46,40,6,44
Adelaide Utd,3463,5,11,6,11,37,40,-3,39
Brisbane,3463,6,10,5,13,33,42,-9,35
Western Sydn,3463,7,8,9,10,38,47,-9,33
Perth Glory,3463,8,10,2,15,37,50,-13,32
Wellington P,3463,9,5,6,16,31,55,-24,21
CC Mariners,3463,10,4,8,15,28,49,-21,20
Sydney FC,3464,1,20,4,4,64,23,41,64
N'castle Jet,3464,2,15,5,8,58,41,17,50
Melbourne C,3464,3,15,4,10,47,34,13,49
Melbourne V,3464,4,14,5,10,46,38,8,47
Adelaide Utd,3464,5,11,6,11,37,40,-3,39
Brisbane,3464,6,10,5,13,33,42,-9,35
Western Sydn,3464,7,8,9,10,38,47,-9,33
Perth Glory,3464,8,10,2,15,37,50,-13,32
Wellington P,3464,9,5,6,16,31,55,-24,21
CC Mariners,3464,10,4,8,15,28,49,-21,20
Sydney FC,3465,1,21,4,3,67,24,43,67
N'castle Jet,3465,2,16,5,7,59,38,21,53
Melbourne C,3465,3,14,4,11,44,35,9,46
Melbourne V,3465,4,13,5,11,47,41,6,44
Adelaide Utd,3465,5,11,6,11,37,40,-3,39
Brisbane,3465,6,10,5,13,33,42,-9,35
Western Sydn,3465,7,8,9,10,38,47,-9,33
Perth Glory,3465,8,10,2,15,37,50,-13,32
Wellington P,3465,9,5,6,16,31,55,-24,21
CC Mariners,3465,10,4,8,15,28,49,-21,20
Sydney FC,3466,1,21,4,3,70,23,47,67
N'castle Jet,3466,2,16,5,7,60,37,23,53
Melbourne C,3466,3,14,4,11,43,36,7,46
Melbourne V,3466,4,13,5,11,46,44,2,44
Adelaide Utd,3466,5,11,6,11,37,40,-3,39
Brisbane,3466,6,10,5,13,33,42,-9,35
Western Sydn,3466,7,8,9,10,38,47,-9,33
Perth Glory,3466,8,10,2,15,37,50,-13,32
Wellington P,3466,9,5,6,16,31,55,-24,21
CC Mariners,3466,10,4,8,15,28,49,-21,20
Sydney FC,3467,1,20,5,3,65,23,42,65
N'castle Jet,3467,2,16,5,7,60,38,22,53
Melbourne C,3467,3,14,4,11,44,36,8,46
Melbourne V,3467,4,13,6,10,46,39,7,45
Adelaide Utd,3467,5,11,6,11,37,40,-3,39
Brisbane,3467,6,10,5,13,33,42,-9,35
Western Sydn,3467,7,8,9,10,38,47,-9,33
Perth Glory,3467,8,10,2,15,37,50,-13,32
Wellington P,3467,9,5,6,16,31,55,-24,21
CC Mariners,3467,10,4,8,15,28,49,-21,20
Sydney FC,3468,1,20,5,3,65,23,42,65
N'castle Jet,3468,2,15,5,8,59,40,19,50
Melbourne C,3468,3,15,4,10,46,35,11,49
Melbourne V,3468,4,13,6,10,46,39,7,45
Adelaide Utd,3468,5,11,6,11,37,40,-3,39
Brisbane,3468,6,10,5,13,33,42,-9,35
Western Sydn,3468,7,8,9,10,38,47,-9,33
Perth Glory,3468,8,10,2,15,37,50,-13,32
Wellington P,3468,9,5,6,16,31,55,-24,21
CC Mariners,3468,10,4,8,15,28,49,-21,20
Sydney FC,3469,1,21,4,3,65,22,43,67
N'castle Jet,3469,2,16,5,7,59,37,22,53
Melbourne C,3469,3,14,4,11,43,35,8,46
Melbourne V,3469,4,13,5,11,45,39,6,44
Adelaide Utd,3469,5,11,6,11,37,40,-3,39
Brisbane,3469,6,10,5,13,33,42,-9,35
Western Sydn,3469,7,8,9,10,38,47,-9,33
Perth Glory,3469,8,10,2,15,37,50,-13,32
Wellington P,3469,9,5,6,16,31,55,-24,21
CC Mariners,3469,10,4,8,15,28,49,-21,20
Sydney FC,3470,1,21,4,3,66,22,44,67
N'castle Jet,3470,2,16,5,7,60,38,22,53
Melbourne C,3470,3,14,4,11,44,36,8,46
Melbourne V,3470,4,13,5,11,45,40,5,44
Adelaide Utd,3470,5,11,6,11,37,40,-3,39
Brisbane,3470,6,10,5,13,33,42,-9,35
Western Sydn,3470,7,8,9,10,38,47,-9,33
Perth Glory,3470,8,10,2,15,37,50,-13,32
Wellington P,3470,9,5,6,16,31,55,-24,21
CC Mariners,3470,10,4,8,15,28,49,-21,20
Sydney FC,3471,1,20,5,3,64,22,42,65
N'castle Jet,3471,2,16,5,7,58,37,21,53
Melbourne C,3471,3,14,4,11,43,34,9,46
Melbourne V,3471,4,13,6,10,45,38,7,45
Adelaide Utd,3471,5,11,6,11,37,40,-3,39
Brisbane,3471,6,10,5,13,33,42,-9,35
Western Sydn,3471,7,8,9,10,38,47,-9,33
Perth Glory,3471,8,10,2,15,37,50,-13,32
Wellington P,3471,9,5,6,16,31,55,-24,21
CC Mariners,3471,10,4,8,15,28,49,-21,20
Sydney FC,3472,1,21,4,3,68,24,44,67
N'castle Jet,3472,2,15,5,8,57,38,19,50
Melbourne C,3472,3,15,4,10,44,33,11,49
Melbourne V,3472,4,13,5,11,47,42,5,44
Adelaide Utd,3472,5,11,6,11,37,40,-3,39
Brisbane,3472,6,10,5,13,33,42,-9,35
Western Sydn,3472,7,8,9,10,38,47,-9,33
Perth Glory,3472,8,10,2,15,37,50,-13,32
Wellington P,3472,9,5,6,16,31,55,-24,21
CC Mariners,3472,10,4,8,15,28,49,-21,20
Sydney FC,3473,1,21,4,3,66,22,44,67
N'castle Jet,3473,2,15,6,7,57,37,20,51
Melbourne C,3473,3,14,5,10,43,33,10,47
Melbourne V,3473,4,13,5,11,45,40,5,44
Adelaide Utd,3473,5,11,6,11,37,40,-3,39
Brisbane,3473,6,10,5,13,33,42,-9,35
Western Sydn,3473,7,8,9,10,38,47,-9,33
Perth Glory,3473,8,10,2,15,37,50,-13,32
Wellington P,3473,9,5,6,16,31,55,-24,21
CC Mariners,3473,10,4,8,15,28,49,-21,20
Sydney FC,3474,1,21,4,3,71,23,48,67
N'castle Jet,3474,2,15,5,8,57,38,19,50
Melbourne C,3474,3,15,4,10,44,33,11,49
Melbourne V,3474,4,13,5,11,46,45,1,44
Adelaide Utd,3474,5,11,6,11,37,40,-3,39
Brisbane,3474,6,10,5,13,33,42,-9,35
Western Sydn,3474,7,8,9,10,38,47,-9,33
Perth Glory,3474,8,10,2,15,37,50,-13,32
Wellington P,3474,9,5,6,16,31,55,-24,21
CC Mariners,3474,10,4,8,15,28,49,-21,20
Sydney FC,3475,1,21,4,3,68,24,44,67
N'castle Jet,3475,2,16,5,7,60,37,23,53
Melbourne C,3475,3,14,4,11,43,36,7,46
Melbourne V,3475,4,13,5,11,47,42,5,44
Adelaide Utd,3475,5,11,6,11,37,40,-3,39
Brisbane,3475,6,10,5,13,33,42,-9,35
Western Sydn,3475,7,8,9,10,38,47,-9,33
Perth Glory,3475,8,10,2,15,37,50,-13,32
Wellington P,3475,9,5,6,16,31,55,-24,21
CC Mariners,3475,10,4,8,15,28,49,-21,20
Sydney FC,3476,1,21,4,3,67,22,45,67
N'castle Jet,3476,2,16,5,7,59,38,21,53
Melbourne C,3476,3,14,4,11,44,35,9,46
Melbourne V,3476,4,13,5,11,45,41,4,44
Adelaide Utd,3476,5,11,6,11,37,40,-3,39
Brisbane,3476,6,10,5,13,33,42,-9,35
Western Sydn,3476,7,8,9,10,38,47,-9,33
Perth Glory,3476,8,10,2,15,37,50,-13,32
Wellington P,3476,9,5,6,16,31,55,-24,21
CC Mariners,3476,10,4,8,15,28,49,-21,20
Sydney FC,3477,1,20,4,4,66,25,41,64
N'castle Jet,3477,2,16,5,7,59,38,21,53
Melbourne V,3477,3,14,5,10,48,40,8,47
Melbourne C,3477,4,14,4,11,44,35,9,46
Adelaide Utd,3477,5,11,6,11,37,40,-3,39
Brisbane,3477,6,10,5,13,33,42,-9,35
Western Sydn,3477,7,8,9,10,38,47,-9,33
Perth Glory,3477,8,10,2,15,37,50,-13,32
Wellington P,3477,9,5,6,16,31,55,-24,21
CC Mariners,3477,10,4,8,15,28,49,-21,20
Sydney FC,3478,1,20,5,3,66,24,42,65
N'castle Jet,3478,2,16,5,7,60,38,22,53
Melbourne C,3478,3,14,4,11,44,36,8,46
Melbourne V,3478,4,13,6,10,47,40,7,45
Adelaide Utd,3478,5,11,6,11,37,40,-3,39
Brisbane,3478,6,10,5,13,33,42,-9,35
Western Sydn,3478,7,8,9,10,38,47,-9,33
Perth Glory,3478,8,10,2,15,37,50,-13,32
Wellington P,3478,9,5,6,16,31,55,-24,21
CC Mariners,3478,10,4,8,15,28,49,-21,20
Sydney FC,3479,1,21,4,3,66,23,43,67
N'castle Jet,3479,2,15,6,7,59,39,20,51
Melbourne C,3479,3,14,5,10,45,35,10,47
Melbourne V,3479,4,13,5,11,46,40,6,44
Adelaide Utd,3479,5,11,6,11,37,40,-3,39
Brisbane,3479,6,10,5,13,33,42,-9,35
Western Sydn,3479,7,8,9,10,38,47,-9,33
Perth Glory,3479,8,10,2,15,37,50,-13,32
Wellington P,3479,9,5,6,16,31,55,-24,21
CC Mariners,3479,10,4,8,15,28,49,-21,20
Sydney FC,3480,1,21,4,3,67,23,44,67
N'castle Jet,3480,2,15,5,8,58,41,17,50
Melbourne C,3480,3,15,4,10,47,34,13,49
Melbourne V,3480,4,13,5,11,46,41,5,44
Adelaide Utd,3480,5,11,6,11,37,40,-3,39
Brisbane,3480,6,10,5,13,33,42,-9,35
Western Sydn,3480,7,8,9,10,38,47,-9,33
Perth Glory,3480,8,10,2,15,37,50,-13,32
Wellington P,3480,9,5,6,16,31,55,-24,21
CC Mariners,3480,10,4,8,15,28,49,-21,20
Sydney FC,3481,1,21,4,3,66,22,44,67
N'castle Jet,3481,2,15,6,7,57,37,20,51
Melbourne C,3481,3,14,5,10,43,33,10,47
Melbourne V,3481,4,13,5,11,45,40,5,44
Adelaide Utd,3481,5,11,6,11,37,40,-3,39
Brisbane,3481,6,10,5,13,33,42,-9,35
Western Sydn,3481,7,8,9,10,38,47,-9,33
Perth Glory,3481,8,10,2,15,37,50,-13,32
Wellington P,3481,9,5,6,16,31,55,-24,21
CC Mariners,3481,10,4,8,15,28,49,-21,20
Sydney FC,3482,1,21,4,3,67,22,45,67
N'castle Jet,3482,2,16,5,7,60,39,21,53
Melbourne C,3482,3,14,4,11,45,36,9,46
Melbourne V,3482,4,13,5,11,45,41,4,44
Adelaide Utd,3482,5,11,6,11,37,40,-3,39
Brisbane,3482,6,10,5,13,33,42,-9,35
Western Sydn,3482,7,8,9,10,38,47,-9,33
Perth Glory,3482,8,10,2,15,37,50,-13,32
Wellington P,3482,9,5,6,16,31,55,-24,21
CC Mariners,3482,10,4,8,15,28,49,-21,20
Sydney FC,3483,1,21,4,3,65,22,43,67
N'castle Jet,3483,2,16,5,7,60,38,22,53
Melbourne C,3483,3,14,4,11,44,36,8,46
Melbourne V,3483,4,13,5,11,45,39,6,44
Adelaide Utd,3483,5,11,6,11,37,40,-3,39
Brisbane,3483,6,10,5,13,33,42,-9,35
Western Sydn,3483,7,8,9,10,38,47,-9,33
Perth Glory,3483,8,10,2,15,37,50,-13,32
Wellington P,3483,9,5,6,16,31,55,-24,21
CC Mariners,3483,10,4,8,15,28,49,-21,20
Sydney FC,3484,1,21,4,3,65,22,43,67
N'castle Jet,3484,2,15,6,7,57,37,20,51
Melbourne C,3484,3,14,5,10,43,33,10,47
Melbourne V,3484,4,13,5,11,45,39,6,44
Adelaide Utd,3484,5,11,6,11,37,40,-3,39
Brisbane,3484,6,10,5,13,33,42,-9,35
Western Sydn,3484,7,8,9,10,38,47,-9,33
Perth Glory,3484,8,10,2,15,37,50,-13,32
Wellington P,3484,9,5,6,16,31,55,-24,21
CC Mariners,3484,10,4,8,15,28,49,-21,20
Sydney FC,3485,1,20,5,3,66,24,42,65
N'castle Jet,3485,2,15,6,7,58,38,20,51
Melbourne C,3485,3,14,5,10,44,34,10,47
Melbourne V,3485,4,13,6,10,47,40,7,45
Adelaide Utd,3485,5,11,6,11,37,40,-3,39
Brisbane,3485,6,10,5,13,33,42,-9,35
Western Sydn,3485,7,8,9,10,38,47,-9,33
Perth Glory,3485,8,10,2,15,37,50,-13,32
Wellington P,3485,9,5,6,16,31,55,-24,21
CC Mariners,3485,10,4,8,15,28,49,-21,20
Sydney FC,3486,1,20,5,3,66,24,42,65
N'castle Jet,3486,2,15,5,8,59,40,19,50
Melbourne C,3486,3,15,4,10,46,35,11,49
Melbourne V,3486,4,13,6,10,47,40,7,45
Adelaide Utd,3486,5,11,6,11,37,40,-3,39
Brisbane,3486,6,10,5,13,33,42,-9,35
Western Sydn,3486,7,8,9,10,38,47,-9,33
Perth Glory,3486,8,10,2,15,37,50,-13,32
Wellington P,3486,9,5,6,16,31,55,-24,21
CC Mariners,3486,10,4,8,15,28,49,-21,20
Sydney FC,3487,1,20,5,3,67,25,42,65
N'castle Jet,3487,2,15,6,7,57,37,20,51
Melbourne C,3487,3,14,5,10,43,33,10,47
Melbourne V,3487,4,13,6,10,48,41,7,45
Adelaide Utd,3487,5,11,6,11,37,40,-3,39
Brisbane,3487,6,10,5,13,33,42,-9,35
Western Sydn,3487,7,8,9,10,38,47,-9,33
Perth Glory,3487,8,10,2,15,37,50,-13,32
Wellington P,3487,9,5,6,16,31,55,-24,21
CC Mariners,3487,10,4,8,15,28,49,-21,20
Sydney FC,3488,1,20,5,3,65,23,42,65
N'castle Jet,3488,2,16,5,7,59,38,21,53
Melbourne C,3488,3,14,4,11,44,35,9,46
Melbourne V,3488,4,13,6,10,46,39,7,45
Adelaide Utd,3488,5,11,6,11,37,40,-3,39
Brisbane,3488,6,10,5,13,33,42,-9,35
Western Sydn,3488,7,8,9,10,38,47,-9,33
Perth Glory,3488,8,10,2,15,37,50,-13,32
Wellington P,3488,9,5,6,16,31,55,-24,21
CC Mariners,3488,10,4,8,15,28,49,-21,20
Sydney FC,3489,1,21,4,3,66,22,44,67
N'castle Jet,3489,2,15,6,7,58,38,20,51
Melbourne C,3489,3,14,5,10,44,34,10,47
Melbourne V,3489,4,13,5,11,45,40,5,44
Adelaide Utd,3489,5,11,6,11,37,40,-3,39
Brisbane,3489,6,10,5,13,33,42,-9,35
Western Sydn,3489,7,8,9,10,38,47,-9,33
Perth Glory,3489,8,10,2,15,37,50,-13,32
Wellington P,3489,9,5,6,16,31,55,-24,21
CC Mariners,3489,10,4,8,15,28,49,-21,20
Sydney FC,3490,1,20,5,3,64,22,42,65
N'castle Jet,3490,2,16,5,7,60,38,22,53
Melbourne C,3490,3,14,4,11,44,36,8,46
Melbourne V,3490,4,13,6,10,45,38,7,45
Adelaide Utd,3490,5,11,6,11,37,40,-3,39
Brisbane,3490,6,10,5,13,33,42,-9,35
Western Sydn,3490,7,8,9,10,38,47,-9,33
Perth Glory,3490,8,10,2,15,37,50,-13,32
Wellington P,3490,9,5,6,16,31,55,-24,21
CC Mariners,3490,10,4,8,15,28,49,-21,20
Sydney FC,3491,1,21,4,3,67,24,43,67
N'castle Jet,3491,2,15,5,8,58,40,18,50
Melbourne C,3491,3,15,4,10,46,34,12,49
Melbourne V,3491,4,13,5,11,47,41,6,44
Adelaide Utd,3491,5,11,6,11,37,40,-3,39
Brisbane,3491,6,10,5,13,33,42,-9,35
Western Sydn,3491,7,8,9,10,38,47,-9,33
Perth Glory,3491,8,10,2,15,37,50,-13,32
Wellington P,3491,9,5,6,16,31,55,-24,21
CC Mariners,3491,10,4,8,15,28,49,-21,20
Sydney FC,3492,1,21,4,3,65,22,43,67
N'castle Jet,3492,2,15,5,8,58,39,19,50
Melbourne C,3492,3,15,4,10,45,34,11,49
Melbourne V,3492,4,13,5,11,45,39,6,44
Adelaide Utd,3492,5,11,6,11,37,40,-3,39
Brisbane,3492,6,10,5,13,33,42,-9,35
Western Sydn,3492,7,8,9,10,38,47,-9,33
Perth Glory,3492,8,10,2,15,37,50,-13,32
Wellington P,3492,9,5,6,16,31,55,-24,21
CC Mariners,3492,10,4,8,15,28,49,-21,20
Sydney FC,3493,1,20,5,3,65,23,42,65
N'castle Jet,3493,2,15,6,7,58,38,20,51
Melbourne C,3493,3,14,5,10,44,34,10,47
Melbourne V,3493,4,13,6,10,46,39,7,45
Adelaide Utd,3493,5,11,6,11,37,40,-3,39
Brisbane,3493,6,10,5,13,33,42,-9,35
Western Sydn,3493,7,8,9,10,38,47,-9,33
Perth Glory,3493,8,10,2,15,37,50,-13,32
Wellington P,3493,9,5,6,16,31,55,-24,21
CC Mariners,3493,10,4,8,15,28,49,-21,20
Sydney FC,3494,1,20,4,4,66,25,41,64
N'castle Jet,3494,2,15,6,7,59,39,20,51
Melbourne C,3494,3,14,5,10,45,35,10,47
Melbourne V,3494,4,14,5,10,48,40,8,47
Adelaide Utd,3494,5,11,6,11,37,40,-3,39
Brisbane,3494,6,10,5,13,33,42,-9,35
Western Sydn,3494,7,8,9,10,38,47,-9,33
Perth Glory,3494,8,10,2,15,37,50,-13,32
Wellington P,3494,9,5,6,16,31,55,-24,21
CC Mariners,3494,10,4,8,15,28,49,-21,20
Sydney FC,3495,1,20,4,4,66,25,41,64
N'castle Jet,3495,2,16,5,7,59,38,21,53
Melbourne V,3495,3,14,5,10,48,40,8,47
Melbourne C,3495,4,14,4,11,44,35,9,46
Adelaide Utd,3495,5,11,6,11,37,40,-3,39
Brisbane,3495,6,10,5,13,33,42,-9,35
Western Sydn,3495,7,8,9,10,38,47,-9,33
Perth Glory,3495,8,10,2,15,37,50,-13,32
Wellington P,3495,9,5,6,16,31,55,-24,21
CC Mariners,3495,10,4,8,15,28,49,-21,20
Sydney FC,3496,1,20,4,4,64,23,41,64
N'castle Jet,3496,2,15,5,8,58,40,18,50
Melbourne C,3496,3,15,4,10,46,34,12,49
Melbourne V,3496,4,14,5,10,46,38,8,47
Adelaide Utd,3496,5,11,6,11,37,40,-3,39
Brisbane,3496,6,10,5,13,33,42,-9,35
Western Sydn,3496,7,8,9,10,38,47,-9,33
Perth Glory,3496,8,10,2,15,37,50,-13,32
Wellington P,3496,9,5,6,16,31,55,-24,21
CC Mariners,3496,10,4,8,15,28,49,-21,20
Sydney FC,3497,1,21,4,3,66,23,43,67
N'castle Jet,3497,2,15,6,7,58,38,20,51
Melbourne C,3497,3,14,5,10,44,34,10,47
Melbourne V,3497,4,13,5,11,46,40,6,44
Adelaide Utd,3497,5,11,6,11,37,40,-3,39
Brisbane,3497,6,10,5,13,33,42,-9,35
Western Sydn,3497,7,8,9,10,38,47,-9,33
Perth Glory,3497,8,10,2,15,37,50,-13,32
Wellington P,3497,9,5,6,16,31,55,-24,21
CC Mariners,3497,10,4,8,15,28,49,-21,20
Sydney FC,3498,1,21,4,3,67,23,44,67
N'castle Jet,3498,2,16,5,7,59,38,21,53
Melbourne C,3498,3,14,4,11,44,35,9,46
Melbourne V,3498,4,13,5,11,46,41,5,44
Adelaide Utd,3498,5,11,6,11,37,40,-3,39
Brisbane,3498,6,10,5,13,33,42,-9,35
Western Sydn,3498,7,8,9,10,38,47,-9,33
Perth Glory,3498,8,10,2,15,37,50,-13,32
Wellington P,3498,9,5,6,16,31,55,-24,21
CC Mariners,3498,10,4,8,15,28,49,-21,20
Sydney FC,3499,1,21,4,3,69,23,46,67
N'castle Jet,3499,2,16,5,7,59,38,21,53
Melbourne C,3499,3,14,4,11,44,35,9,46
Melbourne V,3499,4,13,5,11,46,43,3,44
Adelaide Utd,3499,5,11,6,11,37,40,-3,39
Brisbane,3499,6,10,5,13,33,42,-9,35
Western Sydn,3499,7,8,9,10,38,47,-9,33
Perth Glory,3499,8,10,2,15,37,50,-13,32
Wellington P,3499,9,5,6,16,31,55,-24,21
CC Mariners,3499,10,4,8,15,28,49,-21,20
Sydney FC,3500,1,21,4,3,66,22,44,67
N'castle Jet,3500,2,15,5,8,57,38,19,50
Melbourne C,3500,3,15,4,10,44,33,11,49
Melbourne V,3500,4,13,5,11,45,40,5,44
Adelaide Utd,3500,5,11,6,11,37,40,-3,39
Brisbane,3500,6,10,5,13,33,42,-9,35
Western Sydn,3500,7,8,9,10,38,47,-9,33
Perth Glory,3500,8,10,2,15,37,50,-13,32
Wellington P,3500,9,5,6,16,31,55,-24,21
CC Mariners,3500,10,4,8,15,28,49,-21,20
Sydney FC,3501,1,21,4,3,68,25,43,67
N'castle Jet,3501,2,15,6,7,57,37,20,51
Melbourne C,3501,3,14,5,10,43,33,10,47
Melbourne V,3501,4,13,5,11,48,42,6,44
Adelaide Utd,3501,5,11,6,11,37,40,-3,39
Brisbane,3501,6,10,5,13,33,42,-9,35
Western Sydn,3501,7,8,9,10,38,47,-9,33
Perth Glory,3501,8,10,2,15,37,50,-13,32
Wellington P,3501,9,5,6,16,31,55,-24,21
CC Mariners,3501,10,4,8,15,28,49,-21,20
Sydney FC,3502,1,20,5,3,65,23,42,65
N'castle Jet,3502,2,15,6,7,59,39,20,51
Melbourne C,3502,3,14,5,10,45,35,10,47
Melbourne V,3502,4,13,6,10,46,39,7,45
Adelaide Utd,3502,5,11,6,11,37,40,-3,39
Brisbane,3502,6,10,5,13,33,42,-9,35
Western Sydn,3502,7,8,9,10,38,47,-9,33
Perth Glory,3502,8,10,2,15,37,50,-13,32
Wellington P,3502,9,5,6,16,31,55,-24,21
CC Mariners,3502,10,4,8,15,28,49,-21,20
Sydney FC,3503,1,20,5,3,65,23,42,65
N'castle Jet,3503,2,16,5,7,63,38,25,53
Melbourne C,3503,3,14,4,11,44,39,5,46
Melbourne V,3503,4,13,6,10,46,39,7,45
Adelaide Utd,3503,5,11,6,11,37,40,-3,39
Brisbane,3503,6,10,5,13,33,42,-9,35
Western Sydn,3503,7,8,9,10,38,47,-9,33
Perth Glory,3503,8,10,2,15,37,50,-13,32
Wellington P,3503,9,5,6,16,31,55,-24,21
CC Mariners,3503,10,4,8,15,28,49,-21,20
Sydney FC,3504,1,21,4,3,68,25,43,67
N'castle Jet,3504,2,16,5,7,58,37,21,53
Melbourne C,3504,3,14,4,11,43,34,9,46
Melbourne V,3504,4,13,5,11,48,42,6,44
Adelaide Utd,3504,5,11,6,11,37,40,-3,39
Brisbane,3504,6,10,5,13,33,42,-9,35
Western Sydn,3504,7,8,9,10,38,47,-9,33
Perth Glory,3504,8,10,2,15,37,50,-13,32
Wellington P,3504,9,5,6,16,31,55,-24,21
CC Mariners,3504,10,4,8,15,28,49,-21,20
Sydney FC,3505,1,21,4,3,67,23,44,67
N'castle Jet,3505,2,16,5,7,60,38,22,53
Melbourne C,3505,3,14,4,11,44,36,8,46
Melbourne V,3505,4,13,5,11,46,41,5,44
Adelaide Utd,3505,5,11,6,11,37,40,-3,39
Brisbane,3505,6,10,5,13,33,42,-9,35
Western Sydn,3505,7,8,9,10,38,47,-9,33
Perth Glory,3505,8,10,2,15,37,50,-13,32
Wellington P,3505,9,5,6,16,31,55,-24,21
CC Mariners,3505,10,4,8,15,28,49,-21,20
Sydney FC,3506,1,20,4,4,64,23,41,64
N'castle Jet,3506,2,15,6,7,58,38,20,51
Melbourne C,3506,3,14,5,10,44,34,10,47
Melbourne V,3506,4,14,5,10,46,38,8,47
Adelaide Utd,3506,5,11,6,11,37,40,-3,39
Brisbane,3506,6,10,5,13,33,42,-9,35
Western Sydn,3506,7,8,9,10,38,47,-9,33
Perth Glory,3506,8,10,2,15,37,50,-13,32
Wellington P,3506,9,5,6,16,31,55,-24,21
CC Mariners,3506,10,4,8,15,28,49,-21,20
Sydney FC,3507,1,21,4,3,65,22,43,67
N'castle Jet,3507,2,16,5,7,62,39,23,53
Melbourne C,3507,3,14,4,11,45,38,7,46
Melbourne V,3507,4,13,5,11,45,39,6,44
Adelaide Utd,3507,5,11,6,11,37,40,-3,39
Brisbane,3507,6,10,5,13,33,42,-9,35
Western Sydn,3507,7,8,9,10,38,47,-9,33
Perth Glory,3507,8,10,2,15,37,50,-13,32
Wellington P,3507,9,5,6,16,31,55,-24,21
CC Mariners,3507,10,4,8,15,28,49,-21,20
Sydney FC,3508,1,21,4,3,66,22,44,67
N'castle Jet,3508,2,16,5,7,59,38,21,53
Melbourne C,3508,3,14,4,11,44,35,9,46
Melbourne V,3508,4,13,5,11,45,40,5,44
Adelaide Utd,3508,5,11,6,11,37,40,-3,39
Brisbane,3508,6,10,5,13,33,42,-9,35
Western Sydn,3508,7,8,9,10,38,47,-9,33
Perth Glory,3508,8,10,2,15,37,50,-13,32
Wellington P,3508,9,5,6,16,31,55,-24,21
CC Mariners,3508,10,4,8,15,28,49,-21,20
Sydney FC,3509,1,21,4,3,67,24,43,67
N'castle Jet,3509,2,15,6,7,58,38,20,51
Melbourne C,3509,3,14,5,10,44,34,10,47
Melbourne V,3509,4,13,5,11,47,41,6,44
Adelaide Utd,3509,5,11,6,11,37,40,-3,39
Brisbane,3509,6,10,5,13,33,42,-9,35
Western Sydn,3509,7,8,9,10,38,47,-9,33
Perth Glory,3509,8,10,2,15,37,50,-13,32
Wellington P,3509,9,5,6,16,31,55,-24,21
CC Mariners,3509,10,4,8,15,28,49,-21,20
Sydney FC,3510,1,20,5,3,65,23,42,65
N'castle Jet,3510,2,16,5,7,60,39,21,53
Melbourne C,3510,3,14,4,11,45,36,9,46
Melbourne V,3510,4,13,6,10,46,39,7,45
Adelaide Utd,3510,5,11,6,11,37,40,-3,39
Brisbane,3510,6,10,5,13,33,42,-9,35
Western Sydn,3510,7,8,9,10,38,47,-9,33
Perth Glory,3510,8,10,2,15,37,50,-13,32
Wellington P,3510,9,5,6,16,31,55,-24,21
CC Mariners,3510,10,4,8,15,28,49,-21,20
Sydney FC,3511,1,21,4,3,66,23,43,67
N'castle Jet,3511,2,16,5,7,60,38,22,53
Melbourne C,3511,3,14,4,11,44,36,8,46
Melbourne V,3511,4,13,5,11,46,40,6,44
Adelaide Utd,3511,5,11,6,11,37,40,-3,39
Brisbane,3511,6,10,5,13,33,42,-9,35
Western Sydn,3511,7,8,9,10,38,47,-9,33
Perth Glory,3511,8,10,2,15,37,50,-13,32
Wellington P,3511,9,5,6,16,31,55,-24,21
CC Mariners,3511,10,4,8,15,28,49,-21,20
Sydney FC,3512,1,21,4,3,65,22,43,67
N'castle Jet,3512,2,16,5,7,59,38,21,53
Melbourne C,3512,3,14,4,11,44,35,9,46
Melbourne V,3512,4,13,5,11,45,39,6,44
Adelaide Utd,3512,5,11,6,11,37,40,-3,39
Brisbane,3512,6,10,5,13,33,42,-9,35
Western Sydn,3512,7,8,9,10,38,47,-9,33
Perth Glory,3512,8,10,2,15,37,50,-13,32
Wellington P,3512,9,5,6,16,31,55,-24,21
CC Mariners,3512,10,4,8,15,28,49,-21,20
Sydney FC,3513,1,20,4,4,64,23,41,64
N'castle Jet,3513,2,15,6,7,57,37,20,51
Melbourne C,3513,3,14,5,10,43,33,10,47
Melbourne V,3513,4,14,5,10,46,38,8,47
Adelaide Utd,3513,5,11,6,11,37,40,-3,39
Brisbane,3513,6,10,5,13,33,42,-9,35
Western Sydn,3513,7,8,9,10,38,47,-9,33
Perth Glory,3513,8,10,2,15,37,50,-13,32
Wellington P,3513,9,5,6,16,31,55,-24,21
CC Mariners,3513,10,4,8,15,28,49,-21,20
Sydney FC,3514,1,20,5,3,65,23,42,65
N'castle Jet,3514,2,16,5,7,60,39,21,53
Melbourne C,3514,3,14,4,11,45,36,9,46
Melbourne V,3514,4,13,6,10,46,39,7,45
Adelaide Utd,3514,5,11,6,11,37,40,-3,39
Brisbane,3514,6,10,5,13,33,42,-9,35
Western Sydn,3514,7,8,9,10,38,47,-9,33
Perth Glory,3514,8,10,2,15,37,50,-13,32
Wellington P,3514,9,5,6,16,31,55,-24,21
CC Mariners,3514,10,4,8,15,28,49,-21,20
Sydney FC,3515,1,21,4,3,70,23,47,67
N'castle Jet,3515,2,16,5,7,58,37,21,53
Melbourne C,3515,3,14,4,11,43,34,9,46
Melbourne V,3515,4,13,5,11,46,44,2,44
Adelaide Utd,3515,5,11,6,11,37,40,-3,39
Brisbane,3515,6,10,5,13,33,42,-9,35
Western Sydn,3515,7,8,9,10,38,47,-9,33
Perth Glory,3515,8,10,2,15,37,50,-13,32
Wellington P,3515,9,5,6,16,31,55,-24,21
CC Mariners,3515,10,4,8,15,28,49,-21,20
Sydney FC,3516,1,20,4,4,66,25,41,64
N'castle Jet,3516,2,15,6,7,58,38,20,51
Melbourne C,3516,3,14,5,10,44,34,10,47
Melbourne V,3516,4,14,5,10,48,40,8,47
Adelaide Utd,3516,5,11,6,11,37,40,-3,39
Brisbane,3516,6,10,5,13,33,42,-9,35
Western Sydn,3516,7,8,9,10,38,47,-9,33
Perth Glory,3516,8,10,2,15,37,50,-13,32
Wellington P,3516,9,5,6,16,31,55,-24,21
CC Mariners,3516,10,4,8,15,28,49,-21,20
Sydney FC,3517,1,20,5,3,66,24,42,65
N'castle Jet,3517,2,16,5,7,59,37,22,53
Melbourne C,3517,3,14,4,11,43,35,8,46
Melbourne V,3517,4,13,6,10,47,40,7,45
Adelaide Utd,3517,5,11,6,11,37,40,-3,39
Brisbane,3517,6,10,5,13,33,42,-9,35
Western Sydn,3517,7,8,9,10,38,47,-9,33
Perth Glory,3517,8,10,2,15,37,50,-13,32
Wellington P,3517,9,5,6,16,31,55,-24,21
CC Mariners,3517,10,4,8,15,28,49,-21,20
Sydney FC,3518,1,20,5,3,64,22,42,65
N'castle Jet,3518,2,16,5,7,61,37,24,53
Melbourne C,3518,3,14,4,11,43,37,6,46
Melbourne V,3518,4,13,6,10,45,38,7,45
Adelaide Utd,3518,5,11,6,11,37,40,-3,39
Brisbane,3518,6,10,5,13,33,42,-9,35
Western Sydn,3518,7,8,9,10,38,47,-9,33
Perth Glory,3518,8,10,2,15,37,50,-13,32
Wellington P,3518,9,5,6,16,31,55,-24,21
CC Mariners,3518,10,4,8,15,28,49,-21,20
Sydney FC,3519,1,20,5,3,64,22,42,65
N'castle Jet,3519,2,16,5,7,58,37,21,53
Melbourne C,3519,3,14,4,11,43,34,9,46
Melbourne V,3519,4,13,6,10,45,38,7,45
Adelaide Utd,3519,5,11,6,11,37,40,-3,39
Brisbane,3519,6,10,5,13,33,42,-9,35
Western Sydn,3519,7,8,9,10,38,47,-9,33
Perth Glory,3519,8,10,2,15,37,50,-13,32
Wellington P,3519,9,5,6,16,31,55,-24,21
CC Mariners,3519,10,4,8,15,28,49,-21,20
Sydney FC,3520,1,20,5,3,65,23,42,65
N'castle Jet,3520,2,15,6,7,58,38,20,51
Melbourne C,3520,3,14,5,10,44,34,10,47
Melbourne V,3520,4,13,6,10,46,39,7,45
Adelaide Utd,3520,5,11,6,11,37,40,-3,39
Brisbane,3520,6,10,5,13,33,42,-9,35
Western Sydn,3520,7,8,9,10,38,47,-9,33
Perth Glory,3520,8,10,2,15,37,50,-13,32
Wellington P,3520,9,5,6,16,31,55,-24,21
CC Mariners,3520,10,4,8,15,28,49,-21,20
Sydney FC,3521,1,21,4,3,66,22,44,67
N'castle Jet,3521,2,16,5,7,62,40,22,53
Melbourne C,3521,3,14,4,11,46,38,8,46
Melbourne V,3521,4,13,5,11,45,40,5,44
Adelaide Utd,3521,5,11,6,11,37,40,-3,39
Brisbane,3521,6,10,5,13,33,42,-9,35
Western Sydn,3521,7,8,9,10,38,47,-9,33
Perth Glory,3521,8,10,2,15,37,50,-13,32
Wellington P,3521,9,5,6,16,31,55,-24,21
CC Mariners,3521,10,4,8,15,28,49,-21,20
Sydney FC,3522,1,21,4,3,66,22,44,67
N'castle Jet,3522,2,16,5,7,61,38,23,53
Melbourne C,3522,3,14,4,11,44,37,7,46
Melbourne V,3522,4,13,5,11,45,40,5,44
Adelaide Utd,3522,5,11,6,11,37,40,-3,39
Brisbane,3522,6,10,5,13,33,42,-9,35
Western Sydn,3522,7,8,9,10,38,47,-9,33
Perth Glory,3522,8,10,2,15,37,50,-13,32
Wellington P,3522,9,5,6,16,31,55,-24,21
CC Mariners,3522,10,4,8,15,28,49,-21,20
Sydney FC,3523,1,20,5,3,64,22,42,65
N'castle Jet,3523,2,15,5,8,57,38,19,50
Melbourne C,3523,3,15,4,10,44,33,11,49
Melbourne V,3523,4,13,6,10,45,38,7,45
Adelaide Utd,3523,5,11,6,11,37,40,-3,39
Brisbane,3523,6,10,5,13,33,42,-9,35
Western Sydn,3523,7,8,9,10,38,47,-9,33
Perth Glory,3523,8,10,2,15,37,50,-13,32
Wellington P,3523,9,5,6,16,31,55,-24,21
CC Mariners,3523,10,4,8,15,28,49,-21,20
Sydney FC,3524,1,20,5,3,66,24,42,65
N'castle Jet,3524,2,16,5,7,60,38,22,53
Melbourne C,3524,3,14,4,11,44,36,8,46
Melbourne V,3524,4,13,6,10,47,40,7,45
Adelaide Utd,3524,5,11,6,11,37,40,-3,39
Brisbane,3524,6,10,5,13,33,42,-9,35
Western Sydn,3524,7,8,9,10,38,47,-9,33
Perth Glory,3524,8,10,2,15,37,50,-13,32
Wellington P,3524,9,5,6,16,31,55,-24,21
CC Mariners,3524,10,4,8,15,28,49,-21,20
Sydney FC,3525,1,21,4,3,67,22,45,67
N'castle Jet,3525,2,15,5,8,58,40,18,50
Melbourne C,3525,3,15,4,10,46,34,12,49
Melbourne V,3525,4,13,5,11,45,41,4,44
Adelaide Utd,3525,5,11,6,11,37,40,-3,39
Brisbane,3525,6,10,5,13,33,42,-9,35
Western Sydn,3525,7,8,9,10,38,47,-9,33
Perth Glory,3525,8,10,2,15,37,50,-13,32
Wellington P,3525,9,5,6,16,31,55,-24,21
CC Mariners,3525,10,4,8,15,28,49,-21,20
Sydney FC,3526,1,21,4,3,68,23,45,67
N'castle Jet,3526,2,16,5,7,61,40,21,53
Melbourne C,3526,3,14,4,11,46,37,9,46
Melbourne V,3526,4,13,5,11,46,42,4,44
Adelaide Utd,3526,5,11,6,11,37,40,-3,39
Brisbane,3526,6,10,5,13,33,42,-9,35
Western Sydn,3526,7,8,9,10,38,47,-9,33
Perth Glory,3526,8,10,2,15,37,50,-13,32
Wellington P,3526,9,5,6,16,31,55,-24,21
CC Mariners,3526,10,4,8,15,28,49,-21,20
Sydney FC,3527,1,20,5,3,65,23,42,65
N'castle Jet,3527,2,16,5,7,61,38,23,53
Melbourne C,3527,3,14,4,11,44,37,7,46
Melbourne V,3527,4,13,6,10,46,39,7,45
Adelaide Utd,3527,5,11,6,11,37,40,-3,39
Brisbane,3527,6,10,5,13,33,42,-9,35
Western Sydn,3527,7,8,9,10,38,47,-9,33
Perth Glory,3527,8,10,2,15,37,50,-13,32
Wellington P,3527,9,5,6,16,31,55,-24,21
CC Mariners,3527,10,4,8,15,28,49,-21,20
Sydney FC,3528,1,20,5,3,65,23,42,65
N'castle Jet,3528,2,15,6,7,59,39,20,51
Melbourne C,3528,3,14,5,10,45,35,10,47
Melbourne V,3528,4,13,6,10,46,39,7,45
Adelaide Utd,3528,5,11,6,11,37,40,-3,39
Brisbane,3528,6,10,5,13,33,42,-9,35
Western Sydn,3528,7,8,9,10,38,47,-9,33
Perth Glory,3528,8,10,2,15,37,50,-13,32
Wellington P,3528,9,5,6,16,31,55,-24,21
CC Mariners,3528,10,4,8,15,28,49,-21,20
Sydney FC,3529,1,21,4,3,66,23,43,67
N'castle Jet,3529,2,16,5,7,60,39,21,53
Melbourne C,3529,3,14,4,11,45,36,9,46
Melbourne V,3529,4,13,5,11,46,40,6,44
Adelaide Utd,3529,5,11,6,11,37,40,-3,39
Brisbane,3529,6,10,5,13,33,42,-9,35
Western Sydn,3529,7,8,9,10,38,47,-9,33
Perth Glory,3529,8,10,2,15,37,50,-13,32
Wellington P,3529,9,5,6,16,31,55,-24,21
CC Mariners,3529,10,4,8,15,28,49,-21,20
Sydney FC,3530,1,21,4,3,67,23,44,67
N'castle Jet,3530,2,16,5,7,59,38,21,53
Melbourne C,3530,3,14,4,11,44,35,9,46
Melbourne V,3530,4,13,5,11,46,41,5,44
Adelaide Utd,3530,5,11,6,11,37,40,-3,39
Brisbane,3530,6,10,5,13,33,42,-9,35
Western Sydn,3530,7,8,9,10,38,47,-9,33
Perth Glory,3530,8,10,2,15,37,50,-13,32
Wellington P,3530,9,5,6,16,31,55,-24,21
CC Mariners,3530,10,4,8,15,28,49,-21,20
Sydney FC,3531,1,21,4,3,67,24,43,67
N'castle Jet,3531,2,16,5,7,60,39,21,53
Melbourne C,3531,3,14,4,11,45,36,9,46
Melbourne V,3531,4,13,5,11,47,41,6,44
Adelaide Utd,3531,5,11,6,11,37,40,-3,39
Brisbane,3531,6,10,5,13,33,42,-9,35
Western Sydn,3531,7,8,9,10,38,47,-9,33
Perth Glory,3531,8,10,2,15,37,50,-13,32
Wellington P,3531,9,5,6,16,31,55,-24,21
CC Mariners,3531,10,4,8,15,28,49,-21,20
Sydney FC,3532,1,21,4,3,68,23,45,67
N'castle Jet,3532,2,15,6,7,57,37,20,51
Melbourne C,3532,3,14,5,10,43,33,10,47
Melbourne V,3532,4,13,5,11,46,42,4,44
Adelaide Utd,3532,5,11,6,11,37,40,-3,39
Brisbane,3532,6,10,5,13,33,42,-9,35
Western Sydn,3532,7,8,9,10,38,47,-9,33
Perth Glory,3532,8,10,2,15,37,50,-13,32
Wellington P,3532,9,5,6,16,31,55,-24,21
CC Mariners,3532,10,4,8,15,28,49,-21,20
Sydney FC,3533,1,21,4,3,65,22,43,67
N'castle Jet,3533,2,15,5,8,58,39,19,50
Melbourne C,3533,3,15,4,10,45,34,11,49
Melbourne V,3533,4,13,5,11,45,39,6,44
Adelaide Utd,3533,5,11,6,11,37,40,-3,39
Brisbane,3533,6,10,5,13,33,42,-9,35
Western Sydn,3533,7,8,9,10,38,47,-9,33
Perth Glory,3533,8,10,2,15,37,50,-13,32
Wellington P,3533,9,5,6,16,31,55,-24,21
CC Mariners,3533,10,4,8,15,28,49,-21,20
Sydney FC,3534,1,21,4,3,69,25,44,67
N'castle Jet,3534,2,15,5,8,57,38,19,50
Melbourne C,3534,3,15,4,10,44,33,11,49
Melbourne V,3534,4,13,5,11,48,43,5,44
Adelaide Utd,3534,5,11,6,11,37,40,-3,39
Brisbane,3534,6,10,5,13,33,42,-9,35
Western Sydn,3534,7,8,9,10,38,47,-9,33
Perth Glory,3534,8,10,2,15,37,50,-13,32
Wellington P,3534,9,5,6,16,31,55,-24,21
CC Mariners,3534,10,4,8,15,28,49,-21,20
Sydney FC,3535,1,20,5,3,64,22,42,65
N'castle Jet,3535,2,16,5,7,61,38,23,53
Melbourne C,3535,3,14,4,11,44,37,7,46
Melbourne V,3535,4,13,6,10,45,38,7,45
Adelaide Utd,3535,5,11,6,11,37,40,-3,39
Brisbane,3535,6,10,5,13,33,42,-9,35
Western Sydn,3535,7,8,9,10,38,47,-9,33
Perth Glory,3535,8,10,2,15,37,50,-13,32
Wellington P,3535,9,5,6,16,31,55,-24,21
CC Mariners,3535,10,4,8,15,28,49,-21,20
Sydney FC,3536,1,20,4,4,64,23,41,64
N'castle Jet,3536,2,16,5,7,60,37,23,53
Melbourne V,3536,3,14,5,10,46,38,8,47
Melbourne C,3536,4,14,4,11,43,36,7,46
Adelaide Utd,3536,5,11,6,11,37,40,-3,39
Brisbane,3536,6,10,5,13,33,42,-9,35
Western Sydn,3536,7,8,9,10,38,47,-9,33
Perth Glory,3536,8,10,2,15,37,50,-13,32
Wellington P,3536,9,5,6,16,31,55,-24,21
CC Mariners,3536,10,4,8,15,28,49,-21,20
Sydney FC,3537,1,21,4,3,67,23,44,67
N'castle Jet,3537,2,16,5,7,60,38,22,53
Melbourne C,3537,3,14,4,11,44,36,8,46
Melbourne V,3537,4,13,5,11,46,41,5,44
Adelaide Utd,3537,5,11,6,11,37,40,-3,39
Brisbane,3537,6,10,5,13,33,42,-9,35
Western Sydn,3537,7,8,9,10,38,47,-9,33
Perth Glory,3537,8,10,2,15,37,50,-13,32
Wellington P,3537,9,5,6,16,31,55,-24,21
CC Mariners,3537,10,4,8,15,28,49,-21,20
Sydney FC,3538,1,21,4,3,65,22,43,67
N'castle Jet,3538,2,15,5,8,58,39,19,50
Melbourne C,3538,3,15,4,10,45,34,11,49
Melbourne V,3538,4,13,5,11,45,39,6,44
Adelaide Utd,3538,5,11,6,11,37,40,-3,39
Brisbane,3538,6,10,5,13,33,42,-9,35
Western Sydn,3538,7,8,9,10,38,47,-9,33
Perth Glory,3538,8,10,2,15,37,50,-13,32
Wellington P,3538,9,5,6,16,31,55,-24,21
CC Mariners,3538,10,4,8,15,28,49,-21,20
Sydney FC,3539,1,20,5,3,65,23,42,65
N'castle Jet,3539,2,16,5,7,58,37,21,53
Melbourne C,3539,3,14,4,11,43,34,9,46
Melbourne V,3539,4,13,6,10,46,39,7,45
Adelaide Utd,3539,5,11,6,11,37,40,-3,39
Brisbane,3539,6,10,5,13,33,42,-9,35
Western Sydn,3539,7,8,9,10,38,47,-9,33
Perth Glory,3539,8,10,2,15,37,50,-13,32
Wellington P,3539,9,5,6,16,31,55,-24,21
CC Mariners,3539,10,4,8,15,28,49,-21,20
Sydney FC,3540,1,20,4,4,65,24,41,64
N'castle Jet,3540,2,15,6,7,58,38,20,51
Melbourne C,3540,3,14,5,10,44,34,10,47
Melbourne V,3540,4,14,5,10,47,39,8,47
Adelaide Utd,3540,5,11,6,11,37,40,-3,39
Brisbane,3540,6,10,5,13,33,42,-9,35
Western Sydn,3540,7,8,9,10,38,47,-9,33
Perth Glory,3540,8,10,2,15,37,50,-13,32
Wellington P,3540,9,5,6,16,31,55,-24,21
CC Mariners,3540,10,4,8,15,28,49,-21,20
Sydney FC,3541,1,21,4,3,66,22,44,67
N'castle Jet,3541,2,15,5,8,57,39,18,50
Melbourne C,3541,3,15,4,10,45,33,12,49
Melbourne V,3541,4,13,5,11,45,40,5,44
Adelaide Utd,3541,5,11,6,11,37,40,-3,39
Brisbane,3541,6,10,5,13,33,42,-9,35
Western Sydn,3541,7,8,9,10,38,47,-9,33
Perth Glory,3541,8,10,2,15,37,50,-13,32
Wellington P,3541,9,5,6,16,31,55,-24,21
CC Mariners,3541,10,4,8,15,28,49,-21,20
Sydney FC,3542,1,21,4,3,67,23,44,67
N'castle Jet,3542,2,15,5,8,58,39,19,50
Melbourne C,3542,3,15,4,10,45,34,11,49
Melbourne V,3542,4,13,5,11,46,41,5,44
Adelaide Utd,3542,5,11,6,11,37,40,-3,39
Brisbane,3542,6,10,5,13,33,42,-9,35
Western Sydn,3542,7,8,9,10,38,47,-9,33
Perth Glory,3542,8,10,2,15,37,50,-13,32
Wellington P,3542,9,5,6,16,31,55,-24,21
CC Mariners,3542,10,4,8,15,28,49,-21,20
Sydney FC,3543,1,21,4,3,67,22,45,67
N'castle Jet,3543,2,15,5,8,58,39,19,50
Melbourne C,3543,3,15,4,10,45,34,11,49
Melbourne V,3543,4,13,5,11,45,41,4,44
Adelaide Utd,3543,5,11,6,11,37,40,-3,39
Brisbane,3543,6,10,5,13,33,42,-9,35
Western Sydn,3543,7,8,9,10,38,47,-9,33
Perth Glory,3543,8,10,2,15,37,50,-13,32
Wellington P,3543,9,5,6,16,31,55,-24,21
CC Mariners,3543,10,4,8,15,28,49,-21,20
Sydney FC,3544,1,21,4,3,67,24,43,67
N'castle Jet,3544,2,15,6,7,59,39,20,51
Melbourne C,3544,3,14,5,10,45,35,10,47
Melbourne V,3544,4,13,5,11,47,41,6,44
Adelaide Utd,3544,5,11,6,11,37,40,-3,39
Brisbane,3544,6,10,5,13,33,42,-9,35
Western Sydn,3544,7,8,9,10,38,47,-9,33
Perth Glory,3544,8,10,2,15,37,50,-13,32
Wellington P,3544,9,5,6,16,31,55,-24,21
CC Mariners,3544,10,4,8,15,28,49,-21,20
Sydney FC,3545,1,20,5,3,65,23,42,65
N'castle Jet,3545,2,16,5,7,59,38,21,53
Melbourne C,3545,3,14,4,11,44,35,9,46
Melbourne V,3545,4,13,6,10,46,39,7,45
Adelaide Utd,3545,5,11,6,11,37,40,-3,39
Brisbane,3545,6,10,5,13,33,42,-9,35
Western Sydn,3545,7,8,9,10,38,47,-9,33
Perth Glory,3545,8,10,2,15,37,50,-13,32
Wellington P,3545,9,5,6,16,31,55,-24,21
CC Mariners,3545,10,4,8,15,28,49,-21,20
Sydney FC,3546,1,20,4,4,65,25,40,64
N'castle Jet,3546,2,16,5,7,58,37,21,53
Melbourne V,3546,3,14,5,10,48,39,9,47
Melbourne C,3546,4,14,4,11,43,34,9,46
Adelaide Utd,3546,5,11,6,11,37,40,-3,39
Brisbane,3546,6,10,5,13,33,42,-9,35
Western Sydn,3546,7,8,9,10,38,47,-9,33
Perth Glory,3546,8,10,2,15,37,50,-13,32
Wellington P,3546,9,5,6,16,31,55,-24,21
CC Mariners,3546,10,4,8,15,28,49,-21,20
Sydney FC,3547,1,20,4,4,65,24,41,64
N'castle Jet,3547,2,15,6,7,59,39,20,51
Melbourne C,3547,3,14,5,10,45,35,10,47
Melbourne V,3547,4,14,5,10,47,39,8,47
Adelaide Utd,3547,5,11,6,11,37,40,-3,39
Brisbane,3547,6,10,5,13,33,42,-9,35
Western Sydn,3547,7,8,9,10,38,47,-9,33
Perth Glory,3547,8,10,2,15,37,50,-13,32
Wellington P,3547,9,5,6,16,31,55,-24,21
CC Mariners,3547,10,4,8,15,28,49,-21,20
Sydney FC,3548,1,20,4,4,64,23,41,64
N'castle Jet,3548,2,16,5,7,61,38,23,53
Melbourne V,3548,3,14,5,10,46,38,8,47
Melbourne C,3548,4,14,4,11,44,37,7,46
Adelaide Utd,3548,5,11,6,11,37,40,-3,39
Brisbane,3548,6,10,5,13,33,42,-9,35
Western Sydn,3548,7,8,9,10,38,47,-9,33
Perth Glory,3548,8,10,2,15,37,50,-13,32
Wellington P,3548,9,5,6,16,31,55,-24,21
CC Mariners,3548,10,4,8,15,28,49,-21,20
Sydney FC,3549,1,21,4,3,67,23,44,67
N'castle Jet,3549,2,16,5,7,59,38,21,53
Melbourne C,3549,3,14,4,11,44,35,9,46
Melbourne V,3549,4,13,5,11,46,41,5,44
Adelaide Utd,3549,5,11,6,11,37,40,-3,39
Brisbane,3549,6,10,5,13,33,42,-9,35
Western Sydn,3549,7,8,9,10,38,47,-9,33
Perth Glory,3549,8,10,2,15,37,50,-13,32
Wellington P,3549,9,5,6,16,31,55,-24,21
CC Mariners,3549,10,4,8,15,28,49,-21,20
Sydney FC,3550,1,20,5,3,66,24,42,65
N'castle Jet,3550,2,16,5,7,60,38,22,53
Melbourne C,3550,3,14,4,11,44,36,8,46
Melbourne V,3550,4,13,6,10,47,40,7,45
Adelaide Utd,3550,5,11,6,11,37,40,-3,39
Brisbane,3550,6,10,5,13,33,42,-9,35
Western Sydn,3550,7,8,9,10,38,47,-9,33
Perth Glory,3550,8,10,2,15,37,50,-13,32
Wellington P,3550,9,5,6,16,31,55,-24,21
CC Mariners,3550,10,4,8,15,28,49,-21,20
Sydney FC,3551,1,20,5,3,67,25,42,65
N'castle Jet,3551,2,16,5,7,61,39,22,53
Melbourne C,3551,3,14,4,11,45,37,8,46
Melbourne V,3551,4,13,6,10,48,41,7,45
Adelaide Utd,3551,5,11,6,11,37,40,-3,39
Brisbane,3551,6,10,5,13,33,42,-9,35
Western Sydn,3551,7,8,9,10,38,47,-9,33
Perth Glory,3551,8,10,2,15,37,50,-13,32
Wellington P,3551,9,5,6,16,31,55,-24,21
CC Mariners,3551,10,4,8,15,28,49,-21,20
Sydney FC,3552,1,21,4,3,66,22,44,67
N'castle Jet,3552,2,16,5,7,60,37,23,53
Melbourne C,3552,3,14,4,11,43,36,7,46
Melbourne V,3552,4,13,5,11,45,40,5,44
Adelaide Utd,3552,5,11,6,11,37,40,-3,39
Brisbane,3552,6,10,5,13,33,42,-9,35
Western Sydn,3552,7,8,9,10,38,47,-9,33
Perth Glory,3552,8,10,2,15,37,50,-13,32
Wellington P,3552,9,5,6,16,31,55,-24,21
CC Mariners,3552,10,4,8,15,28,49,-21,20
Sydney FC,3553,1,21,4,3,67,22,45,67
N'castle Jet,3553,2,16,5,7,62,37,25,53
Melbourne C,3553,3,14,4,11,43,38,5,46
Melbourne V,3553,4,13,5,11,45,41,4,44
Adelaide Utd,3553,5,11,6,11,37,40,-3,39
Brisbane,3553,6,10,5,13,33,42,-9,35
Western Sydn,3553,7,8,9,10,38,47,-9,33
Perth Glory,3553,8,10,2,15,37,50,-13,32
Wellington P,3553,9,5,6,16,31,55,-24,21
CC Mariners,3553,10,4,8,15,28,49,-21,20
Sydney FC,3554,1,21,4,3,67,22,45,67
N'castle Jet,3554,2,15,5,8,59,40,19,50
Melbourne C,3554,3,15,4,10,46,35,11,49
Melbourne V,3554,4,13,5,11,45,41,4,44
Adelaide Utd,3554,5,11,6,11,37,40,-3,39
Brisbane,3554,6,10,5,13,33,42,-9,35
Western Sydn,3554,7,8,9,10,38,47,-9,33
Perth Glory,3554,8,10,2,15,37,50,-13,32
Wellington P,3554,9,5,6,16,31,55,-24,21
CC Mariners,3554,10,4,8,15,28,49,-21,20
Sydney FC,3555,1,20,5,3,65,23,42,65
N'castle Jet,3555,2,16,5,7,60,37,23,53
Melbourne C,3555,3,14,4,11,43,36,7,46
Melbourne V,3555,4,13,6,10,46,39,7,45
Adelaide Utd,3555,5,11,6,11,37,40,-3,39
Brisbane,3555,6,10,5,13,33,42,-9,35
Western Sydn,3555,7,8,9,10,38,47,-9,33
Perth Glory,3555,8,10,2,15,37,50,-13,32
Wellington P,3555,9,5,6,16,31,55,-24,21
CC Mariners,3555,10,4,8,15,28,49,-21,20
Sydney FC,3556,1,20,4,4,64,23,41,64
N'castle Jet,3556,2,16,5,7,62,38,24,53
Melbourne V,3556,3,14,5,10,46,38,8,47
Melbourne C,3556,4,14,4,11,44,38,6,46
Adelaide Utd,3556,5,11,6,11,37,40,-3,39
Brisbane,3556,6,10,5,13,33,42,-9,35
Western Sydn,3556,7,8,9,10,38,47,-9,33
Perth Glory,3556,8,10,2,15,37,50,-13,32
Wellington P,3556,9,5,6,16,31,55,-24,21
CC Mariners,3556,10,4,8,15,28,49,-21,20
Sydney FC,3557,1,21,4,3,67,22,45,67
N'castle Jet,3557,2,15,5,8,58,39,19,50
Melbourne C,3557,3,15,4,10,45,34,11,49
Melbourne V,3557,4,13,5,11,45,41,4,44
Adelaide Utd,3557,5,11,6,11,37,40,-3,39
Brisbane,3557,6,10,5,13,33,42,-9,35
Western Sydn,3557,7,8,9,10,38,47,-9,33
Perth Glory,3557,8,10,2,15,37,50,-13,32
Wellington P,3557,9,5,6,16,31,55,-24,21
CC Mariners,3557,10,4,8,15,28,49,-21,20
Sydney FC,3558,1,20,4,4,66,25,41,64
N'castle Jet,3558,2,16,5,7,61,39,22,53
Melbourne V,3558,3,14,5,10,48,40,8,47
Melbourne C,3558,4,14,4,11,45,37,8,46
Adelaide Utd,3558,5,11,6,11,37,40,-3,39
Brisbane,3558,6,10,5,13,33,42,-9,35
Western Sydn,3558,7,8,9,10,38,47,-9,33
Perth Glory,3558,8,10,2,15,37,50,-13,32
Wellington P,3558,9,5,6,16,31,55,-24,21
CC Mariners,3558,10,4,8,15,28,49,-21,20
Sydney FC,3559,1,20,4,4,66,27,39,64
N'castle Jet,3559,2,16,5,7,59,38,21,53
Melbourne V,3559,3,14,5,10,50,40,10,47
Melbourne C,3559,4,14,4,11,44,35,9,46
Adelaide Utd,3559,5,11,6,11,37,40,-3,39
Brisbane,3559,6,10,5,13,33,42,-9,35
Western Sydn,3559,7,8,9,10,38,47,-9,33
Perth Glory,3559,8,10,2,15,37,50,-13,32
Wellington P,3559,9,5,6,16,31,55,-24,21
CC Mariners,3559,10,4,8,15,28,49,-21,20
Sydney FC,3560,1,21,4,3,65,22,43,67
N'castle Jet,3560,2,16,5,7,60,38,22,53
Melbourne C,3560,3,14,4,11,44,36,8,46
Melbourne V,3560,4,13,5,11,45,39,6,44
Adelaide Utd,3560,5,11,6,11,37,40,-3,39
Brisbane,3560,6,10,5,13,33,42,-9,35
Western Sydn,3560,7,8,9,10,38,47,-9,33
Perth Glory,3560,8,10,2,15,37,50,-13,32
Wellington P,3560,9,5,6,16,31,55,-24,21
CC Mariners,3560,10,4,8,15,28,49,-21,20
Sydney FC,3561,1,21,4,3,68,24,44,67
N'castle Jet,3561,2,16,5,7,59,38,21,53
Melbourne C,3561,3,14,4,11,44,35,9,46
Melbourne V,3561,4,13,5,11,47,42,5,44
Adelaide Utd,3561,5,11,6,11,37,40,-3,39
Brisbane,3561,6,10,5,13,33,42,-9,35
Western Sydn,3561,7,8,9,10,38,47,-9,33
Perth Glory,3561,8,10,2,15,37,50,-13,32
Wellington P,3561,9,5,6,16,31,55,-24,21
CC Mariners,3561,10,4,8,15,28,49,-21,20
Sydney FC,3562,1,21,4,3,65,22,43,67
N'castle Jet,3562,2,16,5,7,61,39,22,53
Melbourne C,3562,3,14,4,11,45,37,8,46
Melbourne V,3562,4,13,5,11,45,39,6,44
Adelaide Utd,3562,5,11,6,11,37,40,-3,39
Brisbane,3562,6,10,5,13,33,42,-9,35
Western Sydn,3562,7,8,9,10,38,47,-9,33
Perth Glory,3562,8,10,2,15,37,50,-13,32
Wellington P,3562,9,5,6,16,31,55,-24,21
CC Mariners,3562,10,4,8,15,28,49,-21,20
Sydney FC,3563,1,21,4,3,67,22,45,67
N'castle Jet,3563,2,16,5,7,58,37,21,53
Melbourne C,3563,3,14,4,11,43,34,9,46
Melbourne V,3563,4,13,5,11,45,41,4,44
Adelaide Utd,3563,5,11,6,11,37,40,-3,39
Brisbane,3563,6,10,5,13,33,42,-9,35
Western Sydn,3563,7,8,9,10,38,47,-9,33
Perth Glory,3563,8,10,2,15,37,50,-13,32
Wellington P,3563,9,5,6,16,31,55,-24,21
CC Mariners,3563,10,4,8,15,28,49,-21,20
Sydney FC,3564,1,20,4,4,64,24,40,64
N'castle Jet,3564,2,16,5,7,61,39,22,53
Melbourne V,3564,3,14,5,10,47,38,9,47
Melbourne C,3564,4,14,4,11,45,37,8,46
Adelaide Utd,3564,5,11,6,11,37,40,-3,39
Brisbane,3564,6,10,5,13,33,42,-9,35
Western Sydn,3564,7,8,9,10,38,47,-9,33
Perth Glory,3564,8,10,2,15,37,50,-13,32
Wellington P,3564,9,5,6,16,31,55,-24,21
CC Mariners,3564,10,4,8,15,28,49,-21,20
Sydney FC,3565,1,21,4,3,66,23,43,67
N'castle Jet,3565,2,15,5,8,58,39,19,50
Melbourne C,3565,3,15,4,10,45,34,11,49
Melbourne V,3565,4,13,5,11,46,40,6,44
Adelaide Utd,3565,5,11,6,11,37,40,-3,39
Brisbane,3565,6,10,5,13,33,42,-9,35
Western Sydn,3565,7,8,9,10,38,47,-9,33
Perth Glory,3565,8,10,2,15,37,50,-13,32
Wellington P,3565,9,5,6,16,31,55,-24,21
CC Mariners,3565,10,4,8,15,28,49,-21,20
Sydney FC,3566,1,21,4,3,67,24,43,67
N'castle Jet,3566,2,16,5,7,59,38,21,53
Melbourne C,3566,3,14,4,11,44,35,9,46
Melbourne V,3566,4,13,5,11,47,41,6,44
Adelaide Utd,3566,5,11,6,11,37,40,-3,39
Brisbane,3566,6,10,5,13,33,42,-9,35
Western Sydn,3566,7,8,9,10,38,47,-9,33
Perth Glory,3566,8,10,2,15,37,50,-13,32
Wellington P,3566,9,5,6,16,31,55,-24,21
CC Mariners,3566,10,4,8,15,28,49,-21,20
Sydney FC,3567,1,21,4,3,65,22,43,67
N'castle Jet,3567,2,15,6,7,57,37,20,51
Melbourne C,3567,3,14,5,10,43,33,10,47
Melbourne V,3567,4,13,5,11,45,39,6,44
Adelaide Utd,3567,5,11,6,11,37,40,-3,39
Brisbane,3567,6,10,5,13,33,42,-9,35
Western Sydn,3567,7,8,9,10,38,47,-9,33
Perth Glory,3567,8,10,2,15,37,50,-13,32
Wellington P,3567,9,5,6,16,31,55,-24,21
CC Mariners,3567,10,4,8,15,28,49,-21,20
Sydney FC,3568,1,20,5,3,65,23,42,65
N'castle Jet,3568,2,16,5,7,60,38,22,53
Melbourne C,3568,3,14,4,11,44,36,8,46
Melbourne V,3568,4,13,6,10,46,39,7,45
Adelaide Utd,3568,5,11,6,11,37,40,-3,39
Brisbane,3568,6,10,5,13,33,42,-9,35
Western Sydn,3568,7,8,9,10,38,47,-9,33
Perth Glory,3568,8,10,2,15,37,50,-13,32
Wellington P,3568,9,5,6,16,31,55,-24,21
CC Mariners,3568,10,4,8,15,28,49,-21,20
Sydney FC,3569,1,20,4,4,66,25,41,64
N'castle Jet,3569,2,15,6,7,59,39,20,51
Melbourne C,3569,3,14,5,10,45,35,10,47
Melbourne V,3569,4,14,5,10,48,40,8,47
Adelaide Utd,3569,5,11,6,11,37,40,-3,39
Brisbane,3569,6,10,5,13,33,42,-9,35
Western Sydn,3569,7,8,9,10,38,47,-9,33
Perth Glory,3569,8,10,2,15,37,50,-13,32
Wellington P,3569,9,5,6,16,31,55,-24,21
CC Mariners,3569,10,4,8,15,28,49,-21,20
Sydney FC,3570,1,21,4,3,66,22,44,67
N'castle Jet,3570,2,16,5,7,59,37,22,53
Melbourne C,3570,3,14,4,11,43,35,8,46
Melbourne V,3570,4,13,5,11,45,40,5,44
Adelaide Utd,3570,5,11,6,11,37,40,-3,39
Brisbane,3570,6,10,5,13,33,42,-9,35
Western Sydn,3570,7,8,9,10,38,47,-9,33
Perth Glory,3570,8,10,2,15,37,50,-13,32
Wellington P,3570,9,5,6,16,31,55,-24,21
CC Mariners,3570,10,4,8,15,28,49,-21,20
Sydney FC,3571,1,21,4,3,66,22,44,67
N'castle Jet,3571,2,16,5,7,59,38,21,53
Melbourne C,3571,3,14,4,11,44,35,9,46
Melbourne V,3571,4,13,5,11,45,40,5,44
Adelaide Utd,3571,5,11,6,11,37,40,-3,39
Brisbane,3571,6,10,5,13,33,42,-9,35
Western Sydn,3571,7,8,9,10,38,47,-9,33
Perth Glory,3571,8,10,2,15,37,50,-13,32
Wellington P,3571,9,5,6,16,31,55,-24,21
CC Mariners,3571,10,4,8,15,28,49,-21,20
Sydney FC,3572,1,20,4,4,64,23,41,64
N'castle Jet,3572,2,15,5,8,58,39,19,50
Melbourne C,3572,3,15,4,10,45,34,11,49
Melbourne V,3572,4,14,5,10,46,38,8,47
Adelaide Utd,3572,5,11,6,11,37,40,-3,39
Brisbane,3572,6,10,5,13,33,42,-9,35
Western Sydn,3572,7,8,9,10,38,47,-9,33
Perth Glory,3572,8,10,2,15,37,50,-13,32
Wellington P,3572,9,5,6,16,31,55,-24,21
CC Mariners,3572,10,4,8,15,28,49,-21,20
Sydney FC,3573,1,21,4,3,66,23,43,67
N'castle Jet,3573,2,15,5,8,57,40,17,50
Melbourne C,3573,3,15,4,10,46,33,13,49
Melbourne V,3573,4,13,5,11,46,40,6,44
Adelaide Utd,3573,5,11,6,11,37,40,-3,39
Brisbane,3573,6,10,5,13,33,42,-9,35
Western Sydn,3573,7,8,9,10,38,47,-9,33
Perth Glory,3573,8,10,2,15,37,50,-13,32
Wellington P,3573,9,5,6,16,31,55,-24,21
CC Mariners,3573,10,4,8,15,28,49,-21,20
Sydney FC,3574,1,21,4,3,68,24,44,67
N'castle Jet,3574,2,15,5,8,57,40,17,50
Melbourne C,3574,3,15,4,10,46,33,13,49
Melbourne V,3574,4,13,5,11,47,42,5,44
Adelaide Utd,3574,5,11,6,11,37,40,-3,39
Brisbane,3574,6,10,5,13,33,42,-9,35
Western Sydn,3574,7,8,9,10,38,47,-9,33
Perth Glory,3574,8,10,2,15,37,50,-13,32
Wellington P,3574,9,5,6,16,31,55,-24,21
CC Mariners,3574,10,4,8,15,28,49,-21,20
Sydney FC,3575,1,20,5,3,66,24,42,65
N'castle Jet,3575,2,15,5,8,57,39,18,50
Melbourne C,3575,3,15,4,10,45,33,12,49
Melbourne V,3575,4,13,6,10,47,40,7,45
Adelaide Utd,3575,5,11,6,11,37,40,-3,39
Brisbane,3575,6,10,5,13,33,42,-9,35
Western Sydn,3575,7,8,9,10,38,47,-9,33
Perth Glory,3575,8,10,2,15,37,50,-13,32
Wellington P,3575,9,5,6,16,31,55,-24,21
CC Mariners,3575,10,4,8,15,28,49,-21,20
Sydney FC,3576,1,20,4,4,66,25,41,64
N'castle Jet,3576,2,15,6,7,59,39,20,51
Melbourne C,3576,3,14,5,10,45,35,10,47
Melbourne V,3576,4,14,5,10,48,40,8,47
Adelaide Utd,3576,5,11,6,11,37,40,-3,39
Brisbane,3576,6,10,5,13,33,42,-9,35
Western Sydn,3576,7,8,9,10,38,47,-9,33
Perth Glory,3576,8,10,2,15,37,50,-13,32
Wellington P,3576,9,5,6,16,31,55,-24,21
CC Mariners,3576,10,4,8,15,28,49,-21,20
Sydney FC,3577,1,20,4,4,66,25,41,64
N'castle Jet,3577,2,15,5,8,58,41,17,50
Melbourne C,3577,3,15,4,10,47,34,13,49
Melbourne V,3577,4,14,5,10,48,40,8,47
Adelaide Utd,3577,5,11,6,11,37,40,-3,39
Brisbane,3577,6,10,5,13,33,42,-9,35
Western Sydn,3577,7,8,9,10,38,47,-9,33
Perth Glory,3577,8,10,2,15,37,50,-13,32
Wellington P,3577,9,5,6,16,31,55,-24,21
CC Mariners,3577,10,4,8,15,28,49,-21,20
Sydney FC,3578,1,21,4,3,67,24,43,67
N'castle Jet,3578,2,15,6,7,58,38,20,51
Melbourne C,3578,3,14,5,10,44,34,10,47
Melbourne V,3578,4,13,5,11,47,41,6,44
Adelaide Utd,3578,5,11,6,11,37,40,-3,39
Brisbane,3578,6,10,5,13,33,42,-9,35
Western Sydn,3578,7,8,9,10,38,47,-9,33
Perth Glory,3578,8,10,2,15,37,50,-13,32
Wellington P,3578,9,5,6,16,31,55,-24,21
CC Mariners,3578,10,4,8,15,28,49,-21,20
Sydney FC,3579,1,20,5,3,64,22,42,65
N'castle Jet,3579,2,16,5,7,61,37,24,53
Melbourne C,3579,3,14,4,11,43,37,6,46
Melbourne V,3579,4,13,6,10,45,38,7,45
Adelaide Utd,3579,5,11,6,11,37,40,-3,39
Brisbane,3579,6,10,5,13,33,42,-9,35
Western Sydn,3579,7,8,9,10,38,47,-9,33
Perth Glory,3579,8,10,2,15,37,50,-13,32
Wellington P,3579,9,5,6,16,31,55,-24,21
CC Mariners,3579,10,4,8,15,28,49,-21,20
Sydney FC,3580,1,21,4,3,67,23,44,67
N'castle Jet,3580,2,15,5,8,58,40,18,50
Melbourne C,3580,3,15,4,10,46,34,12,49
Melbourne V,3580,4,13,5,11,46,41,5,44
Adelaide Utd,3580,5,11,6,11,37,40,-3,39
Brisbane,3580,6,10,5,13,33,42,-9,35
Western Sydn,3580,7,8,9,10,38,47,-9,33
Perth Glory,3580,8,10,2,15,37,50,-13,32
Wellington P,3580,9,5,6,16,31,55,-24,21
CC Mariners,3580,10,4,8,15,28,49,-21,20
Sydney FC,3581,1,20,4,4,65,24,41,64
N'castle Jet,3581,2,16,5,7,61,38,23,53
Melbourne V,3581,3,14,5,10,47,39,8,47
Melbourne C,3581,4,14,4,11,44,37,7,46
Adelaide Utd,3581,5,11,6,11,37,40,-3,39
Brisbane,3581,6,10,5,13,33,42,-9,35
Western Sydn,3581,7,8,9,10,38,47,-9,33
Perth Glory,3581,8,10,2,15,37,50,-13,32
Wellington P,3581,9,5,6,16,31,55,-24,21
CC Mariners,3581,10,4,8,15,28,49,-21,20
Sydney FC,3582,1,20,4,4,64,23,41,64
N'castle Jet,3582,2,15,6,7,57,37,20,51
Melbourne C,3582,3,14,5,10,43,33,10,47
Melbourne V,3582,4,14,5,10,46,38,8,47
Adelaide Utd,3582,5,11,6,11,37,40,-3,39
Brisbane,3582,6,10,5,13,33,42,-9,35
Western Sydn,3582,7,8,9,10,38,47,-9,33
Perth Glory,3582,8,10,2,15,37,50,-13,32
Wellington P,3582,9,5,6,16,31,55,-24,21
CC Mariners,3582,10,4,8,15,28,49,-21,20
Sydney FC,3583,1,21,4,3,66,23,43,67
N'castle Jet,3583,2,15,6,7,58,38,20,51
Melbourne C,3583,3,14,5,10,44,34,10,47
Melbourne V,3583,4,13,5,11,46,40,6,44
Adelaide Utd,3583,5,11,6,11,37,40,-3,39
Brisbane,3583,6,10,5,13,33,42,-9,35
Western Sydn,3583,7,8,9,10,38,47,-9,33
Perth Glory,3583,8,10,2,15,37,50,-13,32
Wellington P,3583,9,5,6,16,31,55,-24,21
CC Mariners,3583,10,4,8,15,28,49,-21,20
Sydney FC,3584,1,21,4,3,66,22,44,67
N'castle Jet,3584,2,15,6,7,59,39,20,51
Melbourne C,3584,3,14,5,10,45,35,10,47
Melbourne V,3584,4,13,5,11,45,40,5,44
Adelaide Utd,3584,5,11,6,11,37,40,-3,39
Brisbane,3584,6,10,5,13,33,42,-9,35
Western Sydn,3584,7,8,9,10,38,47,-9,33
Perth Glory,3584,8,10,2,15,37,50,-13,32
Wellington P,3584,9,5,6,16,31,55,-24,21
CC Mariners,3584,10,4,8,15,28,49,-21,20
Sydney FC,3585,1,21,4,3,66,22,44,67
N'castle Jet,3585,2,16,5,7,60,38,22,53
Melbourne C,3585,3,14,4,11,44,36,8,46
Melbourne V,3585,4,13,5,11,45,40,5,44
Adelaide Utd,3585,5,11,6,11,37,40,-3,39
Brisbane,3585,6,10,5,13,33,42,-9,35
Western Sydn,3585,7,8,9,10,38,47,-9,33
Perth Glory,3585,8,10,2,15,37,50,-13,32
Wellington P,3585,9,5,6,16,31,55,-24,21
CC Mariners,3585,10,4,8,15,28,49,-21,20
Sydney FC,3586,1,21,4,3,68,22,46,67
N'castle Jet,3586,2,15,6,7,58,38,20,51
Melbourne C,3586,3,14,5,10,44,34,10,47
Melbourne V,3586,4,13,5,11,45,42,3,44
Adelaide Utd,3586,5,11,6,11,37,40,-3,39
Brisbane,3586,6,10,5,13,33,42,-9,35
Western Sydn,3586,7,8,9,10,38,47,-9,33
Perth Glory,3586,8,10,2,15,37,50,-13,32
Wellington P,3586,9,5,6,16,31,55,-24,21
CC Mariners,3586,10,4,8,15,28,49,-21,20
Sydney FC,3587,1,20,4,4,64,23,41,64
N'castle Jet,3587,2,15,6,7,59,39,20,51
Melbourne C,3587,3,14,5,10,45,35,10,47
Melbourne V,3587,4,14,5,10,46,38,8,47
Adelaide Utd,3587,5,11,6,11,37,40,-3,39
Brisbane,3587,6,10,5,13,33,42,-9,35
Western Sydn,3587,7,8,9,10,38,47,-9,33
Perth Glory,3587,8,10,2,15,37,50,-13,32
Wellington P,3587,9,5,6,16,31,55,-24,21
CC Mariners,3587,10,4,8,15,28,49,-21,20
Sydney FC,3588,1,20,4,4,65,24,41,64
N'castle Jet,3588,2,15,5,8,58,39,19,50
Melbourne C,3588,3,15,4,10,45,34,11,49
Melbourne V,3588,4,14,5,10,47,39,8,47
Adelaide Utd,3588,5,11,6,11,37,40,-3,39
Brisbane,3588,6,10,5,13,33,42,-9,35
Western Sydn,3588,7,8,9,10,38,47,-9,33
Perth Glory,3588,8,10,2,15,37,50,-13,32
Wellington P,3588,9,5,6,16,31,55,-24,21
CC Mariners,3588,10,4,8,15,28,49,-21,20
Sydney FC,3589,1,20,4,4,64,23,41,64
N'castle Jet,3589,2,16,5,7,61,38,23,53
Melbourne V,3589,3,14,5,10,46,38,8,47
Melbourne C,3589,4,14,4,11,44,37,7,46
Adelaide Utd,3589,5,11,6,11,37,40,-3,39
Brisbane,3589,6,10,5,13,33,42,-9,35
Western Sydn,3589,7,8,9,10,38,47,-9,33
Perth Glory,3589,8,10,2,15,37,50,-13,32
Wellington P,3589,9,5,6,16,31,55,-24,21
CC Mariners,3589,10,4,8,15,28,49,-21,20
Sydney FC,3590,1,21,4,3,68,22,46,67
N'castle Jet,3590,2,15,5,8,58,41,17,50
Melbourne C,3590,3,15,4,10,47,34,13,49
Melbourne V,3590,4,13,5,11,45,42,3,44
Adelaide Utd,3590,5,11,6,11,37,40,-3,39
Brisbane,3590,6,10,5,13,33,42,-9,35
Western Sydn,3590,7,8,9,10,38,47,-9,33
Perth Glory,3590,8,10,2,15,37,50,-13,32
Wellington P,3590,9,5,6,16,31,55,-24,21
CC Mariners,3590,10,4,8,15,28,49,-21,20
Sydney FC,3591,1,20,5,3,65,23,42,65
N'castle Jet,3591,2,16,5,7,58,37,21,53
Melbourne C,3591,3,14,4,11,43,34,9,46
Melbourne V,3591,4,13,6,10,46,39,7,45
Adelaide Utd,3591,5,11,6,11,37,40,-3,39
Brisbane,3591,6,10,5,13,33,42,-9,35
Western Sydn,3591,7,8,9,10,38,47,-9,33
Perth Glory,3591,8,10,2,15,37,50,-13,32
Wellington P,3591,9,5,6,16,31,55,-24,21
CC Mariners,3591,10,4,8,15,28,49,-21,20
Sydney FC,3592,1,21,4,3,67,22,45,67
N'castle Jet,3592,2,16,5,7,61,38,23,53
Melbourne C,3592,3,14,4,11,44,37,7,46
Melbourne V,3592,4,13,5,11,45,41,4,44
Adelaide Utd,3592,5,11,6,11,37,40,-3,39
Brisbane,3592,6,10,5,13,33,42,-9,35
Western Sydn,3592,7,8,9,10,38,47,-9,33
Perth Glory,3592,8,10,2,15,37,50,-13,32
Wellington P,3592,9,5,6,16,31,55,-24,21
CC Mariners,3592,10,4,8,15,28,49,-21,20
Sydney FC,3593,1,21,4,3,67,23,44,67
N'castle Jet,3593,2,16,5,7,61,39,22,53
Melbourne C,3593,3,14,4,11,45,37,8,46
Melbourne V,3593,4,13,5,11,46,41,5,44
Adelaide Utd,3593,5,11,6,11,37,40,-3,39
Brisbane,3593,6,10,5,13,33,42,-9,35
Western Sydn,3593,7,8,9,10,38,47,-9,33
Perth Glory,3593,8,10,2,15,37,50,-13,32
Wellington P,3593,9,5,6,16,31,55,-24,21
CC Mariners,3593,10,4,8,15,28,49,-21,20
Sydney FC,3594,1,21,4,3,69,22,47,67
N'castle Jet,3594,2,16,5,7,58,37,21,53
Melbourne C,3594,3,14,4,11,43,34,9,46
Melbourne V,3594,4,13,5,11,45,43,2,44
Adelaide Utd,3594,5,11,6,11,37,40,-3,39
Brisbane,3594,6,10,5,13,33,42,-9,35
Western Sydn,3594,7,8,9,10,38,47,-9,33
Perth Glory,3594,8,10,2,15,37,50,-13,32
Wellington P,3594,9,5,6,16,31,55,-24,21
CC Mariners,3594,10,4,8,15,28,49,-21,20
Sydney FC,3595,1,21,4,3,67,24,43,67
N'castle Jet,3595,2,15,5,8,57,38,19,50
Melbourne C,3595,3,15,4,10,44,33,11,49
Melbourne V,3595,4,13,5,11,47,41,6,44
Adelaide Utd,3595,5,11,6,11,37,40,-3,39
Brisbane,3595,6,10,5,13,33,42,-9,35
Western Sydn,3595,7,8,9,10,38,47,-9,33
Perth Glory,3595,8,10,2,15,37,50,-13,32
Wellington P,3595,9,5,6,16,31,55,-24,21
CC Mariners,3595,10,4,8,15,28,49,-21,20
Sydney FC,3596,1,21,4,3,66,23,43,67
N'castle Jet,3596,2,16,5,7,58,37,21,53
Melbourne C,3596,3,14,4,11,43,34,9,46
Melbourne V,3596,4,13,5,11,46,40,6,44
Adelaide Utd,3596,5,11,6,11,37,40,-3,39
Brisbane,3596,6,10,5,13,33,42,-9,35
Western Sydn,3596,7,8,9,10,38,47,-9,33
Perth Glory,3596,8,10,2,15,37,50,-13,32
Wellington P,3596,9,5,6,16,31,55,-24,21
CC Mariners,3596,10,4,8,15,28,49,-21,20
Sydney FC,3597,1,20,4,4,65,24,41,64
N'castle Jet,3597,2,16,5,7,59,37,22,53
Melbourne V,3597,3,14,5,10,47,39,8,47
Melbourne C,3597,4,14,4,11,43,35,8,46
Adelaide Utd,3597,5,11,6,11,37,40,-3,39
Brisbane,3597,6,10,5,13,33,42,-9,35
Western Sydn,3597,7,8,9,10,38,47,-9,33
Perth Glory,3597,8,10,2,15,37,50,-13,32
Wellington P,3597,9,5,6,16,31,55,-24,21
CC Mariners,3597,10,4,8,15,28,49,-21,20
Sydney FC,3598,1,21,4,3,66,23,43,67
N'castle Jet,3598,2,16,5,7,62,38,24,53
Melbourne C,3598,3,14,4,11,44,38,6,46
Melbourne V,3598,4,13,5,11,46,40,6,44
Adelaide Utd,3598,5,11,6,11,37,40,-3,39
Brisbane,3598,6,10,5,13,33,42,-9,35
Western Sydn,3598,7,8,9,10,38,47,-9,33
Perth Glory,3598,8,10,2,15,37,50,-13,32
Wellington P,3598,9,5,6,16,31,55,-24,21
CC Mariners,3598,10,4,8,15,28,49,-21,20
Sydney FC,3599,1,21,4,3,68,23,45,67
N'castle Jet,3599,2,15,6,7,59,39,20,51
Melbourne C,3599,3,14,5,10,45,35,10,47
Melbourne V,3599,4,13,5,11,46,42,4,44
Adelaide Utd,3599,5,11,6,11,37,40,-3,39
Brisbane,3599,6,10,5,13,33,42,-9,35
Western Sydn,3599,7,8,9,10,38,47,-9,33
Perth Glory,3599,8,10,2,15,37,50,-13,32
Wellington P,3599,9,5,6,16,31,55,-24,21
CC Mariners,3599,10,4,8,15,28,49,-21,20
Sydney FC,3600,1,20,4,4,65,24,41,64
N'castle Jet,3600,2,16,5,7,59,38,21,53
Melbourne V,3600,3,14,5,10,47,39,8,47
Melbourne C,3600,4,14,4,11,44,35,9,46
Adelaide Utd,3600,5,11,6,11,37,40,-3,39
Brisbane,3600,6,10,5,13,33,42,-9,35
Western Sydn,3600,7,8,9,10,38,47,-9,33
Perth Glory,3600,8,10,2,15,37,50,-13,32
Wellington P,3600,9,5,6,16,31,55,-24,21
CC Mariners,3600,10,4,8,15,28,49,-21,20
Sydney FC,3601,1,21,4,3,65,22,43,67
N'castle Jet,3601,2,16,5,7,61,38,23,53
Melbourne C,3601,3,14,4,11,44,37,7,46
Melbourne V,3601,4,13,5,11,45,39,6,44
Adelaide Utd,3601,5,11,6,11,37,40,-3,39
Brisbane,3601,6,10,5,13,33,42,-9,35
Western Sydn,3601,7,8,9,10,38,47,-9,33
Perth Glory,3601,8,10,2,15,37,50,-13,32
Wellington P,3601,9,5,6,16,31,55,-24,21
CC Mariners,3601,10,4,8,15,28,49,-21,20
Sydney FC,3602,1,20,5,3,65,23,42,65
N'castle Jet,3602,2,16,5,7,59,38,21,53
Melbourne C,3602,3,14,4,11,44,35,9,46
Melbourne V,3602,4,13,6,10,46,39,7,45
Adelaide Utd,3602,5,11,6,11,37,40,-3,39
Brisbane,3602,6,10,5,13,33,42,-9,35
Western Sydn,3602,7,8,9,10,38,47,-9,33
Perth Glory,3602,8,10,2,15,37,50,-13,32
Wellington P,3602,9,5,6,16,31,55,-24,21
CC Mariners,3602,10,4,8,15,28,49,-21,20
Sydney FC,3603,1,20,5,3,65,23,42,65
N'castle Jet,3603,2,15,6,7,59,39,20,51
Melbourne C,3603,3,14,5,10,45,35,10,47
Melbourne V,3603,4,13,6,10,46,39,7,45
Adelaide Utd,3603,5,11,6,11,37,40,-3,39
Brisbane,3603,6,10,5,13,33,42,-9,35
Western Sydn,3603,7,8,9,10,38,47,-9,33
Perth Glory,3603,8,10,2,15,37,50,-13,32
Wellington P,3603,9,5,6,16,31,55,-24,21
CC Mariners,3603,10,4,8,15,28,49,-21,20
Sydney FC,3604,1,21,4,3,65,22,43,67
N'castle Jet,3604,2,15,6,7,59,39,20,51
Melbourne C,3604,3,14,5,10,45,35,10,47
Melbourne V,3604,4,13,5,11,45,39,6,44
Adelaide Utd,3604,5,11,6,11,37,40,-3,39
Brisbane,3604,6,10,5,13,33,42,-9,35
Western Sydn,3604,7,8,9,10,38,47,-9,33
Perth Glory,3604,8,10,2,15,37,50,-13,32
Wellington P,3604,9,5,6,16,31,55,-24,21
CC Mariners,3604,10,4,8,15,28,49,-21,20
Sydney FC,3605,1,21,4,3,65,22,43,67
N'castle Jet,3605,2,16,5,7,60,39,21,53
Melbourne C,3605,3,14,4,11,45,36,9,46
Melbourne V,3605,4,13,5,11,45,39,6,44
Adelaide Utd,3605,5,11,6,11,37,40,-3,39
Brisbane,3605,6,10,5,13,33,42,-9,35
Western Sydn,3605,7,8,9,10,38,47,-9,33
Perth Glory,3605,8,10,2,15,37,50,-13,32
Wellington P,3605,9,5,6,16,31,55,-24,21
CC Mariners,3605,10,4,8,15,28,49,-21,20
Sydney FC,3606,1,21,4,3,66,22,44,67
N'castle Jet,3606,2,15,6,7,58,38,20,51
Melbourne C,3606,3,14,5,10,44,34,10,47
Melbourne V,3606,4,13,5,11,45,40,5,44
Adelaide Utd,3606,5,11,6,11,37,40,-3,39
Brisbane,3606,6,10,5,13,33,42,-9,35
Western Sydn,3606,7,8,9,10,38,47,-9,33
Perth Glory,3606,8,10,2,15,37,50,-13,32
Wellington P,3606,9,5,6,16,31,55,-24,21
CC Mariners,3606,10,4,8,15,28,49,-21,20
Sydney FC,3607,1,21,4,3,66,22,44,67
N'castle Jet,3607,2,16,5,7,61,37,24,53
Melbourne C,3607,3,14,4,11,43,37,6,46
Melbourne V,3607,4,13,5,11,45,40,5,44
Adelaide Utd,3607,5,11,6,11,37,40,-3,39
Brisbane,3607,6,10,5,13,33,42,-9,35
Western Sydn,3607,7,8,9,10,38,47,-9,33
Perth Glory,3607,8,10,2,15,37,50,-13,32
Wellington P,3607,9,5,6,16,31,55,-24,21
CC Mariners,3607,10,4,8,15,28,49,-21,20
Sydney FC,3608,1,21,4,3,66,22,44,67
N'castle Jet,3608,2,16,5,7,59,37,22,53
Melbourne C,3608,3,14,4,11,43,35,8,46
Melbourne V,3608,4,13,5,11,45,40,5,44
Adelaide Utd,3608,5,11,6,11,37,40,-3,39
Brisbane,3608,6,10,5,13,33,42,-9,35
Western Sydn,3608,7,8,9,10,38,47,-9,33
Perth Glory,3608,8,10,2,15,37,50,-13,32
Wellington P,3608,9,5,6,16,31,55,-24,21
CC Mariners,3608,10,4,8,15,28,49,-21,20
Sydney FC,3609,1,21,4,3,68,23,45,67
N'castle Jet,3609,2,16,5,7,61,38,23,53
Melbourne C,3609,3,14,4,11,44,37,7,46
Melbourne V,3609,4,13,5,11,46,42,4,44
Adelaide Utd,3609,5,11,6,11,37,40,-3,39
Brisbane,3609,6,10,5,13,33,42,-9,35
Western Sydn,3609,7,8,9,10,38,47,-9,33
Perth Glory,3609,8,10,2,15,37,50,-13,32
Wellington P,3609,9,5,6,16,31,55,-24,21
CC Mariners,3609,10,4,8,15,28,49,-21,20
Sydney FC,3610,1,21,4,3,65,22,43,67
N'castle Jet,3610,2,15,5,8,57,39,18,50
Melbourne C,3610,3,15,4,10,45,33,12,49
Melbourne V,3610,4,13,5,11,45,39,6,44
Adelaide Utd,3610,5,11,6,11,37,40,-3,39
Brisbane,3610,6,10,5,13,33,42,-9,35
Western Sydn,3610,7,8,9,10,38,47,-9,33
Perth Glory,3610,8,10,2,15,37,50,-13,32
Wellington P,3610,9,5,6,16,31,55,-24,21
CC Mariners,3610,10,4,8,15,28,49,-21,20
Sydney FC,3611,1,21,4,3,67,23,44,67
N'castle Jet,3611,2,16,5,7,60,38,22,53
Melbourne C,3611,3,14,4,11,44,36,8,46
Melbourne V,3611,4,13,5,11,46,41,5,44
Adelaide Utd,3611,5,11,6,11,37,40,-3,39
Brisbane,3611,6,10,5,13,33,42,-9,35
Western Sydn,3611,7,8,9,10,38,47,-9,33
Perth Glory,3611,8,10,2,15,37,50,-13,32
Wellington P,3611,9,5,6,16,31,55,-24,21
CC Mariners,3611,10,4,8,15,28,49,-21,20
Sydney FC,3612,1,20,5,3,65,23,42,65
N'castle Jet,3612,2,15,5,8,57,39,18,50
Melbourne C,3612,3,15,4,10,45,33,12,49
Melbourne V,3612,4,13,6,10,46,39,7,45
Adelaide Utd,3612,5,11,6,11,37,40,-3,39
Brisbane,3612,6,10,5,13,33,42,-9,35
Western Sydn,3612,7,8,9,10,38,47,-9,33
Perth Glory,3612,8,10,2,15,37,50,-13,32
Wellington P,3612,9,5,6,16,31,55,-24,21
CC Mariners,3612,10,4,8,15,28,49,-21,20
Sydney FC,3613,1,21,4,3,68,23,45,67
N'castle Jet,3613,2,15,6,7,59,39,20,51
Melbourne C,3613,3,14,5,10,45,35,10,47
Melbourne V,3613,4,13,5,11,46,42,4,44
Adelaide Utd,3613,5,11,6,11,37,40,-3,39
Brisbane,3613,6,10,5,13,33,42,-9,35
Western Sydn,3613,7,8,9,10,38,47,-9,33
Perth Glory,3613,8,10,2,15,37,50,-13,32
Wellington P,3613,9,5,6,16,31,55,-24,21
CC Mariners,3613,10,4,8,15,28,49,-21,20
Sydney FC,3614,1,21,4,3,67,22,45,67
N'castle Jet,3614,2,15,6,7,58,38,20,51
Melbourne C,3614,3,14,5,10,44,34,10,47
Melbourne V,3614,4,13,5,11,45,41,4,44
Adelaide Utd,3614,5,11,6,11,37,40,-3,39
Brisbane,3614,6,10,5,13,33,42,-9,35
Western Sydn,3614,7,8,9,10,38,47,-9,33
Perth Glory,3614,8,10,2,15,37,50,-13,32
Wellington P,3614,9,5,6,16,31,55,-24,21
CC Mariners,3614,10,4,8,15,28,49,-21,20
Sydney FC,3615,1,21,4,3,69,22,47,67
N'castle Jet,3615,2,16,5,7,59,38,21,53
Melbourne C,3615,3,14,4,11,44,35,9,46
Melbourne V,3615,4,13,5,11,45,43,2,44
Adelaide Utd,3615,5,11,6,11,37,40,-3,39
Brisbane,3615,6,10,5,13,33,42,-9,35
Western Sydn,3615,7,8,9,10,38,47,-9,33
Perth Glory,3615,8,10,2,15,37,50,-13,32
Wellington P,3615,9,5,6,16,31,55,-24,21
CC Mariners,3615,10,4,8,15,28,49,-21,20
Sydney FC,3616,1,21,4,3,67,23,44,67
N'castle Jet,3616,2,16,5,7,59,38,21,53
Melbourne C,3616,3,14,4,11,44,35,9,46
Melbourne V,3616,4,13,5,11,46,41,5,44
Adelaide Utd,3616,5,11,6,11,37,40,-3,39
Brisbane,3616,6,10,5,13,33,42,-9,35
Western Sydn,3616,7,8,9,10,38,47,-9,33
Perth Glory,3616,8,10,2,15,37,50,-13,32
Wellington P,3616,9,5,6,16,31,55,-24,21
CC Mariners,3616,10,4,8,15,28,49,-21,20
Sydney FC,3617,1,21,4,3,69,23,46,67
N'castle Jet,3617,2,16,5,7,59,38,21,53
Melbourne C,3617,3,14,4,11,44,35,9,46
Melbourne V,3617,4,13,5,11,46,43,3,44
Adelaide Utd,3617,5,11,6,11,37,40,-3,39
Brisbane,3617,6,10,5,13,33,42,-9,35
Western Sydn,3617,7,8,9,10,38,47,-9,33
Perth Glory,3617,8,10,2,15,37,50,-13,32
Wellington P,3617,9,5,6,16,31,55,-24,21
CC Mariners,3617,10,4,8,15,28,49,-21,20
Sydney FC,3618,1,21,4,3,68,23,45,67
N'castle Jet,3618,2,16,5,7,60,38,22,53
Melbourne C,3618,3,14,4,11,44,36,8,46
Melbourne V,3618,4,13,5,11,46,42,4,44
Adelaide Utd,3618,5,11,6,11,37,40,-3,39
Brisbane,3618,6,10,5,13,33,42,-9,35
Western Sydn,3618,7,8,9,10,38,47,-9,33
Perth Glory,3618,8,10,2,15,37,50,-13,32
Wellington P,3618,9,5,6,16,31,55,-24,21
CC Mariners,3618,10,4,8,15,28,49,-21,20
Sydney FC,3619,1,21,4,3,69,22,47,67
N'castle Jet,3619,2,15,5,8,58,40,18,50
Melbourne C,3619,3,15,4,10,46,34,12,49
Melbourne V,3619,4,13,5,11,45,43,2,44
Adelaide Utd,3619,5,11,6,11,37,40,-3,39
Brisbane,3619,6,10,5,13,33,42,-9,35
Western Sydn,3619,7,8,9,10,38,47,-9,33
Perth Glory,3619,8,10,2,15,37,50,-13,32
Wellington P,3619,9,5,6,16,31,55,-24,21
CC Mariners,3619,10,4,8,15,28,49,-21,20
Sydney FC,3620,1,20,5,3,64,22,42,65
N'castle Jet,3620,2,16,5,7,60,37,23,53
Melbourne C,3620,3,14,4,11,43,36,7,46
Melbourne V,3620,4,13,6,10,45,38,7,45
Adelaide Utd,3620,5,11,6,11,37,40,-3,39
Brisbane,3620,6,10,5,13,33,42,-9,35
Western Sydn,3620,7,8,9,10,38,47,-9,33
Perth Glory,3620,8,10,2,15,37,50,-13,32
Wellington P,3620,9,5,6,16,31,55,-24,21
CC Mariners,3620,10,4,8,15,28,49,-21,20
Sydney FC,3621,1,20,5,3,66,24,42,65
N'castle Jet,3621,2,16,5,7,60,38,22,53
Melbourne C,3621,3,14,4,11,44,36,8,46
Melbourne V,3621,4,13,6,10,47,40,7,45
Adelaide Utd,3621,5,11,6,11,37,40,-3,39
Brisbane,3621,6,10,5,13,33,42,-9,35
Western Sydn,3621,7,8,9,10,38,47,-9,33
Perth Glory,3621,8,10,2,15,37,50,-13,32
Wellington P,3621,9,5,6,16,31,55,-24,21
CC Mariners,3621,10,4,8,15,28,49,-21,20
Sydney FC,3622,1,20,4,4,64,23,41,64
N'castle Jet,3622,2,16,5,7,60,38,22,53
Melbourne V,3622,3,14,5,10,46,38,8,47
Melbourne C,3622,4,14,4,11,44,36,8,46
Adelaide Utd,3622,5,11,6,11,37,40,-3,39
Brisbane,3622,6,10,5,13,33,42,-9,35
Western Sydn,3622,7,8,9,10,38,47,-9,33
Perth Glory,3622,8,10,2,15,37,50,-13,32
Wellington P,3622,9,5,6,16,31,55,-24,21
CC Mariners,3622,10,4,8,15,28,49,-21,20
Sydney FC,3623,1,21,4,3,66,22,44,67
N'castle Jet,3623,2,15,5,8,59,40,19,50
Melbourne C,3623,3,15,4,10,46,35,11,49
Melbourne V,3623,4,13,5,11,45,40,5,44
Adelaide Utd,3623,5,11,6,11,37,40,-3,39
Brisbane,3623,6,10,5,13,33,42,-9,35
Western Sydn,3623,7,8,9,10,38,47,-9,33
Perth Glory,3623,8,10,2,15,37,50,-13,32
Wellington P,3623,9,5,6,16,31,55,-24,21
CC Mariners,3623,10,4,8,15,28,49,-21,20
Sydney FC,3624,1,21,4,3,67,22,45,67
N'castle Jet,3624,2,16,5,7,62,39,23,53
Melbourne C,3624,3,14,4,11,45,38,7,46
Melbourne V,3624,4,13,5,11,45,41,4,44
Adelaide Utd,3624,5,11,6,11,37,40,-3,39
Brisbane,3624,6,10,5,13,33,42,-9,35
Western Sydn,3624,7,8,9,10,38,47,-9,33
Perth Glory,3624,8,10,2,15,37,50,-13,32
Wellington P,3624,9,5,6,16,31,55,-24,21
CC Mariners,3624,10,4,8,15,28,49,-21,20
Sydney FC,3625,1,21,4,3,67,24,43,67
N'castle Jet,3625,2,15,5,8,57,38,19,50
Melbourne C,3625,3,15,4,10,44,33,11,49
Melbourne V,3625,4,13,5,11,47,41,6,44
Adelaide Utd,3625,5,11,6,11,37,40,-3,39
Brisbane,3625,6,10,5,13,33,42,-9,35
Western Sydn,3625,7,8,9,10,38,47,-9,33
Perth Glory,3625,8,10,2,15,37,50,-13,32
Wellington P,3625,9,5,6,16,31,55,-24,21
CC Mariners,3625,10,4,8,15,28,49,-21,20
Sydney FC,3626,1,21,4,3,69,24,45,67
N'castle Jet,3626,2,16,5,7,58,37,21,53
Melbourne C,3626,3,14,4,11,43,34,9,46
Melbourne V,3626,4,13,5,11,47,43,4,44
Adelaide Utd,3626,5,11,6,11,37,40,-3,39
Brisbane,3626,6,10,5,13,33,42,-9,35
Western Sydn,3626,7,8,9,10,38,47,-9,33
Perth Glory,3626,8,10,2,15,37,50,-13,32
Wellington P,3626,9,5,6,16,31,55,-24,21
CC Mariners,3626,10,4,8,15,28,49,-21,20
Sydney FC,3627,1,20,5,3,64,22,42,65
N'castle Jet,3627,2,15,6,7,60,40,20,51
Melbourne C,3627,3,14,5,10,46,36,10,47
Melbourne V,3627,4,13,6,10,45,38,7,45
Adelaide Utd,3627,5,11,6,11,37,40,-3,39
Brisbane,3627,6,10,5,13,33,42,-9,35
Western Sydn,3627,7,8,9,10,38,47,-9,33
Perth Glory,3627,8,10,2,15,37,50,-13,32
Wellington P,3627,9,5,6,16,31,55,-24,21
CC Mariners,3627,10,4,8,15,28,49,-21,20
Sydney FC,3628,1,20,5,3,66,24,42,65
N'castle Jet,3628,2,16,5,7,59,37,22,53
Melbourne C,3628,3,14,4,11,43,35,8,46
Melbourne V,3628,4,13,6,10,47,40,7,45
Adelaide Utd,3628,5,11,6,11,37,40,-3,39
Brisbane,3628,6,10,5,13,33,42,-9,35
Western Sydn,3628,7,8,9,10,38,47,-9,33
Perth Glory,3628,8,10,2,15,37,50,-13,32
Wellington P,3628,9,5,6,16,31,55,-24,21
CC Mariners,3628,10,4,8,15,28,49,-21,20
Sydney FC,3629,1,21,4,3,66,23,43,67
N'castle Jet,3629,2,16,5,7,58,37,21,53
Melbourne C,3629,3,14,4,11,43,34,9,46
Melbourne V,3629,4,13,5,11,46,40,6,44
Adelaide Utd,3629,5,11,6,11,37,40,-3,39
Brisbane,3629,6,10,5,13,33,42,-9,35
Western Sydn,3629,7,8,9,10,38,47,-9,33
Perth Glory,3629,8,10,2,15,37,50,-13,32
Wellington P,3629,9,5,6,16,31,55,-24,21
CC Mariners,3629,10,4,8,15,28,49,-21,20
Sydney FC,3630,1,20,4,4,64,23,41,64
N'castle Jet,3630,2,16,5,7,60,37,23,53
Melbourne V,3630,3,14,5,10,46,38,8,47
Melbourne C,3630,4,14,4,11,43,36,7,46
Adelaide Utd,3630,5,11,6,11,37,40,-3,39
Brisbane,3630,6,10,5,13,33,42,-9,35
Western Sydn,3630,7,8,9,10,38,47,-9,33
Perth Glory,3630,8,10,2,15,37,50,-13,32
Wellington P,3630,9,5,6,16,31,55,-24,21
CC Mariners,3630,10,4,8,15,28,49,-21,20
Sydney FC,3631,1,21,4,3,66,23,43,67
N'castle Jet,3631,2,15,5,8,57,39,18,50
Melbourne C,3631,3,15,4,10,45,33,12,49
Melbourne V,3631,4,13,5,11,46,40,6,44
Adelaide Utd,3631,5,11,6,11,37,40,-3,39
Brisbane,3631,6,10,5,13,33,42,-9,35
Western Sydn,3631,7,8,9,10,38,47,-9,33
Perth Glory,3631,8,10,2,15,37,50,-13,32
Wellington P,3631,9,5,6,16,31,55,-24,21
CC Mariners,3631,10,4,8,15,28,49,-21,20
Sydney FC,3632,1,21,4,3,67,23,44,67
N'castle Jet,3632,2,16,5,7,59,38,21,53
Melbourne C,3632,3,14,4,11,44,35,9,46
Melbourne V,3632,4,13,5,11,46,41,5,44
Adelaide Utd,3632,5,11,6,11,37,40,-3,39
Brisbane,3632,6,10,5,13,33,42,-9,35
Western Sydn,3632,7,8,9,10,38,47,-9,33
Perth Glory,3632,8,10,2,15,37,50,-13,32
Wellington P,3632,9,5,6,16,31,55,-24,21
CC Mariners,3632,10,4,8,15,28,49,-21,20
Sydney FC,3633,1,21,4,3,67,22,45,67
N'castle Jet,3633,2,15,5,8,58,39,19,50
Melbourne C,3633,3,15,4,10,45,34,11,49
Melbourne V,3633,4,13,5,11,45,41,4,44
Adelaide Utd,3633,5,11,6,11,37,40,-3,39
Brisbane,3633,6,10,5,13,33,42,-9,35
Western Sydn,3633,7,8,9,10,38,47,-9,33
Perth Glory,3633,8,10,2,15,37,50,-13,32
Wellington P,3633,9,5,6,16,31,55,-24,21
CC Mariners,3633,10,4,8,15,28,49,-21,20
Sydney FC,3634,1,20,4,4,65,24,41,64
N'castle Jet,3634,2,16,5,7,59,37,22,53
Melbourne V,3634,3,14,5,10,47,39,8,47
Melbourne C,3634,4,14,4,11,43,35,8,46
Adelaide Utd,3634,5,11,6,11,37,40,-3,39
Brisbane,3634,6,10,5,13,33,42,-9,35
Western Sydn,3634,7,8,9,10,38,47,-9,33
Perth Glory,3634,8,10,2,15,37,50,-13,32
Wellington P,3634,9,5,6,16,31,55,-24,21
CC Mariners,3634,10,4,8,15,28,49,-21,20
Sydney FC,3635,1,21,4,3,65,22,43,67
N'castle Jet,3635,2,16,5,7,58,37,21,53
Melbourne C,3635,3,14,4,11,43,34,9,46
Melbourne V,3635,4,13,5,11,45,39,6,44
Adelaide Utd,3635,5,11,6,11,37,40,-3,39
Brisbane,3635,6,10,5,13,33,42,-9,35
Western Sydn,3635,7,8,9,10,38,47,-9,33
Perth Glory,3635,8,10,2,15,37,50,-13,32
Wellington P,3635,9,5,6,16,31,55,-24,21
CC Mariners,3635,10,4,8,15,28,49,-21,20
Sydney FC,3636,1,21,4,3,68,22,46,67
N'castle Jet,3636,2,16,5,7,59,37,22,53
Melbourne C,3636,3,14,4,11,43,35,8,46
Melbourne V,3636,4,13,5,11,45,42,3,44
Adelaide Utd,3636,5,11,6,11,37,40,-3,39
Brisbane,3636,6,10,5,13,33,42,-9,35
Western Sydn,3636,7,8,9,10,38,47,-9,33
Perth Glory,3636,8,10,2,15,37,50,-13,32
Wellington P,3636,9,5,6,16,31,55,-24,21
CC Mariners,3636,10,4,8,15,28,49,-21,20
Sydney FC,3637,1,20,4,4,65,24,41,64
N'castle Jet,3637,2,15,6,7,59,39,20,51
Melbourne C,3637,3,14,5,10,45,35,10,47
Melbourne V,3637,4,14,5,10,47,39,8,47
Adelaide Utd,3637,5,11,6,11,37,40,-3,39
Brisbane,3637,6,10,5,13,33,42,-9,35
Western Sydn,3637,7,8,9,10,38,47,-9,33
Perth Glory,3637,8,10,2,15,37,50,-13,32
Wellington P,3637,9,5,6,16,31,55,-24,21
CC Mariners,3637,10,4,8,15,28,49,-21,20
Sydney FC,3638,1,21,4,3,67,22,45,67
N'castle Jet,3638,2,15,6,7,58,38,20,51
Melbourne C,3638,3,14,5,10,44,34,10,47
Melbourne V,3638,4,13,5,11,45,41,4,44
Adelaide Utd,3638,5,11,6,11,37,40,-3,39
Brisbane,3638,6,10,5,13,33,42,-9,35
Western Sydn,3638,7,8,9,10,38,47,-9,33
Perth Glory,3638,8,10,2,15,37,50,-13,32
Wellington P,3638,9,5,6,16,31,55,-24,21
CC Mariners,3638,10,4,8,15,28,49,-21,20
Sydney FC,3639,1,21,4,3,67,22,45,67
N'castle Jet,3639,2,16,5,7,59,38,21,53
Melbourne C,3639,3,14,4,11,44,35,9,46
Melbourne V,3639,4,13,5,11,45,41,4,44
Adelaide Utd,3639,5,11,6,11,37,40,-3,39
Brisbane,3639,6,10,5,13,33,42,-9,35
Western Sydn,3639,7,8,9,10,38,47,-9,33
Perth Glory,3639,8,10,2,15,37,50,-13,32
Wellington P,3639,9,5,6,16,31,55,-24,21
CC Mariners,3639,10,4,8,15,28,49,-21,20
Sydney FC,3640,1,20,5,3,66,24,42,65
N'castle Jet,3640,2,15,6,7,57,37,20,51
Melbourne C,3640,3,14,5,10,43,33,10,47
Melbourne V,3640,4,13,6,10,47,40,7,45
Adelaide Utd,3640,5,11,6,11,37,40,-3,39
Brisbane,3640,6,10,5,13,33,42,-9,35
Western Sydn,3640,7,8,9,10,38,47,-9,33
Perth Glory,3640,8,10,2,15,37,50,-13,32
Wellington P,3640,9,5,6,16,31,55,-24,21
CC Mariners,3640,10,4,8,15,28,49,-21,20
Sydney FC,3641,1,20,4,4,64,23,41,64
N'castle Jet,3641,2,16,5,7,59,38,21,53
Melbourne V,3641,3,14,5,10,46,38,8,47
Melbourne C,3641,4,14,4,11,44,35,9,46
Adelaide Utd,3641,5,11,6,11,37,40,-3,39
Brisbane,3641,6,10,5,13,33,42,-9,35
Western Sydn,3641,7,8,9,10,38,47,-9,33
Perth Glory,3641,8,10,2,15,37,50,-13,32
Wellington P,3641,9,5,6,16,31,55,-24,21
CC Mariners,3641,10,4,8,15,28,49,-21,20
Sydney FC,3642,1,20,5,3,64,22,42,65
N'castle Jet,3642,2,15,6,7,59,39,20,51
Melbourne C,3642,3,14,5,10,45,35,10,47
Melbourne V,3642,4,13,6,10,45,38,7,45
Adelaide Utd,3642,5,11,6,11,37,40,-3,39
Brisbane,3642,6,10,5,13,33,42,-9,35
Western Sydn,3642,7,8,9,10,38,47,-9,33
Perth Glory,3642,8,10,2,15,37,50,-13,32
Wellington P,3642,9,5,6,16,31,55,-24,21
CC Mariners,3642,10,4,8,15,28,49,-21,20
Sydney FC,3643,1,21,4,3,65,22,43,67
N'castle Jet,3643,2,15,6,7,59,39,20,51
Melbourne C,3643,3,14,5,10,45,35,10,47
Melbourne V,3643,4,13,5,11,45,39,6,44
Adelaide Utd,3643,5,11,6,11,37,40,-3,39
Brisbane,3643,6,10,5,13,33,42,-9,35
Western Sydn,3643,7,8,9,10,38,47,-9,33
Perth Glory,3643,8,10,2,15,37,50,-13,32
Wellington P,3643,9,5,6,16,31,55,-24,21
CC Mariners,3643,10,4,8,15,28,49,-21,20
Sydney FC,3644,1,20,4,4,66,25,41,64
N'castle Jet,3644,2,15,5,8,58,40,18,50
Melbourne C,3644,3,15,4,10,46,34,12,49
Melbourne V,3644,4,14,5,10,48,40,8,47
Adelaide Utd,3644,5,11,6,11,37,40,-3,39
Brisbane,3644,6,10,5,13,33,42,-9,35
Western Sydn,3644,7,8,9,10,38,47,-9,33
Perth Glory,3644,8,10,2,15,37,50,-13,32
Wellington P,3644,9,5,6,16,31,55,-24,21
CC Mariners,3644,10,4,8,15,28,49,-21,20
Sydney FC,3645,1,21,4,3,67,23,44,67
N'castle Jet,3645,2,16,5,7,59,38,21,53
Melbourne C,3645,3,14,4,11,44,35,9,46
Melbourne V,3645,4,13,5,11,46,41,5,44
Adelaide Utd,3645,5,11,6,11,37,40,-3,39
Brisbane,3645,6,10,5,13,33,42,-9,35
Western Sydn,3645,7,8,9,10,38,47,-9,33
Perth Glory,3645,8,10,2,15,37,50,-13,32
Wellington P,3645,9,5,6,16,31,55,-24,21
CC Mariners,3645,10,4,8,15,28,49,-21,20
Sydney FC,3646,1,21,4,3,66,23,43,67
N'castle Jet,3646,2,16,5,7,60,39,21,53
Melbourne C,3646,3,14,4,11,45,36,9,46
Melbourne V,3646,4,13,5,11,46,40,6,44
Adelaide Utd,3646,5,11,6,11,37,40,-3,39
Brisbane,3646,6,10,5,13,33,42,-9,35
Western Sydn,3646,7,8,9,10,38,47,-9,33
Perth Glory,3646,8,10,2,15,37,50,-13,32
Wellington P,3646,9,5,6,16,31,55,-24,21
CC Mariners,3646,10,4,8,15,28,49,-21,20
Sydney FC,3647,1,21,4,3,68,22,46,67
N'castle Jet,3647,2,15,6,7,58,38,20,51
Melbourne C,3647,3,14,5,10,44,34,10,47
Melbourne V,3647,4,13,5,11,45,42,3,44
Adelaide Utd,3647,5,11,6,11,37,40,-3,39
Brisbane,3647,6,10,5,13,33,42,-9,35
Western Sydn,3647,7,8,9,10,38,47,-9,33
Perth Glory,3647,8,10,2,15,37,50,-13,32
Wellington P,3647,9,5,6,16,31,55,-24,21
CC Mariners,3647,10,4,8,15,28,49,-21,20
Sydney FC,3648,1,21,4,3,67,23,44,67
N'castle Jet,3648,2,15,5,8,57,39,18,50
Melbourne C,3648,3,15,4,10,45,33,12,49
Melbourne V,3648,4,13,5,11,46,41,5,44
Adelaide Utd,3648,5,11,6,11,37,40,-3,39
Brisbane,3648,6,10,5,13,33,42,-9,35
Western Sydn,3648,7,8,9,10,38,47,-9,33
Perth Glory,3648,8,10,2,15,37,50,-13,32
Wellington P,3648,9,5,6,16,31,55,-24,21
CC Mariners,3648,10,4,8,15,28,49,-21,20
Sydney FC,3649,1,21,4,3,66,22,44,67
N'castle Jet,3649,2,15,5,8,57,38,19,50
Melbourne C,3649,3,15,4,10,44,33,11,49
Melbourne V,3649,4,13,5,11,45,40,5,44
Adelaide Utd,3649,5,11,6,11,37,40,-3,39
Brisbane,3649,6,10,5,13,33,42,-9,35
Western Sydn,3649,7,8,9,10,38,47,-9,33
Perth Glory,3649,8,10,2,15,37,50,-13,32
Wellington P,3649,9,5,6,16,31,55,-24,21
CC Mariners,3649,10,4,8,15,28,49,-21,20
Sydney FC,3650,1,21,4,3,66,23,43,67
N'castle Jet,3650,2,16,5,7,59,38,21,53
Melbourne C,3650,3,14,4,11,44,35,9,46
Melbourne V,3650,4,13,5,11,46,40,6,44
Adelaide Utd,3650,5,11,6,11,37,40,-3,39
Brisbane,3650,6,10,5,13,33,42,-9,35
Western Sydn,3650,7,8,9,10,38,47,-9,33
Perth Glory,3650,8,10,2,15,37,50,-13,32
Wellington P,3650,9,5,6,16,31,55,-24,21
CC Mariners,3650,10,4,8,15,28,49,-21,20
Sydney FC,3651,1,20,4,4,64,25,39,64
N'castle Jet,3651,2,16,5,7,58,37,21,53
Melbourne V,3651,3,14,5,10,48,38,10,47
Melbourne C,3651,4,14,4,11,43,34,9,46
Adelaide Utd,3651,5,11,6,11,37,40,-3,39
Brisbane,3651,6,10,5,13,33,42,-9,35
Western Sydn,3651,7,8,9,10,38,47,-9,33
Perth Glory,3651,8,10,2,15,37,50,-13,32
Wellington P,3651,9,5,6,16,31,55,-24,21
CC Mariners,3651,10,4,8,15,28,49,-21,20
Sydney FC,3652,1,21,4,3,68,23,45,67
N'castle Jet,3652,2,15,6,7,58,38,20,51
Melbourne C,3652,3,14,5,10,44,34,10,47
Melbourne V,3652,4,13,5,11,46,42,4,44
Adelaide Utd,3652,5,11,6,11,37,40,-3,39
Brisbane,3652,6,10,5,13,33,42,-9,35
Western Sydn,3652,7,8,9,10,38,47,-9,33
Perth Glory,3652,8,10,2,15,37,50,-13,32
Wellington P,3652,9,5,6,16,31,55,-24,21
CC Mariners,3652,10,4,8,15,28,49,-21,20
Sydney FC,3653,1,21,4,3,68,25,43,67
N'castle Jet,3653,2,16,5,7,59,37,22,53
Melbourne C,3653,3,14,4,11,43,35,8,46
Melbourne V,3653,4,13,5,11,48,42,6,44
Adelaide Utd,3653,5,11,6,11,37,40,-3,39
Brisbane,3653,6,10,5,13,33,42,-9,35
Western Sydn,3653,7,8,9,10,38,47,-9,33
Perth Glory,3653,8,10,2,15,37,50,-13,32
Wellington P,3653,9,5,6,16,31,55,-24,21
CC Mariners,3653,10,4,8,15,28,49,-21,20
Sydney FC,3654,1,21,4,3,67,23,44,67
N'castle Jet,3654,2,16,5,7,59,38,21,53
Melbourne C,3654,3,14,4,11,44,35,9,46
Melbourne V,3654,4,13,5,11,46,41,5,44
Adelaide Utd,3654,5,11,6,11,37,40,-3,39
Brisbane,3654,6,10,5,13,33,42,-9,35
Western Sydn,3654,7,8,9,10,38,47,-9,33
Perth Glory,3654,8,10,2,15,37,50,-13,32
Wellington P,3654,9,5,6,16,31,55,-24,21
CC Mariners,3654,10,4,8,15,28,49,-21,20
Sydney FC,3655,1,20,5,3,68,26,42,65
N'castle Jet,3655,2,16,5,7,58,37,21,53
Melbourne C,3655,3,14,4,11,43,34,9,46
Melbourne V,3655,4,13,6,10,49,42,7,45
Adelaide Utd,3655,5,11,6,11,37,40,-3,39
Brisbane,3655,6,10,5,13,33,42,-9,35
Western Sydn,3655,7,8,9,10,38,47,-9,33
Perth Glory,3655,8,10,2,15,37,50,-13,32
Wellington P,3655,9,5,6,16,31,55,-24,21
CC Mariners,3655,10,4,8,15,28,49,-21,20
Sydney FC,3656,1,21,4,3,67,24,43,67
N'castle Jet,3656,2,16,5,7,60,39,21,53
Melbourne C,3656,3,14,4,11,45,36,9,46
Melbourne V,3656,4,13,5,11,47,41,6,44
Adelaide Utd,3656,5,11,6,11,37,40,-3,39
Brisbane,3656,6,10,5,13,33,42,-9,35
Western Sydn,3656,7,8,9,10,38,47,-9,33
Perth Glory,3656,8,10,2,15,37,50,-13,32
Wellington P,3656,9,5,6,16,31,55,-24,21
CC Mariners,3656,10,4,8,15,28,49,-21,20
Sydney FC,3657,1,20,4,4,65,24,41,64
N'castle Jet,3657,2,16,5,7,59,37,22,53
Melbourne V,3657,3,14,5,10,47,39,8,47
Melbourne C,3657,4,14,4,11,43,35,8,46
Adelaide Utd,3657,5,11,6,11,37,40,-3,39
Brisbane,3657,6,10,5,13,33,42,-9,35
Western Sydn,3657,7,8,9,10,38,47,-9,33
Perth Glory,3657,8,10,2,15,37,50,-13,32
Wellington P,3657,9,5,6,16,31,55,-24,21
CC Mariners,3657,10,4,8,15,28,49,-21,20
Sydney FC,3658,1,21,4,3,66,23,43,67
N'castle Jet,3658,2,16,5,7,59,38,21,53
Melbourne C,3658,3,14,4,11,44,35,9,46
Melbourne V,3658,4,13,5,11,46,40,6,44
Adelaide Utd,3658,5,11,6,11,37,40,-3,39
Brisbane,3658,6,10,5,13,33,42,-9,35
Western Sydn,3658,7,8,9,10,38,47,-9,33
Perth Glory,3658,8,10,2,15,37,50,-13,32
Wellington P,3658,9,5,6,16,31,55,-24,21
CC Mariners,3658,10,4,8,15,28,49,-21,20
Sydney FC,3659,1,20,5,3,65,23,42,65
N'castle Jet,3659,2,15,6,7,57,37,20,51
Melbourne C,3659,3,14,5,10,43,33,10,47
Melbourne V,3659,4,13,6,10,46,39,7,45
Adelaide Utd,3659,5,11,6,11,37,40,-3,39
Brisbane,3659,6,10,5,13,33,42,-9,35
Western Sydn,3659,7,8,9,10,38,47,-9,33
Perth Glory,3659,8,10,2,15,37,50,-13,32
Wellington P,3659,9,5,6,16,31,55,-24,21
CC Mariners,3659,10,4,8,15,28,49,-21,20
Sydney FC,3660,1,20,4,4,65,25,40,64
N'castle Jet,3660,2,15,5,8,57,39,18,50
Melbourne C,3660,3,15,4,10,45,33,12,49
Melbourne V,3660,4,14,5,10,48,39,9,47
Adelaide Utd,3660,5,11,6,11,37,40,-3,39
Brisbane,3660,6,10,5,13,33,42,-9,35
Western Sydn,3660,7,8,9,10,38,47,-9,33
Perth Glory,3660,8,10,2,15,37,50,-13,32
Wellington P,3660,9,5,6,16,31,55,-24,21
CC Mariners,3660,10,4,8,15,28,49,-21,20
Sydney FC,3661,1,20,4,4,65,24,41,64
N'castle Jet,3661,2,16,5,7,60,39,21,53
Melbourne V,3661,3,14,5,10,47,39,8,47
Melbourne C,3661,4,14,4,11,45,36,9,46
Adelaide Utd,3661,5,11,6,11,37,40,-3,39
Brisbane,3661,6,10,5,13,33,42,-9,35
Western Sydn,3661,7,8,9,10,38,47,-9,33
Perth Glory,3661,8,10,2,15,37,50,-13,32
Wellington P,3661,9,5,6,16,31,55,-24,21
CC Mariners,3661,10,4,8,15,28,49,-21,20
Sydney FC,3662,1,21,4,3,65,22,43,67
N'castle Jet,3662,2,15,5,8,59,40,19,50
Melbourne C,3662,3,15,4,10,46,35,11,49
Melbourne V,3662,4,13,5,11,45,39,6,44
Adelaide Utd,3662,5,11,6,11,37,40,-3,39
Brisbane,3662,6,10,5,13,33,42,-9,35
Western Sydn,3662,7,8,9,10,38,47,-9,33
Perth Glory,3662,8,10,2,15,37,50,-13,32
Wellington P,3662,9,5,6,16,31,55,-24,21
CC Mariners,3662,10,4,8,15,28,49,-21,20
Sydney FC,3663,1,21,4,3,68,22,46,67
N'castle Jet,3663,2,16,5,7,60,38,22,53
Melbourne C,3663,3,14,4,11,44,36,8,46
Melbourne V,3663,4,13,5,11,45,42,3,44
Adelaide Utd,3663,5,11,6,11,37,40,-3,39
Brisbane,3663,6,10,5,13,33,42,-9,35
Western Sydn,3663,7,8,9,10,38,47,-9,33
Perth Glory,3663,8,10,2,15,37,50,-13,32
Wellington P,3663,9,5,6,16,31,55,-24,21
CC Mariners,3663,10,4,8,15,28,49,-21,20
Sydney FC,3664,1,20,5,3,64,22,42,65
N'castle Jet,3664,2,16,5,7,61,39,22,53
Melbourne C,3664,3,14,4,11,45,37,8,46
Melbourne V,3664,4,13,6,10,45,38,7,45
Adelaide Utd,3664,5,11,6,11,37,40,-3,39
Brisbane,3664,6,10,5,13,33,42,-9,35
Western Sydn,3664,7,8,9,10,38,47,-9,33
Perth Glory,3664,8,10,2,15,37,50,-13,32
Wellington P,3664,9,5,6,16,31,55,-24,21
CC Mariners,3664,10,4,8,15,28,49,-21,20
Sydney FC,3665,1,20,4,4,66,25,41,64
N'castle Jet,3665,2,15,5,8,58,39,19,50
Melbourne C,3665,3,15,4,10,45,34,11,49
Melbourne V,3665,4,14,5,10,48,40,8,47
Adelaide Utd,3665,5,11,6,11,37,40,-3,39
Brisbane,3665,6,10,5,13,33,42,-9,35
Western Sydn,3665,7,8,9,10,38,47,-9,33
Perth Glory,3665,8,10,2,15,37,50,-13,32
Wellington P,3665,9,5,6,16,31,55,-24,21
CC Mariners,3665,10,4,8,15,28,49,-21,20
Sydney FC,3666,1,20,4,4,64,23,41,64
N'castle Jet,3666,2,16,5,7,59,37,22,53
Melbourne V,3666,3,14,5,10,46,38,8,47
Melbourne C,3666,4,14,4,11,43,35,8,46
Adelaide Utd,3666,5,11,6,11,37,40,-3,39
Brisbane,3666,6,10,5,13,33,42,-9,35
Western Sydn,3666,7,8,9,10,38,47,-9,33
Perth Glory,3666,8,10,2,15,37,50,-13,32
Wellington P,3666,9,5,6,16,31,55,-24,21
CC Mariners,3666,10,4,8,15,28,49,-21,20
Sydney FC,3667,1,20,5,3,65,23,42,65
N'castle Jet,3667,2,16,5,7,62,37,25,53
Melbourne C,3667,3,14,4,11,43,38,5,46
Melbourne V,3667,4,13,6,10,46,39,7,45
Adelaide Utd,3667,5,11,6,11,37,40,-3,39
Brisbane,3667,6,10,5,13,33,42,-9,35
Western Sydn,3667,7,8,9,10,38,47,-9,33
Perth Glory,3667,8,10,2,15,37,50,-13,32
Wellington P,3667,9,5,6,16,31,55,-24,21
CC Mariners,3667,10,4,8,15,28,49,-21,20
Sydney FC,3668,1,21,4,3,67,22,45,67
N'castle Jet,3668,2,16,5,7,60,38,22,53
Melbourne C,3668,3,14,4,11,44,36,8,46
Melbourne V,3668,4,13,5,11,45,41,4,44
Adelaide Utd,3668,5,11,6,11,37,40,-3,39
Brisbane,3668,6,10,5,13,33,42,-9,35
Western Sydn,3668,7,8,9,10,38,47,-9,33
Perth Glory,3668,8,10,2,15,37,50,-13,32
Wellington P,3668,9,5,6,16,31,55,-24,21
CC Mariners,3668,10,4,8,15,28,49,-21,20
Sydney FC,3669,1,21,4,3,67,22,45,67
N'castle Jet,3669,2,16,5,7,59,38,21,53
Melbourne C,3669,3,14,4,11,44,35,9,46
Melbourne V,3669,4,13,5,11,45,41,4,44
Adelaide Utd,3669,5,11,6,11,37,40,-3,39
Brisbane,3669,6,10,5,13,33,42,-9,35
Western Sydn,3669,7,8,9,10,38,47,-9,33
Perth Glory,3669,8,10,2,15,37,50,-13,32
Wellington P,3669,9,5,6,16,31,55,-24,21
CC Mariners,3669,10,4,8,15,28,49,-21,20
Sydney FC,3670,1,21,4,3,67,22,45,67
N'castle Jet,3670,2,15,5,8,58,40,18,50
Melbourne C,3670,3,15,4,10,46,34,12,49
Melbourne V,3670,4,13,5,11,45,41,4,44
Adelaide Utd,3670,5,11,6,11,37,40,-3,39
Brisbane,3670,6,10,5,13,33,42,-9,35
Western Sydn,3670,7,8,9,10,38,47,-9,33
Perth Glory,3670,8,10,2,15,37,50,-13,32
Wellington P,3670,9,5,6,16,31,55,-24,21
CC Mariners,3670,10,4,8,15,28,49,-21,20
Sydney FC,3671,1,21,4,3,67,22,45,67
N'castle Jet,3671,2,16,5,7,60,37,23,53
Melbourne C,3671,3,14,4,11,43,36,7,46
Melbourne V,3671,4,13,5,11,45,41,4,44
Adelaide Utd,3671,5,11,6,11,37,40,-3,39
Brisbane,3671,6,10,5,13,33,42,-9,35
Western Sydn,3671,7,8,9,10,38,47,-9,33
Perth Glory,3671,8,10,2,15,37,50,-13,32
Wellington P,3671,9,5,6,16,31,55,-24,21
CC Mariners,3671,10,4,8,15,28,49,-21,20
Sydney FC,3672,1,21,4,3,67,24,43,67
N'castle Jet,3672,2,15,5,8,57,38,19,50
Melbourne C,3672,3,15,4,10,44,33,11,49
Melbourne V,3672,4,13,5,11,47,41,6,44
Adelaide Utd,3672,5,11,6,11,37,40,-3,39
Brisbane,3672,6,10,5,13,33,42,-9,35
Western Sydn,3672,7,8,9,10,38,47,-9,33
Perth Glory,3672,8,10,2,15,37,50,-13,32
Wellington P,3672,9,5,6,16,31,55,-24,21
CC Mariners,3672,10,4,8,15,28,49,-21,20
Sydney FC,3673,1,21,4,3,65,22,43,67
N'castle Jet,3673,2,15,5,8,59,40,19,50
Melbourne C,3673,3,15,4,10,46,35,11,49
Melbourne V,3673,4,13,5,11,45,39,6,44
Adelaide Utd,3673,5,11,6,11,37,40,-3,39
Brisbane,3673,6,10,5,13,33,42,-9,35
Western Sydn,3673,7,8,9,10,38,47,-9,33
Perth Glory,3673,8,10,2,15,37,50,-13,32
Wellington P,3673,9,5,6,16,31,55,-24,21
CC Mariners,3673,10,4,8,15,28,49,-21,20
Sydney FC,3674,1,21,4,3,65,22,43,67
N'castle Jet,3674,2,16,5,7,60,38,22,53
Melbourne C,3674,3,14,4,11,44,36,8,46
Melbourne V,3674,4,13,5,11,45,39,6,44
Adelaide Utd,3674,5,11,6,11,37,40,-3,39
Brisbane,3674,6,10,5,13,33,42,-9,35
Western Sydn,3674,7,8,9,10,38,47,-9,33
Perth Glory,3674,8,10,2,15,37,50,-13,32
Wellington P,3674,9,5,6,16,31,55,-24,21
CC Mariners,3674,10,4,8,15,28,49,-21,20
Sydney FC,3675,1,21,4,3,68,22,46,67
N'castle Jet,3675,2,15,6,7,58,38,20,51
Melbourne C,3675,3,14,5,10,44,34,10,47
Melbourne V,3675,4,13,5,11,45,42,3,44
Adelaide Utd,3675,5,11,6,11,37,40,-3,39
Brisbane,3675,6,10,5,13,33,42,-9,35
Western Sydn,3675,7,8,9,10,38,47,-9,33
Perth Glory,3675,8,10,2,15,37,50,-13,32
Wellington P,3675,9,5,6,16,31,55,-24,21
CC Mariners,3675,10,4,8,15,28,49,-21,20
Sydney FC,3676,1,21,4,3,66,23,43,67
N'castle Jet,3676,2,16,5,7,58,37,21,53
Melbourne C,3676,3,14,4,11,43,34,9,46
Melbourne V,3676,4,13,5,11,46,40,6,44
Adelaide Utd,3676,5,11,6,11,37,40,-3,39
Brisbane,3676,6,10,5,13,33,42,-9,35
Western Sydn,3676,7,8,9,10,38,47,-9,33
Perth Glory,3676,8,10,2,15,37,50,-13,32
Wellington P,3676,9,5,6,16,31,55,-24,21
CC Mariners,3676,10,4,8,15,28,49,-21,20
Sydney FC,3677,1,21,4,3,66,22,44,67
N'castle Jet,3677,2,16,5,7,59,38,21,53
Melbourne C,3677,3,14,4,11,44,35,9,46
Melbourne V,3677,4,13,5,11,45,40,5,44
Adelaide Utd,3677,5,11,6,11,37,40,-3,39
Brisbane,3677,6,10,5,13,33,42,-9,35
Western Sydn,3677,7,8,9,10,38,47,-9,33
Perth Glory,3677,8,10,2,15,37,50,-13,32
Wellington P,3677,9,5,6,16,31,55,-24,21
CC Mariners,3677,10,4,8,15,28,49,-21,20
Sydney FC,3678,1,20,5,3,64,22,42,65
N'castle Jet,3678,2,15,5,8,58,39,19,50
Melbourne C,3678,3,15,4,10,45,34,11,49
Melbourne V,3678,4,13,6,10,45,38,7,45
Adelaide Utd,3678,5,11,6,11,37,40,-3,39
Brisbane,3678,6,10,5,13,33,42,-9,35
Western Sydn,3678,7,8,9,10,38,47,-9,33
Perth Glory,3678,8,10,2,15,37,50,-13,32
Wellington P,3678,9,5,6,16,31,55,-24,21
CC Mariners,3678,10,4,8,15,28,49,-21,20
Sydney FC,3679,1,20,5,3,66,24,42,65
N'castle Jet,3679,2,15,6,7,58,38,20,51
Melbourne C,3679,3,14,5,10,44,34,10,47
Melbourne V,3679,4,13,6,10,47,40,7,45
Adelaide Utd,3679,5,11,6,11,37,40,-3,39
Brisbane,3679,6,10,5,13,33,42,-9,35
Western Sydn,3679,7,8,9,10,38,47,-9,33
Perth Glory,3679,8,10,2,15,37,50,-13,32
Wellington P,3679,9,5,6,16,31,55,-24,21
CC Mariners,3679,10,4,8,15,28,49,-21,20
Sydney FC,3680,1,21,4,3,68,22,46,67
N'castle Jet,3680,2,16,5,7,58,37,21,53
Melbourne C,3680,3,14,4,11,43,34,9,46
Melbourne V,3680,4,13,5,11,45,42,3,44
Adelaide Utd,3680,5,11,6,11,37,40,-3,39
Brisbane,3680,6,10,5,13,33,42,-9,35
Western Sydn,3680,7,8,9,10,38,47,-9,33
Perth Glory,3680,8,10,2,15,37,50,-13,32
Wellington P,3680,9,5,6,16,31,55,-24,21
CC Mariners,3680,10,4,8,15,28,49,-21,20
Sydney FC,3681,1,21,4,3,67,24,43,67
N'castle Jet,3681,2,15,5,8,57,39,18,50
Melbourne C,3681,3,15,4,10,45,33,12,49
Melbourne V,3681,4,13,5,11,47,41,6,44
Adelaide Utd,3681,5,11,6,11,37,40,-3,39
Brisbane,3681,6,10,5,13,33,42,-9,35
Western Sydn,3681,7,8,9,10,38,47,-9,33
Perth Glory,3681,8,10,2,15,37,50,-13,32
Wellington P,3681,9,5,6,16,31,55,-24,21
CC Mariners,3681,10,4,8,15,28,49,-21,20
Sydney FC,3682,1,21,4,3,67,22,45,67
N'castle Jet,3682,2,15,5,8,58,39,19,50
Melbourne C,3682,3,15,4,10,45,34,11,49
Melbourne V,3682,4,13,5,11,45,41,4,44
Adelaide Utd,3682,5,11,6,11,37,40,-3,39
Brisbane,3682,6,10,5,13,33,42,-9,35
Western Sydn,3682,7,8,9,10,38,47,-9,33
Perth Glory,3682,8,10,2,15,37,50,-13,32
Wellington P,3682,9,5,6,16,31,55,-24,21
CC Mariners,3682,10,4,8,15,28,49,-21,20
Sydney FC,3683,1,20,4,4,64,23,41,64
N'castle Jet,3683,2,15,6,7,58,38,20,51
Melbourne C,3683,3,14,5,10,44,34,10,47
Melbourne V,3683,4,14,5,10,46,38,8,47
Adelaide Utd,3683,5,11,6,11,37,40,-3,39
Brisbane,3683,6,10,5,13,33,42,-9,35
Western Sydn,3683,7,8,9,10,38,47,-9,33
Perth Glory,3683,8,10,2,15,37,50,-13,32
Wellington P,3683,9,5,6,16,31,55,-24,21
CC Mariners,3683,10,4,8,15,28,49,-21,20
Sydney FC,3684,1,21,4,3,67,24,43,67
N'castle Jet,3684,2,15,6,7,57,37,20,51
Melbourne C,3684,3,14,5,10,43,33,10,47
Melbourne V,3684,4,13,5,11,47,41,6,44
Adelaide Utd,3684,5,11,6,11,37,40,-3,39
Brisbane,3684,6,10,5,13,33,42,-9,35
Western Sydn,3684,7,8,9,10,38,47,-9,33
Perth Glory,3684,8,10,2,15,37,50,-13,32
Wellington P,3684,9,5,6,16,31,55,-24,21
CC Mariners,3684,10,4,8,15,28,49,-21,20
Sydney FC,3685,1,21,4,3,66,22,44,67
N'castle Jet,3685,2,16,5,7,59,37,22,53
Melbourne C,3685,3,14,4,11,43,35,8,46
Melbourne V,3685,4,13,5,11,45,40,5,44
Adelaide Utd,3685,5,11,6,11,37,40,-3,39
Brisbane,3685,6,10,5,13,33,42,-9,35
Western Sydn,3685,7,8,9,10,38,47,-9,33
Perth Glory,3685,8,10,2,15,37,50,-13,32
Wellington P,3685,9,5,6,16,31,55,-24,21
CC Mariners,3685,10,4,8,15,28,49,-21,20
Sydney FC,3686,1,21,4,3,67,23,44,67
N'castle Jet,3686,2,15,6,7,58,38,20,51
Melbourne C,3686,3,14,5,10,44,34,10,47
Melbourne V,3686,4,13,5,11,46,41,5,44
Adelaide Utd,3686,5,11,6,11,37,40,-3,39
Brisbane,3686,6,10,5,13,33,42,-9,35
Western Sydn,3686,7,8,9,10,38,47,-9,33
Perth Glory,3686,8,10,2,15,37,50,-13,32
Wellington P,3686,9,5,6,16,31,55,-24,21
CC Mariners,3686,10,4,8,15,28,49,-21,20
Sydney FC,3687,1,21,4,3,70,23,47,67
N'castle Jet,3687,2,16,5,7,60,39,21,53
Melbourne C,3687,3,14,4,11,45,36,9,46
Melbourne V,3687,4,13,5,11,46,44,2,44
Adelaide Utd,3687,5,11,6,11,37,40,-3,39
Brisbane,3687,6,10,5,13,33,42,-9,35
Western Sydn,3687,7,8,9,10,38,47,-9,33
Perth Glory,3687,8,10,2,15,37,50,-13,32
Wellington P,3687,9,5,6,16,31,55,-24,21
CC Mariners,3687,10,4,8,15,28,49,-21,20
Sydney FC,3688,1,21,4,3,67,23,44,67
N'castle Jet,3688,2,15,6,7,58,38,20,51
Melbourne C,3688,3,14,5,10,44,34,10,47
Melbourne V,3688,4,13,5,11,46,41,5,44
Adelaide Utd,3688,5,11,6,11,37,40,-3,39
Brisbane,3688,6,10,5,13,33,42,-9,35
Western Sydn,3688,7,8,9,10,38,47,-9,33
Perth Glory,3688,8,10,2,15,37,50,-13,32
Wellington P,3688,9,5,6,16,31,55,-24,21
CC Mariners,3688,10,4,8,15,28,49,-21,20
Sydney FC,3689,1,21,4,3,65,22,43,67
N'castle Jet,3689,2,16,5,7,60,38,22,53
Melbourne C,3689,3,14,4,11,44,36,8,46
Melbourne V,3689,4,13,5,11,45,39,6,44
Adelaide Utd,3689,5,11,6,11,37,40,-3,39
Brisbane,3689,6,10,5,13,33,42,-9,35
Western Sydn,3689,7,8,9,10,38,47,-9,33
Perth Glory,3689,8,10,2,15,37,50,-13,32
Wellington P,3689,9,5,6,16,31,55,-24,21
CC Mariners,3689,10,4,8,15,28,49,-21,20
Sydney FC,3690,1,20,5,3,65,23,42,65
N'castle Jet,3690,2,16,5,7,60,38,22,53
Melbourne C,3690,3,14,4,11,44,36,8,46
Melbourne V,3690,4,13,6,10,46,39,7,45
Adelaide Utd,3690,5,11,6,11,37,40,-3,39
Brisbane,3690,6,10,5,13,33,42,-9,35
Western Sydn,3690,7,8,9,10,38,47,-9,33
Perth Glory,3690,8,10,2,15,37,50,-13,32
Wellington P,3690,9,5,6,16,31,55,-24,21
CC Mariners,3690,10,4,8,15,28,49,-21,20
Sydney FC,3691,1,20,5,3,65,23,42,65
N'castle Jet,3691,2,15,5,8,58,39,19,50
Melbourne C,3691,3,15,4,10,45,34,11,49
Melbourne V,3691,4,13,6,10,46,39,7,45
Adelaide Utd,3691,5,11,6,11,37,40,-3,39
Brisbane,3691,6,10,5,13,33,42,-9,35
Western Sydn,3691,7,8,9,10,38,47,-9,33
Perth Glory,3691,8,10,2,15,37,50,-13,32
Wellington P,3691,9,5,6,16,31,55,-24,21
CC Mariners,3691,10,4,8,15,28,49,-21,20
Sydney FC,3692,1,21,4,3,66,23,43,67
N'castle Jet,3692,2,16,5,7,59,38,21,53
Melbourne C,3692,3,14,4,11,44,35,9,46
Melbourne V,3692,4,13,5,11,46,40,6,44
Adelaide Utd,3692,5,11,6,11,37,40,-3,39
Brisbane,3692,6,10,5,13,33,42,-9,35
Western Sydn,3692,7,8,9,10,38,47,-9,33
Perth Glory,3692,8,10,2,15,37,50,-13,32
Wellington P,3692,9,5,6,16,31,55,-24,21
CC Mariners,3692,10,4,8,15,28,49,-21,20
Sydney FC,3693,1,21,4,3,66,22,44,67
N'castle Jet,3693,2,16,5,7,59,37,22,53
Melbourne C,3693,3,14,4,11,43,35,8,46
Melbourne V,3693,4,13,5,11,45,40,5,44
Adelaide Utd,3693,5,11,6,11,37,40,-3,39
Brisbane,3693,6,10,5,13,33,42,-9,35
Western Sydn,3693,7,8,9,10,38,47,-9,33
Perth Glory,3693,8,10,2,15,37,50,-13,32
Wellington P,3693,9,5,6,16,31,55,-24,21
CC Mariners,3693,10,4,8,15,28,49,-21,20
Sydney FC,3694,1,21,4,3,68,24,44,67
N'castle Jet,3694,2,15,6,7,57,37,20,51
Melbourne C,3694,3,14,5,10,43,33,10,47
Melbourne V,3694,4,13,5,11,47,42,5,44
Adelaide Utd,3694,5,11,6,11,37,40,-3,39
Brisbane,3694,6,10,5,13,33,42,-9,35
Western Sydn,3694,7,8,9,10,38,47,-9,33
Perth Glory,3694,8,10,2,15,37,50,-13,32
Wellington P,3694,9,5,6,16,31,55,-24,21
CC Mariners,3694,10,4,8,15,28,49,-21,20
Sydney FC,3695,1,20,5,3,64,22,42,65
N'castle Jet,3695,2,15,6,7,58,38,20,51
Melbourne C,3695,3,14,5,10,44,34,10,47
Melbourne V,3695,4,13,6,10,45,38,7,45
Adelaide Utd,3695,5,11,6,11,37,40,-3,39
Brisbane,3695,6,10,5,13,33,42,-9,35
Western Sydn,3695,7,8,9,10,38,47,-9,33
Perth Glory,3695,8,10,2,15,37,50,-13,32
Wellington P,3695,9,5,6,16,31,55,-24,21
CC Mariners,3695,10,4,8,15,28,49,-21,20
Sydney FC,3696,1,20,5,3,66,24,42,65
N'castle Jet,3696,2,16,5,7,59,37,22,53
Melbourne C,3696,3,14,4,11,43,35,8,46
Melbourne V,3696,4,13,6,10,47,40,7,45
Adelaide Utd,3696,5,11,6,11,37,40,-3,39
Brisbane,3696,6,10,5,13,33,42,-9,35
Western Sydn,3696,7,8,9,10,38,47,-9,33
Perth Glory,3696,8,10,2,15,37,50,-13,32
Wellington P,3696,9,5,6,16,31,55,-24,21
CC Mariners,3696,10,4,8,15,28,49,-21,20
Sydney FC,3697,1,21,4,3,67,23,44,67
N'castle Jet,3697,2,16,5,7,60,37,23,53
Melbourne C,3697,3,14,4,11,43,36,7,46
Melbourne V,3697,4,13,5,11,46,41,5,44
Adelaide Utd,3697,5,11,6,11,37,40,-3,39
Brisbane,3697,6,10,5,13,33,42,-9,35
Western Sydn,3697,7,8,9,10,38,47,-9,33
Perth Glory,3697,8,10,2,15,37,50,-13,32
Wellington P,3697,9,5,6,16,31,55,-24,21
CC Mariners,3697,10,4,8,15,28,49,-21,20
Sydney FC,3698,1,20,5,3,66,24,42,65
N'castle Jet,3698,2,15,5,8,57,39,18,50
Melbourne C,3698,3,15,4,10,45,33,12,49
Melbourne V,3698,4,13,6,10,47,40,7,45
Adelaide Utd,3698,5,11,6,11,37,40,-3,39
Brisbane,3698,6,10,5,13,33,42,-9,35
Western Sydn,3698,7,8,9,10,38,47,-9,33
Perth Glory,3698,8,10,2,15,37,50,-13,32
Wellington P,3698,9,5,6,16,31,55,-24,21
CC Mariners,3698,10,4,8,15,28,49,-21,20
Sydney FC,3699,1,21,4,3,67,22,45,67
N'castle Jet,3699,2,16,5,7,61,37,24,53
Melbourne C,3699,3,14,4,11,43,37,6,46
Melbourne V,3699,4,13,5,11,45,41,4,44
Adelaide Utd,3699,5,11,6,11,37,40,-3,39
Brisbane,3699,6,10,5,13,33,42,-9,35
Western Sydn,3699,7,8,9,10,38,47,-9,33
Perth Glory,3699,8,10,2,15,37,50,-13,32
Wellington P,3699,9,5,6,16,31,55,-24,21
CC Mariners,3699,10,4,8,15,28,49,-21,20
Sydney FC,3700,1,20,4,4,65,24,41,64
N'castle Jet,3700,2,16,5,7,59,37,22,53
Melbourne V,3700,3,14,5,10,47,39,8,47
Melbourne C,3700,4,14,4,11,43,35,8,46
Adelaide Utd,3700,5,11,6,11,37,40,-3,39
Brisbane,3700,6,10,5,13,33,42,-9,35
Western Sydn,3700,7,8,9,10,38,47,-9,33
Perth Glory,3700,8,10,2,15,37,50,-13,32
Wellington P,3700,9,5,6,16,31,55,-24,21
CC Mariners,3700,10,4,8,15,28,49,-21,20
Sydney FC,3701,1,20,4,4,66,25,41,64
N'castle Jet,3701,2,16,5,7,60,37,23,53
Melbourne V,3701,3,14,5,10,48,40,8,47
Melbourne C,3701,4,14,4,11,43,36,7,46
Adelaide Utd,3701,5,11,6,11,37,40,-3,39
Brisbane,3701,6,10,5,13,33,42,-9,35
Western Sydn,3701,7,8,9,10,38,47,-9,33
Perth Glory,3701,8,10,2,15,37,50,-13,32
Wellington P,3701,9,5,6,16,31,55,-24,21
CC Mariners,3701,10,4,8,15,28,49,-21,20
Sydney FC,3702,1,20,5,3,65,23,42,65
N'castle Jet,3702,2,16,5,7,61,38,23,53
Melbourne C,3702,3,14,4,11,44,37,7,46
Melbourne V,3702,4,13,6,10,46,39,7,45
Adelaide Utd,3702,5,11,6,11,37,40,-3,39
Brisbane,3702,6,10,5,13,33,42,-9,35
Western Sydn,3702,7,8,9,10,38,47,-9,33
Perth Glory,3702,8,10,2,15,37,50,-13,32
Wellington P,3702,9,5,6,16,31,55,-24,21
CC Mariners,3702,10,4,8,15,28,49,-21,20
Sydney FC,3703,1,21,4,3,65,22,43,67
N'castle Jet,3703,2,16,5,7,60,38,22,53
Melbourne C,3703,3,14,4,11,44,36,8,46
Melbourne V,3703,4,13,5,11,45,39,6,44
Adelaide Utd,3703,5,11,6,11,37,40,-3,39
Brisbane,3703,6,10,5,13,33,42,-9,35
Western Sydn,3703,7,8,9,10,38,47,-9,33
Perth Glory,3703,8,10,2,15,37,50,-13,32
Wellington P,3703,9,5,6,16,31,55,-24,21
CC Mariners,3703,10,4,8,15,28,49,-21,20
Sydney FC,3704,1,20,5,3,66,24,42,65
N'castle Jet,3704,2,15,6,7,58,38,20,51
Melbourne C,3704,3,14,5,10,44,34,10,47
Melbourne V,3704,4,13,6,10,47,40,7,45
Adelaide Utd,3704,5,11,6,11,37,40,-3,39
Brisbane,3704,6,10,5,13,33,42,-9,35
Western Sydn,3704,7,8,9,10,38,47,-9,33
Perth Glory,3704,8,10,2,15,37,50,-13,32
Wellington P,3704,9,5,6,16,31,55,-24,21
CC Mariners,3704,10,4,8,15,28,49,-21,20
Sydney FC,3705,1,20,4,4,65,25,40,64
N'castle Jet,3705,2,15,5,8,57,39,18,50
Melbourne C,3705,3,15,4,10,45,33,12,49
Melbourne V,3705,4,14,5,10,48,39,9,47
Adelaide Utd,3705,5,11,6,11,37,40,-3,39
Brisbane,3705,6,10,5,13,33,42,-9,35
Western Sydn,3705,7,8,9,10,38,47,-9,33
Perth Glory,3705,8,10,2,15,37,50,-13,32
Wellington P,3705,9,5,6,16,31,55,-24,21
CC Mariners,3705,10,4,8,15,28,49,-21,20
Sydney FC,3706,1,21,4,3,68,22,46,67
N'castle Jet,3706,2,15,6,7,58,38,20,51
Melbourne C,3706,3,14,5,10,44,34,10,47
Melbourne V,3706,4,13,5,11,45,42,3,44
Adelaide Utd,3706,5,11,6,11,37,40,-3,39
Brisbane,3706,6,10,5,13,33,42,-9,35
Western Sydn,3706,7,8,9,10,38,47,-9,33
Perth Glory,3706,8,10,2,15,37,50,-13,32
Wellington P,3706,9,5,6,16,31,55,-24,21
CC Mariners,3706,10,4,8,15,28,49,-21,20
Sydney FC,3707,1,21,4,3,66,23,43,67
N'castle Jet,3707,2,15,5,8,59,40,19,50
Melbourne C,3707,3,15,4,10,46,35,11,49
Melbourne V,3707,4,13,5,11,46,40,6,44
Adelaide Utd,3707,5,11,6,11,37,40,-3,39
Brisbane,3707,6,10,5,13,33,42,-9,35
Western Sydn,3707,7,8,9,10,38,47,-9,33
Perth Glory,3707,8,10,2,15,37,50,-13,32
Wellington P,3707,9,5,6,16,31,55,-24,21
CC Mariners,3707,10,4,8,15,28,49,-21,20
Sydney FC,3708,1,20,4,4,65,24,41,64
N'castle Jet,3708,2,16,5,7,60,37,23,53
Melbourne V,3708,3,14,5,10,47,39,8,47
Melbourne C,3708,4,14,4,11,43,36,7,46
Adelaide Utd,3708,5,11,6,11,37,40,-3,39
Brisbane,3708,6,10,5,13,33,42,-9,35
Western Sydn,3708,7,8,9,10,38,47,-9,33
Perth Glory,3708,8,10,2,15,37,50,-13,32
Wellington P,3708,9,5,6,16,31,55,-24,21
CC Mariners,3708,10,4,8,15,28,49,-21,20
Sydney FC,3709,1,21,4,3,67,23,44,67
N'castle Jet,3709,2,15,5,8,57,39,18,50
Melbourne C,3709,3,15,4,10,45,33,12,49
Melbourne V,3709,4,13,5,11,46,41,5,44
Adelaide Utd,3709,5,11,6,11,37,40,-3,39
Brisbane,3709,6,10,5,13,33,42,-9,35
Western Sydn,3709,7,8,9,10,38,47,-9,33
Perth Glory,3709,8,10,2,15,37,50,-13,32
Wellington P,3709,9,5,6,16,31,55,-24,21
CC Mariners,3709,10,4,8,15,28,49,-21,20
Sydney FC,3710,1,21,4,3,67,22,45,67
N'castle Jet,3710,2,15,5,8,57,38,19,50
Melbourne C,3710,3,15,4,10,44,33,11,49
Melbourne V,3710,4,13,5,11,45,41,4,44
Adelaide Utd,3710,5,11,6,11,37,40,-3,39
Brisbane,3710,6,10,5,13,33,42,-9,35
Western Sydn,3710,7,8,9,10,38,47,-9,33
Perth Glory,3710,8,10,2,15,37,50,-13,32
Wellington P,3710,9,5,6,16,31,55,-24,21
CC Mariners,3710,10,4,8,15,28,49,-21,20
Sydney FC,3711,1,21,4,3,66,23,43,67
N'castle Jet,3711,2,15,6,7,58,38,20,51
Melbourne C,3711,3,14,5,10,44,34,10,47
Melbourne V,3711,4,13,5,11,46,40,6,44
Adelaide Utd,3711,5,11,6,11,37,40,-3,39
Brisbane,3711,6,10,5,13,33,42,-9,35
Western Sydn,3711,7,8,9,10,38,47,-9,33
Perth Glory,3711,8,10,2,15,37,50,-13,32
Wellington P,3711,9,5,6,16,31,55,-24,21
CC Mariners,3711,10,4,8,15,28,49,-21,20
Sydney FC,3712,1,20,4,4,64,24,40,64
N'castle Jet,3712,2,16,5,7,61,38,23,53
Melbourne V,3712,3,14,5,10,47,38,9,47
Melbourne C,3712,4,14,4,11,44,37,7,46
Adelaide Utd,3712,5,11,6,11,37,40,-3,39
Brisbane,3712,6,10,5,13,33,42,-9,35
Western Sydn,3712,7,8,9,10,38,47,-9,33
Perth Glory,3712,8,10,2,15,37,50,-13,32
Wellington P,3712,9,5,6,16,31,55,-24,21
CC Mariners,3712,10,4,8,15,28,49,-21,20
Sydney FC,3713,1,21,4,3,66,23,43,67
N'castle Jet,3713,2,16,5,7,58,37,21,53
Melbourne C,3713,3,14,4,11,43,34,9,46
Melbourne V,3713,4,13,5,11,46,40,6,44
Adelaide Utd,3713,5,11,6,11,37,40,-3,39
Brisbane,3713,6,10,5,13,33,42,-9,35
Western Sydn,3713,7,8,9,10,38,47,-9,33
Perth Glory,3713,8,10,2,15,37,50,-13,32
Wellington P,3713,9,5,6,16,31,55,-24,21
CC Mariners,3713,10,4,8,15,28,49,-21,20
Sydney FC,3714,1,20,5,3,66,24,42,65
N'castle Jet,3714,2,16,5,7,60,38,22,53
Melbourne C,3714,3,14,4,11,44,36,8,46
Melbourne V,3714,4,13,6,10,47,40,7,45
Adelaide Utd,3714,5,11,6,11,37,40,-3,39
Brisbane,3714,6,10,5,13,33,42,-9,35
Western Sydn,3714,7,8,9,10,38,47,-9,33
Perth Glory,3714,8,10,2,15,37,50,-13,32
Wellington P,3714,9,5,6,16,31,55,-24,21
CC Mariners,3714,10,4,8,15,28,49,-21,20
Sydney FC,3715,1,20,5,3,65,23,42,65
N'castle Jet,3715,2,15,5,8,59,40,19,50
Melbourne C,3715,3,15,4,10,46,35,11,49
Melbourne V,3715,4,13,6,10,46,39,7,45
Adelaide Utd,3715,5,11,6,11,37,40,-3,39
Brisbane,3715,6,10,5,13,33,42,-9,35
Western Sydn,3715,7,8,9,10,38,47,-9,33
Perth Glory,3715,8,10,2,15,37,50,-13,32
Wellington P,3715,9,5,6,16,31,55,-24,21
CC Mariners,3715,10,4,8,15,28,49,-21,20
Sydney FC,3716,1,21,4,3,66,23,43,67
N'castle Jet,3716,2,15,5,8,57,38,19,50
Melbourne C,3716,3,15,4,10,44,33,11,49
Melbourne V,3716,4,13,5,11,46,40,6,44
Adelaide Utd,3716,5,11,6,11,37,40,-3,39
Brisbane,3716,6,10,5,13,33,42,-9,35
Western Sydn,3716,7,8,9,10,38,47,-9,33
Perth Glory,3716,8,10,2,15,37,50,-13,32
Wellington P,3716,9,5,6,16,31,55,-24,21
CC Mariners,3716,10,4,8,15,28,49,-21,20
Sydney FC,3717,1,20,5,3,65,23,42,65
N'castle Jet,3717,2,16,5,7,61,38,23,53
Melbourne C,3717,3,14,4,11,44,37,7,46
Melbourne V,3717,4,13,6,10,46,39,7,45
Adelaide Utd,3717,5,11,6,11,37,40,-3,39
Brisbane,3717,6,10,5,13,33,42,-9,35
Western Sydn,3717,7,8,9,10,38,47,-9,33
Perth Glory,3717,8,10,2,15,37,50,-13,32
Wellington P,3717,9,5,6,16,31,55,-24,21
CC Mariners,3717,10,4,8,15,28,49,-21,20
Sydney FC,3718,1,21,4,3,65,22,43,67
N'castle Jet,3718,2,16,5,7,58,37,21,53
Melbourne C,3718,3,14,4,11,43,34,9,46
Melbourne V,3718,4,13,5,11,45,39,6,44
Adelaide Utd,3718,5,11,6,11,37,40,-3,39
Brisbane,3718,6,10,5,13,33,42,-9,35
Western Sydn,3718,7,8,9,10,38,47,-9,33
Perth Glory,3718,8,10,2,15,37,50,-13,32
Wellington P,3718,9,5,6,16,31,55,-24,21
CC Mariners,3718,10,4,8,15,28,49,-21,20
Sydney FC,3719,1,20,5,3,66,24,42,65
N'castle Jet,3719,2,16,5,7,60,37,23,53
Melbourne C,3719,3,14,4,11,43,36,7,46
Melbourne V,3719,4,13,6,10,47,40,7,45
Adelaide Utd,3719,5,11,6,11,37,40,-3,39
Brisbane,3719,6,10,5,13,33,42,-9,35
Western Sydn,3719,7,8,9,10,38,47,-9,33
Perth Glory,3719,8,10,2,15,37,50,-13,32
Wellington P,3719,9,5,6,16,31,55,-24,21
CC Mariners,3719,10,4,8,15,28,49,-21,20
Sydney FC,3720,1,21,4,3,67,23,44,67
N'castle Jet,3720,2,15,5,8,57,39,18,50
Melbourne C,3720,3,15,4,10,45,33,12,49
Melbourne V,3720,4,13,5,11,46,41,5,44
Adelaide Utd,3720,5,11,6,11,37,40,-3,39
Brisbane,3720,6,10,5,13,33,42,-9,35
Western Sydn,3720,7,8,9,10,38,47,-9,33
Perth Glory,3720,8,10,2,15,37,50,-13,32
Wellington P,3720,9,5,6,16,31,55,-24,21
CC Mariners,3720,10,4,8,15,28,49,-21,20
Sydney FC,3721,1,21,4,3,66,22,44,67
N'castle Jet,3721,2,16,5,7,61,38,23,53
Melbourne C,3721,3,14,4,11,44,37,7,46
Melbourne V,3721,4,13,5,11,45,40,5,44
Adelaide Utd,3721,5,11,6,11,37,40,-3,39
Brisbane,3721,6,10,5,13,33,42,-9,35
Western Sydn,3721,7,8,9,10,38,47,-9,33
Perth Glory,3721,8,10,2,15,37,50,-13,32
Wellington P,3721,9,5,6,16,31,55,-24,21
CC Mariners,3721,10,4,8,15,28,49,-21,20
Sydney FC,3722,1,21,4,3,66,23,43,67
N'castle Jet,3722,2,15,5,8,59,40,19,50
Melbourne C,3722,3,15,4,10,46,35,11,49
Melbourne V,3722,4,13,5,11,46,40,6,44
Adelaide Utd,3722,5,11,6,11,37,40,-3,39
Brisbane,3722,6,10,5,13,33,42,-9,35
Western Sydn,3722,7,8,9,10,38,47,-9,33
Perth Glory,3722,8,10,2,15,37,50,-13,32
Wellington P,3722,9,5,6,16,31,55,-24,21
CC Mariners,3722,10,4,8,15,28,49,-21,20
Sydney FC,3723,1,21,4,3,66,23,43,67
N'castle Jet,3723,2,16,5,7,58,37,21,53
Melbourne C,3723,3,14,4,11,43,34,9,46
Melbourne V,3723,4,13,5,11,46,40,6,44
Adelaide Utd,3723,5,11,6,11,37,40,-3,39
Brisbane,3723,6,10,5,13,33,42,-9,35
Western Sydn,3723,7,8,9,10,38,47,-9,33
Perth Glory,3723,8,10,2,15,37,50,-13,32
Wellington P,3723,9,5,6,16,31,55,-24,21
CC Mariners,3723,10,4,8,15,28,49,-21,20
Sydney FC,3724,1,21,4,3,69,23,46,67
N'castle Jet,3724,2,16,5,7,60,37,23,53
Melbourne C,3724,3,14,4,11,43,36,7,46
Melbourne V,3724,4,13,5,11,46,43,3,44
Adelaide Utd,3724,5,11,6,11,37,40,-3,39
Brisbane,3724,6,10,5,13,33,42,-9,35
Western Sydn,3724,7,8,9,10,38,47,-9,33
Perth Glory,3724,8,10,2,15,37,50,-13,32
Wellington P,3724,9,5,6,16,31,55,-24,21
CC Mariners,3724,10,4,8,15,28,49,-21,20
Sydney FC,3725,1,21,4,3,67,22,45,67
N'castle Jet,3725,2,16,5,7,61,37,24,53
Melbourne C,3725,3,14,4,11,43,37,6,46
Melbourne V,3725,4,13,5,11,45,41,4,44
Adelaide Utd,3725,5,11,6,11,37,40,-3,39
Brisbane,3725,6,10,5,13,33,42,-9,35
Western Sydn,3725,7,8,9,10,38,47,-9,33
Perth Glory,3725,8,10,2,15,37,50,-13,32
Wellington P,3725,9,5,6,16,31,55,-24,21
CC Mariners,3725,10,4,8,15,28,49,-21,20
Sydney FC,3726,1,20,5,3,66,24,42,65
N'castle Jet,3726,2,16,5,7,59,38,21,53
Melbourne C,3726,3,14,4,11,44,35,9,46
Melbourne V,3726,4,13,6,10,47,40,7,45
Adelaide Utd,3726,5,11,6,11,37,40,-3,39
Brisbane,3726,6,10,5,13,33,42,-9,35
Western Sydn,3726,7,8,9,10,38,47,-9,33
Perth Glory,3726,8,10,2,15,37,50,-13,32
Wellington P,3726,9,5,6,16,31,55,-24,21
CC Mariners,3726,10,4,8,15,28,49,-21,20
Sydney FC,3727,1,21,4,3,67,23,44,67
N'castle Jet,3727,2,16,5,7,60,38,22,53
Melbourne C,3727,3,14,4,11,44,36,8,46
Melbourne V,3727,4,13,5,11,46,41,5,44
Adelaide Utd,3727,5,11,6,11,37,40,-3,39
Brisbane,3727,6,10,5,13,33,42,-9,35
Western Sydn,3727,7,8,9,10,38,47,-9,33
Perth Glory,3727,8,10,2,15,37,50,-13,32
Wellington P,3727,9,5,6,16,31,55,-24,21
CC Mariners,3727,10,4,8,15,28,49,-21,20
Sydney FC,3728,1,21,4,3,65,22,43,67
N'castle Jet,3728,2,15,5,8,58,39,19,50
Melbourne C,3728,3,15,4,10,45,34,11,49
Melbourne V,3728,4,13,5,11,45,39,6,44
Adelaide Utd,3728,5,11,6,11,37,40,-3,39
Brisbane,3728,6,10,5,13,33,42,-9,35
Western Sydn,3728,7,8,9,10,38,47,-9,33
Perth Glory,3728,8,10,2,15,37,50,-13,32
Wellington P,3728,9,5,6,16,31,55,-24,21
CC Mariners,3728,10,4,8,15,28,49,-21,20
Sydney FC,3729,1,21,4,3,66,22,44,67
N'castle Jet,3729,2,16,5,7,59,38,21,53
Melbourne C,3729,3,14,4,11,44,35,9,46
Melbourne V,3729,4,13,5,11,45,40,5,44
Adelaide Utd,3729,5,11,6,11,37,40,-3,39
Brisbane,3729,6,10,5,13,33,42,-9,35
Western Sydn,3729,7,8,9,10,38,47,-9,33
Perth Glory,3729,8,10,2,15,37,50,-13,32
Wellington P,3729,9,5,6,16,31,55,-24,21
CC Mariners,3729,10,4,8,15,28,49,-21,20
Sydney FC,3730,1,21,4,3,69,24,45,67
N'castle Jet,3730,2,16,5,7,59,37,22,53
Melbourne C,3730,3,14,4,11,43,35,8,46
Melbourne V,3730,4,13,5,11,47,43,4,44
Adelaide Utd,3730,5,11,6,11,37,40,-3,39
Brisbane,3730,6,10,5,13,33,42,-9,35
Western Sydn,3730,7,8,9,10,38,47,-9,33
Perth Glory,3730,8,10,2,15,37,50,-13,32
Wellington P,3730,9,5,6,16,31,55,-24,21
CC Mariners,3730,10,4,8,15,28,49,-21,20
Sydney FC,3731,1,21,4,3,66,22,44,67
N'castle Jet,3731,2,15,6,7,57,37,20,51
Melbourne C,3731,3,14,5,10,43,33,10,47
Melbourne V,3731,4,13,5,11,45,40,5,44
Adelaide Utd,3731,5,11,6,11,37,40,-3,39
Brisbane,3731,6,10,5,13,33,42,-9,35
Western Sydn,3731,7,8,9,10,38,47,-9,33
Perth Glory,3731,8,10,2,15,37,50,-13,32
Wellington P,3731,9,5,6,16,31,55,-24,21
CC Mariners,3731,10,4,8,15,28,49,-21,20
Sydney FC,3732,1,21,4,3,66,23,43,67
N'castle Jet,3732,2,15,5,8,57,38,19,50
Melbourne C,3732,3,15,4,10,44,33,11,49
Melbourne V,3732,4,13,5,11,46,40,6,44
Adelaide Utd,3732,5,11,6,11,37,40,-3,39
Brisbane,3732,6,10,5,13,33,42,-9,35
Western Sydn,3732,7,8,9,10,38,47,-9,33
Perth Glory,3732,8,10,2,15,37,50,-13,32
Wellington P,3732,9,5,6,16,31,55,-24,21
CC Mariners,3732,10,4,8,15,28,49,-21,20
Sydney FC,3733,1,21,4,3,67,22,45,67
N'castle Jet,3733,2,16,5,7,61,38,23,53
Melbourne C,3733,3,14,4,11,44,37,7,46
Melbourne V,3733,4,13,5,11,45,41,4,44
Adelaide Utd,3733,5,11,6,11,37,40,-3,39
Brisbane,3733,6,10,5,13,33,42,-9,35
Western Sydn,3733,7,8,9,10,38,47,-9,33
Perth Glory,3733,8,10,2,15,37,50,-13,32
Wellington P,3733,9,5,6,16,31,55,-24,21
CC Mariners,3733,10,4,8,15,28,49,-21,20
Sydney FC,3734,1,20,4,4,65,24,41,64
N'castle Jet,3734,2,16,5,7,59,38,21,53
Melbourne V,3734,3,14,5,10,47,39,8,47
Melbourne C,3734,4,14,4,11,44,35,9,46
Adelaide Utd,3734,5,11,6,11,37,40,-3,39
Brisbane,3734,6,10,5,13,33,42,-9,35
Western Sydn,3734,7,8,9,10,38,47,-9,33
Perth Glory,3734,8,10,2,15,37,50,-13,32
Wellington P,3734,9,5,6,16,31,55,-24,21
CC Mariners,3734,10,4,8,15,28,49,-21,20
Sydney FC,3735,1,20,4,4,64,23,41,64
N'castle Jet,3735,2,16,5,7,59,37,22,53
Melbourne V,3735,3,14,5,10,46,38,8,47
Melbourne C,3735,4,14,4,11,43,35,8,46
Adelaide Utd,3735,5,11,6,11,37,40,-3,39
Brisbane,3735,6,10,5,13,33,42,-9,35
Western Sydn,3735,7,8,9,10,38,47,-9,33
Perth Glory,3735,8,10,2,15,37,50,-13,32
Wellington P,3735,9,5,6,16,31,55,-24,21
CC Mariners,3735,10,4,8,15,28,49,-21,20
Sydney FC,3736,1,20,4,4,64,25,39,64
N'castle Jet,3736,2,16,5,7,60,38,22,53
Melbourne V,3736,3,14,5,10,48,38,10,47
Melbourne C,3736,4,14,4,11,44,36,8,46
Adelaide Utd,3736,5,11,6,11,37,40,-3,39
Brisbane,3736,6,10,5,13,33,42,-9,35
Western Sydn,3736,7,8,9,10,38,47,-9,33
Perth Glory,3736,8,10,2,15,37,50,-13,32
Wellington P,3736,9,5,6,16,31,55,-24,21
CC Mariners,3736,10,4,8,15,28,49,-21,20
Sydney FC,3737,1,21,4,3,66,22,44,67
N'castle Jet,3737,2,16,5,7,62,38,24,53
Melbourne C,3737,3,14,4,11,44,38,6,46
Melbourne V,3737,4,13,5,11,45,40,5,44
Adelaide Utd,3737,5,11,6,11,37,40,-3,39
Brisbane,3737,6,10,5,13,33,42,-9,35
Western Sydn,3737,7,8,9,10,38,47,-9,33
Perth Glory,3737,8,10,2,15,37,50,-13,32
Wellington P,3737,9,5,6,16,31,55,-24,21
CC Mariners,3737,10,4,8,15,28,49,-21,20
Sydney FC,3738,1,20,5,3,65,23,42,65
N'castle Jet,3738,2,16,5,7,59,38,21,53
Melbourne C,3738,3,14,4,11,44,35,9,46
Melbourne V,3738,4,13,6,10,46,39,7,45
Adelaide Utd,3738,5,11,6,11,37,40,-3,39
Brisbane,3738,6,10,5,13,33,42,-9,35
Western Sydn,3738,7,8,9,10,38,47,-9,33
Perth Glory,3738,8,10,2,15,37,50,-13,32
Wellington P,3738,9,5,6,16,31,55,-24,21
CC Mariners,3738,10,4,8,15,28,49,-21,20
Sydney FC,3739,1,20,5,3,66,24,42,65
N'castle Jet,3739,2,16,5,7,60,38,22,53
Melbourne C,3739,3,14,4,11,44,36,8,46
Melbourne V,3739,4,13,6,10,47,40,7,45
Adelaide Utd,3739,5,11,6,11,37,40,-3,39
Brisbane,3739,6,10,5,13,33,42,-9,35
Western Sydn,3739,7,8,9,10,38,47,-9,33
Perth Glory,3739,8,10,2,15,37,50,-13,32
Wellington P,3739,9,5,6,16,31,55,-24,21
CC Mariners,3739,10,4,8,15,28,49,-21,20
Sydney FC,3740,1,21,4,3,67,24,43,67
N'castle Jet,3740,2,16,5,7,59,38,21,53
Melbourne C,3740,3,14,4,11,44,35,9,46
Melbourne V,3740,4,13,5,11,47,41,6,44
Adelaide Utd,3740,5,11,6,11,37,40,-3,39
Brisbane,3740,6,10,5,13,33,42,-9,35
Western Sydn,3740,7,8,9,10,38,47,-9,33
Perth Glory,3740,8,10,2,15,37,50,-13,32
Wellington P,3740,9,5,6,16,31,55,-24,21
CC Mariners,3740,10,4,8,15,28,49,-21,20
Sydney FC,3741,1,20,4,4,64,24,40,64
N'castle Jet,3741,2,15,5,8,58,39,19,50
Melbourne C,3741,3,15,4,10,45,34,11,49
Melbourne V,3741,4,14,5,10,47,38,9,47
Adelaide Utd,3741,5,11,6,11,37,40,-3,39
Brisbane,3741,6,10,5,13,33,42,-9,35
Western Sydn,3741,7,8,9,10,38,47,-9,33
Perth Glory,3741,8,10,2,15,37,50,-13,32
Wellington P,3741,9,5,6,16,31,55,-24,21
CC Mariners,3741,10,4,8,15,28,49,-21,20
Sydney FC,3742,1,20,5,3,65,23,42,65
N'castle Jet,3742,2,15,6,7,59,39,20,51
Melbourne C,3742,3,14,5,10,45,35,10,47
Melbourne V,3742,4,13,6,10,46,39,7,45
Adelaide Utd,3742,5,11,6,11,37,40,-3,39
Brisbane,3742,6,10,5,13,33,42,-9,35
Western Sydn,3742,7,8,9,10,38,47,-9,33
Perth Glory,3742,8,10,2,15,37,50,-13,32
Wellington P,3742,9,5,6,16,31,55,-24,21
CC Mariners,3742,10,4,8,15,28,49,-21,20
Sydney FC,3743,1,20,4,4,65,24,41,64
N'castle Jet,3743,2,15,5,8,58,40,18,50
Melbourne C,3743,3,15,4,10,46,34,12,49
Melbourne V,3743,4,14,5,10,47,39,8,47
Adelaide Utd,3743,5,11,6,11,37,40,-3,39
Brisbane,3743,6,10,5,13,33,42,-9,35
Western Sydn,3743,7,8,9,10,38,47,-9,33
Perth Glory,3743,8,10,2,15,37,50,-13,32
Wellington P,3743,9,5,6,16,31,55,-24,21
CC Mariners,3743,10,4,8,15,28,49,-21,20
Sydney FC,3744,1,21,4,3,66,22,44,67
N'castle Jet,3744,2,16,5,7,60,39,21,53
Melbourne C,3744,3,14,4,11,45,36,9,46
Melbourne V,3744,4,13,5,11,45,40,5,44
Adelaide Utd,3744,5,11,6,11,37,40,-3,39
Brisbane,3744,6,10,5,13,33,42,-9,35
Western Sydn,3744,7,8,9,10,38,47,-9,33
Perth Glory,3744,8,10,2,15,37,50,-13,32
Wellington P,3744,9,5,6,16,31,55,-24,21
CC Mariners,3744,10,4,8,15,28,49,-21,20
Sydney FC,3745,1,20,4,4,64,23,41,64
N'castle Jet,3745,2,16,5,7,59,37,22,53
Melbourne V,3745,3,14,5,10,46,38,8,47
Melbourne C,3745,4,14,4,11,43,35,8,46
Adelaide Utd,3745,5,11,6,11,37,40,-3,39
Brisbane,3745,6,10,5,13,33,42,-9,35
Western Sydn,3745,7,8,9,10,38,47,-9,33
Perth Glory,3745,8,10,2,15,37,50,-13,32
Wellington P,3745,9,5,6,16,31,55,-24,21
CC Mariners,3745,10,4,8,15,28,49,-21,20
Sydney FC,3746,1,20,5,3,64,22,42,65
N'castle Jet,3746,2,15,6,7,60,40,20,51
Melbourne C,3746,3,14,5,10,46,36,10,47
Melbourne V,3746,4,13,6,10,45,38,7,45
Adelaide Utd,3746,5,11,6,11,37,40,-3,39
Brisbane,3746,6,10,5,13,33,42,-9,35
Western Sydn,3746,7,8,9,10,38,47,-9,33
Perth Glory,3746,8,10,2,15,37,50,-13,32
Wellington P,3746,9,5,6,16,31,55,-24,21
CC Mariners,3746,10,4,8,15,28,49,-21,20
Sydney FC,3747,1,21,4,3,66,23,43,67
N'castle Jet,3747,2,15,6,7,58,38,20,51
Melbourne C,3747,3,14,5,10,44,34,10,47
Melbourne V,3747,4,13,5,11,46,40,6,44
Adelaide Utd,3747,5,11,6,11,37,40,-3,39
Brisbane,3747,6,10,5,13,33,42,-9,35
Western Sydn,3747,7,8,9,10,38,47,-9,33
Perth Glory,3747,8,10,2,15,37,50,-13,32
Wellington P,3747,9,5,6,16,31,55,-24,21
CC Mariners,3747,10,4,8,15,28,49,-21,20
Sydney FC,3748,1,21,4,3,66,22,44,67
N'castle Jet,3748,2,16,5,7,59,38,21,53
Melbourne C,3748,3,14,4,11,44,35,9,46
Melbourne V,3748,4,13,5,11,45,40,5,44
Adelaide Utd,3748,5,11,6,11,37,40,-3,39
Brisbane,3748,6,10,5,13,33,42,-9,35
Western Sydn,3748,7,8,9,10,38,47,-9,33
Perth Glory,3748,8,10,2,15,37,50,-13,32
Wellington P,3748,9,5,6,16,31,55,-24,21
CC Mariners,3748,10,4,8,15,28,49,-21,20
Sydney FC,3749,1,20,4,4,65,24,41,64
N'castle Jet,3749,2,15,6,7,57,37,20,51
Melbourne C,3749,3,14,5,10,43,33,10,47
Melbourne V,3749,4,14,5,10,47,39,8,47
Adelaide Utd,3749,5,11,6,11,37,40,-3,39
Brisbane,3749,6,10,5,13,33,42,-9,35
Western Sydn,3749,7,8,9,10,38,47,-9,33
Perth Glory,3749,8,10,2,15,37,50,-13,32
Wellington P,3749,9,5,6,16,31,55,-24,21
CC Mariners,3749,10,4,8,15,28,49,-21,20
Sydney FC,3750,1,21,4,3,66,22,44,67
N'castle Jet,3750,2,16,5,7,59,38,21,53
Melbourne C,3750,3,14,4,11,44,35,9,46
Melbourne V,3750,4,13,5,11,45,40,5,44
Adelaide Utd,3750,5,11,6,11,37,40,-3,39
Brisbane,3750,6,10,5,13,33,42,-9,35
Western Sydn,3750,7,8,9,10,38,47,-9,33
Perth Glory,3750,8,10,2,15,37,50,-13,32
Wellington P,3750,9,5,6,16,31,55,-24,21
CC Mariners,3750,10,4,8,15,28,49,-21,20
Sydney FC,3751,1,21,4,3,67,22,45,67
N'castle Jet,3751,2,15,6,7,58,38,20,51
Melbourne C,3751,3,14,5,10,44,34,10,47
Melbourne V,3751,4,13,5,11,45,41,4,44
Adelaide Utd,3751,5,11,6,11,37,40,-3,39
Brisbane,3751,6,10,5,13,33,42,-9,35
Western Sydn,3751,7,8,9,10,38,47,-9,33
Perth Glory,3751,8,10,2,15,37,50,-13,32
Wellington P,3751,9,5,6,16,31,55,-24,21
CC Mariners,3751,10,4,8,15,28,49,-21,20
Sydney FC,3752,1,20,4,4,64,23,41,64
N'castle Jet,3752,2,16,5,7,60,37,23,53
Melbourne V,3752,3,14,5,10,46,38,8,47
Melbourne C,3752,4,14,4,11,43,36,7,46
Adelaide Utd,3752,5,11,6,11,37,40,-3,39
Brisbane,3752,6,10,5,13,33,42,-9,35
Western Sydn,3752,7,8,9,10,38,47,-9,33
Perth Glory,3752,8,10,2,15,37,50,-13,32
Wellington P,3752,9,5,6,16,31,55,-24,21
CC Mariners,3752,10,4,8,15,28,49,-21,20
Sydney FC,3753,1,20,4,4,64,23,41,64
N'castle Jet,3753,2,15,5,8,57,38,19,50
Melbourne C,3753,3,15,4,10,44,33,11,49
Melbourne V,3753,4,14,5,10,46,38,8,47
Adelaide Utd,3753,5,11,6,11,37,40,-3,39
Brisbane,3753,6,10,5,13,33,42,-9,35
Western Sydn,3753,7,8,9,10,38,47,-9,33
Perth Glory,3753,8,10,2,15,37,50,-13,32
Wellington P,3753,9,5,6,16,31,55,-24,21
CC Mariners,3753,10,4,8,15,28,49,-21,20
Sydney FC,3754,1,21,4,3,66,23,43,67
N'castle Jet,3754,2,15,6,7,58,38,20,51
Melbourne C,3754,3,14,5,10,44,34,10,47
Melbourne V,3754,4,13,5,11,46,40,6,44
Adelaide Utd,3754,5,11,6,11,37,40,-3,39
Brisbane,3754,6,10,5,13,33,42,-9,35
Western Sydn,3754,7,8,9,10,38,47,-9,33
Perth Glory,3754,8,10,2,15,37,50,-13,32
Wellington P,3754,9,5,6,16,31,55,-24,21
CC Mariners,3754,10,4,8,15,28,49,-21,20
Sydney FC,3755,1,20,4,4,64,23,41,64
N'castle Jet,3755,2,16,5,7,60,38,22,53
Melbourne V,3755,3,14,5,10,46,38,8,47
Melbourne C,3755,4,14,4,11,44,36,8,46
Adelaide Utd,3755,5,11,6,11,37,40,-3,39
Brisbane,3755,6,10,5,13,33,42,-9,35
Western Sydn,3755,7,8,9,10,38,47,-9,33
Perth Glory,3755,8,10,2,15,37,50,-13,32
Wellington P,3755,9,5,6,16,31,55,-24,21
CC Mariners,3755,10,4,8,15,28,49,-21,20
Sydney FC,3756,1,21,4,3,68,23,45,67
N'castle Jet,3756,2,15,6,7,59,39,20,51
Melbourne C,3756,3,14,5,10,45,35,10,47
Melbourne V,3756,4,13,5,11,46,42,4,44
Adelaide Utd,3756,5,11,6,11,37,40,-3,39
Brisbane,3756,6,10,5,13,33,42,-9,35
Western Sydn,3756,7,8,9,10,38,47,-9,33
Perth Glory,3756,8,10,2,15,37,50,-13,32
Wellington P,3756,9,5,6,16,31,55,-24,21
CC Mariners,3756,10,4,8,15,28,49,-21,20
Sydney FC,3757,1,20,4,4,64,23,41,64
N'castle Jet,3757,2,15,6,7,58,38,20,51
Melbourne C,3757,3,14,5,10,44,34,10,47
Melbourne V,3757,4,14,5,10,46,38,8,47
Adelaide Utd,3757,5,11,6,11,37,40,-3,39
Brisbane,3757,6,10,5,13,33,42,-9,35
Western Sydn,3757,7,8,9,10,38,47,-9,33
Perth Glory,3757,8,10,2,15,37,50,-13,32
Wellington P,3757,9,5,6,16,31,55,-24,21
CC Mariners,3757,10,4,8,15,28,49,-21,20
Sydney FC,3758,1,21,4,3,67,22,45,67
N'castle Jet,3758,2,15,5,8,58,39,19,50
Melbourne C,3758,3,15,4,10,45,34,11,49
Melbourne V,3758,4,13,5,11,45,41,4,44
Adelaide Utd,3758,5,11,6,11,37,40,-3,39
Brisbane,3758,6,10,5,13,33,42,-9,35
Western Sydn,3758,7,8,9,10,38,47,-9,33
Perth Glory,3758,8,10,2,15,37,50,-13,32
Wellington P,3758,9,5,6,16,31,55,-24,21
CC Mariners,3758,10,4,8,15,28,49,-21,20
Sydney FC,3759,1,21,4,3,66,22,44,67
N'castle Jet,3759,2,15,5,8,57,40,17,50
Melbourne C,3759,3,15,4,10,46,33,13,49
Melbourne V,3759,4,13,5,11,45,40,5,44
Adelaide Utd,3759,5,11,6,11,37,40,-3,39
Brisbane,3759,6,10,5,13,33,42,-9,35
Western Sydn,3759,7,8,9,10,38,47,-9,33
Perth Glory,3759,8,10,2,15,37,50,-13,32
Wellington P,3759,9,5,6,16,31,55,-24,21
CC Mariners,3759,10,4,8,15,28,49,-21,20
Sydney FC,3760,1,21,4,3,66,22,44,67
N'castle Jet,3760,2,15,6,7,59,39,20,51
Melbourne C,3760,3,14,5,10,45,35,10,47
Melbourne V,3760,4,13,5,11,45,40,5,44
Adelaide Utd,3760,5,11,6,11,37,40,-3,39
Brisbane,3760,6,10,5,13,33,42,-9,35
Western Sydn,3760,7,8,9,10,38,47,-9,33
Perth Glory,3760,8,10,2,15,37,50,-13,32
Wellington P,3760,9,5,6,16,31,55,-24,21
CC Mariners,3760,10,4,8,15,28,49,-21,20
Sydney FC,3761,1,21,4,3,68,23,45,67
N'castle Jet,3761,2,15,6,7,59,39,20,51
Melbourne C,3761,3,14,5,10,45,35,10,47
Melbourne V,3761,4,13,5,11,46,42,4,44
Adelaide Utd,3761,5,11,6,11,37,40,-3,39
Brisbane,3761,6,10,5,13,33,42,-9,35
Western Sydn,3761,7,8,9,10,38,47,-9,33
Perth Glory,3761,8,10,2,15,37,50,-13,32
Wellington P,3761,9,5,6,16,31,55,-24,21
CC Mariners,3761,10,4,8,15,28,49,-21,20
Sydney FC,3762,1,21,4,3,67,23,44,67
N'castle Jet,3762,2,16,5,7,59,37,22,53
Melbourne C,3762,3,14,4,11,43,35,8,46
Melbourne V,3762,4,13,5,11,46,41,5,44
Adelaide Utd,3762,5,11,6,11,37,40,-3,39
Brisbane,3762,6,10,5,13,33,42,-9,35
Western Sydn,3762,7,8,9,10,38,47,-9,33
Perth Glory,3762,8,10,2,15,37,50,-13,32
Wellington P,3762,9,5,6,16,31,55,-24,21
CC Mariners,3762,10,4,8,15,28,49,-21,20
Sydney FC,3763,1,21,4,3,67,22,45,67
N'castle Jet,3763,2,15,6,7,58,38,20,51
Melbourne C,3763,3,14,5,10,44,34,10,47
Melbourne V,3763,4,13,5,11,45,41,4,44
Adelaide Utd,3763,5,11,6,11,37,40,-3,39
Brisbane,3763,6,10,5,13,33,42,-9,35
Western Sydn,3763,7,8,9,10,38,47,-9,33
Perth Glory,3763,8,10,2,15,37,50,-13,32
Wellington P,3763,9,5,6,16,31,55,-24,21
CC Mariners,3763,10,4,8,15,28,49,-21,20
Sydney FC,3764,1,21,4,3,65,22,43,67
N'castle Jet,3764,2,15,6,7,57,37,20,51
Melbourne C,3764,3,14,5,10,43,33,10,47
Melbourne V,3764,4,13,5,11,45,39,6,44
Adelaide Utd,3764,5,11,6,11,37,40,-3,39
Brisbane,3764,6,10,5,13,33,42,-9,35
Western Sydn,3764,7,8,9,10,38,47,-9,33
Perth Glory,3764,8,10,2,15,37,50,-13,32
Wellington P,3764,9,5,6,16,31,55,-24,21
CC Mariners,3764,10,4,8,15,28,49,-21,20
Sydney FC,3765,1,20,5,3,66,24,42,65
N'castle Jet,3765,2,15,5,8,57,40,17,50
Melbourne C,3765,3,15,4,10,46,33,13,49
Melbourne V,3765,4,13,6,10,47,40,7,45
Adelaide Utd,3765,5,11,6,11,37,40,-3,39
Brisbane,3765,6,10,5,13,33,42,-9,35
Western Sydn,3765,7,8,9,10,38,47,-9,33
Perth Glory,3765,8,10,2,15,37,50,-13,32
Wellington P,3765,9,5,6,16,31,55,-24,21
CC Mariners,3765,10,4,8,15,28,49,-21,20
Sydney FC,3766,1,21,4,3,69,24,45,67
N'castle Jet,3766,2,16,5,7,58,37,21,53
Melbourne C,3766,3,14,4,11,43,34,9,46
Melbourne V,3766,4,13,5,11,47,43,4,44
Adelaide Utd,3766,5,11,6,11,37,40,-3,39
Brisbane,3766,6,10,5,13,33,42,-9,35
Western Sydn,3766,7,8,9,10,38,47,-9,33
Perth Glory,3766,8,10,2,15,37,50,-13,32
Wellington P,3766,9,5,6,16,31,55,-24,21
CC Mariners,3766,10,4,8,15,28,49,-21,20
Sydney FC,3767,1,20,4,4,64,23,41,64
N'castle Jet,3767,2,16,5,7,60,38,22,53
Melbourne V,3767,3,14,5,10,46,38,8,47
Melbourne C,3767,4,14,4,11,44,36,8,46
Adelaide Utd,3767,5,11,6,11,37,40,-3,39
Brisbane,3767,6,10,5,13,33,42,-9,35
Western Sydn,3767,7,8,9,10,38,47,-9,33
Perth Glory,3767,8,10,2,15,37,50,-13,32
Wellington P,3767,9,5,6,16,31,55,-24,21
CC Mariners,3767,10,4,8,15,28,49,-21,20
Sydney FC,3768,1,21,4,3,66,23,43,67
N'castle Jet,3768,2,15,5,8,58,39,19,50
Melbourne C,3768,3,15,4,10,45,34,11,49
Melbourne V,3768,4,13,5,11,46,40,6,44
Adelaide Utd,3768,5,11,6,11,37,40,-3,39
Brisbane,3768,6,10,5,13,33,42,-9,35
Western Sydn,3768,7,8,9,10,38,47,-9,33
Perth Glory,3768,8,10,2,15,37,50,-13,32
Wellington P,3768,9,5,6,16,31,55,-24,21
CC Mariners,3768,10,4,8,15,28,49,-21,20
Sydney FC,3769,1,20,5,3,64,22,42,65
N'castle Jet,3769,2,16,5,7,61,38,23,53
Melbourne C,3769,3,14,4,11,44,37,7,46
Melbourne V,3769,4,13,6,10,45,38,7,45
Adelaide Utd,3769,5,11,6,11,37,40,-3,39
Brisbane,3769,6,10,5,13,33,42,-9,35
Western Sydn,3769,7,8,9,10,38,47,-9,33
Perth Glory,3769,8,10,2,15,37,50,-13,32
Wellington P,3769,9,5,6,16,31,55,-24,21
CC Mariners,3769,10,4,8,15,28,49,-21,20
Sydney FC,3770,1,20,5,3,65,23,42,65
N'castle Jet,3770,2,16,5,7,59,37,22,53
Melbourne C,3770,3,14,4,11,43,35,8,46
Melbourne V,3770,4,13,6,10,46,39,7,45
Adelaide Utd,3770,5,11,6,11,37,40,-3,39
Brisbane,3770,6,10,5,13,33,42,-9,35
Western Sydn,3770,7,8,9,10,38,47,-9,33
Perth Glory,3770,8,10,2,15,37,50,-13,32
Wellington P,3770,9,5,6,16,31,55,-24,21
CC Mariners,3770,10,4,8,15,28,49,-21,20
Sydney FC,3771,1,20,4,4,64,23,41,64
N'castle Jet,3771,2,15,5,8,58,40,18,50
Melbourne C,3771,3,15,4,10,46,34,12,49
Melbourne V,3771,4,14,5,10,46,38,8,47
Adelaide Utd,3771,5,11,6,11,37,40,-3,39
Brisbane,3771,6,10,5,13,33,42,-9,35
Western Sydn,3771,7,8,9,10,38,47,-9,33
Perth Glory,3771,8,10,2,15,37,50,-13,32
Wellington P,3771,9,5,6,16,31,55,-24,21
CC Mariners,3771,10,4,8,15,28,49,-21,20
Sydney FC,3772,1,20,5,3,64,22,42,65
N'castle Jet,3772,2,16,5,7,58,37,21,53
Melbourne C,3772,3,14,4,11,43,34,9,46
Melbourne V,3772,4,13,6,10,45,38,7,45
Adelaide Utd,3772,5,11,6,11,37,40,-3,39
Brisbane,3772,6,10,5,13,33,42,-9,35
Western Sydn,3772,7,8,9,10,38,47,-9,33
Perth Glory,3772,8,10,2,15,37,50,-13,32
Wellington P,3772,9,5,6,16,31,55,-24,21
CC Mariners,3772,10,4,8,15,28,49,-21,20
Sydney FC,3773,1,21,4,3,70,23,47,67
N'castle Jet,3773,2,16,5,7,58,37,21,53
Melbourne C,3773,3,14,4,11,43,34,9,46
Melbourne V,3773,4,13,5,11,46,44,2,44
Adelaide Utd,3773,5,11,6,11,37,40,-3,39
Brisbane,3773,6,10,5,13,33,42,-9,35
Western Sydn,3773,7,8,9,10,38,47,-9,33
Perth Glory,3773,8,10,2,15,37,50,-13,32
Wellington P,3773,9,5,6,16,31,55,-24,21
CC Mariners,3773,10,4,8,15,28,49,-21,20
Sydney FC,3774,1,21,4,3,66,23,43,67
N'castle Jet,3774,2,15,6,7,58,38,20,51
Melbourne C,3774,3,14,5,10,44,34,10,47
Melbourne V,3774,4,13,5,11,46,40,6,44
Adelaide Utd,3774,5,11,6,11,37,40,-3,39
Brisbane,3774,6,10,5,13,33,42,-9,35
Western Sydn,3774,7,8,9,10,38,47,-9,33
Perth Glory,3774,8,10,2,15,37,50,-13,32
Wellington P,3774,9,5,6,16,31,55,-24,21
CC Mariners,3774,10,4,8,15,28,49,-21,20
Sydney FC,3775,1,21,4,3,65,22,43,67
N'castle Jet,3775,2,16,5,7,59,37,22,53
Melbourne C,3775,3,14,4,11,43,35,8,46
Melbourne V,3775,4,13,5,11,45,39,6,44
Adelaide Utd,3775,5,11,6,11,37,40,-3,39
Brisbane,3775,6,10,5,13,33,42,-9,35
Western Sydn,3775,7,8,9,10,38,47,-9,33
Perth Glory,3775,8,10,2,15,37,50,-13,32
Wellington P,3775,9,5,6,16,31,55,-24,21
CC Mariners,3775,10,4,8,15,28,49,-21,20
Sydney FC,3776,1,20,4,4,65,24,41,64
N'castle Jet,3776,2,15,6,7,57,37,20,51
Melbourne C,3776,3,14,5,10,43,33,10,47
Melbourne V,3776,4,14,5,10,47,39,8,47
Adelaide Utd,3776,5,11,6,11,37,40,-3,39
Brisbane,3776,6,10,5,13,33,42,-9,35
Western Sydn,3776,7,8,9,10,38,47,-9,33
Perth Glory,3776,8,10,2,15,37,50,-13,32
Wellington P,3776,9,5,6,16,31,55,-24,21
CC Mariners,3776,10,4,8,15,28,49,-21,20
Sydney FC,3777,1,21,4,3,68,24,44,67
N'castle Jet,3777,2,15,5,8,57,38,19,50
Melbourne C,3777,3,15,4,10,44,33,11,49
Melbourne V,3777,4,13,5,11,47,42,5,44
Adelaide Utd,3777,5,11,6,11,37,40,-3,39
Brisbane,3777,6,10,5,13,33,42,-9,35
Western Sydn,3777,7,8,9,10,38,47,-9,33
Perth Glory,3777,8,10,2,15,37,50,-13,32
Wellington P,3777,9,5,6,16,31,55,-24,21
CC Mariners,3777,10,4,8,15,28,49,-21,20
Sydney FC,3778,1,21,4,3,68,22,46,67
N'castle Jet,3778,2,16,5,7,60,38,22,53
Melbourne C,3778,3,14,4,11,44,36,8,46
Melbourne V,3778,4,13,5,11,45,42,3,44
Adelaide Utd,3778,5,11,6,11,37,40,-3,39
Brisbane,3778,6,10,5,13,33,42,-9,35
Western Sydn,3778,7,8,9,10,38,47,-9,33
Perth Glory,3778,8,10,2,15,37,50,-13,32
Wellington P,3778,9,5,6,16,31,55,-24,21
CC Mariners,3778,10,4,8,15,28,49,-21,20
Sydney FC,3779,1,20,4,4,64,23,41,64
N'castle Jet,3779,2,16,5,7,63,37,26,53
Melbourne V,3779,3,14,5,10,46,38,8,47
Melbourne C,3779,4,14,4,11,43,39,4,46
Adelaide Utd,3779,5,11,6,11,37,40,-3,39
Brisbane,3779,6,10,5,13,33,42,-9,35
Western Sydn,3779,7,8,9,10,38,47,-9,33
Perth Glory,3779,8,10,2,15,37,50,-13,32
Wellington P,3779,9,5,6,16,31,55,-24,21
CC Mariners,3779,10,4,8,15,28,49,-21,20
Sydney FC,3780,1,20,4,4,66,26,40,64
N'castle Jet,3780,2,16,5,7,58,37,21,53
Melbourne V,3780,3,14,5,10,49,40,9,47
Melbourne C,3780,4,14,4,11,43,34,9,46
Adelaide Utd,3780,5,11,6,11,37,40,-3,39
Brisbane,3780,6,10,5,13,33,42,-9,35
Western Sydn,3780,7,8,9,10,38,47,-9,33
Perth Glory,3780,8,10,2,15,37,50,-13,32
Wellington P,3780,9,5,6,16,31,55,-24,21
CC Mariners,3780,10,4,8,15,28,49,-21,20
Sydney FC,3781,1,21,4,3,66,22,44,67
N'castle Jet,3781,2,16,5,7,60,38,22,53
Melbourne C,3781,3,14,4,11,44,36,8,46
Melbourne V,3781,4,13,5,11,45,40,5,44
Adelaide Utd,3781,5,11,6,11,37,40,-3,39
Brisbane,3781,6,10,5,13,33,42,-9,35
Western Sydn,3781,7,8,9,10,38,47,-9,33
Perth Glory,3781,8,10,2,15,37,50,-13,32
Wellington P,3781,9,5,6,16,31,55,-24,21
CC Mariners,3781,10,4,8,15,28,49,-21,20
Sydney FC,3782,1,21,4,3,67,23,44,67
N'castle Jet,3782,2,16,5,7,61,37,24,53
Melbourne C,3782,3,14,4,11,43,37,6,46
Melbourne V,3782,4,13,5,11,46,41,5,44
Adelaide Utd,3782,5,11,6,11,37,40,-3,39
Brisbane,3782,6,10,5,13,33,42,-9,35
Western Sydn,3782,7,8,9,10,38,47,-9,33
Perth Glory,3782,8,10,2,15,37,50,-13,32
Wellington P,3782,9,5,6,16,31,55,-24,21
CC Mariners,3782,10,4,8,15,28,49,-21,20
Sydney FC,3783,1,21,4,3,65,22,43,67
N'castle Jet,3783,2,15,5,8,57,39,18,50
Melbourne C,3783,3,15,4,10,45,33,12,49
Melbourne V,3783,4,13,5,11,45,39,6,44
Adelaide Utd,3783,5,11,6,11,37,40,-3,39
Brisbane,3783,6,10,5,13,33,42,-9,35
Western Sydn,3783,7,8,9,10,38,47,-9,33
Perth Glory,3783,8,10,2,15,37,50,-13,32
Wellington P,3783,9,5,6,16,31,55,-24,21
CC Mariners,3783,10,4,8,15,28,49,-21,20
Sydney FC,3784,1,21,4,3,66,23,43,67
N'castle Jet,3784,2,16,5,7,59,38,21,53
Melbourne C,3784,3,14,4,11,44,35,9,46
Melbourne V,3784,4,13,5,11,46,40,6,44
Adelaide Utd,3784,5,11,6,11,37,40,-3,39
Brisbane,3784,6,10,5,13,33,42,-9,35
Western Sydn,3784,7,8,9,10,38,47,-9,33
Perth Glory,3784,8,10,2,15,37,50,-13,32
Wellington P,3784,9,5,6,16,31,55,-24,21
CC Mariners,3784,10,4,8,15,28,49,-21,20
Sydney FC,3785,1,21,4,3,65,22,43,67
N'castle Jet,3785,2,16,5,7,59,38,21,53
Melbourne C,3785,3,14,4,11,44,35,9,46
Melbourne V,3785,4,13,5,11,45,39,6,44
Adelaide Utd,3785,5,11,6,11,37,40,-3,39
Brisbane,3785,6,10,5,13,33,42,-9,35
Western Sydn,3785,7,8,9,10,38,47,-9,33
Perth Glory,3785,8,10,2,15,37,50,-13,32
Wellington P,3785,9,5,6,16,31,55,-24,21
CC Mariners,3785,10,4,8,15,28,49,-21,20
Sydney FC,3786,1,21,4,3,67,22,45,67
N'castle Jet,3786,2,16,5,7,60,38,22,53
Melbourne C,3786,3,14,4,11,44,36,8,46
Melbourne V,3786,4,13,5,11,45,41,4,44
Adelaide Utd,3786,5,11,6,11,37,40,-3,39
Brisbane,3786,6,10,5,13,33,42,-9,35
Western Sydn,3786,7,8,9,10,38,47,-9,33
Perth Glory,3786,8,10,2,15,37,50,-13,32
Wellington P,3786,9,5,6,16,31,55,-24,21
CC Mariners,3786,10,4,8,15,28,49,-21,20
Sydney FC,3787,1,21,4,3,69,22,47,67
N'castle Jet,3787,2,16,5,7,61,39,22,53
Melbourne C,3787,3,14,4,11,45,37,8,46
Melbourne V,3787,4,13,5,11,45,43,2,44
Adelaide Utd,3787,5,11,6,11,37,40,-3,39
Brisbane,3787,6,10,5,13,33,42,-9,35
Western Sydn,3787,7,8,9,10,38,47,-9,33
Perth Glory,3787,8,10,2,15,37,50,-13,32
Wellington P,3787,9,5,6,16,31,55,-24,21
CC Mariners,3787,10,4,8,15,28,49,-21,20
Sydney FC,3788,1,21,4,3,71,22,49,67
N'castle Jet,3788,2,16,5,7,59,37,22,53
Melbourne C,3788,3,14,4,11,43,35,8,46
Melbourne V,3788,4,13,5,11,45,45,0,44
Adelaide Utd,3788,5,11,6,11,37,40,-3,39
Brisbane,3788,6,10,5,13,33,42,-9,35
Western Sydn,3788,7,8,9,10,38,47,-9,33
Perth Glory,3788,8,10,2,15,37,50,-13,32
Wellington P,3788,9,5,6,16,31,55,-24,21
CC Mariners,3788,10,4,8,15,28,49,-21,20
Sydney FC,3789,1,21,4,3,69,22,47,67
N'castle Jet,3789,2,15,6,7,59,39,20,51
Melbourne C,3789,3,14,5,10,45,35,10,47
Melbourne V,3789,4,13,5,11,45,43,2,44
Adelaide Utd,3789,5,11,6,11,37,40,-3,39
Brisbane,3789,6,10,5,13,33,42,-9,35
Western Sydn,3789,7,8,9,10,38,47,-9,33
Perth Glory,3789,8,10,2,15,37,50,-13,32
Wellington P,3789,9,5,6,16,31,55,-24,21
CC Mariners,3789,10,4,8,15,28,49,-21,20
Sydney FC,3790,1,20,5,3,65,23,42,65
N'castle Jet,3790,2,15,5,8,57,38,19,50
Melbourne C,3790,3,15,4,10,44,33,11,49
Melbourne V,3790,4,13,6,10,46,39,7,45
Adelaide Utd,3790,5,11,6,11,37,40,-3,39
Brisbane,3790,6,10,5,13,33,42,-9,35
Western Sydn,3790,7,8,9,10,38,47,-9,33
Perth Glory,3790,8,10,2,15,37,50,-13,32
Wellington P,3790,9,5,6,16,31,55,-24,21
CC Mariners,3790,10,4,8,15,28,49,-21,20
Sydney FC,3791,1,20,4,4,66,25,41,64
N'castle Jet,3791,2,15,5,8,57,39,18,50
Melbourne C,3791,3,15,4,10,45,33,12,49
Melbourne V,3791,4,14,5,10,48,40,8,47
Adelaide Utd,3791,5,11,6,11,37,40,-3,39
Brisbane,3791,6,10,5,13,33,42,-9,35
Western Sydn,3791,7,8,9,10,38,47,-9,33
Perth Glory,3791,8,10,2,15,37,50,-13,32
Wellington P,3791,9,5,6,16,31,55,-24,21
CC Mariners,3791,10,4,8,15,28,49,-21,20
Sydney FC,3792,1,21,4,3,66,22,44,67
N'castle Jet,3792,2,16,5,7,59,38,21,53
Melbourne C,3792,3,14,4,11,44,35,9,46
Melbourne V,3792,4,13,5,11,45,40,5,44
Adelaide Utd,3792,5,11,6,11,37,40,-3,39
Brisbane,3792,6,10,5,13,33,42,-9,35
Western Sydn,3792,7,8,9,10,38,47,-9,33
Perth Glory,3792,8,10,2,15,37,50,-13,32
Wellington P,3792,9,5,6,16,31,55,-24,21
CC Mariners,3792,10,4,8,15,28,49,-21,20
Sydney FC,3793,1,20,5,3,65,23,42,65
N'castle Jet,3793,2,16,5,7,61,38,23,53
Melbourne C,3793,3,14,4,11,44,37,7,46
Melbourne V,3793,4,13,6,10,46,39,7,45
Adelaide Utd,3793,5,11,6,11,37,40,-3,39
Brisbane,3793,6,10,5,13,33,42,-9,35
Western Sydn,3793,7,8,9,10,38,47,-9,33
Perth Glory,3793,8,10,2,15,37,50,-13,32
Wellington P,3793,9,5,6,16,31,55,-24,21
CC Mariners,3793,10,4,8,15,28,49,-21,20
Sydney FC,3794,1,21,4,3,65,22,43,67
N'castle Jet,3794,2,16,5,7,61,39,22,53
Melbourne C,3794,3,14,4,11,45,37,8,46
Melbourne V,3794,4,13,5,11,45,39,6,44
Adelaide Utd,3794,5,11,6,11,37,40,-3,39
Brisbane,3794,6,10,5,13,33,42,-9,35
Western Sydn,3794,7,8,9,10,38,47,-9,33
Perth Glory,3794,8,10,2,15,37,50,-13,32
Wellington P,3794,9,5,6,16,31,55,-24,21
CC Mariners,3794,10,4,8,15,28,49,-21,20
Sydney FC,3795,1,20,4,4,64,23,41,64
N'castle Jet,3795,2,15,5,8,57,38,19,50
Melbourne C,3795,3,15,4,10,44,33,11,49
Melbourne V,3795,4,14,5,10,46,38,8,47
Adelaide Utd,3795,5,11,6,11,37,40,-3,39
Brisbane,3795,6,10,5,13,33,42,-9,35
Western Sydn,3795,7,8,9,10,38,47,-9,33
Perth Glory,3795,8,10,2,15,37,50,-13,32
Wellington P,3795,9,5,6,16,31,55,-24,21
CC Mariners,3795,10,4,8,15,28,49,-21,20
Sydney FC,3796,1,20,5,3,66,24,42,65
N'castle Jet,3796,2,15,5,8,58,39,19,50
Melbourne C,3796,3,15,4,10,45,34,11,49
Melbourne V,3796,4,13,6,10,47,40,7,45
Adelaide Utd,3796,5,11,6,11,37,40,-3,39
Brisbane,3796,6,10,5,13,33,42,-9,35
Western Sydn,3796,7,8,9,10,38,47,-9,33
Perth Glory,3796,8,10,2,15,37,50,-13,32
Wellington P,3796,9,5,6,16,31,55,-24,21
CC Mariners,3796,10,4,8,15,28,49,-21,20
Sydney FC,3797,1,21,4,3,67,23,44,67
N'castle Jet,3797,2,15,5,8,58,39,19,50
Melbourne C,3797,3,15,4,10,45,34,11,49
Melbourne V,3797,4,13,5,11,46,41,5,44
Adelaide Utd,3797,5,11,6,11,37,40,-3,39
Brisbane,3797,6,10,5,13,33,42,-9,35
Western Sydn,3797,7,8,9,10,38,47,-9,33
Perth Glory,3797,8,10,2,15,37,50,-13,32
Wellington P,3797,9,5,6,16,31,55,-24,21
CC Mariners,3797,10,4,8,15,28,49,-21,20
Sydney FC,3798,1,21,4,3,67,22,45,67
N'castle Jet,3798,2,16,5,7,58,37,21,53
Melbourne C,3798,3,14,4,11,43,34,9,46
Melbourne V,3798,4,13,5,11,45,41,4,44
Adelaide Utd,3798,5,11,6,11,37,40,-3,39
Brisbane,3798,6,10,5,13,33,42,-9,35
Western Sydn,3798,7,8,9,10,38,47,-9,33
Perth Glory,3798,8,10,2,15,37,50,-13,32
Wellington P,3798,9,5,6,16,31,55,-24,21
CC Mariners,3798,10,4,8,15,28,49,-21,20
Sydney FC,3799,1,21,4,3,67,23,44,67
N'castle Jet,3799,2,15,5,8,58,41,17,50
Melbourne C,3799,3,15,4,10,47,34,13,49
Melbourne V,3799,4,13,5,11,46,41,5,44
Adelaide Utd,3799,5,11,6,11,37,40,-3,39
Brisbane,3799,6,10,5,13,33,42,-9,35
Western Sydn,3799,7,8,9,10,38,47,-9,33
Perth Glory,3799,8,10,2,15,37,50,-13,32
Wellington P,3799,9,5,6,16,31,55,-24,21
CC Mariners,3799,10,4,8,15,28,49,-21,20
Sydney FC,3800,1,21,4,3,68,23,45,67
N'castle Jet,3800,2,16,5,7,59,38,21,53
Melbourne C,3800,3,14,4,11,44,35,9,46
Melbourne V,3800,4,13,5,11,46,42,4,44
Adelaide Utd,3800,5,11,6,11,37,40,-3,39
Brisbane,3800,6,10,5,13,33,42,-9,35
Western Sydn,3800,7,8,9,10,38,47,-9,33
Perth Glory,3800,8,10,2,15,37,50,-13,32
Wellington P,3800,9,5,6,16,31,55,-24,21
CC Mariners,3800,10,4,8,15,28,49,-21,20
Sydney FC,3801,1,21,4,3,70,23,47,67
N'castle Jet,3801,2,16,5,7,59,38,21,53
Melbourne C,3801,3,14,4,11,44,35,9,46
Melbourne V,3801,4,13,5,11,46,44,2,44
Adelaide Utd,3801,5,11,6,11,37,40,-3,39
Brisbane,3801,6,10,5,13,33,42,-9,35
Western Sydn,3801,7,8,9,10,38,47,-9,33
Perth Glory,3801,8,10,2,15,37,50,-13,32
Wellington P,3801,9,5,6,16,31,55,-24,21
CC Mariners,3801,10,4,8,15,28,49,-21,20
Sydney FC,3802,1,20,4,4,65,24,41,64
N'castle Jet,3802,2,15,5,8,58,39,19,50
Melbourne C,3802,3,15,4,10,45,34,11,49
Melbourne V,3802,4,14,5,10,47,39,8,47
Adelaide Utd,3802,5,11,6,11,37,40,-3,39
Brisbane,3802,6,10,5,13,33,42,-9,35
Western Sydn,3802,7,8,9,10,38,47,-9,33
Perth Glory,3802,8,10,2,15,37,50,-13,32
Wellington P,3802,9,5,6,16,31,55,-24,21
CC Mariners,3802,10,4,8,15,28,49,-21,20
Sydney FC,3803,1,21,4,3,67,23,44,67
N'castle Jet,3803,2,15,5,8,58,39,19,50
Melbourne C,3803,3,15,4,10,45,34,11,49
Melbourne V,3803,4,13,5,11,46,41,5,44
Adelaide Utd,3803,5,11,6,11,37,40,-3,39
Brisbane,3803,6,10,5,13,33,42,-9,35
Western Sydn,3803,7,8,9,10,38,47,-9,33
Perth Glory,3803,8,10,2,15,37,50,-13,32
Wellington P,3803,9,5,6,16,31,55,-24,21
CC Mariners,3803,10,4,8,15,28,49,-21,20
Sydney FC,3804,1,20,5,3,66,24,42,65
N'castle Jet,3804,2,15,5,8,57,41,16,50
Melbourne C,3804,3,15,4,10,47,33,14,49
Melbourne V,3804,4,13,6,10,47,40,7,45
Adelaide Utd,3804,5,11,6,11,37,40,-3,39
Brisbane,3804,6,10,5,13,33,42,-9,35
Western Sydn,3804,7,8,9,10,38,47,-9,33
Perth Glory,3804,8,10,2,15,37,50,-13,32
Wellington P,3804,9,5,6,16,31,55,-24,21
CC Mariners,3804,10,4,8,15,28,49,-21,20
Sydney FC,3805,1,21,4,3,66,23,43,67
N'castle Jet,3805,2,16,5,7,58,37,21,53
Melbourne C,3805,3,14,4,11,43,34,9,46
Melbourne V,3805,4,13,5,11,46,40,6,44
Adelaide Utd,3805,5,11,6,11,37,40,-3,39
Brisbane,3805,6,10,5,13,33,42,-9,35
Western Sydn,3805,7,8,9,10,38,47,-9,33
Perth Glory,3805,8,10,2,15,37,50,-13,32
Wellington P,3805,9,5,6,16,31,55,-24,21
CC Mariners,3805,10,4,8,15,28,49,-21,20
Sydney FC,3806,1,21,4,3,67,24,43,67
N'castle Jet,3806,2,15,6,7,58,38,20,51
Melbourne C,3806,3,14,5,10,44,34,10,47
Melbourne V,3806,4,13,5,11,47,41,6,44
Adelaide Utd,3806,5,11,6,11,37,40,-3,39
Brisbane,3806,6,10,5,13,33,42,-9,35
Western Sydn,3806,7,8,9,10,38,47,-9,33
Perth Glory,3806,8,10,2,15,37,50,-13,32
Wellington P,3806,9,5,6,16,31,55,-24,21
CC Mariners,3806,10,4,8,15,28,49,-21,20
Sydney FC,3807,1,21,4,3,65,22,43,67
N'castle Jet,3807,2,15,6,7,57,37,20,51
Melbourne C,3807,3,14,5,10,43,33,10,47
Melbourne V,3807,4,13,5,11,45,39,6,44
Adelaide Utd,3807,5,11,6,11,37,40,-3,39
Brisbane,3807,6,10,5,13,33,42,-9,35
Western Sydn,3807,7,8,9,10,38,47,-9,33
Perth Glory,3807,8,10,2,15,37,50,-13,32
Wellington P,3807,9,5,6,16,31,55,-24,21
CC Mariners,3807,10,4,8,15,28,49,-21,20
Sydney FC,3808,1,20,5,3,64,22,42,65
N'castle Jet,3808,2,16,5,7,60,37,23,53
Melbourne C,3808,3,14,4,11,43,36,7,46
Melbourne V,3808,4,13,6,10,45,38,7,45
Adelaide Utd,3808,5,11,6,11,37,40,-3,39
Brisbane,3808,6,10,5,13,33,42,-9,35
Western Sydn,3808,7,8,9,10,38,47,-9,33
Perth Glory,3808,8,10,2,15,37,50,-13,32
Wellington P,3808,9,5,6,16,31,55,-24,21
CC Mariners,3808,10,4,8,15,28,49,-21,20
Sydney FC,3809,1,21,4,3,66,22,44,67
N'castle Jet,3809,2,16,5,7,59,38,21,53
Melbourne C,3809,3,14,4,11,44,35,9,46
Melbourne V,3809,4,13,5,11,45,40,5,44
Adelaide Utd,3809,5,11,6,11,37,40,-3,39
Brisbane,3809,6,10,5,13,33,42,-9,35
Western Sydn,3809,7,8,9,10,38,47,-9,33
Perth Glory,3809,8,10,2,15,37,50,-13,32
Wellington P,3809,9,5,6,16,31,55,-24,21
CC Mariners,3809,10,4,8,15,28,49,-21,20
Sydney FC,3810,1,21,4,3,66,22,44,67
N'castle Jet,3810,2,16,5,7,59,38,21,53
Melbourne C,3810,3,14,4,11,44,35,9,46
Melbourne V,3810,4,13,5,11,45,40,5,44
Adelaide Utd,3810,5,11,6,11,37,40,-3,39
Brisbane,3810,6,10,5,13,33,42,-9,35
Western Sydn,3810,7,8,9,10,38,47,-9,33
Perth Glory,3810,8,10,2,15,37,50,-13,32
Wellington P,3810,9,5,6,16,31,55,-24,21
CC Mariners,3810,10,4,8,15,28,49,-21,20
Sydney FC,3811,1,20,4,4,65,24,41,64
N'castle Jet,3811,2,15,6,7,58,38,20,51
Melbourne C,3811,3,14,5,10,44,34,10,47
Melbourne V,3811,4,14,5,10,47,39,8,47
Adelaide Utd,3811,5,11,6,11,37,40,-3,39
Brisbane,3811,6,10,5,13,33,42,-9,35
Western Sydn,3811,7,8,9,10,38,47,-9,33
Perth Glory,3811,8,10,2,15,37,50,-13,32
Wellington P,3811,9,5,6,16,31,55,-24,21
CC Mariners,3811,10,4,8,15,28,49,-21,20
Sydney FC,3812,1,21,4,3,67,22,45,67
N'castle Jet,3812,2,16,5,7,58,37,21,53
Melbourne C,3812,3,14,4,11,43,34,9,46
Melbourne V,3812,4,13,5,11,45,41,4,44
Adelaide Utd,3812,5,11,6,11,37,40,-3,39
Brisbane,3812,6,10,5,13,33,42,-9,35
Western Sydn,3812,7,8,9,10,38,47,-9,33
Perth Glory,3812,8,10,2,15,37,50,-13,32
Wellington P,3812,9,5,6,16,31,55,-24,21
CC Mariners,3812,10,4,8,15,28,49,-21,20
Sydney FC,3813,1,20,4,4,65,24,41,64
N'castle Jet,3813,2,15,5,8,57,38,19,50
Melbourne C,3813,3,15,4,10,44,33,11,49
Melbourne V,3813,4,14,5,10,47,39,8,47
Adelaide Utd,3813,5,11,6,11,37,40,-3,39
Brisbane,3813,6,10,5,13,33,42,-9,35
Western Sydn,3813,7,8,9,10,38,47,-9,33
Perth Glory,3813,8,10,2,15,37,50,-13,32
Wellington P,3813,9,5,6,16,31,55,-24,21
CC Mariners,3813,10,4,8,15,28,49,-21,20
Sydney FC,3814,1,21,4,3,66,23,43,67
N'castle Jet,3814,2,16,5,7,60,37,23,53
Melbourne C,3814,3,14,4,11,43,36,7,46
Melbourne V,3814,4,13,5,11,46,40,6,44
Adelaide Utd,3814,5,11,6,11,37,40,-3,39
Brisbane,3814,6,10,5,13,33,42,-9,35
Western Sydn,3814,7,8,9,10,38,47,-9,33
Perth Glory,3814,8,10,2,15,37,50,-13,32
Wellington P,3814,9,5,6,16,31,55,-24,21
CC Mariners,3814,10,4,8,15,28,49,-21,20
Sydney FC,3815,1,21,4,3,65,22,43,67
N'castle Jet,3815,2,16,5,7,62,39,23,53
Melbourne C,3815,3,14,4,11,45,38,7,46
Melbourne V,3815,4,13,5,11,45,39,6,44
Adelaide Utd,3815,5,11,6,11,37,40,-3,39
Brisbane,3815,6,10,5,13,33,42,-9,35
Western Sydn,3815,7,8,9,10,38,47,-9,33
Perth Glory,3815,8,10,2,15,37,50,-13,32
Wellington P,3815,9,5,6,16,31,55,-24,21
CC Mariners,3815,10,4,8,15,28,49,-21,20
Sydney FC,3816,1,21,4,3,66,22,44,67
N'castle Jet,3816,2,16,5,7,60,39,21,53
Melbourne C,3816,3,14,4,11,45,36,9,46
Melbourne V,3816,4,13,5,11,45,40,5,44
Adelaide Utd,3816,5,11,6,11,37,40,-3,39
Brisbane,3816,6,10,5,13,33,42,-9,35
Western Sydn,3816,7,8,9,10,38,47,-9,33
Perth Glory,3816,8,10,2,15,37,50,-13,32
Wellington P,3816,9,5,6,16,31,55,-24,21
CC Mariners,3816,10,4,8,15,28,49,-21,20
Sydney FC,3817,1,21,4,3,66,23,43,67
N'castle Jet,3817,2,16,5,7,59,38,21,53
Melbourne C,3817,3,14,4,11,44,35,9,46
Melbourne V,3817,4,13,5,11,46,40,6,44
Adelaide Utd,3817,5,11,6,11,37,40,-3,39
Brisbane,3817,6,10,5,13,33,42,-9,35
Western Sydn,3817,7,8,9,10,38,47,-9,33
Perth Glory,3817,8,10,2,15,37,50,-13,32
Wellington P,3817,9,5,6,16,31,55,-24,21
CC Mariners,3817,10,4,8,15,28,49,-21,20
Sydney FC,3818,1,21,4,3,68,23,45,67
N'castle Jet,3818,2,16,5,7,60,39,21,53
Melbourne C,3818,3,14,4,11,45,36,9,46
Melbourne V,3818,4,13,5,11,46,42,4,44
Adelaide Utd,3818,5,11,6,11,37,40,-3,39
Brisbane,3818,6,10,5,13,33,42,-9,35
Western Sydn,3818,7,8,9,10,38,47,-9,33
Perth Glory,3818,8,10,2,15,37,50,-13,32
Wellington P,3818,9,5,6,16,31,55,-24,21
CC Mariners,3818,10,4,8,15,28,49,-21,20
Sydney FC,3819,1,20,5,3,64,22,42,65
N'castle Jet,3819,2,16,5,7,62,40,22,53
Melbourne C,3819,3,14,4,11,46,38,8,46
Melbourne V,3819,4,13,6,10,45,38,7,45
Adelaide Utd,3819,5,11,6,11,37,40,-3,39
Brisbane,3819,6,10,5,13,33,42,-9,35
Western Sydn,3819,7,8,9,10,38,47,-9,33
Perth Glory,3819,8,10,2,15,37,50,-13,32
Wellington P,3819,9,5,6,16,31,55,-24,21
CC Mariners,3819,10,4,8,15,28,49,-21,20
Sydney FC,3820,1,21,4,3,66,23,43,67
N'castle Jet,3820,2,16,5,7,61,38,23,53
Melbourne C,3820,3,14,4,11,44,37,7,46
Melbourne V,3820,4,13,5,11,46,40,6,44
Adelaide Utd,3820,5,11,6,11,37,40,-3,39
Brisbane,3820,6,10,5,13,33,42,-9,35
Western Sydn,3820,7,8,9,10,38,47,-9,33
Perth Glory,3820,8,10,2,15,37,50,-13,32
Wellington P,3820,9,5,6,16,31,55,-24,21
CC Mariners,3820,10,4,8,15,28,49,-21,20
Sydney FC,3821,1,21,4,3,66,23,43,67
N'castle Jet,3821,2,15,6,7,60,40,20,51
Melbourne C,3821,3,14,5,10,46,36,10,47
Melbourne V,3821,4,13,5,11,46,40,6,44
Adelaide Utd,3821,5,11,6,11,37,40,-3,39
Brisbane,3821,6,10,5,13,33,42,-9,35
Western Sydn,3821,7,8,9,10,38,47,-9,33
Perth Glory,3821,8,10,2,15,37,50,-13,32
Wellington P,3821,9,5,6,16,31,55,-24,21
CC Mariners,3821,10,4,8,15,28,49,-21,20
Sydney FC,3822,1,20,5,3,65,23,42,65
N'castle Jet,3822,2,16,5,7,58,37,21,53
Melbourne C,3822,3,14,4,11,43,34,9,46
Melbourne V,3822,4,13,6,10,46,39,7,45
Adelaide Utd,3822,5,11,6,11,37,40,-3,39
Brisbane,3822,6,10,5,13,33,42,-9,35
Western Sydn,3822,7,8,9,10,38,47,-9,33
Perth Glory,3822,8,10,2,15,37,50,-13,32
Wellington P,3822,9,5,6,16,31,55,-24,21
CC Mariners,3822,10,4,8,15,28,49,-21,20
Sydney FC,3823,1,21,4,3,68,24,44,67
N'castle Jet,3823,2,16,5,7,59,37,22,53
Melbourne C,3823,3,14,4,11,43,35,8,46
Melbourne V,3823,4,13,5,11,47,42,5,44
Adelaide Utd,3823,5,11,6,11,37,40,-3,39
Brisbane,3823,6,10,5,13,33,42,-9,35
Western Sydn,3823,7,8,9,10,38,47,-9,33
Perth Glory,3823,8,10,2,15,37,50,-13,32
Wellington P,3823,9,5,6,16,31,55,-24,21
CC Mariners,3823,10,4,8,15,28,49,-21,20
Sydney FC,3824,1,20,5,3,66,24,42,65
N'castle Jet,3824,2,16,5,7,59,38,21,53
Melbourne C,3824,3,14,4,11,44,35,9,46
Melbourne V,3824,4,13,6,10,47,40,7,45
Adelaide Utd,3824,5,11,6,11,37,40,-3,39
Brisbane,3824,6,10,5,13,33,42,-9,35
Western Sydn,3824,7,8,9,10,38,47,-9,33
Perth Glory,3824,8,10,2,15,37,50,-13,32
Wellington P,3824,9,5,6,16,31,55,-24,21
CC Mariners,3824,10,4,8,15,28,49,-21,20
Sydney FC,3825,1,20,4,4,65,24,41,64
N'castle Jet,3825,2,15,6,7,57,37,20,51
Melbourne C,3825,3,14,5,10,43,33,10,47
Melbourne V,3825,4,14,5,10,47,39,8,47
Adelaide Utd,3825,5,11,6,11,37,40,-3,39
Brisbane,3825,6,10,5,13,33,42,-9,35
Western Sydn,3825,7,8,9,10,38,47,-9,33
Perth Glory,3825,8,10,2,15,37,50,-13,32
Wellington P,3825,9,5,6,16,31,55,-24,21
CC Mariners,3825,10,4,8,15,28,49,-21,20
Sydney FC,3826,1,21,4,3,65,22,43,67
N'castle Jet,3826,2,15,6,7,57,37,20,51
Melbourne C,3826,3,14,5,10,43,33,10,47
Melbourne V,3826,4,13,5,11,45,39,6,44
Adelaide Utd,3826,5,11,6,11,37,40,-3,39
Brisbane,3826,6,10,5,13,33,42,-9,35
Western Sydn,3826,7,8,9,10,38,47,-9,33
Perth Glory,3826,8,10,2,15,37,50,-13,32
Wellington P,3826,9,5,6,16,31,55,-24,21
CC Mariners,3826,10,4,8,15,28,49,-21,20
Sydney FC,3827,1,21,4,3,68,22,46,67
N'castle Jet,3827,2,15,5,8,57,39,18,50
Melbourne C,3827,3,15,4,10,45,33,12,49
Melbourne V,3827,4,13,5,11,45,42,3,44
Adelaide Utd,3827,5,11,6,11,37,40,-3,39
Brisbane,3827,6,10,5,13,33,42,-9,35
Western Sydn,3827,7,8,9,10,38,47,-9,33
Perth Glory,3827,8,10,2,15,37,50,-13,32
Wellington P,3827,9,5,6,16,31,55,-24,21
CC Mariners,3827,10,4,8,15,28,49,-21,20
Sydney FC,3828,1,20,5,3,66,24,42,65
N'castle Jet,3828,2,15,5,8,57,39,18,50
Melbourne C,3828,3,15,4,10,45,33,12,49
Melbourne V,3828,4,13,6,10,47,40,7,45
Adelaide Utd,3828,5,11,6,11,37,40,-3,39
Brisbane,3828,6,10,5,13,33,42,-9,35
Western Sydn,3828,7,8,9,10,38,47,-9,33
Perth Glory,3828,8,10,2,15,37,50,-13,32
Wellington P,3828,9,5,6,16,31,55,-24,21
CC Mariners,3828,10,4,8,15,28,49,-21,20
Sydney FC,3829,1,20,4,4,64,24,40,64
N'castle Jet,3829,2,16,5,7,58,37,21,53
Melbourne V,3829,3,14,5,10,47,38,9,47
Melbourne C,3829,4,14,4,11,43,34,9,46
Adelaide Utd,3829,5,11,6,11,37,40,-3,39
Brisbane,3829,6,10,5,13,33,42,-9,35
Western Sydn,3829,7,8,9,10,38,47,-9,33
Perth Glory,3829,8,10,2,15,37,50,-13,32
Wellington P,3829,9,5,6,16,31,55,-24,21
CC Mariners,3829,10,4,8,15,28,49,-21,20
Sydney FC,3830,1,21,4,3,67,23,44,67
N'castle Jet,3830,2,16,5,7,59,37,22,53
Melbourne C,3830,3,14,4,11,43,35,8,46
Melbourne V,3830,4,13,5,11,46,41,5,44
Adelaide Utd,3830,5,11,6,11,37,40,-3,39
Brisbane,3830,6,10,5,13,33,42,-9,35
Western Sydn,3830,7,8,9,10,38,47,-9,33
Perth Glory,3830,8,10,2,15,37,50,-13,32
Wellington P,3830,9,5,6,16,31,55,-24,21
CC Mariners,3830,10,4,8,15,28,49,-21,20
Sydney FC,3831,1,21,4,3,67,23,44,67
N'castle Jet,3831,2,16,5,7,59,38,21,53
Melbourne C,3831,3,14,4,11,44,35,9,46
Melbourne V,3831,4,13,5,11,46,41,5,44
Adelaide Utd,3831,5,11,6,11,37,40,-3,39
Brisbane,3831,6,10,5,13,33,42,-9,35
Western Sydn,3831,7,8,9,10,38,47,-9,33
Perth Glory,3831,8,10,2,15,37,50,-13,32
Wellington P,3831,9,5,6,16,31,55,-24,21
CC Mariners,3831,10,4,8,15,28,49,-21,20
Sydney FC,3832,1,21,4,3,68,23,45,67
N'castle Jet,3832,2,16,5,7,59,37,22,53
Melbourne C,3832,3,14,4,11,43,35,8,46
Melbourne V,3832,4,13,5,11,46,42,4,44
Adelaide Utd,3832,5,11,6,11,37,40,-3,39
Brisbane,3832,6,10,5,13,33,42,-9,35
Western Sydn,3832,7,8,9,10,38,47,-9,33
Perth Glory,3832,8,10,2,15,37,50,-13,32
Wellington P,3832,9,5,6,16,31,55,-24,21
CC Mariners,3832,10,4,8,15,28,49,-21,20
Sydney FC,3833,1,21,4,3,67,22,45,67
N'castle Jet,3833,2,15,6,7,59,39,20,51
Melbourne C,3833,3,14,5,10,45,35,10,47
Melbourne V,3833,4,13,5,11,45,41,4,44
Adelaide Utd,3833,5,11,6,11,37,40,-3,39
Brisbane,3833,6,10,5,13,33,42,-9,35
Western Sydn,3833,7,8,9,10,38,47,-9,33
Perth Glory,3833,8,10,2,15,37,50,-13,32
Wellington P,3833,9,5,6,16,31,55,-24,21
CC Mariners,3833,10,4,8,15,28,49,-21,20
Sydney FC,3834,1,21,4,3,68,22,46,67
N'castle Jet,3834,2,15,6,7,57,37,20,51
Melbourne C,3834,3,14,5,10,43,33,10,47
Melbourne V,3834,4,13,5,11,45,42,3,44
Adelaide Utd,3834,5,11,6,11,37,40,-3,39
Brisbane,3834,6,10,5,13,33,42,-9,35
Western Sydn,3834,7,8,9,10,38,47,-9,33
Perth Glory,3834,8,10,2,15,37,50,-13,32
Wellington P,3834,9,5,6,16,31,55,-24,21
CC Mariners,3834,10,4,8,15,28,49,-21,20
Sydney FC,3835,1,20,4,4,65,24,41,64
N'castle Jet,3835,2,16,5,7,61,38,23,53
Melbourne V,3835,3,14,5,10,47,39,8,47
Melbourne C,3835,4,14,4,11,44,37,7,46
Adelaide Utd,3835,5,11,6,11,37,40,-3,39
Brisbane,3835,6,10,5,13,33,42,-9,35
Western Sydn,3835,7,8,9,10,38,47,-9,33
Perth Glory,3835,8,10,2,15,37,50,-13,32
Wellington P,3835,9,5,6,16,31,55,-24,21
CC Mariners,3835,10,4,8,15,28,49,-21,20
Sydney FC,3836,1,21,4,3,68,23,45,67
N'castle Jet,3836,2,15,5,8,58,41,17,50
Melbourne C,3836,3,15,4,10,47,34,13,49
Melbourne V,3836,4,13,5,11,46,42,4,44
Adelaide Utd,3836,5,11,6,11,37,40,-3,39
Brisbane,3836,6,10,5,13,33,42,-9,35
Western Sydn,3836,7,8,9,10,38,47,-9,33
Perth Glory,3836,8,10,2,15,37,50,-13,32
Wellington P,3836,9,5,6,16,31,55,-24,21
CC Mariners,3836,10,4,8,15,28,49,-21,20
Sydney FC,3837,1,21,4,3,69,23,46,67
N'castle Jet,3837,2,15,6,7,60,40,20,51
Melbourne C,3837,3,14,5,10,46,36,10,47
Melbourne V,3837,4,13,5,11,46,43,3,44
Adelaide Utd,3837,5,11,6,11,37,40,-3,39
Brisbane,3837,6,10,5,13,33,42,-9,35
Western Sydn,3837,7,8,9,10,38,47,-9,33
Perth Glory,3837,8,10,2,15,37,50,-13,32
Wellington P,3837,9,5,6,16,31,55,-24,21
CC Mariners,3837,10,4,8,15,28,49,-21,20
Sydney FC,3838,1,21,4,3,65,22,43,67
N'castle Jet,3838,2,15,6,7,58,38,20,51
Melbourne C,3838,3,14,5,10,44,34,10,47
Melbourne V,3838,4,13,5,11,45,39,6,44
Adelaide Utd,3838,5,11,6,11,37,40,-3,39
Brisbane,3838,6,10,5,13,33,42,-9,35
Western Sydn,3838,7,8,9,10,38,47,-9,33
Perth Glory,3838,8,10,2,15,37,50,-13,32
Wellington P,3838,9,5,6,16,31,55,-24,21
CC Mariners,3838,10,4,8,15,28,49,-21,20
Sydney FC,3839,1,21,4,3,71,22,49,67
N'castle Jet,3839,2,16,5,7,60,37,23,53
Melbourne C,3839,3,14,4,11,43,36,7,46
Melbourne V,3839,4,13,5,11,45,45,0,44
Adelaide Utd,3839,5,11,6,11,37,40,-3,39
Brisbane,3839,6,10,5,13,33,42,-9,35
Western Sydn,3839,7,8,9,10,38,47,-9,33
Perth Glory,3839,8,10,2,15,37,50,-13,32
Wellington P,3839,9,5,6,16,31,55,-24,21
CC Mariners,3839,10,4,8,15,28,49,-21,20
Sydney FC,3840,1,20,4,4,64,27,37,64
N'castle Jet,3840,2,16,5,7,60,38,22,53
Melbourne V,3840,3,14,5,10,50,38,12,47
Melbourne C,3840,4,14,4,11,44,36,8,46
Adelaide Utd,3840,5,11,6,11,37,40,-3,39
Brisbane,3840,6,10,5,13,33,42,-9,35
Western Sydn,3840,7,8,9,10,38,47,-9,33
Perth Glory,3840,8,10,2,15,37,50,-13,32
Wellington P,3840,9,5,6,16,31,55,-24,21
CC Mariners,3840,10,4,8,15,28,49,-21,20
Sydney FC,3841,1,21,4,3,66,23,43,67
N'castle Jet,3841,2,16,5,7,63,38,25,53
Melbourne C,3841,3,14,4,11,44,39,5,46
Melbourne V,3841,4,13,5,11,46,40,6,44
Adelaide Utd,3841,5,11,6,11,37,40,-3,39
Brisbane,3841,6,10,5,13,33,42,-9,35
Western Sydn,3841,7,8,9,10,38,47,-9,33
Perth Glory,3841,8,10,2,15,37,50,-13,32
Wellington P,3841,9,5,6,16,31,55,-24,21
CC Mariners,3841,10,4,8,15,28,49,-21,20
Sydney FC,3842,1,21,4,3,67,23,44,67
N'castle Jet,3842,2,16,5,7,59,37,22,53
Melbourne C,3842,3,14,4,11,43,35,8,46
Melbourne V,3842,4,13,5,11,46,41,5,44
Adelaide Utd,3842,5,11,6,11,37,40,-3,39
Brisbane,3842,6,10,5,13,33,42,-9,35
Western Sydn,3842,7,8,9,10,38,47,-9,33
Perth Glory,3842,8,10,2,15,37,50,-13,32
Wellington P,3842,9,5,6,16,31,55,-24,21
CC Mariners,3842,10,4,8,15,28,49,-21,20
Sydney FC,3843,1,21,4,3,67,22,45,67
N'castle Jet,3843,2,15,6,7,58,38,20,51
Melbourne C,3843,3,14,5,10,44,34,10,47
Melbourne V,3843,4,13,5,11,45,41,4,44
Adelaide Utd,3843,5,11,6,11,37,40,-3,39
Brisbane,3843,6,10,5,13,33,42,-9,35
Western Sydn,3843,7,8,9,10,38,47,-9,33
Perth Glory,3843,8,10,2,15,37,50,-13,32
Wellington P,3843,9,5,6,16,31,55,-24,21
CC Mariners,3843,10,4,8,15,28,49,-21,20
Sydney FC,3844,1,21,4,3,65,22,43,67
N'castle Jet,3844,2,16,5,7,64,39,25,53
Melbourne C,3844,3,14,4,11,45,40,5,46
Melbourne V,3844,4,13,5,11,45,39,6,44
Adelaide Utd,3844,5,11,6,11,37,40,-3,39
Brisbane,3844,6,10,5,13,33,42,-9,35
Western Sydn,3844,7,8,9,10,38,47,-9,33
Perth Glory,3844,8,10,2,15,37,50,-13,32
Wellington P,3844,9,5,6,16,31,55,-24,21
CC Mariners,3844,10,4,8,15,28,49,-21,20
Sydney FC,3845,1,20,4,4,65,24,41,64
N'castle Jet,3845,2,16,5,7,62,38,24,53
Melbourne V,3845,3,14,5,10,47,39,8,47
Melbourne C,3845,4,14,4,11,44,38,6,46
Adelaide Utd,3845,5,11,6,11,37,40,-3,39
Brisbane,3845,6,10,5,13,33,42,-9,35
Western Sydn,3845,7,8,9,10,38,47,-9,33
Perth Glory,3845,8,10,2,15,37,50,-13,32
Wellington P,3845,9,5,6,16,31,55,-24,21
CC Mariners,3845,10,4,8,15,28,49,-21,20
Sydney FC,3846,1,20,4,4,64,25,39,64
N'castle Jet,3846,2,15,5,8,57,40,17,50
Melbourne C,3846,3,15,4,10,46,33,13,49
Melbourne V,3846,4,14,5,10,48,38,10,47
Adelaide Utd,3846,5,11,6,11,37,40,-3,39
Brisbane,3846,6,10,5,13,33,42,-9,35
Western Sydn,3846,7,8,9,10,38,47,-9,33
Perth Glory,3846,8,10,2,15,37,50,-13,32
Wellington P,3846,9,5,6,16,31,55,-24,21
CC Mariners,3846,10,4,8,15,28,49,-21,20
Sydney FC,3847,1,20,5,3,65,23,42,65
N'castle Jet,3847,2,16,5,7,59,37,22,53
Melbourne C,3847,3,14,4,11,43,35,8,46
Melbourne V,3847,4,13,6,10,46,39,7,45
Adelaide Utd,3847,5,11,6,11,37,40,-3,39
Brisbane,3847,6,10,5,13,33,42,-9,35
Western Sydn,3847,7,8,9,10,38,47,-9,33
Perth Glory,3847,8,10,2,15,37,50,-13,32
Wellington P,3847,9,5,6,16,31,55,-24,21
CC Mariners,3847,10,4,8,15,28,49,-21,20
Sydney FC,3848,1,21,4,3,65,22,43,67
N'castle Jet,3848,2,15,5,8,57,38,19,50
Melbourne C,3848,3,15,4,10,44,33,11,49
Melbourne V,3848,4,13,5,11,45,39,6,44
Adelaide Utd,3848,5,11,6,11,37,40,-3,39
Brisbane,3848,6,10,5,13,33,42,-9,35
Western Sydn,3848,7,8,9,10,38,47,-9,33
Perth Glory,3848,8,10,2,15,37,50,-13,32
Wellington P,3848,9,5,6,16,31,55,-24,21
CC Mariners,3848,10,4,8,15,28,49,-21,20
Sydney FC,3849,1,21,4,3,66,23,43,67
N'castle Jet,3849,2,16,5,7,64,40,24,53
Melbourne C,3849,3,14,4,11,46,40,6,46
Melbourne V,3849,4,13,5,11,46,40,6,44
Adelaide Utd,3849,5,11,6,11,37,40,-3,39
Brisbane,3849,6,10,5,13,33,42,-9,35
Western Sydn,3849,7,8,9,10,38,47,-9,33
Perth Glory,3849,8,10,2,15,37,50,-13,32
Wellington P,3849,9,5,6,16,31,55,-24,21
CC Mariners,3849,10,4,8,15,28,49,-21,20
Sydney FC,3850,1,20,5,3,65,23,42,65
N'castle Jet,3850,2,15,6,7,57,37,20,51
Melbourne C,3850,3,14,5,10,43,33,10,47
Melbourne V,3850,4,13,6,10,46,39,7,45
Adelaide Utd,3850,5,11,6,11,37,40,-3,39
Brisbane,3850,6,10,5,13,33,42,-9,35
Western Sydn,3850,7,8,9,10,38,47,-9,33
Perth Glory,3850,8,10,2,15,37,50,-13,32
Wellington P,3850,9,5,6,16,31,55,-24,21
CC Mariners,3850,10,4,8,15,28,49,-21,20
Sydney FC,3851,1,20,4,4,64,23,41,64
N'castle Jet,3851,2,15,6,7,58,38,20,51
Melbourne C,3851,3,14,5,10,44,34,10,47
Melbourne V,3851,4,14,5,10,46,38,8,47
Adelaide Utd,3851,5,11,6,11,37,40,-3,39
Brisbane,3851,6,10,5,13,33,42,-9,35
Western Sydn,3851,7,8,9,10,38,47,-9,33
Perth Glory,3851,8,10,2,15,37,50,-13,32
Wellington P,3851,9,5,6,16,31,55,-24,21
CC Mariners,3851,10,4,8,15,28,49,-21,20
Sydney FC,3852,1,21,4,3,66,22,44,67
N'castle Jet,3852,2,16,5,7,60,39,21,53
Melbourne C,3852,3,14,4,11,45,36,9,46
Melbourne V,3852,4,13,5,11,45,40,5,44
Adelaide Utd,3852,5,11,6,11,37,40,-3,39
Brisbane,3852,6,10,5,13,33,42,-9,35
Western Sydn,3852,7,8,9,10,38,47,-9,33
Perth Glory,3852,8,10,2,15,37,50,-13,32
Wellington P,3852,9,5,6,16,31,55,-24,21
CC Mariners,3852,10,4,8,15,28,49,-21,20
Sydney FC,3853,1,21,4,3,65,22,43,67
N'castle Jet,3853,2,15,6,7,57,37,20,51
Melbourne C,3853,3,14,5,10,43,33,10,47
Melbourne V,3853,4,13,5,11,45,39,6,44
Adelaide Utd,3853,5,11,6,11,37,40,-3,39
Brisbane,3853,6,10,5,13,33,42,-9,35
Western Sydn,3853,7,8,9,10,38,47,-9,33
Perth Glory,3853,8,10,2,15,37,50,-13,32
Wellington P,3853,9,5,6,16,31,55,-24,21
CC Mariners,3853,10,4,8,15,28,49,-21,20
Sydney FC,3854,1,21,4,3,65,22,43,67
N'castle Jet,3854,2,15,5,8,57,38,19,50
Melbourne C,3854,3,15,4,10,44,33,11,49
Melbourne V,3854,4,13,5,11,45,39,6,44
Adelaide Utd,3854,5,11,6,11,37,40,-3,39
Brisbane,3854,6,10,5,13,33,42,-9,35
Western Sydn,3854,7,8,9,10,38,47,-9,33
Perth Glory,3854,8,10,2,15,37,50,-13,32
Wellington P,3854,9,5,6,16,31,55,-24,21
CC Mariners,3854,10,4,8,15,28,49,-21,20
Sydney FC,3855,1,21,4,3,65,22,43,67
N'castle Jet,3855,2,15,5,8,58,39,19,50
Melbourne C,3855,3,15,4,10,45,34,11,49
Melbourne V,3855,4,13,5,11,45,39,6,44
Adelaide Utd,3855,5,11,6,11,37,40,-3,39
Brisbane,3855,6,10,5,13,33,42,-9,35
Western Sydn,3855,7,8,9,10,38,47,-9,33
Perth Glory,3855,8,10,2,15,37,50,-13,32
Wellington P,3855,9,5,6,16,31,55,-24,21
CC Mariners,3855,10,4,8,15,28,49,-21,20
Sydney FC,3856,1,21,4,3,66,22,44,67
N'castle Jet,3856,2,15,5,8,58,39,19,50
Melbourne C,3856,3,15,4,10,45,34,11,49
Melbourne V,3856,4,13,5,11,45,40,5,44
Adelaide Utd,3856,5,11,6,11,37,40,-3,39
Brisbane,3856,6,10,5,13,33,42,-9,35
Western Sydn,3856,7,8,9,10,38,47,-9,33
Perth Glory,3856,8,10,2,15,37,50,-13,32
Wellington P,3856,9,5,6,16,31,55,-24,21
CC Mariners,3856,10,4,8,15,28,49,-21,20
Sydney FC,3857,1,20,5,3,65,23,42,65
N'castle Jet,3857,2,16,5,7,59,38,21,53
Melbourne C,3857,3,14,4,11,44,35,9,46
Melbourne V,3857,4,13,6,10,46,39,7,45
Adelaide Utd,3857,5,11,6,11,37,40,-3,39
Brisbane,3857,6,10,5,13,33,42,-9,35
Western Sydn,3857,7,8,9,10,38,47,-9,33
Perth Glory,3857,8,10,2,15,37,50,-13,32
Wellington P,3857,9,5,6,16,31,55,-24,21
CC Mariners,3857,10,4,8,15,28,49,-21,20
Sydney FC,3858,1,20,5,3,65,23,42,65
N'castle Jet,3858,2,16,5,7,59,38,21,53
Melbourne C,3858,3,14,4,11,44,35,9,46
Melbourne V,3858,4,13,6,10,46,39,7,45
Adelaide Utd,3858,5,11,6,11,37,40,-3,39
Brisbane,3858,6,10,5,13,33,42,-9,35
Western Sydn,3858,7,8,9,10,38,47,-9,33
Perth Glory,3858,8,10,2,15,37,50,-13,32
Wellington P,3858,9,5,6,16,31,55,-24,21
CC Mariners,3858,10,4,8,15,28,49,-21,20
Sydney FC,3859,1,21,4,3,66,23,43,67
N'castle Jet,3859,2,16,5,7,59,37,22,53
Melbourne C,3859,3,14,4,11,43,35,8,46
Melbourne V,3859,4,13,5,11,46,40,6,44
Adelaide Utd,3859,5,11,6,11,37,40,-3,39
Brisbane,3859,6,10,5,13,33,42,-9,35
Western Sydn,3859,7,8,9,10,38,47,-9,33
Perth Glory,3859,8,10,2,15,37,50,-13,32
Wellington P,3859,9,5,6,16,31,55,-24,21
CC Mariners,3859,10,4,8,15,28,49,-21,20
Sydney FC,3860,1,20,4,4,66,25,41,64
N'castle Jet,3860,2,15,6,7,58,38,20,51
Melbourne C,3860,3,14,5,10,44,34,10,47
Melbourne V,3860,4,14,5,10,48,40,8,47
Adelaide Utd,3860,5,11,6,11,37,40,-3,39
Brisbane,3860,6,10,5,13,33,42,-9,35
Western Sydn,3860,7,8,9,10,38,47,-9,33
Perth Glory,3860,8,10,2,15,37,50,-13,32
Wellington P,3860,9,5,6,16,31,55,-24,21
CC Mariners,3860,10,4,8,15,28,49,-21,20
Sydney FC,3861,1,21,4,3,66,23,43,67
N'castle Jet,3861,2,15,5,8,58,39,19,50
Melbourne C,3861,3,15,4,10,45,34,11,49
Melbourne V,3861,4,13,5,11,46,40,6,44
Adelaide Utd,3861,5,11,6,11,37,40,-3,39
Brisbane,3861,6,10,5,13,33,42,-9,35
Western Sydn,3861,7,8,9,10,38,47,-9,33
Perth Glory,3861,8,10,2,15,37,50,-13,32
Wellington P,3861,9,5,6,16,31,55,-24,21
CC Mariners,3861,10,4,8,15,28,49,-21,20
Sydney FC,3862,1,21,4,3,67,23,44,67
N'castle Jet,3862,2,15,5,8,59,41,18,50
Melbourne C,3862,3,15,4,10,47,35,12,49
Melbourne V,3862,4,13,5,11,46,41,5,44
Adelaide Utd,3862,5,11,6,11,37,40,-3,39
Brisbane,3862,6,10,5,13,33,42,-9,35
Western Sydn,3862,7,8,9,10,38,47,-9,33
Perth Glory,3862,8,10,2,15,37,50,-13,32
Wellington P,3862,9,5,6,16,31,55,-24,21
CC Mariners,3862,10,4,8,15,28,49,-21,20
Sydney FC,3863,1,21,4,3,67,23,44,67
N'castle Jet,3863,2,16,5,7,62,40,22,53
Melbourne C,3863,3,14,4,11,46,38,8,46
Melbourne V,3863,4,13,5,11,46,41,5,44
Adelaide Utd,3863,5,11,6,11,37,40,-3,39
Brisbane,3863,6,10,5,13,33,42,-9,35
Western Sydn,3863,7,8,9,10,38,47,-9,33
Perth Glory,3863,8,10,2,15,37,50,-13,32
Wellington P,3863,9,5,6,16,31,55,-24,21
CC Mariners,3863,10,4,8,15,28,49,-21,20
Sydney FC,3864,1,20,5,3,68,26,42,65
N'castle Jet,3864,2,16,5,7,63,37,26,53
Melbourne C,3864,3,14,4,11,43,39,4,46
Melbourne V,3864,4,13,6,10,49,42,7,45
Adelaide Utd,3864,5,11,6,11,37,40,-3,39
Brisbane,3864,6,10,5,13,33,42,-9,35
Western Sydn,3864,7,8,9,10,38,47,-9,33
Perth Glory,3864,8,10,2,15,37,50,-13,32
Wellington P,3864,9,5,6,16,31,55,-24,21
CC Mariners,3864,10,4,8,15,28,49,-21,20
Sydney FC,3865,1,21,4,3,69,24,45,67
N'castle Jet,3865,2,16,5,7,58,37,21,53
Melbourne C,3865,3,14,4,11,43,34,9,46
Melbourne V,3865,4,13,5,11,47,43,4,44
Adelaide Utd,3865,5,11,6,11,37,40,-3,39
Brisbane,3865,6,10,5,13,33,42,-9,35
Western Sydn,3865,7,8,9,10,38,47,-9,33
Perth Glory,3865,8,10,2,15,37,50,-13,32
Wellington P,3865,9,5,6,16,31,55,-24,21
CC Mariners,3865,10,4,8,15,28,49,-21,20
Sydney FC,3866,1,21,4,3,71,22,49,67
N'castle Jet,3866,2,16,5,7,58,37,21,53
Melbourne C,3866,3,14,4,11,43,34,9,46
Melbourne V,3866,4,13,5,11,45,45,0,44
Adelaide Utd,3866,5,11,6,11,37,40,-3,39
Brisbane,3866,6,10,5,13,33,42,-9,35
Western Sydn,3866,7,8,9,10,38,47,-9,33
Perth Glory,3866,8,10,2,15,37,50,-13,32
Wellington P,3866,9,5,6,16,31,55,-24,21
CC Mariners,3866,10,4,8,15,28,49,-21,20
Sydney FC,3867,1,21,4,3,66,23,43,67
N'castle Jet,3867,2,15,5,8,57,41,16,50
Melbourne C,3867,3,15,4,10,47,33,14,49
Melbourne V,3867,4,13,5,11,46,40,6,44
Adelaide Utd,3867,5,11,6,11,37,40,-3,39
Brisbane,3867,6,10,5,13,33,42,-9,35
Western Sydn,3867,7,8,9,10,38,47,-9,33
Perth Glory,3867,8,10,2,15,37,50,-13,32
Wellington P,3867,9,5,6,16,31,55,-24,21
CC Mariners,3867,10,4,8,15,28,49,-21,20
Sydney FC,3868,1,20,5,3,65,23,42,65
N'castle Jet,3868,2,16,5,7,60,38,22,53
Melbourne C,3868,3,14,4,11,44,36,8,46
Melbourne V,3868,4,13,6,10,46,39,7,45
Adelaide Utd,3868,5,11,6,11,37,40,-3,39
Brisbane,3868,6,10,5,13,33,42,-9,35
Western Sydn,3868,7,8,9,10,38,47,-9,33
Perth Glory,3868,8,10,2,15,37,50,-13,32
Wellington P,3868,9,5,6,16,31,55,-24,21
CC Mariners,3868,10,4,8,15,28,49,-21,20
Sydney FC,3869,1,21,4,3,66,22,44,67
N'castle Jet,3869,2,15,6,7,58,38,20,51
Melbourne C,3869,3,14,5,10,44,34,10,47
Melbourne V,3869,4,13,5,11,45,40,5,44
Adelaide Utd,3869,5,11,6,11,37,40,-3,39
Brisbane,3869,6,10,5,13,33,42,-9,35
Western Sydn,3869,7,8,9,10,38,47,-9,33
Perth Glory,3869,8,10,2,15,37,50,-13,32
Wellington P,3869,9,5,6,16,31,55,-24,21
CC Mariners,3869,10,4,8,15,28,49,-21,20
Sydney FC,3870,1,21,4,3,65,22,43,67
N'castle Jet,3870,2,15,6,7,58,38,20,51
Melbourne C,3870,3,14,5,10,44,34,10,47
Melbourne V,3870,4,13,5,11,45,39,6,44
Adelaide Utd,3870,5,11,6,11,37,40,-3,39
Brisbane,3870,6,10,5,13,33,42,-9,35
Western Sydn,3870,7,8,9,10,38,47,-9,33
Perth Glory,3870,8,10,2,15,37,50,-13,32
Wellington P,3870,9,5,6,16,31,55,-24,21
CC Mariners,3870,10,4,8,15,28,49,-21,20
Sydney FC,3871,1,21,4,3,67,22,45,67
N'castle Jet,3871,2,16,5,7,60,37,23,53
Melbourne C,3871,3,14,4,11,43,36,7,46
Melbourne V,3871,4,13,5,11,45,41,4,44
Adelaide Utd,3871,5,11,6,11,37,40,-3,39
Brisbane,3871,6,10,5,13,33,42,-9,35
Western Sydn,3871,7,8,9,10,38,47,-9,33
Perth Glory,3871,8,10,2,15,37,50,-13,32
Wellington P,3871,9,5,6,16,31,55,-24,21
CC Mariners,3871,10,4,8,15,28,49,-21,20
Sydney FC,3872,1,21,4,3,65,22,43,67
N'castle Jet,3872,2,15,6,7,57,37,20,51
Melbourne C,3872,3,14,5,10,43,33,10,47
Melbourne V,3872,4,13,5,11,45,39,6,44
Adelaide Utd,3872,5,11,6,11,37,40,-3,39
Brisbane,3872,6,10,5,13,33,42,-9,35
Western Sydn,3872,7,8,9,10,38,47,-9,33
Perth Glory,3872,8,10,2,15,37,50,-13,32
Wellington P,3872,9,5,6,16,31,55,-24,21
CC Mariners,3872,10,4,8,15,28,49,-21,20
Sydney FC,3873,1,20,5,3,65,23,42,65
N'castle Jet,3873,2,15,5,8,57,38,19,50
Melbourne C,3873,3,15,4,10,44,33,11,49
Melbourne V,3873,4,13,6,10,46,39,7,45
Adelaide Utd,3873,5,11,6,11,37,40,-3,39
Brisbane,3873,6,10,5,13,33,42,-9,35
Western Sydn,3873,7,8,9,10,38,47,-9,33
Perth Glory,3873,8,10,2,15,37,50,-13,32
Wellington P,3873,9,5,6,16,31,55,-24,21
CC Mariners,3873,10,4,8,15,28,49,-21,20
Sydney FC,3874,1,20,5,3,66,24,42,65
N'castle Jet,3874,2,15,5,8,58,39,19,50
Melbourne C,3874,3,15,4,10,45,34,11,49
Melbourne V,3874,4,13,6,10,47,40,7,45
Adelaide Utd,3874,5,11,6,11,37,40,-3,39
Brisbane,3874,6,10,5,13,33,42,-9,35
Western Sydn,3874,7,8,9,10,38,47,-9,33
Perth Glory,3874,8,10,2,15,37,50,-13,32
Wellington P,3874,9,5,6,16,31,55,-24,21
CC Mariners,3874,10,4,8,15,28,49,-21,20
Sydney FC,3875,1,21,4,3,65,22,43,67
N'castle Jet,3875,2,16,5,7,59,38,21,53
Melbourne C,3875,3,14,4,11,44,35,9,46
Melbourne V,3875,4,13,5,11,45,39,6,44
Adelaide Utd,3875,5,11,6,11,37,40,-3,39
Brisbane,3875,6,10,5,13,33,42,-9,35
Western Sydn,3875,7,8,9,10,38,47,-9,33
Perth Glory,3875,8,10,2,15,37,50,-13,32
Wellington P,3875,9,5,6,16,31,55,-24,21
CC Mariners,3875,10,4,8,15,28,49,-21,20
Sydney FC,3876,1,21,4,3,66,23,43,67
N'castle Jet,3876,2,16,5,7,62,39,23,53
Melbourne C,3876,3,14,4,11,45,38,7,46
Melbourne V,3876,4,13,5,11,46,40,6,44
Adelaide Utd,3876,5,11,6,11,37,40,-3,39
Brisbane,3876,6,10,5,13,33,42,-9,35
Western Sydn,3876,7,8,9,10,38,47,-9,33
Perth Glory,3876,8,10,2,15,37,50,-13,32
Wellington P,3876,9,5,6,16,31,55,-24,21
CC Mariners,3876,10,4,8,15,28,49,-21,20
Sydney FC,3877,1,21,4,3,70,23,47,67
N'castle Jet,3877,2,16,5,7,60,37,23,53
Melbourne C,3877,3,14,4,11,43,36,7,46
Melbourne V,3877,4,13,5,11,46,44,2,44
Adelaide Utd,3877,5,11,6,11,37,40,-3,39
Brisbane,3877,6,10,5,13,33,42,-9,35
Western Sydn,3877,7,8,9,10,38,47,-9,33
Perth Glory,3877,8,10,2,15,37,50,-13,32
Wellington P,3877,9,5,6,16,31,55,-24,21
CC Mariners,3877,10,4,8,15,28,49,-21,20
Sydney FC,3878,1,20,5,3,66,24,42,65
N'castle Jet,3878,2,16,5,7,58,37,21,53
Melbourne C,3878,3,14,4,11,43,34,9,46
Melbourne V,3878,4,13,6,10,47,40,7,45
Adelaide Utd,3878,5,11,6,11,37,40,-3,39
Brisbane,3878,6,10,5,13,33,42,-9,35
Western Sydn,3878,7,8,9,10,38,47,-9,33
Perth Glory,3878,8,10,2,15,37,50,-13,32
Wellington P,3878,9,5,6,16,31,55,-24,21
CC Mariners,3878,10,4,8,15,28,49,-21,20
Sydney FC,3879,1,21,4,3,67,22,45,67
N'castle Jet,3879,2,16,5,7,60,39,21,53
Melbourne C,3879,3,14,4,11,45,36,9,46
Melbourne V,3879,4,13,5,11,45,41,4,44
Adelaide Utd,3879,5,11,6,11,37,40,-3,39
Brisbane,3879,6,10,5,13,33,42,-9,35
Western Sydn,3879,7,8,9,10,38,47,-9,33
Perth Glory,3879,8,10,2,15,37,50,-13,32
Wellington P,3879,9,5,6,16,31,55,-24,21
CC Mariners,3879,10,4,8,15,28,49,-21,20
Sydney FC,3880,1,21,4,3,66,22,44,67
N'castle Jet,3880,2,16,5,7,59,37,22,53
Melbourne C,3880,3,14,4,11,43,35,8,46
Melbourne V,3880,4,13,5,11,45,40,5,44
Adelaide Utd,3880,5,11,6,11,37,40,-3,39
Brisbane,3880,6,10,5,13,33,42,-9,35
Western Sydn,3880,7,8,9,10,38,47,-9,33
Perth Glory,3880,8,10,2,15,37,50,-13,32
Wellington P,3880,9,5,6,16,31,55,-24,21
CC Mariners,3880,10,4,8,15,28,49,-21,20
Sydney FC,3881,1,21,4,3,66,22,44,67
N'castle Jet,3881,2,16,5,7,61,38,23,53
Melbourne C,3881,3,14,4,11,44,37,7,46
Melbourne V,3881,4,13,5,11,45,40,5,44
Adelaide Utd,3881,5,11,6,11,37,40,-3,39
Brisbane,3881,6,10,5,13,33,42,-9,35
Western Sydn,3881,7,8,9,10,38,47,-9,33
Perth Glory,3881,8,10,2,15,37,50,-13,32
Wellington P,3881,9,5,6,16,31,55,-24,21
CC Mariners,3881,10,4,8,15,28,49,-21,20
Sydney FC,3882,1,20,4,4,65,24,41,64
N'castle Jet,3882,2,15,6,7,58,38,20,51
Melbourne C,3882,3,14,5,10,44,34,10,47
Melbourne V,3882,4,14,5,10,47,39,8,47
Adelaide Utd,3882,5,11,6,11,37,40,-3,39
Brisbane,3882,6,10,5,13,33,42,-9,35
Western Sydn,3882,7,8,9,10,38,47,-9,33
Perth Glory,3882,8,10,2,15,37,50,-13,32
Wellington P,3882,9,5,6,16,31,55,-24,21
CC Mariners,3882,10,4,8,15,28,49,-21,20
Sydney FC,3883,1,20,5,3,65,23,42,65
N'castle Jet,3883,2,15,5,8,57,38,19,50
Melbourne C,3883,3,15,4,10,44,33,11,49
Melbourne V,3883,4,13,6,10,46,39,7,45
Adelaide Utd,3883,5,11,6,11,37,40,-3,39
Brisbane,3883,6,10,5,13,33,42,-9,35
Western Sydn,3883,7,8,9,10,38,47,-9,33
Perth Glory,3883,8,10,2,15,37,50,-13,32
Wellington P,3883,9,5,6,16,31,55,-24,21
CC Mariners,3883,10,4,8,15,28,49,-21,20
Sydney FC,3884,1,21,4,3,66,22,44,67
N'castle Jet,3884,2,15,5,8,60,42,18,50
Melbourne C,3884,3,15,4,10,48,36,12,49
Melbourne V,3884,4,13,5,11,45,40,5,44
Adelaide Utd,3884,5,11,6,11,37,40,-3,39
Brisbane,3884,6,10,5,13,33,42,-9,35
Western Sydn,3884,7,8,9,10,38,47,-9,33
Perth Glory,3884,8,10,2,15,37,50,-13,32
Wellington P,3884,9,5,6,16,31,55,-24,21
CC Mariners,3884,10,4,8,15,28,49,-21,20
Sydney FC,3885,1,20,4,4,65,25,40,64
N'castle Jet,3885,2,15,6,7,58,38,20,51
Melbourne C,3885,3,14,5,10,44,34,10,47
Melbourne V,3885,4,14,5,10,48,39,9,47
Adelaide Utd,3885,5,11,6,11,37,40,-3,39
Brisbane,3885,6,10,5,13,33,42,-9,35
Western Sydn,3885,7,8,9,10,38,47,-9,33
Perth Glory,3885,8,10,2,15,37,50,-13,32
Wellington P,3885,9,5,6,16,31,55,-24,21
CC Mariners,3885,10,4,8,15,28,49,-21,20
Sydney FC,3886,1,21,4,3,66,23,43,67
N'castle Jet,3886,2,16,5,7,60,39,21,53
Melbourne C,3886,3,14,4,11,45,36,9,46
Melbourne V,3886,4,13,5,11,46,40,6,44
Adelaide Utd,3886,5,11,6,11,37,40,-3,39
Brisbane,3886,6,10,5,13,33,42,-9,35
Western Sydn,3886,7,8,9,10,38,47,-9,33
Perth Glory,3886,8,10,2,15,37,50,-13,32
Wellington P,3886,9,5,6,16,31,55,-24,21
CC Mariners,3886,10,4,8,15,28,49,-21,20
Sydney FC,3887,1,20,4,4,65,24,41,64
N'castle Jet,3887,2,15,6,7,59,39,20,51
Melbourne C,3887,3,14,5,10,45,35,10,47
Melbourne V,3887,4,14,5,10,47,39,8,47
Adelaide Utd,3887,5,11,6,11,37,40,-3,39
Brisbane,3887,6,10,5,13,33,42,-9,35
Western Sydn,3887,7,8,9,10,38,47,-9,33
Perth Glory,3887,8,10,2,15,37,50,-13,32
Wellington P,3887,9,5,6,16,31,55,-24,21
CC Mariners,3887,10,4,8,15,28,49,-21,20
Sydney FC,3888,1,21,4,3,66,22,44,67
N'castle Jet,3888,2,15,6,7,57,37,20,51
Melbourne C,3888,3,14,5,10,43,33,10,47
Melbourne V,3888,4,13,5,11,45,40,5,44
Adelaide Utd,3888,5,11,6,11,37,40,-3,39
Brisbane,3888,6,10,5,13,33,42,-9,35
Western Sydn,3888,7,8,9,10,38,47,-9,33
Perth Glory,3888,8,10,2,15,37,50,-13,32
Wellington P,3888,9,5,6,16,31,55,-24,21
CC Mariners,3888,10,4,8,15,28,49,-21,20
Sydney FC,3889,1,20,4,4,66,25,41,64
N'castle Jet,3889,2,15,6,7,59,39,20,51
Melbourne C,3889,3,14,5,10,45,35,10,47
Melbourne V,3889,4,14,5,10,48,40,8,47
Adelaide Utd,3889,5,11,6,11,37,40,-3,39
Brisbane,3889,6,10,5,13,33,42,-9,35
Western Sydn,3889,7,8,9,10,38,47,-9,33
Perth Glory,3889,8,10,2,15,37,50,-13,32
Wellington P,3889,9,5,6,16,31,55,-24,21
CC Mariners,3889,10,4,8,15,28,49,-21,20
Sydney FC,3890,1,21,4,3,68,22,46,67
N'castle Jet,3890,2,15,5,8,58,40,18,50
Melbourne C,3890,3,15,4,10,46,34,12,49
Melbourne V,3890,4,13,5,11,45,42,3,44
Adelaide Utd,3890,5,11,6,11,37,40,-3,39
Brisbane,3890,6,10,5,13,33,42,-9,35
Western Sydn,3890,7,8,9,10,38,47,-9,33
Perth Glory,3890,8,10,2,15,37,50,-13,32
Wellington P,3890,9,5,6,16,31,55,-24,21
CC Mariners,3890,10,4,8,15,28,49,-21,20
Sydney FC,3891,1,21,4,3,67,22,45,67
N'castle Jet,3891,2,15,5,8,57,38,19,50
Melbourne C,3891,3,15,4,10,44,33,11,49
Melbourne V,3891,4,13,5,11,45,41,4,44
Adelaide Utd,3891,5,11,6,11,37,40,-3,39
Brisbane,3891,6,10,5,13,33,42,-9,35
Western Sydn,3891,7,8,9,10,38,47,-9,33
Perth Glory,3891,8,10,2,15,37,50,-13,32
Wellington P,3891,9,5,6,16,31,55,-24,21
CC Mariners,3891,10,4,8,15,28,49,-21,20
Sydney FC,3892,1,20,4,4,65,25,40,64
N'castle Jet,3892,2,16,5,7,58,37,21,53
Melbourne V,3892,3,14,5,10,48,39,9,47
Melbourne C,3892,4,14,4,11,43,34,9,46
Adelaide Utd,3892,5,11,6,11,37,40,-3,39
Brisbane,3892,6,10,5,13,33,42,-9,35
Western Sydn,3892,7,8,9,10,38,47,-9,33
Perth Glory,3892,8,10,2,15,37,50,-13,32
Wellington P,3892,9,5,6,16,31,55,-24,21
CC Mariners,3892,10,4,8,15,28,49,-21,20
Sydney FC,3893,1,21,4,3,65,22,43,67
N'castle Jet,3893,2,15,5,8,58,39,19,50
Melbourne C,3893,3,15,4,10,45,34,11,49
Melbourne V,3893,4,13,5,11,45,39,6,44
Adelaide Utd,3893,5,11,6,11,37,40,-3,39
Brisbane,3893,6,10,5,13,33,42,-9,35
Western Sydn,3893,7,8,9,10,38,47,-9,33
Perth Glory,3893,8,10,2,15,37,50,-13,32
Wellington P,3893,9,5,6,16,31,55,-24,21
CC Mariners,3893,10,4,8,15,28,49,-21,20
Sydney FC,3894,1,20,5,3,65,23,42,65
N'castle Jet,3894,2,16,5,7,60,38,22,53
Melbourne C,3894,3,14,4,11,44,36,8,46
Melbourne V,3894,4,13,6,10,46,39,7,45
Adelaide Utd,3894,5,11,6,11,37,40,-3,39
Brisbane,3894,6,10,5,13,33,42,-9,35
Western Sydn,3894,7,8,9,10,38,47,-9,33
Perth Glory,3894,8,10,2,15,37,50,-13,32
Wellington P,3894,9,5,6,16,31,55,-24,21
CC Mariners,3894,10,4,8,15,28,49,-21,20
Sydney FC,3895,1,21,4,3,70,22,48,67
N'castle Jet,3895,2,15,5,8,57,39,18,50
Melbourne C,3895,3,15,4,10,45,33,12,49
Melbourne V,3895,4,13,5,11,45,44,1,44
Adelaide Utd,3895,5,11,6,11,37,40,-3,39
Brisbane,3895,6,10,5,13,33,42,-9,35
Western Sydn,3895,7,8,9,10,38,47,-9,33
Perth Glory,3895,8,10,2,15,37,50,-13,32
Wellington P,3895,9,5,6,16,31,55,-24,21
CC Mariners,3895,10,4,8,15,28,49,-21,20
Sydney FC,3896,1,20,5,3,66,24,42,65
N'castle Jet,3896,2,15,5,8,58,39,19,50
Melbourne C,3896,3,15,4,10,45,34,11,49
Melbourne V,3896,4,13,6,10,47,40,7,45
Adelaide Utd,3896,5,11,6,11,37,40,-3,39
Brisbane,3896,6,10,5,13,33,42,-9,35
Western Sydn,3896,7,8,9,10,38,47,-9,33
Perth Glory,3896,8,10,2,15,37,50,-13,32
Wellington P,3896,9,5,6,16,31,55,-24,21
CC Mariners,3896,10,4,8,15,28,49,-21,20
Sydney FC,3897,1,20,4,4,65,26,39,64
N'castle Jet,3897,2,16,5,7,59,37,22,53
Melbourne V,3897,3,14,5,10,49,39,10,47
Melbourne C,3897,4,14,4,11,43,35,8,46
Adelaide Utd,3897,5,11,6,11,37,40,-3,39
Brisbane,3897,6,10,5,13,33,42,-9,35
Western Sydn,3897,7,8,9,10,38,47,-9,33
Perth Glory,3897,8,10,2,15,37,50,-13,32
Wellington P,3897,9,5,6,16,31,55,-24,21
CC Mariners,3897,10,4,8,15,28,49,-21,20
Sydney FC,3898,1,20,5,3,65,23,42,65
N'castle Jet,3898,2,15,6,7,58,38,20,51
Melbourne C,3898,3,14,5,10,44,34,10,47
Melbourne V,3898,4,13,6,10,46,39,7,45
Adelaide Utd,3898,5,11,6,11,37,40,-3,39
Brisbane,3898,6,10,5,13,33,42,-9,35
Western Sydn,3898,7,8,9,10,38,47,-9,33
Perth Glory,3898,8,10,2,15,37,50,-13,32
Wellington P,3898,9,5,6,16,31,55,-24,21
CC Mariners,3898,10,4,8,15,28,49,-21,20
Sydney FC,3899,1,21,4,3,66,23,43,67
N'castle Jet,3899,2,15,5,8,59,40,19,50
Melbourne C,3899,3,15,4,10,46,35,11,49
Melbourne V,3899,4,13,5,11,46,40,6,44
Adelaide Utd,3899,5,11,6,11,37,40,-3,39
Brisbane,3899,6,10,5,13,33,42,-9,35
Western Sydn,3899,7,8,9,10,38,47,-9,33
Perth Glory,3899,8,10,2,15,37,50,-13,32
Wellington P,3899,9,5,6,16,31,55,-24,21
CC Mariners,3899,10,4,8,15,28,49,-21,20
Sydney FC,3900,1,21,4,3,67,24,43,67
N'castle Jet,3900,2,16,5,7,59,38,21,53
Melbourne C,3900,3,14,4,11,44,35,9,46
Melbourne V,3900,4,13,5,11,47,41,6,44
Adelaide Utd,3900,5,11,6,11,37,40,-3,39
Brisbane,3900,6,10,5,13,33,42,-9,35
Western Sydn,3900,7,8,9,10,38,47,-9,33
Perth Glory,3900,8,10,2,15,37,50,-13,32
Wellington P,3900,9,5,6,16,31,55,-24,21
CC Mariners,3900,10,4,8,15,28,49,-21,20
Sydney FC,3901,1,20,5,3,64,22,42,65
N'castle Jet,3901,2,15,6,7,58,38,20,51
Melbourne C,3901,3,14,5,10,44,34,10,47
Melbourne V,3901,4,13,6,10,45,38,7,45
Adelaide Utd,3901,5,11,6,11,37,40,-3,39
Brisbane,3901,6,10,5,13,33,42,-9,35
Western Sydn,3901,7,8,9,10,38,47,-9,33
Perth Glory,3901,8,10,2,15,37,50,-13,32
Wellington P,3901,9,5,6,16,31,55,-24,21
CC Mariners,3901,10,4,8,15,28,49,-21,20
Sydney FC,3902,1,21,4,3,68,22,46,67
N'castle Jet,3902,2,16,5,7,59,38,21,53
Melbourne C,3902,3,14,4,11,44,35,9,46
Melbourne V,3902,4,13,5,11,45,42,3,44
Adelaide Utd,3902,5,11,6,11,37,40,-3,39
Brisbane,3902,6,10,5,13,33,42,-9,35
Western Sydn,3902,7,8,9,10,38,47,-9,33
Perth Glory,3902,8,10,2,15,37,50,-13,32
Wellington P,3902,9,5,6,16,31,55,-24,21
CC Mariners,3902,10,4,8,15,28,49,-21,20
Sydney FC,3903,1,20,5,3,65,23,42,65
N'castle Jet,3903,2,16,5,7,60,37,23,53
Melbourne C,3903,3,14,4,11,43,36,7,46
Melbourne V,3903,4,13,6,10,46,39,7,45
Adelaide Utd,3903,5,11,6,11,37,40,-3,39
Brisbane,3903,6,10,5,13,33,42,-9,35
Western Sydn,3903,7,8,9,10,38,47,-9,33
Perth Glory,3903,8,10,2,15,37,50,-13,32
Wellington P,3903,9,5,6,16,31,55,-24,21
CC Mariners,3903,10,4,8,15,28,49,-21,20
Sydney FC,3904,1,21,4,3,67,23,44,67
N'castle Jet,3904,2,16,5,7,60,39,21,53
Melbourne C,3904,3,14,4,11,45,36,9,46
Melbourne V,3904,4,13,5,11,46,41,5,44
Adelaide Utd,3904,5,11,6,11,37,40,-3,39
Brisbane,3904,6,10,5,13,33,42,-9,35
Western Sydn,3904,7,8,9,10,38,47,-9,33
Perth Glory,3904,8,10,2,15,37,50,-13,32
Wellington P,3904,9,5,6,16,31,55,-24,21
CC Mariners,3904,10,4,8,15,28,49,-21,20
Sydney FC,3905,1,21,4,3,69,25,44,67
N'castle Jet,3905,2,16,5,7,60,38,22,53
Melbourne C,3905,3,14,4,11,44,36,8,46
Melbourne V,3905,4,13,5,11,48,43,5,44
Adelaide Utd,3905,5,11,6,11,37,40,-3,39
Brisbane,3905,6,10,5,13,33,42,-9,35
Western Sydn,3905,7,8,9,10,38,47,-9,33
Perth Glory,3905,8,10,2,15,37,50,-13,32
Wellington P,3905,9,5,6,16,31,55,-24,21
CC Mariners,3905,10,4,8,15,28,49,-21,20
Sydney FC,3906,1,20,5,3,64,22,42,65
N'castle Jet,3906,2,16,5,7,59,38,21,53
Melbourne C,3906,3,14,4,11,44,35,9,46
Melbourne V,3906,4,13,6,10,45,38,7,45
Adelaide Utd,3906,5,11,6,11,37,40,-3,39
Brisbane,3906,6,10,5,13,33,42,-9,35
Western Sydn,3906,7,8,9,10,38,47,-9,33
Perth Glory,3906,8,10,2,15,37,50,-13,32
Wellington P,3906,9,5,6,16,31,55,-24,21
CC Mariners,3906,10,4,8,15,28,49,-21,20
Sydney FC,3907,1,21,4,3,65,22,43,67
N'castle Jet,3907,2,15,5,8,59,41,18,50
Melbourne C,3907,3,15,4,10,47,35,12,49
Melbourne V,3907,4,13,5,11,45,39,6,44
Adelaide Utd,3907,5,11,6,11,37,40,-3,39
Brisbane,3907,6,10,5,13,33,42,-9,35
Western Sydn,3907,7,8,9,10,38,47,-9,33
Perth Glory,3907,8,10,2,15,37,50,-13,32
Wellington P,3907,9,5,6,16,31,55,-24,21
CC Mariners,3907,10,4,8,15,28,49,-21,20
Sydney FC,3908,1,21,4,3,68,23,45,67
N'castle Jet,3908,2,15,5,8,58,40,18,50
Melbourne C,3908,3,15,4,10,46,34,12,49
Melbourne V,3908,4,13,5,11,46,42,4,44
Adelaide Utd,3908,5,11,6,11,37,40,-3,39
Brisbane,3908,6,10,5,13,33,42,-9,35
Western Sydn,3908,7,8,9,10,38,47,-9,33
Perth Glory,3908,8,10,2,15,37,50,-13,32
Wellington P,3908,9,5,6,16,31,55,-24,21
CC Mariners,3908,10,4,8,15,28,49,-21,20
Sydney FC,3909,1,20,5,3,65,23,42,65
N'castle Jet,3909,2,15,6,7,58,38,20,51
Melbourne C,3909,3,14,5,10,44,34,10,47
Melbourne V,3909,4,13,6,10,46,39,7,45
Adelaide Utd,3909,5,11,6,11,37,40,-3,39
Brisbane,3909,6,10,5,13,33,42,-9,35
Western Sydn,3909,7,8,9,10,38,47,-9,33
Perth Glory,3909,8,10,2,15,37,50,-13,32
Wellington P,3909,9,5,6,16,31,55,-24,21
CC Mariners,3909,10,4,8,15,28,49,-21,20
Sydney FC,3910,1,21,4,3,66,22,44,67
N'castle Jet,3910,2,15,6,7,59,39,20,51
Melbourne C,3910,3,14,5,10,45,35,10,47
Melbourne V,3910,4,13,5,11,45,40,5,44
Adelaide Utd,3910,5,11,6,11,37,40,-3,39
Brisbane,3910,6,10,5,13,33,42,-9,35
Western Sydn,3910,7,8,9,10,38,47,-9,33
Perth Glory,3910,8,10,2,15,37,50,-13,32
Wellington P,3910,9,5,6,16,31,55,-24,21
CC Mariners,3910,10,4,8,15,28,49,-21,20
Sydney FC,3911,1,20,5,3,64,22,42,65
N'castle Jet,3911,2,16,5,7,63,38,25,53
Melbourne C,3911,3,14,4,11,44,39,5,46
Melbourne V,3911,4,13,6,10,45,38,7,45
Adelaide Utd,3911,5,11,6,11,37,40,-3,39
Brisbane,3911,6,10,5,13,33,42,-9,35
Western Sydn,3911,7,8,9,10,38,47,-9,33
Perth Glory,3911,8,10,2,15,37,50,-13,32
Wellington P,3911,9,5,6,16,31,55,-24,21
CC Mariners,3911,10,4,8,15,28,49,-21,20
Sydney FC,3912,1,21,4,3,67,22,45,67
N'castle Jet,3912,2,15,5,8,57,40,17,50
Melbourne C,3912,3,15,4,10,46,33,13,49
Melbourne V,3912,4,13,5,11,45,41,4,44
Adelaide Utd,3912,5,11,6,11,37,40,-3,39
Brisbane,3912,6,10,5,13,33,42,-9,35
Western Sydn,3912,7,8,9,10,38,47,-9,33
Perth Glory,3912,8,10,2,15,37,50,-13,32
Wellington P,3912,9,5,6,16,31,55,-24,21
CC Mariners,3912,10,4,8,15,28,49,-21,20
Sydney FC,3913,1,21,4,3,66,22,44,67
N'castle Jet,3913,2,15,6,7,59,39,20,51
Melbourne C,3913,3,14,5,10,45,35,10,47
Melbourne V,3913,4,13,5,11,45,40,5,44
Adelaide Utd,3913,5,11,6,11,37,40,-3,39
Brisbane,3913,6,10,5,13,33,42,-9,35
Western Sydn,3913,7,8,9,10,38,47,-9,33
Perth Glory,3913,8,10,2,15,37,50,-13,32
Wellington P,3913,9,5,6,16,31,55,-24,21
CC Mariners,3913,10,4,8,15,28,49,-21,20
Sydney FC,3914,1,21,4,3,67,23,44,67
N'castle Jet,3914,2,15,6,7,58,38,20,51
Melbourne C,3914,3,14,5,10,44,34,10,47
Melbourne V,3914,4,13,5,11,46,41,5,44
Adelaide Utd,3914,5,11,6,11,37,40,-3,39
Brisbane,3914,6,10,5,13,33,42,-9,35
Western Sydn,3914,7,8,9,10,38,47,-9,33
Perth Glory,3914,8,10,2,15,37,50,-13,32
Wellington P,3914,9,5,6,16,31,55,-24,21
CC Mariners,3914,10,4,8,15,28,49,-21,20
Sydney FC,3915,1,21,4,3,65,22,43,67
N'castle Jet,3915,2,16,5,7,60,38,22,53
Melbourne C,3915,3,14,4,11,44,36,8,46
Melbourne V,3915,4,13,5,11,45,39,6,44
Adelaide Utd,3915,5,11,6,11,37,40,-3,39
Brisbane,3915,6,10,5,13,33,42,-9,35
Western Sydn,3915,7,8,9,10,38,47,-9,33
Perth Glory,3915,8,10,2,15,37,50,-13,32
Wellington P,3915,9,5,6,16,31,55,-24,21
CC Mariners,3915,10,4,8,15,28,49,-21,20
Sydney FC,3916,1,20,5,3,66,24,42,65
N'castle Jet,3916,2,15,6,7,58,38,20,51
Melbourne C,3916,3,14,5,10,44,34,10,47
Melbourne V,3916,4,13,6,10,47,40,7,45
Adelaide Utd,3916,5,11,6,11,37,40,-3,39
Brisbane,3916,6,10,5,13,33,42,-9,35
Western Sydn,3916,7,8,9,10,38,47,-9,33
Perth Glory,3916,8,10,2,15,37,50,-13,32
Wellington P,3916,9,5,6,16,31,55,-24,21
CC Mariners,3916,10,4,8,15,28,49,-21,20
Sydney FC,3917,1,20,5,3,66,24,42,65
N'castle Jet,3917,2,16,5,7,59,38,21,53
Melbourne C,3917,3,14,4,11,44,35,9,46
Melbourne V,3917,4,13,6,10,47,40,7,45
Adelaide Utd,3917,5,11,6,11,37,40,-3,39
Brisbane,3917,6,10,5,13,33,42,-9,35
Western Sydn,3917,7,8,9,10,38,47,-9,33
Perth Glory,3917,8,10,2,15,37,50,-13,32
Wellington P,3917,9,5,6,16,31,55,-24,21
CC Mariners,3917,10,4,8,15,28,49,-21,20
Sydney FC,3918,1,21,4,3,66,22,44,67
N'castle Jet,3918,2,15,5,8,60,41,19,50
Melbourne C,3918,3,15,4,10,47,36,11,49
Melbourne V,3918,4,13,5,11,45,40,5,44
Adelaide Utd,3918,5,11,6,11,37,40,-3,39
Brisbane,3918,6,10,5,13,33,42,-9,35
Western Sydn,3918,7,8,9,10,38,47,-9,33
Perth Glory,3918,8,10,2,15,37,50,-13,32
Wellington P,3918,9,5,6,16,31,55,-24,21
CC Mariners,3918,10,4,8,15,28,49,-21,20
Sydney FC,3919,1,21,4,3,66,23,43,67
N'castle Jet,3919,2,15,6,7,57,37,20,51
Melbourne C,3919,3,14,5,10,43,33,10,47
Melbourne V,3919,4,13,5,11,46,40,6,44
Adelaide Utd,3919,5,11,6,11,37,40,-3,39
Brisbane,3919,6,10,5,13,33,42,-9,35
Western Sydn,3919,7,8,9,10,38,47,-9,33
Perth Glory,3919,8,10,2,15,37,50,-13,32
Wellington P,3919,9,5,6,16,31,55,-24,21
CC Mariners,3919,10,4,8,15,28,49,-21,20
Sydney FC,3920,1,21,4,3,65,22,43,67
N'castle Jet,3920,2,15,6,7,58,38,20,51
Melbourne C,3920,3,14,5,10,44,34,10,47
Melbourne V,3920,4,13,5,11,45,39,6,44
Adelaide Utd,3920,5,11,6,11,37,40,-3,39
Brisbane,3920,6,10,5,13,33,42,-9,35
Western Sydn,3920,7,8,9,10,38,47,-9,33
Perth Glory,3920,8,10,2,15,37,50,-13,32
Wellington P,3920,9,5,6,16,31,55,-24,21
CC Mariners,3920,10,4,8,15,28,49,-21,20
Sydney FC,3921,1,21,4,3,66,23,43,67
N'castle Jet,3921,2,15,6,7,58,38,20,51
Melbourne C,3921,3,14,5,10,44,34,10,47
Melbourne V,3921,4,13,5,11,46,40,6,44
Adelaide Utd,3921,5,11,6,11,37,40,-3,39
Brisbane,3921,6,10,5,13,33,42,-9,35
Western Sydn,3921,7,8,9,10,38,47,-9,33
Perth Glory,3921,8,10,2,15,37,50,-13,32
Wellington P,3921,9,5,6,16,31,55,-24,21
CC Mariners,3921,10,4,8,15,28,49,-21,20
Sydney FC,3922,1,20,4,4,64,23,41,64
N'castle Jet,3922,2,15,6,7,57,37,20,51
Melbourne C,3922,3,14,5,10,43,33,10,47
Melbourne V,3922,4,14,5,10,46,38,8,47
Adelaide Utd,3922,5,11,6,11,37,40,-3,39
Brisbane,3922,6,10,5,13,33,42,-9,35
Western Sydn,3922,7,8,9,10,38,47,-9,33
Perth Glory,3922,8,10,2,15,37,50,-13,32
Wellington P,3922,9,5,6,16,31,55,-24,21
CC Mariners,3922,10,4,8,15,28,49,-21,20
Sydney FC,3923,1,21,4,3,67,22,45,67
N'castle Jet,3923,2,16,5,7,58,37,21,53
Melbourne C,3923,3,14,4,11,43,34,9,46
Melbourne V,3923,4,13,5,11,45,41,4,44
Adelaide Utd,3923,5,11,6,11,37,40,-3,39
Brisbane,3923,6,10,5,13,33,42,-9,35
Western Sydn,3923,7,8,9,10,38,47,-9,33
Perth Glory,3923,8,10,2,15,37,50,-13,32
Wellington P,3923,9,5,6,16,31,55,-24,21
CC Mariners,3923,10,4,8,15,28,49,-21,20
Sydney FC,3924,1,20,5,3,65,23,42,65
N'castle Jet,3924,2,15,5,8,57,40,17,50
Melbourne C,3924,3,15,4,10,46,33,13,49
Melbourne V,3924,4,13,6,10,46,39,7,45
Adelaide Utd,3924,5,11,6,11,37,40,-3,39
Brisbane,3924,6,10,5,13,33,42,-9,35
Western Sydn,3924,7,8,9,10,38,47,-9,33
Perth Glory,3924,8,10,2,15,37,50,-13,32
Wellington P,3924,9,5,6,16,31,55,-24,21
CC Mariners,3924,10,4,8,15,28,49,-21,20
Sydney FC,3925,1,20,5,3,65,23,42,65
N'castle Jet,3925,2,16,5,7,59,37,22,53
Melbourne C,3925,3,14,4,11,43,35,8,46
Melbourne V,3925,4,13,6,10,46,39,7,45
Adelaide Utd,3925,5,11,6,11,37,40,-3,39
Brisbane,3925,6,10,5,13,33,42,-9,35
Western Sydn,3925,7,8,9,10,38,47,-9,33
Perth Glory,3925,8,10,2,15,37,50,-13,32
Wellington P,3925,9,5,6,16,31,55,-24,21
CC Mariners,3925,10,4,8,15,28,49,-21,20
Sydney FC,3926,1,20,4,4,64,23,41,64
N'castle Jet,3926,2,16,5,7,58,37,21,53
Melbourne V,3926,3,14,5,10,46,38,8,47
Melbourne C,3926,4,14,4,11,43,34,9,46
Adelaide Utd,3926,5,11,6,11,37,40,-3,39
Brisbane,3926,6,10,5,13,33,42,-9,35
Western Sydn,3926,7,8,9,10,38,47,-9,33
Perth Glory,3926,8,10,2,15,37,50,-13,32
Wellington P,3926,9,5,6,16,31,55,-24,21
CC Mariners,3926,10,4,8,15,28,49,-21,20
Sydney FC,3927,1,20,5,3,65,23,42,65
N'castle Jet,3927,2,16,5,7,60,38,22,53
Melbourne C,3927,3,14,4,11,44,36,8,46
Melbourne V,3927,4,13,6,10,46,39,7,45
Adelaide Utd,3927,5,11,6,11,37,40,-3,39
Brisbane,3927,6,10,5,13,33,42,-9,35
Western Sydn,3927,7,8,9,10,38,47,-9,33
Perth Glory,3927,8,10,2,15,37,50,-13,32
Wellington P,3927,9,5,6,16,31,55,-24,21
CC Mariners,3927,10,4,8,15,28,49,-21,20
Sydney FC,3928,1,20,5,3,66,24,42,65
N'castle Jet,3928,2,15,5,8,59,40,19,50
Melbourne C,3928,3,15,4,10,46,35,11,49
Melbourne V,3928,4,13,6,10,47,40,7,45
Adelaide Utd,3928,5,11,6,11,37,40,-3,39
Brisbane,3928,6,10,5,13,33,42,-9,35
Western Sydn,3928,7,8,9,10,38,47,-9,33
Perth Glory,3928,8,10,2,15,37,50,-13,32
Wellington P,3928,9,5,6,16,31,55,-24,21
CC Mariners,3928,10,4,8,15,28,49,-21,20
Sydney FC,3929,1,21,4,3,65,22,43,67
N'castle Jet,3929,2,15,5,8,58,39,19,50
Melbourne C,3929,3,15,4,10,45,34,11,49
Melbourne V,3929,4,13,5,11,45,39,6,44
Adelaide Utd,3929,5,11,6,11,37,40,-3,39
Brisbane,3929,6,10,5,13,33,42,-9,35
Western Sydn,3929,7,8,9,10,38,47,-9,33
Perth Glory,3929,8,10,2,15,37,50,-13,32
Wellington P,3929,9,5,6,16,31,55,-24,21
CC Mariners,3929,10,4,8,15,28,49,-21,20
Sydney FC,3930,1,21,4,3,68,22,46,67
N'castle Jet,3930,2,15,6,7,59,39,20,51
Melbourne C,3930,3,14,5,10,45,35,10,47
Melbourne V,3930,4,13,5,11,45,42,3,44
Adelaide Utd,3930,5,11,6,11,37,40,-3,39
Brisbane,3930,6,10,5,13,33,42,-9,35
Western Sydn,3930,7,8,9,10,38,47,-9,33
Perth Glory,3930,8,10,2,15,37,50,-13,32
Wellington P,3930,9,5,6,16,31,55,-24,21
CC Mariners,3930,10,4,8,15,28,49,-21,20
Sydney FC,3931,1,20,5,3,66,24,42,65
N'castle Jet,3931,2,15,5,8,58,39,19,50
Melbourne C,3931,3,15,4,10,45,34,11,49
Melbourne V,3931,4,13,6,10,47,40,7,45
Adelaide Utd,3931,5,11,6,11,37,40,-3,39
Brisbane,3931,6,10,5,13,33,42,-9,35
Western Sydn,3931,7,8,9,10,38,47,-9,33
Perth Glory,3931,8,10,2,15,37,50,-13,32
Wellington P,3931,9,5,6,16,31,55,-24,21
CC Mariners,3931,10,4,8,15,28,49,-21,20
Sydney FC,3932,1,20,4,4,66,25,41,64
N'castle Jet,3932,2,15,5,8,59,41,18,50
Melbourne C,3932,3,15,4,10,47,35,12,49
Melbourne V,3932,4,14,5,10,48,40,8,47
Adelaide Utd,3932,5,11,6,11,37,40,-3,39
Brisbane,3932,6,10,5,13,33,42,-9,35
Western Sydn,3932,7,8,9,10,38,47,-9,33
Perth Glory,3932,8,10,2,15,37,50,-13,32
Wellington P,3932,9,5,6,16,31,55,-24,21
CC Mariners,3932,10,4,8,15,28,49,-21,20
Sydney FC,3933,1,21,4,3,65,22,43,67
N'castle Jet,3933,2,15,5,8,58,39,19,50
Melbourne C,3933,3,15,4,10,45,34,11,49
Melbourne V,3933,4,13,5,11,45,39,6,44
Adelaide Utd,3933,5,11,6,11,37,40,-3,39
Brisbane,3933,6,10,5,13,33,42,-9,35
Western Sydn,3933,7,8,9,10,38,47,-9,33
Perth Glory,3933,8,10,2,15,37,50,-13,32
Wellington P,3933,9,5,6,16,31,55,-24,21
CC Mariners,3933,10,4,8,15,28,49,-21,20
Sydney FC,3934,1,21,4,3,66,23,43,67
N'castle Jet,3934,2,16,5,7,59,37,22,53
Melbourne C,3934,3,14,4,11,43,35,8,46
Melbourne V,3934,4,13,5,11,46,40,6,44
Adelaide Utd,3934,5,11,6,11,37,40,-3,39
Brisbane,3934,6,10,5,13,33,42,-9,35
Western Sydn,3934,7,8,9,10,38,47,-9,33
Perth Glory,3934,8,10,2,15,37,50,-13,32
Wellington P,3934,9,5,6,16,31,55,-24,21
CC Mariners,3934,10,4,8,15,28,49,-21,20
Sydney FC,3935,1,21,4,3,69,22,47,67
N'castle Jet,3935,2,16,5,7,60,37,23,53
Melbourne C,3935,3,14,4,11,43,36,7,46
Melbourne V,3935,4,13,5,11,45,43,2,44
Adelaide Utd,3935,5,11,6,11,37,40,-3,39
Brisbane,3935,6,10,5,13,33,42,-9,35
Western Sydn,3935,7,8,9,10,38,47,-9,33
Perth Glory,3935,8,10,2,15,37,50,-13,32
Wellington P,3935,9,5,6,16,31,55,-24,21
CC Mariners,3935,10,4,8,15,28,49,-21,20
Sydney FC,3936,1,21,4,3,65,22,43,67
N'castle Jet,3936,2,15,6,7,58,38,20,51
Melbourne C,3936,3,14,5,10,44,34,10,47
Melbourne V,3936,4,13,5,11,45,39,6,44
Adelaide Utd,3936,5,11,6,11,37,40,-3,39
Brisbane,3936,6,10,5,13,33,42,-9,35
Western Sydn,3936,7,8,9,10,38,47,-9,33
Perth Glory,3936,8,10,2,15,37,50,-13,32
Wellington P,3936,9,5,6,16,31,55,-24,21
CC Mariners,3936,10,4,8,15,28,49,-21,20
Sydney FC,3937,1,20,5,3,65,23,42,65
N'castle Jet,3937,2,15,6,7,60,40,20,51
Melbourne C,3937,3,14,5,10,46,36,10,47
Melbourne V,3937,4,13,6,10,46,39,7,45
Adelaide Utd,3937,5,11,6,11,37,40,-3,39
Brisbane,3937,6,10,5,13,33,42,-9,35
Western Sydn,3937,7,8,9,10,38,47,-9,33
Perth Glory,3937,8,10,2,15,37,50,-13,32
Wellington P,3937,9,5,6,16,31,55,-24,21
CC Mariners,3937,10,4,8,15,28,49,-21,20
Sydney FC,3938,1,21,4,3,69,22,47,67
N'castle Jet,3938,2,16,5,7,59,37,22,53
Melbourne C,3938,3,14,4,11,43,35,8,46
Melbourne V,3938,4,13,5,11,45,43,2,44
Adelaide Utd,3938,5,11,6,11,37,40,-3,39
Brisbane,3938,6,10,5,13,33,42,-9,35
Western Sydn,3938,7,8,9,10,38,47,-9,33
Perth Glory,3938,8,10,2,15,37,50,-13,32
Wellington P,3938,9,5,6,16,31,55,-24,21
CC Mariners,3938,10,4,8,15,28,49,-21,20
Sydney FC,3939,1,21,4,3,66,23,43,67
N'castle Jet,3939,2,16,5,7,59,38,21,53
Melbourne C,3939,3,14,4,11,44,35,9,46
Melbourne V,3939,4,13,5,11,46,40,6,44
Adelaide Utd,3939,5,11,6,11,37,40,-3,39
Brisbane,3939,6,10,5,13,33,42,-9,35
Western Sydn,3939,7,8,9,10,38,47,-9,33
Perth Glory,3939,8,10,2,15,37,50,-13,32
Wellington P,3939,9,5,6,16,31,55,-24,21
CC Mariners,3939,10,4,8,15,28,49,-21,20
Sydney FC,3940,1,21,4,3,65,22,43,67
N'castle Jet,3940,2,16,5,7,59,38,21,53
Melbourne C,3940,3,14,4,11,44,35,9,46
Melbourne V,3940,4,13,5,11,45,39,6,44
Adelaide Utd,3940,5,11,6,11,37,40,-3,39
Brisbane,3940,6,10,5,13,33,42,-9,35
Western Sydn,3940,7,8,9,10,38,47,-9,33
Perth Glory,3940,8,10,2,15,37,50,-13,32
Wellington P,3940,9,5,6,16,31,55,-24,21
CC Mariners,3940,10,4,8,15,28,49,-21,20
Sydney FC,3941,1,21,4,3,65,22,43,67
N'castle Jet,3941,2,16,5,7,58,37,21,53
Melbourne C,3941,3,14,4,11,43,34,9,46
Melbourne V,3941,4,13,5,11,45,39,6,44
Adelaide Utd,3941,5,11,6,11,37,40,-3,39
Brisbane,3941,6,10,5,13,33,42,-9,35
Western Sydn,3941,7,8,9,10,38,47,-9,33
Perth Glory,3941,8,10,2,15,37,50,-13,32
Wellington P,3941,9,5,6,16,31,55,-24,21
CC Mariners,3941,10,4,8,15,28,49,-21,20
Sydney FC,3942,1,21,4,3,67,24,43,67
N'castle Jet,3942,2,15,6,7,59,39,20,51
Melbourne C,3942,3,14,5,10,45,35,10,47
Melbourne V,3942,4,13,5,11,47,41,6,44
Adelaide Utd,3942,5,11,6,11,37,40,-3,39
Brisbane,3942,6,10,5,13,33,42,-9,35
Western Sydn,3942,7,8,9,10,38,47,-9,33
Perth Glory,3942,8,10,2,15,37,50,-13,32
Wellington P,3942,9,5,6,16,31,55,-24,21
CC Mariners,3942,10,4,8,15,28,49,-21,20
Sydney FC,3943,1,20,5,3,66,24,42,65
N'castle Jet,3943,2,16,5,7,61,40,21,53
Melbourne C,3943,3,14,4,11,46,37,9,46
Melbourne V,3943,4,13,6,10,47,40,7,45
Adelaide Utd,3943,5,11,6,11,37,40,-3,39
Brisbane,3943,6,10,5,13,33,42,-9,35
Western Sydn,3943,7,8,9,10,38,47,-9,33
Perth Glory,3943,8,10,2,15,37,50,-13,32
Wellington P,3943,9,5,6,16,31,55,-24,21
CC Mariners,3943,10,4,8,15,28,49,-21,20
Sydney FC,3944,1,21,4,3,68,23,45,67
N'castle Jet,3944,2,15,6,7,58,38,20,51
Melbourne C,3944,3,14,5,10,44,34,10,47
Melbourne V,3944,4,13,5,11,46,42,4,44
Adelaide Utd,3944,5,11,6,11,37,40,-3,39
Brisbane,3944,6,10,5,13,33,42,-9,35
Western Sydn,3944,7,8,9,10,38,47,-9,33
Perth Glory,3944,8,10,2,15,37,50,-13,32
Wellington P,3944,9,5,6,16,31,55,-24,21
CC Mariners,3944,10,4,8,15,28,49,-21,20
Sydney FC,3945,1,21,4,3,67,23,44,67
N'castle Jet,3945,2,15,6,7,58,38,20,51
Melbourne C,3945,3,14,5,10,44,34,10,47
Melbourne V,3945,4,13,5,11,46,41,5,44
Adelaide Utd,3945,5,11,6,11,37,40,-3,39
Brisbane,3945,6,10,5,13,33,42,-9,35
Western Sydn,3945,7,8,9,10,38,47,-9,33
Perth Glory,3945,8,10,2,15,37,50,-13,32
Wellington P,3945,9,5,6,16,31,55,-24,21
CC Mariners,3945,10,4,8,15,28,49,-21,20
Sydney FC,3946,1,20,4,4,64,24,40,64
N'castle Jet,3946,2,16,5,7,60,39,21,53
Melbourne V,3946,3,14,5,10,47,38,9,47
Melbourne C,3946,4,14,4,11,45,36,9,46
Adelaide Utd,3946,5,11,6,11,37,40,-3,39
Brisbane,3946,6,10,5,13,33,42,-9,35
Western Sydn,3946,7,8,9,10,38,47,-9,33
Perth Glory,3946,8,10,2,15,37,50,-13,32
Wellington P,3946,9,5,6,16,31,55,-24,21
CC Mariners,3946,10,4,8,15,28,49,-21,20
Sydney FC,3947,1,20,4,4,64,23,41,64
N'castle Jet,3947,2,15,5,8,58,39,19,50
Melbourne C,3947,3,15,4,10,45,34,11,49
Melbourne V,3947,4,14,5,10,46,38,8,47
Adelaide Utd,3947,5,11,6,11,37,40,-3,39
Brisbane,3947,6,10,5,13,33,42,-9,35
Western Sydn,3947,7,8,9,10,38,47,-9,33
Perth Glory,3947,8,10,2,15,37,50,-13,32
Wellington P,3947,9,5,6,16,31,55,-24,21
CC Mariners,3947,10,4,8,15,28,49,-21,20
Sydney FC,3948,1,21,4,3,65,22,43,67
N'castle Jet,3948,2,16,5,7,59,37,22,53
Melbourne C,3948,3,14,4,11,43,35,8,46
Melbourne V,3948,4,13,5,11,45,39,6,44
Adelaide Utd,3948,5,11,6,11,37,40,-3,39
Brisbane,3948,6,10,5,13,33,42,-9,35
Western Sydn,3948,7,8,9,10,38,47,-9,33
Perth Glory,3948,8,10,2,15,37,50,-13,32
Wellington P,3948,9,5,6,16,31,55,-24,21
CC Mariners,3948,10,4,8,15,28,49,-21,20
Sydney FC,3949,1,20,5,3,67,25,42,65
N'castle Jet,3949,2,16,5,7,61,37,24,53
Melbourne C,3949,3,14,4,11,43,37,6,46
Melbourne V,3949,4,13,6,10,48,41,7,45
Adelaide Utd,3949,5,11,6,11,37,40,-3,39
Brisbane,3949,6,10,5,13,33,42,-9,35
Western Sydn,3949,7,8,9,10,38,47,-9,33
Perth Glory,3949,8,10,2,15,37,50,-13,32
Wellington P,3949,9,5,6,16,31,55,-24,21
CC Mariners,3949,10,4,8,15,28,49,-21,20
Sydney FC,3950,1,21,4,3,65,22,43,67
N'castle Jet,3950,2,15,6,7,58,38,20,51
Melbourne C,3950,3,14,5,10,44,34,10,47
Melbourne V,3950,4,13,5,11,45,39,6,44
Adelaide Utd,3950,5,11,6,11,37,40,-3,39
Brisbane,3950,6,10,5,13,33,42,-9,35
Western Sydn,3950,7,8,9,10,38,47,-9,33
Perth Glory,3950,8,10,2,15,37,50,-13,32
Wellington P,3950,9,5,6,16,31,55,-24,21
CC Mariners,3950,10,4,8,15,28,49,-21,20
Sydney FC,3951,1,20,5,3,66,24,42,65
N'castle Jet,3951,2,16,5,7,59,37,22,53
Melbourne C,3951,3,14,4,11,43,35,8,46
Melbourne V,3951,4,13,6,10,47,40,7,45
Adelaide Utd,3951,5,11,6,11,37,40,-3,39
Brisbane,3951,6,10,5,13,33,42,-9,35
Western Sydn,3951,7,8,9,10,38,47,-9,33
Perth Glory,3951,8,10,2,15,37,50,-13,32
Wellington P,3951,9,5,6,16,31,55,-24,21
CC Mariners,3951,10,4,8,15,28,49,-21,20
Sydney FC,3952,1,21,4,3,66,23,43,67
N'castle Jet,3952,2,16,5,7,61,38,23,53
Melbourne C,3952,3,14,4,11,44,37,7,46
Melbourne V,3952,4,13,5,11,46,40,6,44
Adelaide Utd,3952,5,11,6,11,37,40,-3,39
Brisbane,3952,6,10,5,13,33,42,-9,35
Western Sydn,3952,7,8,9,10,38,47,-9,33
Perth Glory,3952,8,10,2,15,37,50,-13,32
Wellington P,3952,9,5,6,16,31,55,-24,21
CC Mariners,3952,10,4,8,15,28,49,-21,20
Sydney FC,3953,1,20,4,4,64,23,41,64
N'castle Jet,3953,2,15,5,8,58,39,19,50
Melbourne C,3953,3,15,4,10,45,34,11,49
Melbourne V,3953,4,14,5,10,46,38,8,47
Adelaide Utd,3953,5,11,6,11,37,40,-3,39
Brisbane,3953,6,10,5,13,33,42,-9,35
Western Sydn,3953,7,8,9,10,38,47,-9,33
Perth Glory,3953,8,10,2,15,37,50,-13,32
Wellington P,3953,9,5,6,16,31,55,-24,21
CC Mariners,3953,10,4,8,15,28,49,-21,20
Sydney FC,3954,1,20,5,3,66,24,42,65
N'castle Jet,3954,2,15,6,7,58,38,20,51
Melbourne C,3954,3,14,5,10,44,34,10,47
Melbourne V,3954,4,13,6,10,47,40,7,45
Adelaide Utd,3954,5,11,6,11,37,40,-3,39
Brisbane,3954,6,10,5,13,33,42,-9,35
Western Sydn,3954,7,8,9,10,38,47,-9,33
Perth Glory,3954,8,10,2,15,37,50,-13,32
Wellington P,3954,9,5,6,16,31,55,-24,21
CC Mariners,3954,10,4,8,15,28,49,-21,20
Sydney FC,3955,1,21,4,3,67,22,45,67
N'castle Jet,3955,2,16,5,7,58,37,21,53
Melbourne C,3955,3,14,4,11,43,34,9,46
Melbourne V,3955,4,13,5,11,45,41,4,44
Adelaide Utd,3955,5,11,6,11,37,40,-3,39
Brisbane,3955,6,10,5,13,33,42,-9,35
Western Sydn,3955,7,8,9,10,38,47,-9,33
Perth Glory,3955,8,10,2,15,37,50,-13,32
Wellington P,3955,9,5,6,16,31,55,-24,21
CC Mariners,3955,10,4,8,15,28,49,-21,20
Sydney FC,3956,1,20,5,3,64,22,42,65
N'castle Jet,3956,2,15,5,8,57,39,18,50
Melbourne C,3956,3,15,4,10,45,33,12,49
Melbourne V,3956,4,13,6,10,45,38,7,45
Adelaide Utd,3956,5,11,6,11,37,40,-3,39
Brisbane,3956,6,10,5,13,33,42,-9,35
Western Sydn,3956,7,8,9,10,38,47,-9,33
Perth Glory,3956,8,10,2,15,37,50,-13,32
Wellington P,3956,9,5,6,16,31,55,-24,21
CC Mariners,3956,10,4,8,15,28,49,-21,20
Sydney FC,3957,1,21,4,3,65,22,43,67
N'castle Jet,3957,2,15,5,8,57,38,19,50
Melbourne C,3957,3,15,4,10,44,33,11,49
Melbourne V,3957,4,13,5,11,45,39,6,44
Adelaide Utd,3957,5,11,6,11,37,40,-3,39
Brisbane,3957,6,10,5,13,33,42,-9,35
Western Sydn,3957,7,8,9,10,38,47,-9,33
Perth Glory,3957,8,10,2,15,37,50,-13,32
Wellington P,3957,9,5,6,16,31,55,-24,21
CC Mariners,3957,10,4,8,15,28,49,-21,20
Sydney FC,3958,1,21,4,3,68,22,46,67
N'castle Jet,3958,2,15,5,8,57,38,19,50
Melbourne C,3958,3,15,4,10,44,33,11,49
Melbourne V,3958,4,13,5,11,45,42,3,44
Adelaide Utd,3958,5,11,6,11,37,40,-3,39
Brisbane,3958,6,10,5,13,33,42,-9,35
Western Sydn,3958,7,8,9,10,38,47,-9,33
Perth Glory,3958,8,10,2,15,37,50,-13,32
Wellington P,3958,9,5,6,16,31,55,-24,21
CC Mariners,3958,10,4,8,15,28,49,-21,20
Sydney FC,3959,1,21,4,3,67,24,43,67
N'castle Jet,3959,2,15,5,8,57,39,18,50
Melbourne C,3959,3,15,4,10,45,33,12,49
Melbourne V,3959,4,13,5,11,47,41,6,44
Adelaide Utd,3959,5,11,6,11,37,40,-3,39
Brisbane,3959,6,10,5,13,33,42,-9,35
Western Sydn,3959,7,8,9,10,38,47,-9,33
Perth Glory,3959,8,10,2,15,37,50,-13,32
Wellington P,3959,9,5,6,16,31,55,-24,21
CC Mariners,3959,10,4,8,15,28,49,-21,20
Sydney FC,3960,1,21,4,3,67,23,44,67
N'castle Jet,3960,2,16,5,7,60,38,22,53
Melbourne C,3960,3,14,4,11,44,36,8,46
Melbourne V,3960,4,13,5,11,46,41,5,44
Adelaide Utd,3960,5,11,6,11,37,40,-3,39
Brisbane,3960,6,10,5,13,33,42,-9,35
Western Sydn,3960,7,8,9,10,38,47,-9,33
Perth Glory,3960,8,10,2,15,37,50,-13,32
Wellington P,3960,9,5,6,16,31,55,-24,21
CC Mariners,3960,10,4,8,15,28,49,-21,20
Sydney FC,3961,1,20,4,4,64,24,40,64
N'castle Jet,3961,2,15,6,7,60,40,20,51
Melbourne C,3961,3,14,5,10,46,36,10,47
Melbourne V,3961,4,14,5,10,47,38,9,47
Adelaide Utd,3961,5,11,6,11,37,40,-3,39
Brisbane,3961,6,10,5,13,33,42,-9,35
Western Sydn,3961,7,8,9,10,38,47,-9,33
Perth Glory,3961,8,10,2,15,37,50,-13,32
Wellington P,3961,9,5,6,16,31,55,-24,21
CC Mariners,3961,10,4,8,15,28,49,-21,20
Sydney FC,3962,1,21,4,3,66,23,43,67
N'castle Jet,3962,2,16,5,7,60,37,23,53
Melbourne C,3962,3,14,4,11,43,36,7,46
Melbourne V,3962,4,13,5,11,46,40,6,44
Adelaide Utd,3962,5,11,6,11,37,40,-3,39
Brisbane,3962,6,10,5,13,33,42,-9,35
Western Sydn,3962,7,8,9,10,38,47,-9,33
Perth Glory,3962,8,10,2,15,37,50,-13,32
Wellington P,3962,9,5,6,16,31,55,-24,21
CC Mariners,3962,10,4,8,15,28,49,-21,20
Sydney FC,3963,1,21,4,3,67,23,44,67
N'castle Jet,3963,2,16,5,7,61,39,22,53
Melbourne C,3963,3,14,4,11,45,37,8,46
Melbourne V,3963,4,13,5,11,46,41,5,44
Adelaide Utd,3963,5,11,6,11,37,40,-3,39
Brisbane,3963,6,10,5,13,33,42,-9,35
Western Sydn,3963,7,8,9,10,38,47,-9,33
Perth Glory,3963,8,10,2,15,37,50,-13,32
Wellington P,3963,9,5,6,16,31,55,-24,21
CC Mariners,3963,10,4,8,15,28,49,-21,20
Sydney FC,3964,1,21,4,3,68,25,43,67
N'castle Jet,3964,2,15,5,8,57,38,19,50
Melbourne C,3964,3,15,4,10,44,33,11,49
Melbourne V,3964,4,13,5,11,48,42,6,44
Adelaide Utd,3964,5,11,6,11,37,40,-3,39
Brisbane,3964,6,10,5,13,33,42,-9,35
Western Sydn,3964,7,8,9,10,38,47,-9,33
Perth Glory,3964,8,10,2,15,37,50,-13,32
Wellington P,3964,9,5,6,16,31,55,-24,21
CC Mariners,3964,10,4,8,15,28,49,-21,20
Sydney FC,3965,1,20,5,3,64,22,42,65
N'castle Jet,3965,2,16,5,7,61,37,24,53
Melbourne C,3965,3,14,4,11,43,37,6,46
Melbourne V,3965,4,13,6,10,45,38,7,45
Adelaide Utd,3965,5,11,6,11,37,40,-3,39
Brisbane,3965,6,10,5,13,33,42,-9,35
Western Sydn,3965,7,8,9,10,38,47,-9,33
Perth Glory,3965,8,10,2,15,37,50,-13,32
Wellington P,3965,9,5,6,16,31,55,-24,21
CC Mariners,3965,10,4,8,15,28,49,-21,20
Sydney FC,3966,1,20,4,4,65,24,41,64
N'castle Jet,3966,2,15,6,7,58,38,20,51
Melbourne C,3966,3,14,5,10,44,34,10,47
Melbourne V,3966,4,14,5,10,47,39,8,47
Adelaide Utd,3966,5,11,6,11,37,40,-3,39
Brisbane,3966,6,10,5,13,33,42,-9,35
Western Sydn,3966,7,8,9,10,38,47,-9,33
Perth Glory,3966,8,10,2,15,37,50,-13,32
Wellington P,3966,9,5,6,16,31,55,-24,21
CC Mariners,3966,10,4,8,15,28,49,-21,20
Sydney FC,3967,1,21,4,3,66,22,44,67
N'castle Jet,3967,2,16,5,7,59,38,21,53
Melbourne C,3967,3,14,4,11,44,35,9,46
Melbourne V,3967,4,13,5,11,45,40,5,44
Adelaide Utd,3967,5,11,6,11,37,40,-3,39
Brisbane,3967,6,10,5,13,33,42,-9,35
Western Sydn,3967,7,8,9,10,38,47,-9,33
Perth Glory,3967,8,10,2,15,37,50,-13,32
Wellington P,3967,9,5,6,16,31,55,-24,21
CC Mariners,3967,10,4,8,15,28,49,-21,20
Sydney FC,3968,1,21,4,3,66,22,44,67
N'castle Jet,3968,2,16,5,7,61,39,22,53
Melbourne C,3968,3,14,4,11,45,37,8,46
Melbourne V,3968,4,13,5,11,45,40,5,44
Adelaide Utd,3968,5,11,6,11,37,40,-3,39
Brisbane,3968,6,10,5,13,33,42,-9,35
Western Sydn,3968,7,8,9,10,38,47,-9,33
Perth Glory,3968,8,10,2,15,37,50,-13,32
Wellington P,3968,9,5,6,16,31,55,-24,21
CC Mariners,3968,10,4,8,15,28,49,-21,20
Sydney FC,3969,1,21,4,3,66,22,44,67
N'castle Jet,3969,2,16,5,7,62,39,23,53
Melbourne C,3969,3,14,4,11,45,38,7,46
Melbourne V,3969,4,13,5,11,45,40,5,44
Adelaide Utd,3969,5,11,6,11,37,40,-3,39
Brisbane,3969,6,10,5,13,33,42,-9,35
Western Sydn,3969,7,8,9,10,38,47,-9,33
Perth Glory,3969,8,10,2,15,37,50,-13,32
Wellington P,3969,9,5,6,16,31,55,-24,21
CC Mariners,3969,10,4,8,15,28,49,-21,20
Sydney FC,3970,1,21,4,3,66,22,44,67
N'castle Jet,3970,2,16,5,7,60,39,21,53
Melbourne C,3970,3,14,4,11,45,36,9,46
Melbourne V,3970,4,13,5,11,45,40,5,44
Adelaide Utd,3970,5,11,6,11,37,40,-3,39
Brisbane,3970,6,10,5,13,33,42,-9,35
Western Sydn,3970,7,8,9,10,38,47,-9,33
Perth Glory,3970,8,10,2,15,37,50,-13,32
Wellington P,3970,9,5,6,16,31,55,-24,21
CC Mariners,3970,10,4,8,15,28,49,-21,20
Sydney FC,3971,1,21,4,3,67,22,45,67
N'castle Jet,3971,2,15,6,7,58,38,20,51
Melbourne C,3971,3,14,5,10,44,34,10,47
Melbourne V,3971,4,13,5,11,45,41,4,44
Adelaide Utd,3971,5,11,6,11,37,40,-3,39
Brisbane,3971,6,10,5,13,33,42,-9,35
Western Sydn,3971,7,8,9,10,38,47,-9,33
Perth Glory,3971,8,10,2,15,37,50,-13,32
Wellington P,3971,9,5,6,16,31,55,-24,21
CC Mariners,3971,10,4,8,15,28,49,-21,20
Sydney FC,3972,1,20,4,4,64,25,39,64
N'castle Jet,3972,2,16,5,7,60,38,22,53
Melbourne V,3972,3,14,5,10,48,38,10,47
Melbourne C,3972,4,14,4,11,44,36,8,46
Adelaide Utd,3972,5,11,6,11,37,40,-3,39
Brisbane,3972,6,10,5,13,33,42,-9,35
Western Sydn,3972,7,8,9,10,38,47,-9,33
Perth Glory,3972,8,10,2,15,37,50,-13,32
Wellington P,3972,9,5,6,16,31,55,-24,21
CC Mariners,3972,10,4,8,15,28,49,-21,20
Sydney FC,3973,1,20,5,3,66,24,42,65
N'castle Jet,3973,2,16,5,7,61,39,22,53
Melbourne C,3973,3,14,4,11,45,37,8,46
Melbourne V,3973,4,13,6,10,47,40,7,45
Adelaide Utd,3973,5,11,6,11,37,40,-3,39
Brisbane,3973,6,10,5,13,33,42,-9,35
Western Sydn,3973,7,8,9,10,38,47,-9,33
Perth Glory,3973,8,10,2,15,37,50,-13,32
Wellington P,3973,9,5,6,16,31,55,-24,21
CC Mariners,3973,10,4,8,15,28,49,-21,20
Sydney FC,3974,1,21,4,3,68,23,45,67
N'castle Jet,3974,2,16,5,7,59,38,21,53
Melbourne C,3974,3,14,4,11,44,35,9,46
Melbourne V,3974,4,13,5,11,46,42,4,44
Adelaide Utd,3974,5,11,6,11,37,40,-3,39
Brisbane,3974,6,10,5,13,33,42,-9,35
Western Sydn,3974,7,8,9,10,38,47,-9,33
Perth Glory,3974,8,10,2,15,37,50,-13,32
Wellington P,3974,9,5,6,16,31,55,-24,21
CC Mariners,3974,10,4,8,15,28,49,-21,20
Sydney FC,3975,1,20,5,3,64,22,42,65
N'castle Jet,3975,2,15,5,8,58,40,18,50
Melbourne C,3975,3,15,4,10,46,34,12,49
Melbourne V,3975,4,13,6,10,45,38,7,45
Adelaide Utd,3975,5,11,6,11,37,40,-3,39
Brisbane,3975,6,10,5,13,33,42,-9,35
Western Sydn,3975,7,8,9,10,38,47,-9,33
Perth Glory,3975,8,10,2,15,37,50,-13,32
Wellington P,3975,9,5,6,16,31,55,-24,21
CC Mariners,3975,10,4,8,15,28,49,-21,20
Sydney FC,3976,1,21,4,3,67,23,44,67
N'castle Jet,3976,2,15,6,7,58,38,20,51
Melbourne C,3976,3,14,5,10,44,34,10,47
Melbourne V,3976,4,13,5,11,46,41,5,44
Adelaide Utd,3976,5,11,6,11,37,40,-3,39
Brisbane,3976,6,10,5,13,33,42,-9,35
Western Sydn,3976,7,8,9,10,38,47,-9,33
Perth Glory,3976,8,10,2,15,37,50,-13,32
Wellington P,3976,9,5,6,16,31,55,-24,21
CC Mariners,3976,10,4,8,15,28,49,-21,20
Sydney FC,3977,1,21,4,3,66,22,44,67
N'castle Jet,3977,2,15,5,8,58,40,18,50
Melbourne C,3977,3,15,4,10,46,34,12,49
Melbourne V,3977,4,13,5,11,45,40,5,44
Adelaide Utd,3977,5,11,6,11,37,40,-3,39
Brisbane,3977,6,10,5,13,33,42,-9,35
Western Sydn,3977,7,8,9,10,38,47,-9,33
Perth Glory,3977,8,10,2,15,37,50,-13,32
Wellington P,3977,9,5,6,16,31,55,-24,21
CC Mariners,3977,10,4,8,15,28,49,-21,20
Sydney FC,3978,1,20,4,4,64,23,41,64
N'castle Jet,3978,2,16,5,7,58,37,21,53
Melbourne V,3978,3,14,5,10,46,38,8,47
Melbourne C,3978,4,14,4,11,43,34,9,46
Adelaide Utd,3978,5,11,6,11,37,40,-3,39
Brisbane,3978,6,10,5,13,33,42,-9,35
Western Sydn,3978,7,8,9,10,38,47,-9,33
Perth Glory,3978,8,10,2,15,37,50,-13,32
Wellington P,3978,9,5,6,16,31,55,-24,21
CC Mariners,3978,10,4,8,15,28,49,-21,20
Sydney FC,3979,1,21,4,3,68,22,46,67
N'castle Jet,3979,2,16,5,7,59,37,22,53
Melbourne C,3979,3,14,4,11,43,35,8,46
Melbourne V,3979,4,13,5,11,45,42,3,44
Adelaide Utd,3979,5,11,6,11,37,40,-3,39
Brisbane,3979,6,10,5,13,33,42,-9,35
Western Sydn,3979,7,8,9,10,38,47,-9,33
Perth Glory,3979,8,10,2,15,37,50,-13,32
Wellington P,3979,9,5,6,16,31,55,-24,21
CC Mariners,3979,10,4,8,15,28,49,-21,20
Sydney FC,3980,1,21,4,3,68,24,44,67
N'castle Jet,3980,2,16,5,7,62,38,24,53
Melbourne C,3980,3,14,4,11,44,38,6,46
Melbourne V,3980,4,13,5,11,47,42,5,44
Adelaide Utd,3980,5,11,6,11,37,40,-3,39
Brisbane,3980,6,10,5,13,33,42,-9,35
Western Sydn,3980,7,8,9,10,38,47,-9,33
Perth Glory,3980,8,10,2,15,37,50,-13,32
Wellington P,3980,9,5,6,16,31,55,-24,21
CC Mariners,3980,10,4,8,15,28,49,-21,20
Sydney FC,3981,1,21,4,3,65,22,43,67
N'castle Jet,3981,2,15,6,7,58,38,20,51
Melbourne C,3981,3,14,5,10,44,34,10,47
Melbourne V,3981,4,13,5,11,45,39,6,44
Adelaide Utd,3981,5,11,6,11,37,40,-3,39
Brisbane,3981,6,10,5,13,33,42,-9,35
Western Sydn,3981,7,8,9,10,38,47,-9,33
Perth Glory,3981,8,10,2,15,37,50,-13,32
Wellington P,3981,9,5,6,16,31,55,-24,21
CC Mariners,3981,10,4,8,15,28,49,-21,20
Sydney FC,3982,1,20,5,3,66,24,42,65
N'castle Jet,3982,2,15,6,7,57,37,20,51
Melbourne C,3982,3,14,5,10,43,33,10,47
Melbourne V,3982,4,13,6,10,47,40,7,45
Adelaide Utd,3982,5,11,6,11,37,40,-3,39
Brisbane,3982,6,10,5,13,33,42,-9,35
Western Sydn,3982,7,8,9,10,38,47,-9,33
Perth Glory,3982,8,10,2,15,37,50,-13,32
Wellington P,3982,9,5,6,16,31,55,-24,21
CC Mariners,3982,10,4,8,15,28,49,-21,20
Sydney FC,3983,1,20,4,4,65,24,41,64
N'castle Jet,3983,2,16,5,7,59,37,22,53
Melbourne V,3983,3,14,5,10,47,39,8,47
Melbourne C,3983,4,14,4,11,43,35,8,46
Adelaide Utd,3983,5,11,6,11,37,40,-3,39
Brisbane,3983,6,10,5,13,33,42,-9,35
Western Sydn,3983,7,8,9,10,38,47,-9,33
Perth Glory,3983,8,10,2,15,37,50,-13,32
Wellington P,3983,9,5,6,16,31,55,-24,21
CC Mariners,3983,10,4,8,15,28,49,-21,20
Sydney FC,3984,1,21,4,3,66,23,43,67
N'castle Jet,3984,2,16,5,7,61,39,22,53
Melbourne C,3984,3,14,4,11,45,37,8,46
Melbourne V,3984,4,13,5,11,46,40,6,44
Adelaide Utd,3984,5,11,6,11,37,40,-3,39
Brisbane,3984,6,10,5,13,33,42,-9,35
Western Sydn,3984,7,8,9,10,38,47,-9,33
Perth Glory,3984,8,10,2,15,37,50,-13,32
Wellington P,3984,9,5,6,16,31,55,-24,21
CC Mariners,3984,10,4,8,15,28,49,-21,20
Sydney FC,3985,1,21,4,3,66,23,43,67
N'castle Jet,3985,2,16,5,7,60,39,21,53
Melbourne C,3985,3,14,4,11,45,36,9,46
Melbourne V,3985,4,13,5,11,46,40,6,44
Adelaide Utd,3985,5,11,6,11,37,40,-3,39
Brisbane,3985,6,10,5,13,33,42,-9,35
Western Sydn,3985,7,8,9,10,38,47,-9,33
Perth Glory,3985,8,10,2,15,37,50,-13,32
Wellington P,3985,9,5,6,16,31,55,-24,21
CC Mariners,3985,10,4,8,15,28,49,-21,20
Sydney FC,3986,1,20,5,3,66,24,42,65
N'castle Jet,3986,2,16,5,7,58,37,21,53
Melbourne C,3986,3,14,4,11,43,34,9,46
Melbourne V,3986,4,13,6,10,47,40,7,45
Adelaide Utd,3986,5,11,6,11,37,40,-3,39
Brisbane,3986,6,10,5,13,33,42,-9,35
Western Sydn,3986,7,8,9,10,38,47,-9,33
Perth Glory,3986,8,10,2,15,37,50,-13,32
Wellington P,3986,9,5,6,16,31,55,-24,21
CC Mariners,3986,10,4,8,15,28,49,-21,20
Sydney FC,3987,1,20,5,3,66,24,42,65
N'castle Jet,3987,2,15,5,8,58,39,19,50
Melbourne C,3987,3,15,4,10,45,34,11,49
Melbourne V,3987,4,13,6,10,47,40,7,45
Adelaide Utd,3987,5,11,6,11,37,40,-3,39
Brisbane,3987,6,10,5,13,33,42,-9,35
Western Sydn,3987,7,8,9,10,38,47,-9,33
Perth Glory,3987,8,10,2,15,37,50,-13,32
Wellington P,3987,9,5,6,16,31,55,-24,21
CC Mariners,3987,10,4,8,15,28,49,-21,20
Sydney FC,3988,1,21,4,3,66,22,44,67
N'castle Jet,3988,2,16,5,7,58,37,21,53
Melbourne C,3988,3,14,4,11,43,34,9,46
Melbourne V,3988,4,13,5,11,45,40,5,44
Adelaide Utd,3988,5,11,6,11,37,40,-3,39
Brisbane,3988,6,10,5,13,33,42,-9,35
Western Sydn,3988,7,8,9,10,38,47,-9,33
Perth Glory,3988,8,10,2,15,37,50,-13,32
Wellington P,3988,9,5,6,16,31,55,-24,21
CC Mariners,3988,10,4,8,15,28,49,-21,20
Sydney FC,3989,1,20,4,4,65,25,40,64
N'castle Jet,3989,2,15,6,7,58,38,20,51
Melbourne C,3989,3,14,5,10,44,34,10,47
Melbourne V,3989,4,14,5,10,48,39,9,47
Adelaide Utd,3989,5,11,6,11,37,40,-3,39
Brisbane,3989,6,10,5,13,33,42,-9,35
Western Sydn,3989,7,8,9,10,38,47,-9,33
Perth Glory,3989,8,10,2,15,37,50,-13,32
Wellington P,3989,9,5,6,16,31,55,-24,21
CC Mariners,3989,10,4,8,15,28,49,-21,20
Sydney FC,3990,1,21,4,3,68,25,43,67
N'castle Jet,3990,2,15,6,7,59,39,20,51
Melbourne C,3990,3,14,5,10,45,35,10,47
Melbourne V,3990,4,13,5,11,48,42,6,44
Adelaide Utd,3990,5,11,6,11,37,40,-3,39
Brisbane,3990,6,10,5,13,33,42,-9,35
Western Sydn,3990,7,8,9,10,38,47,-9,33
Perth Glory,3990,8,10,2,15,37,50,-13,32
Wellington P,3990,9,5,6,16,31,55,-24,21
CC Mariners,3990,10,4,8,15,28,49,-21,20
Sydney FC,3991,1,20,4,4,65,25,40,64
N'castle Jet,3991,2,15,6,7,59,39,20,51
Melbourne C,3991,3,14,5,10,45,35,10,47
Melbourne V,3991,4,14,5,10,48,39,9,47
Adelaide Utd,3991,5,11,6,11,37,40,-3,39
Brisbane,3991,6,10,5,13,33,42,-9,35
Western Sydn,3991,7,8,9,10,38,47,-9,33
Perth Glory,3991,8,10,2,15,37,50,-13,32
Wellington P,3991,9,5,6,16,31,55,-24,21
CC Mariners,3991,10,4,8,15,28,49,-21,20
Sydney FC,3992,1,21,4,3,67,24,43,67
N'castle Jet,3992,2,15,6,7,58,38,20,51
Melbourne C,3992,3,14,5,10,44,34,10,47
Melbourne V,3992,4,13,5,11,47,41,6,44
Adelaide Utd,3992,5,11,6,11,37,40,-3,39
Brisbane,3992,6,10,5,13,33,42,-9,35
Western Sydn,3992,7,8,9,10,38,47,-9,33
Perth Glory,3992,8,10,2,15,37,50,-13,32
Wellington P,3992,9,5,6,16,31,55,-24,21
CC Mariners,3992,10,4,8,15,28,49,-21,20
Sydney FC,3993,1,20,5,3,66,24,42,65
N'castle Jet,3993,2,15,5,8,60,42,18,50
Melbourne C,3993,3,15,4,10,48,36,12,49
Melbourne V,3993,4,13,6,10,47,40,7,45
Adelaide Utd,3993,5,11,6,11,37,40,-3,39
Brisbane,3993,6,10,5,13,33,42,-9,35
Western Sydn,3993,7,8,9,10,38,47,-9,33
Perth Glory,3993,8,10,2,15,37,50,-13,32
Wellington P,3993,9,5,6,16,31,55,-24,21
CC Mariners,3993,10,4,8,15,28,49,-21,20
Sydney FC,3994,1,21,4,3,67,23,44,67
N'castle Jet,3994,2,15,5,8,59,40,19,50
Melbourne C,3994,3,15,4,10,46,35,11,49
Melbourne V,3994,4,13,5,11,46,41,5,44
Adelaide Utd,3994,5,11,6,11,37,40,-3,39
Brisbane,3994,6,10,5,13,33,42,-9,35
Western Sydn,3994,7,8,9,10,38,47,-9,33
Perth Glory,3994,8,10,2,15,37,50,-13,32
Wellington P,3994,9,5,6,16,31,55,-24,21
CC Mariners,3994,10,4,8,15,28,49,-21,20
Sydney FC,3995,1,20,5,3,64,22,42,65
N'castle Jet,3995,2,16,5,7,60,38,22,53
Melbourne C,3995,3,14,4,11,44,36,8,46
Melbourne V,3995,4,13,6,10,45,38,7,45
Adelaide Utd,3995,5,11,6,11,37,40,-3,39
Brisbane,3995,6,10,5,13,33,42,-9,35
Western Sydn,3995,7,8,9,10,38,47,-9,33
Perth Glory,3995,8,10,2,15,37,50,-13,32
Wellington P,3995,9,5,6,16,31,55,-24,21
CC Mariners,3995,10,4,8,15,28,49,-21,20
Sydney FC,3996,1,21,4,3,69,22,47,67
N'castle Jet,3996,2,16,5,7,62,41,21,53
Melbourne C,3996,3,14,4,11,47,38,9,46
Melbourne V,3996,4,13,5,11,45,43,2,44
Adelaide Utd,3996,5,11,6,11,37,40,-3,39
Brisbane,3996,6,10,5,13,33,42,-9,35
Western Sydn,3996,7,8,9,10,38,47,-9,33
Perth Glory,3996,8,10,2,15,37,50,-13,32
Wellington P,3996,9,5,6,16,31,55,-24,21
CC Mariners,3996,10,4,8,15,28,49,-21,20
Sydney FC,3997,1,20,4,4,64,24,40,64
N'castle Jet,3997,2,16,5,7,59,37,22,53
Melbourne V,3997,3,14,5,10,47,38,9,47
Melbourne C,3997,4,14,4,11,43,35,8,46
Adelaide Utd,3997,5,11,6,11,37,40,-3,39
Brisbane,3997,6,10,5,13,33,42,-9,35
Western Sydn,3997,7,8,9,10,38,47,-9,33
Perth Glory,3997,8,10,2,15,37,50,-13,32
Wellington P,3997,9,5,6,16,31,55,-24,21
CC Mariners,3997,10,4,8,15,28,49,-21,20
Sydney FC,3998,1,21,4,3,66,22,44,67
N'castle Jet,3998,2,16,5,7,58,37,21,53
Melbourne C,3998,3,14,4,11,43,34,9,46
Melbourne V,3998,4,13,5,11,45,40,5,44
Adelaide Utd,3998,5,11,6,11,37,40,-3,39
Brisbane,3998,6,10,5,13,33,42,-9,35
Western Sydn,3998,7,8,9,10,38,47,-9,33
Perth Glory,3998,8,10,2,15,37,50,-13,32
Wellington P,3998,9,5,6,16,31,55,-24,21
CC Mariners,3998,10,4,8,15,28,49,-21,20
Sydney FC,3999,1,21,4,3,68,24,44,67
N'castle Jet,3999,2,16,5,7,59,37,22,53
Melbourne C,3999,3,14,4,11,43,35,8,46
Melbourne V,3999,4,13,5,11,47,42,5,44
Adelaide Utd,3999,5,11,6,11,37,40,-3,39
Brisbane,3999,6,10,5,13,33,42,-9,35
Western Sydn,3999,7,8,9,10,38,47,-9,33
Perth Glory,3999,8,10,2,15,37,50,-13,32
Wellington P,3999,9,5,6,16,31,55,-24,21
CC Mariners,3999,10,4,8,15,28,49,-21,20
Sydney FC,4000,1,20,4,4,65,25,40,64
N'castle Jet,4000,2,15,5,8,57,40,17,50
Melbourne C,4000,3,15,4,10,46,33,13,49
Melbourne V,4000,4,14,5,10,48,39,9,47
Adelaide Utd,4000,5,11,6,11,37,40,-3,39
Brisbane,4000,6,10,5,13,33,42,-9,35
Western Sydn,4000,7,8,9,10,38,47,-9,33
Perth Glory,4000,8,10,2,15,37,50,-13,32
Wellington P,4000,9,5,6,16,31,55,-24,21
CC Mariners,4000,10,4,8,15,28,49,-21,20
Sydney FC,4001,1,21,4,3,66,22,44,67
N'castle Jet,4001,2,16,5,7,61,38,23,53
Melbourne C,4001,3,14,4,11,44,37,7,46
Melbourne V,4001,4,13,5,11,45,40,5,44
Adelaide Utd,4001,5,11,6,11,37,40,-3,39
Brisbane,4001,6,10,5,13,33,42,-9,35
Western Sydn,4001,7,8,9,10,38,47,-9,33
Perth Glory,4001,8,10,2,15,37,50,-13,32
Wellington P,4001,9,5,6,16,31,55,-24,21
CC Mariners,4001,10,4,8,15,28,49,-21,20
Sydney FC,4002,1,20,5,3,65,23,42,65
N'castle Jet,4002,2,15,5,8,58,40,18,50
Melbourne C,4002,3,15,4,10,46,34,12,49
Melbourne V,4002,4,13,6,10,46,39,7,45
Adelaide Utd,4002,5,11,6,11,37,40,-3,39
Brisbane,4002,6,10,5,13,33,42,-9,35
Western Sydn,4002,7,8,9,10,38,47,-9,33
Perth Glory,4002,8,10,2,15,37,50,-13,32
Wellington P,4002,9,5,6,16,31,55,-24,21
CC Mariners,4002,10,4,8,15,28,49,-21,20
Sydney FC,4003,1,20,5,3,65,23,42,65
N'castle Jet,4003,2,15,5,8,59,40,19,50
Melbourne C,4003,3,15,4,10,46,35,11,49
Melbourne V,4003,4,13,6,10,46,39,7,45
Adelaide Utd,4003,5,11,6,11,37,40,-3,39
Brisbane,4003,6,10,5,13,33,42,-9,35
Western Sydn,4003,7,8,9,10,38,47,-9,33
Perth Glory,4003,8,10,2,15,37,50,-13,32
Wellington P,4003,9,5,6,16,31,55,-24,21
CC Mariners,4003,10,4,8,15,28,49,-21,20
Sydney FC,4004,1,20,5,3,65,23,42,65
N'castle Jet,4004,2,15,6,7,58,38,20,51
Melbourne C,4004,3,14,5,10,44,34,10,47
Melbourne V,4004,4,13,6,10,46,39,7,45
Adelaide Utd,4004,5,11,6,11,37,40,-3,39
Brisbane,4004,6,10,5,13,33,42,-9,35
Western Sydn,4004,7,8,9,10,38,47,-9,33
Perth Glory,4004,8,10,2,15,37,50,-13,32
Wellington P,4004,9,5,6,16,31,55,-24,21
CC Mariners,4004,10,4,8,15,28,49,-21,20
Sydney FC,4005,1,21,4,3,66,23,43,67
N'castle Jet,4005,2,15,5,8,57,40,17,50
Melbourne C,4005,3,15,4,10,46,33,13,49
Melbourne V,4005,4,13,5,11,46,40,6,44
Adelaide Utd,4005,5,11,6,11,37,40,-3,39
Brisbane,4005,6,10,5,13,33,42,-9,35
Western Sydn,4005,7,8,9,10,38,47,-9,33
Perth Glory,4005,8,10,2,15,37,50,-13,32
Wellington P,4005,9,5,6,16,31,55,-24,21
CC Mariners,4005,10,4,8,15,28,49,-21,20
Sydney FC,4006,1,21,4,3,66,22,44,67
N'castle Jet,4006,2,15,5,8,57,38,19,50
Melbourne C,4006,3,15,4,10,44,33,11,49
Melbourne V,4006,4,13,5,11,45,40,5,44
Adelaide Utd,4006,5,11,6,11,37,40,-3,39
Brisbane,4006,6,10,5,13,33,42,-9,35
Western Sydn,4006,7,8,9,10,38,47,-9,33
Perth Glory,4006,8,10,2,15,37,50,-13,32
Wellington P,4006,9,5,6,16,31,55,-24,21
CC Mariners,4006,10,4,8,15,28,49,-21,20
Sydney FC,4007,1,20,5,3,64,22,42,65
N'castle Jet,4007,2,15,6,7,58,38,20,51
Melbourne C,4007,3,14,5,10,44,34,10,47
Melbourne V,4007,4,13,6,10,45,38,7,45
Adelaide Utd,4007,5,11,6,11,37,40,-3,39
Brisbane,4007,6,10,5,13,33,42,-9,35
Western Sydn,4007,7,8,9,10,38,47,-9,33
Perth Glory,4007,8,10,2,15,37,50,-13,32
Wellington P,4007,9,5,6,16,31,55,-24,21
CC Mariners,4007,10,4,8,15,28,49,-21,20
Sydney FC,4008,1,21,4,3,67,23,44,67
N'castle Jet,4008,2,16,5,7,60,39,21,53
Melbourne C,4008,3,14,4,11,45,36,9,46
Melbourne V,4008,4,13,5,11,46,41,5,44
Adelaide Utd,4008,5,11,6,11,37,40,-3,39
Brisbane,4008,6,10,5,13,33,42,-9,35
Western Sydn,4008,7,8,9,10,38,47,-9,33
Perth Glory,4008,8,10,2,15,37,50,-13,32
Wellington P,4008,9,5,6,16,31,55,-24,21
CC Mariners,4008,10,4,8,15,28,49,-21,20
Sydney FC,4009,1,20,5,3,64,22,42,65
N'castle Jet,4009,2,15,5,8,57,38,19,50
Melbourne C,4009,3,15,4,10,44,33,11,49
Melbourne V,4009,4,13,6,10,45,38,7,45
Adelaide Utd,4009,5,11,6,11,37,40,-3,39
Brisbane,4009,6,10,5,13,33,42,-9,35
Western Sydn,4009,7,8,9,10,38,47,-9,33
Perth Glory,4009,8,10,2,15,37,50,-13,32
Wellington P,4009,9,5,6,16,31,55,-24,21
CC Mariners,4009,10,4,8,15,28,49,-21,20
Sydney FC,4010,1,21,4,3,66,22,44,67
N'castle Jet,4010,2,15,6,7,60,40,20,51
Melbourne C,4010,3,14,5,10,46,36,10,47
Melbourne V,4010,4,13,5,11,45,40,5,44
Adelaide Utd,4010,5,11,6,11,37,40,-3,39
Brisbane,4010,6,10,5,13,33,42,-9,35
Western Sydn,4010,7,8,9,10,38,47,-9,33
Perth Glory,4010,8,10,2,15,37,50,-13,32
Wellington P,4010,9,5,6,16,31,55,-24,21
CC Mariners,4010,10,4,8,15,28,49,-21,20
Sydney FC,4011,1,21,4,3,66,22,44,67
N'castle Jet,4011,2,16,5,7,61,38,23,53
Melbourne C,4011,3,14,4,11,44,37,7,46
Melbourne V,4011,4,13,5,11,45,40,5,44
Adelaide Utd,4011,5,11,6,11,37,40,-3,39
Brisbane,4011,6,10,5,13,33,42,-9,35
Western Sydn,4011,7,8,9,10,38,47,-9,33
Perth Glory,4011,8,10,2,15,37,50,-13,32
Wellington P,4011,9,5,6,16,31,55,-24,21
CC Mariners,4011,10,4,8,15,28,49,-21,20
Sydney FC,4012,1,20,4,4,65,24,41,64
N'castle Jet,4012,2,15,5,8,57,39,18,50
Melbourne C,4012,3,15,4,10,45,33,12,49
Melbourne V,4012,4,14,5,10,47,39,8,47
Adelaide Utd,4012,5,11,6,11,37,40,-3,39
Brisbane,4012,6,10,5,13,33,42,-9,35
Western Sydn,4012,7,8,9,10,38,47,-9,33
Perth Glory,4012,8,10,2,15,37,50,-13,32
Wellington P,4012,9,5,6,16,31,55,-24,21
CC Mariners,4012,10,4,8,15,28,49,-21,20
Sydney FC,4013,1,21,4,3,68,22,46,67
N'castle Jet,4013,2,16,5,7,58,37,21,53
Melbourne C,4013,3,14,4,11,43,34,9,46
Melbourne V,4013,4,13,5,11,45,42,3,44
Adelaide Utd,4013,5,11,6,11,37,40,-3,39
Brisbane,4013,6,10,5,13,33,42,-9,35
Western Sydn,4013,7,8,9,10,38,47,-9,33
Perth Glory,4013,8,10,2,15,37,50,-13,32
Wellington P,4013,9,5,6,16,31,55,-24,21
CC Mariners,4013,10,4,8,15,28,49,-21,20
Sydney FC,4014,1,21,4,3,65,22,43,67
N'castle Jet,4014,2,15,5,8,57,38,19,50
Melbourne C,4014,3,15,4,10,44,33,11,49
Melbourne V,4014,4,13,5,11,45,39,6,44
Adelaide Utd,4014,5,11,6,11,37,40,-3,39
Brisbane,4014,6,10,5,13,33,42,-9,35
Western Sydn,4014,7,8,9,10,38,47,-9,33
Perth Glory,4014,8,10,2,15,37,50,-13,32
Wellington P,4014,9,5,6,16,31,55,-24,21
CC Mariners,4014,10,4,8,15,28,49,-21,20
Sydney FC,4015,1,21,4,3,69,23,46,67
N'castle Jet,4015,2,15,5,8,57,39,18,50
Melbourne C,4015,3,15,4,10,45,33,12,49
Melbourne V,4015,4,13,5,11,46,43,3,44
Adelaide Utd,4015,5,11,6,11,37,40,-3,39
Brisbane,4015,6,10,5,13,33,42,-9,35
Western Sydn,4015,7,8,9,10,38,47,-9,33
Perth Glory,4015,8,10,2,15,37,50,-13,32
Wellington P,4015,9,5,6,16,31,55,-24,21
CC Mariners,4015,10,4,8,15,28,49,-21,20
Sydney FC,4016,1,21,4,3,67,22,45,67
N'castle Jet,4016,2,16,5,7,58,37,21,53
Melbourne C,4016,3,14,4,11,43,34,9,46
Melbourne V,4016,4,13,5,11,45,41,4,44
Adelaide Utd,4016,5,11,6,11,37,40,-3,39
Brisbane,4016,6,10,5,13,33,42,-9,35
Western Sydn,4016,7,8,9,10,38,47,-9,33
Perth Glory,4016,8,10,2,15,37,50,-13,32
Wellington P,4016,9,5,6,16,31,55,-24,21
CC Mariners,4016,10,4,8,15,28,49,-21,20
Sydney FC,4017,1,21,4,3,68,24,44,67
N'castle Jet,4017,2,16,5,7,60,39,21,53
Melbourne C,4017,3,14,4,11,45,36,9,46
Melbourne V,4017,4,13,5,11,47,42,5,44
Adelaide Utd,4017,5,11,6,11,37,40,-3,39
Brisbane,4017,6,10,5,13,33,42,-9,35
Western Sydn,4017,7,8,9,10,38,47,-9,33
Perth Glory,4017,8,10,2,15,37,50,-13,32
Wellington P,4017,9,5,6,16,31,55,-24,21
CC Mariners,4017,10,4,8,15,28,49,-21,20
Sydney FC,4018,1,21,4,3,65,22,43,67
N'castle Jet,4018,2,16,5,7,59,38,21,53
Melbourne C,4018,3,14,4,11,44,35,9,46
Melbourne V,4018,4,13,5,11,45,39,6,44
Adelaide Utd,4018,5,11,6,11,37,40,-3,39
Brisbane,4018,6,10,5,13,33,42,-9,35
Western Sydn,4018,7,8,9,10,38,47,-9,33
Perth Glory,4018,8,10,2,15,37,50,-13,32
Wellington P,4018,9,5,6,16,31,55,-24,21
CC Mariners,4018,10,4,8,15,28,49,-21,20
Sydney FC,4019,1,20,4,4,64,24,40,64
N'castle Jet,4019,2,16,5,7,60,37,23,53
Melbourne V,4019,3,14,5,10,47,38,9,47
Melbourne C,4019,4,14,4,11,43,36,7,46
Adelaide Utd,4019,5,11,6,11,37,40,-3,39
Brisbane,4019,6,10,5,13,33,42,-9,35
Western Sydn,4019,7,8,9,10,38,47,-9,33
Perth Glory,4019,8,10,2,15,37,50,-13,32
Wellington P,4019,9,5,6,16,31,55,-24,21
CC Mariners,4019,10,4,8,15,28,49,-21,20
Sydney FC,4020,1,20,4,4,65,24,41,64
N'castle Jet,4020,2,16,5,7,61,37,24,53
Melbourne V,4020,3,14,5,10,47,39,8,47
Melbourne C,4020,4,14,4,11,43,37,6,46
Adelaide Utd,4020,5,11,6,11,37,40,-3,39
Brisbane,4020,6,10,5,13,33,42,-9,35
Western Sydn,4020,7,8,9,10,38,47,-9,33
Perth Glory,4020,8,10,2,15,37,50,-13,32
Wellington P,4020,9,5,6,16,31,55,-24,21
CC Mariners,4020,10,4,8,15,28,49,-21,20
Sydney FC,4021,1,20,4,4,64,23,41,64
N'castle Jet,4021,2,16,5,7,63,38,25,53
Melbourne V,4021,3,14,5,10,46,38,8,47
Melbourne C,4021,4,14,4,11,44,39,5,46
Adelaide Utd,4021,5,11,6,11,37,40,-3,39
Brisbane,4021,6,10,5,13,33,42,-9,35
Western Sydn,4021,7,8,9,10,38,47,-9,33
Perth Glory,4021,8,10,2,15,37,50,-13,32
Wellington P,4021,9,5,6,16,31,55,-24,21
CC Mariners,4021,10,4,8,15,28,49,-21,20
Sydney FC,4022,1,21,4,3,66,22,44,67
N'castle Jet,4022,2,16,5,7,61,39,22,53
Melbourne C,4022,3,14,4,11,45,37,8,46
Melbourne V,4022,4,13,5,11,45,40,5,44
Adelaide Utd,4022,5,11,6,11,37,40,-3,39
Brisbane,4022,6,10,5,13,33,42,-9,35
Western Sydn,4022,7,8,9,10,38,47,-9,33
Perth Glory,4022,8,10,2,15,37,50,-13,32
Wellington P,4022,9,5,6,16,31,55,-24,21
CC Mariners,4022,10,4,8,15,28,49,-21,20
Sydney FC,4023,1,20,5,3,65,23,42,65
N'castle Jet,4023,2,16,5,7,60,38,22,53
Melbourne C,4023,3,14,4,11,44,36,8,46
Melbourne V,4023,4,13,6,10,46,39,7,45
Adelaide Utd,4023,5,11,6,11,37,40,-3,39
Brisbane,4023,6,10,5,13,33,42,-9,35
Western Sydn,4023,7,8,9,10,38,47,-9,33
Perth Glory,4023,8,10,2,15,37,50,-13,32
Wellington P,4023,9,5,6,16,31,55,-24,21
CC Mariners,4023,10,4,8,15,28,49,-21,20
Sydney FC,4024,1,21,4,3,65,22,43,67
N'castle Jet,4024,2,16,5,7,59,38,21,53
Melbourne C,4024,3,14,4,11,44,35,9,46
Melbourne V,4024,4,13,5,11,45,39,6,44
Adelaide Utd,4024,5,11,6,11,37,40,-3,39
Brisbane,4024,6,10,5,13,33,42,-9,35
Western Sydn,4024,7,8,9,10,38,47,-9,33
Perth Glory,4024,8,10,2,15,37,50,-13,32
Wellington P,4024,9,5,6,16,31,55,-24,21
CC Mariners,4024,10,4,8,15,28,49,-21,20
Sydney FC,4025,1,21,4,3,66,22,44,67
N'castle Jet,4025,2,15,5,8,57,38,19,50
Melbourne C,4025,3,15,4,10,44,33,11,49
Melbourne V,4025,4,13,5,11,45,40,5,44
Adelaide Utd,4025,5,11,6,11,37,40,-3,39
Brisbane,4025,6,10,5,13,33,42,-9,35
Western Sydn,4025,7,8,9,10,38,47,-9,33
Perth Glory,4025,8,10,2,15,37,50,-13,32
Wellington P,4025,9,5,6,16,31,55,-24,21
CC Mariners,4025,10,4,8,15,28,49,-21,20
Sydney FC,4026,1,20,5,3,65,23,42,65
N'castle Jet,4026,2,15,5,8,57,38,19,50
Melbourne C,4026,3,15,4,10,44,33,11,49
Melbourne V,4026,4,13,6,10,46,39,7,45
Adelaide Utd,4026,5,11,6,11,37,40,-3,39
Brisbane,4026,6,10,5,13,33,42,-9,35
Western Sydn,4026,7,8,9,10,38,47,-9,33
Perth Glory,4026,8,10,2,15,37,50,-13,32
Wellington P,4026,9,5,6,16,31,55,-24,21
CC Mariners,4026,10,4,8,15,28,49,-21,20
Sydney FC,4027,1,21,4,3,68,24,44,67
N'castle Jet,4027,2,16,5,7,58,37,21,53
Melbourne C,4027,3,14,4,11,43,34,9,46
Melbourne V,4027,4,13,5,11,47,42,5,44
Adelaide Utd,4027,5,11,6,11,37,40,-3,39
Brisbane,4027,6,10,5,13,33,42,-9,35
Western Sydn,4027,7,8,9,10,38,47,-9,33
Perth Glory,4027,8,10,2,15,37,50,-13,32
Wellington P,4027,9,5,6,16,31,55,-24,21
CC Mariners,4027,10,4,8,15,28,49,-21,20
Sydney FC,4028,1,21,4,3,66,22,44,67
N'castle Jet,4028,2,15,5,8,57,38,19,50
Melbourne C,4028,3,15,4,10,44,33,11,49
Melbourne V,4028,4,13,5,11,45,40,5,44
Adelaide Utd,4028,5,11,6,11,37,40,-3,39
Brisbane,4028,6,10,5,13,33,42,-9,35
Western Sydn,4028,7,8,9,10,38,47,-9,33
Perth Glory,4028,8,10,2,15,37,50,-13,32
Wellington P,4028,9,5,6,16,31,55,-24,21
CC Mariners,4028,10,4,8,15,28,49,-21,20
Sydney FC,4029,1,21,4,3,67,24,43,67
N'castle Jet,4029,2,16,5,7,60,39,21,53
Melbourne C,4029,3,14,4,11,45,36,9,46
Melbourne V,4029,4,13,5,11,47,41,6,44
Adelaide Utd,4029,5,11,6,11,37,40,-3,39
Brisbane,4029,6,10,5,13,33,42,-9,35
Western Sydn,4029,7,8,9,10,38,47,-9,33
Perth Glory,4029,8,10,2,15,37,50,-13,32
Wellington P,4029,9,5,6,16,31,55,-24,21
CC Mariners,4029,10,4,8,15,28,49,-21,20
Sydney FC,4030,1,21,4,3,65,22,43,67
N'castle Jet,4030,2,15,6,7,59,39,20,51
Melbourne C,4030,3,14,5,10,45,35,10,47
Melbourne V,4030,4,13,5,11,45,39,6,44
Adelaide Utd,4030,5,11,6,11,37,40,-3,39
Brisbane,4030,6,10,5,13,33,42,-9,35
Western Sydn,4030,7,8,9,10,38,47,-9,33
Perth Glory,4030,8,10,2,15,37,50,-13,32
Wellington P,4030,9,5,6,16,31,55,-24,21
CC Mariners,4030,10,4,8,15,28,49,-21,20
Sydney FC,4031,1,21,4,3,68,23,45,67
N'castle Jet,4031,2,15,5,8,57,39,18,50
Melbourne C,4031,3,15,4,10,45,33,12,49
Melbourne V,4031,4,13,5,11,46,42,4,44
Adelaide Utd,4031,5,11,6,11,37,40,-3,39
Brisbane,4031,6,10,5,13,33,42,-9,35
Western Sydn,4031,7,8,9,10,38,47,-9,33
Perth Glory,4031,8,10,2,15,37,50,-13,32
Wellington P,4031,9,5,6,16,31,55,-24,21
CC Mariners,4031,10,4,8,15,28,49,-21,20
Sydney FC,4032,1,20,4,4,66,25,41,64
N'castle Jet,4032,2,16,5,7,63,39,24,53
Melbourne V,4032,3,14,5,10,48,40,8,47
Melbourne C,4032,4,14,4,11,45,39,6,46
Adelaide Utd,4032,5,11,6,11,37,40,-3,39
Brisbane,4032,6,10,5,13,33,42,-9,35
Western Sydn,4032,7,8,9,10,38,47,-9,33
Perth Glory,4032,8,10,2,15,37,50,-13,32
Wellington P,4032,9,5,6,16,31,55,-24,21
CC Mariners,4032,10,4,8,15,28,49,-21,20
Sydney FC,4033,1,20,4,4,66,25,41,64
N'castle Jet,4033,2,16,5,7,59,38,21,53
Melbourne V,4033,3,14,5,10,48,40,8,47
Melbourne C,4033,4,14,4,11,44,35,9,46
Adelaide Utd,4033,5,11,6,11,37,40,-3,39
Brisbane,4033,6,10,5,13,33,42,-9,35
Western Sydn,4033,7,8,9,10,38,47,-9,33
Perth Glory,4033,8,10,2,15,37,50,-13,32
Wellington P,4033,9,5,6,16,31,55,-24,21
CC Mariners,4033,10,4,8,15,28,49,-21,20
Sydney FC,4034,1,21,4,3,67,22,45,67
N'castle Jet,4034,2,15,5,8,57,38,19,50
Melbourne C,4034,3,15,4,10,44,33,11,49
Melbourne V,4034,4,13,5,11,45,41,4,44
Adelaide Utd,4034,5,11,6,11,37,40,-3,39
Brisbane,4034,6,10,5,13,33,42,-9,35
Western Sydn,4034,7,8,9,10,38,47,-9,33
Perth Glory,4034,8,10,2,15,37,50,-13,32
Wellington P,4034,9,5,6,16,31,55,-24,21
CC Mariners,4034,10,4,8,15,28,49,-21,20
Sydney FC,4035,1,20,4,4,64,23,41,64
N'castle Jet,4035,2,16,5,7,60,38,22,53
Melbourne V,4035,3,14,5,10,46,38,8,47
Melbourne C,4035,4,14,4,11,44,36,8,46
Adelaide Utd,4035,5,11,6,11,37,40,-3,39
Brisbane,4035,6,10,5,13,33,42,-9,35
Western Sydn,4035,7,8,9,10,38,47,-9,33
Perth Glory,4035,8,10,2,15,37,50,-13,32
Wellington P,4035,9,5,6,16,31,55,-24,21
CC Mariners,4035,10,4,8,15,28,49,-21,20
Sydney FC,4036,1,21,4,3,67,24,43,67
N'castle Jet,4036,2,16,5,7,58,37,21,53
Melbourne C,4036,3,14,4,11,43,34,9,46
Melbourne V,4036,4,13,5,11,47,41,6,44
Adelaide Utd,4036,5,11,6,11,37,40,-3,39
Brisbane,4036,6,10,5,13,33,42,-9,35
Western Sydn,4036,7,8,9,10,38,47,-9,33
Perth Glory,4036,8,10,2,15,37,50,-13,32
Wellington P,4036,9,5,6,16,31,55,-24,21
CC Mariners,4036,10,4,8,15,28,49,-21,20
Sydney FC,4037,1,21,4,3,66,23,43,67
N'castle Jet,4037,2,15,5,8,57,39,18,50
Melbourne C,4037,3,15,4,10,45,33,12,49
Melbourne V,4037,4,13,5,11,46,40,6,44
Adelaide Utd,4037,5,11,6,11,37,40,-3,39
Brisbane,4037,6,10,5,13,33,42,-9,35
Western Sydn,4037,7,8,9,10,38,47,-9,33
Perth Glory,4037,8,10,2,15,37,50,-13,32
Wellington P,4037,9,5,6,16,31,55,-24,21
CC Mariners,4037,10,4,8,15,28,49,-21,20
Sydney FC,4038,1,21,4,3,67,22,45,67
N'castle Jet,4038,2,15,6,7,60,40,20,51
Melbourne C,4038,3,14,5,10,46,36,10,47
Melbourne V,4038,4,13,5,11,45,41,4,44
Adelaide Utd,4038,5,11,6,11,37,40,-3,39
Brisbane,4038,6,10,5,13,33,42,-9,35
Western Sydn,4038,7,8,9,10,38,47,-9,33
Perth Glory,4038,8,10,2,15,37,50,-13,32
Wellington P,4038,9,5,6,16,31,55,-24,21
CC Mariners,4038,10,4,8,15,28,49,-21,20
Sydney FC,4039,1,20,4,4,64,23,41,64
N'castle Jet,4039,2,15,5,8,60,41,19,50
Melbourne C,4039,3,15,4,10,47,36,11,49
Melbourne V,4039,4,14,5,10,46,38,8,47
Adelaide Utd,4039,5,11,6,11,37,40,-3,39
Brisbane,4039,6,10,5,13,33,42,-9,35
Western Sydn,4039,7,8,9,10,38,47,-9,33
Perth Glory,4039,8,10,2,15,37,50,-13,32
Wellington P,4039,9,5,6,16,31,55,-24,21
CC Mariners,4039,10,4,8,15,28,49,-21,20
Sydney FC,4040,1,20,4,4,65,24,41,64
N'castle Jet,4040,2,16,5,7,60,38,22,53
Melbourne V,4040,3,14,5,10,47,39,8,47
Melbourne C,4040,4,14,4,11,44,36,8,46
Adelaide Utd,4040,5,11,6,11,37,40,-3,39
Brisbane,4040,6,10,5,13,33,42,-9,35
Western Sydn,4040,7,8,9,10,38,47,-9,33
Perth Glory,4040,8,10,2,15,37,50,-13,32
Wellington P,4040,9,5,6,16,31,55,-24,21
CC Mariners,4040,10,4,8,15,28,49,-21,20
Sydney FC,4041,1,20,4,4,65,25,40,64
N'castle Jet,4041,2,16,5,7,58,37,21,53
Melbourne V,4041,3,14,5,10,48,39,9,47
Melbourne C,4041,4,14,4,11,43,34,9,46
Adelaide Utd,4041,5,11,6,11,37,40,-3,39
Brisbane,4041,6,10,5,13,33,42,-9,35
Western Sydn,4041,7,8,9,10,38,47,-9,33
Perth Glory,4041,8,10,2,15,37,50,-13,32
Wellington P,4041,9,5,6,16,31,55,-24,21
CC Mariners,4041,10,4,8,15,28,49,-21,20
Sydney FC,4042,1,20,5,3,66,24,42,65
N'castle Jet,4042,2,16,5,7,60,38,22,53
Melbourne C,4042,3,14,4,11,44,36,8,46
Melbourne V,4042,4,13,6,10,47,40,7,45
Adelaide Utd,4042,5,11,6,11,37,40,-3,39
Brisbane,4042,6,10,5,13,33,42,-9,35
Western Sydn,4042,7,8,9,10,38,47,-9,33
Perth Glory,4042,8,10,2,15,37,50,-13,32
Wellington P,4042,9,5,6,16,31,55,-24,21
CC Mariners,4042,10,4,8,15,28,49,-21,20
Sydney FC,4043,1,21,4,3,66,22,44,67
N'castle Jet,4043,2,15,5,8,59,40,19,50
Melbourne C,4043,3,15,4,10,46,35,11,49
Melbourne V,4043,4,13,5,11,45,40,5,44
Adelaide Utd,4043,5,11,6,11,37,40,-3,39
Brisbane,4043,6,10,5,13,33,42,-9,35
Western Sydn,4043,7,8,9,10,38,47,-9,33
Perth Glory,4043,8,10,2,15,37,50,-13,32
Wellington P,4043,9,5,6,16,31,55,-24,21
CC Mariners,4043,10,4,8,15,28,49,-21,20
Sydney FC,4044,1,20,4,4,65,25,40,64
N'castle Jet,4044,2,16,5,7,64,37,27,53
Melbourne V,4044,3,14,5,10,48,39,9,47
Melbourne C,4044,4,14,4,11,43,40,3,46
Adelaide Utd,4044,5,11,6,11,37,40,-3,39
Brisbane,4044,6,10,5,13,33,42,-9,35
Western Sydn,4044,7,8,9,10,38,47,-9,33
Perth Glory,4044,8,10,2,15,37,50,-13,32
Wellington P,4044,9,5,6,16,31,55,-24,21
CC Mariners,4044,10,4,8,15,28,49,-21,20
Sydney FC,4045,1,21,4,3,67,23,44,67
N'castle Jet,4045,2,15,6,7,59,39,20,51
Melbourne C,4045,3,14,5,10,45,35,10,47
Melbourne V,4045,4,13,5,11,46,41,5,44
Adelaide Utd,4045,5,11,6,11,37,40,-3,39
Brisbane,4045,6,10,5,13,33,42,-9,35
Western Sydn,4045,7,8,9,10,38,47,-9,33
Perth Glory,4045,8,10,2,15,37,50,-13,32
Wellington P,4045,9,5,6,16,31,55,-24,21
CC Mariners,4045,10,4,8,15,28,49,-21,20
Sydney FC,4046,1,20,4,4,65,24,41,64
N'castle Jet,4046,2,16,5,7,60,37,23,53
Melbourne V,4046,3,14,5,10,47,39,8,47
Melbourne C,4046,4,14,4,11,43,36,7,46
Adelaide Utd,4046,5,11,6,11,37,40,-3,39
Brisbane,4046,6,10,5,13,33,42,-9,35
Western Sydn,4046,7,8,9,10,38,47,-9,33
Perth Glory,4046,8,10,2,15,37,50,-13,32
Wellington P,4046,9,5,6,16,31,55,-24,21
CC Mariners,4046,10,4,8,15,28,49,-21,20
Sydney FC,4047,1,20,5,3,65,23,42,65
N'castle Jet,4047,2,15,5,8,58,40,18,50
Melbourne C,4047,3,15,4,10,46,34,12,49
Melbourne V,4047,4,13,6,10,46,39,7,45
Adelaide Utd,4047,5,11,6,11,37,40,-3,39
Brisbane,4047,6,10,5,13,33,42,-9,35
Western Sydn,4047,7,8,9,10,38,47,-9,33
Perth Glory,4047,8,10,2,15,37,50,-13,32
Wellington P,4047,9,5,6,16,31,55,-24,21
CC Mariners,4047,10,4,8,15,28,49,-21,20
Sydney FC,4048,1,20,4,4,65,24,41,64
N'castle Jet,4048,2,15,5,8,59,40,19,50
Melbourne C,4048,3,15,4,10,46,35,11,49
Melbourne V,4048,4,14,5,10,47,39,8,47
Adelaide Utd,4048,5,11,6,11,37,40,-3,39
Brisbane,4048,6,10,5,13,33,42,-9,35
Western Sydn,4048,7,8,9,10,38,47,-9,33
Perth Glory,4048,8,10,2,15,37,50,-13,32
Wellington P,4048,9,5,6,16,31,55,-24,21
CC Mariners,4048,10,4,8,15,28,49,-21,20
Sydney FC,4049,1,20,5,3,64,22,42,65
N'castle Jet,4049,2,16,5,7,59,38,21,53
Melbourne C,4049,3,14,4,11,44,35,9,46
Melbourne V,4049,4,13,6,10,45,38,7,45
Adelaide Utd,4049,5,11,6,11,37,40,-3,39
Brisbane,4049,6,10,5,13,33,42,-9,35
Western Sydn,4049,7,8,9,10,38,47,-9,33
Perth Glory,4049,8,10,2,15,37,50,-13,32
Wellington P,4049,9,5,6,16,31,55,-24,21
CC Mariners,4049,10,4,8,15,28,49,-21,20
Sydney FC,4050,1,21,4,3,67,23,44,67
N'castle Jet,4050,2,16,5,7,60,39,21,53
Melbourne C,4050,3,14,4,11,45,36,9,46
Melbourne V,4050,4,13,5,11,46,41,5,44
Adelaide Utd,4050,5,11,6,11,37,40,-3,39
Brisbane,4050,6,10,5,13,33,42,-9,35
Western Sydn,4050,7,8,9,10,38,47,-9,33
Perth Glory,4050,8,10,2,15,37,50,-13,32
Wellington P,4050,9,5,6,16,31,55,-24,21
CC Mariners,4050,10,4,8,15,28,49,-21,20
Sydney FC,4051,1,21,4,3,68,23,45,67
N'castle Jet,4051,2,16,5,7,59,38,21,53
Melbourne C,4051,3,14,4,11,44,35,9,46
Melbourne V,4051,4,13,5,11,46,42,4,44
Adelaide Utd,4051,5,11,6,11,37,40,-3,39
Brisbane,4051,6,10,5,13,33,42,-9,35
Western Sydn,4051,7,8,9,10,38,47,-9,33
Perth Glory,4051,8,10,2,15,37,50,-13,32
Wellington P,4051,9,5,6,16,31,55,-24,21
CC Mariners,4051,10,4,8,15,28,49,-21,20
Sydney FC,4052,1,20,4,4,64,23,41,64
N'castle Jet,4052,2,16,5,7,60,38,22,53
Melbourne V,4052,3,14,5,10,46,38,8,47
Melbourne C,4052,4,14,4,11,44,36,8,46
Adelaide Utd,4052,5,11,6,11,37,40,-3,39
Brisbane,4052,6,10,5,13,33,42,-9,35
Western Sydn,4052,7,8,9,10,38,47,-9,33
Perth Glory,4052,8,10,2,15,37,50,-13,32
Wellington P,4052,9,5,6,16,31,55,-24,21
CC Mariners,4052,10,4,8,15,28,49,-21,20
Sydney FC,4053,1,20,5,3,66,24,42,65
N'castle Jet,4053,2,15,5,8,57,38,19,50
Melbourne C,4053,3,15,4,10,44,33,11,49
Melbourne V,4053,4,13,6,10,47,40,7,45
Adelaide Utd,4053,5,11,6,11,37,40,-3,39
Brisbane,4053,6,10,5,13,33,42,-9,35
Western Sydn,4053,7,8,9,10,38,47,-9,33
Perth Glory,4053,8,10,2,15,37,50,-13,32
Wellington P,4053,9,5,6,16,31,55,-24,21
CC Mariners,4053,10,4,8,15,28,49,-21,20
Sydney FC,4054,1,21,4,3,67,23,44,67
N'castle Jet,4054,2,16,5,7,58,37,21,53
Melbourne C,4054,3,14,4,11,43,34,9,46
Melbourne V,4054,4,13,5,11,46,41,5,44
Adelaide Utd,4054,5,11,6,11,37,40,-3,39
Brisbane,4054,6,10,5,13,33,42,-9,35
Western Sydn,4054,7,8,9,10,38,47,-9,33
Perth Glory,4054,8,10,2,15,37,50,-13,32
Wellington P,4054,9,5,6,16,31,55,-24,21
CC Mariners,4054,10,4,8,15,28,49,-21,20
Sydney FC,4055,1,20,4,4,65,24,41,64
N'castle Jet,4055,2,16,5,7,60,38,22,53
Melbourne V,4055,3,14,5,10,47,39,8,47
Melbourne C,4055,4,14,4,11,44,36,8,46
Adelaide Utd,4055,5,11,6,11,37,40,-3,39
Brisbane,4055,6,10,5,13,33,42,-9,35
Western Sydn,4055,7,8,9,10,38,47,-9,33
Perth Glory,4055,8,10,2,15,37,50,-13,32
Wellington P,4055,9,5,6,16,31,55,-24,21
CC Mariners,4055,10,4,8,15,28,49,-21,20
Sydney FC,4056,1,20,5,3,67,25,42,65
N'castle Jet,4056,2,16,5,7,59,38,21,53
Melbourne C,4056,3,14,4,11,44,35,9,46
Melbourne V,4056,4,13,6,10,48,41,7,45
Adelaide Utd,4056,5,11,6,11,37,40,-3,39
Brisbane,4056,6,10,5,13,33,42,-9,35
Western Sydn,4056,7,8,9,10,38,47,-9,33
Perth Glory,4056,8,10,2,15,37,50,-13,32
Wellington P,4056,9,5,6,16,31,55,-24,21
CC Mariners,4056,10,4,8,15,28,49,-21,20
Sydney FC,4057,1,21,4,3,68,23,45,67
N'castle Jet,4057,2,15,5,8,58,39,19,50
Melbourne C,4057,3,15,4,10,45,34,11,49
Melbourne V,4057,4,13,5,11,46,42,4,44
Adelaide Utd,4057,5,11,6,11,37,40,-3,39
Brisbane,4057,6,10,5,13,33,42,-9,35
Western Sydn,4057,7,8,9,10,38,47,-9,33
Perth Glory,4057,8,10,2,15,37,50,-13,32
Wellington P,4057,9,5,6,16,31,55,-24,21
CC Mariners,4057,10,4,8,15,28,49,-21,20
Sydney FC,4058,1,21,4,3,65,22,43,67
N'castle Jet,4058,2,15,6,7,59,39,20,51
Melbourne C,4058,3,14,5,10,45,35,10,47
Melbourne V,4058,4,13,5,11,45,39,6,44
Adelaide Utd,4058,5,11,6,11,37,40,-3,39
Brisbane,4058,6,10,5,13,33,42,-9,35
Western Sydn,4058,7,8,9,10,38,47,-9,33
Perth Glory,4058,8,10,2,15,37,50,-13,32
Wellington P,4058,9,5,6,16,31,55,-24,21
CC Mariners,4058,10,4,8,15,28,49,-21,20
Sydney FC,4059,1,20,4,4,64,23,41,64
N'castle Jet,4059,2,16,5,7,60,38,22,53
Melbourne V,4059,3,14,5,10,46,38,8,47
Melbourne C,4059,4,14,4,11,44,36,8,46
Adelaide Utd,4059,5,11,6,11,37,40,-3,39
Brisbane,4059,6,10,5,13,33,42,-9,35
Western Sydn,4059,7,8,9,10,38,47,-9,33
Perth Glory,4059,8,10,2,15,37,50,-13,32
Wellington P,4059,9,5,6,16,31,55,-24,21
CC Mariners,4059,10,4,8,15,28,49,-21,20
Sydney FC,4060,1,20,4,4,65,24,41,64
N'castle Jet,4060,2,16,5,7,62,39,23,53
Melbourne V,4060,3,14,5,10,47,39,8,47
Melbourne C,4060,4,14,4,11,45,38,7,46
Adelaide Utd,4060,5,11,6,11,37,40,-3,39
Brisbane,4060,6,10,5,13,33,42,-9,35
Western Sydn,4060,7,8,9,10,38,47,-9,33
Perth Glory,4060,8,10,2,15,37,50,-13,32
Wellington P,4060,9,5,6,16,31,55,-24,21
CC Mariners,4060,10,4,8,15,28,49,-21,20
Sydney FC,4061,1,20,5,3,65,23,42,65
N'castle Jet,4061,2,15,5,8,59,40,19,50
Melbourne C,4061,3,15,4,10,46,35,11,49
Melbourne V,4061,4,13,6,10,46,39,7,45
Adelaide Utd,4061,5,11,6,11,37,40,-3,39
Brisbane,4061,6,10,5,13,33,42,-9,35
Western Sydn,4061,7,8,9,10,38,47,-9,33
Perth Glory,4061,8,10,2,15,37,50,-13,32
Wellington P,4061,9,5,6,16,31,55,-24,21
CC Mariners,4061,10,4,8,15,28,49,-21,20
Sydney FC,4062,1,21,4,3,68,22,46,67
N'castle Jet,4062,2,15,6,7,57,37,20,51
Melbourne C,4062,3,14,5,10,43,33,10,47
Melbourne V,4062,4,13,5,11,45,42,3,44
Adelaide Utd,4062,5,11,6,11,37,40,-3,39
Brisbane,4062,6,10,5,13,33,42,-9,35
Western Sydn,4062,7,8,9,10,38,47,-9,33
Perth Glory,4062,8,10,2,15,37,50,-13,32
Wellington P,4062,9,5,6,16,31,55,-24,21
CC Mariners,4062,10,4,8,15,28,49,-21,20
Sydney FC,4063,1,21,4,3,66,22,44,67
N'castle Jet,4063,2,16,5,7,59,37,22,53
Melbourne C,4063,3,14,4,11,43,35,8,46
Melbourne V,4063,4,13,5,11,45,40,5,44
Adelaide Utd,4063,5,11,6,11,37,40,-3,39
Brisbane,4063,6,10,5,13,33,42,-9,35
Western Sydn,4063,7,8,9,10,38,47,-9,33
Perth Glory,4063,8,10,2,15,37,50,-13,32
Wellington P,4063,9,5,6,16,31,55,-24,21
CC Mariners,4063,10,4,8,15,28,49,-21,20
Sydney FC,4064,1,21,4,3,66,22,44,67
N'castle Jet,4064,2,16,5,7,59,38,21,53
Melbourne C,4064,3,14,4,11,44,35,9,46
Melbourne V,4064,4,13,5,11,45,40,5,44
Adelaide Utd,4064,5,11,6,11,37,40,-3,39
Brisbane,4064,6,10,5,13,33,42,-9,35
Western Sydn,4064,7,8,9,10,38,47,-9,33
Perth Glory,4064,8,10,2,15,37,50,-13,32
Wellington P,4064,9,5,6,16,31,55,-24,21
CC Mariners,4064,10,4,8,15,28,49,-21,20
Sydney FC,4065,1,21,4,3,67,22,45,67
N'castle Jet,4065,2,15,6,7,58,38,20,51
Melbourne C,4065,3,14,5,10,44,34,10,47
Melbourne V,4065,4,13,5,11,45,41,4,44
Adelaide Utd,4065,5,11,6,11,37,40,-3,39
Brisbane,4065,6,10,5,13,33,42,-9,35
Western Sydn,4065,7,8,9,10,38,47,-9,33
Perth Glory,4065,8,10,2,15,37,50,-13,32
Wellington P,4065,9,5,6,16,31,55,-24,21
CC Mariners,4065,10,4,8,15,28,49,-21,20
Sydney FC,4066,1,21,4,3,66,23,43,67
N'castle Jet,4066,2,15,6,7,60,40,20,51
Melbourne C,4066,3,14,5,10,46,36,10,47
Melbourne V,4066,4,13,5,11,46,40,6,44
Adelaide Utd,4066,5,11,6,11,37,40,-3,39
Brisbane,4066,6,10,5,13,33,42,-9,35
Western Sydn,4066,7,8,9,10,38,47,-9,33
Perth Glory,4066,8,10,2,15,37,50,-13,32
Wellington P,4066,9,5,6,16,31,55,-24,21
CC Mariners,4066,10,4,8,15,28,49,-21,20
Sydney FC,4067,1,20,4,4,65,24,41,64
N'castle Jet,4067,2,16,5,7,59,37,22,53
Melbourne V,4067,3,14,5,10,47,39,8,47
Melbourne C,4067,4,14,4,11,43,35,8,46
Adelaide Utd,4067,5,11,6,11,37,40,-3,39
Brisbane,4067,6,10,5,13,33,42,-9,35
Western Sydn,4067,7,8,9,10,38,47,-9,33
Perth Glory,4067,8,10,2,15,37,50,-13,32
Wellington P,4067,9,5,6,16,31,55,-24,21
CC Mariners,4067,10,4,8,15,28,49,-21,20
Sydney FC,4068,1,20,4,4,64,23,41,64
N'castle Jet,4068,2,16,5,7,60,38,22,53
Melbourne V,4068,3,14,5,10,46,38,8,47
Melbourne C,4068,4,14,4,11,44,36,8,46
Adelaide Utd,4068,5,11,6,11,37,40,-3,39
Brisbane,4068,6,10,5,13,33,42,-9,35
Western Sydn,4068,7,8,9,10,38,47,-9,33
Perth Glory,4068,8,10,2,15,37,50,-13,32
Wellington P,4068,9,5,6,16,31,55,-24,21
CC Mariners,4068,10,4,8,15,28,49,-21,20
Sydney FC,4069,1,20,5,3,66,24,42,65
N'castle Jet,4069,2,16,5,7,60,39,21,53
Melbourne C,4069,3,14,4,11,45,36,9,46
Melbourne V,4069,4,13,6,10,47,40,7,45
Adelaide Utd,4069,5,11,6,11,37,40,-3,39
Brisbane,4069,6,10,5,13,33,42,-9,35
Western Sydn,4069,7,8,9,10,38,47,-9,33
Perth Glory,4069,8,10,2,15,37,50,-13,32
Wellington P,4069,9,5,6,16,31,55,-24,21
CC Mariners,4069,10,4,8,15,28,49,-21,20
Sydney FC,4070,1,20,5,3,64,22,42,65
N'castle Jet,4070,2,15,5,8,57,38,19,50
Melbourne C,4070,3,15,4,10,44,33,11,49
Melbourne V,4070,4,13,6,10,45,38,7,45
Adelaide Utd,4070,5,11,6,11,37,40,-3,39
Brisbane,4070,6,10,5,13,33,42,-9,35
Western Sydn,4070,7,8,9,10,38,47,-9,33
Perth Glory,4070,8,10,2,15,37,50,-13,32
Wellington P,4070,9,5,6,16,31,55,-24,21
CC Mariners,4070,10,4,8,15,28,49,-21,20
Sydney FC,4071,1,21,4,3,65,22,43,67
N'castle Jet,4071,2,16,5,7,58,37,21,53
Melbourne C,4071,3,14,4,11,43,34,9,46
Melbourne V,4071,4,13,5,11,45,39,6,44
Adelaide Utd,4071,5,11,6,11,37,40,-3,39
Brisbane,4071,6,10,5,13,33,42,-9,35
Western Sydn,4071,7,8,9,10,38,47,-9,33
Perth Glory,4071,8,10,2,15,37,50,-13,32
Wellington P,4071,9,5,6,16,31,55,-24,21
CC Mariners,4071,10,4,8,15,28,49,-21,20
Sydney FC,4072,1,20,4,4,64,25,39,64
N'castle Jet,4072,2,16,5,7,61,38,23,53
Melbourne V,4072,3,14,5,10,48,38,10,47
Melbourne C,4072,4,14,4,11,44,37,7,46
Adelaide Utd,4072,5,11,6,11,37,40,-3,39
Brisbane,4072,6,10,5,13,33,42,-9,35
Western Sydn,4072,7,8,9,10,38,47,-9,33
Perth Glory,4072,8,10,2,15,37,50,-13,32
Wellington P,4072,9,5,6,16,31,55,-24,21
CC Mariners,4072,10,4,8,15,28,49,-21,20
Sydney FC,4073,1,21,4,3,67,22,45,67
N'castle Jet,4073,2,15,5,8,59,40,19,50
Melbourne C,4073,3,15,4,10,46,35,11,49
Melbourne V,4073,4,13,5,11,45,41,4,44
Adelaide Utd,4073,5,11,6,11,37,40,-3,39
Brisbane,4073,6,10,5,13,33,42,-9,35
Western Sydn,4073,7,8,9,10,38,47,-9,33
Perth Glory,4073,8,10,2,15,37,50,-13,32
Wellington P,4073,9,5,6,16,31,55,-24,21
CC Mariners,4073,10,4,8,15,28,49,-21,20
Sydney FC,4074,1,20,4,4,65,24,41,64
N'castle Jet,4074,2,15,6,7,58,38,20,51
Melbourne C,4074,3,14,5,10,44,34,10,47
Melbourne V,4074,4,14,5,10,47,39,8,47
Adelaide Utd,4074,5,11,6,11,37,40,-3,39
Brisbane,4074,6,10,5,13,33,42,-9,35
Western Sydn,4074,7,8,9,10,38,47,-9,33
Perth Glory,4074,8,10,2,15,37,50,-13,32
Wellington P,4074,9,5,6,16,31,55,-24,21
CC Mariners,4074,10,4,8,15,28,49,-21,20
Sydney FC,4075,1,20,5,3,64,22,42,65
N'castle Jet,4075,2,16,5,7,61,40,21,53
Melbourne C,4075,3,14,4,11,46,37,9,46
Melbourne V,4075,4,13,6,10,45,38,7,45
Adelaide Utd,4075,5,11,6,11,37,40,-3,39
Brisbane,4075,6,10,5,13,33,42,-9,35
Western Sydn,4075,7,8,9,10,38,47,-9,33
Perth Glory,4075,8,10,2,15,37,50,-13,32
Wellington P,4075,9,5,6,16,31,55,-24,21
CC Mariners,4075,10,4,8,15,28,49,-21,20
Sydney FC,4076,1,20,4,4,65,26,39,64
N'castle Jet,4076,2,16,5,7,60,38,22,53
Melbourne V,4076,3,14,5,10,49,39,10,47
Melbourne C,4076,4,14,4,11,44,36,8,46
Adelaide Utd,4076,5,11,6,11,37,40,-3,39
Brisbane,4076,6,10,5,13,33,42,-9,35
Western Sydn,4076,7,8,9,10,38,47,-9,33
Perth Glory,4076,8,10,2,15,37,50,-13,32
Wellington P,4076,9,5,6,16,31,55,-24,21
CC Mariners,4076,10,4,8,15,28,49,-21,20
Sydney FC,4077,1,21,4,3,69,24,45,67
N'castle Jet,4077,2,15,5,8,58,39,19,50
Melbourne C,4077,3,15,4,10,45,34,11,49
Melbourne V,4077,4,13,5,11,47,43,4,44
Adelaide Utd,4077,5,11,6,11,37,40,-3,39
Brisbane,4077,6,10,5,13,33,42,-9,35
Western Sydn,4077,7,8,9,10,38,47,-9,33
Perth Glory,4077,8,10,2,15,37,50,-13,32
Wellington P,4077,9,5,6,16,31,55,-24,21
CC Mariners,4077,10,4,8,15,28,49,-21,20
Sydney FC,4078,1,20,5,3,67,25,42,65
N'castle Jet,4078,2,16,5,7,60,38,22,53
Melbourne C,4078,3,14,4,11,44,36,8,46
Melbourne V,4078,4,13,6,10,48,41,7,45
Adelaide Utd,4078,5,11,6,11,37,40,-3,39
Brisbane,4078,6,10,5,13,33,42,-9,35
Western Sydn,4078,7,8,9,10,38,47,-9,33
Perth Glory,4078,8,10,2,15,37,50,-13,32
Wellington P,4078,9,5,6,16,31,55,-24,21
CC Mariners,4078,10,4,8,15,28,49,-21,20
Sydney FC,4079,1,20,4,4,67,28,39,64
N'castle Jet,4079,2,15,6,7,60,40,20,51
Melbourne V,4079,3,14,5,10,51,41,10,47
Melbourne C,4079,4,14,5,10,46,36,10,47
Adelaide Utd,4079,5,11,6,11,37,40,-3,39
Brisbane,4079,6,10,5,13,33,42,-9,35
Western Sydn,4079,7,8,9,10,38,47,-9,33
Perth Glory,4079,8,10,2,15,37,50,-13,32
Wellington P,4079,9,5,6,16,31,55,-24,21
CC Mariners,4079,10,4,8,15,28,49,-21,20
Sydney FC,4080,1,20,5,3,64,22,42,65
N'castle Jet,4080,2,15,6,7,59,39,20,51
Melbourne C,4080,3,14,5,10,45,35,10,47
Melbourne V,4080,4,13,6,10,45,38,7,45
Adelaide Utd,4080,5,11,6,11,37,40,-3,39
Brisbane,4080,6,10,5,13,33,42,-9,35
Western Sydn,4080,7,8,9,10,38,47,-9,33
Perth Glory,4080,8,10,2,15,37,50,-13,32
Wellington P,4080,9,5,6,16,31,55,-24,21
CC Mariners,4080,10,4,8,15,28,49,-21,20
Sydney FC,4081,1,21,4,3,66,22,44,67
N'castle Jet,4081,2,16,5,7,60,37,23,53
Melbourne C,4081,3,14,4,11,43,36,7,46
Melbourne V,4081,4,13,5,11,45,40,5,44
Adelaide Utd,4081,5,11,6,11,37,40,-3,39
Brisbane,4081,6,10,5,13,33,42,-9,35
Western Sydn,4081,7,8,9,10,38,47,-9,33
Perth Glory,4081,8,10,2,15,37,50,-13,32
Wellington P,4081,9,5,6,16,31,55,-24,21
CC Mariners,4081,10,4,8,15,28,49,-21,20
Sydney FC,4082,1,21,4,3,67,22,45,67
N'castle Jet,4082,2,16,5,7,58,37,21,53
Melbourne C,4082,3,14,4,11,43,34,9,46
Melbourne V,4082,4,13,5,11,45,41,4,44
Adelaide Utd,4082,5,11,6,11,37,40,-3,39
Brisbane,4082,6,10,5,13,33,42,-9,35
Western Sydn,4082,7,8,9,10,38,47,-9,33
Perth Glory,4082,8,10,2,15,37,50,-13,32
Wellington P,4082,9,5,6,16,31,55,-24,21
CC Mariners,4082,10,4,8,15,28,49,-21,20
Sydney FC,4083,1,21,4,3,69,22,47,67
N'castle Jet,4083,2,16,5,7,58,37,21,53
Melbourne C,4083,3,14,4,11,43,34,9,46
Melbourne V,4083,4,13,5,11,45,43,2,44
Adelaide Utd,4083,5,11,6,11,37,40,-3,39
Brisbane,4083,6,10,5,13,33,42,-9,35
Western Sydn,4083,7,8,9,10,38,47,-9,33
Perth Glory,4083,8,10,2,15,37,50,-13,32
Wellington P,4083,9,5,6,16,31,55,-24,21
CC Mariners,4083,10,4,8,15,28,49,-21,20
Sydney FC,4084,1,21,4,3,67,22,45,67
N'castle Jet,4084,2,16,5,7,58,37,21,53
Melbourne C,4084,3,14,4,11,43,34,9,46
Melbourne V,4084,4,13,5,11,45,41,4,44
Adelaide Utd,4084,5,11,6,11,37,40,-3,39
Brisbane,4084,6,10,5,13,33,42,-9,35
Western Sydn,4084,7,8,9,10,38,47,-9,33
Perth Glory,4084,8,10,2,15,37,50,-13,32
Wellington P,4084,9,5,6,16,31,55,-24,21
CC Mariners,4084,10,4,8,15,28,49,-21,20
Sydney FC,4085,1,20,4,4,65,24,41,64
N'castle Jet,4085,2,16,5,7,60,39,21,53
Melbourne V,4085,3,14,5,10,47,39,8,47
Melbourne C,4085,4,14,4,11,45,36,9,46
Adelaide Utd,4085,5,11,6,11,37,40,-3,39
Brisbane,4085,6,10,5,13,33,42,-9,35
Western Sydn,4085,7,8,9,10,38,47,-9,33
Perth Glory,4085,8,10,2,15,37,50,-13,32
Wellington P,4085,9,5,6,16,31,55,-24,21
CC Mariners,4085,10,4,8,15,28,49,-21,20
Sydney FC,4086,1,21,4,3,67,24,43,67
N'castle Jet,4086,2,15,5,8,58,40,18,50
Melbourne C,4086,3,15,4,10,46,34,12,49
Melbourne V,4086,4,13,5,11,47,41,6,44
Adelaide Utd,4086,5,11,6,11,37,40,-3,39
Brisbane,4086,6,10,5,13,33,42,-9,35
Western Sydn,4086,7,8,9,10,38,47,-9,33
Perth Glory,4086,8,10,2,15,37,50,-13,32
Wellington P,4086,9,5,6,16,31,55,-24,21
CC Mariners,4086,10,4,8,15,28,49,-21,20
Sydney FC,4087,1,21,4,3,66,22,44,67
N'castle Jet,4087,2,16,5,7,58,37,21,53
Melbourne C,4087,3,14,4,11,43,34,9,46
Melbourne V,4087,4,13,5,11,45,40,5,44
Adelaide Utd,4087,5,11,6,11,37,40,-3,39
Brisbane,4087,6,10,5,13,33,42,-9,35
Western Sydn,4087,7,8,9,10,38,47,-9,33
Perth Glory,4087,8,10,2,15,37,50,-13,32
Wellington P,4087,9,5,6,16,31,55,-24,21
CC Mariners,4087,10,4,8,15,28,49,-21,20
Sydney FC,4088,1,21,4,3,67,24,43,67
N'castle Jet,4088,2,15,6,7,58,38,20,51
Melbourne C,4088,3,14,5,10,44,34,10,47
Melbourne V,4088,4,13,5,11,47,41,6,44
Adelaide Utd,4088,5,11,6,11,37,40,-3,39
Brisbane,4088,6,10,5,13,33,42,-9,35
Western Sydn,4088,7,8,9,10,38,47,-9,33
Perth Glory,4088,8,10,2,15,37,50,-13,32
Wellington P,4088,9,5,6,16,31,55,-24,21
CC Mariners,4088,10,4,8,15,28,49,-21,20
Sydney FC,4089,1,21,4,3,66,23,43,67
N'castle Jet,4089,2,15,6,7,58,38,20,51
Melbourne C,4089,3,14,5,10,44,34,10,47
Melbourne V,4089,4,13,5,11,46,40,6,44
Adelaide Utd,4089,5,11,6,11,37,40,-3,39
Brisbane,4089,6,10,5,13,33,42,-9,35
Western Sydn,4089,7,8,9,10,38,47,-9,33
Perth Glory,4089,8,10,2,15,37,50,-13,32
Wellington P,4089,9,5,6,16,31,55,-24,21
CC Mariners,4089,10,4,8,15,28,49,-21,20
Sydney FC,4090,1,20,5,3,65,23,42,65
N'castle Jet,4090,2,15,5,8,59,40,19,50
Melbourne C,4090,3,15,4,10,46,35,11,49
Melbourne V,4090,4,13,6,10,46,39,7,45
Adelaide Utd,4090,5,11,6,11,37,40,-3,39
Brisbane,4090,6,10,5,13,33,42,-9,35
Western Sydn,4090,7,8,9,10,38,47,-9,33
Perth Glory,4090,8,10,2,15,37,50,-13,32
Wellington P,4090,9,5,6,16,31,55,-24,21
CC Mariners,4090,10,4,8,15,28,49,-21,20
Sydney FC,4091,1,20,4,4,65,24,41,64
N'castle Jet,4091,2,16,5,7,60,38,22,53
Melbourne V,4091,3,14,5,10,47,39,8,47
Melbourne C,4091,4,14,4,11,44,36,8,46
Adelaide Utd,4091,5,11,6,11,37,40,-3,39
Brisbane,4091,6,10,5,13,33,42,-9,35
Western Sydn,4091,7,8,9,10,38,47,-9,33
Perth Glory,4091,8,10,2,15,37,50,-13,32
Wellington P,4091,9,5,6,16,31,55,-24,21
CC Mariners,4091,10,4,8,15,28,49,-21,20
Sydney FC,4092,1,20,4,4,64,23,41,64
N'castle Jet,4092,2,16,5,7,59,38,21,53
Melbourne V,4092,3,14,5,10,46,38,8,47
Melbourne C,4092,4,14,4,11,44,35,9,46
Adelaide Utd,4092,5,11,6,11,37,40,-3,39
Brisbane,4092,6,10,5,13,33,42,-9,35
Western Sydn,4092,7,8,9,10,38,47,-9,33
Perth Glory,4092,8,10,2,15,37,50,-13,32
Wellington P,4092,9,5,6,16,31,55,-24,21
CC Mariners,4092,10,4,8,15,28,49,-21,20
Sydney FC,4093,1,21,4,3,69,23,46,67
N'castle Jet,4093,2,15,5,8,58,39,19,50
Melbourne C,4093,3,15,4,10,45,34,11,49
Melbourne V,4093,4,13,5,11,46,43,3,44
Adelaide Utd,4093,5,11,6,11,37,40,-3,39
Brisbane,4093,6,10,5,13,33,42,-9,35
Western Sydn,4093,7,8,9,10,38,47,-9,33
Perth Glory,4093,8,10,2,15,37,50,-13,32
Wellington P,4093,9,5,6,16,31,55,-24,21
CC Mariners,4093,10,4,8,15,28,49,-21,20
Sydney FC,4094,1,21,4,3,69,24,45,67
N'castle Jet,4094,2,15,5,8,58,40,18,50
Melbourne C,4094,3,15,4,10,46,34,12,49
Melbourne V,4094,4,13,5,11,47,43,4,44
Adelaide Utd,4094,5,11,6,11,37,40,-3,39
Brisbane,4094,6,10,5,13,33,42,-9,35
Western Sydn,4094,7,8,9,10,38,47,-9,33
Perth Glory,4094,8,10,2,15,37,50,-13,32
Wellington P,4094,9,5,6,16,31,55,-24,21
CC Mariners,4094,10,4,8,15,28,49,-21,20
Sydney FC,4095,1,20,4,4,64,24,40,64
N'castle Jet,4095,2,15,5,8,58,40,18,50
Melbourne C,4095,3,15,4,10,46,34,12,49
Melbourne V,4095,4,14,5,10,47,38,9,47
Adelaide Utd,4095,5,11,6,11,37,40,-3,39
Brisbane,4095,6,10,5,13,33,42,-9,35
Western Sydn,4095,7,8,9,10,38,47,-9,33
Perth Glory,4095,8,10,2,15,37,50,-13,32
Wellington P,4095,9,5,6,16,31,55,-24,21
CC Mariners,4095,10,4,8,15,28,49,-21,20
Sydney FC,4096,1,20,5,3,65,23,42,65
N'castle Jet,4096,2,16,5,7,61,38,23,53
Melbourne C,4096,3,14,4,11,44,37,7,46
Melbourne V,4096,4,13,6,10,46,39,7,45
Adelaide Utd,4096,5,11,6,11,37,40,-3,39
Brisbane,4096,6,10,5,13,33,42,-9,35
Western Sydn,4096,7,8,9,10,38,47,-9,33
Perth Glory,4096,8,10,2,15,37,50,-13,32
Wellington P,4096,9,5,6,16,31,55,-24,21
CC Mariners,4096,10,4,8,15,28,49,-21,20
Sydney FC,4097,1,20,4,4,66,25,41,64
N'castle Jet,4097,2,16,5,7,61,37,24,53
Melbourne V,4097,3,14,5,10,48,40,8,47
Melbourne C,4097,4,14,4,11,43,37,6,46
Adelaide Utd,4097,5,11,6,11,37,40,-3,39
Brisbane,4097,6,10,5,13,33,42,-9,35
Western Sydn,4097,7,8,9,10,38,47,-9,33
Perth Glory,4097,8,10,2,15,37,50,-13,32
Wellington P,4097,9,5,6,16,31,55,-24,21
CC Mariners,4097,10,4,8,15,28,49,-21,20
Sydney FC,4098,1,21,4,3,65,22,43,67
N'castle Jet,4098,2,16,5,7,62,39,23,53
Melbourne C,4098,3,14,4,11,45,38,7,46
Melbourne V,4098,4,13,5,11,45,39,6,44
Adelaide Utd,4098,5,11,6,11,37,40,-3,39
Brisbane,4098,6,10,5,13,33,42,-9,35
Western Sydn,4098,7,8,9,10,38,47,-9,33
Perth Glory,4098,8,10,2,15,37,50,-13,32
Wellington P,4098,9,5,6,16,31,55,-24,21
CC Mariners,4098,10,4,8,15,28,49,-21,20
Sydney FC,4099,1,20,5,3,64,22,42,65
N'castle Jet,4099,2,16,5,7,62,38,24,53
Melbourne C,4099,3,14,4,11,44,38,6,46
Melbourne V,4099,4,13,6,10,45,38,7,45
Adelaide Utd,4099,5,11,6,11,37,40,-3,39
Brisbane,4099,6,10,5,13,33,42,-9,35
Western Sydn,4099,7,8,9,10,38,47,-9,33
Perth Glory,4099,8,10,2,15,37,50,-13,32
Wellington P,4099,9,5,6,16,31,55,-24,21
CC Mariners,4099,10,4,8,15,28,49,-21,20
Sydney FC,4100,1,20,4,4,64,23,41,64
N'castle Jet,4100,2,15,5,8,57,38,19,50
Melbourne C,4100,3,15,4,10,44,33,11,49
Melbourne V,4100,4,14,5,10,46,38,8,47
Adelaide Utd,4100,5,11,6,11,37,40,-3,39
Brisbane,4100,6,10,5,13,33,42,-9,35
Western Sydn,4100,7,8,9,10,38,47,-9,33
Perth Glory,4100,8,10,2,15,37,50,-13,32
Wellington P,4100,9,5,6,16,31,55,-24,21
CC Mariners,4100,10,4,8,15,28,49,-21,20
Sydney FC,4101,1,21,4,3,69,22,47,67
N'castle Jet,4101,2,16,5,7,59,37,22,53
Melbourne C,4101,3,14,4,11,43,35,8,46
Melbourne V,4101,4,13,5,11,45,43,2,44
Adelaide Utd,4101,5,11,6,11,37,40,-3,39
Brisbane,4101,6,10,5,13,33,42,-9,35
Western Sydn,4101,7,8,9,10,38,47,-9,33
Perth Glory,4101,8,10,2,15,37,50,-13,32
Wellington P,4101,9,5,6,16,31,55,-24,21
CC Mariners,4101,10,4,8,15,28,49,-21,20
Sydney FC,4102,1,20,5,3,66,24,42,65
N'castle Jet,4102,2,16,5,7,60,39,21,53
Melbourne C,4102,3,14,4,11,45,36,9,46
Melbourne V,4102,4,13,6,10,47,40,7,45
Adelaide Utd,4102,5,11,6,11,37,40,-3,39
Brisbane,4102,6,10,5,13,33,42,-9,35
Western Sydn,4102,7,8,9,10,38,47,-9,33
Perth Glory,4102,8,10,2,15,37,50,-13,32
Wellington P,4102,9,5,6,16,31,55,-24,21
CC Mariners,4102,10,4,8,15,28,49,-21,20
Sydney FC,4103,1,20,5,3,65,23,42,65
N'castle Jet,4103,2,16,5,7,60,38,22,53
Melbourne C,4103,3,14,4,11,44,36,8,46
Melbourne V,4103,4,13,6,10,46,39,7,45
Adelaide Utd,4103,5,11,6,11,37,40,-3,39
Brisbane,4103,6,10,5,13,33,42,-9,35
Western Sydn,4103,7,8,9,10,38,47,-9,33
Perth Glory,4103,8,10,2,15,37,50,-13,32
Wellington P,4103,9,5,6,16,31,55,-24,21
CC Mariners,4103,10,4,8,15,28,49,-21,20
Sydney FC,4104,1,21,4,3,67,22,45,67
N'castle Jet,4104,2,15,5,8,58,39,19,50
Melbourne C,4104,3,15,4,10,45,34,11,49
Melbourne V,4104,4,13,5,11,45,41,4,44
Adelaide Utd,4104,5,11,6,11,37,40,-3,39
Brisbane,4104,6,10,5,13,33,42,-9,35
Western Sydn,4104,7,8,9,10,38,47,-9,33
Perth Glory,4104,8,10,2,15,37,50,-13,32
Wellington P,4104,9,5,6,16,31,55,-24,21
CC Mariners,4104,10,4,8,15,28,49,-21,20
Sydney FC,4105,1,21,4,3,66,22,44,67
N'castle Jet,4105,2,16,5,7,60,39,21,53
Melbourne C,4105,3,14,4,11,45,36,9,46
Melbourne V,4105,4,13,5,11,45,40,5,44
Adelaide Utd,4105,5,11,6,11,37,40,-3,39
Brisbane,4105,6,10,5,13,33,42,-9,35
Western Sydn,4105,7,8,9,10,38,47,-9,33
Perth Glory,4105,8,10,2,15,37,50,-13,32
Wellington P,4105,9,5,6,16,31,55,-24,21
CC Mariners,4105,10,4,8,15,28,49,-21,20
Sydney FC,4106,1,21,4,3,66,23,43,67
N'castle Jet,4106,2,15,5,8,57,38,19,50
Melbourne C,4106,3,15,4,10,44,33,11,49
Melbourne V,4106,4,13,5,11,46,40,6,44
Adelaide Utd,4106,5,11,6,11,37,40,-3,39
Brisbane,4106,6,10,5,13,33,42,-9,35
Western Sydn,4106,7,8,9,10,38,47,-9,33
Perth Glory,4106,8,10,2,15,37,50,-13,32
Wellington P,4106,9,5,6,16,31,55,-24,21
CC Mariners,4106,10,4,8,15,28,49,-21,20
Sydney FC,4107,1,20,4,4,65,25,40,64
N'castle Jet,4107,2,16,5,7,58,37,21,53
Melbourne V,4107,3,14,5,10,48,39,9,47
Melbourne C,4107,4,14,4,11,43,34,9,46
Adelaide Utd,4107,5,11,6,11,37,40,-3,39
Brisbane,4107,6,10,5,13,33,42,-9,35
Western Sydn,4107,7,8,9,10,38,47,-9,33
Perth Glory,4107,8,10,2,15,37,50,-13,32
Wellington P,4107,9,5,6,16,31,55,-24,21
CC Mariners,4107,10,4,8,15,28,49,-21,20
Sydney FC,4108,1,21,4,3,69,23,46,67
N'castle Jet,4108,2,15,5,8,57,38,19,50
Melbourne C,4108,3,15,4,10,44,33,11,49
Melbourne V,4108,4,13,5,11,46,43,3,44
Adelaide Utd,4108,5,11,6,11,37,40,-3,39
Brisbane,4108,6,10,5,13,33,42,-9,35
Western Sydn,4108,7,8,9,10,38,47,-9,33
Perth Glory,4108,8,10,2,15,37,50,-13,32
Wellington P,4108,9,5,6,16,31,55,-24,21
CC Mariners,4108,10,4,8,15,28,49,-21,20
Sydney FC,4109,1,21,4,3,70,23,47,67
N'castle Jet,4109,2,15,5,8,59,40,19,50
Melbourne C,4109,3,15,4,10,46,35,11,49
Melbourne V,4109,4,13,5,11,46,44,2,44
Adelaide Utd,4109,5,11,6,11,37,40,-3,39
Brisbane,4109,6,10,5,13,33,42,-9,35
Western Sydn,4109,7,8,9,10,38,47,-9,33
Perth Glory,4109,8,10,2,15,37,50,-13,32
Wellington P,4109,9,5,6,16,31,55,-24,21
CC Mariners,4109,10,4,8,15,28,49,-21,20
Sydney FC,4110,1,21,4,3,67,23,44,67
N'castle Jet,4110,2,16,5,7,59,37,22,53
Melbourne C,4110,3,14,4,11,43,35,8,46
Melbourne V,4110,4,13,5,11,46,41,5,44
Adelaide Utd,4110,5,11,6,11,37,40,-3,39
Brisbane,4110,6,10,5,13,33,42,-9,35
Western Sydn,4110,7,8,9,10,38,47,-9,33
Perth Glory,4110,8,10,2,15,37,50,-13,32
Wellington P,4110,9,5,6,16,31,55,-24,21
CC Mariners,4110,10,4,8,15,28,49,-21,20
Sydney FC,4111,1,21,4,3,65,22,43,67
N'castle Jet,4111,2,15,6,7,58,38,20,51
Melbourne C,4111,3,14,5,10,44,34,10,47
Melbourne V,4111,4,13,5,11,45,39,6,44
Adelaide Utd,4111,5,11,6,11,37,40,-3,39
Brisbane,4111,6,10,5,13,33,42,-9,35
Western Sydn,4111,7,8,9,10,38,47,-9,33
Perth Glory,4111,8,10,2,15,37,50,-13,32
Wellington P,4111,9,5,6,16,31,55,-24,21
CC Mariners,4111,10,4,8,15,28,49,-21,20
Sydney FC,4112,1,21,4,3,65,22,43,67
N'castle Jet,4112,2,15,5,8,58,40,18,50
Melbourne C,4112,3,15,4,10,46,34,12,49
Melbourne V,4112,4,13,5,11,45,39,6,44
Adelaide Utd,4112,5,11,6,11,37,40,-3,39
Brisbane,4112,6,10,5,13,33,42,-9,35
Western Sydn,4112,7,8,9,10,38,47,-9,33
Perth Glory,4112,8,10,2,15,37,50,-13,32
Wellington P,4112,9,5,6,16,31,55,-24,21
CC Mariners,4112,10,4,8,15,28,49,-21,20
Sydney FC,4113,1,21,4,3,70,25,45,67
N'castle Jet,4113,2,15,6,7,57,37,20,51
Melbourne C,4113,3,14,5,10,43,33,10,47
Melbourne V,4113,4,13,5,11,48,44,4,44
Adelaide Utd,4113,5,11,6,11,37,40,-3,39
Brisbane,4113,6,10,5,13,33,42,-9,35
Western Sydn,4113,7,8,9,10,38,47,-9,33
Perth Glory,4113,8,10,2,15,37,50,-13,32
Wellington P,4113,9,5,6,16,31,55,-24,21
CC Mariners,4113,10,4,8,15,28,49,-21,20
Sydney FC,4114,1,21,4,3,66,22,44,67
N'castle Jet,4114,2,15,6,7,59,39,20,51
Melbourne C,4114,3,14,5,10,45,35,10,47
Melbourne V,4114,4,13,5,11,45,40,5,44
Adelaide Utd,4114,5,11,6,11,37,40,-3,39
Brisbane,4114,6,10,5,13,33,42,-9,35
Western Sydn,4114,7,8,9,10,38,47,-9,33
Perth Glory,4114,8,10,2,15,37,50,-13,32
Wellington P,4114,9,5,6,16,31,55,-24,21
CC Mariners,4114,10,4,8,15,28,49,-21,20
Sydney FC,4115,1,20,5,3,66,24,42,65
N'castle Jet,4115,2,15,5,8,58,39,19,50
Melbourne C,4115,3,15,4,10,45,34,11,49
Melbourne V,4115,4,13,6,10,47,40,7,45
Adelaide Utd,4115,5,11,6,11,37,40,-3,39
Brisbane,4115,6,10,5,13,33,42,-9,35
Western Sydn,4115,7,8,9,10,38,47,-9,33
Perth Glory,4115,8,10,2,15,37,50,-13,32
Wellington P,4115,9,5,6,16,31,55,-24,21
CC Mariners,4115,10,4,8,15,28,49,-21,20
Sydney FC,4116,1,20,5,3,67,25,42,65
N'castle Jet,4116,2,15,6,7,60,40,20,51
Melbourne C,4116,3,14,5,10,46,36,10,47
Melbourne V,4116,4,13,6,10,48,41,7,45
Adelaide Utd,4116,5,11,6,11,37,40,-3,39
Brisbane,4116,6,10,5,13,33,42,-9,35
Western Sydn,4116,7,8,9,10,38,47,-9,33
Perth Glory,4116,8,10,2,15,37,50,-13,32
Wellington P,4116,9,5,6,16,31,55,-24,21
CC Mariners,4116,10,4,8,15,28,49,-21,20
Sydney FC,4117,1,21,4,3,67,22,45,67
N'castle Jet,4117,2,15,5,8,57,38,19,50
Melbourne C,4117,3,15,4,10,44,33,11,49
Melbourne V,4117,4,13,5,11,45,41,4,44
Adelaide Utd,4117,5,11,6,11,37,40,-3,39
Brisbane,4117,6,10,5,13,33,42,-9,35
Western Sydn,4117,7,8,9,10,38,47,-9,33
Perth Glory,4117,8,10,2,15,37,50,-13,32
Wellington P,4117,9,5,6,16,31,55,-24,21
CC Mariners,4117,10,4,8,15,28,49,-21,20
Sydney FC,4118,1,20,5,3,65,23,42,65
N'castle Jet,4118,2,15,6,7,58,38,20,51
Melbourne C,4118,3,14,5,10,44,34,10,47
Melbourne V,4118,4,13,6,10,46,39,7,45
Adelaide Utd,4118,5,11,6,11,37,40,-3,39
Brisbane,4118,6,10,5,13,33,42,-9,35
Western Sydn,4118,7,8,9,10,38,47,-9,33
Perth Glory,4118,8,10,2,15,37,50,-13,32
Wellington P,4118,9,5,6,16,31,55,-24,21
CC Mariners,4118,10,4,8,15,28,49,-21,20
Sydney FC,4119,1,20,5,3,67,25,42,65
N'castle Jet,4119,2,16,5,7,59,38,21,53
Melbourne C,4119,3,14,4,11,44,35,9,46
Melbourne V,4119,4,13,6,10,48,41,7,45
Adelaide Utd,4119,5,11,6,11,37,40,-3,39
Brisbane,4119,6,10,5,13,33,42,-9,35
Western Sydn,4119,7,8,9,10,38,47,-9,33
Perth Glory,4119,8,10,2,15,37,50,-13,32
Wellington P,4119,9,5,6,16,31,55,-24,21
CC Mariners,4119,10,4,8,15,28,49,-21,20
Sydney FC,4120,1,21,4,3,65,22,43,67
N'castle Jet,4120,2,15,6,7,57,37,20,51
Melbourne C,4120,3,14,5,10,43,33,10,47
Melbourne V,4120,4,13,5,11,45,39,6,44
Adelaide Utd,4120,5,11,6,11,37,40,-3,39
Brisbane,4120,6,10,5,13,33,42,-9,35
Western Sydn,4120,7,8,9,10,38,47,-9,33
Perth Glory,4120,8,10,2,15,37,50,-13,32
Wellington P,4120,9,5,6,16,31,55,-24,21
CC Mariners,4120,10,4,8,15,28,49,-21,20
Sydney FC,4121,1,21,4,3,66,23,43,67
N'castle Jet,4121,2,16,5,7,60,37,23,53
Melbourne C,4121,3,14,4,11,43,36,7,46
Melbourne V,4121,4,13,5,11,46,40,6,44
Adelaide Utd,4121,5,11,6,11,37,40,-3,39
Brisbane,4121,6,10,5,13,33,42,-9,35
Western Sydn,4121,7,8,9,10,38,47,-9,33
Perth Glory,4121,8,10,2,15,37,50,-13,32
Wellington P,4121,9,5,6,16,31,55,-24,21
CC Mariners,4121,10,4,8,15,28,49,-21,20
Sydney FC,4122,1,21,4,3,69,23,46,67
N'castle Jet,4122,2,15,6,7,58,38,20,51
Melbourne C,4122,3,14,5,10,44,34,10,47
Melbourne V,4122,4,13,5,11,46,43,3,44
Adelaide Utd,4122,5,11,6,11,37,40,-3,39
Brisbane,4122,6,10,5,13,33,42,-9,35
Western Sydn,4122,7,8,9,10,38,47,-9,33
Perth Glory,4122,8,10,2,15,37,50,-13,32
Wellington P,4122,9,5,6,16,31,55,-24,21
CC Mariners,4122,10,4,8,15,28,49,-21,20
Sydney FC,4123,1,20,4,4,64,26,38,64
N'castle Jet,4123,2,15,6,7,57,37,20,51
Melbourne V,4123,3,14,5,10,49,38,11,47
Melbourne C,4123,4,14,5,10,43,33,10,47
Adelaide Utd,4123,5,11,6,11,37,40,-3,39
Brisbane,4123,6,10,5,13,33,42,-9,35
Western Sydn,4123,7,8,9,10,38,47,-9,33
Perth Glory,4123,8,10,2,15,37,50,-13,32
Wellington P,4123,9,5,6,16,31,55,-24,21
CC Mariners,4123,10,4,8,15,28,49,-21,20
Sydney FC,4124,1,20,5,3,67,25,42,65
N'castle Jet,4124,2,15,6,7,59,39,20,51
Melbourne C,4124,3,14,5,10,45,35,10,47
Melbourne V,4124,4,13,6,10,48,41,7,45
Adelaide Utd,4124,5,11,6,11,37,40,-3,39
Brisbane,4124,6,10,5,13,33,42,-9,35
Western Sydn,4124,7,8,9,10,38,47,-9,33
Perth Glory,4124,8,10,2,15,37,50,-13,32
Wellington P,4124,9,5,6,16,31,55,-24,21
CC Mariners,4124,10,4,8,15,28,49,-21,20
Sydney FC,4125,1,21,4,3,67,23,44,67
N'castle Jet,4125,2,16,5,7,61,37,24,53
Melbourne C,4125,3,14,4,11,43,37,6,46
Melbourne V,4125,4,13,5,11,46,41,5,44
Adelaide Utd,4125,5,11,6,11,37,40,-3,39
Brisbane,4125,6,10,5,13,33,42,-9,35
Western Sydn,4125,7,8,9,10,38,47,-9,33
Perth Glory,4125,8,10,2,15,37,50,-13,32
Wellington P,4125,9,5,6,16,31,55,-24,21
CC Mariners,4125,10,4,8,15,28,49,-21,20
Sydney FC,4126,1,21,4,3,66,23,43,67
N'castle Jet,4126,2,16,5,7,60,39,21,53
Melbourne C,4126,3,14,4,11,45,36,9,46
Melbourne V,4126,4,13,5,11,46,40,6,44
Adelaide Utd,4126,5,11,6,11,37,40,-3,39
Brisbane,4126,6,10,5,13,33,42,-9,35
Western Sydn,4126,7,8,9,10,38,47,-9,33
Perth Glory,4126,8,10,2,15,37,50,-13,32
Wellington P,4126,9,5,6,16,31,55,-24,21
CC Mariners,4126,10,4,8,15,28,49,-21,20
Sydney FC,4127,1,21,4,3,66,22,44,67
N'castle Jet,4127,2,16,5,7,58,37,21,53
Melbourne C,4127,3,14,4,11,43,34,9,46
Melbourne V,4127,4,13,5,11,45,40,5,44
Adelaide Utd,4127,5,11,6,11,37,40,-3,39
Brisbane,4127,6,10,5,13,33,42,-9,35
Western Sydn,4127,7,8,9,10,38,47,-9,33
Perth Glory,4127,8,10,2,15,37,50,-13,32
Wellington P,4127,9,5,6,16,31,55,-24,21
CC Mariners,4127,10,4,8,15,28,49,-21,20
Sydney FC,4128,1,20,4,4,64,24,40,64
N'castle Jet,4128,2,15,5,8,58,39,19,50
Melbourne C,4128,3,15,4,10,45,34,11,49
Melbourne V,4128,4,14,5,10,47,38,9,47
Adelaide Utd,4128,5,11,6,11,37,40,-3,39
Brisbane,4128,6,10,5,13,33,42,-9,35
Western Sydn,4128,7,8,9,10,38,47,-9,33
Perth Glory,4128,8,10,2,15,37,50,-13,32
Wellington P,4128,9,5,6,16,31,55,-24,21
CC Mariners,4128,10,4,8,15,28,49,-21,20
Sydney FC,4129,1,20,4,4,66,25,41,64
N'castle Jet,4129,2,15,6,7,59,39,20,51
Melbourne C,4129,3,14,5,10,45,35,10,47
Melbourne V,4129,4,14,5,10,48,40,8,47
Adelaide Utd,4129,5,11,6,11,37,40,-3,39
Brisbane,4129,6,10,5,13,33,42,-9,35
Western Sydn,4129,7,8,9,10,38,47,-9,33
Perth Glory,4129,8,10,2,15,37,50,-13,32
Wellington P,4129,9,5,6,16,31,55,-24,21
CC Mariners,4129,10,4,8,15,28,49,-21,20
Sydney FC,4130,1,20,5,3,66,24,42,65
N'castle Jet,4130,2,15,6,7,59,39,20,51
Melbourne C,4130,3,14,5,10,45,35,10,47
Melbourne V,4130,4,13,6,10,47,40,7,45
Adelaide Utd,4130,5,11,6,11,37,40,-3,39
Brisbane,4130,6,10,5,13,33,42,-9,35
Western Sydn,4130,7,8,9,10,38,47,-9,33
Perth Glory,4130,8,10,2,15,37,50,-13,32
Wellington P,4130,9,5,6,16,31,55,-24,21
CC Mariners,4130,10,4,8,15,28,49,-21,20
Sydney FC,4131,1,20,5,3,66,24,42,65
N'castle Jet,4131,2,16,5,7,60,38,22,53
Melbourne C,4131,3,14,4,11,44,36,8,46
Melbourne V,4131,4,13,6,10,47,40,7,45
Adelaide Utd,4131,5,11,6,11,37,40,-3,39
Brisbane,4131,6,10,5,13,33,42,-9,35
Western Sydn,4131,7,8,9,10,38,47,-9,33
Perth Glory,4131,8,10,2,15,37,50,-13,32
Wellington P,4131,9,5,6,16,31,55,-24,21
CC Mariners,4131,10,4,8,15,28,49,-21,20
Sydney FC,4132,1,20,5,3,65,23,42,65
N'castle Jet,4132,2,15,6,7,57,37,20,51
Melbourne C,4132,3,14,5,10,43,33,10,47
Melbourne V,4132,4,13,6,10,46,39,7,45
Adelaide Utd,4132,5,11,6,11,37,40,-3,39
Brisbane,4132,6,10,5,13,33,42,-9,35
Western Sydn,4132,7,8,9,10,38,47,-9,33
Perth Glory,4132,8,10,2,15,37,50,-13,32
Wellington P,4132,9,5,6,16,31,55,-24,21
CC Mariners,4132,10,4,8,15,28,49,-21,20
Sydney FC,4133,1,20,4,4,65,24,41,64
N'castle Jet,4133,2,16,5,7,61,37,24,53
Melbourne V,4133,3,14,5,10,47,39,8,47
Melbourne C,4133,4,14,4,11,43,37,6,46
Adelaide Utd,4133,5,11,6,11,37,40,-3,39
Brisbane,4133,6,10,5,13,33,42,-9,35
Western Sydn,4133,7,8,9,10,38,47,-9,33
Perth Glory,4133,8,10,2,15,37,50,-13,32
Wellington P,4133,9,5,6,16,31,55,-24,21
CC Mariners,4133,10,4,8,15,28,49,-21,20
Sydney FC,4134,1,20,5,3,64,22,42,65
N'castle Jet,4134,2,15,6,7,58,38,20,51
Melbourne C,4134,3,14,5,10,44,34,10,47
Melbourne V,4134,4,13,6,10,45,38,7,45
Adelaide Utd,4134,5,11,6,11,37,40,-3,39
Brisbane,4134,6,10,5,13,33,42,-9,35
Western Sydn,4134,7,8,9,10,38,47,-9,33
Perth Glory,4134,8,10,2,15,37,50,-13,32
Wellington P,4134,9,5,6,16,31,55,-24,21
CC Mariners,4134,10,4,8,15,28,49,-21,20
Sydney FC,4135,1,20,5,3,66,24,42,65
N'castle Jet,4135,2,16,5,7,58,37,21,53
Melbourne C,4135,3,14,4,11,43,34,9,46
Melbourne V,4135,4,13,6,10,47,40,7,45
Adelaide Utd,4135,5,11,6,11,37,40,-3,39
Brisbane,4135,6,10,5,13,33,42,-9,35
Western Sydn,4135,7,8,9,10,38,47,-9,33
Perth Glory,4135,8,10,2,15,37,50,-13,32
Wellington P,4135,9,5,6,16,31,55,-24,21
CC Mariners,4135,10,4,8,15,28,49,-21,20
Sydney FC,4136,1,20,5,3,66,24,42,65
N'castle Jet,4136,2,16,5,7,59,38,21,53
Melbourne C,4136,3,14,4,11,44,35,9,46
Melbourne V,4136,4,13,6,10,47,40,7,45
Adelaide Utd,4136,5,11,6,11,37,40,-3,39
Brisbane,4136,6,10,5,13,33,42,-9,35
Western Sydn,4136,7,8,9,10,38,47,-9,33
Perth Glory,4136,8,10,2,15,37,50,-13,32
Wellington P,4136,9,5,6,16,31,55,-24,21
CC Mariners,4136,10,4,8,15,28,49,-21,20
Sydney FC,4137,1,20,4,4,64,25,39,64
N'castle Jet,4137,2,15,6,7,57,37,20,51
Melbourne V,4137,3,14,5,10,48,38,10,47
Melbourne C,4137,4,14,5,10,43,33,10,47
Adelaide Utd,4137,5,11,6,11,37,40,-3,39
Brisbane,4137,6,10,5,13,33,42,-9,35
Western Sydn,4137,7,8,9,10,38,47,-9,33
Perth Glory,4137,8,10,2,15,37,50,-13,32
Wellington P,4137,9,5,6,16,31,55,-24,21
CC Mariners,4137,10,4,8,15,28,49,-21,20
Sydney FC,4138,1,21,4,3,70,25,45,67
N'castle Jet,4138,2,15,6,7,60,40,20,51
Melbourne C,4138,3,14,5,10,46,36,10,47
Melbourne V,4138,4,13,5,11,48,44,4,44
Adelaide Utd,4138,5,11,6,11,37,40,-3,39
Brisbane,4138,6,10,5,13,33,42,-9,35
Western Sydn,4138,7,8,9,10,38,47,-9,33
Perth Glory,4138,8,10,2,15,37,50,-13,32
Wellington P,4138,9,5,6,16,31,55,-24,21
CC Mariners,4138,10,4,8,15,28,49,-21,20
Sydney FC,4139,1,21,4,3,68,22,46,67
N'castle Jet,4139,2,16,5,7,58,37,21,53
Melbourne C,4139,3,14,4,11,43,34,9,46
Melbourne V,4139,4,13,5,11,45,42,3,44
Adelaide Utd,4139,5,11,6,11,37,40,-3,39
Brisbane,4139,6,10,5,13,33,42,-9,35
Western Sydn,4139,7,8,9,10,38,47,-9,33
Perth Glory,4139,8,10,2,15,37,50,-13,32
Wellington P,4139,9,5,6,16,31,55,-24,21
CC Mariners,4139,10,4,8,15,28,49,-21,20
Sydney FC,4140,1,21,4,3,66,22,44,67
N'castle Jet,4140,2,15,5,8,57,39,18,50
Melbourne C,4140,3,15,4,10,45,33,12,49
Melbourne V,4140,4,13,5,11,45,40,5,44
Adelaide Utd,4140,5,11,6,11,37,40,-3,39
Brisbane,4140,6,10,5,13,33,42,-9,35
Western Sydn,4140,7,8,9,10,38,47,-9,33
Perth Glory,4140,8,10,2,15,37,50,-13,32
Wellington P,4140,9,5,6,16,31,55,-24,21
CC Mariners,4140,10,4,8,15,28,49,-21,20
Sydney FC,4141,1,21,4,3,69,22,47,67
N'castle Jet,4141,2,16,5,7,58,37,21,53
Melbourne C,4141,3,14,4,11,43,34,9,46
Melbourne V,4141,4,13,5,11,45,43,2,44
Adelaide Utd,4141,5,11,6,11,37,40,-3,39
Brisbane,4141,6,10,5,13,33,42,-9,35
Western Sydn,4141,7,8,9,10,38,47,-9,33
Perth Glory,4141,8,10,2,15,37,50,-13,32
Wellington P,4141,9,5,6,16,31,55,-24,21
CC Mariners,4141,10,4,8,15,28,49,-21,20
Sydney FC,4142,1,21,4,3,66,22,44,67
N'castle Jet,4142,2,15,6,7,58,38,20,51
Melbourne C,4142,3,14,5,10,44,34,10,47
Melbourne V,4142,4,13,5,11,45,40,5,44
Adelaide Utd,4142,5,11,6,11,37,40,-3,39
Brisbane,4142,6,10,5,13,33,42,-9,35
Western Sydn,4142,7,8,9,10,38,47,-9,33
Perth Glory,4142,8,10,2,15,37,50,-13,32
Wellington P,4142,9,5,6,16,31,55,-24,21
CC Mariners,4142,10,4,8,15,28,49,-21,20
Sydney FC,4143,1,20,5,3,65,23,42,65
N'castle Jet,4143,2,15,5,8,58,39,19,50
Melbourne C,4143,3,15,4,10,45,34,11,49
Melbourne V,4143,4,13,6,10,46,39,7,45
Adelaide Utd,4143,5,11,6,11,37,40,-3,39
Brisbane,4143,6,10,5,13,33,42,-9,35
Western Sydn,4143,7,8,9,10,38,47,-9,33
Perth Glory,4143,8,10,2,15,37,50,-13,32
Wellington P,4143,9,5,6,16,31,55,-24,21
CC Mariners,4143,10,4,8,15,28,49,-21,20
Sydney FC,4144,1,20,4,4,64,23,41,64
N'castle Jet,4144,2,16,5,7,60,37,23,53
Melbourne V,4144,3,14,5,10,46,38,8,47
Melbourne C,4144,4,14,4,11,43,36,7,46
Adelaide Utd,4144,5,11,6,11,37,40,-3,39
Brisbane,4144,6,10,5,13,33,42,-9,35
Western Sydn,4144,7,8,9,10,38,47,-9,33
Perth Glory,4144,8,10,2,15,37,50,-13,32
Wellington P,4144,9,5,6,16,31,55,-24,21
CC Mariners,4144,10,4,8,15,28,49,-21,20
Sydney FC,4145,1,21,4,3,67,22,45,67
N'castle Jet,4145,2,15,5,8,57,38,19,50
Melbourne C,4145,3,15,4,10,44,33,11,49
Melbourne V,4145,4,13,5,11,45,41,4,44
Adelaide Utd,4145,5,11,6,11,37,40,-3,39
Brisbane,4145,6,10,5,13,33,42,-9,35
Western Sydn,4145,7,8,9,10,38,47,-9,33
Perth Glory,4145,8,10,2,15,37,50,-13,32
Wellington P,4145,9,5,6,16,31,55,-24,21
CC Mariners,4145,10,4,8,15,28,49,-21,20
Sydney FC,4146,1,21,4,3,68,22,46,67
N'castle Jet,4146,2,16,5,7,61,37,24,53
Melbourne C,4146,3,14,4,11,43,37,6,46
Melbourne V,4146,4,13,5,11,45,42,3,44
Adelaide Utd,4146,5,11,6,11,37,40,-3,39
Brisbane,4146,6,10,5,13,33,42,-9,35
Western Sydn,4146,7,8,9,10,38,47,-9,33
Perth Glory,4146,8,10,2,15,37,50,-13,32
Wellington P,4146,9,5,6,16,31,55,-24,21
CC Mariners,4146,10,4,8,15,28,49,-21,20
Sydney FC,4147,1,20,5,3,66,24,42,65
N'castle Jet,4147,2,16,5,7,59,38,21,53
Melbourne C,4147,3,14,4,11,44,35,9,46
Melbourne V,4147,4,13,6,10,47,40,7,45
Adelaide Utd,4147,5,11,6,11,37,40,-3,39
Brisbane,4147,6,10,5,13,33,42,-9,35
Western Sydn,4147,7,8,9,10,38,47,-9,33
Perth Glory,4147,8,10,2,15,37,50,-13,32
Wellington P,4147,9,5,6,16,31,55,-24,21
CC Mariners,4147,10,4,8,15,28,49,-21,20
Sydney FC,4148,1,21,4,3,66,23,43,67
N'castle Jet,4148,2,15,6,7,59,39,20,51
Melbourne C,4148,3,14,5,10,45,35,10,47
Melbourne V,4148,4,13,5,11,46,40,6,44
Adelaide Utd,4148,5,11,6,11,37,40,-3,39
Brisbane,4148,6,10,5,13,33,42,-9,35
Western Sydn,4148,7,8,9,10,38,47,-9,33
Perth Glory,4148,8,10,2,15,37,50,-13,32
Wellington P,4148,9,5,6,16,31,55,-24,21
CC Mariners,4148,10,4,8,15,28,49,-21,20
Sydney FC,4149,1,20,5,3,65,23,42,65
N'castle Jet,4149,2,15,5,8,57,38,19,50
Melbourne C,4149,3,15,4,10,44,33,11,49
Melbourne V,4149,4,13,6,10,46,39,7,45
Adelaide Utd,4149,5,11,6,11,37,40,-3,39
Brisbane,4149,6,10,5,13,33,42,-9,35
Western Sydn,4149,7,8,9,10,38,47,-9,33
Perth Glory,4149,8,10,2,15,37,50,-13,32
Wellington P,4149,9,5,6,16,31,55,-24,21
CC Mariners,4149,10,4,8,15,28,49,-21,20
Sydney FC,4150,1,21,4,3,66,22,44,67
N'castle Jet,4150,2,15,5,8,57,39,18,50
Melbourne C,4150,3,15,4,10,45,33,12,49
Melbourne V,4150,4,13,5,11,45,40,5,44
Adelaide Utd,4150,5,11,6,11,37,40,-3,39
Brisbane,4150,6,10,5,13,33,42,-9,35
Western Sydn,4150,7,8,9,10,38,47,-9,33
Perth Glory,4150,8,10,2,15,37,50,-13,32
Wellington P,4150,9,5,6,16,31,55,-24,21
CC Mariners,4150,10,4,8,15,28,49,-21,20
Sydney FC,4151,1,21,4,3,67,22,45,67
N'castle Jet,4151,2,16,5,7,62,38,24,53
Melbourne C,4151,3,14,4,11,44,38,6,46
Melbourne V,4151,4,13,5,11,45,41,4,44
Adelaide Utd,4151,5,11,6,11,37,40,-3,39
Brisbane,4151,6,10,5,13,33,42,-9,35
Western Sydn,4151,7,8,9,10,38,47,-9,33
Perth Glory,4151,8,10,2,15,37,50,-13,32
Wellington P,4151,9,5,6,16,31,55,-24,21
CC Mariners,4151,10,4,8,15,28,49,-21,20
Sydney FC,4152,1,21,4,3,67,23,44,67
N'castle Jet,4152,2,16,5,7,61,37,24,53
Melbourne C,4152,3,14,4,11,43,37,6,46
Melbourne V,4152,4,13,5,11,46,41,5,44
Adelaide Utd,4152,5,11,6,11,37,40,-3,39
Brisbane,4152,6,10,5,13,33,42,-9,35
Western Sydn,4152,7,8,9,10,38,47,-9,33
Perth Glory,4152,8,10,2,15,37,50,-13,32
Wellington P,4152,9,5,6,16,31,55,-24,21
CC Mariners,4152,10,4,8,15,28,49,-21,20
Sydney FC,4153,1,20,5,3,65,23,42,65
N'castle Jet,4153,2,15,6,7,60,40,20,51
Melbourne C,4153,3,14,5,10,46,36,10,47
Melbourne V,4153,4,13,6,10,46,39,7,45
Adelaide Utd,4153,5,11,6,11,37,40,-3,39
Brisbane,4153,6,10,5,13,33,42,-9,35
Western Sydn,4153,7,8,9,10,38,47,-9,33
Perth Glory,4153,8,10,2,15,37,50,-13,32
Wellington P,4153,9,5,6,16,31,55,-24,21
CC Mariners,4153,10,4,8,15,28,49,-21,20
Sydney FC,4154,1,21,4,3,68,23,45,67
N'castle Jet,4154,2,16,5,7,58,37,21,53
Melbourne C,4154,3,14,4,11,43,34,9,46
Melbourne V,4154,4,13,5,11,46,42,4,44
Adelaide Utd,4154,5,11,6,11,37,40,-3,39
Brisbane,4154,6,10,5,13,33,42,-9,35
Western Sydn,4154,7,8,9,10,38,47,-9,33
Perth Glory,4154,8,10,2,15,37,50,-13,32
Wellington P,4154,9,5,6,16,31,55,-24,21
CC Mariners,4154,10,4,8,15,28,49,-21,20
Sydney FC,4155,1,20,4,4,64,25,39,64
N'castle Jet,4155,2,15,6,7,57,37,20,51
Melbourne V,4155,3,14,5,10,48,38,10,47
Melbourne C,4155,4,14,5,10,43,33,10,47
Adelaide Utd,4155,5,11,6,11,37,40,-3,39
Brisbane,4155,6,10,5,13,33,42,-9,35
Western Sydn,4155,7,8,9,10,38,47,-9,33
Perth Glory,4155,8,10,2,15,37,50,-13,32
Wellington P,4155,9,5,6,16,31,55,-24,21
CC Mariners,4155,10,4,8,15,28,49,-21,20
Sydney FC,4156,1,21,4,3,65,22,43,67
N'castle Jet,4156,2,16,5,7,59,37,22,53
Melbourne C,4156,3,14,4,11,43,35,8,46
Melbourne V,4156,4,13,5,11,45,39,6,44
Adelaide Utd,4156,5,11,6,11,37,40,-3,39
Brisbane,4156,6,10,5,13,33,42,-9,35
Western Sydn,4156,7,8,9,10,38,47,-9,33
Perth Glory,4156,8,10,2,15,37,50,-13,32
Wellington P,4156,9,5,6,16,31,55,-24,21
CC Mariners,4156,10,4,8,15,28,49,-21,20
Sydney FC,4157,1,20,5,3,65,23,42,65
N'castle Jet,4157,2,16,5,7,59,38,21,53
Melbourne C,4157,3,14,4,11,44,35,9,46
Melbourne V,4157,4,13,6,10,46,39,7,45
Adelaide Utd,4157,5,11,6,11,37,40,-3,39
Brisbane,4157,6,10,5,13,33,42,-9,35
Western Sydn,4157,7,8,9,10,38,47,-9,33
Perth Glory,4157,8,10,2,15,37,50,-13,32
Wellington P,4157,9,5,6,16,31,55,-24,21
CC Mariners,4157,10,4,8,15,28,49,-21,20
Sydney FC,4158,1,21,4,3,67,22,45,67
N'castle Jet,4158,2,15,5,8,57,39,18,50
Melbourne C,4158,3,15,4,10,45,33,12,49
Melbourne V,4158,4,13,5,11,45,41,4,44
Adelaide Utd,4158,5,11,6,11,37,40,-3,39
Brisbane,4158,6,10,5,13,33,42,-9,35
Western Sydn,4158,7,8,9,10,38,47,-9,33
Perth Glory,4158,8,10,2,15,37,50,-13,32
Wellington P,4158,9,5,6,16,31,55,-24,21
CC Mariners,4158,10,4,8,15,28,49,-21,20
Sydney FC,4159,1,20,5,3,65,23,42,65
N'castle Jet,4159,2,15,5,8,58,41,17,50
Melbourne C,4159,3,15,4,10,47,34,13,49
Melbourne V,4159,4,13,6,10,46,39,7,45
Adelaide Utd,4159,5,11,6,11,37,40,-3,39
Brisbane,4159,6,10,5,13,33,42,-9,35
Western Sydn,4159,7,8,9,10,38,47,-9,33
Perth Glory,4159,8,10,2,15,37,50,-13,32
Wellington P,4159,9,5,6,16,31,55,-24,21
CC Mariners,4159,10,4,8,15,28,49,-21,20
Sydney FC,4160,1,21,4,3,65,22,43,67
N'castle Jet,4160,2,16,5,7,62,38,24,53
Melbourne C,4160,3,14,4,11,44,38,6,46
Melbourne V,4160,4,13,5,11,45,39,6,44
Adelaide Utd,4160,5,11,6,11,37,40,-3,39
Brisbane,4160,6,10,5,13,33,42,-9,35
Western Sydn,4160,7,8,9,10,38,47,-9,33
Perth Glory,4160,8,10,2,15,37,50,-13,32
Wellington P,4160,9,5,6,16,31,55,-24,21
CC Mariners,4160,10,4,8,15,28,49,-21,20
Sydney FC,4161,1,21,4,3,68,22,46,67
N'castle Jet,4161,2,16,5,7,59,37,22,53
Melbourne C,4161,3,14,4,11,43,35,8,46
Melbourne V,4161,4,13,5,11,45,42,3,44
Adelaide Utd,4161,5,11,6,11,37,40,-3,39
Brisbane,4161,6,10,5,13,33,42,-9,35
Western Sydn,4161,7,8,9,10,38,47,-9,33
Perth Glory,4161,8,10,2,15,37,50,-13,32
Wellington P,4161,9,5,6,16,31,55,-24,21
CC Mariners,4161,10,4,8,15,28,49,-21,20
Sydney FC,4162,1,20,5,3,65,23,42,65
N'castle Jet,4162,2,15,6,7,59,39,20,51
Melbourne C,4162,3,14,5,10,45,35,10,47
Melbourne V,4162,4,13,6,10,46,39,7,45
Adelaide Utd,4162,5,11,6,11,37,40,-3,39
Brisbane,4162,6,10,5,13,33,42,-9,35
Western Sydn,4162,7,8,9,10,38,47,-9,33
Perth Glory,4162,8,10,2,15,37,50,-13,32
Wellington P,4162,9,5,6,16,31,55,-24,21
CC Mariners,4162,10,4,8,15,28,49,-21,20
Sydney FC,4163,1,21,4,3,69,25,44,67
N'castle Jet,4163,2,16,5,7,60,38,22,53
Melbourne C,4163,3,14,4,11,44,36,8,46
Melbourne V,4163,4,13,5,11,48,43,5,44
Adelaide Utd,4163,5,11,6,11,37,40,-3,39
Brisbane,4163,6,10,5,13,33,42,-9,35
Western Sydn,4163,7,8,9,10,38,47,-9,33
Perth Glory,4163,8,10,2,15,37,50,-13,32
Wellington P,4163,9,5,6,16,31,55,-24,21
CC Mariners,4163,10,4,8,15,28,49,-21,20
Sydney FC,4164,1,21,4,3,67,22,45,67
N'castle Jet,4164,2,15,5,8,58,40,18,50
Melbourne C,4164,3,15,4,10,46,34,12,49
Melbourne V,4164,4,13,5,11,45,41,4,44
Adelaide Utd,4164,5,11,6,11,37,40,-3,39
Brisbane,4164,6,10,5,13,33,42,-9,35
Western Sydn,4164,7,8,9,10,38,47,-9,33
Perth Glory,4164,8,10,2,15,37,50,-13,32
Wellington P,4164,9,5,6,16,31,55,-24,21
CC Mariners,4164,10,4,8,15,28,49,-21,20
Sydney FC,4165,1,21,4,3,68,22,46,67
N'castle Jet,4165,2,16,5,7,58,37,21,53
Melbourne C,4165,3,14,4,11,43,34,9,46
Melbourne V,4165,4,13,5,11,45,42,3,44
Adelaide Utd,4165,5,11,6,11,37,40,-3,39
Brisbane,4165,6,10,5,13,33,42,-9,35
Western Sydn,4165,7,8,9,10,38,47,-9,33
Perth Glory,4165,8,10,2,15,37,50,-13,32
Wellington P,4165,9,5,6,16,31,55,-24,21
CC Mariners,4165,10,4,8,15,28,49,-21,20
Sydney FC,4166,1,21,4,3,65,22,43,67
N'castle Jet,4166,2,15,6,7,59,39,20,51
Melbourne C,4166,3,14,5,10,45,35,10,47
Melbourne V,4166,4,13,5,11,45,39,6,44
Adelaide Utd,4166,5,11,6,11,37,40,-3,39
Brisbane,4166,6,10,5,13,33,42,-9,35
Western Sydn,4166,7,8,9,10,38,47,-9,33
Perth Glory,4166,8,10,2,15,37,50,-13,32
Wellington P,4166,9,5,6,16,31,55,-24,21
CC Mariners,4166,10,4,8,15,28,49,-21,20
Sydney FC,4167,1,20,5,3,66,24,42,65
N'castle Jet,4167,2,15,6,7,58,38,20,51
Melbourne C,4167,3,14,5,10,44,34,10,47
Melbourne V,4167,4,13,6,10,47,40,7,45
Adelaide Utd,4167,5,11,6,11,37,40,-3,39
Brisbane,4167,6,10,5,13,33,42,-9,35
Western Sydn,4167,7,8,9,10,38,47,-9,33
Perth Glory,4167,8,10,2,15,37,50,-13,32
Wellington P,4167,9,5,6,16,31,55,-24,21
CC Mariners,4167,10,4,8,15,28,49,-21,20
Sydney FC,4168,1,20,4,4,65,24,41,64
N'castle Jet,4168,2,15,6,7,58,38,20,51
Melbourne C,4168,3,14,5,10,44,34,10,47
Melbourne V,4168,4,14,5,10,47,39,8,47
Adelaide Utd,4168,5,11,6,11,37,40,-3,39
Brisbane,4168,6,10,5,13,33,42,-9,35
Western Sydn,4168,7,8,9,10,38,47,-9,33
Perth Glory,4168,8,10,2,15,37,50,-13,32
Wellington P,4168,9,5,6,16,31,55,-24,21
CC Mariners,4168,10,4,8,15,28,49,-21,20
Sydney FC,4169,1,20,5,3,66,24,42,65
N'castle Jet,4169,2,16,5,7,61,39,22,53
Melbourne C,4169,3,14,4,11,45,37,8,46
Melbourne V,4169,4,13,6,10,47,40,7,45
Adelaide Utd,4169,5,11,6,11,37,40,-3,39
Brisbane,4169,6,10,5,13,33,42,-9,35
Western Sydn,4169,7,8,9,10,38,47,-9,33
Perth Glory,4169,8,10,2,15,37,50,-13,32
Wellington P,4169,9,5,6,16,31,55,-24,21
CC Mariners,4169,10,4,8,15,28,49,-21,20
Sydney FC,4170,1,21,4,3,67,23,44,67
N'castle Jet,4170,2,16,5,7,58,37,21,53
Melbourne C,4170,3,14,4,11,43,34,9,46
Melbourne V,4170,4,13,5,11,46,41,5,44
Adelaide Utd,4170,5,11,6,11,37,40,-3,39
Brisbane,4170,6,10,5,13,33,42,-9,35
Western Sydn,4170,7,8,9,10,38,47,-9,33
Perth Glory,4170,8,10,2,15,37,50,-13,32
Wellington P,4170,9,5,6,16,31,55,-24,21
CC Mariners,4170,10,4,8,15,28,49,-21,20
Sydney FC,4171,1,21,4,3,68,22,46,67
N'castle Jet,4171,2,15,5,8,57,39,18,50
Melbourne C,4171,3,15,4,10,45,33,12,49
Melbourne V,4171,4,13,5,11,45,42,3,44
Adelaide Utd,4171,5,11,6,11,37,40,-3,39
Brisbane,4171,6,10,5,13,33,42,-9,35
Western Sydn,4171,7,8,9,10,38,47,-9,33
Perth Glory,4171,8,10,2,15,37,50,-13,32
Wellington P,4171,9,5,6,16,31,55,-24,21
CC Mariners,4171,10,4,8,15,28,49,-21,20
Sydney FC,4172,1,21,4,3,68,23,45,67
N'castle Jet,4172,2,15,6,7,57,37,20,51
Melbourne C,4172,3,14,5,10,43,33,10,47
Melbourne V,4172,4,13,5,11,46,42,4,44
Adelaide Utd,4172,5,11,6,11,37,40,-3,39
Brisbane,4172,6,10,5,13,33,42,-9,35
Western Sydn,4172,7,8,9,10,38,47,-9,33
Perth Glory,4172,8,10,2,15,37,50,-13,32
Wellington P,4172,9,5,6,16,31,55,-24,21
CC Mariners,4172,10,4,8,15,28,49,-21,20
Sydney FC,4173,1,21,4,3,67,24,43,67
N'castle Jet,4173,2,16,5,7,58,37,21,53
Melbourne C,4173,3,14,4,11,43,34,9,46
Melbourne V,4173,4,13,5,11,47,41,6,44
Adelaide Utd,4173,5,11,6,11,37,40,-3,39
Brisbane,4173,6,10,5,13,33,42,-9,35
Western Sydn,4173,7,8,9,10,38,47,-9,33
Perth Glory,4173,8,10,2,15,37,50,-13,32
Wellington P,4173,9,5,6,16,31,55,-24,21
CC Mariners,4173,10,4,8,15,28,49,-21,20
Sydney FC,4174,1,20,5,3,66,24,42,65
N'castle Jet,4174,2,15,5,8,57,38,19,50
Melbourne C,4174,3,15,4,10,44,33,11,49
Melbourne V,4174,4,13,6,10,47,40,7,45
Adelaide Utd,4174,5,11,6,11,37,40,-3,39
Brisbane,4174,6,10,5,13,33,42,-9,35
Western Sydn,4174,7,8,9,10,38,47,-9,33
Perth Glory,4174,8,10,2,15,37,50,-13,32
Wellington P,4174,9,5,6,16,31,55,-24,21
CC Mariners,4174,10,4,8,15,28,49,-21,20
Sydney FC,4175,1,20,5,3,65,23,42,65
N'castle Jet,4175,2,16,5,7,59,38,21,53
Melbourne C,4175,3,14,4,11,44,35,9,46
Melbourne V,4175,4,13,6,10,46,39,7,45
Adelaide Utd,4175,5,11,6,11,37,40,-3,39
Brisbane,4175,6,10,5,13,33,42,-9,35
Western Sydn,4175,7,8,9,10,38,47,-9,33
Perth Glory,4175,8,10,2,15,37,50,-13,32
Wellington P,4175,9,5,6,16,31,55,-24,21
CC Mariners,4175,10,4,8,15,28,49,-21,20
Sydney FC,4176,1,21,4,3,71,23,48,67
N'castle Jet,4176,2,16,5,7,60,39,21,53
Melbourne C,4176,3,14,4,11,45,36,9,46
Melbourne V,4176,4,13,5,11,46,45,1,44
Adelaide Utd,4176,5,11,6,11,37,40,-3,39
Brisbane,4176,6,10,5,13,33,42,-9,35
Western Sydn,4176,7,8,9,10,38,47,-9,33
Perth Glory,4176,8,10,2,15,37,50,-13,32
Wellington P,4176,9,5,6,16,31,55,-24,21
CC Mariners,4176,10,4,8,15,28,49,-21,20
Sydney FC,4177,1,21,4,3,67,23,44,67
N'castle Jet,4177,2,15,5,8,57,39,18,50
Melbourne C,4177,3,15,4,10,45,33,12,49
Melbourne V,4177,4,13,5,11,46,41,5,44
Adelaide Utd,4177,5,11,6,11,37,40,-3,39
Brisbane,4177,6,10,5,13,33,42,-9,35
Western Sydn,4177,7,8,9,10,38,47,-9,33
Perth Glory,4177,8,10,2,15,37,50,-13,32
Wellington P,4177,9,5,6,16,31,55,-24,21
CC Mariners,4177,10,4,8,15,28,49,-21,20
Sydney FC,4178,1,21,4,3,66,23,43,67
N'castle Jet,4178,2,15,5,8,57,39,18,50
Melbourne C,4178,3,15,4,10,45,33,12,49
Melbourne V,4178,4,13,5,11,46,40,6,44
Adelaide Utd,4178,5,11,6,11,37,40,-3,39
Brisbane,4178,6,10,5,13,33,42,-9,35
Western Sydn,4178,7,8,9,10,38,47,-9,33
Perth Glory,4178,8,10,2,15,37,50,-13,32
Wellington P,4178,9,5,6,16,31,55,-24,21
CC Mariners,4178,10,4,8,15,28,49,-21,20
Sydney FC,4179,1,20,4,4,64,23,41,64
N'castle Jet,4179,2,15,5,8,58,39,19,50
Melbourne C,4179,3,15,4,10,45,34,11,49
Melbourne V,4179,4,14,5,10,46,38,8,47
Adelaide Utd,4179,5,11,6,11,37,40,-3,39
Brisbane,4179,6,10,5,13,33,42,-9,35
Western Sydn,4179,7,8,9,10,38,47,-9,33
Perth Glory,4179,8,10,2,15,37,50,-13,32
Wellington P,4179,9,5,6,16,31,55,-24,21
CC Mariners,4179,10,4,8,15,28,49,-21,20
Sydney FC,4180,1,21,4,3,67,22,45,67
N'castle Jet,4180,2,15,6,7,58,38,20,51
Melbourne C,4180,3,14,5,10,44,34,10,47
Melbourne V,4180,4,13,5,11,45,41,4,44
Adelaide Utd,4180,5,11,6,11,37,40,-3,39
Brisbane,4180,6,10,5,13,33,42,-9,35
Western Sydn,4180,7,8,9,10,38,47,-9,33
Perth Glory,4180,8,10,2,15,37,50,-13,32
Wellington P,4180,9,5,6,16,31,55,-24,21
CC Mariners,4180,10,4,8,15,28,49,-21,20
Sydney FC,4181,1,20,5,3,66,24,42,65
N'castle Jet,4181,2,16,5,7,58,37,21,53
Melbourne C,4181,3,14,4,11,43,34,9,46
Melbourne V,4181,4,13,6,10,47,40,7,45
Adelaide Utd,4181,5,11,6,11,37,40,-3,39
Brisbane,4181,6,10,5,13,33,42,-9,35
Western Sydn,4181,7,8,9,10,38,47,-9,33
Perth Glory,4181,8,10,2,15,37,50,-13,32
Wellington P,4181,9,5,6,16,31,55,-24,21
CC Mariners,4181,10,4,8,15,28,49,-21,20
Sydney FC,4182,1,21,4,3,65,22,43,67
N'castle Jet,4182,2,16,5,7,60,38,22,53
Melbourne C,4182,3,14,4,11,44,36,8,46
Melbourne V,4182,4,13,5,11,45,39,6,44
Adelaide Utd,4182,5,11,6,11,37,40,-3,39
Brisbane,4182,6,10,5,13,33,42,-9,35
Western Sydn,4182,7,8,9,10,38,47,-9,33
Perth Glory,4182,8,10,2,15,37,50,-13,32
Wellington P,4182,9,5,6,16,31,55,-24,21
CC Mariners,4182,10,4,8,15,28,49,-21,20
Sydney FC,4183,1,21,4,3,67,22,45,67
N'castle Jet,4183,2,15,6,7,58,38,20,51
Melbourne C,4183,3,14,5,10,44,34,10,47
Melbourne V,4183,4,13,5,11,45,41,4,44
Adelaide Utd,4183,5,11,6,11,37,40,-3,39
Brisbane,4183,6,10,5,13,33,42,-9,35
Western Sydn,4183,7,8,9,10,38,47,-9,33
Perth Glory,4183,8,10,2,15,37,50,-13,32
Wellington P,4183,9,5,6,16,31,55,-24,21
CC Mariners,4183,10,4,8,15,28,49,-21,20
Sydney FC,4184,1,20,4,4,65,24,41,64
N'castle Jet,4184,2,15,5,8,57,38,19,50
Melbourne C,4184,3,15,4,10,44,33,11,49
Melbourne V,4184,4,14,5,10,47,39,8,47
Adelaide Utd,4184,5,11,6,11,37,40,-3,39
Brisbane,4184,6,10,5,13,33,42,-9,35
Western Sydn,4184,7,8,9,10,38,47,-9,33
Perth Glory,4184,8,10,2,15,37,50,-13,32
Wellington P,4184,9,5,6,16,31,55,-24,21
CC Mariners,4184,10,4,8,15,28,49,-21,20
Sydney FC,4185,1,21,4,3,67,23,44,67
N'castle Jet,4185,2,15,6,7,57,37,20,51
Melbourne C,4185,3,14,5,10,43,33,10,47
Melbourne V,4185,4,13,5,11,46,41,5,44
Adelaide Utd,4185,5,11,6,11,37,40,-3,39
Brisbane,4185,6,10,5,13,33,42,-9,35
Western Sydn,4185,7,8,9,10,38,47,-9,33
Perth Glory,4185,8,10,2,15,37,50,-13,32
Wellington P,4185,9,5,6,16,31,55,-24,21
CC Mariners,4185,10,4,8,15,28,49,-21,20
Sydney FC,4186,1,21,4,3,66,22,44,67
N'castle Jet,4186,2,15,5,8,58,39,19,50
Melbourne C,4186,3,15,4,10,45,34,11,49
Melbourne V,4186,4,13,5,11,45,40,5,44
Adelaide Utd,4186,5,11,6,11,37,40,-3,39
Brisbane,4186,6,10,5,13,33,42,-9,35
Western Sydn,4186,7,8,9,10,38,47,-9,33
Perth Glory,4186,8,10,2,15,37,50,-13,32
Wellington P,4186,9,5,6,16,31,55,-24,21
CC Mariners,4186,10,4,8,15,28,49,-21,20
Sydney FC,4187,1,21,4,3,67,24,43,67
N'castle Jet,4187,2,16,5,7,60,39,21,53
Melbourne C,4187,3,14,4,11,45,36,9,46
Melbourne V,4187,4,13,5,11,47,41,6,44
Adelaide Utd,4187,5,11,6,11,37,40,-3,39
Brisbane,4187,6,10,5,13,33,42,-9,35
Western Sydn,4187,7,8,9,10,38,47,-9,33
Perth Glory,4187,8,10,2,15,37,50,-13,32
Wellington P,4187,9,5,6,16,31,55,-24,21
CC Mariners,4187,10,4,8,15,28,49,-21,20
Sydney FC,4188,1,20,4,4,64,23,41,64
N'castle Jet,4188,2,15,5,8,57,38,19,50
Melbourne C,4188,3,15,4,10,44,33,11,49
Melbourne V,4188,4,14,5,10,46,38,8,47
Adelaide Utd,4188,5,11,6,11,37,40,-3,39
Brisbane,4188,6,10,5,13,33,42,-9,35
Western Sydn,4188,7,8,9,10,38,47,-9,33
Perth Glory,4188,8,10,2,15,37,50,-13,32
Wellington P,4188,9,5,6,16,31,55,-24,21
CC Mariners,4188,10,4,8,15,28,49,-21,20
Sydney FC,4189,1,21,4,3,67,22,45,67
N'castle Jet,4189,2,15,5,8,57,39,18,50
Melbourne C,4189,3,15,4,10,45,33,12,49
Melbourne V,4189,4,13,5,11,45,41,4,44
Adelaide Utd,4189,5,11,6,11,37,40,-3,39
Brisbane,4189,6,10,5,13,33,42,-9,35
Western Sydn,4189,7,8,9,10,38,47,-9,33
Perth Glory,4189,8,10,2,15,37,50,-13,32
Wellington P,4189,9,5,6,16,31,55,-24,21
CC Mariners,4189,10,4,8,15,28,49,-21,20
Sydney FC,4190,1,21,4,3,65,22,43,67
N'castle Jet,4190,2,16,5,7,60,38,22,53
Melbourne C,4190,3,14,4,11,44,36,8,46
Melbourne V,4190,4,13,5,11,45,39,6,44
Adelaide Utd,4190,5,11,6,11,37,40,-3,39
Brisbane,4190,6,10,5,13,33,42,-9,35
Western Sydn,4190,7,8,9,10,38,47,-9,33
Perth Glory,4190,8,10,2,15,37,50,-13,32
Wellington P,4190,9,5,6,16,31,55,-24,21
CC Mariners,4190,10,4,8,15,28,49,-21,20
Sydney FC,4191,1,21,4,3,68,23,45,67
N'castle Jet,4191,2,16,5,7,60,38,22,53
Melbourne C,4191,3,14,4,11,44,36,8,46
Melbourne V,4191,4,13,5,11,46,42,4,44
Adelaide Utd,4191,5,11,6,11,37,40,-3,39
Brisbane,4191,6,10,5,13,33,42,-9,35
Western Sydn,4191,7,8,9,10,38,47,-9,33
Perth Glory,4191,8,10,2,15,37,50,-13,32
Wellington P,4191,9,5,6,16,31,55,-24,21
CC Mariners,4191,10,4,8,15,28,49,-21,20
Sydney FC,4192,1,20,4,4,65,24,41,64
N'castle Jet,4192,2,15,6,7,60,40,20,51
Melbourne C,4192,3,14,5,10,46,36,10,47
Melbourne V,4192,4,14,5,10,47,39,8,47
Adelaide Utd,4192,5,11,6,11,37,40,-3,39
Brisbane,4192,6,10,5,13,33,42,-9,35
Western Sydn,4192,7,8,9,10,38,47,-9,33
Perth Glory,4192,8,10,2,15,37,50,-13,32
Wellington P,4192,9,5,6,16,31,55,-24,21
CC Mariners,4192,10,4,8,15,28,49,-21,20
Sydney FC,4193,1,21,4,3,67,23,44,67
N'castle Jet,4193,2,15,6,7,59,39,20,51
Melbourne C,4193,3,14,5,10,45,35,10,47
Melbourne V,4193,4,13,5,11,46,41,5,44
Adelaide Utd,4193,5,11,6,11,37,40,-3,39
Brisbane,4193,6,10,5,13,33,42,-9,35
Western Sydn,4193,7,8,9,10,38,47,-9,33
Perth Glory,4193,8,10,2,15,37,50,-13,32
Wellington P,4193,9,5,6,16,31,55,-24,21
CC Mariners,4193,10,4,8,15,28,49,-21,20
Sydney FC,4194,1,21,4,3,67,23,44,67
N'castle Jet,4194,2,15,6,7,58,38,20,51
Melbourne C,4194,3,14,5,10,44,34,10,47
Melbourne V,4194,4,13,5,11,46,41,5,44
Adelaide Utd,4194,5,11,6,11,37,40,-3,39
Brisbane,4194,6,10,5,13,33,42,-9,35
Western Sydn,4194,7,8,9,10,38,47,-9,33
Perth Glory,4194,8,10,2,15,37,50,-13,32
Wellington P,4194,9,5,6,16,31,55,-24,21
CC Mariners,4194,10,4,8,15,28,49,-21,20
Sydney FC,4195,1,21,4,3,67,24,43,67
N'castle Jet,4195,2,16,5,7,60,38,22,53
Melbourne C,4195,3,14,4,11,44,36,8,46
Melbourne V,4195,4,13,5,11,47,41,6,44
Adelaide Utd,4195,5,11,6,11,37,40,-3,39
Brisbane,4195,6,10,5,13,33,42,-9,35
Western Sydn,4195,7,8,9,10,38,47,-9,33
Perth Glory,4195,8,10,2,15,37,50,-13,32
Wellington P,4195,9,5,6,16,31,55,-24,21
CC Mariners,4195,10,4,8,15,28,49,-21,20
Sydney FC,4196,1,20,4,4,66,25,41,64
N'castle Jet,4196,2,15,5,8,58,39,19,50
Melbourne C,4196,3,15,4,10,45,34,11,49
Melbourne V,4196,4,14,5,10,48,40,8,47
Adelaide Utd,4196,5,11,6,11,37,40,-3,39
Brisbane,4196,6,10,5,13,33,42,-9,35
Western Sydn,4196,7,8,9,10,38,47,-9,33
Perth Glory,4196,8,10,2,15,37,50,-13,32
Wellington P,4196,9,5,6,16,31,55,-24,21
CC Mariners,4196,10,4,8,15,28,49,-21,20
Sydney FC,4197,1,20,5,3,65,23,42,65
N'castle Jet,4197,2,16,5,7,60,38,22,53
Melbourne C,4197,3,14,4,11,44,36,8,46
Melbourne V,4197,4,13,6,10,46,39,7,45
Adelaide Utd,4197,5,11,6,11,37,40,-3,39
Brisbane,4197,6,10,5,13,33,42,-9,35
Western Sydn,4197,7,8,9,10,38,47,-9,33
Perth Glory,4197,8,10,2,15,37,50,-13,32
Wellington P,4197,9,5,6,16,31,55,-24,21
CC Mariners,4197,10,4,8,15,28,49,-21,20
Sydney FC,4198,1,20,5,3,65,23,42,65
N'castle Jet,4198,2,15,6,7,59,39,20,51
Melbourne C,4198,3,14,5,10,45,35,10,47
Melbourne V,4198,4,13,6,10,46,39,7,45
Adelaide Utd,4198,5,11,6,11,37,40,-3,39
Brisbane,4198,6,10,5,13,33,42,-9,35
Western Sydn,4198,7,8,9,10,38,47,-9,33
Perth Glory,4198,8,10,2,15,37,50,-13,32
Wellington P,4198,9,5,6,16,31,55,-24,21
CC Mariners,4198,10,4,8,15,28,49,-21,20
Sydney FC,4199,1,21,4,3,66,23,43,67
N'castle Jet,4199,2,15,6,7,57,37,20,51
Melbourne C,4199,3,14,5,10,43,33,10,47
Melbourne V,4199,4,13,5,11,46,40,6,44
Adelaide Utd,4199,5,11,6,11,37,40,-3,39
Brisbane,4199,6,10,5,13,33,42,-9,35
Western Sydn,4199,7,8,9,10,38,47,-9,33
Perth Glory,4199,8,10,2,15,37,50,-13,32
Wellington P,4199,9,5,6,16,31,55,-24,21
CC Mariners,4199,10,4,8,15,28,49,-21,20
Sydney FC,4200,1,21,4,3,67,24,43,67
N'castle Jet,4200,2,16,5,7,60,37,23,53
Melbourne C,4200,3,14,4,11,43,36,7,46
Melbourne V,4200,4,13,5,11,47,41,6,44
Adelaide Utd,4200,5,11,6,11,37,40,-3,39
Brisbane,4200,6,10,5,13,33,42,-9,35
Western Sydn,4200,7,8,9,10,38,47,-9,33
Perth Glory,4200,8,10,2,15,37,50,-13,32
Wellington P,4200,9,5,6,16,31,55,-24,21
CC Mariners,4200,10,4,8,15,28,49,-21,20
Sydney FC,4201,1,21,4,3,67,24,43,67
N'castle Jet,4201,2,15,6,7,59,39,20,51
Melbourne C,4201,3,14,5,10,45,35,10,47
Melbourne V,4201,4,13,5,11,47,41,6,44
Adelaide Utd,4201,5,11,6,11,37,40,-3,39
Brisbane,4201,6,10,5,13,33,42,-9,35
Western Sydn,4201,7,8,9,10,38,47,-9,33
Perth Glory,4201,8,10,2,15,37,50,-13,32
Wellington P,4201,9,5,6,16,31,55,-24,21
CC Mariners,4201,10,4,8,15,28,49,-21,20
Sydney FC,4202,1,21,4,3,66,22,44,67
N'castle Jet,4202,2,16,5,7,59,38,21,53
Melbourne C,4202,3,14,4,11,44,35,9,46
Melbourne V,4202,4,13,5,11,45,40,5,44
Adelaide Utd,4202,5,11,6,11,37,40,-3,39
Brisbane,4202,6,10,5,13,33,42,-9,35
Western Sydn,4202,7,8,9,10,38,47,-9,33
Perth Glory,4202,8,10,2,15,37,50,-13,32
Wellington P,4202,9,5,6,16,31,55,-24,21
CC Mariners,4202,10,4,8,15,28,49,-21,20
Sydney FC,4203,1,21,4,3,72,23,49,67
N'castle Jet,4203,2,16,5,7,59,38,21,53
Melbourne C,4203,3,14,4,11,44,35,9,46
Melbourne V,4203,4,13,5,11,46,46,0,44
Adelaide Utd,4203,5,11,6,11,37,40,-3,39
Brisbane,4203,6,10,5,13,33,42,-9,35
Western Sydn,4203,7,8,9,10,38,47,-9,33
Perth Glory,4203,8,10,2,15,37,50,-13,32
Wellington P,4203,9,5,6,16,31,55,-24,21
CC Mariners,4203,10,4,8,15,28,49,-21,20
Sydney FC,4204,1,21,4,3,66,23,43,67
N'castle Jet,4204,2,16,5,7,59,38,21,53
Melbourne C,4204,3,14,4,11,44,35,9,46
Melbourne V,4204,4,13,5,11,46,40,6,44
Adelaide Utd,4204,5,11,6,11,37,40,-3,39
Brisbane,4204,6,10,5,13,33,42,-9,35
Western Sydn,4204,7,8,9,10,38,47,-9,33
Perth Glory,4204,8,10,2,15,37,50,-13,32
Wellington P,4204,9,5,6,16,31,55,-24,21
CC Mariners,4204,10,4,8,15,28,49,-21,20
Sydney FC,4205,1,20,5,3,64,22,42,65
N'castle Jet,4205,2,15,5,8,57,38,19,50
Melbourne C,4205,3,15,4,10,44,33,11,49
Melbourne V,4205,4,13,6,10,45,38,7,45
Adelaide Utd,4205,5,11,6,11,37,40,-3,39
Brisbane,4205,6,10,5,13,33,42,-9,35
Western Sydn,4205,7,8,9,10,38,47,-9,33
Perth Glory,4205,8,10,2,15,37,50,-13,32
Wellington P,4205,9,5,6,16,31,55,-24,21
CC Mariners,4205,10,4,8,15,28,49,-21,20
Sydney FC,4206,1,20,5,3,65,23,42,65
N'castle Jet,4206,2,15,6,7,58,38,20,51
Melbourne C,4206,3,14,5,10,44,34,10,47
Melbourne V,4206,4,13,6,10,46,39,7,45
Adelaide Utd,4206,5,11,6,11,37,40,-3,39
Brisbane,4206,6,10,5,13,33,42,-9,35
Western Sydn,4206,7,8,9,10,38,47,-9,33
Perth Glory,4206,8,10,2,15,37,50,-13,32
Wellington P,4206,9,5,6,16,31,55,-24,21
CC Mariners,4206,10,4,8,15,28,49,-21,20
Sydney FC,4207,1,20,5,3,65,23,42,65
N'castle Jet,4207,2,16,5,7,60,38,22,53
Melbourne C,4207,3,14,4,11,44,36,8,46
Melbourne V,4207,4,13,6,10,46,39,7,45
Adelaide Utd,4207,5,11,6,11,37,40,-3,39
Brisbane,4207,6,10,5,13,33,42,-9,35
Western Sydn,4207,7,8,9,10,38,47,-9,33
Perth Glory,4207,8,10,2,15,37,50,-13,32
Wellington P,4207,9,5,6,16,31,55,-24,21
CC Mariners,4207,10,4,8,15,28,49,-21,20
Sydney FC,4208,1,20,4,4,64,23,41,64
N'castle Jet,4208,2,16,5,7,61,37,24,53
Melbourne V,4208,3,14,5,10,46,38,8,47
Melbourne C,4208,4,14,4,11,43,37,6,46
Adelaide Utd,4208,5,11,6,11,37,40,-3,39
Brisbane,4208,6,10,5,13,33,42,-9,35
Western Sydn,4208,7,8,9,10,38,47,-9,33
Perth Glory,4208,8,10,2,15,37,50,-13,32
Wellington P,4208,9,5,6,16,31,55,-24,21
CC Mariners,4208,10,4,8,15,28,49,-21,20
Sydney FC,4209,1,20,4,4,66,25,41,64
N'castle Jet,4209,2,16,5,7,59,38,21,53
Melbourne V,4209,3,14,5,10,48,40,8,47
Melbourne C,4209,4,14,4,11,44,35,9,46
Adelaide Utd,4209,5,11,6,11,37,40,-3,39
Brisbane,4209,6,10,5,13,33,42,-9,35
Western Sydn,4209,7,8,9,10,38,47,-9,33
Perth Glory,4209,8,10,2,15,37,50,-13,32
Wellington P,4209,9,5,6,16,31,55,-24,21
CC Mariners,4209,10,4,8,15,28,49,-21,20
Sydney FC,4210,1,20,5,3,64,22,42,65
N'castle Jet,4210,2,15,6,7,60,40,20,51
Melbourne C,4210,3,14,5,10,46,36,10,47
Melbourne V,4210,4,13,6,10,45,38,7,45
Adelaide Utd,4210,5,11,6,11,37,40,-3,39
Brisbane,4210,6,10,5,13,33,42,-9,35
Western Sydn,4210,7,8,9,10,38,47,-9,33
Perth Glory,4210,8,10,2,15,37,50,-13,32
Wellington P,4210,9,5,6,16,31,55,-24,21
CC Mariners,4210,10,4,8,15,28,49,-21,20
Sydney FC,4211,1,21,4,3,69,23,46,67
N'castle Jet,4211,2,15,5,8,57,38,19,50
Melbourne C,4211,3,15,4,10,44,33,11,49
Melbourne V,4211,4,13,5,11,46,43,3,44
Adelaide Utd,4211,5,11,6,11,37,40,-3,39
Brisbane,4211,6,10,5,13,33,42,-9,35
Western Sydn,4211,7,8,9,10,38,47,-9,33
Perth Glory,4211,8,10,2,15,37,50,-13,32
Wellington P,4211,9,5,6,16,31,55,-24,21
CC Mariners,4211,10,4,8,15,28,49,-21,20
Sydney FC,4212,1,20,4,4,64,23,41,64
N'castle Jet,4212,2,15,6,7,59,39,20,51
Melbourne C,4212,3,14,5,10,45,35,10,47
Melbourne V,4212,4,14,5,10,46,38,8,47
Adelaide Utd,4212,5,11,6,11,37,40,-3,39
Brisbane,4212,6,10,5,13,33,42,-9,35
Western Sydn,4212,7,8,9,10,38,47,-9,33
Perth Glory,4212,8,10,2,15,37,50,-13,32
Wellington P,4212,9,5,6,16,31,55,-24,21
CC Mariners,4212,10,4,8,15,28,49,-21,20
Sydney FC,4213,1,21,4,3,65,22,43,67
N'castle Jet,4213,2,15,6,7,59,39,20,51
Melbourne C,4213,3,14,5,10,45,35,10,47
Melbourne V,4213,4,13,5,11,45,39,6,44
Adelaide Utd,4213,5,11,6,11,37,40,-3,39
Brisbane,4213,6,10,5,13,33,42,-9,35
Western Sydn,4213,7,8,9,10,38,47,-9,33
Perth Glory,4213,8,10,2,15,37,50,-13,32
Wellington P,4213,9,5,6,16,31,55,-24,21
CC Mariners,4213,10,4,8,15,28,49,-21,20
Sydney FC,4214,1,20,4,4,65,25,40,64
N'castle Jet,4214,2,16,5,7,58,37,21,53
Melbourne V,4214,3,14,5,10,48,39,9,47
Melbourne C,4214,4,14,4,11,43,34,9,46
Adelaide Utd,4214,5,11,6,11,37,40,-3,39
Brisbane,4214,6,10,5,13,33,42,-9,35
Western Sydn,4214,7,8,9,10,38,47,-9,33
Perth Glory,4214,8,10,2,15,37,50,-13,32
Wellington P,4214,9,5,6,16,31,55,-24,21
CC Mariners,4214,10,4,8,15,28,49,-21,20
Sydney FC,4215,1,21,4,3,67,24,43,67
N'castle Jet,4215,2,16,5,7,59,37,22,53
Melbourne C,4215,3,14,4,11,43,35,8,46
Melbourne V,4215,4,13,5,11,47,41,6,44
Adelaide Utd,4215,5,11,6,11,37,40,-3,39
Brisbane,4215,6,10,5,13,33,42,-9,35
Western Sydn,4215,7,8,9,10,38,47,-9,33
Perth Glory,4215,8,10,2,15,37,50,-13,32
Wellington P,4215,9,5,6,16,31,55,-24,21
CC Mariners,4215,10,4,8,15,28,49,-21,20
Sydney FC,4216,1,20,4,4,65,24,41,64
N'castle Jet,4216,2,15,6,7,57,37,20,51
Melbourne C,4216,3,14,5,10,43,33,10,47
Melbourne V,4216,4,14,5,10,47,39,8,47
Adelaide Utd,4216,5,11,6,11,37,40,-3,39
Brisbane,4216,6,10,5,13,33,42,-9,35
Western Sydn,4216,7,8,9,10,38,47,-9,33
Perth Glory,4216,8,10,2,15,37,50,-13,32
Wellington P,4216,9,5,6,16,31,55,-24,21
CC Mariners,4216,10,4,8,15,28,49,-21,20
Sydney FC,4217,1,21,4,3,66,23,43,67
N'castle Jet,4217,2,16,5,7,61,38,23,53
Melbourne C,4217,3,14,4,11,44,37,7,46
Melbourne V,4217,4,13,5,11,46,40,6,44
Adelaide Utd,4217,5,11,6,11,37,40,-3,39
Brisbane,4217,6,10,5,13,33,42,-9,35
Western Sydn,4217,7,8,9,10,38,47,-9,33
Perth Glory,4217,8,10,2,15,37,50,-13,32
Wellington P,4217,9,5,6,16,31,55,-24,21
CC Mariners,4217,10,4,8,15,28,49,-21,20
Sydney FC,4218,1,20,5,3,65,23,42,65
N'castle Jet,4218,2,16,5,7,63,38,25,53
Melbourne C,4218,3,14,4,11,44,39,5,46
Melbourne V,4218,4,13,6,10,46,39,7,45
Adelaide Utd,4218,5,11,6,11,37,40,-3,39
Brisbane,4218,6,10,5,13,33,42,-9,35
Western Sydn,4218,7,8,9,10,38,47,-9,33
Perth Glory,4218,8,10,2,15,37,50,-13,32
Wellington P,4218,9,5,6,16,31,55,-24,21
CC Mariners,4218,10,4,8,15,28,49,-21,20
Sydney FC,4219,1,21,4,3,65,22,43,67
N'castle Jet,4219,2,15,6,7,57,37,20,51
Melbourne C,4219,3,14,5,10,43,33,10,47
Melbourne V,4219,4,13,5,11,45,39,6,44
Adelaide Utd,4219,5,11,6,11,37,40,-3,39
Brisbane,4219,6,10,5,13,33,42,-9,35
Western Sydn,4219,7,8,9,10,38,47,-9,33
Perth Glory,4219,8,10,2,15,37,50,-13,32
Wellington P,4219,9,5,6,16,31,55,-24,21
CC Mariners,4219,10,4,8,15,28,49,-21,20
Sydney FC,4220,1,21,4,3,66,23,43,67
N'castle Jet,4220,2,15,5,8,59,40,19,50
Melbourne C,4220,3,15,4,10,46,35,11,49
Melbourne V,4220,4,13,5,11,46,40,6,44
Adelaide Utd,4220,5,11,6,11,37,40,-3,39
Brisbane,4220,6,10,5,13,33,42,-9,35
Western Sydn,4220,7,8,9,10,38,47,-9,33
Perth Glory,4220,8,10,2,15,37,50,-13,32
Wellington P,4220,9,5,6,16,31,55,-24,21
CC Mariners,4220,10,4,8,15,28,49,-21,20
Sydney FC,4221,1,20,4,4,65,24,41,64
N'castle Jet,4221,2,16,5,7,62,39,23,53
Melbourne V,4221,3,14,5,10,47,39,8,47
Melbourne C,4221,4,14,4,11,45,38,7,46
Adelaide Utd,4221,5,11,6,11,37,40,-3,39
Brisbane,4221,6,10,5,13,33,42,-9,35
Western Sydn,4221,7,8,9,10,38,47,-9,33
Perth Glory,4221,8,10,2,15,37,50,-13,32
Wellington P,4221,9,5,6,16,31,55,-24,21
CC Mariners,4221,10,4,8,15,28,49,-21,20
Sydney FC,4222,1,21,4,3,67,22,45,67
N'castle Jet,4222,2,16,5,7,59,38,21,53
Melbourne C,4222,3,14,4,11,44,35,9,46
Melbourne V,4222,4,13,5,11,45,41,4,44
Adelaide Utd,4222,5,11,6,11,37,40,-3,39
Brisbane,4222,6,10,5,13,33,42,-9,35
Western Sydn,4222,7,8,9,10,38,47,-9,33
Perth Glory,4222,8,10,2,15,37,50,-13,32
Wellington P,4222,9,5,6,16,31,55,-24,21
CC Mariners,4222,10,4,8,15,28,49,-21,20
Sydney FC,4223,1,20,5,3,65,23,42,65
N'castle Jet,4223,2,16,5,7,59,37,22,53
Melbourne C,4223,3,14,4,11,43,35,8,46
Melbourne V,4223,4,13,6,10,46,39,7,45
Adelaide Utd,4223,5,11,6,11,37,40,-3,39
Brisbane,4223,6,10,5,13,33,42,-9,35
Western Sydn,4223,7,8,9,10,38,47,-9,33
Perth Glory,4223,8,10,2,15,37,50,-13,32
Wellington P,4223,9,5,6,16,31,55,-24,21
CC Mariners,4223,10,4,8,15,28,49,-21,20
Sydney FC,4224,1,21,4,3,66,23,43,67
N'castle Jet,4224,2,16,5,7,59,37,22,53
Melbourne C,4224,3,14,4,11,43,35,8,46
Melbourne V,4224,4,13,5,11,46,40,6,44
Adelaide Utd,4224,5,11,6,11,37,40,-3,39
Brisbane,4224,6,10,5,13,33,42,-9,35
Western Sydn,4224,7,8,9,10,38,47,-9,33
Perth Glory,4224,8,10,2,15,37,50,-13,32
Wellington P,4224,9,5,6,16,31,55,-24,21
CC Mariners,4224,10,4,8,15,28,49,-21,20
Sydney FC,4225,1,20,5,3,66,24,42,65
N'castle Jet,4225,2,16,5,7,59,38,21,53
Melbourne C,4225,3,14,4,11,44,35,9,46
Melbourne V,4225,4,13,6,10,47,40,7,45
Adelaide Utd,4225,5,11,6,11,37,40,-3,39
Brisbane,4225,6,10,5,13,33,42,-9,35
Western Sydn,4225,7,8,9,10,38,47,-9,33
Perth Glory,4225,8,10,2,15,37,50,-13,32
Wellington P,4225,9,5,6,16,31,55,-24,21
CC Mariners,4225,10,4,8,15,28,49,-21,20
Sydney FC,4226,1,21,4,3,65,22,43,67
N'castle Jet,4226,2,15,6,7,58,38,20,51
Melbourne C,4226,3,14,5,10,44,34,10,47
Melbourne V,4226,4,13,5,11,45,39,6,44
Adelaide Utd,4226,5,11,6,11,37,40,-3,39
Brisbane,4226,6,10,5,13,33,42,-9,35
Western Sydn,4226,7,8,9,10,38,47,-9,33
Perth Glory,4226,8,10,2,15,37,50,-13,32
Wellington P,4226,9,5,6,16,31,55,-24,21
CC Mariners,4226,10,4,8,15,28,49,-21,20
Sydney FC,4227,1,20,4,4,66,25,41,64
N'castle Jet,4227,2,15,6,7,58,38,20,51
Melbourne C,4227,3,14,5,10,44,34,10,47
Melbourne V,4227,4,14,5,10,48,40,8,47
Adelaide Utd,4227,5,11,6,11,37,40,-3,39
Brisbane,4227,6,10,5,13,33,42,-9,35
Western Sydn,4227,7,8,9,10,38,47,-9,33
Perth Glory,4227,8,10,2,15,37,50,-13,32
Wellington P,4227,9,5,6,16,31,55,-24,21
CC Mariners,4227,10,4,8,15,28,49,-21,20
Sydney FC,4228,1,20,5,3,64,22,42,65
N'castle Jet,4228,2,15,5,8,58,39,19,50
Melbourne C,4228,3,15,4,10,45,34,11,49
Melbourne V,4228,4,13,6,10,45,38,7,45
Adelaide Utd,4228,5,11,6,11,37,40,-3,39
Brisbane,4228,6,10,5,13,33,42,-9,35
Western Sydn,4228,7,8,9,10,38,47,-9,33
Perth Glory,4228,8,10,2,15,37,50,-13,32
Wellington P,4228,9,5,6,16,31,55,-24,21
CC Mariners,4228,10,4,8,15,28,49,-21,20
Sydney FC,4229,1,21,4,3,67,23,44,67
N'castle Jet,4229,2,16,5,7,59,38,21,53
Melbourne C,4229,3,14,4,11,44,35,9,46
Melbourne V,4229,4,13,5,11,46,41,5,44
Adelaide Utd,4229,5,11,6,11,37,40,-3,39
Brisbane,4229,6,10,5,13,33,42,-9,35
Western Sydn,4229,7,8,9,10,38,47,-9,33
Perth Glory,4229,8,10,2,15,37,50,-13,32
Wellington P,4229,9,5,6,16,31,55,-24,21
CC Mariners,4229,10,4,8,15,28,49,-21,20
Sydney FC,4230,1,20,4,4,64,23,41,64
N'castle Jet,4230,2,16,5,7,59,37,22,53
Melbourne V,4230,3,14,5,10,46,38,8,47
Melbourne C,4230,4,14,4,11,43,35,8,46
Adelaide Utd,4230,5,11,6,11,37,40,-3,39
Brisbane,4230,6,10,5,13,33,42,-9,35
Western Sydn,4230,7,8,9,10,38,47,-9,33
Perth Glory,4230,8,10,2,15,37,50,-13,32
Wellington P,4230,9,5,6,16,31,55,-24,21
CC Mariners,4230,10,4,8,15,28,49,-21,20
Sydney FC,4231,1,20,5,3,65,23,42,65
N'castle Jet,4231,2,15,5,8,57,38,19,50
Melbourne C,4231,3,15,4,10,44,33,11,49
Melbourne V,4231,4,13,6,10,46,39,7,45
Adelaide Utd,4231,5,11,6,11,37,40,-3,39
Brisbane,4231,6,10,5,13,33,42,-9,35
Western Sydn,4231,7,8,9,10,38,47,-9,33
Perth Glory,4231,8,10,2,15,37,50,-13,32
Wellington P,4231,9,5,6,16,31,55,-24,21
CC Mariners,4231,10,4,8,15,28,49,-21,20
Sydney FC,4232,1,20,5,3,66,24,42,65
N'castle Jet,4232,2,15,5,8,57,38,19,50
Melbourne C,4232,3,15,4,10,44,33,11,49
Melbourne V,4232,4,13,6,10,47,40,7,45
Adelaide Utd,4232,5,11,6,11,37,40,-3,39
Brisbane,4232,6,10,5,13,33,42,-9,35
Western Sydn,4232,7,8,9,10,38,47,-9,33
Perth Glory,4232,8,10,2,15,37,50,-13,32
Wellington P,4232,9,5,6,16,31,55,-24,21
CC Mariners,4232,10,4,8,15,28,49,-21,20
Sydney FC,4233,1,21,4,3,66,23,43,67
N'castle Jet,4233,2,15,6,7,57,37,20,51
Melbourne C,4233,3,14,5,10,43,33,10,47
Melbourne V,4233,4,13,5,11,46,40,6,44
Adelaide Utd,4233,5,11,6,11,37,40,-3,39
Brisbane,4233,6,10,5,13,33,42,-9,35
Western Sydn,4233,7,8,9,10,38,47,-9,33
Perth Glory,4233,8,10,2,15,37,50,-13,32
Wellington P,4233,9,5,6,16,31,55,-24,21
CC Mariners,4233,10,4,8,15,28,49,-21,20
Sydney FC,4234,1,20,5,3,66,24,42,65
N'castle Jet,4234,2,16,5,7,61,37,24,53
Melbourne C,4234,3,14,4,11,43,37,6,46
Melbourne V,4234,4,13,6,10,47,40,7,45
Adelaide Utd,4234,5,11,6,11,37,40,-3,39
Brisbane,4234,6,10,5,13,33,42,-9,35
Western Sydn,4234,7,8,9,10,38,47,-9,33
Perth Glory,4234,8,10,2,15,37,50,-13,32
Wellington P,4234,9,5,6,16,31,55,-24,21
CC Mariners,4234,10,4,8,15,28,49,-21,20
Sydney FC,4235,1,21,4,3,67,22,45,67
N'castle Jet,4235,2,15,5,8,57,40,17,50
Melbourne C,4235,3,15,4,10,46,33,13,49
Melbourne V,4235,4,13,5,11,45,41,4,44
Adelaide Utd,4235,5,11,6,11,37,40,-3,39
Brisbane,4235,6,10,5,13,33,42,-9,35
Western Sydn,4235,7,8,9,10,38,47,-9,33
Perth Glory,4235,8,10,2,15,37,50,-13,32
Wellington P,4235,9,5,6,16,31,55,-24,21
CC Mariners,4235,10,4,8,15,28,49,-21,20
Sydney FC,4236,1,20,5,3,64,22,42,65
N'castle Jet,4236,2,16,5,7,60,38,22,53
Melbourne C,4236,3,14,4,11,44,36,8,46
Melbourne V,4236,4,13,6,10,45,38,7,45
Adelaide Utd,4236,5,11,6,11,37,40,-3,39
Brisbane,4236,6,10,5,13,33,42,-9,35
Western Sydn,4236,7,8,9,10,38,47,-9,33
Perth Glory,4236,8,10,2,15,37,50,-13,32
Wellington P,4236,9,5,6,16,31,55,-24,21
CC Mariners,4236,10,4,8,15,28,49,-21,20
Sydney FC,4237,1,20,5,3,65,23,42,65
N'castle Jet,4237,2,15,6,7,57,37,20,51
Melbourne C,4237,3,14,5,10,43,33,10,47
Melbourne V,4237,4,13,6,10,46,39,7,45
Adelaide Utd,4237,5,11,6,11,37,40,-3,39
Brisbane,4237,6,10,5,13,33,42,-9,35
Western Sydn,4237,7,8,9,10,38,47,-9,33
Perth Glory,4237,8,10,2,15,37,50,-13,32
Wellington P,4237,9,5,6,16,31,55,-24,21
CC Mariners,4237,10,4,8,15,28,49,-21,20
Sydney FC,4238,1,21,4,3,66,23,43,67
N'castle Jet,4238,2,15,6,7,59,39,20,51
Melbourne C,4238,3,14,5,10,45,35,10,47
Melbourne V,4238,4,13,5,11,46,40,6,44
Adelaide Utd,4238,5,11,6,11,37,40,-3,39
Brisbane,4238,6,10,5,13,33,42,-9,35
Western Sydn,4238,7,8,9,10,38,47,-9,33
Perth Glory,4238,8,10,2,15,37,50,-13,32
Wellington P,4238,9,5,6,16,31,55,-24,21
CC Mariners,4238,10,4,8,15,28,49,-21,20
Sydney FC,4239,1,21,4,3,69,23,46,67
N'castle Jet,4239,2,15,5,8,58,40,18,50
Melbourne C,4239,3,15,4,10,46,34,12,49
Melbourne V,4239,4,13,5,11,46,43,3,44
Adelaide Utd,4239,5,11,6,11,37,40,-3,39
Brisbane,4239,6,10,5,13,33,42,-9,35
Western Sydn,4239,7,8,9,10,38,47,-9,33
Perth Glory,4239,8,10,2,15,37,50,-13,32
Wellington P,4239,9,5,6,16,31,55,-24,21
CC Mariners,4239,10,4,8,15,28,49,-21,20
Sydney FC,4240,1,21,4,3,67,23,44,67
N'castle Jet,4240,2,16,5,7,60,37,23,53
Melbourne C,4240,3,14,4,11,43,36,7,46
Melbourne V,4240,4,13,5,11,46,41,5,44
Adelaide Utd,4240,5,11,6,11,37,40,-3,39
Brisbane,4240,6,10,5,13,33,42,-9,35
Western Sydn,4240,7,8,9,10,38,47,-9,33
Perth Glory,4240,8,10,2,15,37,50,-13,32
Wellington P,4240,9,5,6,16,31,55,-24,21
CC Mariners,4240,10,4,8,15,28,49,-21,20
Sydney FC,4241,1,20,4,4,65,24,41,64
N'castle Jet,4241,2,16,5,7,61,39,22,53
Melbourne V,4241,3,14,5,10,47,39,8,47
Melbourne C,4241,4,14,4,11,45,37,8,46
Adelaide Utd,4241,5,11,6,11,37,40,-3,39
Brisbane,4241,6,10,5,13,33,42,-9,35
Western Sydn,4241,7,8,9,10,38,47,-9,33
Perth Glory,4241,8,10,2,15,37,50,-13,32
Wellington P,4241,9,5,6,16,31,55,-24,21
CC Mariners,4241,10,4,8,15,28,49,-21,20
Sydney FC,4242,1,21,4,3,68,25,43,67
N'castle Jet,4242,2,15,6,7,59,39,20,51
Melbourne C,4242,3,14,5,10,45,35,10,47
Melbourne V,4242,4,13,5,11,48,42,6,44
Adelaide Utd,4242,5,11,6,11,37,40,-3,39
Brisbane,4242,6,10,5,13,33,42,-9,35
Western Sydn,4242,7,8,9,10,38,47,-9,33
Perth Glory,4242,8,10,2,15,37,50,-13,32
Wellington P,4242,9,5,6,16,31,55,-24,21
CC Mariners,4242,10,4,8,15,28,49,-21,20
Sydney FC,4243,1,20,5,3,65,23,42,65
N'castle Jet,4243,2,16,5,7,58,37,21,53
Melbourne C,4243,3,14,4,11,43,34,9,46
Melbourne V,4243,4,13,6,10,46,39,7,45
Adelaide Utd,4243,5,11,6,11,37,40,-3,39
Brisbane,4243,6,10,5,13,33,42,-9,35
Western Sydn,4243,7,8,9,10,38,47,-9,33
Perth Glory,4243,8,10,2,15,37,50,-13,32
Wellington P,4243,9,5,6,16,31,55,-24,21
CC Mariners,4243,10,4,8,15,28,49,-21,20
Sydney FC,4244,1,20,5,3,65,23,42,65
N'castle Jet,4244,2,15,5,8,57,39,18,50
Melbourne C,4244,3,15,4,10,45,33,12,49
Melbourne V,4244,4,13,6,10,46,39,7,45
Adelaide Utd,4244,5,11,6,11,37,40,-3,39
Brisbane,4244,6,10,5,13,33,42,-9,35
Western Sydn,4244,7,8,9,10,38,47,-9,33
Perth Glory,4244,8,10,2,15,37,50,-13,32
Wellington P,4244,9,5,6,16,31,55,-24,21
CC Mariners,4244,10,4,8,15,28,49,-21,20
Sydney FC,4245,1,20,5,3,65,23,42,65
N'castle Jet,4245,2,15,6,7,58,38,20,51
Melbourne C,4245,3,14,5,10,44,34,10,47
Melbourne V,4245,4,13,6,10,46,39,7,45
Adelaide Utd,4245,5,11,6,11,37,40,-3,39
Brisbane,4245,6,10,5,13,33,42,-9,35
Western Sydn,4245,7,8,9,10,38,47,-9,33
Perth Glory,4245,8,10,2,15,37,50,-13,32
Wellington P,4245,9,5,6,16,31,55,-24,21
CC Mariners,4245,10,4,8,15,28,49,-21,20
Sydney FC,4246,1,21,4,3,66,23,43,67
N'castle Jet,4246,2,16,5,7,60,38,22,53
Melbourne C,4246,3,14,4,11,44,36,8,46
Melbourne V,4246,4,13,5,11,46,40,6,44
Adelaide Utd,4246,5,11,6,11,37,40,-3,39
Brisbane,4246,6,10,5,13,33,42,-9,35
Western Sydn,4246,7,8,9,10,38,47,-9,33
Perth Glory,4246,8,10,2,15,37,50,-13,32
Wellington P,4246,9,5,6,16,31,55,-24,21
CC Mariners,4246,10,4,8,15,28,49,-21,20
Sydney FC,4247,1,21,4,3,65,22,43,67
N'castle Jet,4247,2,16,5,7,60,37,23,53
Melbourne C,4247,3,14,4,11,43,36,7,46
Melbourne V,4247,4,13,5,11,45,39,6,44
Adelaide Utd,4247,5,11,6,11,37,40,-3,39
Brisbane,4247,6,10,5,13,33,42,-9,35
Western Sydn,4247,7,8,9,10,38,47,-9,33
Perth Glory,4247,8,10,2,15,37,50,-13,32
Wellington P,4247,9,5,6,16,31,55,-24,21
CC Mariners,4247,10,4,8,15,28,49,-21,20
Sydney FC,4248,1,20,4,4,66,25,41,64
N'castle Jet,4248,2,15,5,8,58,39,19,50
Melbourne C,4248,3,15,4,10,45,34,11,49
Melbourne V,4248,4,14,5,10,48,40,8,47
Adelaide Utd,4248,5,11,6,11,37,40,-3,39
Brisbane,4248,6,10,5,13,33,42,-9,35
Western Sydn,4248,7,8,9,10,38,47,-9,33
Perth Glory,4248,8,10,2,15,37,50,-13,32
Wellington P,4248,9,5,6,16,31,55,-24,21
CC Mariners,4248,10,4,8,15,28,49,-21,20
Sydney FC,4249,1,21,4,3,66,23,43,67
N'castle Jet,4249,2,16,5,7,59,38,21,53
Melbourne C,4249,3,14,4,11,44,35,9,46
Melbourne V,4249,4,13,5,11,46,40,6,44
Adelaide Utd,4249,5,11,6,11,37,40,-3,39
Brisbane,4249,6,10,5,13,33,42,-9,35
Western Sydn,4249,7,8,9,10,38,47,-9,33
Perth Glory,4249,8,10,2,15,37,50,-13,32
Wellington P,4249,9,5,6,16,31,55,-24,21
CC Mariners,4249,10,4,8,15,28,49,-21,20
Sydney FC,4250,1,20,4,4,64,23,41,64
N'castle Jet,4250,2,15,6,7,57,37,20,51
Melbourne C,4250,3,14,5,10,43,33,10,47
Melbourne V,4250,4,14,5,10,46,38,8,47
Adelaide Utd,4250,5,11,6,11,37,40,-3,39
Brisbane,4250,6,10,5,13,33,42,-9,35
Western Sydn,4250,7,8,9,10,38,47,-9,33
Perth Glory,4250,8,10,2,15,37,50,-13,32
Wellington P,4250,9,5,6,16,31,55,-24,21
CC Mariners,4250,10,4,8,15,28,49,-21,20
Sydney FC,4251,1,21,4,3,68,23,45,67
N'castle Jet,4251,2,16,5,7,58,37,21,53
Melbourne C,4251,3,14,4,11,43,34,9,46
Melbourne V,4251,4,13,5,11,46,42,4,44
Adelaide Utd,4251,5,11,6,11,37,40,-3,39
Brisbane,4251,6,10,5,13,33,42,-9,35
Western Sydn,4251,7,8,9,10,38,47,-9,33
Perth Glory,4251,8,10,2,15,37,50,-13,32
Wellington P,4251,9,5,6,16,31,55,-24,21
CC Mariners,4251,10,4,8,15,28,49,-21,20
Sydney FC,4252,1,21,4,3,65,22,43,67
N'castle Jet,4252,2,15,6,7,59,39,20,51
Melbourne C,4252,3,14,5,10,45,35,10,47
Melbourne V,4252,4,13,5,11,45,39,6,44
Adelaide Utd,4252,5,11,6,11,37,40,-3,39
Brisbane,4252,6,10,5,13,33,42,-9,35
Western Sydn,4252,7,8,9,10,38,47,-9,33
Perth Glory,4252,8,10,2,15,37,50,-13,32
Wellington P,4252,9,5,6,16,31,55,-24,21
CC Mariners,4252,10,4,8,15,28,49,-21,20
Sydney FC,4253,1,21,4,3,68,23,45,67
N'castle Jet,4253,2,16,5,7,58,37,21,53
Melbourne C,4253,3,14,4,11,43,34,9,46
Melbourne V,4253,4,13,5,11,46,42,4,44
Adelaide Utd,4253,5,11,6,11,37,40,-3,39
Brisbane,4253,6,10,5,13,33,42,-9,35
Western Sydn,4253,7,8,9,10,38,47,-9,33
Perth Glory,4253,8,10,2,15,37,50,-13,32
Wellington P,4253,9,5,6,16,31,55,-24,21
CC Mariners,4253,10,4,8,15,28,49,-21,20
Sydney FC,4254,1,21,4,3,65,22,43,67
N'castle Jet,4254,2,15,6,7,58,38,20,51
Melbourne C,4254,3,14,5,10,44,34,10,47
Melbourne V,4254,4,13,5,11,45,39,6,44
Adelaide Utd,4254,5,11,6,11,37,40,-3,39
Brisbane,4254,6,10,5,13,33,42,-9,35
Western Sydn,4254,7,8,9,10,38,47,-9,33
Perth Glory,4254,8,10,2,15,37,50,-13,32
Wellington P,4254,9,5,6,16,31,55,-24,21
CC Mariners,4254,10,4,8,15,28,49,-21,20
Sydney FC,4255,1,21,4,3,66,23,43,67
N'castle Jet,4255,2,16,5,7,58,37,21,53
Melbourne C,4255,3,14,4,11,43,34,9,46
Melbourne V,4255,4,13,5,11,46,40,6,44
Adelaide Utd,4255,5,11,6,11,37,40,-3,39
Brisbane,4255,6,10,5,13,33,42,-9,35
Western Sydn,4255,7,8,9,10,38,47,-9,33
Perth Glory,4255,8,10,2,15,37,50,-13,32
Wellington P,4255,9,5,6,16,31,55,-24,21
CC Mariners,4255,10,4,8,15,28,49,-21,20
Sydney FC,4256,1,21,4,3,67,22,45,67
N'castle Jet,4256,2,16,5,7,59,37,22,53
Melbourne C,4256,3,14,4,11,43,35,8,46
Melbourne V,4256,4,13,5,11,45,41,4,44
Adelaide Utd,4256,5,11,6,11,37,40,-3,39
Brisbane,4256,6,10,5,13,33,42,-9,35
Western Sydn,4256,7,8,9,10,38,47,-9,33
Perth Glory,4256,8,10,2,15,37,50,-13,32
Wellington P,4256,9,5,6,16,31,55,-24,21
CC Mariners,4256,10,4,8,15,28,49,-21,20
Sydney FC,4257,1,21,4,3,66,22,44,67
N'castle Jet,4257,2,15,5,8,57,39,18,50
Melbourne C,4257,3,15,4,10,45,33,12,49
Melbourne V,4257,4,13,5,11,45,40,5,44
Adelaide Utd,4257,5,11,6,11,37,40,-3,39
Brisbane,4257,6,10,5,13,33,42,-9,35
Western Sydn,4257,7,8,9,10,38,47,-9,33
Perth Glory,4257,8,10,2,15,37,50,-13,32
Wellington P,4257,9,5,6,16,31,55,-24,21
CC Mariners,4257,10,4,8,15,28,49,-21,20
Sydney FC,4258,1,20,4,4,64,24,40,64
N'castle Jet,4258,2,16,5,7,59,37,22,53
Melbourne V,4258,3,14,5,10,47,38,9,47
Melbourne C,4258,4,14,4,11,43,35,8,46
Adelaide Utd,4258,5,11,6,11,37,40,-3,39
Brisbane,4258,6,10,5,13,33,42,-9,35
Western Sydn,4258,7,8,9,10,38,47,-9,33
Perth Glory,4258,8,10,2,15,37,50,-13,32
Wellington P,4258,9,5,6,16,31,55,-24,21
CC Mariners,4258,10,4,8,15,28,49,-21,20
Sydney FC,4259,1,20,4,4,64,25,39,64
N'castle Jet,4259,2,15,5,8,57,38,19,50
Melbourne C,4259,3,15,4,10,44,33,11,49
Melbourne V,4259,4,14,5,10,48,38,10,47
Adelaide Utd,4259,5,11,6,11,37,40,-3,39
Brisbane,4259,6,10,5,13,33,42,-9,35
Western Sydn,4259,7,8,9,10,38,47,-9,33
Perth Glory,4259,8,10,2,15,37,50,-13,32
Wellington P,4259,9,5,6,16,31,55,-24,21
CC Mariners,4259,10,4,8,15,28,49,-21,20
Sydney FC,4260,1,21,4,3,66,23,43,67
N'castle Jet,4260,2,16,5,7,59,38,21,53
Melbourne C,4260,3,14,4,11,44,35,9,46
Melbourne V,4260,4,13,5,11,46,40,6,44
Adelaide Utd,4260,5,11,6,11,37,40,-3,39
Brisbane,4260,6,10,5,13,33,42,-9,35
Western Sydn,4260,7,8,9,10,38,47,-9,33
Perth Glory,4260,8,10,2,15,37,50,-13,32
Wellington P,4260,9,5,6,16,31,55,-24,21
CC Mariners,4260,10,4,8,15,28,49,-21,20
Sydney FC,4261,1,21,4,3,68,22,46,67
N'castle Jet,4261,2,15,5,8,58,39,19,50
Melbourne C,4261,3,15,4,10,45,34,11,49
Melbourne V,4261,4,13,5,11,45,42,3,44
Adelaide Utd,4261,5,11,6,11,37,40,-3,39
Brisbane,4261,6,10,5,13,33,42,-9,35
Western Sydn,4261,7,8,9,10,38,47,-9,33
Perth Glory,4261,8,10,2,15,37,50,-13,32
Wellington P,4261,9,5,6,16,31,55,-24,21
CC Mariners,4261,10,4,8,15,28,49,-21,20
Sydney FC,4262,1,21,4,3,69,23,46,67
N'castle Jet,4262,2,16,5,7,61,39,22,53
Melbourne C,4262,3,14,4,11,45,37,8,46
Melbourne V,4262,4,13,5,11,46,43,3,44
Adelaide Utd,4262,5,11,6,11,37,40,-3,39
Brisbane,4262,6,10,5,13,33,42,-9,35
Western Sydn,4262,7,8,9,10,38,47,-9,33
Perth Glory,4262,8,10,2,15,37,50,-13,32
Wellington P,4262,9,5,6,16,31,55,-24,21
CC Mariners,4262,10,4,8,15,28,49,-21,20
Sydney FC,4263,1,21,4,3,67,23,44,67
N'castle Jet,4263,2,16,5,7,60,39,21,53
Melbourne C,4263,3,14,4,11,45,36,9,46
Melbourne V,4263,4,13,5,11,46,41,5,44
Adelaide Utd,4263,5,11,6,11,37,40,-3,39
Brisbane,4263,6,10,5,13,33,42,-9,35
Western Sydn,4263,7,8,9,10,38,47,-9,33
Perth Glory,4263,8,10,2,15,37,50,-13,32
Wellington P,4263,9,5,6,16,31,55,-24,21
CC Mariners,4263,10,4,8,15,28,49,-21,20
Sydney FC,4264,1,21,4,3,68,25,43,67
N'castle Jet,4264,2,15,5,8,61,42,19,50
Melbourne C,4264,3,15,4,10,48,37,11,49
Melbourne V,4264,4,13,5,11,48,42,6,44
Adelaide Utd,4264,5,11,6,11,37,40,-3,39
Brisbane,4264,6,10,5,13,33,42,-9,35
Western Sydn,4264,7,8,9,10,38,47,-9,33
Perth Glory,4264,8,10,2,15,37,50,-13,32
Wellington P,4264,9,5,6,16,31,55,-24,21
CC Mariners,4264,10,4,8,15,28,49,-21,20
Sydney FC,4265,1,20,5,3,64,22,42,65
N'castle Jet,4265,2,16,5,7,58,37,21,53
Melbourne C,4265,3,14,4,11,43,34,9,46
Melbourne V,4265,4,13,6,10,45,38,7,45
Adelaide Utd,4265,5,11,6,11,37,40,-3,39
Brisbane,4265,6,10,5,13,33,42,-9,35
Western Sydn,4265,7,8,9,10,38,47,-9,33
Perth Glory,4265,8,10,2,15,37,50,-13,32
Wellington P,4265,9,5,6,16,31,55,-24,21
CC Mariners,4265,10,4,8,15,28,49,-21,20
Sydney FC,4266,1,20,4,4,64,24,40,64
N'castle Jet,4266,2,15,5,8,58,39,19,50
Melbourne C,4266,3,15,4,10,45,34,11,49
Melbourne V,4266,4,14,5,10,47,38,9,47
Adelaide Utd,4266,5,11,6,11,37,40,-3,39
Brisbane,4266,6,10,5,13,33,42,-9,35
Western Sydn,4266,7,8,9,10,38,47,-9,33
Perth Glory,4266,8,10,2,15,37,50,-13,32
Wellington P,4266,9,5,6,16,31,55,-24,21
CC Mariners,4266,10,4,8,15,28,49,-21,20
Sydney FC,4267,1,21,4,3,66,23,43,67
N'castle Jet,4267,2,15,5,8,57,38,19,50
Melbourne C,4267,3,15,4,10,44,33,11,49
Melbourne V,4267,4,13,5,11,46,40,6,44
Adelaide Utd,4267,5,11,6,11,37,40,-3,39
Brisbane,4267,6,10,5,13,33,42,-9,35
Western Sydn,4267,7,8,9,10,38,47,-9,33
Perth Glory,4267,8,10,2,15,37,50,-13,32
Wellington P,4267,9,5,6,16,31,55,-24,21
CC Mariners,4267,10,4,8,15,28,49,-21,20
Sydney FC,4268,1,21,4,3,65,22,43,67
N'castle Jet,4268,2,15,6,7,60,40,20,51
Melbourne C,4268,3,14,5,10,46,36,10,47
Melbourne V,4268,4,13,5,11,45,39,6,44
Adelaide Utd,4268,5,11,6,11,37,40,-3,39
Brisbane,4268,6,10,5,13,33,42,-9,35
Western Sydn,4268,7,8,9,10,38,47,-9,33
Perth Glory,4268,8,10,2,15,37,50,-13,32
Wellington P,4268,9,5,6,16,31,55,-24,21
CC Mariners,4268,10,4,8,15,28,49,-21,20
Sydney FC,4269,1,21,4,3,67,23,44,67
N'castle Jet,4269,2,15,5,8,58,39,19,50
Melbourne C,4269,3,15,4,10,45,34,11,49
Melbourne V,4269,4,13,5,11,46,41,5,44
Adelaide Utd,4269,5,11,6,11,37,40,-3,39
Brisbane,4269,6,10,5,13,33,42,-9,35
Western Sydn,4269,7,8,9,10,38,47,-9,33
Perth Glory,4269,8,10,2,15,37,50,-13,32
Wellington P,4269,9,5,6,16,31,55,-24,21
CC Mariners,4269,10,4,8,15,28,49,-21,20
Sydney FC,4270,1,21,4,3,66,23,43,67
N'castle Jet,4270,2,16,5,7,61,38,23,53
Melbourne C,4270,3,14,4,11,44,37,7,46
Melbourne V,4270,4,13,5,11,46,40,6,44
Adelaide Utd,4270,5,11,6,11,37,40,-3,39
Brisbane,4270,6,10,5,13,33,42,-9,35
Western Sydn,4270,7,8,9,10,38,47,-9,33
Perth Glory,4270,8,10,2,15,37,50,-13,32
Wellington P,4270,9,5,6,16,31,55,-24,21
CC Mariners,4270,10,4,8,15,28,49,-21,20
Sydney FC,4271,1,20,5,3,64,22,42,65
N'castle Jet,4271,2,16,5,7,59,38,21,53
Melbourne C,4271,3,14,4,11,44,35,9,46
Melbourne V,4271,4,13,6,10,45,38,7,45
Adelaide Utd,4271,5,11,6,11,37,40,-3,39
Brisbane,4271,6,10,5,13,33,42,-9,35
Western Sydn,4271,7,8,9,10,38,47,-9,33
Perth Glory,4271,8,10,2,15,37,50,-13,32
Wellington P,4271,9,5,6,16,31,55,-24,21
CC Mariners,4271,10,4,8,15,28,49,-21,20
Sydney FC,4272,1,20,4,4,64,23,41,64
N'castle Jet,4272,2,15,6,7,59,39,20,51
Melbourne C,4272,3,14,5,10,45,35,10,47
Melbourne V,4272,4,14,5,10,46,38,8,47
Adelaide Utd,4272,5,11,6,11,37,40,-3,39
Brisbane,4272,6,10,5,13,33,42,-9,35
Western Sydn,4272,7,8,9,10,38,47,-9,33
Perth Glory,4272,8,10,2,15,37,50,-13,32
Wellington P,4272,9,5,6,16,31,55,-24,21
CC Mariners,4272,10,4,8,15,28,49,-21,20
Sydney FC,4273,1,21,4,3,67,22,45,67
N'castle Jet,4273,2,16,5,7,60,39,21,53
Melbourne C,4273,3,14,4,11,45,36,9,46
Melbourne V,4273,4,13,5,11,45,41,4,44
Adelaide Utd,4273,5,11,6,11,37,40,-3,39
Brisbane,4273,6,10,5,13,33,42,-9,35
Western Sydn,4273,7,8,9,10,38,47,-9,33
Perth Glory,4273,8,10,2,15,37,50,-13,32
Wellington P,4273,9,5,6,16,31,55,-24,21
CC Mariners,4273,10,4,8,15,28,49,-21,20
Sydney FC,4274,1,20,5,3,66,24,42,65
N'castle Jet,4274,2,16,5,7,58,37,21,53
Melbourne C,4274,3,14,4,11,43,34,9,46
Melbourne V,4274,4,13,6,10,47,40,7,45
Adelaide Utd,4274,5,11,6,11,37,40,-3,39
Brisbane,4274,6,10,5,13,33,42,-9,35
Western Sydn,4274,7,8,9,10,38,47,-9,33
Perth Glory,4274,8,10,2,15,37,50,-13,32
Wellington P,4274,9,5,6,16,31,55,-24,21
CC Mariners,4274,10,4,8,15,28,49,-21,20
Sydney FC,4275,1,20,4,4,64,23,41,64
N'castle Jet,4275,2,15,5,8,57,38,19,50
Melbourne C,4275,3,15,4,10,44,33,11,49
Melbourne V,4275,4,14,5,10,46,38,8,47
Adelaide Utd,4275,5,11,6,11,37,40,-3,39
Brisbane,4275,6,10,5,13,33,42,-9,35
Western Sydn,4275,7,8,9,10,38,47,-9,33
Perth Glory,4275,8,10,2,15,37,50,-13,32
Wellington P,4275,9,5,6,16,31,55,-24,21
CC Mariners,4275,10,4,8,15,28,49,-21,20
Sydney FC,4276,1,21,4,3,66,22,44,67
N'castle Jet,4276,2,15,6,7,57,37,20,51
Melbourne C,4276,3,14,5,10,43,33,10,47
Melbourne V,4276,4,13,5,11,45,40,5,44
Adelaide Utd,4276,5,11,6,11,37,40,-3,39
Brisbane,4276,6,10,5,13,33,42,-9,35
Western Sydn,4276,7,8,9,10,38,47,-9,33
Perth Glory,4276,8,10,2,15,37,50,-13,32
Wellington P,4276,9,5,6,16,31,55,-24,21
CC Mariners,4276,10,4,8,15,28,49,-21,20
Sydney FC,4277,1,21,4,3,65,22,43,67
N'castle Jet,4277,2,15,6,7,58,38,20,51
Melbourne C,4277,3,14,5,10,44,34,10,47
Melbourne V,4277,4,13,5,11,45,39,6,44
Adelaide Utd,4277,5,11,6,11,37,40,-3,39
Brisbane,4277,6,10,5,13,33,42,-9,35
Western Sydn,4277,7,8,9,10,38,47,-9,33
Perth Glory,4277,8,10,2,15,37,50,-13,32
Wellington P,4277,9,5,6,16,31,55,-24,21
CC Mariners,4277,10,4,8,15,28,49,-21,20
Sydney FC,4278,1,21,4,3,66,22,44,67
N'castle Jet,4278,2,16,5,7,58,37,21,53
Melbourne C,4278,3,14,4,11,43,34,9,46
Melbourne V,4278,4,13,5,11,45,40,5,44
Adelaide Utd,4278,5,11,6,11,37,40,-3,39
Brisbane,4278,6,10,5,13,33,42,-9,35
Western Sydn,4278,7,8,9,10,38,47,-9,33
Perth Glory,4278,8,10,2,15,37,50,-13,32
Wellington P,4278,9,5,6,16,31,55,-24,21
CC Mariners,4278,10,4,8,15,28,49,-21,20
Sydney FC,4279,1,20,4,4,65,24,41,64
N'castle Jet,4279,2,15,5,8,58,39,19,50
Melbourne C,4279,3,15,4,10,45,34,11,49
Melbourne V,4279,4,14,5,10,47,39,8,47
Adelaide Utd,4279,5,11,6,11,37,40,-3,39
Brisbane,4279,6,10,5,13,33,42,-9,35
Western Sydn,4279,7,8,9,10,38,47,-9,33
Perth Glory,4279,8,10,2,15,37,50,-13,32
Wellington P,4279,9,5,6,16,31,55,-24,21
CC Mariners,4279,10,4,8,15,28,49,-21,20
Sydney FC,4280,1,21,4,3,65,22,43,67
N'castle Jet,4280,2,15,6,7,58,38,20,51
Melbourne C,4280,3,14,5,10,44,34,10,47
Melbourne V,4280,4,13,5,11,45,39,6,44
Adelaide Utd,4280,5,11,6,11,37,40,-3,39
Brisbane,4280,6,10,5,13,33,42,-9,35
Western Sydn,4280,7,8,9,10,38,47,-9,33
Perth Glory,4280,8,10,2,15,37,50,-13,32
Wellington P,4280,9,5,6,16,31,55,-24,21
CC Mariners,4280,10,4,8,15,28,49,-21,20
Sydney FC,4281,1,21,4,3,67,23,44,67
N'castle Jet,4281,2,16,5,7,61,38,23,53
Melbourne C,4281,3,14,4,11,44,37,7,46
Melbourne V,4281,4,13,5,11,46,41,5,44
Adelaide Utd,4281,5,11,6,11,37,40,-3,39
Brisbane,4281,6,10,5,13,33,42,-9,35
Western Sydn,4281,7,8,9,10,38,47,-9,33
Perth Glory,4281,8,10,2,15,37,50,-13,32
Wellington P,4281,9,5,6,16,31,55,-24,21
CC Mariners,4281,10,4,8,15,28,49,-21,20
Sydney FC,4282,1,20,5,3,66,24,42,65
N'castle Jet,4282,2,15,5,8,57,39,18,50
Melbourne C,4282,3,15,4,10,45,33,12,49
Melbourne V,4282,4,13,6,10,47,40,7,45
Adelaide Utd,4282,5,11,6,11,37,40,-3,39
Brisbane,4282,6,10,5,13,33,42,-9,35
Western Sydn,4282,7,8,9,10,38,47,-9,33
Perth Glory,4282,8,10,2,15,37,50,-13,32
Wellington P,4282,9,5,6,16,31,55,-24,21
CC Mariners,4282,10,4,8,15,28,49,-21,20
Sydney FC,4283,1,21,4,3,66,23,43,67
N'castle Jet,4283,2,15,5,8,57,39,18,50
Melbourne C,4283,3,15,4,10,45,33,12,49
Melbourne V,4283,4,13,5,11,46,40,6,44
Adelaide Utd,4283,5,11,6,11,37,40,-3,39
Brisbane,4283,6,10,5,13,33,42,-9,35
Western Sydn,4283,7,8,9,10,38,47,-9,33
Perth Glory,4283,8,10,2,15,37,50,-13,32
Wellington P,4283,9,5,6,16,31,55,-24,21
CC Mariners,4283,10,4,8,15,28,49,-21,20
Sydney FC,4284,1,21,4,3,65,22,43,67
N'castle Jet,4284,2,16,5,7,58,37,21,53
Melbourne C,4284,3,14,4,11,43,34,9,46
Melbourne V,4284,4,13,5,11,45,39,6,44
Adelaide Utd,4284,5,11,6,11,37,40,-3,39
Brisbane,4284,6,10,5,13,33,42,-9,35
Western Sydn,4284,7,8,9,10,38,47,-9,33
Perth Glory,4284,8,10,2,15,37,50,-13,32
Wellington P,4284,9,5,6,16,31,55,-24,21
CC Mariners,4284,10,4,8,15,28,49,-21,20
Sydney FC,4285,1,21,4,3,66,23,43,67
N'castle Jet,4285,2,16,5,7,63,37,26,53
Melbourne C,4285,3,14,4,11,43,39,4,46
Melbourne V,4285,4,13,5,11,46,40,6,44
Adelaide Utd,4285,5,11,6,11,37,40,-3,39
Brisbane,4285,6,10,5,13,33,42,-9,35
Western Sydn,4285,7,8,9,10,38,47,-9,33
Perth Glory,4285,8,10,2,15,37,50,-13,32
Wellington P,4285,9,5,6,16,31,55,-24,21
CC Mariners,4285,10,4,8,15,28,49,-21,20
Sydney FC,4286,1,21,4,3,68,22,46,67
N'castle Jet,4286,2,16,5,7,61,38,23,53
Melbourne C,4286,3,14,4,11,44,37,7,46
Melbourne V,4286,4,13,5,11,45,42,3,44
Adelaide Utd,4286,5,11,6,11,37,40,-3,39
Brisbane,4286,6,10,5,13,33,42,-9,35
Western Sydn,4286,7,8,9,10,38,47,-9,33
Perth Glory,4286,8,10,2,15,37,50,-13,32
Wellington P,4286,9,5,6,16,31,55,-24,21
CC Mariners,4286,10,4,8,15,28,49,-21,20
Sydney FC,4287,1,21,4,3,66,22,44,67
N'castle Jet,4287,2,15,6,7,57,37,20,51
Melbourne C,4287,3,14,5,10,43,33,10,47
Melbourne V,4287,4,13,5,11,45,40,5,44
Adelaide Utd,4287,5,11,6,11,37,40,-3,39
Brisbane,4287,6,10,5,13,33,42,-9,35
Western Sydn,4287,7,8,9,10,38,47,-9,33
Perth Glory,4287,8,10,2,15,37,50,-13,32
Wellington P,4287,9,5,6,16,31,55,-24,21
CC Mariners,4287,10,4,8,15,28,49,-21,20
Sydney FC,4288,1,21,4,3,65,22,43,67
N'castle Jet,4288,2,15,6,7,58,38,20,51
Melbourne C,4288,3,14,5,10,44,34,10,47
Melbourne V,4288,4,13,5,11,45,39,6,44
Adelaide Utd,4288,5,11,6,11,37,40,-3,39
Brisbane,4288,6,10,5,13,33,42,-9,35
Western Sydn,4288,7,8,9,10,38,47,-9,33
Perth Glory,4288,8,10,2,15,37,50,-13,32
Wellington P,4288,9,5,6,16,31,55,-24,21
CC Mariners,4288,10,4,8,15,28,49,-21,20
Sydney FC,4289,1,21,4,3,67,22,45,67
N'castle Jet,4289,2,15,6,7,57,37,20,51
Melbourne C,4289,3,14,5,10,43,33,10,47
Melbourne V,4289,4,13,5,11,45,41,4,44
Adelaide Utd,4289,5,11,6,11,37,40,-3,39
Brisbane,4289,6,10,5,13,33,42,-9,35
Western Sydn,4289,7,8,9,10,38,47,-9,33
Perth Glory,4289,8,10,2,15,37,50,-13,32
Wellington P,4289,9,5,6,16,31,55,-24,21
CC Mariners,4289,10,4,8,15,28,49,-21,20
Sydney FC,4290,1,21,4,3,70,24,46,67
N'castle Jet,4290,2,16,5,7,58,37,21,53
Melbourne C,4290,3,14,4,11,43,34,9,46
Melbourne V,4290,4,13,5,11,47,44,3,44
Adelaide Utd,4290,5,11,6,11,37,40,-3,39
Brisbane,4290,6,10,5,13,33,42,-9,35
Western Sydn,4290,7,8,9,10,38,47,-9,33
Perth Glory,4290,8,10,2,15,37,50,-13,32
Wellington P,4290,9,5,6,16,31,55,-24,21
CC Mariners,4290,10,4,8,15,28,49,-21,20
Sydney FC,4291,1,20,5,3,67,25,42,65
N'castle Jet,4291,2,16,5,7,60,37,23,53
Melbourne C,4291,3,14,4,11,43,36,7,46
Melbourne V,4291,4,13,6,10,48,41,7,45
Adelaide Utd,4291,5,11,6,11,37,40,-3,39
Brisbane,4291,6,10,5,13,33,42,-9,35
Western Sydn,4291,7,8,9,10,38,47,-9,33
Perth Glory,4291,8,10,2,15,37,50,-13,32
Wellington P,4291,9,5,6,16,31,55,-24,21
CC Mariners,4291,10,4,8,15,28,49,-21,20
Sydney FC,4292,1,21,4,3,66,22,44,67
N'castle Jet,4292,2,16,5,7,59,38,21,53
Melbourne C,4292,3,14,4,11,44,35,9,46
Melbourne V,4292,4,13,5,11,45,40,5,44
Adelaide Utd,4292,5,11,6,11,37,40,-3,39
Brisbane,4292,6,10,5,13,33,42,-9,35
Western Sydn,4292,7,8,9,10,38,47,-9,33
Perth Glory,4292,8,10,2,15,37,50,-13,32
Wellington P,4292,9,5,6,16,31,55,-24,21
CC Mariners,4292,10,4,8,15,28,49,-21,20
Sydney FC,4293,1,21,4,3,66,22,44,67
N'castle Jet,4293,2,15,6,7,58,38,20,51
Melbourne C,4293,3,14,5,10,44,34,10,47
Melbourne V,4293,4,13,5,11,45,40,5,44
Adelaide Utd,4293,5,11,6,11,37,40,-3,39
Brisbane,4293,6,10,5,13,33,42,-9,35
Western Sydn,4293,7,8,9,10,38,47,-9,33
Perth Glory,4293,8,10,2,15,37,50,-13,32
Wellington P,4293,9,5,6,16,31,55,-24,21
CC Mariners,4293,10,4,8,15,28,49,-21,20
Sydney FC,4294,1,20,4,4,65,24,41,64
N'castle Jet,4294,2,16,5,7,61,38,23,53
Melbourne V,4294,3,14,5,10,47,39,8,47
Melbourne C,4294,4,14,4,11,44,37,7,46
Adelaide Utd,4294,5,11,6,11,37,40,-3,39
Brisbane,4294,6,10,5,13,33,42,-9,35
Western Sydn,4294,7,8,9,10,38,47,-9,33
Perth Glory,4294,8,10,2,15,37,50,-13,32
Wellington P,4294,9,5,6,16,31,55,-24,21
CC Mariners,4294,10,4,8,15,28,49,-21,20
Sydney FC,4295,1,21,4,3,66,22,44,67
N'castle Jet,4295,2,16,5,7,60,37,23,53
Melbourne C,4295,3,14,4,11,43,36,7,46
Melbourne V,4295,4,13,5,11,45,40,5,44
Adelaide Utd,4295,5,11,6,11,37,40,-3,39
Brisbane,4295,6,10,5,13,33,42,-9,35
Western Sydn,4295,7,8,9,10,38,47,-9,33
Perth Glory,4295,8,10,2,15,37,50,-13,32
Wellington P,4295,9,5,6,16,31,55,-24,21
CC Mariners,4295,10,4,8,15,28,49,-21,20
Sydney FC,4296,1,21,4,3,67,23,44,67
N'castle Jet,4296,2,16,5,7,58,37,21,53
Melbourne C,4296,3,14,4,11,43,34,9,46
Melbourne V,4296,4,13,5,11,46,41,5,44
Adelaide Utd,4296,5,11,6,11,37,40,-3,39
Brisbane,4296,6,10,5,13,33,42,-9,35
Western Sydn,4296,7,8,9,10,38,47,-9,33
Perth Glory,4296,8,10,2,15,37,50,-13,32
Wellington P,4296,9,5,6,16,31,55,-24,21
CC Mariners,4296,10,4,8,15,28,49,-21,20
Sydney FC,4297,1,21,4,3,69,23,46,67
N'castle Jet,4297,2,16,5,7,59,38,21,53
Melbourne C,4297,3,14,4,11,44,35,9,46
Melbourne V,4297,4,13,5,11,46,43,3,44
Adelaide Utd,4297,5,11,6,11,37,40,-3,39
Brisbane,4297,6,10,5,13,33,42,-9,35
Western Sydn,4297,7,8,9,10,38,47,-9,33
Perth Glory,4297,8,10,2,15,37,50,-13,32
Wellington P,4297,9,5,6,16,31,55,-24,21
CC Mariners,4297,10,4,8,15,28,49,-21,20
Sydney FC,4298,1,20,5,3,65,23,42,65
N'castle Jet,4298,2,16,5,7,61,39,22,53
Melbourne C,4298,3,14,4,11,45,37,8,46
Melbourne V,4298,4,13,6,10,46,39,7,45
Adelaide Utd,4298,5,11,6,11,37,40,-3,39
Brisbane,4298,6,10,5,13,33,42,-9,35
Western Sydn,4298,7,8,9,10,38,47,-9,33
Perth Glory,4298,8,10,2,15,37,50,-13,32
Wellington P,4298,9,5,6,16,31,55,-24,21
CC Mariners,4298,10,4,8,15,28,49,-21,20
Sydney FC,4299,1,21,4,3,65,22,43,67
N'castle Jet,4299,2,16,5,7,59,37,22,53
Melbourne C,4299,3,14,4,11,43,35,8,46
Melbourne V,4299,4,13,5,11,45,39,6,44
Adelaide Utd,4299,5,11,6,11,37,40,-3,39
Brisbane,4299,6,10,5,13,33,42,-9,35
Western Sydn,4299,7,8,9,10,38,47,-9,33
Perth Glory,4299,8,10,2,15,37,50,-13,32
Wellington P,4299,9,5,6,16,31,55,-24,21
CC Mariners,4299,10,4,8,15,28,49,-21,20
Sydney FC,4300,1,21,4,3,68,25,43,67
N'castle Jet,4300,2,16,5,7,59,38,21,53
Melbourne C,4300,3,14,4,11,44,35,9,46
Melbourne V,4300,4,13,5,11,48,42,6,44
Adelaide Utd,4300,5,11,6,11,37,40,-3,39
Brisbane,4300,6,10,5,13,33,42,-9,35
Western Sydn,4300,7,8,9,10,38,47,-9,33
Perth Glory,4300,8,10,2,15,37,50,-13,32
Wellington P,4300,9,5,6,16,31,55,-24,21
CC Mariners,4300,10,4,8,15,28,49,-21,20
Sydney FC,4301,1,20,4,4,64,24,40,64
N'castle Jet,4301,2,16,5,7,60,39,21,53
Melbourne V,4301,3,14,5,10,47,38,9,47
Melbourne C,4301,4,14,4,11,45,36,9,46
Adelaide Utd,4301,5,11,6,11,37,40,-3,39
Brisbane,4301,6,10,5,13,33,42,-9,35
Western Sydn,4301,7,8,9,10,38,47,-9,33
Perth Glory,4301,8,10,2,15,37,50,-13,32
Wellington P,4301,9,5,6,16,31,55,-24,21
CC Mariners,4301,10,4,8,15,28,49,-21,20
Sydney FC,4302,1,21,4,3,67,23,44,67
N'castle Jet,4302,2,16,5,7,60,37,23,53
Melbourne C,4302,3,14,4,11,43,36,7,46
Melbourne V,4302,4,13,5,11,46,41,5,44
Adelaide Utd,4302,5,11,6,11,37,40,-3,39
Brisbane,4302,6,10,5,13,33,42,-9,35
Western Sydn,4302,7,8,9,10,38,47,-9,33
Perth Glory,4302,8,10,2,15,37,50,-13,32
Wellington P,4302,9,5,6,16,31,55,-24,21
CC Mariners,4302,10,4,8,15,28,49,-21,20
Sydney FC,4303,1,21,4,3,67,22,45,67
N'castle Jet,4303,2,16,5,7,60,37,23,53
Melbourne C,4303,3,14,4,11,43,36,7,46
Melbourne V,4303,4,13,5,11,45,41,4,44
Adelaide Utd,4303,5,11,6,11,37,40,-3,39
Brisbane,4303,6,10,5,13,33,42,-9,35
Western Sydn,4303,7,8,9,10,38,47,-9,33
Perth Glory,4303,8,10,2,15,37,50,-13,32
Wellington P,4303,9,5,6,16,31,55,-24,21
CC Mariners,4303,10,4,8,15,28,49,-21,20
Sydney FC,4304,1,20,4,4,65,24,41,64
N'castle Jet,4304,2,15,6,7,58,38,20,51
Melbourne C,4304,3,14,5,10,44,34,10,47
Melbourne V,4304,4,14,5,10,47,39,8,47
Adelaide Utd,4304,5,11,6,11,37,40,-3,39
Brisbane,4304,6,10,5,13,33,42,-9,35
Western Sydn,4304,7,8,9,10,38,47,-9,33
Perth Glory,4304,8,10,2,15,37,50,-13,32
Wellington P,4304,9,5,6,16,31,55,-24,21
CC Mariners,4304,10,4,8,15,28,49,-21,20
Sydney FC,4305,1,21,4,3,65,22,43,67
N'castle Jet,4305,2,15,5,8,57,38,19,50
Melbourne C,4305,3,15,4,10,44,33,11,49
Melbourne V,4305,4,13,5,11,45,39,6,44
Adelaide Utd,4305,5,11,6,11,37,40,-3,39
Brisbane,4305,6,10,5,13,33,42,-9,35
Western Sydn,4305,7,8,9,10,38,47,-9,33
Perth Glory,4305,8,10,2,15,37,50,-13,32
Wellington P,4305,9,5,6,16,31,55,-24,21
CC Mariners,4305,10,4,8,15,28,49,-21,20
Sydney FC,4306,1,21,4,3,67,24,43,67
N'castle Jet,4306,2,15,5,8,57,39,18,50
Melbourne C,4306,3,15,4,10,45,33,12,49
Melbourne V,4306,4,13,5,11,47,41,6,44
Adelaide Utd,4306,5,11,6,11,37,40,-3,39
Brisbane,4306,6,10,5,13,33,42,-9,35
Western Sydn,4306,7,8,9,10,38,47,-9,33
Perth Glory,4306,8,10,2,15,37,50,-13,32
Wellington P,4306,9,5,6,16,31,55,-24,21
CC Mariners,4306,10,4,8,15,28,49,-21,20
Sydney FC,4307,1,20,5,3,64,22,42,65
N'castle Jet,4307,2,15,5,8,58,41,17,50
Melbourne C,4307,3,15,4,10,47,34,13,49
Melbourne V,4307,4,13,6,10,45,38,7,45
Adelaide Utd,4307,5,11,6,11,37,40,-3,39
Brisbane,4307,6,10,5,13,33,42,-9,35
Western Sydn,4307,7,8,9,10,38,47,-9,33
Perth Glory,4307,8,10,2,15,37,50,-13,32
Wellington P,4307,9,5,6,16,31,55,-24,21
CC Mariners,4307,10,4,8,15,28,49,-21,20
Sydney FC,4308,1,21,4,3,66,23,43,67
N'castle Jet,4308,2,15,5,8,58,39,19,50
Melbourne C,4308,3,15,4,10,45,34,11,49
Melbourne V,4308,4,13,5,11,46,40,6,44
Adelaide Utd,4308,5,11,6,11,37,40,-3,39
Brisbane,4308,6,10,5,13,33,42,-9,35
Western Sydn,4308,7,8,9,10,38,47,-9,33
Perth Glory,4308,8,10,2,15,37,50,-13,32
Wellington P,4308,9,5,6,16,31,55,-24,21
CC Mariners,4308,10,4,8,15,28,49,-21,20
Sydney FC,4309,1,20,5,3,66,24,42,65
N'castle Jet,4309,2,16,5,7,59,38,21,53
Melbourne C,4309,3,14,4,11,44,35,9,46
Melbourne V,4309,4,13,6,10,47,40,7,45
Adelaide Utd,4309,5,11,6,11,37,40,-3,39
Brisbane,4309,6,10,5,13,33,42,-9,35
Western Sydn,4309,7,8,9,10,38,47,-9,33
Perth Glory,4309,8,10,2,15,37,50,-13,32
Wellington P,4309,9,5,6,16,31,55,-24,21
CC Mariners,4309,10,4,8,15,28,49,-21,20
Sydney FC,4310,1,21,4,3,66,23,43,67
N'castle Jet,4310,2,16,5,7,58,37,21,53
Melbourne C,4310,3,14,4,11,43,34,9,46
Melbourne V,4310,4,13,5,11,46,40,6,44
Adelaide Utd,4310,5,11,6,11,37,40,-3,39
Brisbane,4310,6,10,5,13,33,42,-9,35
Western Sydn,4310,7,8,9,10,38,47,-9,33
Perth Glory,4310,8,10,2,15,37,50,-13,32
Wellington P,4310,9,5,6,16,31,55,-24,21
CC Mariners,4310,10,4,8,15,28,49,-21,20
Sydney FC,4311,1,20,4,4,64,23,41,64
N'castle Jet,4311,2,16,5,7,60,37,23,53
Melbourne V,4311,3,14,5,10,46,38,8,47
Melbourne C,4311,4,14,4,11,43,36,7,46
Adelaide Utd,4311,5,11,6,11,37,40,-3,39
Brisbane,4311,6,10,5,13,33,42,-9,35
Western Sydn,4311,7,8,9,10,38,47,-9,33
Perth Glory,4311,8,10,2,15,37,50,-13,32
Wellington P,4311,9,5,6,16,31,55,-24,21
CC Mariners,4311,10,4,8,15,28,49,-21,20
Sydney FC,4312,1,21,4,3,68,23,45,67
N'castle Jet,4312,2,15,5,8,57,39,18,50
Melbourne C,4312,3,15,4,10,45,33,12,49
Melbourne V,4312,4,13,5,11,46,42,4,44
Adelaide Utd,4312,5,11,6,11,37,40,-3,39
Brisbane,4312,6,10,5,13,33,42,-9,35
Western Sydn,4312,7,8,9,10,38,47,-9,33
Perth Glory,4312,8,10,2,15,37,50,-13,32
Wellington P,4312,9,5,6,16,31,55,-24,21
CC Mariners,4312,10,4,8,15,28,49,-21,20
Sydney FC,4313,1,20,5,3,65,23,42,65
N'castle Jet,4313,2,15,6,7,58,38,20,51
Melbourne C,4313,3,14,5,10,44,34,10,47
Melbourne V,4313,4,13,6,10,46,39,7,45
Adelaide Utd,4313,5,11,6,11,37,40,-3,39
Brisbane,4313,6,10,5,13,33,42,-9,35
Western Sydn,4313,7,8,9,10,38,47,-9,33
Perth Glory,4313,8,10,2,15,37,50,-13,32
Wellington P,4313,9,5,6,16,31,55,-24,21
CC Mariners,4313,10,4,8,15,28,49,-21,20
Sydney FC,4314,1,21,4,3,66,23,43,67
N'castle Jet,4314,2,16,5,7,59,38,21,53
Melbourne C,4314,3,14,4,11,44,35,9,46
Melbourne V,4314,4,13,5,11,46,40,6,44
Adelaide Utd,4314,5,11,6,11,37,40,-3,39
Brisbane,4314,6,10,5,13,33,42,-9,35
Western Sydn,4314,7,8,9,10,38,47,-9,33
Perth Glory,4314,8,10,2,15,37,50,-13,32
Wellington P,4314,9,5,6,16,31,55,-24,21
CC Mariners,4314,10,4,8,15,28,49,-21,20
Sydney FC,4315,1,20,4,4,64,23,41,64
N'castle Jet,4315,2,15,5,8,59,40,19,50
Melbourne C,4315,3,15,4,10,46,35,11,49
Melbourne V,4315,4,14,5,10,46,38,8,47
Adelaide Utd,4315,5,11,6,11,37,40,-3,39
Brisbane,4315,6,10,5,13,33,42,-9,35
Western Sydn,4315,7,8,9,10,38,47,-9,33
Perth Glory,4315,8,10,2,15,37,50,-13,32
Wellington P,4315,9,5,6,16,31,55,-24,21
CC Mariners,4315,10,4,8,15,28,49,-21,20
Sydney FC,4316,1,21,4,3,65,22,43,67
N'castle Jet,4316,2,16,5,7,60,38,22,53
Melbourne C,4316,3,14,4,11,44,36,8,46
Melbourne V,4316,4,13,5,11,45,39,6,44
Adelaide Utd,4316,5,11,6,11,37,40,-3,39
Brisbane,4316,6,10,5,13,33,42,-9,35
Western Sydn,4316,7,8,9,10,38,47,-9,33
Perth Glory,4316,8,10,2,15,37,50,-13,32
Wellington P,4316,9,5,6,16,31,55,-24,21
CC Mariners,4316,10,4,8,15,28,49,-21,20
Sydney FC,4317,1,20,5,3,65,23,42,65
N'castle Jet,4317,2,15,6,7,59,39,20,51
Melbourne C,4317,3,14,5,10,45,35,10,47
Melbourne V,4317,4,13,6,10,46,39,7,45
Adelaide Utd,4317,5,11,6,11,37,40,-3,39
Brisbane,4317,6,10,5,13,33,42,-9,35
Western Sydn,4317,7,8,9,10,38,47,-9,33
Perth Glory,4317,8,10,2,15,37,50,-13,32
Wellington P,4317,9,5,6,16,31,55,-24,21
CC Mariners,4317,10,4,8,15,28,49,-21,20
Sydney FC,4318,1,21,4,3,66,22,44,67
N'castle Jet,4318,2,15,5,8,57,40,17,50
Melbourne C,4318,3,15,4,10,46,33,13,49
Melbourne V,4318,4,13,5,11,45,40,5,44
Adelaide Utd,4318,5,11,6,11,37,40,-3,39
Brisbane,4318,6,10,5,13,33,42,-9,35
Western Sydn,4318,7,8,9,10,38,47,-9,33
Perth Glory,4318,8,10,2,15,37,50,-13,32
Wellington P,4318,9,5,6,16,31,55,-24,21
CC Mariners,4318,10,4,8,15,28,49,-21,20
Sydney FC,4319,1,20,4,4,64,24,40,64
N'castle Jet,4319,2,15,6,7,58,38,20,51
Melbourne C,4319,3,14,5,10,44,34,10,47
Melbourne V,4319,4,14,5,10,47,38,9,47
Adelaide Utd,4319,5,11,6,11,37,40,-3,39
Brisbane,4319,6,10,5,13,33,42,-9,35
Western Sydn,4319,7,8,9,10,38,47,-9,33
Perth Glory,4319,8,10,2,15,37,50,-13,32
Wellington P,4319,9,5,6,16,31,55,-24,21
CC Mariners,4319,10,4,8,15,28,49,-21,20
Sydney FC,4320,1,21,4,3,65,22,43,67
N'castle Jet,4320,2,16,5,7,60,38,22,53
Melbourne C,4320,3,14,4,11,44,36,8,46
Melbourne V,4320,4,13,5,11,45,39,6,44
Adelaide Utd,4320,5,11,6,11,37,40,-3,39
Brisbane,4320,6,10,5,13,33,42,-9,35
Western Sydn,4320,7,8,9,10,38,47,-9,33
Perth Glory,4320,8,10,2,15,37,50,-13,32
Wellington P,4320,9,5,6,16,31,55,-24,21
CC Mariners,4320,10,4,8,15,28,49,-21,20
Sydney FC,4321,1,20,5,3,65,23,42,65
N'castle Jet,4321,2,16,5,7,59,37,22,53
Melbourne C,4321,3,14,4,11,43,35,8,46
Melbourne V,4321,4,13,6,10,46,39,7,45
Adelaide Utd,4321,5,11,6,11,37,40,-3,39
Brisbane,4321,6,10,5,13,33,42,-9,35
Western Sydn,4321,7,8,9,10,38,47,-9,33
Perth Glory,4321,8,10,2,15,37,50,-13,32
Wellington P,4321,9,5,6,16,31,55,-24,21
CC Mariners,4321,10,4,8,15,28,49,-21,20
Sydney FC,4322,1,21,4,3,65,22,43,67
N'castle Jet,4322,2,16,5,7,58,37,21,53
Melbourne C,4322,3,14,4,11,43,34,9,46
Melbourne V,4322,4,13,5,11,45,39,6,44
Adelaide Utd,4322,5,11,6,11,37,40,-3,39
Brisbane,4322,6,10,5,13,33,42,-9,35
Western Sydn,4322,7,8,9,10,38,47,-9,33
Perth Glory,4322,8,10,2,15,37,50,-13,32
Wellington P,4322,9,5,6,16,31,55,-24,21
CC Mariners,4322,10,4,8,15,28,49,-21,20
Sydney FC,4323,1,21,4,3,66,23,43,67
N'castle Jet,4323,2,15,5,8,58,40,18,50
Melbourne C,4323,3,15,4,10,46,34,12,49
Melbourne V,4323,4,13,5,11,46,40,6,44
Adelaide Utd,4323,5,11,6,11,37,40,-3,39
Brisbane,4323,6,10,5,13,33,42,-9,35
Western Sydn,4323,7,8,9,10,38,47,-9,33
Perth Glory,4323,8,10,2,15,37,50,-13,32
Wellington P,4323,9,5,6,16,31,55,-24,21
CC Mariners,4323,10,4,8,15,28,49,-21,20
Sydney FC,4324,1,21,4,3,72,23,49,67
N'castle Jet,4324,2,16,5,7,58,37,21,53
Melbourne C,4324,3,14,4,11,43,34,9,46
Melbourne V,4324,4,13,5,11,46,46,0,44
Adelaide Utd,4324,5,11,6,11,37,40,-3,39
Brisbane,4324,6,10,5,13,33,42,-9,35
Western Sydn,4324,7,8,9,10,38,47,-9,33
Perth Glory,4324,8,10,2,15,37,50,-13,32
Wellington P,4324,9,5,6,16,31,55,-24,21
CC Mariners,4324,10,4,8,15,28,49,-21,20
Sydney FC,4325,1,21,4,3,68,25,43,67
N'castle Jet,4325,2,16,5,7,60,38,22,53
Melbourne C,4325,3,14,4,11,44,36,8,46
Melbourne V,4325,4,13,5,11,48,42,6,44
Adelaide Utd,4325,5,11,6,11,37,40,-3,39
Brisbane,4325,6,10,5,13,33,42,-9,35
Western Sydn,4325,7,8,9,10,38,47,-9,33
Perth Glory,4325,8,10,2,15,37,50,-13,32
Wellington P,4325,9,5,6,16,31,55,-24,21
CC Mariners,4325,10,4,8,15,28,49,-21,20
Sydney FC,4326,1,20,5,3,64,22,42,65
N'castle Jet,4326,2,16,5,7,58,37,21,53
Melbourne C,4326,3,14,4,11,43,34,9,46
Melbourne V,4326,4,13,6,10,45,38,7,45
Adelaide Utd,4326,5,11,6,11,37,40,-3,39
Brisbane,4326,6,10,5,13,33,42,-9,35
Western Sydn,4326,7,8,9,10,38,47,-9,33
Perth Glory,4326,8,10,2,15,37,50,-13,32
Wellington P,4326,9,5,6,16,31,55,-24,21
CC Mariners,4326,10,4,8,15,28,49,-21,20
Sydney FC,4327,1,20,4,4,64,24,40,64
N'castle Jet,4327,2,15,5,8,57,39,18,50
Melbourne C,4327,3,15,4,10,45,33,12,49
Melbourne V,4327,4,14,5,10,47,38,9,47
Adelaide Utd,4327,5,11,6,11,37,40,-3,39
Brisbane,4327,6,10,5,13,33,42,-9,35
Western Sydn,4327,7,8,9,10,38,47,-9,33
Perth Glory,4327,8,10,2,15,37,50,-13,32
Wellington P,4327,9,5,6,16,31,55,-24,21
CC Mariners,4327,10,4,8,15,28,49,-21,20
Sydney FC,4328,1,21,4,3,67,23,44,67
N'castle Jet,4328,2,16,5,7,58,37,21,53
Melbourne C,4328,3,14,4,11,43,34,9,46
Melbourne V,4328,4,13,5,11,46,41,5,44
Adelaide Utd,4328,5,11,6,11,37,40,-3,39
Brisbane,4328,6,10,5,13,33,42,-9,35
Western Sydn,4328,7,8,9,10,38,47,-9,33
Perth Glory,4328,8,10,2,15,37,50,-13,32
Wellington P,4328,9,5,6,16,31,55,-24,21
CC Mariners,4328,10,4,8,15,28,49,-21,20
Sydney FC,4329,1,20,5,3,65,23,42,65
N'castle Jet,4329,2,15,5,8,58,39,19,50
Melbourne C,4329,3,15,4,10,45,34,11,49
Melbourne V,4329,4,13,6,10,46,39,7,45
Adelaide Utd,4329,5,11,6,11,37,40,-3,39
Brisbane,4329,6,10,5,13,33,42,-9,35
Western Sydn,4329,7,8,9,10,38,47,-9,33
Perth Glory,4329,8,10,2,15,37,50,-13,32
Wellington P,4329,9,5,6,16,31,55,-24,21
CC Mariners,4329,10,4,8,15,28,49,-21,20
Sydney FC,4330,1,21,4,3,69,24,45,67
N'castle Jet,4330,2,16,5,7,59,37,22,53
Melbourne C,4330,3,14,4,11,43,35,8,46
Melbourne V,4330,4,13,5,11,47,43,4,44
Adelaide Utd,4330,5,11,6,11,37,40,-3,39
Brisbane,4330,6,10,5,13,33,42,-9,35
Western Sydn,4330,7,8,9,10,38,47,-9,33
Perth Glory,4330,8,10,2,15,37,50,-13,32
Wellington P,4330,9,5,6,16,31,55,-24,21
CC Mariners,4330,10,4,8,15,28,49,-21,20
Sydney FC,4331,1,21,4,3,65,22,43,67
N'castle Jet,4331,2,15,5,8,57,40,17,50
Melbourne C,4331,3,15,4,10,46,33,13,49
Melbourne V,4331,4,13,5,11,45,39,6,44
Adelaide Utd,4331,5,11,6,11,37,40,-3,39
Brisbane,4331,6,10,5,13,33,42,-9,35
Western Sydn,4331,7,8,9,10,38,47,-9,33
Perth Glory,4331,8,10,2,15,37,50,-13,32
Wellington P,4331,9,5,6,16,31,55,-24,21
CC Mariners,4331,10,4,8,15,28,49,-21,20
Sydney FC,4332,1,20,4,4,65,24,41,64
N'castle Jet,4332,2,15,5,8,57,39,18,50
Melbourne C,4332,3,15,4,10,45,33,12,49
Melbourne V,4332,4,14,5,10,47,39,8,47
Adelaide Utd,4332,5,11,6,11,37,40,-3,39
Brisbane,4332,6,10,5,13,33,42,-9,35
Western Sydn,4332,7,8,9,10,38,47,-9,33
Perth Glory,4332,8,10,2,15,37,50,-13,32
Wellington P,4332,9,5,6,16,31,55,-24,21
CC Mariners,4332,10,4,8,15,28,49,-21,20
Sydney FC,4333,1,20,5,3,66,24,42,65
N'castle Jet,4333,2,16,5,7,59,37,22,53
Melbourne C,4333,3,14,4,11,43,35,8,46
Melbourne V,4333,4,13,6,10,47,40,7,45
Adelaide Utd,4333,5,11,6,11,37,40,-3,39
Brisbane,4333,6,10,5,13,33,42,-9,35
Western Sydn,4333,7,8,9,10,38,47,-9,33
Perth Glory,4333,8,10,2,15,37,50,-13,32
Wellington P,4333,9,5,6,16,31,55,-24,21
CC Mariners,4333,10,4,8,15,28,49,-21,20
Sydney FC,4334,1,20,5,3,64,22,42,65
N'castle Jet,4334,2,16,5,7,60,38,22,53
Melbourne C,4334,3,14,4,11,44,36,8,46
Melbourne V,4334,4,13,6,10,45,38,7,45
Adelaide Utd,4334,5,11,6,11,37,40,-3,39
Brisbane,4334,6,10,5,13,33,42,-9,35
Western Sydn,4334,7,8,9,10,38,47,-9,33
Perth Glory,4334,8,10,2,15,37,50,-13,32
Wellington P,4334,9,5,6,16,31,55,-24,21
CC Mariners,4334,10,4,8,15,28,49,-21,20
Sydney FC,4335,1,21,4,3,67,23,44,67
N'castle Jet,4335,2,16,5,7,62,38,24,53
Melbourne C,4335,3,14,4,11,44,38,6,46
Melbourne V,4335,4,13,5,11,46,41,5,44
Adelaide Utd,4335,5,11,6,11,37,40,-3,39
Brisbane,4335,6,10,5,13,33,42,-9,35
Western Sydn,4335,7,8,9,10,38,47,-9,33
Perth Glory,4335,8,10,2,15,37,50,-13,32
Wellington P,4335,9,5,6,16,31,55,-24,21
CC Mariners,4335,10,4,8,15,28,49,-21,20
Sydney FC,4336,1,20,4,4,65,25,40,64
N'castle Jet,4336,2,15,6,7,58,38,20,51
Melbourne C,4336,3,14,5,10,44,34,10,47
Melbourne V,4336,4,14,5,10,48,39,9,47
Adelaide Utd,4336,5,11,6,11,37,40,-3,39
Brisbane,4336,6,10,5,13,33,42,-9,35
Western Sydn,4336,7,8,9,10,38,47,-9,33
Perth Glory,4336,8,10,2,15,37,50,-13,32
Wellington P,4336,9,5,6,16,31,55,-24,21
CC Mariners,4336,10,4,8,15,28,49,-21,20
Sydney FC,4337,1,20,5,3,66,24,42,65
N'castle Jet,4337,2,16,5,7,60,39,21,53
Melbourne C,4337,3,14,4,11,45,36,9,46
Melbourne V,4337,4,13,6,10,47,40,7,45
Adelaide Utd,4337,5,11,6,11,37,40,-3,39
Brisbane,4337,6,10,5,13,33,42,-9,35
Western Sydn,4337,7,8,9,10,38,47,-9,33
Perth Glory,4337,8,10,2,15,37,50,-13,32
Wellington P,4337,9,5,6,16,31,55,-24,21
CC Mariners,4337,10,4,8,15,28,49,-21,20
Sydney FC,4338,1,21,4,3,69,23,46,67
N'castle Jet,4338,2,15,5,8,59,41,18,50
Melbourne C,4338,3,15,4,10,47,35,12,49
Melbourne V,4338,4,13,5,11,46,43,3,44
Adelaide Utd,4338,5,11,6,11,37,40,-3,39
Brisbane,4338,6,10,5,13,33,42,-9,35
Western Sydn,4338,7,8,9,10,38,47,-9,33
Perth Glory,4338,8,10,2,15,37,50,-13,32
Wellington P,4338,9,5,6,16,31,55,-24,21
CC Mariners,4338,10,4,8,15,28,49,-21,20
Sydney FC,4339,1,21,4,3,68,23,45,67
N'castle Jet,4339,2,16,5,7,59,38,21,53
Melbourne C,4339,3,14,4,11,44,35,9,46
Melbourne V,4339,4,13,5,11,46,42,4,44
Adelaide Utd,4339,5,11,6,11,37,40,-3,39
Brisbane,4339,6,10,5,13,33,42,-9,35
Western Sydn,4339,7,8,9,10,38,47,-9,33
Perth Glory,4339,8,10,2,15,37,50,-13,32
Wellington P,4339,9,5,6,16,31,55,-24,21
CC Mariners,4339,10,4,8,15,28,49,-21,20
Sydney FC,4340,1,21,4,3,66,23,43,67
N'castle Jet,4340,2,16,5,7,60,38,22,53
Melbourne C,4340,3,14,4,11,44,36,8,46
Melbourne V,4340,4,13,5,11,46,40,6,44
Adelaide Utd,4340,5,11,6,11,37,40,-3,39
Brisbane,4340,6,10,5,13,33,42,-9,35
Western Sydn,4340,7,8,9,10,38,47,-9,33
Perth Glory,4340,8,10,2,15,37,50,-13,32
Wellington P,4340,9,5,6,16,31,55,-24,21
CC Mariners,4340,10,4,8,15,28,49,-21,20
Sydney FC,4341,1,20,4,4,64,23,41,64
N'castle Jet,4341,2,16,5,7,58,37,21,53
Melbourne V,4341,3,14,5,10,46,38,8,47
Melbourne C,4341,4,14,4,11,43,34,9,46
Adelaide Utd,4341,5,11,6,11,37,40,-3,39
Brisbane,4341,6,10,5,13,33,42,-9,35
Western Sydn,4341,7,8,9,10,38,47,-9,33
Perth Glory,4341,8,10,2,15,37,50,-13,32
Wellington P,4341,9,5,6,16,31,55,-24,21
CC Mariners,4341,10,4,8,15,28,49,-21,20
Sydney FC,4342,1,20,5,3,64,22,42,65
N'castle Jet,4342,2,15,6,7,58,38,20,51
Melbourne C,4342,3,14,5,10,44,34,10,47
Melbourne V,4342,4,13,6,10,45,38,7,45
Adelaide Utd,4342,5,11,6,11,37,40,-3,39
Brisbane,4342,6,10,5,13,33,42,-9,35
Western Sydn,4342,7,8,9,10,38,47,-9,33
Perth Glory,4342,8,10,2,15,37,50,-13,32
Wellington P,4342,9,5,6,16,31,55,-24,21
CC Mariners,4342,10,4,8,15,28,49,-21,20
Sydney FC,4343,1,20,4,4,64,24,40,64
N'castle Jet,4343,2,15,5,8,57,38,19,50
Melbourne C,4343,3,15,4,10,44,33,11,49
Melbourne V,4343,4,14,5,10,47,38,9,47
Adelaide Utd,4343,5,11,6,11,37,40,-3,39
Brisbane,4343,6,10,5,13,33,42,-9,35
Western Sydn,4343,7,8,9,10,38,47,-9,33
Perth Glory,4343,8,10,2,15,37,50,-13,32
Wellington P,4343,9,5,6,16,31,55,-24,21
CC Mariners,4343,10,4,8,15,28,49,-21,20
Sydney FC,4344,1,20,5,3,65,23,42,65
N'castle Jet,4344,2,15,5,8,58,40,18,50
Melbourne C,4344,3,15,4,10,46,34,12,49
Melbourne V,4344,4,13,6,10,46,39,7,45
Adelaide Utd,4344,5,11,6,11,37,40,-3,39
Brisbane,4344,6,10,5,13,33,42,-9,35
Western Sydn,4344,7,8,9,10,38,47,-9,33
Perth Glory,4344,8,10,2,15,37,50,-13,32
Wellington P,4344,9,5,6,16,31,55,-24,21
CC Mariners,4344,10,4,8,15,28,49,-21,20
Sydney FC,4345,1,21,4,3,68,23,45,67
N'castle Jet,4345,2,15,6,7,57,37,20,51
Melbourne C,4345,3,14,5,10,43,33,10,47
Melbourne V,4345,4,13,5,11,46,42,4,44
Adelaide Utd,4345,5,11,6,11,37,40,-3,39
Brisbane,4345,6,10,5,13,33,42,-9,35
Western Sydn,4345,7,8,9,10,38,47,-9,33
Perth Glory,4345,8,10,2,15,37,50,-13,32
Wellington P,4345,9,5,6,16,31,55,-24,21
CC Mariners,4345,10,4,8,15,28,49,-21,20
Sydney FC,4346,1,20,5,3,65,23,42,65
N'castle Jet,4346,2,16,5,7,60,37,23,53
Melbourne C,4346,3,14,4,11,43,36,7,46
Melbourne V,4346,4,13,6,10,46,39,7,45
Adelaide Utd,4346,5,11,6,11,37,40,-3,39
Brisbane,4346,6,10,5,13,33,42,-9,35
Western Sydn,4346,7,8,9,10,38,47,-9,33
Perth Glory,4346,8,10,2,15,37,50,-13,32
Wellington P,4346,9,5,6,16,31,55,-24,21
CC Mariners,4346,10,4,8,15,28,49,-21,20
Sydney FC,4347,1,21,4,3,67,22,45,67
N'castle Jet,4347,2,15,5,8,58,39,19,50
Melbourne C,4347,3,15,4,10,45,34,11,49
Melbourne V,4347,4,13,5,11,45,41,4,44
Adelaide Utd,4347,5,11,6,11,37,40,-3,39
Brisbane,4347,6,10,5,13,33,42,-9,35
Western Sydn,4347,7,8,9,10,38,47,-9,33
Perth Glory,4347,8,10,2,15,37,50,-13,32
Wellington P,4347,9,5,6,16,31,55,-24,21
CC Mariners,4347,10,4,8,15,28,49,-21,20
Sydney FC,4348,1,21,4,3,68,22,46,67
N'castle Jet,4348,2,15,5,8,57,38,19,50
Melbourne C,4348,3,15,4,10,44,33,11,49
Melbourne V,4348,4,13,5,11,45,42,3,44
Adelaide Utd,4348,5,11,6,11,37,40,-3,39
Brisbane,4348,6,10,5,13,33,42,-9,35
Western Sydn,4348,7,8,9,10,38,47,-9,33
Perth Glory,4348,8,10,2,15,37,50,-13,32
Wellington P,4348,9,5,6,16,31,55,-24,21
CC Mariners,4348,10,4,8,15,28,49,-21,20
Sydney FC,4349,1,20,4,4,65,24,41,64
N'castle Jet,4349,2,16,5,7,62,37,25,53
Melbourne V,4349,3,14,5,10,47,39,8,47
Melbourne C,4349,4,14,4,11,43,38,5,46
Adelaide Utd,4349,5,11,6,11,37,40,-3,39
Brisbane,4349,6,10,5,13,33,42,-9,35
Western Sydn,4349,7,8,9,10,38,47,-9,33
Perth Glory,4349,8,10,2,15,37,50,-13,32
Wellington P,4349,9,5,6,16,31,55,-24,21
CC Mariners,4349,10,4,8,15,28,49,-21,20
Sydney FC,4350,1,21,4,3,66,22,44,67
N'castle Jet,4350,2,15,5,8,57,39,18,50
Melbourne C,4350,3,15,4,10,45,33,12,49
Melbourne V,4350,4,13,5,11,45,40,5,44
Adelaide Utd,4350,5,11,6,11,37,40,-3,39
Brisbane,4350,6,10,5,13,33,42,-9,35
Western Sydn,4350,7,8,9,10,38,47,-9,33
Perth Glory,4350,8,10,2,15,37,50,-13,32
Wellington P,4350,9,5,6,16,31,55,-24,21
CC Mariners,4350,10,4,8,15,28,49,-21,20
Sydney FC,4351,1,20,4,4,64,23,41,64
N'castle Jet,4351,2,15,6,7,58,38,20,51
Melbourne C,4351,3,14,5,10,44,34,10,47
Melbourne V,4351,4,14,5,10,46,38,8,47
Adelaide Utd,4351,5,11,6,11,37,40,-3,39
Brisbane,4351,6,10,5,13,33,42,-9,35
Western Sydn,4351,7,8,9,10,38,47,-9,33
Perth Glory,4351,8,10,2,15,37,50,-13,32
Wellington P,4351,9,5,6,16,31,55,-24,21
CC Mariners,4351,10,4,8,15,28,49,-21,20
Sydney FC,4352,1,20,5,3,65,23,42,65
N'castle Jet,4352,2,16,5,7,59,37,22,53
Melbourne C,4352,3,14,4,11,43,35,8,46
Melbourne V,4352,4,13,6,10,46,39,7,45
Adelaide Utd,4352,5,11,6,11,37,40,-3,39
Brisbane,4352,6,10,5,13,33,42,-9,35
Western Sydn,4352,7,8,9,10,38,47,-9,33
Perth Glory,4352,8,10,2,15,37,50,-13,32
Wellington P,4352,9,5,6,16,31,55,-24,21
CC Mariners,4352,10,4,8,15,28,49,-21,20
Sydney FC,4353,1,21,4,3,65,22,43,67
N'castle Jet,4353,2,16,5,7,59,38,21,53
Melbourne C,4353,3,14,4,11,44,35,9,46
Melbourne V,4353,4,13,5,11,45,39,6,44
Adelaide Utd,4353,5,11,6,11,37,40,-3,39
Brisbane,4353,6,10,5,13,33,42,-9,35
Western Sydn,4353,7,8,9,10,38,47,-9,33
Perth Glory,4353,8,10,2,15,37,50,-13,32
Wellington P,4353,9,5,6,16,31,55,-24,21
CC Mariners,4353,10,4,8,15,28,49,-21,20
Sydney FC,4354,1,21,4,3,66,23,43,67
N'castle Jet,4354,2,16,5,7,59,37,22,53
Melbourne C,4354,3,14,4,11,43,35,8,46
Melbourne V,4354,4,13,5,11,46,40,6,44
Adelaide Utd,4354,5,11,6,11,37,40,-3,39
Brisbane,4354,6,10,5,13,33,42,-9,35
Western Sydn,4354,7,8,9,10,38,47,-9,33
Perth Glory,4354,8,10,2,15,37,50,-13,32
Wellington P,4354,9,5,6,16,31,55,-24,21
CC Mariners,4354,10,4,8,15,28,49,-21,20
Sydney FC,4355,1,21,4,3,65,22,43,67
N'castle Jet,4355,2,15,6,7,59,39,20,51
Melbourne C,4355,3,14,5,10,45,35,10,47
Melbourne V,4355,4,13,5,11,45,39,6,44
Adelaide Utd,4355,5,11,6,11,37,40,-3,39
Brisbane,4355,6,10,5,13,33,42,-9,35
Western Sydn,4355,7,8,9,10,38,47,-9,33
Perth Glory,4355,8,10,2,15,37,50,-13,32
Wellington P,4355,9,5,6,16,31,55,-24,21
CC Mariners,4355,10,4,8,15,28,49,-21,20
Sydney FC,4356,1,21,4,3,68,22,46,67
N'castle Jet,4356,2,16,5,7,60,38,22,53
Melbourne C,4356,3,14,4,11,44,36,8,46
Melbourne V,4356,4,13,5,11,45,42,3,44
Adelaide Utd,4356,5,11,6,11,37,40,-3,39
Brisbane,4356,6,10,5,13,33,42,-9,35
Western Sydn,4356,7,8,9,10,38,47,-9,33
Perth Glory,4356,8,10,2,15,37,50,-13,32
Wellington P,4356,9,5,6,16,31,55,-24,21
CC Mariners,4356,10,4,8,15,28,49,-21,20
Sydney FC,4357,1,21,4,3,68,23,45,67
N'castle Jet,4357,2,15,5,8,59,41,18,50
Melbourne C,4357,3,15,4,10,47,35,12,49
Melbourne V,4357,4,13,5,11,46,42,4,44
Adelaide Utd,4357,5,11,6,11,37,40,-3,39
Brisbane,4357,6,10,5,13,33,42,-9,35
Western Sydn,4357,7,8,9,10,38,47,-9,33
Perth Glory,4357,8,10,2,15,37,50,-13,32
Wellington P,4357,9,5,6,16,31,55,-24,21
CC Mariners,4357,10,4,8,15,28,49,-21,20
Sydney FC,4358,1,21,4,3,68,22,46,67
N'castle Jet,4358,2,16,5,7,59,37,22,53
Melbourne C,4358,3,14,4,11,43,35,8,46
Melbourne V,4358,4,13,5,11,45,42,3,44
Adelaide Utd,4358,5,11,6,11,37,40,-3,39
Brisbane,4358,6,10,5,13,33,42,-9,35
Western Sydn,4358,7,8,9,10,38,47,-9,33
Perth Glory,4358,8,10,2,15,37,50,-13,32
Wellington P,4358,9,5,6,16,31,55,-24,21
CC Mariners,4358,10,4,8,15,28,49,-21,20
Sydney FC,4359,1,20,5,3,65,23,42,65
N'castle Jet,4359,2,16,5,7,61,38,23,53
Melbourne C,4359,3,14,4,11,44,37,7,46
Melbourne V,4359,4,13,6,10,46,39,7,45
Adelaide Utd,4359,5,11,6,11,37,40,-3,39
Brisbane,4359,6,10,5,13,33,42,-9,35
Western Sydn,4359,7,8,9,10,38,47,-9,33
Perth Glory,4359,8,10,2,15,37,50,-13,32
Wellington P,4359,9,5,6,16,31,55,-24,21
CC Mariners,4359,10,4,8,15,28,49,-21,20
Sydney FC,4360,1,21,4,3,66,23,43,67
N'castle Jet,4360,2,16,5,7,58,37,21,53
Melbourne C,4360,3,14,4,11,43,34,9,46
Melbourne V,4360,4,13,5,11,46,40,6,44
Adelaide Utd,4360,5,11,6,11,37,40,-3,39
Brisbane,4360,6,10,5,13,33,42,-9,35
Western Sydn,4360,7,8,9,10,38,47,-9,33
Perth Glory,4360,8,10,2,15,37,50,-13,32
Wellington P,4360,9,5,6,16,31,55,-24,21
CC Mariners,4360,10,4,8,15,28,49,-21,20
Sydney FC,4361,1,21,4,3,65,22,43,67
N'castle Jet,4361,2,15,6,7,57,37,20,51
Melbourne C,4361,3,14,5,10,43,33,10,47
Melbourne V,4361,4,13,5,11,45,39,6,44
Adelaide Utd,4361,5,11,6,11,37,40,-3,39
Brisbane,4361,6,10,5,13,33,42,-9,35
Western Sydn,4361,7,8,9,10,38,47,-9,33
Perth Glory,4361,8,10,2,15,37,50,-13,32
Wellington P,4361,9,5,6,16,31,55,-24,21
CC Mariners,4361,10,4,8,15,28,49,-21,20
Sydney FC,4362,1,20,4,4,66,26,40,64
N'castle Jet,4362,2,15,6,7,58,38,20,51
Melbourne C,4362,3,14,5,10,44,34,10,47
Melbourne V,4362,4,14,5,10,49,40,9,47
Adelaide Utd,4362,5,11,6,11,37,40,-3,39
Brisbane,4362,6,10,5,13,33,42,-9,35
Western Sydn,4362,7,8,9,10,38,47,-9,33
Perth Glory,4362,8,10,2,15,37,50,-13,32
Wellington P,4362,9,5,6,16,31,55,-24,21
CC Mariners,4362,10,4,8,15,28,49,-21,20
Sydney FC,4363,1,20,5,3,65,23,42,65
N'castle Jet,4363,2,16,5,7,60,38,22,53
Melbourne C,4363,3,14,4,11,44,36,8,46
Melbourne V,4363,4,13,6,10,46,39,7,45
Adelaide Utd,4363,5,11,6,11,37,40,-3,39
Brisbane,4363,6,10,5,13,33,42,-9,35
Western Sydn,4363,7,8,9,10,38,47,-9,33
Perth Glory,4363,8,10,2,15,37,50,-13,32
Wellington P,4363,9,5,6,16,31,55,-24,21
CC Mariners,4363,10,4,8,15,28,49,-21,20
Sydney FC,4364,1,21,4,3,67,22,45,67
N'castle Jet,4364,2,16,5,7,58,37,21,53
Melbourne C,4364,3,14,4,11,43,34,9,46
Melbourne V,4364,4,13,5,11,45,41,4,44
Adelaide Utd,4364,5,11,6,11,37,40,-3,39
Brisbane,4364,6,10,5,13,33,42,-9,35
Western Sydn,4364,7,8,9,10,38,47,-9,33
Perth Glory,4364,8,10,2,15,37,50,-13,32
Wellington P,4364,9,5,6,16,31,55,-24,21
CC Mariners,4364,10,4,8,15,28,49,-21,20
Sydney FC,4365,1,20,5,3,64,22,42,65
N'castle Jet,4365,2,16,5,7,59,38,21,53
Melbourne C,4365,3,14,4,11,44,35,9,46
Melbourne V,4365,4,13,6,10,45,38,7,45
Adelaide Utd,4365,5,11,6,11,37,40,-3,39
Brisbane,4365,6,10,5,13,33,42,-9,35
Western Sydn,4365,7,8,9,10,38,47,-9,33
Perth Glory,4365,8,10,2,15,37,50,-13,32
Wellington P,4365,9,5,6,16,31,55,-24,21
CC Mariners,4365,10,4,8,15,28,49,-21,20
Sydney FC,4366,1,21,4,3,68,23,45,67
N'castle Jet,4366,2,15,6,7,60,40,20,51
Melbourne C,4366,3,14,5,10,46,36,10,47
Melbourne V,4366,4,13,5,11,46,42,4,44
Adelaide Utd,4366,5,11,6,11,37,40,-3,39
Brisbane,4366,6,10,5,13,33,42,-9,35
Western Sydn,4366,7,8,9,10,38,47,-9,33
Perth Glory,4366,8,10,2,15,37,50,-13,32
Wellington P,4366,9,5,6,16,31,55,-24,21
CC Mariners,4366,10,4,8,15,28,49,-21,20
Sydney FC,4367,1,21,4,3,67,22,45,67
N'castle Jet,4367,2,16,5,7,61,38,23,53
Melbourne C,4367,3,14,4,11,44,37,7,46
Melbourne V,4367,4,13,5,11,45,41,4,44
Adelaide Utd,4367,5,11,6,11,37,40,-3,39
Brisbane,4367,6,10,5,13,33,42,-9,35
Western Sydn,4367,7,8,9,10,38,47,-9,33
Perth Glory,4367,8,10,2,15,37,50,-13,32
Wellington P,4367,9,5,6,16,31,55,-24,21
CC Mariners,4367,10,4,8,15,28,49,-21,20
Sydney FC,4368,1,21,4,3,72,24,48,67
N'castle Jet,4368,2,15,5,8,57,38,19,50
Melbourne C,4368,3,15,4,10,44,33,11,49
Melbourne V,4368,4,13,5,11,47,46,1,44
Adelaide Utd,4368,5,11,6,11,37,40,-3,39
Brisbane,4368,6,10,5,13,33,42,-9,35
Western Sydn,4368,7,8,9,10,38,47,-9,33
Perth Glory,4368,8,10,2,15,37,50,-13,32
Wellington P,4368,9,5,6,16,31,55,-24,21
CC Mariners,4368,10,4,8,15,28,49,-21,20
Sydney FC,4369,1,21,4,3,66,22,44,67
N'castle Jet,4369,2,16,5,7,61,38,23,53
Melbourne C,4369,3,14,4,11,44,37,7,46
Melbourne V,4369,4,13,5,11,45,40,5,44
Adelaide Utd,4369,5,11,6,11,37,40,-3,39
Brisbane,4369,6,10,5,13,33,42,-9,35
Western Sydn,4369,7,8,9,10,38,47,-9,33
Perth Glory,4369,8,10,2,15,37,50,-13,32
Wellington P,4369,9,5,6,16,31,55,-24,21
CC Mariners,4369,10,4,8,15,28,49,-21,20
Sydney FC,4370,1,21,4,3,66,23,43,67
N'castle Jet,4370,2,16,5,7,59,37,22,53
Melbourne C,4370,3,14,4,11,43,35,8,46
Melbourne V,4370,4,13,5,11,46,40,6,44
Adelaide Utd,4370,5,11,6,11,37,40,-3,39
Brisbane,4370,6,10,5,13,33,42,-9,35
Western Sydn,4370,7,8,9,10,38,47,-9,33
Perth Glory,4370,8,10,2,15,37,50,-13,32
Wellington P,4370,9,5,6,16,31,55,-24,21
CC Mariners,4370,10,4,8,15,28,49,-21,20
Sydney FC,4371,1,21,4,3,67,24,43,67
N'castle Jet,4371,2,15,6,7,59,39,20,51
Melbourne C,4371,3,14,5,10,45,35,10,47
Melbourne V,4371,4,13,5,11,47,41,6,44
Adelaide Utd,4371,5,11,6,11,37,40,-3,39
Brisbane,4371,6,10,5,13,33,42,-9,35
Western Sydn,4371,7,8,9,10,38,47,-9,33
Perth Glory,4371,8,10,2,15,37,50,-13,32
Wellington P,4371,9,5,6,16,31,55,-24,21
CC Mariners,4371,10,4,8,15,28,49,-21,20
Sydney FC,4372,1,20,4,4,64,23,41,64
N'castle Jet,4372,2,15,5,8,57,38,19,50
Melbourne C,4372,3,15,4,10,44,33,11,49
Melbourne V,4372,4,14,5,10,46,38,8,47
Adelaide Utd,4372,5,11,6,11,37,40,-3,39
Brisbane,4372,6,10,5,13,33,42,-9,35
Western Sydn,4372,7,8,9,10,38,47,-9,33
Perth Glory,4372,8,10,2,15,37,50,-13,32
Wellington P,4372,9,5,6,16,31,55,-24,21
CC Mariners,4372,10,4,8,15,28,49,-21,20
Sydney FC,4373,1,20,4,4,65,24,41,64
N'castle Jet,4373,2,16,5,7,63,38,25,53
Melbourne V,4373,3,14,5,10,47,39,8,47
Melbourne C,4373,4,14,4,11,44,39,5,46
Adelaide Utd,4373,5,11,6,11,37,40,-3,39
Brisbane,4373,6,10,5,13,33,42,-9,35
Western Sydn,4373,7,8,9,10,38,47,-9,33
Perth Glory,4373,8,10,2,15,37,50,-13,32
Wellington P,4373,9,5,6,16,31,55,-24,21
CC Mariners,4373,10,4,8,15,28,49,-21,20
Sydney FC,4374,1,20,4,4,65,24,41,64
N'castle Jet,4374,2,16,5,7,63,37,26,53
Melbourne V,4374,3,14,5,10,47,39,8,47
Melbourne C,4374,4,14,4,11,43,39,4,46
Adelaide Utd,4374,5,11,6,11,37,40,-3,39
Brisbane,4374,6,10,5,13,33,42,-9,35
Western Sydn,4374,7,8,9,10,38,47,-9,33
Perth Glory,4374,8,10,2,15,37,50,-13,32
Wellington P,4374,9,5,6,16,31,55,-24,21
CC Mariners,4374,10,4,8,15,28,49,-21,20
Sydney FC,4375,1,21,4,3,67,22,45,67
N'castle Jet,4375,2,16,5,7,60,38,22,53
Melbourne C,4375,3,14,4,11,44,36,8,46
Melbourne V,4375,4,13,5,11,45,41,4,44
Adelaide Utd,4375,5,11,6,11,37,40,-3,39
Brisbane,4375,6,10,5,13,33,42,-9,35
Western Sydn,4375,7,8,9,10,38,47,-9,33
Perth Glory,4375,8,10,2,15,37,50,-13,32
Wellington P,4375,9,5,6,16,31,55,-24,21
CC Mariners,4375,10,4,8,15,28,49,-21,20
Sydney FC,4376,1,21,4,3,67,24,43,67
N'castle Jet,4376,2,15,6,7,59,39,20,51
Melbourne C,4376,3,14,5,10,45,35,10,47
Melbourne V,4376,4,13,5,11,47,41,6,44
Adelaide Utd,4376,5,11,6,11,37,40,-3,39
Brisbane,4376,6,10,5,13,33,42,-9,35
Western Sydn,4376,7,8,9,10,38,47,-9,33
Perth Glory,4376,8,10,2,15,37,50,-13,32
Wellington P,4376,9,5,6,16,31,55,-24,21
CC Mariners,4376,10,4,8,15,28,49,-21,20
Sydney FC,4377,1,21,4,3,65,22,43,67
N'castle Jet,4377,2,16,5,7,59,37,22,53
Melbourne C,4377,3,14,4,11,43,35,8,46
Melbourne V,4377,4,13,5,11,45,39,6,44
Adelaide Utd,4377,5,11,6,11,37,40,-3,39
Brisbane,4377,6,10,5,13,33,42,-9,35
Western Sydn,4377,7,8,9,10,38,47,-9,33
Perth Glory,4377,8,10,2,15,37,50,-13,32
Wellington P,4377,9,5,6,16,31,55,-24,21
CC Mariners,4377,10,4,8,15,28,49,-21,20
Sydney FC,4378,1,21,4,3,65,22,43,67
N'castle Jet,4378,2,16,5,7,58,37,21,53
Melbourne C,4378,3,14,4,11,43,34,9,46
Melbourne V,4378,4,13,5,11,45,39,6,44
Adelaide Utd,4378,5,11,6,11,37,40,-3,39
Brisbane,4378,6,10,5,13,33,42,-9,35
Western Sydn,4378,7,8,9,10,38,47,-9,33
Perth Glory,4378,8,10,2,15,37,50,-13,32
Wellington P,4378,9,5,6,16,31,55,-24,21
CC Mariners,4378,10,4,8,15,28,49,-21,20
Sydney FC,4379,1,21,4,3,65,22,43,67
N'castle Jet,4379,2,15,6,7,57,37,20,51
Melbourne C,4379,3,14,5,10,43,33,10,47
Melbourne V,4379,4,13,5,11,45,39,6,44
Adelaide Utd,4379,5,11,6,11,37,40,-3,39
Brisbane,4379,6,10,5,13,33,42,-9,35
Western Sydn,4379,7,8,9,10,38,47,-9,33
Perth Glory,4379,8,10,2,15,37,50,-13,32
Wellington P,4379,9,5,6,16,31,55,-24,21
CC Mariners,4379,10,4,8,15,28,49,-21,20
Sydney FC,4380,1,20,5,3,66,24,42,65
N'castle Jet,4380,2,16,5,7,61,39,22,53
Melbourne C,4380,3,14,4,11,45,37,8,46
Melbourne V,4380,4,13,6,10,47,40,7,45
Adelaide Utd,4380,5,11,6,11,37,40,-3,39
Brisbane,4380,6,10,5,13,33,42,-9,35
Western Sydn,4380,7,8,9,10,38,47,-9,33
Perth Glory,4380,8,10,2,15,37,50,-13,32
Wellington P,4380,9,5,6,16,31,55,-24,21
CC Mariners,4380,10,4,8,15,28,49,-21,20
Sydney FC,4381,1,21,4,3,65,22,43,67
N'castle Jet,4381,2,16,5,7,58,37,21,53
Melbourne C,4381,3,14,4,11,43,34,9,46
Melbourne V,4381,4,13,5,11,45,39,6,44
Adelaide Utd,4381,5,11,6,11,37,40,-3,39
Brisbane,4381,6,10,5,13,33,42,-9,35
Western Sydn,4381,7,8,9,10,38,47,-9,33
Perth Glory,4381,8,10,2,15,37,50,-13,32
Wellington P,4381,9,5,6,16,31,55,-24,21
CC Mariners,4381,10,4,8,15,28,49,-21,20
Sydney FC,4382,1,20,5,3,67,25,42,65
N'castle Jet,4382,2,15,6,7,58,38,20,51
Melbourne C,4382,3,14,5,10,44,34,10,47
Melbourne V,4382,4,13,6,10,48,41,7,45
Adelaide Utd,4382,5,11,6,11,37,40,-3,39
Brisbane,4382,6,10,5,13,33,42,-9,35
Western Sydn,4382,7,8,9,10,38,47,-9,33
Perth Glory,4382,8,10,2,15,37,50,-13,32
Wellington P,4382,9,5,6,16,31,55,-24,21
CC Mariners,4382,10,4,8,15,28,49,-21,20
Sydney FC,4383,1,21,4,3,68,23,45,67
N'castle Jet,4383,2,16,5,7,59,38,21,53
Melbourne C,4383,3,14,4,11,44,35,9,46
Melbourne V,4383,4,13,5,11,46,42,4,44
Adelaide Utd,4383,5,11,6,11,37,40,-3,39
Brisbane,4383,6,10,5,13,33,42,-9,35
Western Sydn,4383,7,8,9,10,38,47,-9,33
Perth Glory,4383,8,10,2,15,37,50,-13,32
Wellington P,4383,9,5,6,16,31,55,-24,21
CC Mariners,4383,10,4,8,15,28,49,-21,20
Sydney FC,4384,1,20,5,3,65,23,42,65
N'castle Jet,4384,2,15,5,8,58,39,19,50
Melbourne C,4384,3,15,4,10,45,34,11,49
Melbourne V,4384,4,13,6,10,46,39,7,45
Adelaide Utd,4384,5,11,6,11,37,40,-3,39
Brisbane,4384,6,10,5,13,33,42,-9,35
Western Sydn,4384,7,8,9,10,38,47,-9,33
Perth Glory,4384,8,10,2,15,37,50,-13,32
Wellington P,4384,9,5,6,16,31,55,-24,21
CC Mariners,4384,10,4,8,15,28,49,-21,20
Sydney FC,4385,1,21,4,3,68,24,44,67
N'castle Jet,4385,2,16,5,7,59,37,22,53
Melbourne C,4385,3,14,4,11,43,35,8,46
Melbourne V,4385,4,13,5,11,47,42,5,44
Adelaide Utd,4385,5,11,6,11,37,40,-3,39
Brisbane,4385,6,10,5,13,33,42,-9,35
Western Sydn,4385,7,8,9,10,38,47,-9,33
Perth Glory,4385,8,10,2,15,37,50,-13,32
Wellington P,4385,9,5,6,16,31,55,-24,21
CC Mariners,4385,10,4,8,15,28,49,-21,20
Sydney FC,4386,1,21,4,3,67,23,44,67
N'castle Jet,4386,2,15,5,8,58,39,19,50
Melbourne C,4386,3,15,4,10,45,34,11,49
Melbourne V,4386,4,13,5,11,46,41,5,44
Adelaide Utd,4386,5,11,6,11,37,40,-3,39
Brisbane,4386,6,10,5,13,33,42,-9,35
Western Sydn,4386,7,8,9,10,38,47,-9,33
Perth Glory,4386,8,10,2,15,37,50,-13,32
Wellington P,4386,9,5,6,16,31,55,-24,21
CC Mariners,4386,10,4,8,15,28,49,-21,20
Sydney FC,4387,1,20,4,4,64,24,40,64
N'castle Jet,4387,2,15,6,7,58,38,20,51
Melbourne C,4387,3,14,5,10,44,34,10,47
Melbourne V,4387,4,14,5,10,47,38,9,47
Adelaide Utd,4387,5,11,6,11,37,40,-3,39
Brisbane,4387,6,10,5,13,33,42,-9,35
Western Sydn,4387,7,8,9,10,38,47,-9,33
Perth Glory,4387,8,10,2,15,37,50,-13,32
Wellington P,4387,9,5,6,16,31,55,-24,21
CC Mariners,4387,10,4,8,15,28,49,-21,20
Sydney FC,4388,1,20,4,4,64,23,41,64
N'castle Jet,4388,2,15,5,8,57,39,18,50
Melbourne C,4388,3,15,4,10,45,33,12,49
Melbourne V,4388,4,14,5,10,46,38,8,47
Adelaide Utd,4388,5,11,6,11,37,40,-3,39
Brisbane,4388,6,10,5,13,33,42,-9,35
Western Sydn,4388,7,8,9,10,38,47,-9,33
Perth Glory,4388,8,10,2,15,37,50,-13,32
Wellington P,4388,9,5,6,16,31,55,-24,21
CC Mariners,4388,10,4,8,15,28,49,-21,20
Sydney FC,4389,1,21,4,3,65,22,43,67
N'castle Jet,4389,2,16,5,7,60,38,22,53
Melbourne C,4389,3,14,4,11,44,36,8,46
Melbourne V,4389,4,13,5,11,45,39,6,44
Adelaide Utd,4389,5,11,6,11,37,40,-3,39
Brisbane,4389,6,10,5,13,33,42,-9,35
Western Sydn,4389,7,8,9,10,38,47,-9,33
Perth Glory,4389,8,10,2,15,37,50,-13,32
Wellington P,4389,9,5,6,16,31,55,-24,21
CC Mariners,4389,10,4,8,15,28,49,-21,20
Sydney FC,4390,1,20,5,3,66,24,42,65
N'castle Jet,4390,2,16,5,7,59,38,21,53
Melbourne C,4390,3,14,4,11,44,35,9,46
Melbourne V,4390,4,13,6,10,47,40,7,45
Adelaide Utd,4390,5,11,6,11,37,40,-3,39
Brisbane,4390,6,10,5,13,33,42,-9,35
Western Sydn,4390,7,8,9,10,38,47,-9,33
Perth Glory,4390,8,10,2,15,37,50,-13,32
Wellington P,4390,9,5,6,16,31,55,-24,21
CC Mariners,4390,10,4,8,15,28,49,-21,20
Sydney FC,4391,1,21,4,3,66,23,43,67
N'castle Jet,4391,2,16,5,7,58,37,21,53
Melbourne C,4391,3,14,4,11,43,34,9,46
Melbourne V,4391,4,13,5,11,46,40,6,44
Adelaide Utd,4391,5,11,6,11,37,40,-3,39
Brisbane,4391,6,10,5,13,33,42,-9,35
Western Sydn,4391,7,8,9,10,38,47,-9,33
Perth Glory,4391,8,10,2,15,37,50,-13,32
Wellington P,4391,9,5,6,16,31,55,-24,21
CC Mariners,4391,10,4,8,15,28,49,-21,20
Sydney FC,4392,1,21,4,3,69,22,47,67
N'castle Jet,4392,2,16,5,7,58,37,21,53
Melbourne C,4392,3,14,4,11,43,34,9,46
Melbourne V,4392,4,13,5,11,45,43,2,44
Adelaide Utd,4392,5,11,6,11,37,40,-3,39
Brisbane,4392,6,10,5,13,33,42,-9,35
Western Sydn,4392,7,8,9,10,38,47,-9,33
Perth Glory,4392,8,10,2,15,37,50,-13,32
Wellington P,4392,9,5,6,16,31,55,-24,21
CC Mariners,4392,10,4,8,15,28,49,-21,20
Sydney FC,4393,1,20,4,4,65,24,41,64
N'castle Jet,4393,2,16,5,7,59,38,21,53
Melbourne V,4393,3,14,5,10,47,39,8,47
Melbourne C,4393,4,14,4,11,44,35,9,46
Adelaide Utd,4393,5,11,6,11,37,40,-3,39
Brisbane,4393,6,10,5,13,33,42,-9,35
Western Sydn,4393,7,8,9,10,38,47,-9,33
Perth Glory,4393,8,10,2,15,37,50,-13,32
Wellington P,4393,9,5,6,16,31,55,-24,21
CC Mariners,4393,10,4,8,15,28,49,-21,20
Sydney FC,4394,1,21,4,3,66,22,44,67
N'castle Jet,4394,2,15,5,8,57,38,19,50
Melbourne C,4394,3,15,4,10,44,33,11,49
Melbourne V,4394,4,13,5,11,45,40,5,44
Adelaide Utd,4394,5,11,6,11,37,40,-3,39
Brisbane,4394,6,10,5,13,33,42,-9,35
Western Sydn,4394,7,8,9,10,38,47,-9,33
Perth Glory,4394,8,10,2,15,37,50,-13,32
Wellington P,4394,9,5,6,16,31,55,-24,21
CC Mariners,4394,10,4,8,15,28,49,-21,20
Sydney FC,4395,1,21,4,3,65,22,43,67
N'castle Jet,4395,2,15,6,7,60,40,20,51
Melbourne C,4395,3,14,5,10,46,36,10,47
Melbourne V,4395,4,13,5,11,45,39,6,44
Adelaide Utd,4395,5,11,6,11,37,40,-3,39
Brisbane,4395,6,10,5,13,33,42,-9,35
Western Sydn,4395,7,8,9,10,38,47,-9,33
Perth Glory,4395,8,10,2,15,37,50,-13,32
Wellington P,4395,9,5,6,16,31,55,-24,21
CC Mariners,4395,10,4,8,15,28,49,-21,20
Sydney FC,4396,1,21,4,3,66,22,44,67
N'castle Jet,4396,2,15,6,7,57,37,20,51
Melbourne C,4396,3,14,5,10,43,33,10,47
Melbourne V,4396,4,13,5,11,45,40,5,44
Adelaide Utd,4396,5,11,6,11,37,40,-3,39
Brisbane,4396,6,10,5,13,33,42,-9,35
Western Sydn,4396,7,8,9,10,38,47,-9,33
Perth Glory,4396,8,10,2,15,37,50,-13,32
Wellington P,4396,9,5,6,16,31,55,-24,21
CC Mariners,4396,10,4,8,15,28,49,-21,20
Sydney FC,4397,1,21,4,3,66,23,43,67
N'castle Jet,4397,2,16,5,7,58,37,21,53
Melbourne C,4397,3,14,4,11,43,34,9,46
Melbourne V,4397,4,13,5,11,46,40,6,44
Adelaide Utd,4397,5,11,6,11,37,40,-3,39
Brisbane,4397,6,10,5,13,33,42,-9,35
Western Sydn,4397,7,8,9,10,38,47,-9,33
Perth Glory,4397,8,10,2,15,37,50,-13,32
Wellington P,4397,9,5,6,16,31,55,-24,21
CC Mariners,4397,10,4,8,15,28,49,-21,20
Sydney FC,4398,1,20,4,4,64,24,40,64
N'castle Jet,4398,2,16,5,7,62,38,24,53
Melbourne V,4398,3,14,5,10,47,38,9,47
Melbourne C,4398,4,14,4,11,44,38,6,46
Adelaide Utd,4398,5,11,6,11,37,40,-3,39
Brisbane,4398,6,10,5,13,33,42,-9,35
Western Sydn,4398,7,8,9,10,38,47,-9,33
Perth Glory,4398,8,10,2,15,37,50,-13,32
Wellington P,4398,9,5,6,16,31,55,-24,21
CC Mariners,4398,10,4,8,15,28,49,-21,20
Sydney FC,4399,1,20,5,3,65,23,42,65
N'castle Jet,4399,2,15,6,7,59,39,20,51
Melbourne C,4399,3,14,5,10,45,35,10,47
Melbourne V,4399,4,13,6,10,46,39,7,45
Adelaide Utd,4399,5,11,6,11,37,40,-3,39
Brisbane,4399,6,10,5,13,33,42,-9,35
Western Sydn,4399,7,8,9,10,38,47,-9,33
Perth Glory,4399,8,10,2,15,37,50,-13,32
Wellington P,4399,9,5,6,16,31,55,-24,21
CC Mariners,4399,10,4,8,15,28,49,-21,20
Sydney FC,4400,1,21,4,3,66,23,43,67
N'castle Jet,4400,2,16,5,7,60,38,22,53
Melbourne C,4400,3,14,4,11,44,36,8,46
Melbourne V,4400,4,13,5,11,46,40,6,44
Adelaide Utd,4400,5,11,6,11,37,40,-3,39
Brisbane,4400,6,10,5,13,33,42,-9,35
Western Sydn,4400,7,8,9,10,38,47,-9,33
Perth Glory,4400,8,10,2,15,37,50,-13,32
Wellington P,4400,9,5,6,16,31,55,-24,21
CC Mariners,4400,10,4,8,15,28,49,-21,20
Sydney FC,4401,1,20,4,4,65,24,41,64
N'castle Jet,4401,2,15,5,8,59,40,19,50
Melbourne C,4401,3,15,4,10,46,35,11,49
Melbourne V,4401,4,14,5,10,47,39,8,47
Adelaide Utd,4401,5,11,6,11,37,40,-3,39
Brisbane,4401,6,10,5,13,33,42,-9,35
Western Sydn,4401,7,8,9,10,38,47,-9,33
Perth Glory,4401,8,10,2,15,37,50,-13,32
Wellington P,4401,9,5,6,16,31,55,-24,21
CC Mariners,4401,10,4,8,15,28,49,-21,20
Sydney FC,4402,1,21,4,3,69,24,45,67
N'castle Jet,4402,2,16,5,7,61,38,23,53
Melbourne C,4402,3,14,4,11,44,37,7,46
Melbourne V,4402,4,13,5,11,47,43,4,44
Adelaide Utd,4402,5,11,6,11,37,40,-3,39
Brisbane,4402,6,10,5,13,33,42,-9,35
Western Sydn,4402,7,8,9,10,38,47,-9,33
Perth Glory,4402,8,10,2,15,37,50,-13,32
Wellington P,4402,9,5,6,16,31,55,-24,21
CC Mariners,4402,10,4,8,15,28,49,-21,20
Sydney FC,4403,1,21,4,3,67,24,43,67
N'castle Jet,4403,2,15,6,7,57,37,20,51
Melbourne C,4403,3,14,5,10,43,33,10,47
Melbourne V,4403,4,13,5,11,47,41,6,44
Adelaide Utd,4403,5,11,6,11,37,40,-3,39
Brisbane,4403,6,10,5,13,33,42,-9,35
Western Sydn,4403,7,8,9,10,38,47,-9,33
Perth Glory,4403,8,10,2,15,37,50,-13,32
Wellington P,4403,9,5,6,16,31,55,-24,21
CC Mariners,4403,10,4,8,15,28,49,-21,20
Sydney FC,4404,1,21,4,3,65,22,43,67
N'castle Jet,4404,2,15,5,8,58,39,19,50
Melbourne C,4404,3,15,4,10,45,34,11,49
Melbourne V,4404,4,13,5,11,45,39,6,44
Adelaide Utd,4404,5,11,6,11,37,40,-3,39
Brisbane,4404,6,10,5,13,33,42,-9,35
Western Sydn,4404,7,8,9,10,38,47,-9,33
Perth Glory,4404,8,10,2,15,37,50,-13,32
Wellington P,4404,9,5,6,16,31,55,-24,21
CC Mariners,4404,10,4,8,15,28,49,-21,20
Sydney FC,4405,1,21,4,3,67,23,44,67
N'castle Jet,4405,2,15,5,8,57,38,19,50
Melbourne C,4405,3,15,4,10,44,33,11,49
Melbourne V,4405,4,13,5,11,46,41,5,44
Adelaide Utd,4405,5,11,6,11,37,40,-3,39
Brisbane,4405,6,10,5,13,33,42,-9,35
Western Sydn,4405,7,8,9,10,38,47,-9,33
Perth Glory,4405,8,10,2,15,37,50,-13,32
Wellington P,4405,9,5,6,16,31,55,-24,21
CC Mariners,4405,10,4,8,15,28,49,-21,20
Sydney FC,4406,1,21,4,3,68,22,46,67
N'castle Jet,4406,2,16,5,7,59,37,22,53
Melbourne C,4406,3,14,4,11,43,35,8,46
Melbourne V,4406,4,13,5,11,45,42,3,44
Adelaide Utd,4406,5,11,6,11,37,40,-3,39
Brisbane,4406,6,10,5,13,33,42,-9,35
Western Sydn,4406,7,8,9,10,38,47,-9,33
Perth Glory,4406,8,10,2,15,37,50,-13,32
Wellington P,4406,9,5,6,16,31,55,-24,21
CC Mariners,4406,10,4,8,15,28,49,-21,20
Sydney FC,4407,1,21,4,3,66,23,43,67
N'castle Jet,4407,2,15,6,7,58,38,20,51
Melbourne C,4407,3,14,5,10,44,34,10,47
Melbourne V,4407,4,13,5,11,46,40,6,44
Adelaide Utd,4407,5,11,6,11,37,40,-3,39
Brisbane,4407,6,10,5,13,33,42,-9,35
Western Sydn,4407,7,8,9,10,38,47,-9,33
Perth Glory,4407,8,10,2,15,37,50,-13,32
Wellington P,4407,9,5,6,16,31,55,-24,21
CC Mariners,4407,10,4,8,15,28,49,-21,20
Sydney FC,4408,1,20,5,3,66,24,42,65
N'castle Jet,4408,2,16,5,7,59,37,22,53
Melbourne C,4408,3,14,4,11,43,35,8,46
Melbourne V,4408,4,13,6,10,47,40,7,45
Adelaide Utd,4408,5,11,6,11,37,40,-3,39
Brisbane,4408,6,10,5,13,33,42,-9,35
Western Sydn,4408,7,8,9,10,38,47,-9,33
Perth Glory,4408,8,10,2,15,37,50,-13,32
Wellington P,4408,9,5,6,16,31,55,-24,21
CC Mariners,4408,10,4,8,15,28,49,-21,20
Sydney FC,4409,1,21,4,3,66,22,44,67
N'castle Jet,4409,2,16,5,7,60,37,23,53
Melbourne C,4409,3,14,4,11,43,36,7,46
Melbourne V,4409,4,13,5,11,45,40,5,44
Adelaide Utd,4409,5,11,6,11,37,40,-3,39
Brisbane,4409,6,10,5,13,33,42,-9,35
Western Sydn,4409,7,8,9,10,38,47,-9,33
Perth Glory,4409,8,10,2,15,37,50,-13,32
Wellington P,4409,9,5,6,16,31,55,-24,21
CC Mariners,4409,10,4,8,15,28,49,-21,20
Sydney FC,4410,1,21,4,3,67,23,44,67
N'castle Jet,4410,2,16,5,7,59,38,21,53
Melbourne C,4410,3,14,4,11,44,35,9,46
Melbourne V,4410,4,13,5,11,46,41,5,44
Adelaide Utd,4410,5,11,6,11,37,40,-3,39
Brisbane,4410,6,10,5,13,33,42,-9,35
Western Sydn,4410,7,8,9,10,38,47,-9,33
Perth Glory,4410,8,10,2,15,37,50,-13,32
Wellington P,4410,9,5,6,16,31,55,-24,21
CC Mariners,4410,10,4,8,15,28,49,-21,20
Sydney FC,4411,1,21,4,3,67,23,44,67
N'castle Jet,4411,2,16,5,7,62,38,24,53
Melbourne C,4411,3,14,4,11,44,38,6,46
Melbourne V,4411,4,13,5,11,46,41,5,44
Adelaide Utd,4411,5,11,6,11,37,40,-3,39
Brisbane,4411,6,10,5,13,33,42,-9,35
Western Sydn,4411,7,8,9,10,38,47,-9,33
Perth Glory,4411,8,10,2,15,37,50,-13,32
Wellington P,4411,9,5,6,16,31,55,-24,21
CC Mariners,4411,10,4,8,15,28,49,-21,20
Sydney FC,4412,1,21,4,3,68,22,46,67
N'castle Jet,4412,2,15,6,7,58,38,20,51
Melbourne C,4412,3,14,5,10,44,34,10,47
Melbourne V,4412,4,13,5,11,45,42,3,44
Adelaide Utd,4412,5,11,6,11,37,40,-3,39
Brisbane,4412,6,10,5,13,33,42,-9,35
Western Sydn,4412,7,8,9,10,38,47,-9,33
Perth Glory,4412,8,10,2,15,37,50,-13,32
Wellington P,4412,9,5,6,16,31,55,-24,21
CC Mariners,4412,10,4,8,15,28,49,-21,20
Sydney FC,4413,1,21,4,3,66,22,44,67
N'castle Jet,4413,2,15,5,8,57,38,19,50
Melbourne C,4413,3,15,4,10,44,33,11,49
Melbourne V,4413,4,13,5,11,45,40,5,44
Adelaide Utd,4413,5,11,6,11,37,40,-3,39
Brisbane,4413,6,10,5,13,33,42,-9,35
Western Sydn,4413,7,8,9,10,38,47,-9,33
Perth Glory,4413,8,10,2,15,37,50,-13,32
Wellington P,4413,9,5,6,16,31,55,-24,21
CC Mariners,4413,10,4,8,15,28,49,-21,20
Sydney FC,4414,1,21,4,3,66,22,44,67
N'castle Jet,4414,2,16,5,7,59,38,21,53
Melbourne C,4414,3,14,4,11,44,35,9,46
Melbourne V,4414,4,13,5,11,45,40,5,44
Adelaide Utd,4414,5,11,6,11,37,40,-3,39
Brisbane,4414,6,10,5,13,33,42,-9,35
Western Sydn,4414,7,8,9,10,38,47,-9,33
Perth Glory,4414,8,10,2,15,37,50,-13,32
Wellington P,4414,9,5,6,16,31,55,-24,21
CC Mariners,4414,10,4,8,15,28,49,-21,20
Sydney FC,4415,1,21,4,3,66,22,44,67
N'castle Jet,4415,2,15,6,7,58,38,20,51
Melbourne C,4415,3,14,5,10,44,34,10,47
Melbourne V,4415,4,13,5,11,45,40,5,44
Adelaide Utd,4415,5,11,6,11,37,40,-3,39
Brisbane,4415,6,10,5,13,33,42,-9,35
Western Sydn,4415,7,8,9,10,38,47,-9,33
Perth Glory,4415,8,10,2,15,37,50,-13,32
Wellington P,4415,9,5,6,16,31,55,-24,21
CC Mariners,4415,10,4,8,15,28,49,-21,20
Sydney FC,4416,1,21,4,3,66,23,43,67
N'castle Jet,4416,2,15,6,7,58,38,20,51
Melbourne C,4416,3,14,5,10,44,34,10,47
Melbourne V,4416,4,13,5,11,46,40,6,44
Adelaide Utd,4416,5,11,6,11,37,40,-3,39
Brisbane,4416,6,10,5,13,33,42,-9,35
Western Sydn,4416,7,8,9,10,38,47,-9,33
Perth Glory,4416,8,10,2,15,37,50,-13,32
Wellington P,4416,9,5,6,16,31,55,-24,21
CC Mariners,4416,10,4,8,15,28,49,-21,20
Sydney FC,4417,1,20,4,4,65,24,41,64
N'castle Jet,4417,2,15,6,7,57,37,20,51
Melbourne C,4417,3,14,5,10,43,33,10,47
Melbourne V,4417,4,14,5,10,47,39,8,47
Adelaide Utd,4417,5,11,6,11,37,40,-3,39
Brisbane,4417,6,10,5,13,33,42,-9,35
Western Sydn,4417,7,8,9,10,38,47,-9,33
Perth Glory,4417,8,10,2,15,37,50,-13,32
Wellington P,4417,9,5,6,16,31,55,-24,21
CC Mariners,4417,10,4,8,15,28,49,-21,20
Sydney FC,4418,1,20,4,4,64,24,40,64
N'castle Jet,4418,2,16,5,7,60,37,23,53
Melbourne V,4418,3,14,5,10,47,38,9,47
Melbourne C,4418,4,14,4,11,43,36,7,46
Adelaide Utd,4418,5,11,6,11,37,40,-3,39
Brisbane,4418,6,10,5,13,33,42,-9,35
Western Sydn,4418,7,8,9,10,38,47,-9,33
Perth Glory,4418,8,10,2,15,37,50,-13,32
Wellington P,4418,9,5,6,16,31,55,-24,21
CC Mariners,4418,10,4,8,15,28,49,-21,20
Sydney FC,4419,1,21,4,3,67,22,45,67
N'castle Jet,4419,2,15,6,7,60,40,20,51
Melbourne C,4419,3,14,5,10,46,36,10,47
Melbourne V,4419,4,13,5,11,45,41,4,44
Adelaide Utd,4419,5,11,6,11,37,40,-3,39
Brisbane,4419,6,10,5,13,33,42,-9,35
Western Sydn,4419,7,8,9,10,38,47,-9,33
Perth Glory,4419,8,10,2,15,37,50,-13,32
Wellington P,4419,9,5,6,16,31,55,-24,21
CC Mariners,4419,10,4,8,15,28,49,-21,20
Sydney FC,4420,1,21,4,3,66,22,44,67
N'castle Jet,4420,2,16,5,7,61,39,22,53
Melbourne C,4420,3,14,4,11,45,37,8,46
Melbourne V,4420,4,13,5,11,45,40,5,44
Adelaide Utd,4420,5,11,6,11,37,40,-3,39
Brisbane,4420,6,10,5,13,33,42,-9,35
Western Sydn,4420,7,8,9,10,38,47,-9,33
Perth Glory,4420,8,10,2,15,37,50,-13,32
Wellington P,4420,9,5,6,16,31,55,-24,21
CC Mariners,4420,10,4,8,15,28,49,-21,20
Sydney FC,4421,1,21,4,3,66,23,43,67
N'castle Jet,4421,2,16,5,7,59,37,22,53
Melbourne C,4421,3,14,4,11,43,35,8,46
Melbourne V,4421,4,13,5,11,46,40,6,44
Adelaide Utd,4421,5,11,6,11,37,40,-3,39
Brisbane,4421,6,10,5,13,33,42,-9,35
Western Sydn,4421,7,8,9,10,38,47,-9,33
Perth Glory,4421,8,10,2,15,37,50,-13,32
Wellington P,4421,9,5,6,16,31,55,-24,21
CC Mariners,4421,10,4,8,15,28,49,-21,20
Sydney FC,4422,1,21,4,3,68,22,46,67
N'castle Jet,4422,2,16,5,7,61,39,22,53
Melbourne C,4422,3,14,4,11,45,37,8,46
Melbourne V,4422,4,13,5,11,45,42,3,44
Adelaide Utd,4422,5,11,6,11,37,40,-3,39
Brisbane,4422,6,10,5,13,33,42,-9,35
Western Sydn,4422,7,8,9,10,38,47,-9,33
Perth Glory,4422,8,10,2,15,37,50,-13,32
Wellington P,4422,9,5,6,16,31,55,-24,21
CC Mariners,4422,10,4,8,15,28,49,-21,20
Sydney FC,4423,1,20,4,4,64,23,41,64
N'castle Jet,4423,2,16,5,7,59,37,22,53
Melbourne V,4423,3,14,5,10,46,38,8,47
Melbourne C,4423,4,14,4,11,43,35,8,46
Adelaide Utd,4423,5,11,6,11,37,40,-3,39
Brisbane,4423,6,10,5,13,33,42,-9,35
Western Sydn,4423,7,8,9,10,38,47,-9,33
Perth Glory,4423,8,10,2,15,37,50,-13,32
Wellington P,4423,9,5,6,16,31,55,-24,21
CC Mariners,4423,10,4,8,15,28,49,-21,20
Sydney FC,4424,1,20,5,3,65,23,42,65
N'castle Jet,4424,2,15,6,7,57,37,20,51
Melbourne C,4424,3,14,5,10,43,33,10,47
Melbourne V,4424,4,13,6,10,46,39,7,45
Adelaide Utd,4424,5,11,6,11,37,40,-3,39
Brisbane,4424,6,10,5,13,33,42,-9,35
Western Sydn,4424,7,8,9,10,38,47,-9,33
Perth Glory,4424,8,10,2,15,37,50,-13,32
Wellington P,4424,9,5,6,16,31,55,-24,21
CC Mariners,4424,10,4,8,15,28,49,-21,20
Sydney FC,4425,1,20,5,3,65,23,42,65
N'castle Jet,4425,2,15,6,7,59,39,20,51
Melbourne C,4425,3,14,5,10,45,35,10,47
Melbourne V,4425,4,13,6,10,46,39,7,45
Adelaide Utd,4425,5,11,6,11,37,40,-3,39
Brisbane,4425,6,10,5,13,33,42,-9,35
Western Sydn,4425,7,8,9,10,38,47,-9,33
Perth Glory,4425,8,10,2,15,37,50,-13,32
Wellington P,4425,9,5,6,16,31,55,-24,21
CC Mariners,4425,10,4,8,15,28,49,-21,20
Sydney FC,4426,1,21,4,3,67,23,44,67
N'castle Jet,4426,2,15,5,8,58,39,19,50
Melbourne C,4426,3,15,4,10,45,34,11,49
Melbourne V,4426,4,13,5,11,46,41,5,44
Adelaide Utd,4426,5,11,6,11,37,40,-3,39
Brisbane,4426,6,10,5,13,33,42,-9,35
Western Sydn,4426,7,8,9,10,38,47,-9,33
Perth Glory,4426,8,10,2,15,37,50,-13,32
Wellington P,4426,9,5,6,16,31,55,-24,21
CC Mariners,4426,10,4,8,15,28,49,-21,20
Sydney FC,4427,1,21,4,3,65,22,43,67
N'castle Jet,4427,2,15,5,8,57,38,19,50
Melbourne C,4427,3,15,4,10,44,33,11,49
Melbourne V,4427,4,13,5,11,45,39,6,44
Adelaide Utd,4427,5,11,6,11,37,40,-3,39
Brisbane,4427,6,10,5,13,33,42,-9,35
Western Sydn,4427,7,8,9,10,38,47,-9,33
Perth Glory,4427,8,10,2,15,37,50,-13,32
Wellington P,4427,9,5,6,16,31,55,-24,21
CC Mariners,4427,10,4,8,15,28,49,-21,20
Sydney FC,4428,1,21,4,3,65,22,43,67
N'castle Jet,4428,2,16,5,7,62,40,22,53
Melbourne C,4428,3,14,4,11,46,38,8,46
Melbourne V,4428,4,13,5,11,45,39,6,44
Adelaide Utd,4428,5,11,6,11,37,40,-3,39
Brisbane,4428,6,10,5,13,33,42,-9,35
Western Sydn,4428,7,8,9,10,38,47,-9,33
Perth Glory,4428,8,10,2,15,37,50,-13,32
Wellington P,4428,9,5,6,16,31,55,-24,21
CC Mariners,4428,10,4,8,15,28,49,-21,20
Sydney FC,4429,1,21,4,3,68,22,46,67
N'castle Jet,4429,2,16,5,7,59,37,22,53
Melbourne C,4429,3,14,4,11,43,35,8,46
Melbourne V,4429,4,13,5,11,45,42,3,44
Adelaide Utd,4429,5,11,6,11,37,40,-3,39
Brisbane,4429,6,10,5,13,33,42,-9,35
Western Sydn,4429,7,8,9,10,38,47,-9,33
Perth Glory,4429,8,10,2,15,37,50,-13,32
Wellington P,4429,9,5,6,16,31,55,-24,21
CC Mariners,4429,10,4,8,15,28,49,-21,20
Sydney FC,4430,1,21,4,3,67,24,43,67
N'castle Jet,4430,2,16,5,7,59,38,21,53
Melbourne C,4430,3,14,4,11,44,35,9,46
Melbourne V,4430,4,13,5,11,47,41,6,44
Adelaide Utd,4430,5,11,6,11,37,40,-3,39
Brisbane,4430,6,10,5,13,33,42,-9,35
Western Sydn,4430,7,8,9,10,38,47,-9,33
Perth Glory,4430,8,10,2,15,37,50,-13,32
Wellington P,4430,9,5,6,16,31,55,-24,21
CC Mariners,4430,10,4,8,15,28,49,-21,20
Sydney FC,4431,1,21,4,3,71,24,47,67
N'castle Jet,4431,2,15,6,7,58,38,20,51
Melbourne C,4431,3,14,5,10,44,34,10,47
Melbourne V,4431,4,13,5,11,47,45,2,44
Adelaide Utd,4431,5,11,6,11,37,40,-3,39
Brisbane,4431,6,10,5,13,33,42,-9,35
Western Sydn,4431,7,8,9,10,38,47,-9,33
Perth Glory,4431,8,10,2,15,37,50,-13,32
Wellington P,4431,9,5,6,16,31,55,-24,21
CC Mariners,4431,10,4,8,15,28,49,-21,20
Sydney FC,4432,1,21,4,3,67,23,44,67
N'castle Jet,4432,2,16,5,7,59,37,22,53
Melbourne C,4432,3,14,4,11,43,35,8,46
Melbourne V,4432,4,13,5,11,46,41,5,44
Adelaide Utd,4432,5,11,6,11,37,40,-3,39
Brisbane,4432,6,10,5,13,33,42,-9,35
Western Sydn,4432,7,8,9,10,38,47,-9,33
Perth Glory,4432,8,10,2,15,37,50,-13,32
Wellington P,4432,9,5,6,16,31,55,-24,21
CC Mariners,4432,10,4,8,15,28,49,-21,20
Sydney FC,4433,1,21,4,3,68,22,46,67
N'castle Jet,4433,2,15,5,8,57,38,19,50
Melbourne C,4433,3,15,4,10,44,33,11,49
Melbourne V,4433,4,13,5,11,45,42,3,44
Adelaide Utd,4433,5,11,6,11,37,40,-3,39
Brisbane,4433,6,10,5,13,33,42,-9,35
Western Sydn,4433,7,8,9,10,38,47,-9,33
Perth Glory,4433,8,10,2,15,37,50,-13,32
Wellington P,4433,9,5,6,16,31,55,-24,21
CC Mariners,4433,10,4,8,15,28,49,-21,20
Sydney FC,4434,1,21,4,3,67,22,45,67
N'castle Jet,4434,2,15,5,8,57,40,17,50
Melbourne C,4434,3,15,4,10,46,33,13,49
Melbourne V,4434,4,13,5,11,45,41,4,44
Adelaide Utd,4434,5,11,6,11,37,40,-3,39
Brisbane,4434,6,10,5,13,33,42,-9,35
Western Sydn,4434,7,8,9,10,38,47,-9,33
Perth Glory,4434,8,10,2,15,37,50,-13,32
Wellington P,4434,9,5,6,16,31,55,-24,21
CC Mariners,4434,10,4,8,15,28,49,-21,20
Sydney FC,4435,1,21,4,3,65,22,43,67
N'castle Jet,4435,2,16,5,7,59,37,22,53
Melbourne C,4435,3,14,4,11,43,35,8,46
Melbourne V,4435,4,13,5,11,45,39,6,44
Adelaide Utd,4435,5,11,6,11,37,40,-3,39
Brisbane,4435,6,10,5,13,33,42,-9,35
Western Sydn,4435,7,8,9,10,38,47,-9,33
Perth Glory,4435,8,10,2,15,37,50,-13,32
Wellington P,4435,9,5,6,16,31,55,-24,21
CC Mariners,4435,10,4,8,15,28,49,-21,20
Sydney FC,4436,1,21,4,3,66,23,43,67
N'castle Jet,4436,2,16,5,7,61,37,24,53
Melbourne C,4436,3,14,4,11,43,37,6,46
Melbourne V,4436,4,13,5,11,46,40,6,44
Adelaide Utd,4436,5,11,6,11,37,40,-3,39
Brisbane,4436,6,10,5,13,33,42,-9,35
Western Sydn,4436,7,8,9,10,38,47,-9,33
Perth Glory,4436,8,10,2,15,37,50,-13,32
Wellington P,4436,9,5,6,16,31,55,-24,21
CC Mariners,4436,10,4,8,15,28,49,-21,20
Sydney FC,4437,1,20,5,3,67,25,42,65
N'castle Jet,4437,2,15,5,8,57,38,19,50
Melbourne C,4437,3,15,4,10,44,33,11,49
Melbourne V,4437,4,13,6,10,48,41,7,45
Adelaide Utd,4437,5,11,6,11,37,40,-3,39
Brisbane,4437,6,10,5,13,33,42,-9,35
Western Sydn,4437,7,8,9,10,38,47,-9,33
Perth Glory,4437,8,10,2,15,37,50,-13,32
Wellington P,4437,9,5,6,16,31,55,-24,21
CC Mariners,4437,10,4,8,15,28,49,-21,20
Sydney FC,4438,1,21,4,3,70,24,46,67
N'castle Jet,4438,2,16,5,7,60,38,22,53
Melbourne C,4438,3,14,4,11,44,36,8,46
Melbourne V,4438,4,13,5,11,47,44,3,44
Adelaide Utd,4438,5,11,6,11,37,40,-3,39
Brisbane,4438,6,10,5,13,33,42,-9,35
Western Sydn,4438,7,8,9,10,38,47,-9,33
Perth Glory,4438,8,10,2,15,37,50,-13,32
Wellington P,4438,9,5,6,16,31,55,-24,21
CC Mariners,4438,10,4,8,15,28,49,-21,20
Sydney FC,4439,1,21,4,3,66,23,43,67
N'castle Jet,4439,2,15,6,7,58,38,20,51
Melbourne C,4439,3,14,5,10,44,34,10,47
Melbourne V,4439,4,13,5,11,46,40,6,44
Adelaide Utd,4439,5,11,6,11,37,40,-3,39
Brisbane,4439,6,10,5,13,33,42,-9,35
Western Sydn,4439,7,8,9,10,38,47,-9,33
Perth Glory,4439,8,10,2,15,37,50,-13,32
Wellington P,4439,9,5,6,16,31,55,-24,21
CC Mariners,4439,10,4,8,15,28,49,-21,20
Sydney FC,4440,1,20,5,3,65,23,42,65
N'castle Jet,4440,2,15,6,7,60,40,20,51
Melbourne C,4440,3,14,5,10,46,36,10,47
Melbourne V,4440,4,13,6,10,46,39,7,45
Adelaide Utd,4440,5,11,6,11,37,40,-3,39
Brisbane,4440,6,10,5,13,33,42,-9,35
Western Sydn,4440,7,8,9,10,38,47,-9,33
Perth Glory,4440,8,10,2,15,37,50,-13,32
Wellington P,4440,9,5,6,16,31,55,-24,21
CC Mariners,4440,10,4,8,15,28,49,-21,20
Sydney FC,4441,1,21,4,3,69,23,46,67
N'castle Jet,4441,2,16,5,7,59,37,22,53
Melbourne C,4441,3,14,4,11,43,35,8,46
Melbourne V,4441,4,13,5,11,46,43,3,44
Adelaide Utd,4441,5,11,6,11,37,40,-3,39
Brisbane,4441,6,10,5,13,33,42,-9,35
Western Sydn,4441,7,8,9,10,38,47,-9,33
Perth Glory,4441,8,10,2,15,37,50,-13,32
Wellington P,4441,9,5,6,16,31,55,-24,21
CC Mariners,4441,10,4,8,15,28,49,-21,20
Sydney FC,4442,1,20,4,4,64,23,41,64
N'castle Jet,4442,2,16,5,7,60,37,23,53
Melbourne V,4442,3,14,5,10,46,38,8,47
Melbourne C,4442,4,14,4,11,43,36,7,46
Adelaide Utd,4442,5,11,6,11,37,40,-3,39
Brisbane,4442,6,10,5,13,33,42,-9,35
Western Sydn,4442,7,8,9,10,38,47,-9,33
Perth Glory,4442,8,10,2,15,37,50,-13,32
Wellington P,4442,9,5,6,16,31,55,-24,21
CC Mariners,4442,10,4,8,15,28,49,-21,20
Sydney FC,4443,1,20,5,3,65,23,42,65
N'castle Jet,4443,2,16,5,7,58,37,21,53
Melbourne C,4443,3,14,4,11,43,34,9,46
Melbourne V,4443,4,13,6,10,46,39,7,45
Adelaide Utd,4443,5,11,6,11,37,40,-3,39
Brisbane,4443,6,10,5,13,33,42,-9,35
Western Sydn,4443,7,8,9,10,38,47,-9,33
Perth Glory,4443,8,10,2,15,37,50,-13,32
Wellington P,4443,9,5,6,16,31,55,-24,21
CC Mariners,4443,10,4,8,15,28,49,-21,20
Sydney FC,4444,1,20,4,4,65,24,41,64
N'castle Jet,4444,2,15,6,7,59,39,20,51
Melbourne C,4444,3,14,5,10,45,35,10,47
Melbourne V,4444,4,14,5,10,47,39,8,47
Adelaide Utd,4444,5,11,6,11,37,40,-3,39
Brisbane,4444,6,10,5,13,33,42,-9,35
Western Sydn,4444,7,8,9,10,38,47,-9,33
Perth Glory,4444,8,10,2,15,37,50,-13,32
Wellington P,4444,9,5,6,16,31,55,-24,21
CC Mariners,4444,10,4,8,15,28,49,-21,20
Sydney FC,4445,1,21,4,3,71,23,48,67
N'castle Jet,4445,2,16,5,7,59,37,22,53
Melbourne C,4445,3,14,4,11,43,35,8,46
Melbourne V,4445,4,13,5,11,46,45,1,44
Adelaide Utd,4445,5,11,6,11,37,40,-3,39
Brisbane,4445,6,10,5,13,33,42,-9,35
Western Sydn,4445,7,8,9,10,38,47,-9,33
Perth Glory,4445,8,10,2,15,37,50,-13,32
Wellington P,4445,9,5,6,16,31,55,-24,21
CC Mariners,4445,10,4,8,15,28,49,-21,20
Sydney FC,4446,1,21,4,3,67,24,43,67
N'castle Jet,4446,2,16,5,7,58,37,21,53
Melbourne C,4446,3,14,4,11,43,34,9,46
Melbourne V,4446,4,13,5,11,47,41,6,44
Adelaide Utd,4446,5,11,6,11,37,40,-3,39
Brisbane,4446,6,10,5,13,33,42,-9,35
Western Sydn,4446,7,8,9,10,38,47,-9,33
Perth Glory,4446,8,10,2,15,37,50,-13,32
Wellington P,4446,9,5,6,16,31,55,-24,21
CC Mariners,4446,10,4,8,15,28,49,-21,20
Sydney FC,4447,1,21,4,3,65,22,43,67
N'castle Jet,4447,2,16,5,7,59,38,21,53
Melbourne C,4447,3,14,4,11,44,35,9,46
Melbourne V,4447,4,13,5,11,45,39,6,44
Adelaide Utd,4447,5,11,6,11,37,40,-3,39
Brisbane,4447,6,10,5,13,33,42,-9,35
Western Sydn,4447,7,8,9,10,38,47,-9,33
Perth Glory,4447,8,10,2,15,37,50,-13,32
Wellington P,4447,9,5,6,16,31,55,-24,21
CC Mariners,4447,10,4,8,15,28,49,-21,20
Sydney FC,4448,1,21,4,3,66,23,43,67
N'castle Jet,4448,2,15,6,7,58,38,20,51
Melbourne C,4448,3,14,5,10,44,34,10,47
Melbourne V,4448,4,13,5,11,46,40,6,44
Adelaide Utd,4448,5,11,6,11,37,40,-3,39
Brisbane,4448,6,10,5,13,33,42,-9,35
Western Sydn,4448,7,8,9,10,38,47,-9,33
Perth Glory,4448,8,10,2,15,37,50,-13,32
Wellington P,4448,9,5,6,16,31,55,-24,21
CC Mariners,4448,10,4,8,15,28,49,-21,20
Sydney FC,4449,1,21,4,3,65,22,43,67
N'castle Jet,4449,2,16,5,7,61,37,24,53
Melbourne C,4449,3,14,4,11,43,37,6,46
Melbourne V,4449,4,13,5,11,45,39,6,44
Adelaide Utd,4449,5,11,6,11,37,40,-3,39
Brisbane,4449,6,10,5,13,33,42,-9,35
Western Sydn,4449,7,8,9,10,38,47,-9,33
Perth Glory,4449,8,10,2,15,37,50,-13,32
Wellington P,4449,9,5,6,16,31,55,-24,21
CC Mariners,4449,10,4,8,15,28,49,-21,20
Sydney FC,4450,1,21,4,3,68,22,46,67
N'castle Jet,4450,2,15,6,7,59,39,20,51
Melbourne C,4450,3,14,5,10,45,35,10,47
Melbourne V,4450,4,13,5,11,45,42,3,44
Adelaide Utd,4450,5,11,6,11,37,40,-3,39
Brisbane,4450,6,10,5,13,33,42,-9,35
Western Sydn,4450,7,8,9,10,38,47,-9,33
Perth Glory,4450,8,10,2,15,37,50,-13,32
Wellington P,4450,9,5,6,16,31,55,-24,21
CC Mariners,4450,10,4,8,15,28,49,-21,20
Sydney FC,4451,1,20,5,3,65,23,42,65
N'castle Jet,4451,2,16,5,7,59,38,21,53
Melbourne C,4451,3,14,4,11,44,35,9,46
Melbourne V,4451,4,13,6,10,46,39,7,45
Adelaide Utd,4451,5,11,6,11,37,40,-3,39
Brisbane,4451,6,10,5,13,33,42,-9,35
Western Sydn,4451,7,8,9,10,38,47,-9,33
Perth Glory,4451,8,10,2,15,37,50,-13,32
Wellington P,4451,9,5,6,16,31,55,-24,21
CC Mariners,4451,10,4,8,15,28,49,-21,20
Sydney FC,4452,1,21,4,3,70,23,47,67
N'castle Jet,4452,2,16,5,7,60,37,23,53
Melbourne C,4452,3,14,4,11,43,36,7,46
Melbourne V,4452,4,13,5,11,46,44,2,44
Adelaide Utd,4452,5,11,6,11,37,40,-3,39
Brisbane,4452,6,10,5,13,33,42,-9,35
Western Sydn,4452,7,8,9,10,38,47,-9,33
Perth Glory,4452,8,10,2,15,37,50,-13,32
Wellington P,4452,9,5,6,16,31,55,-24,21
CC Mariners,4452,10,4,8,15,28,49,-21,20
Sydney FC,4453,1,21,4,3,66,22,44,67
N'castle Jet,4453,2,15,6,7,57,37,20,51
Melbourne C,4453,3,14,5,10,43,33,10,47
Melbourne V,4453,4,13,5,11,45,40,5,44
Adelaide Utd,4453,5,11,6,11,37,40,-3,39
Brisbane,4453,6,10,5,13,33,42,-9,35
Western Sydn,4453,7,8,9,10,38,47,-9,33
Perth Glory,4453,8,10,2,15,37,50,-13,32
Wellington P,4453,9,5,6,16,31,55,-24,21
CC Mariners,4453,10,4,8,15,28,49,-21,20
Sydney FC,4454,1,21,4,3,69,22,47,67
N'castle Jet,4454,2,15,5,8,57,38,19,50
Melbourne C,4454,3,15,4,10,44,33,11,49
Melbourne V,4454,4,13,5,11,45,43,2,44
Adelaide Utd,4454,5,11,6,11,37,40,-3,39
Brisbane,4454,6,10,5,13,33,42,-9,35
Western Sydn,4454,7,8,9,10,38,47,-9,33
Perth Glory,4454,8,10,2,15,37,50,-13,32
Wellington P,4454,9,5,6,16,31,55,-24,21
CC Mariners,4454,10,4,8,15,28,49,-21,20
Sydney FC,4455,1,20,5,3,65,23,42,65
N'castle Jet,4455,2,16,5,7,58,37,21,53
Melbourne C,4455,3,14,4,11,43,34,9,46
Melbourne V,4455,4,13,6,10,46,39,7,45
Adelaide Utd,4455,5,11,6,11,37,40,-3,39
Brisbane,4455,6,10,5,13,33,42,-9,35
Western Sydn,4455,7,8,9,10,38,47,-9,33
Perth Glory,4455,8,10,2,15,37,50,-13,32
Wellington P,4455,9,5,6,16,31,55,-24,21
CC Mariners,4455,10,4,8,15,28,49,-21,20
Sydney FC,4456,1,21,4,3,68,22,46,67
N'castle Jet,4456,2,16,5,7,60,38,22,53
Melbourne C,4456,3,14,4,11,44,36,8,46
Melbourne V,4456,4,13,5,11,45,42,3,44
Adelaide Utd,4456,5,11,6,11,37,40,-3,39
Brisbane,4456,6,10,5,13,33,42,-9,35
Western Sydn,4456,7,8,9,10,38,47,-9,33
Perth Glory,4456,8,10,2,15,37,50,-13,32
Wellington P,4456,9,5,6,16,31,55,-24,21
CC Mariners,4456,10,4,8,15,28,49,-21,20
Sydney FC,4457,1,21,4,3,67,23,44,67
N'castle Jet,4457,2,15,5,8,58,39,19,50
Melbourne C,4457,3,15,4,10,45,34,11,49
Melbourne V,4457,4,13,5,11,46,41,5,44
Adelaide Utd,4457,5,11,6,11,37,40,-3,39
Brisbane,4457,6,10,5,13,33,42,-9,35
Western Sydn,4457,7,8,9,10,38,47,-9,33
Perth Glory,4457,8,10,2,15,37,50,-13,32
Wellington P,4457,9,5,6,16,31,55,-24,21
CC Mariners,4457,10,4,8,15,28,49,-21,20
Sydney FC,4458,1,20,5,3,65,23,42,65
N'castle Jet,4458,2,16,5,7,59,37,22,53
Melbourne C,4458,3,14,4,11,43,35,8,46
Melbourne V,4458,4,13,6,10,46,39,7,45
Adelaide Utd,4458,5,11,6,11,37,40,-3,39
Brisbane,4458,6,10,5,13,33,42,-9,35
Western Sydn,4458,7,8,9,10,38,47,-9,33
Perth Glory,4458,8,10,2,15,37,50,-13,32
Wellington P,4458,9,5,6,16,31,55,-24,21
CC Mariners,4458,10,4,8,15,28,49,-21,20
Sydney FC,4459,1,20,4,4,65,24,41,64
N'castle Jet,4459,2,15,6,7,60,40,20,51
Melbourne C,4459,3,14,5,10,46,36,10,47
Melbourne V,4459,4,14,5,10,47,39,8,47
Adelaide Utd,4459,5,11,6,11,37,40,-3,39
Brisbane,4459,6,10,5,13,33,42,-9,35
Western Sydn,4459,7,8,9,10,38,47,-9,33
Perth Glory,4459,8,10,2,15,37,50,-13,32
Wellington P,4459,9,5,6,16,31,55,-24,21
CC Mariners,4459,10,4,8,15,28,49,-21,20
Sydney FC,4460,1,21,4,3,67,24,43,67
N'castle Jet,4460,2,15,5,8,57,39,18,50
Melbourne C,4460,3,15,4,10,45,33,12,49
Melbourne V,4460,4,13,5,11,47,41,6,44
Adelaide Utd,4460,5,11,6,11,37,40,-3,39
Brisbane,4460,6,10,5,13,33,42,-9,35
Western Sydn,4460,7,8,9,10,38,47,-9,33
Perth Glory,4460,8,10,2,15,37,50,-13,32
Wellington P,4460,9,5,6,16,31,55,-24,21
CC Mariners,4460,10,4,8,15,28,49,-21,20
Sydney FC,4461,1,20,5,3,65,23,42,65
N'castle Jet,4461,2,16,5,7,59,37,22,53
Melbourne C,4461,3,14,4,11,43,35,8,46
Melbourne V,4461,4,13,6,10,46,39,7,45
Adelaide Utd,4461,5,11,6,11,37,40,-3,39
Brisbane,4461,6,10,5,13,33,42,-9,35
Western Sydn,4461,7,8,9,10,38,47,-9,33
Perth Glory,4461,8,10,2,15,37,50,-13,32
Wellington P,4461,9,5,6,16,31,55,-24,21
CC Mariners,4461,10,4,8,15,28,49,-21,20
Sydney FC,4462,1,21,4,3,67,23,44,67
N'castle Jet,4462,2,15,5,8,59,40,19,50
Melbourne C,4462,3,15,4,10,46,35,11,49
Melbourne V,4462,4,13,5,11,46,41,5,44
Adelaide Utd,4462,5,11,6,11,37,40,-3,39
Brisbane,4462,6,10,5,13,33,42,-9,35
Western Sydn,4462,7,8,9,10,38,47,-9,33
Perth Glory,4462,8,10,2,15,37,50,-13,32
Wellington P,4462,9,5,6,16,31,55,-24,21
CC Mariners,4462,10,4,8,15,28,49,-21,20
Sydney FC,4463,1,21,4,3,66,23,43,67
N'castle Jet,4463,2,15,6,7,60,40,20,51
Melbourne C,4463,3,14,5,10,46,36,10,47
Melbourne V,4463,4,13,5,11,46,40,6,44
Adelaide Utd,4463,5,11,6,11,37,40,-3,39
Brisbane,4463,6,10,5,13,33,42,-9,35
Western Sydn,4463,7,8,9,10,38,47,-9,33
Perth Glory,4463,8,10,2,15,37,50,-13,32
Wellington P,4463,9,5,6,16,31,55,-24,21
CC Mariners,4463,10,4,8,15,28,49,-21,20
Sydney FC,4464,1,21,4,3,66,22,44,67
N'castle Jet,4464,2,16,5,7,59,38,21,53
Melbourne C,4464,3,14,4,11,44,35,9,46
Melbourne V,4464,4,13,5,11,45,40,5,44
Adelaide Utd,4464,5,11,6,11,37,40,-3,39
Brisbane,4464,6,10,5,13,33,42,-9,35
Western Sydn,4464,7,8,9,10,38,47,-9,33
Perth Glory,4464,8,10,2,15,37,50,-13,32
Wellington P,4464,9,5,6,16,31,55,-24,21
CC Mariners,4464,10,4,8,15,28,49,-21,20
Sydney FC,4465,1,21,4,3,65,22,43,67
N'castle Jet,4465,2,15,5,8,58,41,17,50
Melbourne C,4465,3,15,4,10,47,34,13,49
Melbourne V,4465,4,13,5,11,45,39,6,44
Adelaide Utd,4465,5,11,6,11,37,40,-3,39
Brisbane,4465,6,10,5,13,33,42,-9,35
Western Sydn,4465,7,8,9,10,38,47,-9,33
Perth Glory,4465,8,10,2,15,37,50,-13,32
Wellington P,4465,9,5,6,16,31,55,-24,21
CC Mariners,4465,10,4,8,15,28,49,-21,20
Sydney FC,4466,1,21,4,3,67,23,44,67
N'castle Jet,4466,2,16,5,7,58,37,21,53
Melbourne C,4466,3,14,4,11,43,34,9,46
Melbourne V,4466,4,13,5,11,46,41,5,44
Adelaide Utd,4466,5,11,6,11,37,40,-3,39
Brisbane,4466,6,10,5,13,33,42,-9,35
Western Sydn,4466,7,8,9,10,38,47,-9,33
Perth Glory,4466,8,10,2,15,37,50,-13,32
Wellington P,4466,9,5,6,16,31,55,-24,21
CC Mariners,4466,10,4,8,15,28,49,-21,20
Sydney FC,4467,1,20,5,3,66,24,42,65
N'castle Jet,4467,2,15,5,8,58,39,19,50
Melbourne C,4467,3,15,4,10,45,34,11,49
Melbourne V,4467,4,13,6,10,47,40,7,45
Adelaide Utd,4467,5,11,6,11,37,40,-3,39
Brisbane,4467,6,10,5,13,33,42,-9,35
Western Sydn,4467,7,8,9,10,38,47,-9,33
Perth Glory,4467,8,10,2,15,37,50,-13,32
Wellington P,4467,9,5,6,16,31,55,-24,21
CC Mariners,4467,10,4,8,15,28,49,-21,20
Sydney FC,4468,1,21,4,3,69,22,47,67
N'castle Jet,4468,2,15,5,8,58,40,18,50
Melbourne C,4468,3,15,4,10,46,34,12,49
Melbourne V,4468,4,13,5,11,45,43,2,44
Adelaide Utd,4468,5,11,6,11,37,40,-3,39
Brisbane,4468,6,10,5,13,33,42,-9,35
Western Sydn,4468,7,8,9,10,38,47,-9,33
Perth Glory,4468,8,10,2,15,37,50,-13,32
Wellington P,4468,9,5,6,16,31,55,-24,21
CC Mariners,4468,10,4,8,15,28,49,-21,20
Sydney FC,4469,1,21,4,3,66,22,44,67
N'castle Jet,4469,2,16,5,7,61,38,23,53
Melbourne C,4469,3,14,4,11,44,37,7,46
Melbourne V,4469,4,13,5,11,45,40,5,44
Adelaide Utd,4469,5,11,6,11,37,40,-3,39
Brisbane,4469,6,10,5,13,33,42,-9,35
Western Sydn,4469,7,8,9,10,38,47,-9,33
Perth Glory,4469,8,10,2,15,37,50,-13,32
Wellington P,4469,9,5,6,16,31,55,-24,21
CC Mariners,4469,10,4,8,15,28,49,-21,20
Sydney FC,4470,1,21,4,3,69,22,47,67
N'castle Jet,4470,2,15,6,7,57,37,20,51
Melbourne C,4470,3,14,5,10,43,33,10,47
Melbourne V,4470,4,13,5,11,45,43,2,44
Adelaide Utd,4470,5,11,6,11,37,40,-3,39
Brisbane,4470,6,10,5,13,33,42,-9,35
Western Sydn,4470,7,8,9,10,38,47,-9,33
Perth Glory,4470,8,10,2,15,37,50,-13,32
Wellington P,4470,9,5,6,16,31,55,-24,21
CC Mariners,4470,10,4,8,15,28,49,-21,20
Sydney FC,4471,1,21,4,3,66,22,44,67
N'castle Jet,4471,2,15,5,8,58,39,19,50
Melbourne C,4471,3,15,4,10,45,34,11,49
Melbourne V,4471,4,13,5,11,45,40,5,44
Adelaide Utd,4471,5,11,6,11,37,40,-3,39
Brisbane,4471,6,10,5,13,33,42,-9,35
Western Sydn,4471,7,8,9,10,38,47,-9,33
Perth Glory,4471,8,10,2,15,37,50,-13,32
Wellington P,4471,9,5,6,16,31,55,-24,21
CC Mariners,4471,10,4,8,15,28,49,-21,20
Sydney FC,4472,1,21,4,3,66,22,44,67
N'castle Jet,4472,2,15,6,7,57,37,20,51
Melbourne C,4472,3,14,5,10,43,33,10,47
Melbourne V,4472,4,13,5,11,45,40,5,44
Adelaide Utd,4472,5,11,6,11,37,40,-3,39
Brisbane,4472,6,10,5,13,33,42,-9,35
Western Sydn,4472,7,8,9,10,38,47,-9,33
Perth Glory,4472,8,10,2,15,37,50,-13,32
Wellington P,4472,9,5,6,16,31,55,-24,21
CC Mariners,4472,10,4,8,15,28,49,-21,20
Sydney FC,4473,1,21,4,3,67,22,45,67
N'castle Jet,4473,2,15,6,7,58,38,20,51
Melbourne C,4473,3,14,5,10,44,34,10,47
Melbourne V,4473,4,13,5,11,45,41,4,44
Adelaide Utd,4473,5,11,6,11,37,40,-3,39
Brisbane,4473,6,10,5,13,33,42,-9,35
Western Sydn,4473,7,8,9,10,38,47,-9,33
Perth Glory,4473,8,10,2,15,37,50,-13,32
Wellington P,4473,9,5,6,16,31,55,-24,21
CC Mariners,4473,10,4,8,15,28,49,-21,20
Sydney FC,4474,1,21,4,3,68,22,46,67
N'castle Jet,4474,2,15,6,7,57,37,20,51
Melbourne C,4474,3,14,5,10,43,33,10,47
Melbourne V,4474,4,13,5,11,45,42,3,44
Adelaide Utd,4474,5,11,6,11,37,40,-3,39
Brisbane,4474,6,10,5,13,33,42,-9,35
Western Sydn,4474,7,8,9,10,38,47,-9,33
Perth Glory,4474,8,10,2,15,37,50,-13,32
Wellington P,4474,9,5,6,16,31,55,-24,21
CC Mariners,4474,10,4,8,15,28,49,-21,20
Sydney FC,4475,1,21,4,3,67,23,44,67
N'castle Jet,4475,2,16,5,7,61,38,23,53
Melbourne C,4475,3,14,4,11,44,37,7,46
Melbourne V,4475,4,13,5,11,46,41,5,44
Adelaide Utd,4475,5,11,6,11,37,40,-3,39
Brisbane,4475,6,10,5,13,33,42,-9,35
Western Sydn,4475,7,8,9,10,38,47,-9,33
Perth Glory,4475,8,10,2,15,37,50,-13,32
Wellington P,4475,9,5,6,16,31,55,-24,21
CC Mariners,4475,10,4,8,15,28,49,-21,20
Sydney FC,4476,1,20,4,4,65,25,40,64
N'castle Jet,4476,2,15,5,8,57,38,19,50
Melbourne C,4476,3,15,4,10,44,33,11,49
Melbourne V,4476,4,14,5,10,48,39,9,47
Adelaide Utd,4476,5,11,6,11,37,40,-3,39
Brisbane,4476,6,10,5,13,33,42,-9,35
Western Sydn,4476,7,8,9,10,38,47,-9,33
Perth Glory,4476,8,10,2,15,37,50,-13,32
Wellington P,4476,9,5,6,16,31,55,-24,21
CC Mariners,4476,10,4,8,15,28,49,-21,20
Sydney FC,4477,1,21,4,3,65,22,43,67
N'castle Jet,4477,2,16,5,7,60,37,23,53
Melbourne C,4477,3,14,4,11,43,36,7,46
Melbourne V,4477,4,13,5,11,45,39,6,44
Adelaide Utd,4477,5,11,6,11,37,40,-3,39
Brisbane,4477,6,10,5,13,33,42,-9,35
Western Sydn,4477,7,8,9,10,38,47,-9,33
Perth Glory,4477,8,10,2,15,37,50,-13,32
Wellington P,4477,9,5,6,16,31,55,-24,21
CC Mariners,4477,10,4,8,15,28,49,-21,20
Sydney FC,4478,1,20,5,3,67,25,42,65
N'castle Jet,4478,2,16,5,7,58,37,21,53
Melbourne C,4478,3,14,4,11,43,34,9,46
Melbourne V,4478,4,13,6,10,48,41,7,45
Adelaide Utd,4478,5,11,6,11,37,40,-3,39
Brisbane,4478,6,10,5,13,33,42,-9,35
Western Sydn,4478,7,8,9,10,38,47,-9,33
Perth Glory,4478,8,10,2,15,37,50,-13,32
Wellington P,4478,9,5,6,16,31,55,-24,21
CC Mariners,4478,10,4,8,15,28,49,-21,20
Sydney FC,4479,1,21,4,3,67,23,44,67
N'castle Jet,4479,2,16,5,7,59,37,22,53
Melbourne C,4479,3,14,4,11,43,35,8,46
Melbourne V,4479,4,13,5,11,46,41,5,44
Adelaide Utd,4479,5,11,6,11,37,40,-3,39
Brisbane,4479,6,10,5,13,33,42,-9,35
Western Sydn,4479,7,8,9,10,38,47,-9,33
Perth Glory,4479,8,10,2,15,37,50,-13,32
Wellington P,4479,9,5,6,16,31,55,-24,21
CC Mariners,4479,10,4,8,15,28,49,-21,20
Sydney FC,4480,1,21,4,3,65,22,43,67
N'castle Jet,4480,2,16,5,7,60,38,22,53
Melbourne C,4480,3,14,4,11,44,36,8,46
Melbourne V,4480,4,13,5,11,45,39,6,44
Adelaide Utd,4480,5,11,6,11,37,40,-3,39
Brisbane,4480,6,10,5,13,33,42,-9,35
Western Sydn,4480,7,8,9,10,38,47,-9,33
Perth Glory,4480,8,10,2,15,37,50,-13,32
Wellington P,4480,9,5,6,16,31,55,-24,21
CC Mariners,4480,10,4,8,15,28,49,-21,20
Sydney FC,4481,1,20,5,3,65,23,42,65
N'castle Jet,4481,2,16,5,7,62,38,24,53
Melbourne C,4481,3,14,4,11,44,38,6,46
Melbourne V,4481,4,13,6,10,46,39,7,45
Adelaide Utd,4481,5,11,6,11,37,40,-3,39
Brisbane,4481,6,10,5,13,33,42,-9,35
Western Sydn,4481,7,8,9,10,38,47,-9,33
Perth Glory,4481,8,10,2,15,37,50,-13,32
Wellington P,4481,9,5,6,16,31,55,-24,21
CC Mariners,4481,10,4,8,15,28,49,-21,20
Sydney FC,4482,1,20,5,3,65,23,42,65
N'castle Jet,4482,2,15,5,8,57,41,16,50
Melbourne C,4482,3,15,4,10,47,33,14,49
Melbourne V,4482,4,13,6,10,46,39,7,45
Adelaide Utd,4482,5,11,6,11,37,40,-3,39
Brisbane,4482,6,10,5,13,33,42,-9,35
Western Sydn,4482,7,8,9,10,38,47,-9,33
Perth Glory,4482,8,10,2,15,37,50,-13,32
Wellington P,4482,9,5,6,16,31,55,-24,21
CC Mariners,4482,10,4,8,15,28,49,-21,20
Sydney FC,4483,1,21,4,3,67,23,44,67
N'castle Jet,4483,2,15,6,7,59,39,20,51
Melbourne C,4483,3,14,5,10,45,35,10,47
Melbourne V,4483,4,13,5,11,46,41,5,44
Adelaide Utd,4483,5,11,6,11,37,40,-3,39
Brisbane,4483,6,10,5,13,33,42,-9,35
Western Sydn,4483,7,8,9,10,38,47,-9,33
Perth Glory,4483,8,10,2,15,37,50,-13,32
Wellington P,4483,9,5,6,16,31,55,-24,21
CC Mariners,4483,10,4,8,15,28,49,-21,20
Sydney FC,4484,1,21,4,3,65,22,43,67
N'castle Jet,4484,2,15,6,7,58,38,20,51
Melbourne C,4484,3,14,5,10,44,34,10,47
Melbourne V,4484,4,13,5,11,45,39,6,44
Adelaide Utd,4484,5,11,6,11,37,40,-3,39
Brisbane,4484,6,10,5,13,33,42,-9,35
Western Sydn,4484,7,8,9,10,38,47,-9,33
Perth Glory,4484,8,10,2,15,37,50,-13,32
Wellington P,4484,9,5,6,16,31,55,-24,21
CC Mariners,4484,10,4,8,15,28,49,-21,20
Sydney FC,4485,1,20,5,3,66,24,42,65
N'castle Jet,4485,2,15,6,7,59,39,20,51
Melbourne C,4485,3,14,5,10,45,35,10,47
Melbourne V,4485,4,13,6,10,47,40,7,45
Adelaide Utd,4485,5,11,6,11,37,40,-3,39
Brisbane,4485,6,10,5,13,33,42,-9,35
Western Sydn,4485,7,8,9,10,38,47,-9,33
Perth Glory,4485,8,10,2,15,37,50,-13,32
Wellington P,4485,9,5,6,16,31,55,-24,21
CC Mariners,4485,10,4,8,15,28,49,-21,20
Sydney FC,4486,1,20,4,4,64,24,40,64
N'castle Jet,4486,2,15,6,7,59,39,20,51
Melbourne C,4486,3,14,5,10,45,35,10,47
Melbourne V,4486,4,14,5,10,47,38,9,47
Adelaide Utd,4486,5,11,6,11,37,40,-3,39
Brisbane,4486,6,10,5,13,33,42,-9,35
Western Sydn,4486,7,8,9,10,38,47,-9,33
Perth Glory,4486,8,10,2,15,37,50,-13,32
Wellington P,4486,9,5,6,16,31,55,-24,21
CC Mariners,4486,10,4,8,15,28,49,-21,20
Sydney FC,4487,1,21,4,3,68,23,45,67
N'castle Jet,4487,2,16,5,7,61,39,22,53
Melbourne C,4487,3,14,4,11,45,37,8,46
Melbourne V,4487,4,13,5,11,46,42,4,44
Adelaide Utd,4487,5,11,6,11,37,40,-3,39
Brisbane,4487,6,10,5,13,33,42,-9,35
Western Sydn,4487,7,8,9,10,38,47,-9,33
Perth Glory,4487,8,10,2,15,37,50,-13,32
Wellington P,4487,9,5,6,16,31,55,-24,21
CC Mariners,4487,10,4,8,15,28,49,-21,20
Sydney FC,4488,1,21,4,3,68,23,45,67
N'castle Jet,4488,2,15,5,8,57,38,19,50
Melbourne C,4488,3,15,4,10,44,33,11,49
Melbourne V,4488,4,13,5,11,46,42,4,44
Adelaide Utd,4488,5,11,6,11,37,40,-3,39
Brisbane,4488,6,10,5,13,33,42,-9,35
Western Sydn,4488,7,8,9,10,38,47,-9,33
Perth Glory,4488,8,10,2,15,37,50,-13,32
Wellington P,4488,9,5,6,16,31,55,-24,21
CC Mariners,4488,10,4,8,15,28,49,-21,20
Sydney FC,4489,1,21,4,3,67,24,43,67
N'castle Jet,4489,2,15,6,7,57,37,20,51
Melbourne C,4489,3,14,5,10,43,33,10,47
Melbourne V,4489,4,13,5,11,47,41,6,44
Adelaide Utd,4489,5,11,6,11,37,40,-3,39
Brisbane,4489,6,10,5,13,33,42,-9,35
Western Sydn,4489,7,8,9,10,38,47,-9,33
Perth Glory,4489,8,10,2,15,37,50,-13,32
Wellington P,4489,9,5,6,16,31,55,-24,21
CC Mariners,4489,10,4,8,15,28,49,-21,20
Sydney FC,4490,1,21,4,3,67,23,44,67
N'castle Jet,4490,2,15,6,7,57,37,20,51
Melbourne C,4490,3,14,5,10,43,33,10,47
Melbourne V,4490,4,13,5,11,46,41,5,44
Adelaide Utd,4490,5,11,6,11,37,40,-3,39
Brisbane,4490,6,10,5,13,33,42,-9,35
Western Sydn,4490,7,8,9,10,38,47,-9,33
Perth Glory,4490,8,10,2,15,37,50,-13,32
Wellington P,4490,9,5,6,16,31,55,-24,21
CC Mariners,4490,10,4,8,15,28,49,-21,20
Sydney FC,4491,1,20,5,3,64,22,42,65
N'castle Jet,4491,2,15,6,7,57,37,20,51
Melbourne C,4491,3,14,5,10,43,33,10,47
Melbourne V,4491,4,13,6,10,45,38,7,45
Adelaide Utd,4491,5,11,6,11,37,40,-3,39
Brisbane,4491,6,10,5,13,33,42,-9,35
Western Sydn,4491,7,8,9,10,38,47,-9,33
Perth Glory,4491,8,10,2,15,37,50,-13,32
Wellington P,4491,9,5,6,16,31,55,-24,21
CC Mariners,4491,10,4,8,15,28,49,-21,20
Sydney FC,4492,1,20,4,4,65,24,41,64
N'castle Jet,4492,2,16,5,7,59,38,21,53
Melbourne V,4492,3,14,5,10,47,39,8,47
Melbourne C,4492,4,14,4,11,44,35,9,46
Adelaide Utd,4492,5,11,6,11,37,40,-3,39
Brisbane,4492,6,10,5,13,33,42,-9,35
Western Sydn,4492,7,8,9,10,38,47,-9,33
Perth Glory,4492,8,10,2,15,37,50,-13,32
Wellington P,4492,9,5,6,16,31,55,-24,21
CC Mariners,4492,10,4,8,15,28,49,-21,20
Sydney FC,4493,1,21,4,3,66,22,44,67
N'castle Jet,4493,2,15,6,7,57,37,20,51
Melbourne C,4493,3,14,5,10,43,33,10,47
Melbourne V,4493,4,13,5,11,45,40,5,44
Adelaide Utd,4493,5,11,6,11,37,40,-3,39
Brisbane,4493,6,10,5,13,33,42,-9,35
Western Sydn,4493,7,8,9,10,38,47,-9,33
Perth Glory,4493,8,10,2,15,37,50,-13,32
Wellington P,4493,9,5,6,16,31,55,-24,21
CC Mariners,4493,10,4,8,15,28,49,-21,20
Sydney FC,4494,1,20,4,4,64,25,39,64
N'castle Jet,4494,2,16,5,7,60,37,23,53
Melbourne V,4494,3,14,5,10,48,38,10,47
Melbourne C,4494,4,14,4,11,43,36,7,46
Adelaide Utd,4494,5,11,6,11,37,40,-3,39
Brisbane,4494,6,10,5,13,33,42,-9,35
Western Sydn,4494,7,8,9,10,38,47,-9,33
Perth Glory,4494,8,10,2,15,37,50,-13,32
Wellington P,4494,9,5,6,16,31,55,-24,21
CC Mariners,4494,10,4,8,15,28,49,-21,20
Sydney FC,4495,1,21,4,3,66,22,44,67
N'castle Jet,4495,2,15,6,7,57,37,20,51
Melbourne C,4495,3,14,5,10,43,33,10,47
Melbourne V,4495,4,13,5,11,45,40,5,44
Adelaide Utd,4495,5,11,6,11,37,40,-3,39
Brisbane,4495,6,10,5,13,33,42,-9,35
Western Sydn,4495,7,8,9,10,38,47,-9,33
Perth Glory,4495,8,10,2,15,37,50,-13,32
Wellington P,4495,9,5,6,16,31,55,-24,21
CC Mariners,4495,10,4,8,15,28,49,-21,20
Sydney FC,4496,1,20,5,3,65,23,42,65
N'castle Jet,4496,2,16,5,7,60,37,23,53
Melbourne C,4496,3,14,4,11,43,36,7,46
Melbourne V,4496,4,13,6,10,46,39,7,45
Adelaide Utd,4496,5,11,6,11,37,40,-3,39
Brisbane,4496,6,10,5,13,33,42,-9,35
Western Sydn,4496,7,8,9,10,38,47,-9,33
Perth Glory,4496,8,10,2,15,37,50,-13,32
Wellington P,4496,9,5,6,16,31,55,-24,21
CC Mariners,4496,10,4,8,15,28,49,-21,20
Sydney FC,4497,1,20,5,3,64,22,42,65
N'castle Jet,4497,2,15,5,8,57,38,19,50
Melbourne C,4497,3,15,4,10,44,33,11,49
Melbourne V,4497,4,13,6,10,45,38,7,45
Adelaide Utd,4497,5,11,6,11,37,40,-3,39
Brisbane,4497,6,10,5,13,33,42,-9,35
Western Sydn,4497,7,8,9,10,38,47,-9,33
Perth Glory,4497,8,10,2,15,37,50,-13,32
Wellington P,4497,9,5,6,16,31,55,-24,21
CC Mariners,4497,10,4,8,15,28,49,-21,20
Sydney FC,4498,1,21,4,3,67,24,43,67
N'castle Jet,4498,2,15,5,8,59,41,18,50
Melbourne C,4498,3,15,4,10,47,35,12,49
Melbourne V,4498,4,13,5,11,47,41,6,44
Adelaide Utd,4498,5,11,6,11,37,40,-3,39
Brisbane,4498,6,10,5,13,33,42,-9,35
Western Sydn,4498,7,8,9,10,38,47,-9,33
Perth Glory,4498,8,10,2,15,37,50,-13,32
Wellington P,4498,9,5,6,16,31,55,-24,21
CC Mariners,4498,10,4,8,15,28,49,-21,20
Sydney FC,4499,1,21,4,3,70,24,46,67
N'castle Jet,4499,2,16,5,7,59,38,21,53
Melbourne C,4499,3,14,4,11,44,35,9,46
Melbourne V,4499,4,13,5,11,47,44,3,44
Adelaide Utd,4499,5,11,6,11,37,40,-3,39
Brisbane,4499,6,10,5,13,33,42,-9,35
Western Sydn,4499,7,8,9,10,38,47,-9,33
Perth Glory,4499,8,10,2,15,37,50,-13,32
Wellington P,4499,9,5,6,16,31,55,-24,21
CC Mariners,4499,10,4,8,15,28,49,-21,20
Sydney FC,4500,1,21,4,3,67,24,43,67
N'castle Jet,4500,2,16,5,7,59,37,22,53
Melbourne C,4500,3,14,4,11,43,35,8,46
Melbourne V,4500,4,13,5,11,47,41,6,44
Adelaide Utd,4500,5,11,6,11,37,40,-3,39
Brisbane,4500,6,10,5,13,33,42,-9,35
Western Sydn,4500,7,8,9,10,38,47,-9,33
Perth Glory,4500,8,10,2,15,37,50,-13,32
Wellington P,4500,9,5,6,16,31,55,-24,21
CC Mariners,4500,10,4,8,15,28,49,-21,20
Sydney FC,4501,1,21,4,3,65,22,43,67
N'castle Jet,4501,2,16,5,7,58,37,21,53
Melbourne C,4501,3,14,4,11,43,34,9,46
Melbourne V,4501,4,13,5,11,45,39,6,44
Adelaide Utd,4501,5,11,6,11,37,40,-3,39
Brisbane,4501,6,10,5,13,33,42,-9,35
Western Sydn,4501,7,8,9,10,38,47,-9,33
Perth Glory,4501,8,10,2,15,37,50,-13,32
Wellington P,4501,9,5,6,16,31,55,-24,21
CC Mariners,4501,10,4,8,15,28,49,-21,20
Sydney FC,4502,1,21,4,3,69,24,45,67
N'castle Jet,4502,2,16,5,7,60,39,21,53
Melbourne C,4502,3,14,4,11,45,36,9,46
Melbourne V,4502,4,13,5,11,47,43,4,44
Adelaide Utd,4502,5,11,6,11,37,40,-3,39
Brisbane,4502,6,10,5,13,33,42,-9,35
Western Sydn,4502,7,8,9,10,38,47,-9,33
Perth Glory,4502,8,10,2,15,37,50,-13,32
Wellington P,4502,9,5,6,16,31,55,-24,21
CC Mariners,4502,10,4,8,15,28,49,-21,20
Sydney FC,4503,1,20,5,3,66,24,42,65
N'castle Jet,4503,2,16,5,7,60,38,22,53
Melbourne C,4503,3,14,4,11,44,36,8,46
Melbourne V,4503,4,13,6,10,47,40,7,45
Adelaide Utd,4503,5,11,6,11,37,40,-3,39
Brisbane,4503,6,10,5,13,33,42,-9,35
Western Sydn,4503,7,8,9,10,38,47,-9,33
Perth Glory,4503,8,10,2,15,37,50,-13,32
Wellington P,4503,9,5,6,16,31,55,-24,21
CC Mariners,4503,10,4,8,15,28,49,-21,20
Sydney FC,4504,1,20,5,3,65,23,42,65
N'castle Jet,4504,2,15,6,7,59,39,20,51
Melbourne C,4504,3,14,5,10,45,35,10,47
Melbourne V,4504,4,13,6,10,46,39,7,45
Adelaide Utd,4504,5,11,6,11,37,40,-3,39
Brisbane,4504,6,10,5,13,33,42,-9,35
Western Sydn,4504,7,8,9,10,38,47,-9,33
Perth Glory,4504,8,10,2,15,37,50,-13,32
Wellington P,4504,9,5,6,16,31,55,-24,21
CC Mariners,4504,10,4,8,15,28,49,-21,20
Sydney FC,4505,1,20,4,4,65,24,41,64
N'castle Jet,4505,2,15,6,7,58,38,20,51
Melbourne C,4505,3,14,5,10,44,34,10,47
Melbourne V,4505,4,14,5,10,47,39,8,47
Adelaide Utd,4505,5,11,6,11,37,40,-3,39
Brisbane,4505,6,10,5,13,33,42,-9,35
Western Sydn,4505,7,8,9,10,38,47,-9,33
Perth Glory,4505,8,10,2,15,37,50,-13,32
Wellington P,4505,9,5,6,16,31,55,-24,21
CC Mariners,4505,10,4,8,15,28,49,-21,20
Sydney FC,4506,1,20,5,3,65,23,42,65
N'castle Jet,4506,2,15,5,8,58,39,19,50
Melbourne C,4506,3,15,4,10,45,34,11,49
Melbourne V,4506,4,13,6,10,46,39,7,45
Adelaide Utd,4506,5,11,6,11,37,40,-3,39
Brisbane,4506,6,10,5,13,33,42,-9,35
Western Sydn,4506,7,8,9,10,38,47,-9,33
Perth Glory,4506,8,10,2,15,37,50,-13,32
Wellington P,4506,9,5,6,16,31,55,-24,21
CC Mariners,4506,10,4,8,15,28,49,-21,20
Sydney FC,4507,1,20,5,3,66,24,42,65
N'castle Jet,4507,2,16,5,7,60,37,23,53
Melbourne C,4507,3,14,4,11,43,36,7,46
Melbourne V,4507,4,13,6,10,47,40,7,45
Adelaide Utd,4507,5,11,6,11,37,40,-3,39
Brisbane,4507,6,10,5,13,33,42,-9,35
Western Sydn,4507,7,8,9,10,38,47,-9,33
Perth Glory,4507,8,10,2,15,37,50,-13,32
Wellington P,4507,9,5,6,16,31,55,-24,21
CC Mariners,4507,10,4,8,15,28,49,-21,20
Sydney FC,4508,1,20,5,3,64,22,42,65
N'castle Jet,4508,2,16,5,7,62,37,25,53
Melbourne C,4508,3,14,4,11,43,38,5,46
Melbourne V,4508,4,13,6,10,45,38,7,45
Adelaide Utd,4508,5,11,6,11,37,40,-3,39
Brisbane,4508,6,10,5,13,33,42,-9,35
Western Sydn,4508,7,8,9,10,38,47,-9,33
Perth Glory,4508,8,10,2,15,37,50,-13,32
Wellington P,4508,9,5,6,16,31,55,-24,21
CC Mariners,4508,10,4,8,15,28,49,-21,20
Sydney FC,4509,1,21,4,3,66,23,43,67
N'castle Jet,4509,2,15,5,8,57,39,18,50
Melbourne C,4509,3,15,4,10,45,33,12,49
Melbourne V,4509,4,13,5,11,46,40,6,44
Adelaide Utd,4509,5,11,6,11,37,40,-3,39
Brisbane,4509,6,10,5,13,33,42,-9,35
Western Sydn,4509,7,8,9,10,38,47,-9,33
Perth Glory,4509,8,10,2,15,37,50,-13,32
Wellington P,4509,9,5,6,16,31,55,-24,21
CC Mariners,4509,10,4,8,15,28,49,-21,20
Sydney FC,4510,1,21,4,3,66,23,43,67
N'castle Jet,4510,2,16,5,7,58,37,21,53
Melbourne C,4510,3,14,4,11,43,34,9,46
Melbourne V,4510,4,13,5,11,46,40,6,44
Adelaide Utd,4510,5,11,6,11,37,40,-3,39
Brisbane,4510,6,10,5,13,33,42,-9,35
Western Sydn,4510,7,8,9,10,38,47,-9,33
Perth Glory,4510,8,10,2,15,37,50,-13,32
Wellington P,4510,9,5,6,16,31,55,-24,21
CC Mariners,4510,10,4,8,15,28,49,-21,20
Sydney FC,4511,1,20,4,4,65,24,41,64
N'castle Jet,4511,2,15,5,8,59,40,19,50
Melbourne C,4511,3,15,4,10,46,35,11,49
Melbourne V,4511,4,14,5,10,47,39,8,47
Adelaide Utd,4511,5,11,6,11,37,40,-3,39
Brisbane,4511,6,10,5,13,33,42,-9,35
Western Sydn,4511,7,8,9,10,38,47,-9,33
Perth Glory,4511,8,10,2,15,37,50,-13,32
Wellington P,4511,9,5,6,16,31,55,-24,21
CC Mariners,4511,10,4,8,15,28,49,-21,20
Sydney FC,4512,1,21,4,3,68,23,45,67
N'castle Jet,4512,2,15,6,7,59,39,20,51
Melbourne C,4512,3,14,5,10,45,35,10,47
Melbourne V,4512,4,13,5,11,46,42,4,44
Adelaide Utd,4512,5,11,6,11,37,40,-3,39
Brisbane,4512,6,10,5,13,33,42,-9,35
Western Sydn,4512,7,8,9,10,38,47,-9,33
Perth Glory,4512,8,10,2,15,37,50,-13,32
Wellington P,4512,9,5,6,16,31,55,-24,21
CC Mariners,4512,10,4,8,15,28,49,-21,20
Sydney FC,4513,1,20,5,3,66,24,42,65
N'castle Jet,4513,2,15,5,8,57,38,19,50
Melbourne C,4513,3,15,4,10,44,33,11,49
Melbourne V,4513,4,13,6,10,47,40,7,45
Adelaide Utd,4513,5,11,6,11,37,40,-3,39
Brisbane,4513,6,10,5,13,33,42,-9,35
Western Sydn,4513,7,8,9,10,38,47,-9,33
Perth Glory,4513,8,10,2,15,37,50,-13,32
Wellington P,4513,9,5,6,16,31,55,-24,21
CC Mariners,4513,10,4,8,15,28,49,-21,20
Sydney FC,4514,1,20,5,3,65,23,42,65
N'castle Jet,4514,2,16,5,7,60,38,22,53
Melbourne C,4514,3,14,4,11,44,36,8,46
Melbourne V,4514,4,13,6,10,46,39,7,45
Adelaide Utd,4514,5,11,6,11,37,40,-3,39
Brisbane,4514,6,10,5,13,33,42,-9,35
Western Sydn,4514,7,8,9,10,38,47,-9,33
Perth Glory,4514,8,10,2,15,37,50,-13,32
Wellington P,4514,9,5,6,16,31,55,-24,21
CC Mariners,4514,10,4,8,15,28,49,-21,20
Sydney FC,4515,1,20,5,3,67,25,42,65
N'castle Jet,4515,2,16,5,7,59,38,21,53
Melbourne C,4515,3,14,4,11,44,35,9,46
Melbourne V,4515,4,13,6,10,48,41,7,45
Adelaide Utd,4515,5,11,6,11,37,40,-3,39
Brisbane,4515,6,10,5,13,33,42,-9,35
Western Sydn,4515,7,8,9,10,38,47,-9,33
Perth Glory,4515,8,10,2,15,37,50,-13,32
Wellington P,4515,9,5,6,16,31,55,-24,21
CC Mariners,4515,10,4,8,15,28,49,-21,20
Sydney FC,4516,1,21,4,3,65,22,43,67
N'castle Jet,4516,2,15,6,7,58,38,20,51
Melbourne C,4516,3,14,5,10,44,34,10,47
Melbourne V,4516,4,13,5,11,45,39,6,44
Adelaide Utd,4516,5,11,6,11,37,40,-3,39
Brisbane,4516,6,10,5,13,33,42,-9,35
Western Sydn,4516,7,8,9,10,38,47,-9,33
Perth Glory,4516,8,10,2,15,37,50,-13,32
Wellington P,4516,9,5,6,16,31,55,-24,21
CC Mariners,4516,10,4,8,15,28,49,-21,20
Sydney FC,4517,1,20,4,4,64,24,40,64
N'castle Jet,4517,2,15,6,7,59,39,20,51
Melbourne C,4517,3,14,5,10,45,35,10,47
Melbourne V,4517,4,14,5,10,47,38,9,47
Adelaide Utd,4517,5,11,6,11,37,40,-3,39
Brisbane,4517,6,10,5,13,33,42,-9,35
Western Sydn,4517,7,8,9,10,38,47,-9,33
Perth Glory,4517,8,10,2,15,37,50,-13,32
Wellington P,4517,9,5,6,16,31,55,-24,21
CC Mariners,4517,10,4,8,15,28,49,-21,20
Sydney FC,4518,1,21,4,3,65,22,43,67
N'castle Jet,4518,2,16,5,7,60,37,23,53
Melbourne C,4518,3,14,4,11,43,36,7,46
Melbourne V,4518,4,13,5,11,45,39,6,44
Adelaide Utd,4518,5,11,6,11,37,40,-3,39
Brisbane,4518,6,10,5,13,33,42,-9,35
Western Sydn,4518,7,8,9,10,38,47,-9,33
Perth Glory,4518,8,10,2,15,37,50,-13,32
Wellington P,4518,9,5,6,16,31,55,-24,21
CC Mariners,4518,10,4,8,15,28,49,-21,20
Sydney FC,4519,1,21,4,3,69,24,45,67
N'castle Jet,4519,2,15,6,7,58,38,20,51
Melbourne C,4519,3,14,5,10,44,34,10,47
Melbourne V,4519,4,13,5,11,47,43,4,44
Adelaide Utd,4519,5,11,6,11,37,40,-3,39
Brisbane,4519,6,10,5,13,33,42,-9,35
Western Sydn,4519,7,8,9,10,38,47,-9,33
Perth Glory,4519,8,10,2,15,37,50,-13,32
Wellington P,4519,9,5,6,16,31,55,-24,21
CC Mariners,4519,10,4,8,15,28,49,-21,20
Sydney FC,4520,1,21,4,3,68,23,45,67
N'castle Jet,4520,2,15,5,8,58,40,18,50
Melbourne C,4520,3,15,4,10,46,34,12,49
Melbourne V,4520,4,13,5,11,46,42,4,44
Adelaide Utd,4520,5,11,6,11,37,40,-3,39
Brisbane,4520,6,10,5,13,33,42,-9,35
Western Sydn,4520,7,8,9,10,38,47,-9,33
Perth Glory,4520,8,10,2,15,37,50,-13,32
Wellington P,4520,9,5,6,16,31,55,-24,21
CC Mariners,4520,10,4,8,15,28,49,-21,20
Sydney FC,4521,1,21,4,3,67,23,44,67
N'castle Jet,4521,2,16,5,7,61,37,24,53
Melbourne C,4521,3,14,4,11,43,37,6,46
Melbourne V,4521,4,13,5,11,46,41,5,44
Adelaide Utd,4521,5,11,6,11,37,40,-3,39
Brisbane,4521,6,10,5,13,33,42,-9,35
Western Sydn,4521,7,8,9,10,38,47,-9,33
Perth Glory,4521,8,10,2,15,37,50,-13,32
Wellington P,4521,9,5,6,16,31,55,-24,21
CC Mariners,4521,10,4,8,15,28,49,-21,20
Sydney FC,4522,1,20,4,4,65,24,41,64
N'castle Jet,4522,2,16,5,7,59,38,21,53
Melbourne V,4522,3,14,5,10,47,39,8,47
Melbourne C,4522,4,14,4,11,44,35,9,46
Adelaide Utd,4522,5,11,6,11,37,40,-3,39
Brisbane,4522,6,10,5,13,33,42,-9,35
Western Sydn,4522,7,8,9,10,38,47,-9,33
Perth Glory,4522,8,10,2,15,37,50,-13,32
Wellington P,4522,9,5,6,16,31,55,-24,21
CC Mariners,4522,10,4,8,15,28,49,-21,20
Sydney FC,4523,1,21,4,3,66,22,44,67
N'castle Jet,4523,2,15,5,8,57,38,19,50
Melbourne C,4523,3,15,4,10,44,33,11,49
Melbourne V,4523,4,13,5,11,45,40,5,44
Adelaide Utd,4523,5,11,6,11,37,40,-3,39
Brisbane,4523,6,10,5,13,33,42,-9,35
Western Sydn,4523,7,8,9,10,38,47,-9,33
Perth Glory,4523,8,10,2,15,37,50,-13,32
Wellington P,4523,9,5,6,16,31,55,-24,21
CC Mariners,4523,10,4,8,15,28,49,-21,20
Sydney FC,4524,1,20,4,4,64,25,39,64
N'castle Jet,4524,2,16,5,7,60,39,21,53
Melbourne V,4524,3,14,5,10,48,38,10,47
Melbourne C,4524,4,14,4,11,45,36,9,46
Adelaide Utd,4524,5,11,6,11,37,40,-3,39
Brisbane,4524,6,10,5,13,33,42,-9,35
Western Sydn,4524,7,8,9,10,38,47,-9,33
Perth Glory,4524,8,10,2,15,37,50,-13,32
Wellington P,4524,9,5,6,16,31,55,-24,21
CC Mariners,4524,10,4,8,15,28,49,-21,20
Sydney FC,4525,1,21,4,3,66,23,43,67
N'castle Jet,4525,2,16,5,7,60,38,22,53
Melbourne C,4525,3,14,4,11,44,36,8,46
Melbourne V,4525,4,13,5,11,46,40,6,44
Adelaide Utd,4525,5,11,6,11,37,40,-3,39
Brisbane,4525,6,10,5,13,33,42,-9,35
Western Sydn,4525,7,8,9,10,38,47,-9,33
Perth Glory,4525,8,10,2,15,37,50,-13,32
Wellington P,4525,9,5,6,16,31,55,-24,21
CC Mariners,4525,10,4,8,15,28,49,-21,20
Sydney FC,4526,1,20,4,4,65,24,41,64
N'castle Jet,4526,2,15,5,8,58,39,19,50
Melbourne C,4526,3,15,4,10,45,34,11,49
Melbourne V,4526,4,14,5,10,47,39,8,47
Adelaide Utd,4526,5,11,6,11,37,40,-3,39
Brisbane,4526,6,10,5,13,33,42,-9,35
Western Sydn,4526,7,8,9,10,38,47,-9,33
Perth Glory,4526,8,10,2,15,37,50,-13,32
Wellington P,4526,9,5,6,16,31,55,-24,21
CC Mariners,4526,10,4,8,15,28,49,-21,20
Sydney FC,4527,1,21,4,3,66,23,43,67
N'castle Jet,4527,2,15,5,8,58,39,19,50
Melbourne C,4527,3,15,4,10,45,34,11,49
Melbourne V,4527,4,13,5,11,46,40,6,44
Adelaide Utd,4527,5,11,6,11,37,40,-3,39
Brisbane,4527,6,10,5,13,33,42,-9,35
Western Sydn,4527,7,8,9,10,38,47,-9,33
Perth Glory,4527,8,10,2,15,37,50,-13,32
Wellington P,4527,9,5,6,16,31,55,-24,21
CC Mariners,4527,10,4,8,15,28,49,-21,20
Sydney FC,4528,1,21,4,3,67,23,44,67
N'castle Jet,4528,2,16,5,7,61,40,21,53
Melbourne C,4528,3,14,4,11,46,37,9,46
Melbourne V,4528,4,13,5,11,46,41,5,44
Adelaide Utd,4528,5,11,6,11,37,40,-3,39
Brisbane,4528,6,10,5,13,33,42,-9,35
Western Sydn,4528,7,8,9,10,38,47,-9,33
Perth Glory,4528,8,10,2,15,37,50,-13,32
Wellington P,4528,9,5,6,16,31,55,-24,21
CC Mariners,4528,10,4,8,15,28,49,-21,20
Sydney FC,4529,1,20,4,4,64,23,41,64
N'castle Jet,4529,2,15,6,7,59,39,20,51
Melbourne C,4529,3,14,5,10,45,35,10,47
Melbourne V,4529,4,14,5,10,46,38,8,47
Adelaide Utd,4529,5,11,6,11,37,40,-3,39
Brisbane,4529,6,10,5,13,33,42,-9,35
Western Sydn,4529,7,8,9,10,38,47,-9,33
Perth Glory,4529,8,10,2,15,37,50,-13,32
Wellington P,4529,9,5,6,16,31,55,-24,21
CC Mariners,4529,10,4,8,15,28,49,-21,20
Sydney FC,4530,1,20,5,3,64,22,42,65
N'castle Jet,4530,2,16,5,7,59,37,22,53
Melbourne C,4530,3,14,4,11,43,35,8,46
Melbourne V,4530,4,13,6,10,45,38,7,45
Adelaide Utd,4530,5,11,6,11,37,40,-3,39
Brisbane,4530,6,10,5,13,33,42,-9,35
Western Sydn,4530,7,8,9,10,38,47,-9,33
Perth Glory,4530,8,10,2,15,37,50,-13,32
Wellington P,4530,9,5,6,16,31,55,-24,21
CC Mariners,4530,10,4,8,15,28,49,-21,20
Sydney FC,4531,1,21,4,3,67,24,43,67
N'castle Jet,4531,2,16,5,7,60,39,21,53
Melbourne C,4531,3,14,4,11,45,36,9,46
Melbourne V,4531,4,13,5,11,47,41,6,44
Adelaide Utd,4531,5,11,6,11,37,40,-3,39
Brisbane,4531,6,10,5,13,33,42,-9,35
Western Sydn,4531,7,8,9,10,38,47,-9,33
Perth Glory,4531,8,10,2,15,37,50,-13,32
Wellington P,4531,9,5,6,16,31,55,-24,21
CC Mariners,4531,10,4,8,15,28,49,-21,20
Sydney FC,4532,1,20,5,3,65,23,42,65
N'castle Jet,4532,2,15,5,8,57,39,18,50
Melbourne C,4532,3,15,4,10,45,33,12,49
Melbourne V,4532,4,13,6,10,46,39,7,45
Adelaide Utd,4532,5,11,6,11,37,40,-3,39
Brisbane,4532,6,10,5,13,33,42,-9,35
Western Sydn,4532,7,8,9,10,38,47,-9,33
Perth Glory,4532,8,10,2,15,37,50,-13,32
Wellington P,4532,9,5,6,16,31,55,-24,21
CC Mariners,4532,10,4,8,15,28,49,-21,20
Sydney FC,4533,1,21,4,3,66,22,44,67
N'castle Jet,4533,2,16,5,7,59,37,22,53
Melbourne C,4533,3,14,4,11,43,35,8,46
Melbourne V,4533,4,13,5,11,45,40,5,44
Adelaide Utd,4533,5,11,6,11,37,40,-3,39
Brisbane,4533,6,10,5,13,33,42,-9,35
Western Sydn,4533,7,8,9,10,38,47,-9,33
Perth Glory,4533,8,10,2,15,37,50,-13,32
Wellington P,4533,9,5,6,16,31,55,-24,21
CC Mariners,4533,10,4,8,15,28,49,-21,20
Sydney FC,4534,1,21,4,3,67,24,43,67
N'castle Jet,4534,2,16,5,7,61,38,23,53
Melbourne C,4534,3,14,4,11,44,37,7,46
Melbourne V,4534,4,13,5,11,47,41,6,44
Adelaide Utd,4534,5,11,6,11,37,40,-3,39
Brisbane,4534,6,10,5,13,33,42,-9,35
Western Sydn,4534,7,8,9,10,38,47,-9,33
Perth Glory,4534,8,10,2,15,37,50,-13,32
Wellington P,4534,9,5,6,16,31,55,-24,21
CC Mariners,4534,10,4,8,15,28,49,-21,20
Sydney FC,4535,1,20,5,3,65,23,42,65
N'castle Jet,4535,2,16,5,7,60,39,21,53
Melbourne C,4535,3,14,4,11,45,36,9,46
Melbourne V,4535,4,13,6,10,46,39,7,45
Adelaide Utd,4535,5,11,6,11,37,40,-3,39
Brisbane,4535,6,10,5,13,33,42,-9,35
Western Sydn,4535,7,8,9,10,38,47,-9,33
Perth Glory,4535,8,10,2,15,37,50,-13,32
Wellington P,4535,9,5,6,16,31,55,-24,21
CC Mariners,4535,10,4,8,15,28,49,-21,20
Sydney FC,4536,1,21,4,3,66,22,44,67
N'castle Jet,4536,2,15,6,7,58,38,20,51
Melbourne C,4536,3,14,5,10,44,34,10,47
Melbourne V,4536,4,13,5,11,45,40,5,44
Adelaide Utd,4536,5,11,6,11,37,40,-3,39
Brisbane,4536,6,10,5,13,33,42,-9,35
Western Sydn,4536,7,8,9,10,38,47,-9,33
Perth Glory,4536,8,10,2,15,37,50,-13,32
Wellington P,4536,9,5,6,16,31,55,-24,21
CC Mariners,4536,10,4,8,15,28,49,-21,20
Sydney FC,4537,1,20,5,3,65,23,42,65
N'castle Jet,4537,2,15,5,8,58,39,19,50
Melbourne C,4537,3,15,4,10,45,34,11,49
Melbourne V,4537,4,13,6,10,46,39,7,45
Adelaide Utd,4537,5,11,6,11,37,40,-3,39
Brisbane,4537,6,10,5,13,33,42,-9,35
Western Sydn,4537,7,8,9,10,38,47,-9,33
Perth Glory,4537,8,10,2,15,37,50,-13,32
Wellington P,4537,9,5,6,16,31,55,-24,21
CC Mariners,4537,10,4,8,15,28,49,-21,20
Sydney FC,4538,1,21,4,3,66,22,44,67
N'castle Jet,4538,2,16,5,7,61,37,24,53
Melbourne C,4538,3,14,4,11,43,37,6,46
Melbourne V,4538,4,13,5,11,45,40,5,44
Adelaide Utd,4538,5,11,6,11,37,40,-3,39
Brisbane,4538,6,10,5,13,33,42,-9,35
Western Sydn,4538,7,8,9,10,38,47,-9,33
Perth Glory,4538,8,10,2,15,37,50,-13,32
Wellington P,4538,9,5,6,16,31,55,-24,21
CC Mariners,4538,10,4,8,15,28,49,-21,20
Sydney FC,4539,1,21,4,3,66,23,43,67
N'castle Jet,4539,2,15,5,8,57,40,17,50
Melbourne C,4539,3,15,4,10,46,33,13,49
Melbourne V,4539,4,13,5,11,46,40,6,44
Adelaide Utd,4539,5,11,6,11,37,40,-3,39
Brisbane,4539,6,10,5,13,33,42,-9,35
Western Sydn,4539,7,8,9,10,38,47,-9,33
Perth Glory,4539,8,10,2,15,37,50,-13,32
Wellington P,4539,9,5,6,16,31,55,-24,21
CC Mariners,4539,10,4,8,15,28,49,-21,20
Sydney FC,4540,1,20,4,4,65,24,41,64
N'castle Jet,4540,2,16,5,7,59,37,22,53
Melbourne V,4540,3,14,5,10,47,39,8,47
Melbourne C,4540,4,14,4,11,43,35,8,46
Adelaide Utd,4540,5,11,6,11,37,40,-3,39
Brisbane,4540,6,10,5,13,33,42,-9,35
Western Sydn,4540,7,8,9,10,38,47,-9,33
Perth Glory,4540,8,10,2,15,37,50,-13,32
Wellington P,4540,9,5,6,16,31,55,-24,21
CC Mariners,4540,10,4,8,15,28,49,-21,20
Sydney FC,4541,1,21,4,3,66,23,43,67
N'castle Jet,4541,2,16,5,7,58,37,21,53
Melbourne C,4541,3,14,4,11,43,34,9,46
Melbourne V,4541,4,13,5,11,46,40,6,44
Adelaide Utd,4541,5,11,6,11,37,40,-3,39
Brisbane,4541,6,10,5,13,33,42,-9,35
Western Sydn,4541,7,8,9,10,38,47,-9,33
Perth Glory,4541,8,10,2,15,37,50,-13,32
Wellington P,4541,9,5,6,16,31,55,-24,21
CC Mariners,4541,10,4,8,15,28,49,-21,20
Sydney FC,4542,1,20,5,3,65,23,42,65
N'castle Jet,4542,2,15,5,8,58,39,19,50
Melbourne C,4542,3,15,4,10,45,34,11,49
Melbourne V,4542,4,13,6,10,46,39,7,45
Adelaide Utd,4542,5,11,6,11,37,40,-3,39
Brisbane,4542,6,10,5,13,33,42,-9,35
Western Sydn,4542,7,8,9,10,38,47,-9,33
Perth Glory,4542,8,10,2,15,37,50,-13,32
Wellington P,4542,9,5,6,16,31,55,-24,21
CC Mariners,4542,10,4,8,15,28,49,-21,20
Sydney FC,4543,1,20,4,4,64,23,41,64
N'castle Jet,4543,2,15,5,8,57,38,19,50
Melbourne C,4543,3,15,4,10,44,33,11,49
Melbourne V,4543,4,14,5,10,46,38,8,47
Adelaide Utd,4543,5,11,6,11,37,40,-3,39
Brisbane,4543,6,10,5,13,33,42,-9,35
Western Sydn,4543,7,8,9,10,38,47,-9,33
Perth Glory,4543,8,10,2,15,37,50,-13,32
Wellington P,4543,9,5,6,16,31,55,-24,21
CC Mariners,4543,10,4,8,15,28,49,-21,20
Sydney FC,4544,1,21,4,3,67,22,45,67
N'castle Jet,4544,2,16,5,7,59,38,21,53
Melbourne C,4544,3,14,4,11,44,35,9,46
Melbourne V,4544,4,13,5,11,45,41,4,44
Adelaide Utd,4544,5,11,6,11,37,40,-3,39
Brisbane,4544,6,10,5,13,33,42,-9,35
Western Sydn,4544,7,8,9,10,38,47,-9,33
Perth Glory,4544,8,10,2,15,37,50,-13,32
Wellington P,4544,9,5,6,16,31,55,-24,21
CC Mariners,4544,10,4,8,15,28,49,-21,20
Sydney FC,4545,1,21,4,3,68,22,46,67
N'castle Jet,4545,2,16,5,7,61,37,24,53
Melbourne C,4545,3,14,4,11,43,37,6,46
Melbourne V,4545,4,13,5,11,45,42,3,44
Adelaide Utd,4545,5,11,6,11,37,40,-3,39
Brisbane,4545,6,10,5,13,33,42,-9,35
Western Sydn,4545,7,8,9,10,38,47,-9,33
Perth Glory,4545,8,10,2,15,37,50,-13,32
Wellington P,4545,9,5,6,16,31,55,-24,21
CC Mariners,4545,10,4,8,15,28,49,-21,20
Sydney FC,4546,1,21,4,3,66,23,43,67
N'castle Jet,4546,2,15,5,8,57,38,19,50
Melbourne C,4546,3,15,4,10,44,33,11,49
Melbourne V,4546,4,13,5,11,46,40,6,44
Adelaide Utd,4546,5,11,6,11,37,40,-3,39
Brisbane,4546,6,10,5,13,33,42,-9,35
Western Sydn,4546,7,8,9,10,38,47,-9,33
Perth Glory,4546,8,10,2,15,37,50,-13,32
Wellington P,4546,9,5,6,16,31,55,-24,21
CC Mariners,4546,10,4,8,15,28,49,-21,20
Sydney FC,4547,1,21,4,3,65,22,43,67
N'castle Jet,4547,2,15,5,8,59,40,19,50
Melbourne C,4547,3,15,4,10,46,35,11,49
Melbourne V,4547,4,13,5,11,45,39,6,44
Adelaide Utd,4547,5,11,6,11,37,40,-3,39
Brisbane,4547,6,10,5,13,33,42,-9,35
Western Sydn,4547,7,8,9,10,38,47,-9,33
Perth Glory,4547,8,10,2,15,37,50,-13,32
Wellington P,4547,9,5,6,16,31,55,-24,21
CC Mariners,4547,10,4,8,15,28,49,-21,20
Sydney FC,4548,1,20,5,3,65,23,42,65
N'castle Jet,4548,2,16,5,7,59,37,22,53
Melbourne C,4548,3,14,4,11,43,35,8,46
Melbourne V,4548,4,13,6,10,46,39,7,45
Adelaide Utd,4548,5,11,6,11,37,40,-3,39
Brisbane,4548,6,10,5,13,33,42,-9,35
Western Sydn,4548,7,8,9,10,38,47,-9,33
Perth Glory,4548,8,10,2,15,37,50,-13,32
Wellington P,4548,9,5,6,16,31,55,-24,21
CC Mariners,4548,10,4,8,15,28,49,-21,20
Sydney FC,4549,1,21,4,3,65,22,43,67
N'castle Jet,4549,2,16,5,7,59,38,21,53
Melbourne C,4549,3,14,4,11,44,35,9,46
Melbourne V,4549,4,13,5,11,45,39,6,44
Adelaide Utd,4549,5,11,6,11,37,40,-3,39
Brisbane,4549,6,10,5,13,33,42,-9,35
Western Sydn,4549,7,8,9,10,38,47,-9,33
Perth Glory,4549,8,10,2,15,37,50,-13,32
Wellington P,4549,9,5,6,16,31,55,-24,21
CC Mariners,4549,10,4,8,15,28,49,-21,20
Sydney FC,4550,1,21,4,3,67,22,45,67
N'castle Jet,4550,2,16,5,7,59,37,22,53
Melbourne C,4550,3,14,4,11,43,35,8,46
Melbourne V,4550,4,13,5,11,45,41,4,44
Adelaide Utd,4550,5,11,6,11,37,40,-3,39
Brisbane,4550,6,10,5,13,33,42,-9,35
Western Sydn,4550,7,8,9,10,38,47,-9,33
Perth Glory,4550,8,10,2,15,37,50,-13,32
Wellington P,4550,9,5,6,16,31,55,-24,21
CC Mariners,4550,10,4,8,15,28,49,-21,20
Sydney FC,4551,1,21,4,3,66,23,43,67
N'castle Jet,4551,2,16,5,7,60,38,22,53
Melbourne C,4551,3,14,4,11,44,36,8,46
Melbourne V,4551,4,13,5,11,46,40,6,44
Adelaide Utd,4551,5,11,6,11,37,40,-3,39
Brisbane,4551,6,10,5,13,33,42,-9,35
Western Sydn,4551,7,8,9,10,38,47,-9,33
Perth Glory,4551,8,10,2,15,37,50,-13,32
Wellington P,4551,9,5,6,16,31,55,-24,21
CC Mariners,4551,10,4,8,15,28,49,-21,20
Sydney FC,4552,1,21,4,3,69,22,47,67
N'castle Jet,4552,2,15,6,7,57,37,20,51
Melbourne C,4552,3,14,5,10,43,33,10,47
Melbourne V,4552,4,13,5,11,45,43,2,44
Adelaide Utd,4552,5,11,6,11,37,40,-3,39
Brisbane,4552,6,10,5,13,33,42,-9,35
Western Sydn,4552,7,8,9,10,38,47,-9,33
Perth Glory,4552,8,10,2,15,37,50,-13,32
Wellington P,4552,9,5,6,16,31,55,-24,21
CC Mariners,4552,10,4,8,15,28,49,-21,20
Sydney FC,4553,1,20,5,3,68,26,42,65
N'castle Jet,4553,2,15,5,8,57,39,18,50
Melbourne C,4553,3,15,4,10,45,33,12,49
Melbourne V,4553,4,13,6,10,49,42,7,45
Adelaide Utd,4553,5,11,6,11,37,40,-3,39
Brisbane,4553,6,10,5,13,33,42,-9,35
Western Sydn,4553,7,8,9,10,38,47,-9,33
Perth Glory,4553,8,10,2,15,37,50,-13,32
Wellington P,4553,9,5,6,16,31,55,-24,21
CC Mariners,4553,10,4,8,15,28,49,-21,20
Sydney FC,4554,1,21,4,3,66,22,44,67
N'castle Jet,4554,2,16,5,7,59,37,22,53
Melbourne C,4554,3,14,4,11,43,35,8,46
Melbourne V,4554,4,13,5,11,45,40,5,44
Adelaide Utd,4554,5,11,6,11,37,40,-3,39
Brisbane,4554,6,10,5,13,33,42,-9,35
Western Sydn,4554,7,8,9,10,38,47,-9,33
Perth Glory,4554,8,10,2,15,37,50,-13,32
Wellington P,4554,9,5,6,16,31,55,-24,21
CC Mariners,4554,10,4,8,15,28,49,-21,20
Sydney FC,4555,1,21,4,3,67,22,45,67
N'castle Jet,4555,2,16,5,7,59,38,21,53
Melbourne C,4555,3,14,4,11,44,35,9,46
Melbourne V,4555,4,13,5,11,45,41,4,44
Adelaide Utd,4555,5,11,6,11,37,40,-3,39
Brisbane,4555,6,10,5,13,33,42,-9,35
Western Sydn,4555,7,8,9,10,38,47,-9,33
Perth Glory,4555,8,10,2,15,37,50,-13,32
Wellington P,4555,9,5,6,16,31,55,-24,21
CC Mariners,4555,10,4,8,15,28,49,-21,20
Sydney FC,4556,1,21,4,3,68,22,46,67
N'castle Jet,4556,2,16,5,7,60,37,23,53
Melbourne C,4556,3,14,4,11,43,36,7,46
Melbourne V,4556,4,13,5,11,45,42,3,44
Adelaide Utd,4556,5,11,6,11,37,40,-3,39
Brisbane,4556,6,10,5,13,33,42,-9,35
Western Sydn,4556,7,8,9,10,38,47,-9,33
Perth Glory,4556,8,10,2,15,37,50,-13,32
Wellington P,4556,9,5,6,16,31,55,-24,21
CC Mariners,4556,10,4,8,15,28,49,-21,20
Sydney FC,4557,1,21,4,3,69,24,45,67
N'castle Jet,4557,2,15,6,7,58,38,20,51
Melbourne C,4557,3,14,5,10,44,34,10,47
Melbourne V,4557,4,13,5,11,47,43,4,44
Adelaide Utd,4557,5,11,6,11,37,40,-3,39
Brisbane,4557,6,10,5,13,33,42,-9,35
Western Sydn,4557,7,8,9,10,38,47,-9,33
Perth Glory,4557,8,10,2,15,37,50,-13,32
Wellington P,4557,9,5,6,16,31,55,-24,21
CC Mariners,4557,10,4,8,15,28,49,-21,20
Sydney FC,4558,1,20,5,3,65,23,42,65
N'castle Jet,4558,2,16,5,7,60,37,23,53
Melbourne C,4558,3,14,4,11,43,36,7,46
Melbourne V,4558,4,13,6,10,46,39,7,45
Adelaide Utd,4558,5,11,6,11,37,40,-3,39
Brisbane,4558,6,10,5,13,33,42,-9,35
Western Sydn,4558,7,8,9,10,38,47,-9,33
Perth Glory,4558,8,10,2,15,37,50,-13,32
Wellington P,4558,9,5,6,16,31,55,-24,21
CC Mariners,4558,10,4,8,15,28,49,-21,20
Sydney FC,4559,1,21,4,3,67,22,45,67
N'castle Jet,4559,2,15,5,8,57,38,19,50
Melbourne C,4559,3,15,4,10,44,33,11,49
Melbourne V,4559,4,13,5,11,45,41,4,44
Adelaide Utd,4559,5,11,6,11,37,40,-3,39
Brisbane,4559,6,10,5,13,33,42,-9,35
Western Sydn,4559,7,8,9,10,38,47,-9,33
Perth Glory,4559,8,10,2,15,37,50,-13,32
Wellington P,4559,9,5,6,16,31,55,-24,21
CC Mariners,4559,10,4,8,15,28,49,-21,20
Sydney FC,4560,1,20,5,3,65,23,42,65
N'castle Jet,4560,2,15,5,8,58,39,19,50
Melbourne C,4560,3,15,4,10,45,34,11,49
Melbourne V,4560,4,13,6,10,46,39,7,45
Adelaide Utd,4560,5,11,6,11,37,40,-3,39
Brisbane,4560,6,10,5,13,33,42,-9,35
Western Sydn,4560,7,8,9,10,38,47,-9,33
Perth Glory,4560,8,10,2,15,37,50,-13,32
Wellington P,4560,9,5,6,16,31,55,-24,21
CC Mariners,4560,10,4,8,15,28,49,-21,20
Sydney FC,4561,1,21,4,3,65,22,43,67
N'castle Jet,4561,2,15,5,8,58,39,19,50
Melbourne C,4561,3,15,4,10,45,34,11,49
Melbourne V,4561,4,13,5,11,45,39,6,44
Adelaide Utd,4561,5,11,6,11,37,40,-3,39
Brisbane,4561,6,10,5,13,33,42,-9,35
Western Sydn,4561,7,8,9,10,38,47,-9,33
Perth Glory,4561,8,10,2,15,37,50,-13,32
Wellington P,4561,9,5,6,16,31,55,-24,21
CC Mariners,4561,10,4,8,15,28,49,-21,20
Sydney FC,4562,1,21,4,3,68,24,44,67
N'castle Jet,4562,2,16,5,7,62,41,21,53
Melbourne C,4562,3,14,4,11,47,38,9,46
Melbourne V,4562,4,13,5,11,47,42,5,44
Adelaide Utd,4562,5,11,6,11,37,40,-3,39
Brisbane,4562,6,10,5,13,33,42,-9,35
Western Sydn,4562,7,8,9,10,38,47,-9,33
Perth Glory,4562,8,10,2,15,37,50,-13,32
Wellington P,4562,9,5,6,16,31,55,-24,21
CC Mariners,4562,10,4,8,15,28,49,-21,20
Sydney FC,4563,1,21,4,3,70,22,48,67
N'castle Jet,4563,2,16,5,7,61,38,23,53
Melbourne C,4563,3,14,4,11,44,37,7,46
Melbourne V,4563,4,13,5,11,45,44,1,44
Adelaide Utd,4563,5,11,6,11,37,40,-3,39
Brisbane,4563,6,10,5,13,33,42,-9,35
Western Sydn,4563,7,8,9,10,38,47,-9,33
Perth Glory,4563,8,10,2,15,37,50,-13,32
Wellington P,4563,9,5,6,16,31,55,-24,21
CC Mariners,4563,10,4,8,15,28,49,-21,20
Sydney FC,4564,1,21,4,3,70,22,48,67
N'castle Jet,4564,2,15,6,7,58,38,20,51
Melbourne C,4564,3,14,5,10,44,34,10,47
Melbourne V,4564,4,13,5,11,45,44,1,44
Adelaide Utd,4564,5,11,6,11,37,40,-3,39
Brisbane,4564,6,10,5,13,33,42,-9,35
Western Sydn,4564,7,8,9,10,38,47,-9,33
Perth Glory,4564,8,10,2,15,37,50,-13,32
Wellington P,4564,9,5,6,16,31,55,-24,21
CC Mariners,4564,10,4,8,15,28,49,-21,20
Sydney FC,4565,1,21,4,3,67,22,45,67
N'castle Jet,4565,2,15,6,7,58,38,20,51
Melbourne C,4565,3,14,5,10,44,34,10,47
Melbourne V,4565,4,13,5,11,45,41,4,44
Adelaide Utd,4565,5,11,6,11,37,40,-3,39
Brisbane,4565,6,10,5,13,33,42,-9,35
Western Sydn,4565,7,8,9,10,38,47,-9,33
Perth Glory,4565,8,10,2,15,37,50,-13,32
Wellington P,4565,9,5,6,16,31,55,-24,21
CC Mariners,4565,10,4,8,15,28,49,-21,20
Sydney FC,4566,1,21,4,3,66,22,44,67
N'castle Jet,4566,2,16,5,7,59,37,22,53
Melbourne C,4566,3,14,4,11,43,35,8,46
Melbourne V,4566,4,13,5,11,45,40,5,44
Adelaide Utd,4566,5,11,6,11,37,40,-3,39
Brisbane,4566,6,10,5,13,33,42,-9,35
Western Sydn,4566,7,8,9,10,38,47,-9,33
Perth Glory,4566,8,10,2,15,37,50,-13,32
Wellington P,4566,9,5,6,16,31,55,-24,21
CC Mariners,4566,10,4,8,15,28,49,-21,20
Sydney FC,4567,1,21,4,3,66,23,43,67
N'castle Jet,4567,2,15,6,7,58,38,20,51
Melbourne C,4567,3,14,5,10,44,34,10,47
Melbourne V,4567,4,13,5,11,46,40,6,44
Adelaide Utd,4567,5,11,6,11,37,40,-3,39
Brisbane,4567,6,10,5,13,33,42,-9,35
Western Sydn,4567,7,8,9,10,38,47,-9,33
Perth Glory,4567,8,10,2,15,37,50,-13,32
Wellington P,4567,9,5,6,16,31,55,-24,21
CC Mariners,4567,10,4,8,15,28,49,-21,20
Sydney FC,4568,1,20,5,3,65,23,42,65
N'castle Jet,4568,2,16,5,7,58,37,21,53
Melbourne C,4568,3,14,4,11,43,34,9,46
Melbourne V,4568,4,13,6,10,46,39,7,45
Adelaide Utd,4568,5,11,6,11,37,40,-3,39
Brisbane,4568,6,10,5,13,33,42,-9,35
Western Sydn,4568,7,8,9,10,38,47,-9,33
Perth Glory,4568,8,10,2,15,37,50,-13,32
Wellington P,4568,9,5,6,16,31,55,-24,21
CC Mariners,4568,10,4,8,15,28,49,-21,20
Sydney FC,4569,1,20,5,3,66,24,42,65
N'castle Jet,4569,2,16,5,7,59,38,21,53
Melbourne C,4569,3,14,4,11,44,35,9,46
Melbourne V,4569,4,13,6,10,47,40,7,45
Adelaide Utd,4569,5,11,6,11,37,40,-3,39
Brisbane,4569,6,10,5,13,33,42,-9,35
Western Sydn,4569,7,8,9,10,38,47,-9,33
Perth Glory,4569,8,10,2,15,37,50,-13,32
Wellington P,4569,9,5,6,16,31,55,-24,21
CC Mariners,4569,10,4,8,15,28,49,-21,20
Sydney FC,4570,1,21,4,3,68,22,46,67
N'castle Jet,4570,2,16,5,7,59,37,22,53
Melbourne C,4570,3,14,4,11,43,35,8,46
Melbourne V,4570,4,13,5,11,45,42,3,44
Adelaide Utd,4570,5,11,6,11,37,40,-3,39
Brisbane,4570,6,10,5,13,33,42,-9,35
Western Sydn,4570,7,8,9,10,38,47,-9,33
Perth Glory,4570,8,10,2,15,37,50,-13,32
Wellington P,4570,9,5,6,16,31,55,-24,21
CC Mariners,4570,10,4,8,15,28,49,-21,20
Sydney FC,4571,1,21,4,3,68,22,46,67
N'castle Jet,4571,2,16,5,7,59,37,22,53
Melbourne C,4571,3,14,4,11,43,35,8,46
Melbourne V,4571,4,13,5,11,45,42,3,44
Adelaide Utd,4571,5,11,6,11,37,40,-3,39
Brisbane,4571,6,10,5,13,33,42,-9,35
Western Sydn,4571,7,8,9,10,38,47,-9,33
Perth Glory,4571,8,10,2,15,37,50,-13,32
Wellington P,4571,9,5,6,16,31,55,-24,21
CC Mariners,4571,10,4,8,15,28,49,-21,20
Sydney FC,4572,1,21,4,3,67,24,43,67
N'castle Jet,4572,2,16,5,7,59,37,22,53
Melbourne C,4572,3,14,4,11,43,35,8,46
Melbourne V,4572,4,13,5,11,47,41,6,44
Adelaide Utd,4572,5,11,6,11,37,40,-3,39
Brisbane,4572,6,10,5,13,33,42,-9,35
Western Sydn,4572,7,8,9,10,38,47,-9,33
Perth Glory,4572,8,10,2,15,37,50,-13,32
Wellington P,4572,9,5,6,16,31,55,-24,21
CC Mariners,4572,10,4,8,15,28,49,-21,20
Sydney FC,4573,1,21,4,3,67,23,44,67
N'castle Jet,4573,2,16,5,7,60,39,21,53
Melbourne C,4573,3,14,4,11,45,36,9,46
Melbourne V,4573,4,13,5,11,46,41,5,44
Adelaide Utd,4573,5,11,6,11,37,40,-3,39
Brisbane,4573,6,10,5,13,33,42,-9,35
Western Sydn,4573,7,8,9,10,38,47,-9,33
Perth Glory,4573,8,10,2,15,37,50,-13,32
Wellington P,4573,9,5,6,16,31,55,-24,21
CC Mariners,4573,10,4,8,15,28,49,-21,20
Sydney FC,4574,1,21,4,3,69,22,47,67
N'castle Jet,4574,2,15,6,7,60,40,20,51
Melbourne C,4574,3,14,5,10,46,36,10,47
Melbourne V,4574,4,13,5,11,45,43,2,44
Adelaide Utd,4574,5,11,6,11,37,40,-3,39
Brisbane,4574,6,10,5,13,33,42,-9,35
Western Sydn,4574,7,8,9,10,38,47,-9,33
Perth Glory,4574,8,10,2,15,37,50,-13,32
Wellington P,4574,9,5,6,16,31,55,-24,21
CC Mariners,4574,10,4,8,15,28,49,-21,20
Sydney FC,4575,1,20,5,3,65,23,42,65
N'castle Jet,4575,2,16,5,7,59,38,21,53
Melbourne C,4575,3,14,4,11,44,35,9,46
Melbourne V,4575,4,13,6,10,46,39,7,45
Adelaide Utd,4575,5,11,6,11,37,40,-3,39
Brisbane,4575,6,10,5,13,33,42,-9,35
Western Sydn,4575,7,8,9,10,38,47,-9,33
Perth Glory,4575,8,10,2,15,37,50,-13,32
Wellington P,4575,9,5,6,16,31,55,-24,21
CC Mariners,4575,10,4,8,15,28,49,-21,20
Sydney FC,4576,1,21,4,3,65,22,43,67
N'castle Jet,4576,2,15,5,8,58,40,18,50
Melbourne C,4576,3,15,4,10,46,34,12,49
Melbourne V,4576,4,13,5,11,45,39,6,44
Adelaide Utd,4576,5,11,6,11,37,40,-3,39
Brisbane,4576,6,10,5,13,33,42,-9,35
Western Sydn,4576,7,8,9,10,38,47,-9,33
Perth Glory,4576,8,10,2,15,37,50,-13,32
Wellington P,4576,9,5,6,16,31,55,-24,21
CC Mariners,4576,10,4,8,15,28,49,-21,20
Sydney FC,4577,1,20,5,3,66,24,42,65
N'castle Jet,4577,2,15,5,8,57,39,18,50
Melbourne C,4577,3,15,4,10,45,33,12,49
Melbourne V,4577,4,13,6,10,47,40,7,45
Adelaide Utd,4577,5,11,6,11,37,40,-3,39
Brisbane,4577,6,10,5,13,33,42,-9,35
Western Sydn,4577,7,8,9,10,38,47,-9,33
Perth Glory,4577,8,10,2,15,37,50,-13,32
Wellington P,4577,9,5,6,16,31,55,-24,21
CC Mariners,4577,10,4,8,15,28,49,-21,20
Sydney FC,4578,1,21,4,3,69,24,45,67
N'castle Jet,4578,2,16,5,7,58,37,21,53
Melbourne C,4578,3,14,4,11,43,34,9,46
Melbourne V,4578,4,13,5,11,47,43,4,44
Adelaide Utd,4578,5,11,6,11,37,40,-3,39
Brisbane,4578,6,10,5,13,33,42,-9,35
Western Sydn,4578,7,8,9,10,38,47,-9,33
Perth Glory,4578,8,10,2,15,37,50,-13,32
Wellington P,4578,9,5,6,16,31,55,-24,21
CC Mariners,4578,10,4,8,15,28,49,-21,20
Sydney FC,4579,1,20,4,4,65,25,40,64
N'castle Jet,4579,2,15,6,7,59,39,20,51
Melbourne C,4579,3,14,5,10,45,35,10,47
Melbourne V,4579,4,14,5,10,48,39,9,47
Adelaide Utd,4579,5,11,6,11,37,40,-3,39
Brisbane,4579,6,10,5,13,33,42,-9,35
Western Sydn,4579,7,8,9,10,38,47,-9,33
Perth Glory,4579,8,10,2,15,37,50,-13,32
Wellington P,4579,9,5,6,16,31,55,-24,21
CC Mariners,4579,10,4,8,15,28,49,-21,20
Sydney FC,4580,1,20,4,4,64,23,41,64
N'castle Jet,4580,2,16,5,7,60,38,22,53
Melbourne V,4580,3,14,5,10,46,38,8,47
Melbourne C,4580,4,14,4,11,44,36,8,46
Adelaide Utd,4580,5,11,6,11,37,40,-3,39
Brisbane,4580,6,10,5,13,33,42,-9,35
Western Sydn,4580,7,8,9,10,38,47,-9,33
Perth Glory,4580,8,10,2,15,37,50,-13,32
Wellington P,4580,9,5,6,16,31,55,-24,21
CC Mariners,4580,10,4,8,15,28,49,-21,20
Sydney FC,4581,1,20,5,3,65,23,42,65
N'castle Jet,4581,2,16,5,7,59,38,21,53
Melbourne C,4581,3,14,4,11,44,35,9,46
Melbourne V,4581,4,13,6,10,46,39,7,45
Adelaide Utd,4581,5,11,6,11,37,40,-3,39
Brisbane,4581,6,10,5,13,33,42,-9,35
Western Sydn,4581,7,8,9,10,38,47,-9,33
Perth Glory,4581,8,10,2,15,37,50,-13,32
Wellington P,4581,9,5,6,16,31,55,-24,21
CC Mariners,4581,10,4,8,15,28,49,-21,20
Sydney FC,4582,1,21,4,3,67,22,45,67
N'castle Jet,4582,2,15,6,7,57,37,20,51
Melbourne C,4582,3,14,5,10,43,33,10,47
Melbourne V,4582,4,13,5,11,45,41,4,44
Adelaide Utd,4582,5,11,6,11,37,40,-3,39
Brisbane,4582,6,10,5,13,33,42,-9,35
Western Sydn,4582,7,8,9,10,38,47,-9,33
Perth Glory,4582,8,10,2,15,37,50,-13,32
Wellington P,4582,9,5,6,16,31,55,-24,21
CC Mariners,4582,10,4,8,15,28,49,-21,20
Sydney FC,4583,1,21,4,3,66,23,43,67
N'castle Jet,4583,2,16,5,7,59,37,22,53
Melbourne C,4583,3,14,4,11,43,35,8,46
Melbourne V,4583,4,13,5,11,46,40,6,44
Adelaide Utd,4583,5,11,6,11,37,40,-3,39
Brisbane,4583,6,10,5,13,33,42,-9,35
Western Sydn,4583,7,8,9,10,38,47,-9,33
Perth Glory,4583,8,10,2,15,37,50,-13,32
Wellington P,4583,9,5,6,16,31,55,-24,21
CC Mariners,4583,10,4,8,15,28,49,-21,20
Sydney FC,4584,1,21,4,3,67,22,45,67
N'castle Jet,4584,2,15,5,8,58,41,17,50
Melbourne C,4584,3,15,4,10,47,34,13,49
Melbourne V,4584,4,13,5,11,45,41,4,44
Adelaide Utd,4584,5,11,6,11,37,40,-3,39
Brisbane,4584,6,10,5,13,33,42,-9,35
Western Sydn,4584,7,8,9,10,38,47,-9,33
Perth Glory,4584,8,10,2,15,37,50,-13,32
Wellington P,4584,9,5,6,16,31,55,-24,21
CC Mariners,4584,10,4,8,15,28,49,-21,20
Sydney FC,4585,1,21,4,3,66,23,43,67
N'castle Jet,4585,2,15,5,8,59,42,17,50
Melbourne C,4585,3,15,4,10,48,35,13,49
Melbourne V,4585,4,13,5,11,46,40,6,44
Adelaide Utd,4585,5,11,6,11,37,40,-3,39
Brisbane,4585,6,10,5,13,33,42,-9,35
Western Sydn,4585,7,8,9,10,38,47,-9,33
Perth Glory,4585,8,10,2,15,37,50,-13,32
Wellington P,4585,9,5,6,16,31,55,-24,21
CC Mariners,4585,10,4,8,15,28,49,-21,20
Sydney FC,4586,1,20,5,3,65,23,42,65
N'castle Jet,4586,2,15,6,7,59,39,20,51
Melbourne C,4586,3,14,5,10,45,35,10,47
Melbourne V,4586,4,13,6,10,46,39,7,45
Adelaide Utd,4586,5,11,6,11,37,40,-3,39
Brisbane,4586,6,10,5,13,33,42,-9,35
Western Sydn,4586,7,8,9,10,38,47,-9,33
Perth Glory,4586,8,10,2,15,37,50,-13,32
Wellington P,4586,9,5,6,16,31,55,-24,21
CC Mariners,4586,10,4,8,15,28,49,-21,20
Sydney FC,4587,1,21,4,3,65,22,43,67
N'castle Jet,4587,2,15,5,8,57,38,19,50
Melbourne C,4587,3,15,4,10,44,33,11,49
Melbourne V,4587,4,13,5,11,45,39,6,44
Adelaide Utd,4587,5,11,6,11,37,40,-3,39
Brisbane,4587,6,10,5,13,33,42,-9,35
Western Sydn,4587,7,8,9,10,38,47,-9,33
Perth Glory,4587,8,10,2,15,37,50,-13,32
Wellington P,4587,9,5,6,16,31,55,-24,21
CC Mariners,4587,10,4,8,15,28,49,-21,20
Sydney FC,4588,1,21,4,3,67,23,44,67
N'castle Jet,4588,2,15,6,7,57,37,20,51
Melbourne C,4588,3,14,5,10,43,33,10,47
Melbourne V,4588,4,13,5,11,46,41,5,44
Adelaide Utd,4588,5,11,6,11,37,40,-3,39
Brisbane,4588,6,10,5,13,33,42,-9,35
Western Sydn,4588,7,8,9,10,38,47,-9,33
Perth Glory,4588,8,10,2,15,37,50,-13,32
Wellington P,4588,9,5,6,16,31,55,-24,21
CC Mariners,4588,10,4,8,15,28,49,-21,20
Sydney FC,4589,1,21,4,3,67,22,45,67
N'castle Jet,4589,2,15,5,8,57,38,19,50
Melbourne C,4589,3,15,4,10,44,33,11,49
Melbourne V,4589,4,13,5,11,45,41,4,44
Adelaide Utd,4589,5,11,6,11,37,40,-3,39
Brisbane,4589,6,10,5,13,33,42,-9,35
Western Sydn,4589,7,8,9,10,38,47,-9,33
Perth Glory,4589,8,10,2,15,37,50,-13,32
Wellington P,4589,9,5,6,16,31,55,-24,21
CC Mariners,4589,10,4,8,15,28,49,-21,20
Sydney FC,4590,1,21,4,3,68,23,45,67
N'castle Jet,4590,2,15,6,7,58,38,20,51
Melbourne C,4590,3,14,5,10,44,34,10,47
Melbourne V,4590,4,13,5,11,46,42,4,44
Adelaide Utd,4590,5,11,6,11,37,40,-3,39
Brisbane,4590,6,10,5,13,33,42,-9,35
Western Sydn,4590,7,8,9,10,38,47,-9,33
Perth Glory,4590,8,10,2,15,37,50,-13,32
Wellington P,4590,9,5,6,16,31,55,-24,21
CC Mariners,4590,10,4,8,15,28,49,-21,20
Sydney FC,4591,1,20,4,4,65,24,41,64
N'castle Jet,4591,2,16,5,7,59,37,22,53
Melbourne V,4591,3,14,5,10,47,39,8,47
Melbourne C,4591,4,14,4,11,43,35,8,46
Adelaide Utd,4591,5,11,6,11,37,40,-3,39
Brisbane,4591,6,10,5,13,33,42,-9,35
Western Sydn,4591,7,8,9,10,38,47,-9,33
Perth Glory,4591,8,10,2,15,37,50,-13,32
Wellington P,4591,9,5,6,16,31,55,-24,21
CC Mariners,4591,10,4,8,15,28,49,-21,20
Sydney FC,4592,1,21,4,3,68,24,44,67
N'castle Jet,4592,2,16,5,7,59,38,21,53
Melbourne C,4592,3,14,4,11,44,35,9,46
Melbourne V,4592,4,13,5,11,47,42,5,44
Adelaide Utd,4592,5,11,6,11,37,40,-3,39
Brisbane,4592,6,10,5,13,33,42,-9,35
Western Sydn,4592,7,8,9,10,38,47,-9,33
Perth Glory,4592,8,10,2,15,37,50,-13,32
Wellington P,4592,9,5,6,16,31,55,-24,21
CC Mariners,4592,10,4,8,15,28,49,-21,20
Sydney FC,4593,1,20,5,3,65,23,42,65
N'castle Jet,4593,2,15,6,7,58,38,20,51
Melbourne C,4593,3,14,5,10,44,34,10,47
Melbourne V,4593,4,13,6,10,46,39,7,45
Adelaide Utd,4593,5,11,6,11,37,40,-3,39
Brisbane,4593,6,10,5,13,33,42,-9,35
Western Sydn,4593,7,8,9,10,38,47,-9,33
Perth Glory,4593,8,10,2,15,37,50,-13,32
Wellington P,4593,9,5,6,16,31,55,-24,21
CC Mariners,4593,10,4,8,15,28,49,-21,20
Sydney FC,4594,1,20,5,3,65,23,42,65
N'castle Jet,4594,2,16,5,7,63,37,26,53
Melbourne C,4594,3,14,4,11,43,39,4,46
Melbourne V,4594,4,13,6,10,46,39,7,45
Adelaide Utd,4594,5,11,6,11,37,40,-3,39
Brisbane,4594,6,10,5,13,33,42,-9,35
Western Sydn,4594,7,8,9,10,38,47,-9,33
Perth Glory,4594,8,10,2,15,37,50,-13,32
Wellington P,4594,9,5,6,16,31,55,-24,21
CC Mariners,4594,10,4,8,15,28,49,-21,20
Sydney FC,4595,1,21,4,3,65,22,43,67
N'castle Jet,4595,2,16,5,7,58,37,21,53
Melbourne C,4595,3,14,4,11,43,34,9,46
Melbourne V,4595,4,13,5,11,45,39,6,44
Adelaide Utd,4595,5,11,6,11,37,40,-3,39
Brisbane,4595,6,10,5,13,33,42,-9,35
Western Sydn,4595,7,8,9,10,38,47,-9,33
Perth Glory,4595,8,10,2,15,37,50,-13,32
Wellington P,4595,9,5,6,16,31,55,-24,21
CC Mariners,4595,10,4,8,15,28,49,-21,20
Sydney FC,4596,1,21,4,3,66,23,43,67
N'castle Jet,4596,2,15,6,7,59,39,20,51
Melbourne C,4596,3,14,5,10,45,35,10,47
Melbourne V,4596,4,13,5,11,46,40,6,44
Adelaide Utd,4596,5,11,6,11,37,40,-3,39
Brisbane,4596,6,10,5,13,33,42,-9,35
Western Sydn,4596,7,8,9,10,38,47,-9,33
Perth Glory,4596,8,10,2,15,37,50,-13,32
Wellington P,4596,9,5,6,16,31,55,-24,21
CC Mariners,4596,10,4,8,15,28,49,-21,20
Sydney FC,4597,1,21,4,3,68,24,44,67
N'castle Jet,4597,2,15,6,7,59,39,20,51
Melbourne C,4597,3,14,5,10,45,35,10,47
Melbourne V,4597,4,13,5,11,47,42,5,44
Adelaide Utd,4597,5,11,6,11,37,40,-3,39
Brisbane,4597,6,10,5,13,33,42,-9,35
Western Sydn,4597,7,8,9,10,38,47,-9,33
Perth Glory,4597,8,10,2,15,37,50,-13,32
Wellington P,4597,9,5,6,16,31,55,-24,21
CC Mariners,4597,10,4,8,15,28,49,-21,20
Sydney FC,4598,1,21,4,3,70,22,48,67
N'castle Jet,4598,2,15,5,8,58,39,19,50
Melbourne C,4598,3,15,4,10,45,34,11,49
Melbourne V,4598,4,13,5,11,45,44,1,44
Adelaide Utd,4598,5,11,6,11,37,40,-3,39
Brisbane,4598,6,10,5,13,33,42,-9,35
Western Sydn,4598,7,8,9,10,38,47,-9,33
Perth Glory,4598,8,10,2,15,37,50,-13,32
Wellington P,4598,9,5,6,16,31,55,-24,21
CC Mariners,4598,10,4,8,15,28,49,-21,20
Sydney FC,4599,1,20,5,3,65,23,42,65
N'castle Jet,4599,2,16,5,7,60,37,23,53
Melbourne C,4599,3,14,4,11,43,36,7,46
Melbourne V,4599,4,13,6,10,46,39,7,45
Adelaide Utd,4599,5,11,6,11,37,40,-3,39
Brisbane,4599,6,10,5,13,33,42,-9,35
Western Sydn,4599,7,8,9,10,38,47,-9,33
Perth Glory,4599,8,10,2,15,37,50,-13,32
Wellington P,4599,9,5,6,16,31,55,-24,21
CC Mariners,4599,10,4,8,15,28,49,-21,20
Sydney FC,4600,1,20,5,3,65,23,42,65
N'castle Jet,4600,2,15,6,7,58,38,20,51
Melbourne C,4600,3,14,5,10,44,34,10,47
Melbourne V,4600,4,13,6,10,46,39,7,45
Adelaide Utd,4600,5,11,6,11,37,40,-3,39
Brisbane,4600,6,10,5,13,33,42,-9,35
Western Sydn,4600,7,8,9,10,38,47,-9,33
Perth Glory,4600,8,10,2,15,37,50,-13,32
Wellington P,4600,9,5,6,16,31,55,-24,21
CC Mariners,4600,10,4,8,15,28,49,-21,20
Sydney FC,4601,1,20,4,4,64,23,41,64
N'castle Jet,4601,2,16,5,7,59,38,21,53
Melbourne V,4601,3,14,5,10,46,38,8,47
Melbourne C,4601,4,14,4,11,44,35,9,46
Adelaide Utd,4601,5,11,6,11,37,40,-3,39
Brisbane,4601,6,10,5,13,33,42,-9,35
Western Sydn,4601,7,8,9,10,38,47,-9,33
Perth Glory,4601,8,10,2,15,37,50,-13,32
Wellington P,4601,9,5,6,16,31,55,-24,21
CC Mariners,4601,10,4,8,15,28,49,-21,20
Sydney FC,4602,1,21,4,3,66,22,44,67
N'castle Jet,4602,2,15,6,7,59,39,20,51
Melbourne C,4602,3,14,5,10,45,35,10,47
Melbourne V,4602,4,13,5,11,45,40,5,44
Adelaide Utd,4602,5,11,6,11,37,40,-3,39
Brisbane,4602,6,10,5,13,33,42,-9,35
Western Sydn,4602,7,8,9,10,38,47,-9,33
Perth Glory,4602,8,10,2,15,37,50,-13,32
Wellington P,4602,9,5,6,16,31,55,-24,21
CC Mariners,4602,10,4,8,15,28,49,-21,20
Sydney FC,4603,1,20,5,3,65,23,42,65
N'castle Jet,4603,2,16,5,7,61,37,24,53
Melbourne C,4603,3,14,4,11,43,37,6,46
Melbourne V,4603,4,13,6,10,46,39,7,45
Adelaide Utd,4603,5,11,6,11,37,40,-3,39
Brisbane,4603,6,10,5,13,33,42,-9,35
Western Sydn,4603,7,8,9,10,38,47,-9,33
Perth Glory,4603,8,10,2,15,37,50,-13,32
Wellington P,4603,9,5,6,16,31,55,-24,21
CC Mariners,4603,10,4,8,15,28,49,-21,20
Sydney FC,4604,1,21,4,3,67,22,45,67
N'castle Jet,4604,2,15,5,8,58,41,17,50
Melbourne C,4604,3,15,4,10,47,34,13,49
Melbourne V,4604,4,13,5,11,45,41,4,44
Adelaide Utd,4604,5,11,6,11,37,40,-3,39
Brisbane,4604,6,10,5,13,33,42,-9,35
Western Sydn,4604,7,8,9,10,38,47,-9,33
Perth Glory,4604,8,10,2,15,37,50,-13,32
Wellington P,4604,9,5,6,16,31,55,-24,21
CC Mariners,4604,10,4,8,15,28,49,-21,20
Sydney FC,4605,1,21,4,3,65,22,43,67
N'castle Jet,4605,2,16,5,7,59,38,21,53
Melbourne C,4605,3,14,4,11,44,35,9,46
Melbourne V,4605,4,13,5,11,45,39,6,44
Adelaide Utd,4605,5,11,6,11,37,40,-3,39
Brisbane,4605,6,10,5,13,33,42,-9,35
Western Sydn,4605,7,8,9,10,38,47,-9,33
Perth Glory,4605,8,10,2,15,37,50,-13,32
Wellington P,4605,9,5,6,16,31,55,-24,21
CC Mariners,4605,10,4,8,15,28,49,-21,20
Sydney FC,4606,1,20,5,3,65,23,42,65
N'castle Jet,4606,2,15,5,8,57,39,18,50
Melbourne C,4606,3,15,4,10,45,33,12,49
Melbourne V,4606,4,13,6,10,46,39,7,45
Adelaide Utd,4606,5,11,6,11,37,40,-3,39
Brisbane,4606,6,10,5,13,33,42,-9,35
Western Sydn,4606,7,8,9,10,38,47,-9,33
Perth Glory,4606,8,10,2,15,37,50,-13,32
Wellington P,4606,9,5,6,16,31,55,-24,21
CC Mariners,4606,10,4,8,15,28,49,-21,20
Sydney FC,4607,1,21,4,3,66,22,44,67
N'castle Jet,4607,2,15,5,8,57,41,16,50
Melbourne C,4607,3,15,4,10,47,33,14,49
Melbourne V,4607,4,13,5,11,45,40,5,44
Adelaide Utd,4607,5,11,6,11,37,40,-3,39
Brisbane,4607,6,10,5,13,33,42,-9,35
Western Sydn,4607,7,8,9,10,38,47,-9,33
Perth Glory,4607,8,10,2,15,37,50,-13,32
Wellington P,4607,9,5,6,16,31,55,-24,21
CC Mariners,4607,10,4,8,15,28,49,-21,20
Sydney FC,4608,1,21,4,3,66,22,44,67
N'castle Jet,4608,2,16,5,7,59,38,21,53
Melbourne C,4608,3,14,4,11,44,35,9,46
Melbourne V,4608,4,13,5,11,45,40,5,44
Adelaide Utd,4608,5,11,6,11,37,40,-3,39
Brisbane,4608,6,10,5,13,33,42,-9,35
Western Sydn,4608,7,8,9,10,38,47,-9,33
Perth Glory,4608,8,10,2,15,37,50,-13,32
Wellington P,4608,9,5,6,16,31,55,-24,21
CC Mariners,4608,10,4,8,15,28,49,-21,20
Sydney FC,4609,1,21,4,3,65,22,43,67
N'castle Jet,4609,2,16,5,7,58,37,21,53
Melbourne C,4609,3,14,4,11,43,34,9,46
Melbourne V,4609,4,13,5,11,45,39,6,44
Adelaide Utd,4609,5,11,6,11,37,40,-3,39
Brisbane,4609,6,10,5,13,33,42,-9,35
Western Sydn,4609,7,8,9,10,38,47,-9,33
Perth Glory,4609,8,10,2,15,37,50,-13,32
Wellington P,4609,9,5,6,16,31,55,-24,21
CC Mariners,4609,10,4,8,15,28,49,-21,20
Sydney FC,4610,1,20,5,3,65,23,42,65
N'castle Jet,4610,2,16,5,7,59,38,21,53
Melbourne C,4610,3,14,4,11,44,35,9,46
Melbourne V,4610,4,13,6,10,46,39,7,45
Adelaide Utd,4610,5,11,6,11,37,40,-3,39
Brisbane,4610,6,10,5,13,33,42,-9,35
Western Sydn,4610,7,8,9,10,38,47,-9,33
Perth Glory,4610,8,10,2,15,37,50,-13,32
Wellington P,4610,9,5,6,16,31,55,-24,21
CC Mariners,4610,10,4,8,15,28,49,-21,20
Sydney FC,4611,1,21,4,3,66,23,43,67
N'castle Jet,4611,2,15,5,8,57,40,17,50
Melbourne C,4611,3,15,4,10,46,33,13,49
Melbourne V,4611,4,13,5,11,46,40,6,44
Adelaide Utd,4611,5,11,6,11,37,40,-3,39
Brisbane,4611,6,10,5,13,33,42,-9,35
Western Sydn,4611,7,8,9,10,38,47,-9,33
Perth Glory,4611,8,10,2,15,37,50,-13,32
Wellington P,4611,9,5,6,16,31,55,-24,21
CC Mariners,4611,10,4,8,15,28,49,-21,20
Sydney FC,4612,1,20,4,4,64,24,40,64
N'castle Jet,4612,2,15,6,7,60,40,20,51
Melbourne C,4612,3,14,5,10,46,36,10,47
Melbourne V,4612,4,14,5,10,47,38,9,47
Adelaide Utd,4612,5,11,6,11,37,40,-3,39
Brisbane,4612,6,10,5,13,33,42,-9,35
Western Sydn,4612,7,8,9,10,38,47,-9,33
Perth Glory,4612,8,10,2,15,37,50,-13,32
Wellington P,4612,9,5,6,16,31,55,-24,21
CC Mariners,4612,10,4,8,15,28,49,-21,20
Sydney FC,4613,1,21,4,3,70,24,46,67
N'castle Jet,4613,2,15,5,8,58,40,18,50
Melbourne C,4613,3,15,4,10,46,34,12,49
Melbourne V,4613,4,13,5,11,47,44,3,44
Adelaide Utd,4613,5,11,6,11,37,40,-3,39
Brisbane,4613,6,10,5,13,33,42,-9,35
Western Sydn,4613,7,8,9,10,38,47,-9,33
Perth Glory,4613,8,10,2,15,37,50,-13,32
Wellington P,4613,9,5,6,16,31,55,-24,21
CC Mariners,4613,10,4,8,15,28,49,-21,20
Sydney FC,4614,1,21,4,3,66,23,43,67
N'castle Jet,4614,2,15,6,7,59,39,20,51
Melbourne C,4614,3,14,5,10,45,35,10,47
Melbourne V,4614,4,13,5,11,46,40,6,44
Adelaide Utd,4614,5,11,6,11,37,40,-3,39
Brisbane,4614,6,10,5,13,33,42,-9,35
Western Sydn,4614,7,8,9,10,38,47,-9,33
Perth Glory,4614,8,10,2,15,37,50,-13,32
Wellington P,4614,9,5,6,16,31,55,-24,21
CC Mariners,4614,10,4,8,15,28,49,-21,20
Sydney FC,4615,1,21,4,3,65,22,43,67
N'castle Jet,4615,2,16,5,7,61,39,22,53
Melbourne C,4615,3,14,4,11,45,37,8,46
Melbourne V,4615,4,13,5,11,45,39,6,44
Adelaide Utd,4615,5,11,6,11,37,40,-3,39
Brisbane,4615,6,10,5,13,33,42,-9,35
Western Sydn,4615,7,8,9,10,38,47,-9,33
Perth Glory,4615,8,10,2,15,37,50,-13,32
Wellington P,4615,9,5,6,16,31,55,-24,21
CC Mariners,4615,10,4,8,15,28,49,-21,20
Sydney FC,4616,1,20,4,4,64,23,41,64
N'castle Jet,4616,2,15,6,7,59,39,20,51
Melbourne C,4616,3,14,5,10,45,35,10,47
Melbourne V,4616,4,14,5,10,46,38,8,47
Adelaide Utd,4616,5,11,6,11,37,40,-3,39
Brisbane,4616,6,10,5,13,33,42,-9,35
Western Sydn,4616,7,8,9,10,38,47,-9,33
Perth Glory,4616,8,10,2,15,37,50,-13,32
Wellington P,4616,9,5,6,16,31,55,-24,21
CC Mariners,4616,10,4,8,15,28,49,-21,20
Sydney FC,4617,1,21,4,3,67,22,45,67
N'castle Jet,4617,2,16,5,7,59,38,21,53
Melbourne C,4617,3,14,4,11,44,35,9,46
Melbourne V,4617,4,13,5,11,45,41,4,44
Adelaide Utd,4617,5,11,6,11,37,40,-3,39
Brisbane,4617,6,10,5,13,33,42,-9,35
Western Sydn,4617,7,8,9,10,38,47,-9,33
Perth Glory,4617,8,10,2,15,37,50,-13,32
Wellington P,4617,9,5,6,16,31,55,-24,21
CC Mariners,4617,10,4,8,15,28,49,-21,20
Sydney FC,4618,1,21,4,3,65,22,43,67
N'castle Jet,4618,2,15,5,8,57,38,19,50
Melbourne C,4618,3,15,4,10,44,33,11,49
Melbourne V,4618,4,13,5,11,45,39,6,44
Adelaide Utd,4618,5,11,6,11,37,40,-3,39
Brisbane,4618,6,10,5,13,33,42,-9,35
Western Sydn,4618,7,8,9,10,38,47,-9,33
Perth Glory,4618,8,10,2,15,37,50,-13,32
Wellington P,4618,9,5,6,16,31,55,-24,21
CC Mariners,4618,10,4,8,15,28,49,-21,20
Sydney FC,4619,1,21,4,3,66,23,43,67
N'castle Jet,4619,2,15,6,7,58,38,20,51
Melbourne C,4619,3,14,5,10,44,34,10,47
Melbourne V,4619,4,13,5,11,46,40,6,44
Adelaide Utd,4619,5,11,6,11,37,40,-3,39
Brisbane,4619,6,10,5,13,33,42,-9,35
Western Sydn,4619,7,8,9,10,38,47,-9,33
Perth Glory,4619,8,10,2,15,37,50,-13,32
Wellington P,4619,9,5,6,16,31,55,-24,21
CC Mariners,4619,10,4,8,15,28,49,-21,20
Sydney FC,4620,1,21,4,3,66,23,43,67
N'castle Jet,4620,2,16,5,7,58,37,21,53
Melbourne C,4620,3,14,4,11,43,34,9,46
Melbourne V,4620,4,13,5,11,46,40,6,44
Adelaide Utd,4620,5,11,6,11,37,40,-3,39
Brisbane,4620,6,10,5,13,33,42,-9,35
Western Sydn,4620,7,8,9,10,38,47,-9,33
Perth Glory,4620,8,10,2,15,37,50,-13,32
Wellington P,4620,9,5,6,16,31,55,-24,21
CC Mariners,4620,10,4,8,15,28,49,-21,20
Sydney FC,4621,1,21,4,3,67,22,45,67
N'castle Jet,4621,2,16,5,7,60,38,22,53
Melbourne C,4621,3,14,4,11,44,36,8,46
Melbourne V,4621,4,13,5,11,45,41,4,44
Adelaide Utd,4621,5,11,6,11,37,40,-3,39
Brisbane,4621,6,10,5,13,33,42,-9,35
Western Sydn,4621,7,8,9,10,38,47,-9,33
Perth Glory,4621,8,10,2,15,37,50,-13,32
Wellington P,4621,9,5,6,16,31,55,-24,21
CC Mariners,4621,10,4,8,15,28,49,-21,20
Sydney FC,4622,1,21,4,3,69,22,47,67
N'castle Jet,4622,2,16,5,7,58,37,21,53
Melbourne C,4622,3,14,4,11,43,34,9,46
Melbourne V,4622,4,13,5,11,45,43,2,44
Adelaide Utd,4622,5,11,6,11,37,40,-3,39
Brisbane,4622,6,10,5,13,33,42,-9,35
Western Sydn,4622,7,8,9,10,38,47,-9,33
Perth Glory,4622,8,10,2,15,37,50,-13,32
Wellington P,4622,9,5,6,16,31,55,-24,21
CC Mariners,4622,10,4,8,15,28,49,-21,20
Sydney FC,4623,1,21,4,3,69,22,47,67
N'castle Jet,4623,2,15,6,7,58,38,20,51
Melbourne C,4623,3,14,5,10,44,34,10,47
Melbourne V,4623,4,13,5,11,45,43,2,44
Adelaide Utd,4623,5,11,6,11,37,40,-3,39
Brisbane,4623,6,10,5,13,33,42,-9,35
Western Sydn,4623,7,8,9,10,38,47,-9,33
Perth Glory,4623,8,10,2,15,37,50,-13,32
Wellington P,4623,9,5,6,16,31,55,-24,21
CC Mariners,4623,10,4,8,15,28,49,-21,20
Sydney FC,4624,1,21,4,3,68,24,44,67
N'castle Jet,4624,2,16,5,7,59,38,21,53
Melbourne C,4624,3,14,4,11,44,35,9,46
Melbourne V,4624,4,13,5,11,47,42,5,44
Adelaide Utd,4624,5,11,6,11,37,40,-3,39
Brisbane,4624,6,10,5,13,33,42,-9,35
Western Sydn,4624,7,8,9,10,38,47,-9,33
Perth Glory,4624,8,10,2,15,37,50,-13,32
Wellington P,4624,9,5,6,16,31,55,-24,21
CC Mariners,4624,10,4,8,15,28,49,-21,20
Sydney FC,4625,1,20,5,3,64,22,42,65
N'castle Jet,4625,2,15,5,8,57,38,19,50
Melbourne C,4625,3,15,4,10,44,33,11,49
Melbourne V,4625,4,13,6,10,45,38,7,45
Adelaide Utd,4625,5,11,6,11,37,40,-3,39
Brisbane,4625,6,10,5,13,33,42,-9,35
Western Sydn,4625,7,8,9,10,38,47,-9,33
Perth Glory,4625,8,10,2,15,37,50,-13,32
Wellington P,4625,9,5,6,16,31,55,-24,21
CC Mariners,4625,10,4,8,15,28,49,-21,20
Sydney FC,4626,1,20,5,3,65,23,42,65
N'castle Jet,4626,2,16,5,7,60,38,22,53
Melbourne C,4626,3,14,4,11,44,36,8,46
Melbourne V,4626,4,13,6,10,46,39,7,45
Adelaide Utd,4626,5,11,6,11,37,40,-3,39
Brisbane,4626,6,10,5,13,33,42,-9,35
Western Sydn,4626,7,8,9,10,38,47,-9,33
Perth Glory,4626,8,10,2,15,37,50,-13,32
Wellington P,4626,9,5,6,16,31,55,-24,21
CC Mariners,4626,10,4,8,15,28,49,-21,20
Sydney FC,4627,1,20,5,3,66,24,42,65
N'castle Jet,4627,2,15,5,8,57,38,19,50
Melbourne C,4627,3,15,4,10,44,33,11,49
Melbourne V,4627,4,13,6,10,47,40,7,45
Adelaide Utd,4627,5,11,6,11,37,40,-3,39
Brisbane,4627,6,10,5,13,33,42,-9,35
Western Sydn,4627,7,8,9,10,38,47,-9,33
Perth Glory,4627,8,10,2,15,37,50,-13,32
Wellington P,4627,9,5,6,16,31,55,-24,21
CC Mariners,4627,10,4,8,15,28,49,-21,20
Sydney FC,4628,1,21,4,3,65,22,43,67
N'castle Jet,4628,2,16,5,7,60,39,21,53
Melbourne C,4628,3,14,4,11,45,36,9,46
Melbourne V,4628,4,13,5,11,45,39,6,44
Adelaide Utd,4628,5,11,6,11,37,40,-3,39
Brisbane,4628,6,10,5,13,33,42,-9,35
Western Sydn,4628,7,8,9,10,38,47,-9,33
Perth Glory,4628,8,10,2,15,37,50,-13,32
Wellington P,4628,9,5,6,16,31,55,-24,21
CC Mariners,4628,10,4,8,15,28,49,-21,20
Sydney FC,4629,1,20,4,4,64,23,41,64
N'castle Jet,4629,2,15,5,8,59,40,19,50
Melbourne C,4629,3,15,4,10,46,35,11,49
Melbourne V,4629,4,14,5,10,46,38,8,47
Adelaide Utd,4629,5,11,6,11,37,40,-3,39
Brisbane,4629,6,10,5,13,33,42,-9,35
Western Sydn,4629,7,8,9,10,38,47,-9,33
Perth Glory,4629,8,10,2,15,37,50,-13,32
Wellington P,4629,9,5,6,16,31,55,-24,21
CC Mariners,4629,10,4,8,15,28,49,-21,20
Sydney FC,4630,1,20,5,3,65,23,42,65
N'castle Jet,4630,2,15,5,8,59,40,19,50
Melbourne C,4630,3,15,4,10,46,35,11,49
Melbourne V,4630,4,13,6,10,46,39,7,45
Adelaide Utd,4630,5,11,6,11,37,40,-3,39
Brisbane,4630,6,10,5,13,33,42,-9,35
Western Sydn,4630,7,8,9,10,38,47,-9,33
Perth Glory,4630,8,10,2,15,37,50,-13,32
Wellington P,4630,9,5,6,16,31,55,-24,21
CC Mariners,4630,10,4,8,15,28,49,-21,20
Sydney FC,4631,1,21,4,3,69,23,46,67
N'castle Jet,4631,2,15,5,8,58,41,17,50
Melbourne C,4631,3,15,4,10,47,34,13,49
Melbourne V,4631,4,13,5,11,46,43,3,44
Adelaide Utd,4631,5,11,6,11,37,40,-3,39
Brisbane,4631,6,10,5,13,33,42,-9,35
Western Sydn,4631,7,8,9,10,38,47,-9,33
Perth Glory,4631,8,10,2,15,37,50,-13,32
Wellington P,4631,9,5,6,16,31,55,-24,21
CC Mariners,4631,10,4,8,15,28,49,-21,20
Sydney FC,4632,1,20,4,4,64,23,41,64
N'castle Jet,4632,2,16,5,7,59,38,21,53
Melbourne V,4632,3,14,5,10,46,38,8,47
Melbourne C,4632,4,14,4,11,44,35,9,46
Adelaide Utd,4632,5,11,6,11,37,40,-3,39
Brisbane,4632,6,10,5,13,33,42,-9,35
Western Sydn,4632,7,8,9,10,38,47,-9,33
Perth Glory,4632,8,10,2,15,37,50,-13,32
Wellington P,4632,9,5,6,16,31,55,-24,21
CC Mariners,4632,10,4,8,15,28,49,-21,20
Sydney FC,4633,1,21,4,3,67,24,43,67
N'castle Jet,4633,2,16,5,7,60,38,22,53
Melbourne C,4633,3,14,4,11,44,36,8,46
Melbourne V,4633,4,13,5,11,47,41,6,44
Adelaide Utd,4633,5,11,6,11,37,40,-3,39
Brisbane,4633,6,10,5,13,33,42,-9,35
Western Sydn,4633,7,8,9,10,38,47,-9,33
Perth Glory,4633,8,10,2,15,37,50,-13,32
Wellington P,4633,9,5,6,16,31,55,-24,21
CC Mariners,4633,10,4,8,15,28,49,-21,20
Sydney FC,4634,1,21,4,3,67,23,44,67
N'castle Jet,4634,2,15,5,8,57,38,19,50
Melbourne C,4634,3,15,4,10,44,33,11,49
Melbourne V,4634,4,13,5,11,46,41,5,44
Adelaide Utd,4634,5,11,6,11,37,40,-3,39
Brisbane,4634,6,10,5,13,33,42,-9,35
Western Sydn,4634,7,8,9,10,38,47,-9,33
Perth Glory,4634,8,10,2,15,37,50,-13,32
Wellington P,4634,9,5,6,16,31,55,-24,21
CC Mariners,4634,10,4,8,15,28,49,-21,20
Sydney FC,4635,1,20,5,3,67,25,42,65
N'castle Jet,4635,2,15,6,7,59,39,20,51
Melbourne C,4635,3,14,5,10,45,35,10,47
Melbourne V,4635,4,13,6,10,48,41,7,45
Adelaide Utd,4635,5,11,6,11,37,40,-3,39
Brisbane,4635,6,10,5,13,33,42,-9,35
Western Sydn,4635,7,8,9,10,38,47,-9,33
Perth Glory,4635,8,10,2,15,37,50,-13,32
Wellington P,4635,9,5,6,16,31,55,-24,21
CC Mariners,4635,10,4,8,15,28,49,-21,20
Sydney FC,4636,1,21,4,3,65,22,43,67
N'castle Jet,4636,2,15,6,7,60,40,20,51
Melbourne C,4636,3,14,5,10,46,36,10,47
Melbourne V,4636,4,13,5,11,45,39,6,44
Adelaide Utd,4636,5,11,6,11,37,40,-3,39
Brisbane,4636,6,10,5,13,33,42,-9,35
Western Sydn,4636,7,8,9,10,38,47,-9,33
Perth Glory,4636,8,10,2,15,37,50,-13,32
Wellington P,4636,9,5,6,16,31,55,-24,21
CC Mariners,4636,10,4,8,15,28,49,-21,20
Sydney FC,4637,1,21,4,3,67,24,43,67
N'castle Jet,4637,2,16,5,7,60,37,23,53
Melbourne C,4637,3,14,4,11,43,36,7,46
Melbourne V,4637,4,13,5,11,47,41,6,44
Adelaide Utd,4637,5,11,6,11,37,40,-3,39
Brisbane,4637,6,10,5,13,33,42,-9,35
Western Sydn,4637,7,8,9,10,38,47,-9,33
Perth Glory,4637,8,10,2,15,37,50,-13,32
Wellington P,4637,9,5,6,16,31,55,-24,21
CC Mariners,4637,10,4,8,15,28,49,-21,20
Sydney FC,4638,1,20,4,4,66,25,41,64
N'castle Jet,4638,2,16,5,7,59,37,22,53
Melbourne V,4638,3,14,5,10,48,40,8,47
Melbourne C,4638,4,14,4,11,43,35,8,46
Adelaide Utd,4638,5,11,6,11,37,40,-3,39
Brisbane,4638,6,10,5,13,33,42,-9,35
Western Sydn,4638,7,8,9,10,38,47,-9,33
Perth Glory,4638,8,10,2,15,37,50,-13,32
Wellington P,4638,9,5,6,16,31,55,-24,21
CC Mariners,4638,10,4,8,15,28,49,-21,20
Sydney FC,4639,1,20,4,4,66,26,40,64
N'castle Jet,4639,2,15,6,7,57,37,20,51
Melbourne C,4639,3,14,5,10,43,33,10,47
Melbourne V,4639,4,14,5,10,49,40,9,47
Adelaide Utd,4639,5,11,6,11,37,40,-3,39
Brisbane,4639,6,10,5,13,33,42,-9,35
Western Sydn,4639,7,8,9,10,38,47,-9,33
Perth Glory,4639,8,10,2,15,37,50,-13,32
Wellington P,4639,9,5,6,16,31,55,-24,21
CC Mariners,4639,10,4,8,15,28,49,-21,20
Sydney FC,4640,1,20,4,4,65,24,41,64
N'castle Jet,4640,2,16,5,7,59,37,22,53
Melbourne V,4640,3,14,5,10,47,39,8,47
Melbourne C,4640,4,14,4,11,43,35,8,46
Adelaide Utd,4640,5,11,6,11,37,40,-3,39
Brisbane,4640,6,10,5,13,33,42,-9,35
Western Sydn,4640,7,8,9,10,38,47,-9,33
Perth Glory,4640,8,10,2,15,37,50,-13,32
Wellington P,4640,9,5,6,16,31,55,-24,21
CC Mariners,4640,10,4,8,15,28,49,-21,20
Sydney FC,4641,1,21,4,3,66,22,44,67
N'castle Jet,4641,2,15,6,7,58,38,20,51
Melbourne C,4641,3,14,5,10,44,34,10,47
Melbourne V,4641,4,13,5,11,45,40,5,44
Adelaide Utd,4641,5,11,6,11,37,40,-3,39
Brisbane,4641,6,10,5,13,33,42,-9,35
Western Sydn,4641,7,8,9,10,38,47,-9,33
Perth Glory,4641,8,10,2,15,37,50,-13,32
Wellington P,4641,9,5,6,16,31,55,-24,21
CC Mariners,4641,10,4,8,15,28,49,-21,20
Sydney FC,4642,1,20,5,3,66,24,42,65
N'castle Jet,4642,2,15,5,8,57,39,18,50
Melbourne C,4642,3,15,4,10,45,33,12,49
Melbourne V,4642,4,13,6,10,47,40,7,45
Adelaide Utd,4642,5,11,6,11,37,40,-3,39
Brisbane,4642,6,10,5,13,33,42,-9,35
Western Sydn,4642,7,8,9,10,38,47,-9,33
Perth Glory,4642,8,10,2,15,37,50,-13,32
Wellington P,4642,9,5,6,16,31,55,-24,21
CC Mariners,4642,10,4,8,15,28,49,-21,20
Sydney FC,4643,1,21,4,3,66,23,43,67
N'castle Jet,4643,2,16,5,7,62,39,23,53
Melbourne C,4643,3,14,4,11,45,38,7,46
Melbourne V,4643,4,13,5,11,46,40,6,44
Adelaide Utd,4643,5,11,6,11,37,40,-3,39
Brisbane,4643,6,10,5,13,33,42,-9,35
Western Sydn,4643,7,8,9,10,38,47,-9,33
Perth Glory,4643,8,10,2,15,37,50,-13,32
Wellington P,4643,9,5,6,16,31,55,-24,21
CC Mariners,4643,10,4,8,15,28,49,-21,20
Sydney FC,4644,1,20,4,4,64,23,41,64
N'castle Jet,4644,2,16,5,7,58,37,21,53
Melbourne V,4644,3,14,5,10,46,38,8,47
Melbourne C,4644,4,14,4,11,43,34,9,46
Adelaide Utd,4644,5,11,6,11,37,40,-3,39
Brisbane,4644,6,10,5,13,33,42,-9,35
Western Sydn,4644,7,8,9,10,38,47,-9,33
Perth Glory,4644,8,10,2,15,37,50,-13,32
Wellington P,4644,9,5,6,16,31,55,-24,21
CC Mariners,4644,10,4,8,15,28,49,-21,20
Sydney FC,4645,1,20,4,4,65,24,41,64
N'castle Jet,4645,2,15,6,7,57,37,20,51
Melbourne C,4645,3,14,5,10,43,33,10,47
Melbourne V,4645,4,14,5,10,47,39,8,47
Adelaide Utd,4645,5,11,6,11,37,40,-3,39
Brisbane,4645,6,10,5,13,33,42,-9,35
Western Sydn,4645,7,8,9,10,38,47,-9,33
Perth Glory,4645,8,10,2,15,37,50,-13,32
Wellington P,4645,9,5,6,16,31,55,-24,21
CC Mariners,4645,10,4,8,15,28,49,-21,20
Sydney FC,4646,1,20,5,3,66,24,42,65
N'castle Jet,4646,2,15,5,8,58,39,19,50
Melbourne C,4646,3,15,4,10,45,34,11,49
Melbourne V,4646,4,13,6,10,47,40,7,45
Adelaide Utd,4646,5,11,6,11,37,40,-3,39
Brisbane,4646,6,10,5,13,33,42,-9,35
Western Sydn,4646,7,8,9,10,38,47,-9,33
Perth Glory,4646,8,10,2,15,37,50,-13,32
Wellington P,4646,9,5,6,16,31,55,-24,21
CC Mariners,4646,10,4,8,15,28,49,-21,20
Sydney FC,4647,1,21,4,3,69,22,47,67
N'castle Jet,4647,2,15,5,8,57,38,19,50
Melbourne C,4647,3,15,4,10,44,33,11,49
Melbourne V,4647,4,13,5,11,45,43,2,44
Adelaide Utd,4647,5,11,6,11,37,40,-3,39
Brisbane,4647,6,10,5,13,33,42,-9,35
Western Sydn,4647,7,8,9,10,38,47,-9,33
Perth Glory,4647,8,10,2,15,37,50,-13,32
Wellington P,4647,9,5,6,16,31,55,-24,21
CC Mariners,4647,10,4,8,15,28,49,-21,20
Sydney FC,4648,1,20,4,4,66,25,41,64
N'castle Jet,4648,2,15,5,8,57,40,17,50
Melbourne C,4648,3,15,4,10,46,33,13,49
Melbourne V,4648,4,14,5,10,48,40,8,47
Adelaide Utd,4648,5,11,6,11,37,40,-3,39
Brisbane,4648,6,10,5,13,33,42,-9,35
Western Sydn,4648,7,8,9,10,38,47,-9,33
Perth Glory,4648,8,10,2,15,37,50,-13,32
Wellington P,4648,9,5,6,16,31,55,-24,21
CC Mariners,4648,10,4,8,15,28,49,-21,20
Sydney FC,4649,1,20,5,3,67,25,42,65
N'castle Jet,4649,2,16,5,7,62,38,24,53
Melbourne C,4649,3,14,4,11,44,38,6,46
Melbourne V,4649,4,13,6,10,48,41,7,45
Adelaide Utd,4649,5,11,6,11,37,40,-3,39
Brisbane,4649,6,10,5,13,33,42,-9,35
Western Sydn,4649,7,8,9,10,38,47,-9,33
Perth Glory,4649,8,10,2,15,37,50,-13,32
Wellington P,4649,9,5,6,16,31,55,-24,21
CC Mariners,4649,10,4,8,15,28,49,-21,20
Sydney FC,4650,1,20,4,4,65,24,41,64
N'castle Jet,4650,2,15,5,8,57,39,18,50
Melbourne C,4650,3,15,4,10,45,33,12,49
Melbourne V,4650,4,14,5,10,47,39,8,47
Adelaide Utd,4650,5,11,6,11,37,40,-3,39
Brisbane,4650,6,10,5,13,33,42,-9,35
Western Sydn,4650,7,8,9,10,38,47,-9,33
Perth Glory,4650,8,10,2,15,37,50,-13,32
Wellington P,4650,9,5,6,16,31,55,-24,21
CC Mariners,4650,10,4,8,15,28,49,-21,20
Sydney FC,4651,1,21,4,3,67,23,44,67
N'castle Jet,4651,2,15,6,7,58,38,20,51
Melbourne C,4651,3,14,5,10,44,34,10,47
Melbourne V,4651,4,13,5,11,46,41,5,44
Adelaide Utd,4651,5,11,6,11,37,40,-3,39
Brisbane,4651,6,10,5,13,33,42,-9,35
Western Sydn,4651,7,8,9,10,38,47,-9,33
Perth Glory,4651,8,10,2,15,37,50,-13,32
Wellington P,4651,9,5,6,16,31,55,-24,21
CC Mariners,4651,10,4,8,15,28,49,-21,20
Sydney FC,4652,1,21,4,3,68,25,43,67
N'castle Jet,4652,2,15,6,7,57,37,20,51
Melbourne C,4652,3,14,5,10,43,33,10,47
Melbourne V,4652,4,13,5,11,48,42,6,44
Adelaide Utd,4652,5,11,6,11,37,40,-3,39
Brisbane,4652,6,10,5,13,33,42,-9,35
Western Sydn,4652,7,8,9,10,38,47,-9,33
Perth Glory,4652,8,10,2,15,37,50,-13,32
Wellington P,4652,9,5,6,16,31,55,-24,21
CC Mariners,4652,10,4,8,15,28,49,-21,20
Sydney FC,4653,1,21,4,3,65,22,43,67
N'castle Jet,4653,2,15,5,8,57,39,18,50
Melbourne C,4653,3,15,4,10,45,33,12,49
Melbourne V,4653,4,13,5,11,45,39,6,44
Adelaide Utd,4653,5,11,6,11,37,40,-3,39
Brisbane,4653,6,10,5,13,33,42,-9,35
Western Sydn,4653,7,8,9,10,38,47,-9,33
Perth Glory,4653,8,10,2,15,37,50,-13,32
Wellington P,4653,9,5,6,16,31,55,-24,21
CC Mariners,4653,10,4,8,15,28,49,-21,20
Sydney FC,4654,1,21,4,3,66,22,44,67
N'castle Jet,4654,2,15,5,8,57,39,18,50
Melbourne C,4654,3,15,4,10,45,33,12,49
Melbourne V,4654,4,13,5,11,45,40,5,44
Adelaide Utd,4654,5,11,6,11,37,40,-3,39
Brisbane,4654,6,10,5,13,33,42,-9,35
Western Sydn,4654,7,8,9,10,38,47,-9,33
Perth Glory,4654,8,10,2,15,37,50,-13,32
Wellington P,4654,9,5,6,16,31,55,-24,21
CC Mariners,4654,10,4,8,15,28,49,-21,20
Sydney FC,4655,1,20,5,3,65,23,42,65
N'castle Jet,4655,2,16,5,7,60,39,21,53
Melbourne C,4655,3,14,4,11,45,36,9,46
Melbourne V,4655,4,13,6,10,46,39,7,45
Adelaide Utd,4655,5,11,6,11,37,40,-3,39
Brisbane,4655,6,10,5,13,33,42,-9,35
Western Sydn,4655,7,8,9,10,38,47,-9,33
Perth Glory,4655,8,10,2,15,37,50,-13,32
Wellington P,4655,9,5,6,16,31,55,-24,21
CC Mariners,4655,10,4,8,15,28,49,-21,20
Sydney FC,4656,1,21,4,3,66,23,43,67
N'castle Jet,4656,2,15,6,7,58,38,20,51
Melbourne C,4656,3,14,5,10,44,34,10,47
Melbourne V,4656,4,13,5,11,46,40,6,44
Adelaide Utd,4656,5,11,6,11,37,40,-3,39
Brisbane,4656,6,10,5,13,33,42,-9,35
Western Sydn,4656,7,8,9,10,38,47,-9,33
Perth Glory,4656,8,10,2,15,37,50,-13,32
Wellington P,4656,9,5,6,16,31,55,-24,21
CC Mariners,4656,10,4,8,15,28,49,-21,20
Sydney FC,4657,1,21,4,3,67,24,43,67
N'castle Jet,4657,2,16,5,7,61,40,21,53
Melbourne C,4657,3,14,4,11,46,37,9,46
Melbourne V,4657,4,13,5,11,47,41,6,44
Adelaide Utd,4657,5,11,6,11,37,40,-3,39
Brisbane,4657,6,10,5,13,33,42,-9,35
Western Sydn,4657,7,8,9,10,38,47,-9,33
Perth Glory,4657,8,10,2,15,37,50,-13,32
Wellington P,4657,9,5,6,16,31,55,-24,21
CC Mariners,4657,10,4,8,15,28,49,-21,20
Sydney FC,4658,1,21,4,3,66,23,43,67
N'castle Jet,4658,2,15,5,8,58,39,19,50
Melbourne C,4658,3,15,4,10,45,34,11,49
Melbourne V,4658,4,13,5,11,46,40,6,44
Adelaide Utd,4658,5,11,6,11,37,40,-3,39
Brisbane,4658,6,10,5,13,33,42,-9,35
Western Sydn,4658,7,8,9,10,38,47,-9,33
Perth Glory,4658,8,10,2,15,37,50,-13,32
Wellington P,4658,9,5,6,16,31,55,-24,21
CC Mariners,4658,10,4,8,15,28,49,-21,20
Sydney FC,4659,1,20,4,4,65,25,40,64
N'castle Jet,4659,2,16,5,7,59,37,22,53
Melbourne V,4659,3,14,5,10,48,39,9,47
Melbourne C,4659,4,14,4,11,43,35,8,46
Adelaide Utd,4659,5,11,6,11,37,40,-3,39
Brisbane,4659,6,10,5,13,33,42,-9,35
Western Sydn,4659,7,8,9,10,38,47,-9,33
Perth Glory,4659,8,10,2,15,37,50,-13,32
Wellington P,4659,9,5,6,16,31,55,-24,21
CC Mariners,4659,10,4,8,15,28,49,-21,20
Sydney FC,4660,1,21,4,3,66,22,44,67
N'castle Jet,4660,2,15,6,7,59,39,20,51
Melbourne C,4660,3,14,5,10,45,35,10,47
Melbourne V,4660,4,13,5,11,45,40,5,44
Adelaide Utd,4660,5,11,6,11,37,40,-3,39
Brisbane,4660,6,10,5,13,33,42,-9,35
Western Sydn,4660,7,8,9,10,38,47,-9,33
Perth Glory,4660,8,10,2,15,37,50,-13,32
Wellington P,4660,9,5,6,16,31,55,-24,21
CC Mariners,4660,10,4,8,15,28,49,-21,20
Sydney FC,4661,1,21,4,3,65,22,43,67
N'castle Jet,4661,2,16,5,7,60,37,23,53
Melbourne C,4661,3,14,4,11,43,36,7,46
Melbourne V,4661,4,13,5,11,45,39,6,44
Adelaide Utd,4661,5,11,6,11,37,40,-3,39
Brisbane,4661,6,10,5,13,33,42,-9,35
Western Sydn,4661,7,8,9,10,38,47,-9,33
Perth Glory,4661,8,10,2,15,37,50,-13,32
Wellington P,4661,9,5,6,16,31,55,-24,21
CC Mariners,4661,10,4,8,15,28,49,-21,20
Sydney FC,4662,1,21,4,3,67,24,43,67
N'castle Jet,4662,2,16,5,7,62,38,24,53
Melbourne C,4662,3,14,4,11,44,38,6,46
Melbourne V,4662,4,13,5,11,47,41,6,44
Adelaide Utd,4662,5,11,6,11,37,40,-3,39
Brisbane,4662,6,10,5,13,33,42,-9,35
Western Sydn,4662,7,8,9,10,38,47,-9,33
Perth Glory,4662,8,10,2,15,37,50,-13,32
Wellington P,4662,9,5,6,16,31,55,-24,21
CC Mariners,4662,10,4,8,15,28,49,-21,20
Sydney FC,4663,1,21,4,3,66,22,44,67
N'castle Jet,4663,2,16,5,7,61,39,22,53
Melbourne C,4663,3,14,4,11,45,37,8,46
Melbourne V,4663,4,13,5,11,45,40,5,44
Adelaide Utd,4663,5,11,6,11,37,40,-3,39
Brisbane,4663,6,10,5,13,33,42,-9,35
Western Sydn,4663,7,8,9,10,38,47,-9,33
Perth Glory,4663,8,10,2,15,37,50,-13,32
Wellington P,4663,9,5,6,16,31,55,-24,21
CC Mariners,4663,10,4,8,15,28,49,-21,20
Sydney FC,4664,1,21,4,3,66,22,44,67
N'castle Jet,4664,2,15,5,8,58,39,19,50
Melbourne C,4664,3,15,4,10,45,34,11,49
Melbourne V,4664,4,13,5,11,45,40,5,44
Adelaide Utd,4664,5,11,6,11,37,40,-3,39
Brisbane,4664,6,10,5,13,33,42,-9,35
Western Sydn,4664,7,8,9,10,38,47,-9,33
Perth Glory,4664,8,10,2,15,37,50,-13,32
Wellington P,4664,9,5,6,16,31,55,-24,21
CC Mariners,4664,10,4,8,15,28,49,-21,20
Sydney FC,4665,1,20,4,4,65,24,41,64
N'castle Jet,4665,2,16,5,7,59,37,22,53
Melbourne V,4665,3,14,5,10,47,39,8,47
Melbourne C,4665,4,14,4,11,43,35,8,46
Adelaide Utd,4665,5,11,6,11,37,40,-3,39
Brisbane,4665,6,10,5,13,33,42,-9,35
Western Sydn,4665,7,8,9,10,38,47,-9,33
Perth Glory,4665,8,10,2,15,37,50,-13,32
Wellington P,4665,9,5,6,16,31,55,-24,21
CC Mariners,4665,10,4,8,15,28,49,-21,20
Sydney FC,4666,1,21,4,3,67,23,44,67
N'castle Jet,4666,2,15,5,8,59,40,19,50
Melbourne C,4666,3,15,4,10,46,35,11,49
Melbourne V,4666,4,13,5,11,46,41,5,44
Adelaide Utd,4666,5,11,6,11,37,40,-3,39
Brisbane,4666,6,10,5,13,33,42,-9,35
Western Sydn,4666,7,8,9,10,38,47,-9,33
Perth Glory,4666,8,10,2,15,37,50,-13,32
Wellington P,4666,9,5,6,16,31,55,-24,21
CC Mariners,4666,10,4,8,15,28,49,-21,20
Sydney FC,4667,1,20,5,3,67,25,42,65
N'castle Jet,4667,2,16,5,7,63,39,24,53
Melbourne C,4667,3,14,4,11,45,39,6,46
Melbourne V,4667,4,13,6,10,48,41,7,45
Adelaide Utd,4667,5,11,6,11,37,40,-3,39
Brisbane,4667,6,10,5,13,33,42,-9,35
Western Sydn,4667,7,8,9,10,38,47,-9,33
Perth Glory,4667,8,10,2,15,37,50,-13,32
Wellington P,4667,9,5,6,16,31,55,-24,21
CC Mariners,4667,10,4,8,15,28,49,-21,20
Sydney FC,4668,1,20,4,4,66,25,41,64
N'castle Jet,4668,2,16,5,7,60,38,22,53
Melbourne V,4668,3,14,5,10,48,40,8,47
Melbourne C,4668,4,14,4,11,44,36,8,46
Adelaide Utd,4668,5,11,6,11,37,40,-3,39
Brisbane,4668,6,10,5,13,33,42,-9,35
Western Sydn,4668,7,8,9,10,38,47,-9,33
Perth Glory,4668,8,10,2,15,37,50,-13,32
Wellington P,4668,9,5,6,16,31,55,-24,21
CC Mariners,4668,10,4,8,15,28,49,-21,20
Sydney FC,4669,1,21,4,3,67,23,44,67
N'castle Jet,4669,2,15,6,7,58,38,20,51
Melbourne C,4669,3,14,5,10,44,34,10,47
Melbourne V,4669,4,13,5,11,46,41,5,44
Adelaide Utd,4669,5,11,6,11,37,40,-3,39
Brisbane,4669,6,10,5,13,33,42,-9,35
Western Sydn,4669,7,8,9,10,38,47,-9,33
Perth Glory,4669,8,10,2,15,37,50,-13,32
Wellington P,4669,9,5,6,16,31,55,-24,21
CC Mariners,4669,10,4,8,15,28,49,-21,20
Sydney FC,4670,1,21,4,3,67,23,44,67
N'castle Jet,4670,2,16,5,7,59,38,21,53
Melbourne C,4670,3,14,4,11,44,35,9,46
Melbourne V,4670,4,13,5,11,46,41,5,44
Adelaide Utd,4670,5,11,6,11,37,40,-3,39
Brisbane,4670,6,10,5,13,33,42,-9,35
Western Sydn,4670,7,8,9,10,38,47,-9,33
Perth Glory,4670,8,10,2,15,37,50,-13,32
Wellington P,4670,9,5,6,16,31,55,-24,21
CC Mariners,4670,10,4,8,15,28,49,-21,20
Sydney FC,4671,1,21,4,3,69,24,45,67
N'castle Jet,4671,2,16,5,7,61,38,23,53
Melbourne C,4671,3,14,4,11,44,37,7,46
Melbourne V,4671,4,13,5,11,47,43,4,44
Adelaide Utd,4671,5,11,6,11,37,40,-3,39
Brisbane,4671,6,10,5,13,33,42,-9,35
Western Sydn,4671,7,8,9,10,38,47,-9,33
Perth Glory,4671,8,10,2,15,37,50,-13,32
Wellington P,4671,9,5,6,16,31,55,-24,21
CC Mariners,4671,10,4,8,15,28,49,-21,20
Sydney FC,4672,1,21,4,3,67,22,45,67
N'castle Jet,4672,2,15,6,7,58,38,20,51
Melbourne C,4672,3,14,5,10,44,34,10,47
Melbourne V,4672,4,13,5,11,45,41,4,44
Adelaide Utd,4672,5,11,6,11,37,40,-3,39
Brisbane,4672,6,10,5,13,33,42,-9,35
Western Sydn,4672,7,8,9,10,38,47,-9,33
Perth Glory,4672,8,10,2,15,37,50,-13,32
Wellington P,4672,9,5,6,16,31,55,-24,21
CC Mariners,4672,10,4,8,15,28,49,-21,20
Sydney FC,4673,1,21,4,3,66,23,43,67
N'castle Jet,4673,2,15,6,7,57,37,20,51
Melbourne C,4673,3,14,5,10,43,33,10,47
Melbourne V,4673,4,13,5,11,46,40,6,44
Adelaide Utd,4673,5,11,6,11,37,40,-3,39
Brisbane,4673,6,10,5,13,33,42,-9,35
Western Sydn,4673,7,8,9,10,38,47,-9,33
Perth Glory,4673,8,10,2,15,37,50,-13,32
Wellington P,4673,9,5,6,16,31,55,-24,21
CC Mariners,4673,10,4,8,15,28,49,-21,20
Sydney FC,4674,1,21,4,3,66,22,44,67
N'castle Jet,4674,2,15,5,8,58,39,19,50
Melbourne C,4674,3,15,4,10,45,34,11,49
Melbourne V,4674,4,13,5,11,45,40,5,44
Adelaide Utd,4674,5,11,6,11,37,40,-3,39
Brisbane,4674,6,10,5,13,33,42,-9,35
Western Sydn,4674,7,8,9,10,38,47,-9,33
Perth Glory,4674,8,10,2,15,37,50,-13,32
Wellington P,4674,9,5,6,16,31,55,-24,21
CC Mariners,4674,10,4,8,15,28,49,-21,20
Sydney FC,4675,1,20,4,4,65,25,40,64
N'castle Jet,4675,2,16,5,7,60,39,21,53
Melbourne V,4675,3,14,5,10,48,39,9,47
Melbourne C,4675,4,14,4,11,45,36,9,46
Adelaide Utd,4675,5,11,6,11,37,40,-3,39
Brisbane,4675,6,10,5,13,33,42,-9,35
Western Sydn,4675,7,8,9,10,38,47,-9,33
Perth Glory,4675,8,10,2,15,37,50,-13,32
Wellington P,4675,9,5,6,16,31,55,-24,21
CC Mariners,4675,10,4,8,15,28,49,-21,20
Sydney FC,4676,1,21,4,3,65,22,43,67
N'castle Jet,4676,2,16,5,7,58,37,21,53
Melbourne C,4676,3,14,4,11,43,34,9,46
Melbourne V,4676,4,13,5,11,45,39,6,44
Adelaide Utd,4676,5,11,6,11,37,40,-3,39
Brisbane,4676,6,10,5,13,33,42,-9,35
Western Sydn,4676,7,8,9,10,38,47,-9,33
Perth Glory,4676,8,10,2,15,37,50,-13,32
Wellington P,4676,9,5,6,16,31,55,-24,21
CC Mariners,4676,10,4,8,15,28,49,-21,20
Sydney FC,4677,1,21,4,3,66,22,44,67
N'castle Jet,4677,2,15,6,7,58,38,20,51
Melbourne C,4677,3,14,5,10,44,34,10,47
Melbourne V,4677,4,13,5,11,45,40,5,44
Adelaide Utd,4677,5,11,6,11,37,40,-3,39
Brisbane,4677,6,10,5,13,33,42,-9,35
Western Sydn,4677,7,8,9,10,38,47,-9,33
Perth Glory,4677,8,10,2,15,37,50,-13,32
Wellington P,4677,9,5,6,16,31,55,-24,21
CC Mariners,4677,10,4,8,15,28,49,-21,20
Sydney FC,4678,1,21,4,3,68,22,46,67
N'castle Jet,4678,2,16,5,7,58,37,21,53
Melbourne C,4678,3,14,4,11,43,34,9,46
Melbourne V,4678,4,13,5,11,45,42,3,44
Adelaide Utd,4678,5,11,6,11,37,40,-3,39
Brisbane,4678,6,10,5,13,33,42,-9,35
Western Sydn,4678,7,8,9,10,38,47,-9,33
Perth Glory,4678,8,10,2,15,37,50,-13,32
Wellington P,4678,9,5,6,16,31,55,-24,21
CC Mariners,4678,10,4,8,15,28,49,-21,20
Sydney FC,4679,1,20,4,4,64,23,41,64
N'castle Jet,4679,2,16,5,7,59,38,21,53
Melbourne V,4679,3,14,5,10,46,38,8,47
Melbourne C,4679,4,14,4,11,44,35,9,46
Adelaide Utd,4679,5,11,6,11,37,40,-3,39
Brisbane,4679,6,10,5,13,33,42,-9,35
Western Sydn,4679,7,8,9,10,38,47,-9,33
Perth Glory,4679,8,10,2,15,37,50,-13,32
Wellington P,4679,9,5,6,16,31,55,-24,21
CC Mariners,4679,10,4,8,15,28,49,-21,20
Sydney FC,4680,1,21,4,3,65,22,43,67
N'castle Jet,4680,2,16,5,7,61,39,22,53
Melbourne C,4680,3,14,4,11,45,37,8,46
Melbourne V,4680,4,13,5,11,45,39,6,44
Adelaide Utd,4680,5,11,6,11,37,40,-3,39
Brisbane,4680,6,10,5,13,33,42,-9,35
Western Sydn,4680,7,8,9,10,38,47,-9,33
Perth Glory,4680,8,10,2,15,37,50,-13,32
Wellington P,4680,9,5,6,16,31,55,-24,21
CC Mariners,4680,10,4,8,15,28,49,-21,20
Sydney FC,4681,1,21,4,3,67,22,45,67
N'castle Jet,4681,2,16,5,7,60,37,23,53
Melbourne C,4681,3,14,4,11,43,36,7,46
Melbourne V,4681,4,13,5,11,45,41,4,44
Adelaide Utd,4681,5,11,6,11,37,40,-3,39
Brisbane,4681,6,10,5,13,33,42,-9,35
Western Sydn,4681,7,8,9,10,38,47,-9,33
Perth Glory,4681,8,10,2,15,37,50,-13,32
Wellington P,4681,9,5,6,16,31,55,-24,21
CC Mariners,4681,10,4,8,15,28,49,-21,20
Sydney FC,4682,1,20,4,4,65,24,41,64
N'castle Jet,4682,2,16,5,7,60,38,22,53
Melbourne V,4682,3,14,5,10,47,39,8,47
Melbourne C,4682,4,14,4,11,44,36,8,46
Adelaide Utd,4682,5,11,6,11,37,40,-3,39
Brisbane,4682,6,10,5,13,33,42,-9,35
Western Sydn,4682,7,8,9,10,38,47,-9,33
Perth Glory,4682,8,10,2,15,37,50,-13,32
Wellington P,4682,9,5,6,16,31,55,-24,21
CC Mariners,4682,10,4,8,15,28,49,-21,20
Sydney FC,4683,1,21,4,3,66,22,44,67
N'castle Jet,4683,2,15,6,7,58,38,20,51
Melbourne C,4683,3,14,5,10,44,34,10,47
Melbourne V,4683,4,13,5,11,45,40,5,44
Adelaide Utd,4683,5,11,6,11,37,40,-3,39
Brisbane,4683,6,10,5,13,33,42,-9,35
Western Sydn,4683,7,8,9,10,38,47,-9,33
Perth Glory,4683,8,10,2,15,37,50,-13,32
Wellington P,4683,9,5,6,16,31,55,-24,21
CC Mariners,4683,10,4,8,15,28,49,-21,20
Sydney FC,4684,1,21,4,3,69,24,45,67
N'castle Jet,4684,2,16,5,7,58,37,21,53
Melbourne C,4684,3,14,4,11,43,34,9,46
Melbourne V,4684,4,13,5,11,47,43,4,44
Adelaide Utd,4684,5,11,6,11,37,40,-3,39
Brisbane,4684,6,10,5,13,33,42,-9,35
Western Sydn,4684,7,8,9,10,38,47,-9,33
Perth Glory,4684,8,10,2,15,37,50,-13,32
Wellington P,4684,9,5,6,16,31,55,-24,21
CC Mariners,4684,10,4,8,15,28,49,-21,20
Sydney FC,4685,1,20,5,3,66,24,42,65
N'castle Jet,4685,2,15,5,8,57,39,18,50
Melbourne C,4685,3,15,4,10,45,33,12,49
Melbourne V,4685,4,13,6,10,47,40,7,45
Adelaide Utd,4685,5,11,6,11,37,40,-3,39
Brisbane,4685,6,10,5,13,33,42,-9,35
Western Sydn,4685,7,8,9,10,38,47,-9,33
Perth Glory,4685,8,10,2,15,37,50,-13,32
Wellington P,4685,9,5,6,16,31,55,-24,21
CC Mariners,4685,10,4,8,15,28,49,-21,20
Sydney FC,4686,1,21,4,3,68,22,46,67
N'castle Jet,4686,2,15,5,8,57,40,17,50
Melbourne C,4686,3,15,4,10,46,33,13,49
Melbourne V,4686,4,13,5,11,45,42,3,44
Adelaide Utd,4686,5,11,6,11,37,40,-3,39
Brisbane,4686,6,10,5,13,33,42,-9,35
Western Sydn,4686,7,8,9,10,38,47,-9,33
Perth Glory,4686,8,10,2,15,37,50,-13,32
Wellington P,4686,9,5,6,16,31,55,-24,21
CC Mariners,4686,10,4,8,15,28,49,-21,20
Sydney FC,4687,1,21,4,3,66,22,44,67
N'castle Jet,4687,2,15,5,8,57,38,19,50
Melbourne C,4687,3,15,4,10,44,33,11,49
Melbourne V,4687,4,13,5,11,45,40,5,44
Adelaide Utd,4687,5,11,6,11,37,40,-3,39
Brisbane,4687,6,10,5,13,33,42,-9,35
Western Sydn,4687,7,8,9,10,38,47,-9,33
Perth Glory,4687,8,10,2,15,37,50,-13,32
Wellington P,4687,9,5,6,16,31,55,-24,21
CC Mariners,4687,10,4,8,15,28,49,-21,20
Sydney FC,4688,1,21,4,3,68,22,46,67
N'castle Jet,4688,2,15,5,8,59,42,17,50
Melbourne C,4688,3,15,4,10,48,35,13,49
Melbourne V,4688,4,13,5,11,45,42,3,44
Adelaide Utd,4688,5,11,6,11,37,40,-3,39
Brisbane,4688,6,10,5,13,33,42,-9,35
Western Sydn,4688,7,8,9,10,38,47,-9,33
Perth Glory,4688,8,10,2,15,37,50,-13,32
Wellington P,4688,9,5,6,16,31,55,-24,21
CC Mariners,4688,10,4,8,15,28,49,-21,20
Sydney FC,4689,1,21,4,3,65,22,43,67
N'castle Jet,4689,2,16,5,7,61,38,23,53
Melbourne C,4689,3,14,4,11,44,37,7,46
Melbourne V,4689,4,13,5,11,45,39,6,44
Adelaide Utd,4689,5,11,6,11,37,40,-3,39
Brisbane,4689,6,10,5,13,33,42,-9,35
Western Sydn,4689,7,8,9,10,38,47,-9,33
Perth Glory,4689,8,10,2,15,37,50,-13,32
Wellington P,4689,9,5,6,16,31,55,-24,21
CC Mariners,4689,10,4,8,15,28,49,-21,20
Sydney FC,4690,1,21,4,3,65,22,43,67
N'castle Jet,4690,2,16,5,7,59,37,22,53
Melbourne C,4690,3,14,4,11,43,35,8,46
Melbourne V,4690,4,13,5,11,45,39,6,44
Adelaide Utd,4690,5,11,6,11,37,40,-3,39
Brisbane,4690,6,10,5,13,33,42,-9,35
Western Sydn,4690,7,8,9,10,38,47,-9,33
Perth Glory,4690,8,10,2,15,37,50,-13,32
Wellington P,4690,9,5,6,16,31,55,-24,21
CC Mariners,4690,10,4,8,15,28,49,-21,20
Sydney FC,4691,1,21,4,3,66,23,43,67
N'castle Jet,4691,2,15,5,8,58,43,15,50
Melbourne C,4691,3,15,4,10,49,34,15,49
Melbourne V,4691,4,13,5,11,46,40,6,44
Adelaide Utd,4691,5,11,6,11,37,40,-3,39
Brisbane,4691,6,10,5,13,33,42,-9,35
Western Sydn,4691,7,8,9,10,38,47,-9,33
Perth Glory,4691,8,10,2,15,37,50,-13,32
Wellington P,4691,9,5,6,16,31,55,-24,21
CC Mariners,4691,10,4,8,15,28,49,-21,20
Sydney FC,4692,1,20,5,3,65,23,42,65
N'castle Jet,4692,2,16,5,7,63,38,25,53
Melbourne C,4692,3,14,4,11,44,39,5,46
Melbourne V,4692,4,13,6,10,46,39,7,45
Adelaide Utd,4692,5,11,6,11,37,40,-3,39
Brisbane,4692,6,10,5,13,33,42,-9,35
Western Sydn,4692,7,8,9,10,38,47,-9,33
Perth Glory,4692,8,10,2,15,37,50,-13,32
Wellington P,4692,9,5,6,16,31,55,-24,21
CC Mariners,4692,10,4,8,15,28,49,-21,20
Sydney FC,4693,1,21,4,3,67,23,44,67
N'castle Jet,4693,2,16,5,7,58,37,21,53
Melbourne C,4693,3,14,4,11,43,34,9,46
Melbourne V,4693,4,13,5,11,46,41,5,44
Adelaide Utd,4693,5,11,6,11,37,40,-3,39
Brisbane,4693,6,10,5,13,33,42,-9,35
Western Sydn,4693,7,8,9,10,38,47,-9,33
Perth Glory,4693,8,10,2,15,37,50,-13,32
Wellington P,4693,9,5,6,16,31,55,-24,21
CC Mariners,4693,10,4,8,15,28,49,-21,20
Sydney FC,4694,1,20,5,3,66,24,42,65
N'castle Jet,4694,2,15,6,7,57,37,20,51
Melbourne C,4694,3,14,5,10,43,33,10,47
Melbourne V,4694,4,13,6,10,47,40,7,45
Adelaide Utd,4694,5,11,6,11,37,40,-3,39
Brisbane,4694,6,10,5,13,33,42,-9,35
Western Sydn,4694,7,8,9,10,38,47,-9,33
Perth Glory,4694,8,10,2,15,37,50,-13,32
Wellington P,4694,9,5,6,16,31,55,-24,21
CC Mariners,4694,10,4,8,15,28,49,-21,20
Sydney FC,4695,1,20,5,3,64,22,42,65
N'castle Jet,4695,2,15,6,7,59,39,20,51
Melbourne C,4695,3,14,5,10,45,35,10,47
Melbourne V,4695,4,13,6,10,45,38,7,45
Adelaide Utd,4695,5,11,6,11,37,40,-3,39
Brisbane,4695,6,10,5,13,33,42,-9,35
Western Sydn,4695,7,8,9,10,38,47,-9,33
Perth Glory,4695,8,10,2,15,37,50,-13,32
Wellington P,4695,9,5,6,16,31,55,-24,21
CC Mariners,4695,10,4,8,15,28,49,-21,20
Sydney FC,4696,1,21,4,3,67,23,44,67
N'castle Jet,4696,2,15,5,8,57,38,19,50
Melbourne C,4696,3,15,4,10,44,33,11,49
Melbourne V,4696,4,13,5,11,46,41,5,44
Adelaide Utd,4696,5,11,6,11,37,40,-3,39
Brisbane,4696,6,10,5,13,33,42,-9,35
Western Sydn,4696,7,8,9,10,38,47,-9,33
Perth Glory,4696,8,10,2,15,37,50,-13,32
Wellington P,4696,9,5,6,16,31,55,-24,21
CC Mariners,4696,10,4,8,15,28,49,-21,20
Sydney FC,4697,1,21,4,3,67,24,43,67
N'castle Jet,4697,2,16,5,7,59,38,21,53
Melbourne C,4697,3,14,4,11,44,35,9,46
Melbourne V,4697,4,13,5,11,47,41,6,44
Adelaide Utd,4697,5,11,6,11,37,40,-3,39
Brisbane,4697,6,10,5,13,33,42,-9,35
Western Sydn,4697,7,8,9,10,38,47,-9,33
Perth Glory,4697,8,10,2,15,37,50,-13,32
Wellington P,4697,9,5,6,16,31,55,-24,21
CC Mariners,4697,10,4,8,15,28,49,-21,20
Sydney FC,4698,1,21,4,3,67,23,44,67
N'castle Jet,4698,2,16,5,7,59,38,21,53
Melbourne C,4698,3,14,4,11,44,35,9,46
Melbourne V,4698,4,13,5,11,46,41,5,44
Adelaide Utd,4698,5,11,6,11,37,40,-3,39
Brisbane,4698,6,10,5,13,33,42,-9,35
Western Sydn,4698,7,8,9,10,38,47,-9,33
Perth Glory,4698,8,10,2,15,37,50,-13,32
Wellington P,4698,9,5,6,16,31,55,-24,21
CC Mariners,4698,10,4,8,15,28,49,-21,20
Sydney FC,4699,1,21,4,3,68,22,46,67
N'castle Jet,4699,2,15,5,8,58,39,19,50
Melbourne C,4699,3,15,4,10,45,34,11,49
Melbourne V,4699,4,13,5,11,45,42,3,44
Adelaide Utd,4699,5,11,6,11,37,40,-3,39
Brisbane,4699,6,10,5,13,33,42,-9,35
Western Sydn,4699,7,8,9,10,38,47,-9,33
Perth Glory,4699,8,10,2,15,37,50,-13,32
Wellington P,4699,9,5,6,16,31,55,-24,21
CC Mariners,4699,10,4,8,15,28,49,-21,20
Sydney FC,4700,1,20,4,4,64,23,41,64
N'castle Jet,4700,2,15,5,8,59,40,19,50
Melbourne C,4700,3,15,4,10,46,35,11,49
Melbourne V,4700,4,14,5,10,46,38,8,47
Adelaide Utd,4700,5,11,6,11,37,40,-3,39
Brisbane,4700,6,10,5,13,33,42,-9,35
Western Sydn,4700,7,8,9,10,38,47,-9,33
Perth Glory,4700,8,10,2,15,37,50,-13,32
Wellington P,4700,9,5,6,16,31,55,-24,21
CC Mariners,4700,10,4,8,15,28,49,-21,20
Sydney FC,4701,1,21,4,3,68,22,46,67
N'castle Jet,4701,2,15,5,8,58,39,19,50
Melbourne C,4701,3,15,4,10,45,34,11,49
Melbourne V,4701,4,13,5,11,45,42,3,44
Adelaide Utd,4701,5,11,6,11,37,40,-3,39
Brisbane,4701,6,10,5,13,33,42,-9,35
Western Sydn,4701,7,8,9,10,38,47,-9,33
Perth Glory,4701,8,10,2,15,37,50,-13,32
Wellington P,4701,9,5,6,16,31,55,-24,21
CC Mariners,4701,10,4,8,15,28,49,-21,20
Sydney FC,4702,1,21,4,3,68,23,45,67
N'castle Jet,4702,2,16,5,7,59,37,22,53
Melbourne C,4702,3,14,4,11,43,35,8,46
Melbourne V,4702,4,13,5,11,46,42,4,44
Adelaide Utd,4702,5,11,6,11,37,40,-3,39
Brisbane,4702,6,10,5,13,33,42,-9,35
Western Sydn,4702,7,8,9,10,38,47,-9,33
Perth Glory,4702,8,10,2,15,37,50,-13,32
Wellington P,4702,9,5,6,16,31,55,-24,21
CC Mariners,4702,10,4,8,15,28,49,-21,20
Sydney FC,4703,1,21,4,3,68,22,46,67
N'castle Jet,4703,2,16,5,7,59,38,21,53
Melbourne C,4703,3,14,4,11,44,35,9,46
Melbourne V,4703,4,13,5,11,45,42,3,44
Adelaide Utd,4703,5,11,6,11,37,40,-3,39
Brisbane,4703,6,10,5,13,33,42,-9,35
Western Sydn,4703,7,8,9,10,38,47,-9,33
Perth Glory,4703,8,10,2,15,37,50,-13,32
Wellington P,4703,9,5,6,16,31,55,-24,21
CC Mariners,4703,10,4,8,15,28,49,-21,20
Sydney FC,4704,1,20,4,4,64,23,41,64
N'castle Jet,4704,2,15,6,7,58,38,20,51
Melbourne C,4704,3,14,5,10,44,34,10,47
Melbourne V,4704,4,14,5,10,46,38,8,47
Adelaide Utd,4704,5,11,6,11,37,40,-3,39
Brisbane,4704,6,10,5,13,33,42,-9,35
Western Sydn,4704,7,8,9,10,38,47,-9,33
Perth Glory,4704,8,10,2,15,37,50,-13,32
Wellington P,4704,9,5,6,16,31,55,-24,21
CC Mariners,4704,10,4,8,15,28,49,-21,20
Sydney FC,4705,1,20,4,4,64,24,40,64
N'castle Jet,4705,2,15,5,8,57,39,18,50
Melbourne C,4705,3,15,4,10,45,33,12,49
Melbourne V,4705,4,14,5,10,47,38,9,47
Adelaide Utd,4705,5,11,6,11,37,40,-3,39
Brisbane,4705,6,10,5,13,33,42,-9,35
Western Sydn,4705,7,8,9,10,38,47,-9,33
Perth Glory,4705,8,10,2,15,37,50,-13,32
Wellington P,4705,9,5,6,16,31,55,-24,21
CC Mariners,4705,10,4,8,15,28,49,-21,20
Sydney FC,4706,1,20,5,3,65,23,42,65
N'castle Jet,4706,2,16,5,7,58,37,21,53
Melbourne C,4706,3,14,4,11,43,34,9,46
Melbourne V,4706,4,13,6,10,46,39,7,45
Adelaide Utd,4706,5,11,6,11,37,40,-3,39
Brisbane,4706,6,10,5,13,33,42,-9,35
Western Sydn,4706,7,8,9,10,38,47,-9,33
Perth Glory,4706,8,10,2,15,37,50,-13,32
Wellington P,4706,9,5,6,16,31,55,-24,21
CC Mariners,4706,10,4,8,15,28,49,-21,20
Sydney FC,4707,1,21,4,3,66,22,44,67
N'castle Jet,4707,2,15,6,7,58,38,20,51
Melbourne C,4707,3,14,5,10,44,34,10,47
Melbourne V,4707,4,13,5,11,45,40,5,44
Adelaide Utd,4707,5,11,6,11,37,40,-3,39
Brisbane,4707,6,10,5,13,33,42,-9,35
Western Sydn,4707,7,8,9,10,38,47,-9,33
Perth Glory,4707,8,10,2,15,37,50,-13,32
Wellington P,4707,9,5,6,16,31,55,-24,21
CC Mariners,4707,10,4,8,15,28,49,-21,20
Sydney FC,4708,1,21,4,3,68,22,46,67
N'castle Jet,4708,2,15,6,7,60,40,20,51
Melbourne C,4708,3,14,5,10,46,36,10,47
Melbourne V,4708,4,13,5,11,45,42,3,44
Adelaide Utd,4708,5,11,6,11,37,40,-3,39
Brisbane,4708,6,10,5,13,33,42,-9,35
Western Sydn,4708,7,8,9,10,38,47,-9,33
Perth Glory,4708,8,10,2,15,37,50,-13,32
Wellington P,4708,9,5,6,16,31,55,-24,21
CC Mariners,4708,10,4,8,15,28,49,-21,20
Sydney FC,4709,1,21,4,3,66,22,44,67
N'castle Jet,4709,2,16,5,7,59,38,21,53
Melbourne C,4709,3,14,4,11,44,35,9,46
Melbourne V,4709,4,13,5,11,45,40,5,44
Adelaide Utd,4709,5,11,6,11,37,40,-3,39
Brisbane,4709,6,10,5,13,33,42,-9,35
Western Sydn,4709,7,8,9,10,38,47,-9,33
Perth Glory,4709,8,10,2,15,37,50,-13,32
Wellington P,4709,9,5,6,16,31,55,-24,21
CC Mariners,4709,10,4,8,15,28,49,-21,20
Sydney FC,4710,1,21,4,3,65,22,43,67
N'castle Jet,4710,2,15,5,8,58,39,19,50
Melbourne C,4710,3,15,4,10,45,34,11,49
Melbourne V,4710,4,13,5,11,45,39,6,44
Adelaide Utd,4710,5,11,6,11,37,40,-3,39
Brisbane,4710,6,10,5,13,33,42,-9,35
Western Sydn,4710,7,8,9,10,38,47,-9,33
Perth Glory,4710,8,10,2,15,37,50,-13,32
Wellington P,4710,9,5,6,16,31,55,-24,21
CC Mariners,4710,10,4,8,15,28,49,-21,20
Sydney FC,4711,1,21,4,3,68,23,45,67
N'castle Jet,4711,2,16,5,7,59,38,21,53
Melbourne C,4711,3,14,4,11,44,35,9,46
Melbourne V,4711,4,13,5,11,46,42,4,44
Adelaide Utd,4711,5,11,6,11,37,40,-3,39
Brisbane,4711,6,10,5,13,33,42,-9,35
Western Sydn,4711,7,8,9,10,38,47,-9,33
Perth Glory,4711,8,10,2,15,37,50,-13,32
Wellington P,4711,9,5,6,16,31,55,-24,21
CC Mariners,4711,10,4,8,15,28,49,-21,20
Sydney FC,4712,1,20,4,4,68,27,41,64
N'castle Jet,4712,2,16,5,7,60,38,22,53
Melbourne V,4712,3,14,5,10,50,42,8,47
Melbourne C,4712,4,14,4,11,44,36,8,46
Adelaide Utd,4712,5,11,6,11,37,40,-3,39
Brisbane,4712,6,10,5,13,33,42,-9,35
Western Sydn,4712,7,8,9,10,38,47,-9,33
Perth Glory,4712,8,10,2,15,37,50,-13,32
Wellington P,4712,9,5,6,16,31,55,-24,21
CC Mariners,4712,10,4,8,15,28,49,-21,20
Sydney FC,4713,1,20,5,3,64,22,42,65
N'castle Jet,4713,2,15,6,7,59,39,20,51
Melbourne C,4713,3,14,5,10,45,35,10,47
Melbourne V,4713,4,13,6,10,45,38,7,45
Adelaide Utd,4713,5,11,6,11,37,40,-3,39
Brisbane,4713,6,10,5,13,33,42,-9,35
Western Sydn,4713,7,8,9,10,38,47,-9,33
Perth Glory,4713,8,10,2,15,37,50,-13,32
Wellington P,4713,9,5,6,16,31,55,-24,21
CC Mariners,4713,10,4,8,15,28,49,-21,20
Sydney FC,4714,1,20,5,3,64,22,42,65
N'castle Jet,4714,2,15,5,8,57,38,19,50
Melbourne C,4714,3,15,4,10,44,33,11,49
Melbourne V,4714,4,13,6,10,45,38,7,45
Adelaide Utd,4714,5,11,6,11,37,40,-3,39
Brisbane,4714,6,10,5,13,33,42,-9,35
Western Sydn,4714,7,8,9,10,38,47,-9,33
Perth Glory,4714,8,10,2,15,37,50,-13,32
Wellington P,4714,9,5,6,16,31,55,-24,21
CC Mariners,4714,10,4,8,15,28,49,-21,20
Sydney FC,4715,1,21,4,3,66,22,44,67
N'castle Jet,4715,2,15,6,7,60,40,20,51
Melbourne C,4715,3,14,5,10,46,36,10,47
Melbourne V,4715,4,13,5,11,45,40,5,44
Adelaide Utd,4715,5,11,6,11,37,40,-3,39
Brisbane,4715,6,10,5,13,33,42,-9,35
Western Sydn,4715,7,8,9,10,38,47,-9,33
Perth Glory,4715,8,10,2,15,37,50,-13,32
Wellington P,4715,9,5,6,16,31,55,-24,21
CC Mariners,4715,10,4,8,15,28,49,-21,20
Sydney FC,4716,1,21,4,3,65,22,43,67
N'castle Jet,4716,2,15,5,8,57,38,19,50
Melbourne C,4716,3,15,4,10,44,33,11,49
Melbourne V,4716,4,13,5,11,45,39,6,44
Adelaide Utd,4716,5,11,6,11,37,40,-3,39
Brisbane,4716,6,10,5,13,33,42,-9,35
Western Sydn,4716,7,8,9,10,38,47,-9,33
Perth Glory,4716,8,10,2,15,37,50,-13,32
Wellington P,4716,9,5,6,16,31,55,-24,21
CC Mariners,4716,10,4,8,15,28,49,-21,20
Sydney FC,4717,1,21,4,3,69,23,46,67
N'castle Jet,4717,2,16,5,7,59,38,21,53
Melbourne C,4717,3,14,4,11,44,35,9,46
Melbourne V,4717,4,13,5,11,46,43,3,44
Adelaide Utd,4717,5,11,6,11,37,40,-3,39
Brisbane,4717,6,10,5,13,33,42,-9,35
Western Sydn,4717,7,8,9,10,38,47,-9,33
Perth Glory,4717,8,10,2,15,37,50,-13,32
Wellington P,4717,9,5,6,16,31,55,-24,21
CC Mariners,4717,10,4,8,15,28,49,-21,20
Sydney FC,4718,1,21,4,3,67,23,44,67
N'castle Jet,4718,2,15,5,8,57,38,19,50
Melbourne C,4718,3,15,4,10,44,33,11,49
Melbourne V,4718,4,13,5,11,46,41,5,44
Adelaide Utd,4718,5,11,6,11,37,40,-3,39
Brisbane,4718,6,10,5,13,33,42,-9,35
Western Sydn,4718,7,8,9,10,38,47,-9,33
Perth Glory,4718,8,10,2,15,37,50,-13,32
Wellington P,4718,9,5,6,16,31,55,-24,21
CC Mariners,4718,10,4,8,15,28,49,-21,20
Sydney FC,4719,1,20,5,3,65,23,42,65
N'castle Jet,4719,2,15,6,7,58,38,20,51
Melbourne C,4719,3,14,5,10,44,34,10,47
Melbourne V,4719,4,13,6,10,46,39,7,45
Adelaide Utd,4719,5,11,6,11,37,40,-3,39
Brisbane,4719,6,10,5,13,33,42,-9,35
Western Sydn,4719,7,8,9,10,38,47,-9,33
Perth Glory,4719,8,10,2,15,37,50,-13,32
Wellington P,4719,9,5,6,16,31,55,-24,21
CC Mariners,4719,10,4,8,15,28,49,-21,20
Sydney FC,4720,1,20,5,3,66,24,42,65
N'castle Jet,4720,2,15,6,7,59,39,20,51
Melbourne C,4720,3,14,5,10,45,35,10,47
Melbourne V,4720,4,13,6,10,47,40,7,45
Adelaide Utd,4720,5,11,6,11,37,40,-3,39
Brisbane,4720,6,10,5,13,33,42,-9,35
Western Sydn,4720,7,8,9,10,38,47,-9,33
Perth Glory,4720,8,10,2,15,37,50,-13,32
Wellington P,4720,9,5,6,16,31,55,-24,21
CC Mariners,4720,10,4,8,15,28,49,-21,20
Sydney FC,4721,1,21,4,3,66,23,43,67
N'castle Jet,4721,2,16,5,7,60,38,22,53
Melbourne C,4721,3,14,4,11,44,36,8,46
Melbourne V,4721,4,13,5,11,46,40,6,44
Adelaide Utd,4721,5,11,6,11,37,40,-3,39
Brisbane,4721,6,10,5,13,33,42,-9,35
Western Sydn,4721,7,8,9,10,38,47,-9,33
Perth Glory,4721,8,10,2,15,37,50,-13,32
Wellington P,4721,9,5,6,16,31,55,-24,21
CC Mariners,4721,10,4,8,15,28,49,-21,20
Sydney FC,4722,1,21,4,3,67,24,43,67
N'castle Jet,4722,2,15,6,7,57,37,20,51
Melbourne C,4722,3,14,5,10,43,33,10,47
Melbourne V,4722,4,13,5,11,47,41,6,44
Adelaide Utd,4722,5,11,6,11,37,40,-3,39
Brisbane,4722,6,10,5,13,33,42,-9,35
Western Sydn,4722,7,8,9,10,38,47,-9,33
Perth Glory,4722,8,10,2,15,37,50,-13,32
Wellington P,4722,9,5,6,16,31,55,-24,21
CC Mariners,4722,10,4,8,15,28,49,-21,20
Sydney FC,4723,1,21,4,3,67,22,45,67
N'castle Jet,4723,2,16,5,7,60,38,22,53
Melbourne C,4723,3,14,4,11,44,36,8,46
Melbourne V,4723,4,13,5,11,45,41,4,44
Adelaide Utd,4723,5,11,6,11,37,40,-3,39
Brisbane,4723,6,10,5,13,33,42,-9,35
Western Sydn,4723,7,8,9,10,38,47,-9,33
Perth Glory,4723,8,10,2,15,37,50,-13,32
Wellington P,4723,9,5,6,16,31,55,-24,21
CC Mariners,4723,10,4,8,15,28,49,-21,20
Sydney FC,4724,1,21,4,3,66,23,43,67
N'castle Jet,4724,2,16,5,7,59,38,21,53
Melbourne C,4724,3,14,4,11,44,35,9,46
Melbourne V,4724,4,13,5,11,46,40,6,44
Adelaide Utd,4724,5,11,6,11,37,40,-3,39
Brisbane,4724,6,10,5,13,33,42,-9,35
Western Sydn,4724,7,8,9,10,38,47,-9,33
Perth Glory,4724,8,10,2,15,37,50,-13,32
Wellington P,4724,9,5,6,16,31,55,-24,21
CC Mariners,4724,10,4,8,15,28,49,-21,20
Sydney FC,4725,1,21,4,3,67,22,45,67
N'castle Jet,4725,2,16,5,7,61,38,23,53
Melbourne C,4725,3,14,4,11,44,37,7,46
Melbourne V,4725,4,13,5,11,45,41,4,44
Adelaide Utd,4725,5,11,6,11,37,40,-3,39
Brisbane,4725,6,10,5,13,33,42,-9,35
Western Sydn,4725,7,8,9,10,38,47,-9,33
Perth Glory,4725,8,10,2,15,37,50,-13,32
Wellington P,4725,9,5,6,16,31,55,-24,21
CC Mariners,4725,10,4,8,15,28,49,-21,20
Sydney FC,4726,1,21,4,3,67,22,45,67
N'castle Jet,4726,2,16,5,7,59,38,21,53
Melbourne C,4726,3,14,4,11,44,35,9,46
Melbourne V,4726,4,13,5,11,45,41,4,44
Adelaide Utd,4726,5,11,6,11,37,40,-3,39
Brisbane,4726,6,10,5,13,33,42,-9,35
Western Sydn,4726,7,8,9,10,38,47,-9,33
Perth Glory,4726,8,10,2,15,37,50,-13,32
Wellington P,4726,9,5,6,16,31,55,-24,21
CC Mariners,4726,10,4,8,15,28,49,-21,20
Sydney FC,4727,1,21,4,3,67,22,45,67
N'castle Jet,4727,2,16,5,7,61,39,22,53
Melbourne C,4727,3,14,4,11,45,37,8,46
Melbourne V,4727,4,13,5,11,45,41,4,44
Adelaide Utd,4727,5,11,6,11,37,40,-3,39
Brisbane,4727,6,10,5,13,33,42,-9,35
Western Sydn,4727,7,8,9,10,38,47,-9,33
Perth Glory,4727,8,10,2,15,37,50,-13,32
Wellington P,4727,9,5,6,16,31,55,-24,21
CC Mariners,4727,10,4,8,15,28,49,-21,20
Sydney FC,4728,1,20,4,4,65,25,40,64
N'castle Jet,4728,2,15,5,8,57,38,19,50
Melbourne C,4728,3,15,4,10,44,33,11,49
Melbourne V,4728,4,14,5,10,48,39,9,47
Adelaide Utd,4728,5,11,6,11,37,40,-3,39
Brisbane,4728,6,10,5,13,33,42,-9,35
Western Sydn,4728,7,8,9,10,38,47,-9,33
Perth Glory,4728,8,10,2,15,37,50,-13,32
Wellington P,4728,9,5,6,16,31,55,-24,21
CC Mariners,4728,10,4,8,15,28,49,-21,20
Sydney FC,4729,1,20,5,3,64,22,42,65
N'castle Jet,4729,2,15,6,7,58,38,20,51
Melbourne C,4729,3,14,5,10,44,34,10,47
Melbourne V,4729,4,13,6,10,45,38,7,45
Adelaide Utd,4729,5,11,6,11,37,40,-3,39
Brisbane,4729,6,10,5,13,33,42,-9,35
Western Sydn,4729,7,8,9,10,38,47,-9,33
Perth Glory,4729,8,10,2,15,37,50,-13,32
Wellington P,4729,9,5,6,16,31,55,-24,21
CC Mariners,4729,10,4,8,15,28,49,-21,20
Sydney FC,4730,1,20,4,4,64,24,40,64
N'castle Jet,4730,2,16,5,7,60,38,22,53
Melbourne V,4730,3,14,5,10,47,38,9,47
Melbourne C,4730,4,14,4,11,44,36,8,46
Adelaide Utd,4730,5,11,6,11,37,40,-3,39
Brisbane,4730,6,10,5,13,33,42,-9,35
Western Sydn,4730,7,8,9,10,38,47,-9,33
Perth Glory,4730,8,10,2,15,37,50,-13,32
Wellington P,4730,9,5,6,16,31,55,-24,21
CC Mariners,4730,10,4,8,15,28,49,-21,20
Sydney FC,4731,1,21,4,3,66,23,43,67
N'castle Jet,4731,2,16,5,7,61,38,23,53
Melbourne C,4731,3,14,4,11,44,37,7,46
Melbourne V,4731,4,13,5,11,46,40,6,44
Adelaide Utd,4731,5,11,6,11,37,40,-3,39
Brisbane,4731,6,10,5,13,33,42,-9,35
Western Sydn,4731,7,8,9,10,38,47,-9,33
Perth Glory,4731,8,10,2,15,37,50,-13,32
Wellington P,4731,9,5,6,16,31,55,-24,21
CC Mariners,4731,10,4,8,15,28,49,-21,20
Sydney FC,4732,1,20,5,3,65,23,42,65
N'castle Jet,4732,2,16,5,7,59,37,22,53
Melbourne C,4732,3,14,4,11,43,35,8,46
Melbourne V,4732,4,13,6,10,46,39,7,45
Adelaide Utd,4732,5,11,6,11,37,40,-3,39
Brisbane,4732,6,10,5,13,33,42,-9,35
Western Sydn,4732,7,8,9,10,38,47,-9,33
Perth Glory,4732,8,10,2,15,37,50,-13,32
Wellington P,4732,9,5,6,16,31,55,-24,21
CC Mariners,4732,10,4,8,15,28,49,-21,20
Sydney FC,4733,1,21,4,3,66,23,43,67
N'castle Jet,4733,2,16,5,7,60,39,21,53
Melbourne C,4733,3,14,4,11,45,36,9,46
Melbourne V,4733,4,13,5,11,46,40,6,44
Adelaide Utd,4733,5,11,6,11,37,40,-3,39
Brisbane,4733,6,10,5,13,33,42,-9,35
Western Sydn,4733,7,8,9,10,38,47,-9,33
Perth Glory,4733,8,10,2,15,37,50,-13,32
Wellington P,4733,9,5,6,16,31,55,-24,21
CC Mariners,4733,10,4,8,15,28,49,-21,20
Sydney FC,4734,1,21,4,3,65,22,43,67
N'castle Jet,4734,2,15,5,8,59,40,19,50
Melbourne C,4734,3,15,4,10,46,35,11,49
Melbourne V,4734,4,13,5,11,45,39,6,44
Adelaide Utd,4734,5,11,6,11,37,40,-3,39
Brisbane,4734,6,10,5,13,33,42,-9,35
Western Sydn,4734,7,8,9,10,38,47,-9,33
Perth Glory,4734,8,10,2,15,37,50,-13,32
Wellington P,4734,9,5,6,16,31,55,-24,21
CC Mariners,4734,10,4,8,15,28,49,-21,20
Sydney FC,4735,1,20,5,3,64,22,42,65
N'castle Jet,4735,2,16,5,7,59,38,21,53
Melbourne C,4735,3,14,4,11,44,35,9,46
Melbourne V,4735,4,13,6,10,45,38,7,45
Adelaide Utd,4735,5,11,6,11,37,40,-3,39
Brisbane,4735,6,10,5,13,33,42,-9,35
Western Sydn,4735,7,8,9,10,38,47,-9,33
Perth Glory,4735,8,10,2,15,37,50,-13,32
Wellington P,4735,9,5,6,16,31,55,-24,21
CC Mariners,4735,10,4,8,15,28,49,-21,20
Sydney FC,4736,1,21,4,3,69,24,45,67
N'castle Jet,4736,2,15,5,8,58,40,18,50
Melbourne C,4736,3,15,4,10,46,34,12,49
Melbourne V,4736,4,13,5,11,47,43,4,44
Adelaide Utd,4736,5,11,6,11,37,40,-3,39
Brisbane,4736,6,10,5,13,33,42,-9,35
Western Sydn,4736,7,8,9,10,38,47,-9,33
Perth Glory,4736,8,10,2,15,37,50,-13,32
Wellington P,4736,9,5,6,16,31,55,-24,21
CC Mariners,4736,10,4,8,15,28,49,-21,20
Sydney FC,4737,1,21,4,3,69,24,45,67
N'castle Jet,4737,2,16,5,7,61,37,24,53
Melbourne C,4737,3,14,4,11,43,37,6,46
Melbourne V,4737,4,13,5,11,47,43,4,44
Adelaide Utd,4737,5,11,6,11,37,40,-3,39
Brisbane,4737,6,10,5,13,33,42,-9,35
Western Sydn,4737,7,8,9,10,38,47,-9,33
Perth Glory,4737,8,10,2,15,37,50,-13,32
Wellington P,4737,9,5,6,16,31,55,-24,21
CC Mariners,4737,10,4,8,15,28,49,-21,20
Sydney FC,4738,1,20,5,3,66,24,42,65
N'castle Jet,4738,2,15,5,8,57,42,15,50
Melbourne C,4738,3,15,4,10,48,33,15,49
Melbourne V,4738,4,13,6,10,47,40,7,45
Adelaide Utd,4738,5,11,6,11,37,40,-3,39
Brisbane,4738,6,10,5,13,33,42,-9,35
Western Sydn,4738,7,8,9,10,38,47,-9,33
Perth Glory,4738,8,10,2,15,37,50,-13,32
Wellington P,4738,9,5,6,16,31,55,-24,21
CC Mariners,4738,10,4,8,15,28,49,-21,20
Sydney FC,4739,1,21,4,3,68,23,45,67
N'castle Jet,4739,2,15,5,8,58,39,19,50
Melbourne C,4739,3,15,4,10,45,34,11,49
Melbourne V,4739,4,13,5,11,46,42,4,44
Adelaide Utd,4739,5,11,6,11,37,40,-3,39
Brisbane,4739,6,10,5,13,33,42,-9,35
Western Sydn,4739,7,8,9,10,38,47,-9,33
Perth Glory,4739,8,10,2,15,37,50,-13,32
Wellington P,4739,9,5,6,16,31,55,-24,21
CC Mariners,4739,10,4,8,15,28,49,-21,20
Sydney FC,4740,1,21,4,3,69,23,46,67
N'castle Jet,4740,2,16,5,7,59,38,21,53
Melbourne C,4740,3,14,4,11,44,35,9,46
Melbourne V,4740,4,13,5,11,46,43,3,44
Adelaide Utd,4740,5,11,6,11,37,40,-3,39
Brisbane,4740,6,10,5,13,33,42,-9,35
Western Sydn,4740,7,8,9,10,38,47,-9,33
Perth Glory,4740,8,10,2,15,37,50,-13,32
Wellington P,4740,9,5,6,16,31,55,-24,21
CC Mariners,4740,10,4,8,15,28,49,-21,20
Sydney FC,4741,1,21,4,3,67,24,43,67
N'castle Jet,4741,2,15,6,7,59,39,20,51
Melbourne C,4741,3,14,5,10,45,35,10,47
Melbourne V,4741,4,13,5,11,47,41,6,44
Adelaide Utd,4741,5,11,6,11,37,40,-3,39
Brisbane,4741,6,10,5,13,33,42,-9,35
Western Sydn,4741,7,8,9,10,38,47,-9,33
Perth Glory,4741,8,10,2,15,37,50,-13,32
Wellington P,4741,9,5,6,16,31,55,-24,21
CC Mariners,4741,10,4,8,15,28,49,-21,20
Sydney FC,4742,1,20,4,4,64,23,41,64
N'castle Jet,4742,2,15,6,7,58,38,20,51
Melbourne C,4742,3,14,5,10,44,34,10,47
Melbourne V,4742,4,14,5,10,46,38,8,47
Adelaide Utd,4742,5,11,6,11,37,40,-3,39
Brisbane,4742,6,10,5,13,33,42,-9,35
Western Sydn,4742,7,8,9,10,38,47,-9,33
Perth Glory,4742,8,10,2,15,37,50,-13,32
Wellington P,4742,9,5,6,16,31,55,-24,21
CC Mariners,4742,10,4,8,15,28,49,-21,20
Sydney FC,4743,1,21,4,3,68,23,45,67
N'castle Jet,4743,2,16,5,7,61,37,24,53
Melbourne C,4743,3,14,4,11,43,37,6,46
Melbourne V,4743,4,13,5,11,46,42,4,44
Adelaide Utd,4743,5,11,6,11,37,40,-3,39
Brisbane,4743,6,10,5,13,33,42,-9,35
Western Sydn,4743,7,8,9,10,38,47,-9,33
Perth Glory,4743,8,10,2,15,37,50,-13,32
Wellington P,4743,9,5,6,16,31,55,-24,21
CC Mariners,4743,10,4,8,15,28,49,-21,20
Sydney FC,4744,1,21,4,3,68,22,46,67
N'castle Jet,4744,2,16,5,7,59,37,22,53
Melbourne C,4744,3,14,4,11,43,35,8,46
Melbourne V,4744,4,13,5,11,45,42,3,44
Adelaide Utd,4744,5,11,6,11,37,40,-3,39
Brisbane,4744,6,10,5,13,33,42,-9,35
Western Sydn,4744,7,8,9,10,38,47,-9,33
Perth Glory,4744,8,10,2,15,37,50,-13,32
Wellington P,4744,9,5,6,16,31,55,-24,21
CC Mariners,4744,10,4,8,15,28,49,-21,20
Sydney FC,4745,1,21,4,3,67,22,45,67
N'castle Jet,4745,2,16,5,7,59,37,22,53
Melbourne C,4745,3,14,4,11,43,35,8,46
Melbourne V,4745,4,13,5,11,45,41,4,44
Adelaide Utd,4745,5,11,6,11,37,40,-3,39
Brisbane,4745,6,10,5,13,33,42,-9,35
Western Sydn,4745,7,8,9,10,38,47,-9,33
Perth Glory,4745,8,10,2,15,37,50,-13,32
Wellington P,4745,9,5,6,16,31,55,-24,21
CC Mariners,4745,10,4,8,15,28,49,-21,20
Sydney FC,4746,1,21,4,3,68,25,43,67
N'castle Jet,4746,2,16,5,7,59,38,21,53
Melbourne C,4746,3,14,4,11,44,35,9,46
Melbourne V,4746,4,13,5,11,48,42,6,44
Adelaide Utd,4746,5,11,6,11,37,40,-3,39
Brisbane,4746,6,10,5,13,33,42,-9,35
Western Sydn,4746,7,8,9,10,38,47,-9,33
Perth Glory,4746,8,10,2,15,37,50,-13,32
Wellington P,4746,9,5,6,16,31,55,-24,21
CC Mariners,4746,10,4,8,15,28,49,-21,20
Sydney FC,4747,1,21,4,3,68,23,45,67
N'castle Jet,4747,2,16,5,7,59,37,22,53
Melbourne C,4747,3,14,4,11,43,35,8,46
Melbourne V,4747,4,13,5,11,46,42,4,44
Adelaide Utd,4747,5,11,6,11,37,40,-3,39
Brisbane,4747,6,10,5,13,33,42,-9,35
Western Sydn,4747,7,8,9,10,38,47,-9,33
Perth Glory,4747,8,10,2,15,37,50,-13,32
Wellington P,4747,9,5,6,16,31,55,-24,21
CC Mariners,4747,10,4,8,15,28,49,-21,20
Sydney FC,4748,1,21,4,3,67,22,45,67
N'castle Jet,4748,2,15,5,8,57,39,18,50
Melbourne C,4748,3,15,4,10,45,33,12,49
Melbourne V,4748,4,13,5,11,45,41,4,44
Adelaide Utd,4748,5,11,6,11,37,40,-3,39
Brisbane,4748,6,10,5,13,33,42,-9,35
Western Sydn,4748,7,8,9,10,38,47,-9,33
Perth Glory,4748,8,10,2,15,37,50,-13,32
Wellington P,4748,9,5,6,16,31,55,-24,21
CC Mariners,4748,10,4,8,15,28,49,-21,20
Sydney FC,4749,1,21,4,3,67,22,45,67
N'castle Jet,4749,2,15,6,7,58,38,20,51
Melbourne C,4749,3,14,5,10,44,34,10,47
Melbourne V,4749,4,13,5,11,45,41,4,44
Adelaide Utd,4749,5,11,6,11,37,40,-3,39
Brisbane,4749,6,10,5,13,33,42,-9,35
Western Sydn,4749,7,8,9,10,38,47,-9,33
Perth Glory,4749,8,10,2,15,37,50,-13,32
Wellington P,4749,9,5,6,16,31,55,-24,21
CC Mariners,4749,10,4,8,15,28,49,-21,20
Sydney FC,4750,1,20,5,3,66,24,42,65
N'castle Jet,4750,2,16,5,7,60,37,23,53
Melbourne C,4750,3,14,4,11,43,36,7,46
Melbourne V,4750,4,13,6,10,47,40,7,45
Adelaide Utd,4750,5,11,6,11,37,40,-3,39
Brisbane,4750,6,10,5,13,33,42,-9,35
Western Sydn,4750,7,8,9,10,38,47,-9,33
Perth Glory,4750,8,10,2,15,37,50,-13,32
Wellington P,4750,9,5,6,16,31,55,-24,21
CC Mariners,4750,10,4,8,15,28,49,-21,20
Sydney FC,4751,1,21,4,3,69,23,46,67
N'castle Jet,4751,2,16,5,7,60,38,22,53
Melbourne C,4751,3,14,4,11,44,36,8,46
Melbourne V,4751,4,13,5,11,46,43,3,44
Adelaide Utd,4751,5,11,6,11,37,40,-3,39
Brisbane,4751,6,10,5,13,33,42,-9,35
Western Sydn,4751,7,8,9,10,38,47,-9,33
Perth Glory,4751,8,10,2,15,37,50,-13,32
Wellington P,4751,9,5,6,16,31,55,-24,21
CC Mariners,4751,10,4,8,15,28,49,-21,20
Sydney FC,4752,1,21,4,3,66,22,44,67
N'castle Jet,4752,2,16,5,7,58,37,21,53
Melbourne C,4752,3,14,4,11,43,34,9,46
Melbourne V,4752,4,13,5,11,45,40,5,44
Adelaide Utd,4752,5,11,6,11,37,40,-3,39
Brisbane,4752,6,10,5,13,33,42,-9,35
Western Sydn,4752,7,8,9,10,38,47,-9,33
Perth Glory,4752,8,10,2,15,37,50,-13,32
Wellington P,4752,9,5,6,16,31,55,-24,21
CC Mariners,4752,10,4,8,15,28,49,-21,20
Sydney FC,4753,1,20,5,3,66,24,42,65
N'castle Jet,4753,2,16,5,7,59,37,22,53
Melbourne C,4753,3,14,4,11,43,35,8,46
Melbourne V,4753,4,13,6,10,47,40,7,45
Adelaide Utd,4753,5,11,6,11,37,40,-3,39
Brisbane,4753,6,10,5,13,33,42,-9,35
Western Sydn,4753,7,8,9,10,38,47,-9,33
Perth Glory,4753,8,10,2,15,37,50,-13,32
Wellington P,4753,9,5,6,16,31,55,-24,21
CC Mariners,4753,10,4,8,15,28,49,-21,20
Sydney FC,4754,1,20,4,4,66,25,41,64
N'castle Jet,4754,2,16,5,7,59,38,21,53
Melbourne V,4754,3,14,5,10,48,40,8,47
Melbourne C,4754,4,14,4,11,44,35,9,46
Adelaide Utd,4754,5,11,6,11,37,40,-3,39
Brisbane,4754,6,10,5,13,33,42,-9,35
Western Sydn,4754,7,8,9,10,38,47,-9,33
Perth Glory,4754,8,10,2,15,37,50,-13,32
Wellington P,4754,9,5,6,16,31,55,-24,21
CC Mariners,4754,10,4,8,15,28,49,-21,20
Sydney FC,4755,1,20,5,3,65,23,42,65
N'castle Jet,4755,2,15,5,8,57,39,18,50
Melbourne C,4755,3,15,4,10,45,33,12,49
Melbourne V,4755,4,13,6,10,46,39,7,45
Adelaide Utd,4755,5,11,6,11,37,40,-3,39
Brisbane,4755,6,10,5,13,33,42,-9,35
Western Sydn,4755,7,8,9,10,38,47,-9,33
Perth Glory,4755,8,10,2,15,37,50,-13,32
Wellington P,4755,9,5,6,16,31,55,-24,21
CC Mariners,4755,10,4,8,15,28,49,-21,20
Sydney FC,4756,1,21,4,3,65,22,43,67
N'castle Jet,4756,2,16,5,7,58,37,21,53
Melbourne C,4756,3,14,4,11,43,34,9,46
Melbourne V,4756,4,13,5,11,45,39,6,44
Adelaide Utd,4756,5,11,6,11,37,40,-3,39
Brisbane,4756,6,10,5,13,33,42,-9,35
Western Sydn,4756,7,8,9,10,38,47,-9,33
Perth Glory,4756,8,10,2,15,37,50,-13,32
Wellington P,4756,9,5,6,16,31,55,-24,21
CC Mariners,4756,10,4,8,15,28,49,-21,20
Sydney FC,4757,1,20,4,4,64,24,40,64
N'castle Jet,4757,2,15,6,7,58,38,20,51
Melbourne C,4757,3,14,5,10,44,34,10,47
Melbourne V,4757,4,14,5,10,47,38,9,47
Adelaide Utd,4757,5,11,6,11,37,40,-3,39
Brisbane,4757,6,10,5,13,33,42,-9,35
Western Sydn,4757,7,8,9,10,38,47,-9,33
Perth Glory,4757,8,10,2,15,37,50,-13,32
Wellington P,4757,9,5,6,16,31,55,-24,21
CC Mariners,4757,10,4,8,15,28,49,-21,20
Sydney FC,4758,1,21,4,3,67,22,45,67
N'castle Jet,4758,2,15,5,8,60,41,19,50
Melbourne C,4758,3,15,4,10,47,36,11,49
Melbourne V,4758,4,13,5,11,45,41,4,44
Adelaide Utd,4758,5,11,6,11,37,40,-3,39
Brisbane,4758,6,10,5,13,33,42,-9,35
Western Sydn,4758,7,8,9,10,38,47,-9,33
Perth Glory,4758,8,10,2,15,37,50,-13,32
Wellington P,4758,9,5,6,16,31,55,-24,21
CC Mariners,4758,10,4,8,15,28,49,-21,20
Sydney FC,4759,1,20,5,3,65,23,42,65
N'castle Jet,4759,2,15,6,7,57,37,20,51
Melbourne C,4759,3,14,5,10,43,33,10,47
Melbourne V,4759,4,13,6,10,46,39,7,45
Adelaide Utd,4759,5,11,6,11,37,40,-3,39
Brisbane,4759,6,10,5,13,33,42,-9,35
Western Sydn,4759,7,8,9,10,38,47,-9,33
Perth Glory,4759,8,10,2,15,37,50,-13,32
Wellington P,4759,9,5,6,16,31,55,-24,21
CC Mariners,4759,10,4,8,15,28,49,-21,20
Sydney FC,4760,1,20,4,4,64,24,40,64
N'castle Jet,4760,2,15,5,8,57,39,18,50
Melbourne C,4760,3,15,4,10,45,33,12,49
Melbourne V,4760,4,14,5,10,47,38,9,47
Adelaide Utd,4760,5,11,6,11,37,40,-3,39
Brisbane,4760,6,10,5,13,33,42,-9,35
Western Sydn,4760,7,8,9,10,38,47,-9,33
Perth Glory,4760,8,10,2,15,37,50,-13,32
Wellington P,4760,9,5,6,16,31,55,-24,21
CC Mariners,4760,10,4,8,15,28,49,-21,20
Sydney FC,4761,1,20,5,3,65,23,42,65
N'castle Jet,4761,2,16,5,7,60,38,22,53
Melbourne C,4761,3,14,4,11,44,36,8,46
Melbourne V,4761,4,13,6,10,46,39,7,45
Adelaide Utd,4761,5,11,6,11,37,40,-3,39
Brisbane,4761,6,10,5,13,33,42,-9,35
Western Sydn,4761,7,8,9,10,38,47,-9,33
Perth Glory,4761,8,10,2,15,37,50,-13,32
Wellington P,4761,9,5,6,16,31,55,-24,21
CC Mariners,4761,10,4,8,15,28,49,-21,20
Sydney FC,4762,1,20,4,4,64,24,40,64
N'castle Jet,4762,2,16,5,7,59,37,22,53
Melbourne V,4762,3,14,5,10,47,38,9,47
Melbourne C,4762,4,14,4,11,43,35,8,46
Adelaide Utd,4762,5,11,6,11,37,40,-3,39
Brisbane,4762,6,10,5,13,33,42,-9,35
Western Sydn,4762,7,8,9,10,38,47,-9,33
Perth Glory,4762,8,10,2,15,37,50,-13,32
Wellington P,4762,9,5,6,16,31,55,-24,21
CC Mariners,4762,10,4,8,15,28,49,-21,20
Sydney FC,4763,1,20,4,4,65,26,39,64
N'castle Jet,4763,2,15,6,7,58,38,20,51
Melbourne V,4763,3,14,5,10,49,39,10,47
Melbourne C,4763,4,14,5,10,44,34,10,47
Adelaide Utd,4763,5,11,6,11,37,40,-3,39
Brisbane,4763,6,10,5,13,33,42,-9,35
Western Sydn,4763,7,8,9,10,38,47,-9,33
Perth Glory,4763,8,10,2,15,37,50,-13,32
Wellington P,4763,9,5,6,16,31,55,-24,21
CC Mariners,4763,10,4,8,15,28,49,-21,20
Sydney FC,4764,1,21,4,3,66,23,43,67
N'castle Jet,4764,2,15,5,8,60,41,19,50
Melbourne C,4764,3,15,4,10,47,36,11,49
Melbourne V,4764,4,13,5,11,46,40,6,44
Adelaide Utd,4764,5,11,6,11,37,40,-3,39
Brisbane,4764,6,10,5,13,33,42,-9,35
Western Sydn,4764,7,8,9,10,38,47,-9,33
Perth Glory,4764,8,10,2,15,37,50,-13,32
Wellington P,4764,9,5,6,16,31,55,-24,21
CC Mariners,4764,10,4,8,15,28,49,-21,20
Sydney FC,4765,1,20,5,3,65,23,42,65
N'castle Jet,4765,2,16,5,7,60,38,22,53
Melbourne C,4765,3,14,4,11,44,36,8,46
Melbourne V,4765,4,13,6,10,46,39,7,45
Adelaide Utd,4765,5,11,6,11,37,40,-3,39
Brisbane,4765,6,10,5,13,33,42,-9,35
Western Sydn,4765,7,8,9,10,38,47,-9,33
Perth Glory,4765,8,10,2,15,37,50,-13,32
Wellington P,4765,9,5,6,16,31,55,-24,21
CC Mariners,4765,10,4,8,15,28,49,-21,20
Sydney FC,4766,1,21,4,3,66,22,44,67
N'castle Jet,4766,2,15,5,8,60,41,19,50
Melbourne C,4766,3,15,4,10,47,36,11,49
Melbourne V,4766,4,13,5,11,45,40,5,44
Adelaide Utd,4766,5,11,6,11,37,40,-3,39
Brisbane,4766,6,10,5,13,33,42,-9,35
Western Sydn,4766,7,8,9,10,38,47,-9,33
Perth Glory,4766,8,10,2,15,37,50,-13,32
Wellington P,4766,9,5,6,16,31,55,-24,21
CC Mariners,4766,10,4,8,15,28,49,-21,20
Sydney FC,4767,1,21,4,3,66,22,44,67
N'castle Jet,4767,2,15,6,7,57,37,20,51
Melbourne C,4767,3,14,5,10,43,33,10,47
Melbourne V,4767,4,13,5,11,45,40,5,44
Adelaide Utd,4767,5,11,6,11,37,40,-3,39
Brisbane,4767,6,10,5,13,33,42,-9,35
Western Sydn,4767,7,8,9,10,38,47,-9,33
Perth Glory,4767,8,10,2,15,37,50,-13,32
Wellington P,4767,9,5,6,16,31,55,-24,21
CC Mariners,4767,10,4,8,15,28,49,-21,20
Sydney FC,4768,1,21,4,3,67,24,43,67
N'castle Jet,4768,2,16,5,7,59,37,22,53
Melbourne C,4768,3,14,4,11,43,35,8,46
Melbourne V,4768,4,13,5,11,47,41,6,44
Adelaide Utd,4768,5,11,6,11,37,40,-3,39
Brisbane,4768,6,10,5,13,33,42,-9,35
Western Sydn,4768,7,8,9,10,38,47,-9,33
Perth Glory,4768,8,10,2,15,37,50,-13,32
Wellington P,4768,9,5,6,16,31,55,-24,21
CC Mariners,4768,10,4,8,15,28,49,-21,20
Sydney FC,4769,1,21,4,3,66,22,44,67
N'castle Jet,4769,2,15,6,7,58,38,20,51
Melbourne C,4769,3,14,5,10,44,34,10,47
Melbourne V,4769,4,13,5,11,45,40,5,44
Adelaide Utd,4769,5,11,6,11,37,40,-3,39
Brisbane,4769,6,10,5,13,33,42,-9,35
Western Sydn,4769,7,8,9,10,38,47,-9,33
Perth Glory,4769,8,10,2,15,37,50,-13,32
Wellington P,4769,9,5,6,16,31,55,-24,21
CC Mariners,4769,10,4,8,15,28,49,-21,20
Sydney FC,4770,1,20,4,4,65,25,40,64
N'castle Jet,4770,2,15,5,8,57,39,18,50
Melbourne C,4770,3,15,4,10,45,33,12,49
Melbourne V,4770,4,14,5,10,48,39,9,47
Adelaide Utd,4770,5,11,6,11,37,40,-3,39
Brisbane,4770,6,10,5,13,33,42,-9,35
Western Sydn,4770,7,8,9,10,38,47,-9,33
Perth Glory,4770,8,10,2,15,37,50,-13,32
Wellington P,4770,9,5,6,16,31,55,-24,21
CC Mariners,4770,10,4,8,15,28,49,-21,20
Sydney FC,4771,1,20,5,3,65,23,42,65
N'castle Jet,4771,2,16,5,7,61,39,22,53
Melbourne C,4771,3,14,4,11,45,37,8,46
Melbourne V,4771,4,13,6,10,46,39,7,45
Adelaide Utd,4771,5,11,6,11,37,40,-3,39
Brisbane,4771,6,10,5,13,33,42,-9,35
Western Sydn,4771,7,8,9,10,38,47,-9,33
Perth Glory,4771,8,10,2,15,37,50,-13,32
Wellington P,4771,9,5,6,16,31,55,-24,21
CC Mariners,4771,10,4,8,15,28,49,-21,20
Sydney FC,4772,1,21,4,3,66,22,44,67
N'castle Jet,4772,2,16,5,7,61,39,22,53
Melbourne C,4772,3,14,4,11,45,37,8,46
Melbourne V,4772,4,13,5,11,45,40,5,44
Adelaide Utd,4772,5,11,6,11,37,40,-3,39
Brisbane,4772,6,10,5,13,33,42,-9,35
Western Sydn,4772,7,8,9,10,38,47,-9,33
Perth Glory,4772,8,10,2,15,37,50,-13,32
Wellington P,4772,9,5,6,16,31,55,-24,21
CC Mariners,4772,10,4,8,15,28,49,-21,20
Sydney FC,4773,1,21,4,3,65,22,43,67
N'castle Jet,4773,2,16,5,7,59,38,21,53
Melbourne C,4773,3,14,4,11,44,35,9,46
Melbourne V,4773,4,13,5,11,45,39,6,44
Adelaide Utd,4773,5,11,6,11,37,40,-3,39
Brisbane,4773,6,10,5,13,33,42,-9,35
Western Sydn,4773,7,8,9,10,38,47,-9,33
Perth Glory,4773,8,10,2,15,37,50,-13,32
Wellington P,4773,9,5,6,16,31,55,-24,21
CC Mariners,4773,10,4,8,15,28,49,-21,20
Sydney FC,4774,1,21,4,3,66,22,44,67
N'castle Jet,4774,2,15,6,7,58,38,20,51
Melbourne C,4774,3,14,5,10,44,34,10,47
Melbourne V,4774,4,13,5,11,45,40,5,44
Adelaide Utd,4774,5,11,6,11,37,40,-3,39
Brisbane,4774,6,10,5,13,33,42,-9,35
Western Sydn,4774,7,8,9,10,38,47,-9,33
Perth Glory,4774,8,10,2,15,37,50,-13,32
Wellington P,4774,9,5,6,16,31,55,-24,21
CC Mariners,4774,10,4,8,15,28,49,-21,20
Sydney FC,4775,1,20,5,3,64,22,42,65
N'castle Jet,4775,2,15,6,7,57,37,20,51
Melbourne C,4775,3,14,5,10,43,33,10,47
Melbourne V,4775,4,13,6,10,45,38,7,45
Adelaide Utd,4775,5,11,6,11,37,40,-3,39
Brisbane,4775,6,10,5,13,33,42,-9,35
Western Sydn,4775,7,8,9,10,38,47,-9,33
Perth Glory,4775,8,10,2,15,37,50,-13,32
Wellington P,4775,9,5,6,16,31,55,-24,21
CC Mariners,4775,10,4,8,15,28,49,-21,20
Sydney FC,4776,1,21,4,3,65,22,43,67
N'castle Jet,4776,2,16,5,7,59,38,21,53
Melbourne C,4776,3,14,4,11,44,35,9,46
Melbourne V,4776,4,13,5,11,45,39,6,44
Adelaide Utd,4776,5,11,6,11,37,40,-3,39
Brisbane,4776,6,10,5,13,33,42,-9,35
Western Sydn,4776,7,8,9,10,38,47,-9,33
Perth Glory,4776,8,10,2,15,37,50,-13,32
Wellington P,4776,9,5,6,16,31,55,-24,21
CC Mariners,4776,10,4,8,15,28,49,-21,20
Sydney FC,4777,1,21,4,3,67,22,45,67
N'castle Jet,4777,2,15,6,7,59,39,20,51
Melbourne C,4777,3,14,5,10,45,35,10,47
Melbourne V,4777,4,13,5,11,45,41,4,44
Adelaide Utd,4777,5,11,6,11,37,40,-3,39
Brisbane,4777,6,10,5,13,33,42,-9,35
Western Sydn,4777,7,8,9,10,38,47,-9,33
Perth Glory,4777,8,10,2,15,37,50,-13,32
Wellington P,4777,9,5,6,16,31,55,-24,21
CC Mariners,4777,10,4,8,15,28,49,-21,20
Sydney FC,4778,1,21,4,3,65,22,43,67
N'castle Jet,4778,2,15,5,8,59,40,19,50
Melbourne C,4778,3,15,4,10,46,35,11,49
Melbourne V,4778,4,13,5,11,45,39,6,44
Adelaide Utd,4778,5,11,6,11,37,40,-3,39
Brisbane,4778,6,10,5,13,33,42,-9,35
Western Sydn,4778,7,8,9,10,38,47,-9,33
Perth Glory,4778,8,10,2,15,37,50,-13,32
Wellington P,4778,9,5,6,16,31,55,-24,21
CC Mariners,4778,10,4,8,15,28,49,-21,20
Sydney FC,4779,1,21,4,3,66,23,43,67
N'castle Jet,4779,2,16,5,7,59,37,22,53
Melbourne C,4779,3,14,4,11,43,35,8,46
Melbourne V,4779,4,13,5,11,46,40,6,44
Adelaide Utd,4779,5,11,6,11,37,40,-3,39
Brisbane,4779,6,10,5,13,33,42,-9,35
Western Sydn,4779,7,8,9,10,38,47,-9,33
Perth Glory,4779,8,10,2,15,37,50,-13,32
Wellington P,4779,9,5,6,16,31,55,-24,21
CC Mariners,4779,10,4,8,15,28,49,-21,20
Sydney FC,4780,1,20,5,3,65,23,42,65
N'castle Jet,4780,2,16,5,7,60,39,21,53
Melbourne C,4780,3,14,4,11,45,36,9,46
Melbourne V,4780,4,13,6,10,46,39,7,45
Adelaide Utd,4780,5,11,6,11,37,40,-3,39
Brisbane,4780,6,10,5,13,33,42,-9,35
Western Sydn,4780,7,8,9,10,38,47,-9,33
Perth Glory,4780,8,10,2,15,37,50,-13,32
Wellington P,4780,9,5,6,16,31,55,-24,21
CC Mariners,4780,10,4,8,15,28,49,-21,20
Sydney FC,4781,1,21,4,3,66,23,43,67
N'castle Jet,4781,2,16,5,7,59,38,21,53
Melbourne C,4781,3,14,4,11,44,35,9,46
Melbourne V,4781,4,13,5,11,46,40,6,44
Adelaide Utd,4781,5,11,6,11,37,40,-3,39
Brisbane,4781,6,10,5,13,33,42,-9,35
Western Sydn,4781,7,8,9,10,38,47,-9,33
Perth Glory,4781,8,10,2,15,37,50,-13,32
Wellington P,4781,9,5,6,16,31,55,-24,21
CC Mariners,4781,10,4,8,15,28,49,-21,20
Sydney FC,4782,1,21,4,3,68,22,46,67
N'castle Jet,4782,2,16,5,7,59,38,21,53
Melbourne C,4782,3,14,4,11,44,35,9,46
Melbourne V,4782,4,13,5,11,45,42,3,44
Adelaide Utd,4782,5,11,6,11,37,40,-3,39
Brisbane,4782,6,10,5,13,33,42,-9,35
Western Sydn,4782,7,8,9,10,38,47,-9,33
Perth Glory,4782,8,10,2,15,37,50,-13,32
Wellington P,4782,9,5,6,16,31,55,-24,21
CC Mariners,4782,10,4,8,15,28,49,-21,20
Sydney FC,4783,1,20,5,3,64,22,42,65
N'castle Jet,4783,2,16,5,7,59,37,22,53
Melbourne C,4783,3,14,4,11,43,35,8,46
Melbourne V,4783,4,13,6,10,45,38,7,45
Adelaide Utd,4783,5,11,6,11,37,40,-3,39
Brisbane,4783,6,10,5,13,33,42,-9,35
Western Sydn,4783,7,8,9,10,38,47,-9,33
Perth Glory,4783,8,10,2,15,37,50,-13,32
Wellington P,4783,9,5,6,16,31,55,-24,21
CC Mariners,4783,10,4,8,15,28,49,-21,20
Sydney FC,4784,1,20,4,4,65,25,40,64
N'castle Jet,4784,2,16,5,7,59,37,22,53
Melbourne V,4784,3,14,5,10,48,39,9,47
Melbourne C,4784,4,14,4,11,43,35,8,46
Adelaide Utd,4784,5,11,6,11,37,40,-3,39
Brisbane,4784,6,10,5,13,33,42,-9,35
Western Sydn,4784,7,8,9,10,38,47,-9,33
Perth Glory,4784,8,10,2,15,37,50,-13,32
Wellington P,4784,9,5,6,16,31,55,-24,21
CC Mariners,4784,10,4,8,15,28,49,-21,20
Sydney FC,4785,1,20,5,3,65,23,42,65
N'castle Jet,4785,2,16,5,7,61,39,22,53
Melbourne C,4785,3,14,4,11,45,37,8,46
Melbourne V,4785,4,13,6,10,46,39,7,45
Adelaide Utd,4785,5,11,6,11,37,40,-3,39
Brisbane,4785,6,10,5,13,33,42,-9,35
Western Sydn,4785,7,8,9,10,38,47,-9,33
Perth Glory,4785,8,10,2,15,37,50,-13,32
Wellington P,4785,9,5,6,16,31,55,-24,21
CC Mariners,4785,10,4,8,15,28,49,-21,20
Sydney FC,4786,1,20,5,3,65,23,42,65
N'castle Jet,4786,2,16,5,7,61,37,24,53
Melbourne C,4786,3,14,4,11,43,37,6,46
Melbourne V,4786,4,13,6,10,46,39,7,45
Adelaide Utd,4786,5,11,6,11,37,40,-3,39
Brisbane,4786,6,10,5,13,33,42,-9,35
Western Sydn,4786,7,8,9,10,38,47,-9,33
Perth Glory,4786,8,10,2,15,37,50,-13,32
Wellington P,4786,9,5,6,16,31,55,-24,21
CC Mariners,4786,10,4,8,15,28,49,-21,20
Sydney FC,4787,1,21,4,3,67,24,43,67
N'castle Jet,4787,2,15,5,8,57,39,18,50
Melbourne C,4787,3,15,4,10,45,33,12,49
Melbourne V,4787,4,13,5,11,47,41,6,44
Adelaide Utd,4787,5,11,6,11,37,40,-3,39
Brisbane,4787,6,10,5,13,33,42,-9,35
Western Sydn,4787,7,8,9,10,38,47,-9,33
Perth Glory,4787,8,10,2,15,37,50,-13,32
Wellington P,4787,9,5,6,16,31,55,-24,21
CC Mariners,4787,10,4,8,15,28,49,-21,20
Sydney FC,4788,1,21,4,3,66,22,44,67
N'castle Jet,4788,2,15,5,8,58,40,18,50
Melbourne C,4788,3,15,4,10,46,34,12,49
Melbourne V,4788,4,13,5,11,45,40,5,44
Adelaide Utd,4788,5,11,6,11,37,40,-3,39
Brisbane,4788,6,10,5,13,33,42,-9,35
Western Sydn,4788,7,8,9,10,38,47,-9,33
Perth Glory,4788,8,10,2,15,37,50,-13,32
Wellington P,4788,9,5,6,16,31,55,-24,21
CC Mariners,4788,10,4,8,15,28,49,-21,20
Sydney FC,4789,1,20,4,4,64,23,41,64
N'castle Jet,4789,2,15,5,8,57,38,19,50
Melbourne C,4789,3,15,4,10,44,33,11,49
Melbourne V,4789,4,14,5,10,46,38,8,47
Adelaide Utd,4789,5,11,6,11,37,40,-3,39
Brisbane,4789,6,10,5,13,33,42,-9,35
Western Sydn,4789,7,8,9,10,38,47,-9,33
Perth Glory,4789,8,10,2,15,37,50,-13,32
Wellington P,4789,9,5,6,16,31,55,-24,21
CC Mariners,4789,10,4,8,15,28,49,-21,20
Sydney FC,4790,1,21,4,3,65,22,43,67
N'castle Jet,4790,2,16,5,7,62,38,24,53
Melbourne C,4790,3,14,4,11,44,38,6,46
Melbourne V,4790,4,13,5,11,45,39,6,44
Adelaide Utd,4790,5,11,6,11,37,40,-3,39
Brisbane,4790,6,10,5,13,33,42,-9,35
Western Sydn,4790,7,8,9,10,38,47,-9,33
Perth Glory,4790,8,10,2,15,37,50,-13,32
Wellington P,4790,9,5,6,16,31,55,-24,21
CC Mariners,4790,10,4,8,15,28,49,-21,20
Sydney FC,4791,1,20,4,4,65,24,41,64
N'castle Jet,4791,2,16,5,7,59,37,22,53
Melbourne V,4791,3,14,5,10,47,39,8,47
Melbourne C,4791,4,14,4,11,43,35,8,46
Adelaide Utd,4791,5,11,6,11,37,40,-3,39
Brisbane,4791,6,10,5,13,33,42,-9,35
Western Sydn,4791,7,8,9,10,38,47,-9,33
Perth Glory,4791,8,10,2,15,37,50,-13,32
Wellington P,4791,9,5,6,16,31,55,-24,21
CC Mariners,4791,10,4,8,15,28,49,-21,20
Sydney FC,4792,1,20,4,4,64,27,37,64
N'castle Jet,4792,2,15,6,7,58,38,20,51
Melbourne V,4792,3,14,5,10,50,38,12,47
Melbourne C,4792,4,14,5,10,44,34,10,47
Adelaide Utd,4792,5,11,6,11,37,40,-3,39
Brisbane,4792,6,10,5,13,33,42,-9,35
Western Sydn,4792,7,8,9,10,38,47,-9,33
Perth Glory,4792,8,10,2,15,37,50,-13,32
Wellington P,4792,9,5,6,16,31,55,-24,21
CC Mariners,4792,10,4,8,15,28,49,-21,20
Sydney FC,4793,1,20,5,3,65,23,42,65
N'castle Jet,4793,2,15,6,7,58,38,20,51
Melbourne C,4793,3,14,5,10,44,34,10,47
Melbourne V,4793,4,13,6,10,46,39,7,45
Adelaide Utd,4793,5,11,6,11,37,40,-3,39
Brisbane,4793,6,10,5,13,33,42,-9,35
Western Sydn,4793,7,8,9,10,38,47,-9,33
Perth Glory,4793,8,10,2,15,37,50,-13,32
Wellington P,4793,9,5,6,16,31,55,-24,21
CC Mariners,4793,10,4,8,15,28,49,-21,20
Sydney FC,4794,1,21,4,3,65,22,43,67
N'castle Jet,4794,2,15,5,8,57,38,19,50
Melbourne C,4794,3,15,4,10,44,33,11,49
Melbourne V,4794,4,13,5,11,45,39,6,44
Adelaide Utd,4794,5,11,6,11,37,40,-3,39
Brisbane,4794,6,10,5,13,33,42,-9,35
Western Sydn,4794,7,8,9,10,38,47,-9,33
Perth Glory,4794,8,10,2,15,37,50,-13,32
Wellington P,4794,9,5,6,16,31,55,-24,21
CC Mariners,4794,10,4,8,15,28,49,-21,20
Sydney FC,4795,1,20,5,3,64,22,42,65
N'castle Jet,4795,2,15,5,8,58,40,18,50
Melbourne C,4795,3,15,4,10,46,34,12,49
Melbourne V,4795,4,13,6,10,45,38,7,45
Adelaide Utd,4795,5,11,6,11,37,40,-3,39
Brisbane,4795,6,10,5,13,33,42,-9,35
Western Sydn,4795,7,8,9,10,38,47,-9,33
Perth Glory,4795,8,10,2,15,37,50,-13,32
Wellington P,4795,9,5,6,16,31,55,-24,21
CC Mariners,4795,10,4,8,15,28,49,-21,20
Sydney FC,4796,1,20,5,3,65,23,42,65
N'castle Jet,4796,2,15,6,7,58,38,20,51
Melbourne C,4796,3,14,5,10,44,34,10,47
Melbourne V,4796,4,13,6,10,46,39,7,45
Adelaide Utd,4796,5,11,6,11,37,40,-3,39
Brisbane,4796,6,10,5,13,33,42,-9,35
Western Sydn,4796,7,8,9,10,38,47,-9,33
Perth Glory,4796,8,10,2,15,37,50,-13,32
Wellington P,4796,9,5,6,16,31,55,-24,21
CC Mariners,4796,10,4,8,15,28,49,-21,20
Sydney FC,4797,1,21,4,3,65,22,43,67
N'castle Jet,4797,2,15,5,8,58,41,17,50
Melbourne C,4797,3,15,4,10,47,34,13,49
Melbourne V,4797,4,13,5,11,45,39,6,44
Adelaide Utd,4797,5,11,6,11,37,40,-3,39
Brisbane,4797,6,10,5,13,33,42,-9,35
Western Sydn,4797,7,8,9,10,38,47,-9,33
Perth Glory,4797,8,10,2,15,37,50,-13,32
Wellington P,4797,9,5,6,16,31,55,-24,21
CC Mariners,4797,10,4,8,15,28,49,-21,20
Sydney FC,4798,1,21,4,3,66,22,44,67
N'castle Jet,4798,2,15,6,7,58,38,20,51
Melbourne C,4798,3,14,5,10,44,34,10,47
Melbourne V,4798,4,13,5,11,45,40,5,44
Adelaide Utd,4798,5,11,6,11,37,40,-3,39
Brisbane,4798,6,10,5,13,33,42,-9,35
Western Sydn,4798,7,8,9,10,38,47,-9,33
Perth Glory,4798,8,10,2,15,37,50,-13,32
Wellington P,4798,9,5,6,16,31,55,-24,21
CC Mariners,4798,10,4,8,15,28,49,-21,20
Sydney FC,4799,1,21,4,3,65,22,43,67
N'castle Jet,4799,2,15,5,8,57,38,19,50
Melbourne C,4799,3,15,4,10,44,33,11,49
Melbourne V,4799,4,13,5,11,45,39,6,44
Adelaide Utd,4799,5,11,6,11,37,40,-3,39
Brisbane,4799,6,10,5,13,33,42,-9,35
Western Sydn,4799,7,8,9,10,38,47,-9,33
Perth Glory,4799,8,10,2,15,37,50,-13,32
Wellington P,4799,9,5,6,16,31,55,-24,21
CC Mariners,4799,10,4,8,15,28,49,-21,20
Sydney FC,4800,1,21,4,3,68,23,45,67
N'castle Jet,4800,2,16,5,7,58,37,21,53
Melbourne C,4800,3,14,4,11,43,34,9,46
Melbourne V,4800,4,13,5,11,46,42,4,44
Adelaide Utd,4800,5,11,6,11,37,40,-3,39
Brisbane,4800,6,10,5,13,33,42,-9,35
Western Sydn,4800,7,8,9,10,38,47,-9,33
Perth Glory,4800,8,10,2,15,37,50,-13,32
Wellington P,4800,9,5,6,16,31,55,-24,21
CC Mariners,4800,10,4,8,15,28,49,-21,20
Sydney FC,4801,1,21,4,3,67,23,44,67
N'castle Jet,4801,2,16,5,7,59,38,21,53
Melbourne C,4801,3,14,4,11,44,35,9,46
Melbourne V,4801,4,13,5,11,46,41,5,44
Adelaide Utd,4801,5,11,6,11,37,40,-3,39
Brisbane,4801,6,10,5,13,33,42,-9,35
Western Sydn,4801,7,8,9,10,38,47,-9,33
Perth Glory,4801,8,10,2,15,37,50,-13,32
Wellington P,4801,9,5,6,16,31,55,-24,21
CC Mariners,4801,10,4,8,15,28,49,-21,20
Sydney FC,4802,1,21,4,3,65,22,43,67
N'castle Jet,4802,2,15,6,7,57,37,20,51
Melbourne C,4802,3,14,5,10,43,33,10,47
Melbourne V,4802,4,13,5,11,45,39,6,44
Adelaide Utd,4802,5,11,6,11,37,40,-3,39
Brisbane,4802,6,10,5,13,33,42,-9,35
Western Sydn,4802,7,8,9,10,38,47,-9,33
Perth Glory,4802,8,10,2,15,37,50,-13,32
Wellington P,4802,9,5,6,16,31,55,-24,21
CC Mariners,4802,10,4,8,15,28,49,-21,20
Sydney FC,4803,1,20,5,3,65,23,42,65
N'castle Jet,4803,2,16,5,7,59,38,21,53
Melbourne C,4803,3,14,4,11,44,35,9,46
Melbourne V,4803,4,13,6,10,46,39,7,45
Adelaide Utd,4803,5,11,6,11,37,40,-3,39
Brisbane,4803,6,10,5,13,33,42,-9,35
Western Sydn,4803,7,8,9,10,38,47,-9,33
Perth Glory,4803,8,10,2,15,37,50,-13,32
Wellington P,4803,9,5,6,16,31,55,-24,21
CC Mariners,4803,10,4,8,15,28,49,-21,20
Sydney FC,4804,1,20,4,4,64,25,39,64
N'castle Jet,4804,2,15,5,8,58,39,19,50
Melbourne C,4804,3,15,4,10,45,34,11,49
Melbourne V,4804,4,14,5,10,48,38,10,47
Adelaide Utd,4804,5,11,6,11,37,40,-3,39
Brisbane,4804,6,10,5,13,33,42,-9,35
Western Sydn,4804,7,8,9,10,38,47,-9,33
Perth Glory,4804,8,10,2,15,37,50,-13,32
Wellington P,4804,9,5,6,16,31,55,-24,21
CC Mariners,4804,10,4,8,15,28,49,-21,20
Sydney FC,4805,1,21,4,3,69,24,45,67
N'castle Jet,4805,2,15,5,8,57,38,19,50
Melbourne C,4805,3,15,4,10,44,33,11,49
Melbourne V,4805,4,13,5,11,47,43,4,44
Adelaide Utd,4805,5,11,6,11,37,40,-3,39
Brisbane,4805,6,10,5,13,33,42,-9,35
Western Sydn,4805,7,8,9,10,38,47,-9,33
Perth Glory,4805,8,10,2,15,37,50,-13,32
Wellington P,4805,9,5,6,16,31,55,-24,21
CC Mariners,4805,10,4,8,15,28,49,-21,20
Sydney FC,4806,1,20,4,4,64,23,41,64
N'castle Jet,4806,2,15,6,7,58,38,20,51
Melbourne C,4806,3,14,5,10,44,34,10,47
Melbourne V,4806,4,14,5,10,46,38,8,47
Adelaide Utd,4806,5,11,6,11,37,40,-3,39
Brisbane,4806,6,10,5,13,33,42,-9,35
Western Sydn,4806,7,8,9,10,38,47,-9,33
Perth Glory,4806,8,10,2,15,37,50,-13,32
Wellington P,4806,9,5,6,16,31,55,-24,21
CC Mariners,4806,10,4,8,15,28,49,-21,20
Sydney FC,4807,1,21,4,3,67,22,45,67
N'castle Jet,4807,2,15,5,8,58,39,19,50
Melbourne C,4807,3,15,4,10,45,34,11,49
Melbourne V,4807,4,13,5,11,45,41,4,44
Adelaide Utd,4807,5,11,6,11,37,40,-3,39
Brisbane,4807,6,10,5,13,33,42,-9,35
Western Sydn,4807,7,8,9,10,38,47,-9,33
Perth Glory,4807,8,10,2,15,37,50,-13,32
Wellington P,4807,9,5,6,16,31,55,-24,21
CC Mariners,4807,10,4,8,15,28,49,-21,20
Sydney FC,4808,1,20,4,4,66,25,41,64
N'castle Jet,4808,2,16,5,7,59,37,22,53
Melbourne V,4808,3,14,5,10,48,40,8,47
Melbourne C,4808,4,14,4,11,43,35,8,46
Adelaide Utd,4808,5,11,6,11,37,40,-3,39
Brisbane,4808,6,10,5,13,33,42,-9,35
Western Sydn,4808,7,8,9,10,38,47,-9,33
Perth Glory,4808,8,10,2,15,37,50,-13,32
Wellington P,4808,9,5,6,16,31,55,-24,21
CC Mariners,4808,10,4,8,15,28,49,-21,20
Sydney FC,4809,1,21,4,3,66,22,44,67
N'castle Jet,4809,2,15,6,7,58,38,20,51
Melbourne C,4809,3,14,5,10,44,34,10,47
Melbourne V,4809,4,13,5,11,45,40,5,44
Adelaide Utd,4809,5,11,6,11,37,40,-3,39
Brisbane,4809,6,10,5,13,33,42,-9,35
Western Sydn,4809,7,8,9,10,38,47,-9,33
Perth Glory,4809,8,10,2,15,37,50,-13,32
Wellington P,4809,9,5,6,16,31,55,-24,21
CC Mariners,4809,10,4,8,15,28,49,-21,20
Sydney FC,4810,1,21,4,3,69,24,45,67
N'castle Jet,4810,2,15,6,7,57,37,20,51
Melbourne C,4810,3,14,5,10,43,33,10,47
Melbourne V,4810,4,13,5,11,47,43,4,44
Adelaide Utd,4810,5,11,6,11,37,40,-3,39
Brisbane,4810,6,10,5,13,33,42,-9,35
Western Sydn,4810,7,8,9,10,38,47,-9,33
Perth Glory,4810,8,10,2,15,37,50,-13,32
Wellington P,4810,9,5,6,16,31,55,-24,21
CC Mariners,4810,10,4,8,15,28,49,-21,20
Sydney FC,4811,1,21,4,3,65,22,43,67
N'castle Jet,4811,2,16,5,7,59,38,21,53
Melbourne C,4811,3,14,4,11,44,35,9,46
Melbourne V,4811,4,13,5,11,45,39,6,44
Adelaide Utd,4811,5,11,6,11,37,40,-3,39
Brisbane,4811,6,10,5,13,33,42,-9,35
Western Sydn,4811,7,8,9,10,38,47,-9,33
Perth Glory,4811,8,10,2,15,37,50,-13,32
Wellington P,4811,9,5,6,16,31,55,-24,21
CC Mariners,4811,10,4,8,15,28,49,-21,20
Sydney FC,4812,1,21,4,3,66,23,43,67
N'castle Jet,4812,2,16,5,7,58,37,21,53
Melbourne C,4812,3,14,4,11,43,34,9,46
Melbourne V,4812,4,13,5,11,46,40,6,44
Adelaide Utd,4812,5,11,6,11,37,40,-3,39
Brisbane,4812,6,10,5,13,33,42,-9,35
Western Sydn,4812,7,8,9,10,38,47,-9,33
Perth Glory,4812,8,10,2,15,37,50,-13,32
Wellington P,4812,9,5,6,16,31,55,-24,21
CC Mariners,4812,10,4,8,15,28,49,-21,20
Sydney FC,4813,1,21,4,3,66,22,44,67
N'castle Jet,4813,2,16,5,7,61,39,22,53
Melbourne C,4813,3,14,4,11,45,37,8,46
Melbourne V,4813,4,13,5,11,45,40,5,44
Adelaide Utd,4813,5,11,6,11,37,40,-3,39
Brisbane,4813,6,10,5,13,33,42,-9,35
Western Sydn,4813,7,8,9,10,38,47,-9,33
Perth Glory,4813,8,10,2,15,37,50,-13,32
Wellington P,4813,9,5,6,16,31,55,-24,21
CC Mariners,4813,10,4,8,15,28,49,-21,20
Sydney FC,4814,1,20,5,3,64,22,42,65
N'castle Jet,4814,2,16,5,7,59,38,21,53
Melbourne C,4814,3,14,4,11,44,35,9,46
Melbourne V,4814,4,13,6,10,45,38,7,45
Adelaide Utd,4814,5,11,6,11,37,40,-3,39
Brisbane,4814,6,10,5,13,33,42,-9,35
Western Sydn,4814,7,8,9,10,38,47,-9,33
Perth Glory,4814,8,10,2,15,37,50,-13,32
Wellington P,4814,9,5,6,16,31,55,-24,21
CC Mariners,4814,10,4,8,15,28,49,-21,20
Sydney FC,4815,1,20,5,3,66,24,42,65
N'castle Jet,4815,2,15,5,8,59,40,19,50
Melbourne C,4815,3,15,4,10,46,35,11,49
Melbourne V,4815,4,13,6,10,47,40,7,45
Adelaide Utd,4815,5,11,6,11,37,40,-3,39
Brisbane,4815,6,10,5,13,33,42,-9,35
Western Sydn,4815,7,8,9,10,38,47,-9,33
Perth Glory,4815,8,10,2,15,37,50,-13,32
Wellington P,4815,9,5,6,16,31,55,-24,21
CC Mariners,4815,10,4,8,15,28,49,-21,20
Sydney FC,4816,1,20,5,3,64,22,42,65
N'castle Jet,4816,2,15,5,8,57,38,19,50
Melbourne C,4816,3,15,4,10,44,33,11,49
Melbourne V,4816,4,13,6,10,45,38,7,45
Adelaide Utd,4816,5,11,6,11,37,40,-3,39
Brisbane,4816,6,10,5,13,33,42,-9,35
Western Sydn,4816,7,8,9,10,38,47,-9,33
Perth Glory,4816,8,10,2,15,37,50,-13,32
Wellington P,4816,9,5,6,16,31,55,-24,21
CC Mariners,4816,10,4,8,15,28,49,-21,20
Sydney FC,4817,1,21,4,3,66,22,44,67
N'castle Jet,4817,2,15,6,7,58,38,20,51
Melbourne C,4817,3,14,5,10,44,34,10,47
Melbourne V,4817,4,13,5,11,45,40,5,44
Adelaide Utd,4817,5,11,6,11,37,40,-3,39
Brisbane,4817,6,10,5,13,33,42,-9,35
Western Sydn,4817,7,8,9,10,38,47,-9,33
Perth Glory,4817,8,10,2,15,37,50,-13,32
Wellington P,4817,9,5,6,16,31,55,-24,21
CC Mariners,4817,10,4,8,15,28,49,-21,20
Sydney FC,4818,1,21,4,3,68,23,45,67
N'castle Jet,4818,2,15,5,8,58,39,19,50
Melbourne C,4818,3,15,4,10,45,34,11,49
Melbourne V,4818,4,13,5,11,46,42,4,44
Adelaide Utd,4818,5,11,6,11,37,40,-3,39
Brisbane,4818,6,10,5,13,33,42,-9,35
Western Sydn,4818,7,8,9,10,38,47,-9,33
Perth Glory,4818,8,10,2,15,37,50,-13,32
Wellington P,4818,9,5,6,16,31,55,-24,21
CC Mariners,4818,10,4,8,15,28,49,-21,20
Sydney FC,4819,1,20,4,4,66,25,41,64
N'castle Jet,4819,2,16,5,7,60,38,22,53
Melbourne V,4819,3,14,5,10,48,40,8,47
Melbourne C,4819,4,14,4,11,44,36,8,46
Adelaide Utd,4819,5,11,6,11,37,40,-3,39
Brisbane,4819,6,10,5,13,33,42,-9,35
Western Sydn,4819,7,8,9,10,38,47,-9,33
Perth Glory,4819,8,10,2,15,37,50,-13,32
Wellington P,4819,9,5,6,16,31,55,-24,21
CC Mariners,4819,10,4,8,15,28,49,-21,20
Sydney FC,4820,1,21,4,3,67,23,44,67
N'castle Jet,4820,2,16,5,7,61,38,23,53
Melbourne C,4820,3,14,4,11,44,37,7,46
Melbourne V,4820,4,13,5,11,46,41,5,44
Adelaide Utd,4820,5,11,6,11,37,40,-3,39
Brisbane,4820,6,10,5,13,33,42,-9,35
Western Sydn,4820,7,8,9,10,38,47,-9,33
Perth Glory,4820,8,10,2,15,37,50,-13,32
Wellington P,4820,9,5,6,16,31,55,-24,21
CC Mariners,4820,10,4,8,15,28,49,-21,20
Sydney FC,4821,1,20,5,3,66,24,42,65
N'castle Jet,4821,2,16,5,7,58,37,21,53
Melbourne C,4821,3,14,4,11,43,34,9,46
Melbourne V,4821,4,13,6,10,47,40,7,45
Adelaide Utd,4821,5,11,6,11,37,40,-3,39
Brisbane,4821,6,10,5,13,33,42,-9,35
Western Sydn,4821,7,8,9,10,38,47,-9,33
Perth Glory,4821,8,10,2,15,37,50,-13,32
Wellington P,4821,9,5,6,16,31,55,-24,21
CC Mariners,4821,10,4,8,15,28,49,-21,20
Sydney FC,4822,1,21,4,3,67,22,45,67
N'castle Jet,4822,2,15,5,8,57,39,18,50
Melbourne C,4822,3,15,4,10,45,33,12,49
Melbourne V,4822,4,13,5,11,45,41,4,44
Adelaide Utd,4822,5,11,6,11,37,40,-3,39
Brisbane,4822,6,10,5,13,33,42,-9,35
Western Sydn,4822,7,8,9,10,38,47,-9,33
Perth Glory,4822,8,10,2,15,37,50,-13,32
Wellington P,4822,9,5,6,16,31,55,-24,21
CC Mariners,4822,10,4,8,15,28,49,-21,20
Sydney FC,4823,1,21,4,3,69,23,46,67
N'castle Jet,4823,2,15,5,8,57,39,18,50
Melbourne C,4823,3,15,4,10,45,33,12,49
Melbourne V,4823,4,13,5,11,46,43,3,44
Adelaide Utd,4823,5,11,6,11,37,40,-3,39
Brisbane,4823,6,10,5,13,33,42,-9,35
Western Sydn,4823,7,8,9,10,38,47,-9,33
Perth Glory,4823,8,10,2,15,37,50,-13,32
Wellington P,4823,9,5,6,16,31,55,-24,21
CC Mariners,4823,10,4,8,15,28,49,-21,20
Sydney FC,4824,1,21,4,3,67,22,45,67
N'castle Jet,4824,2,15,6,7,57,37,20,51
Melbourne C,4824,3,14,5,10,43,33,10,47
Melbourne V,4824,4,13,5,11,45,41,4,44
Adelaide Utd,4824,5,11,6,11,37,40,-3,39
Brisbane,4824,6,10,5,13,33,42,-9,35
Western Sydn,4824,7,8,9,10,38,47,-9,33
Perth Glory,4824,8,10,2,15,37,50,-13,32
Wellington P,4824,9,5,6,16,31,55,-24,21
CC Mariners,4824,10,4,8,15,28,49,-21,20
Sydney FC,4825,1,21,4,3,67,23,44,67
N'castle Jet,4825,2,16,5,7,61,37,24,53
Melbourne C,4825,3,14,4,11,43,37,6,46
Melbourne V,4825,4,13,5,11,46,41,5,44
Adelaide Utd,4825,5,11,6,11,37,40,-3,39
Brisbane,4825,6,10,5,13,33,42,-9,35
Western Sydn,4825,7,8,9,10,38,47,-9,33
Perth Glory,4825,8,10,2,15,37,50,-13,32
Wellington P,4825,9,5,6,16,31,55,-24,21
CC Mariners,4825,10,4,8,15,28,49,-21,20
Sydney FC,4826,1,21,4,3,66,23,43,67
N'castle Jet,4826,2,16,5,7,59,38,21,53
Melbourne C,4826,3,14,4,11,44,35,9,46
Melbourne V,4826,4,13,5,11,46,40,6,44
Adelaide Utd,4826,5,11,6,11,37,40,-3,39
Brisbane,4826,6,10,5,13,33,42,-9,35
Western Sydn,4826,7,8,9,10,38,47,-9,33
Perth Glory,4826,8,10,2,15,37,50,-13,32
Wellington P,4826,9,5,6,16,31,55,-24,21
CC Mariners,4826,10,4,8,15,28,49,-21,20
Sydney FC,4827,1,21,4,3,68,23,45,67
N'castle Jet,4827,2,16,5,7,59,38,21,53
Melbourne C,4827,3,14,4,11,44,35,9,46
Melbourne V,4827,4,13,5,11,46,42,4,44
Adelaide Utd,4827,5,11,6,11,37,40,-3,39
Brisbane,4827,6,10,5,13,33,42,-9,35
Western Sydn,4827,7,8,9,10,38,47,-9,33
Perth Glory,4827,8,10,2,15,37,50,-13,32
Wellington P,4827,9,5,6,16,31,55,-24,21
CC Mariners,4827,10,4,8,15,28,49,-21,20
Sydney FC,4828,1,20,5,3,64,22,42,65
N'castle Jet,4828,2,16,5,7,59,37,22,53
Melbourne C,4828,3,14,4,11,43,35,8,46
Melbourne V,4828,4,13,6,10,45,38,7,45
Adelaide Utd,4828,5,11,6,11,37,40,-3,39
Brisbane,4828,6,10,5,13,33,42,-9,35
Western Sydn,4828,7,8,9,10,38,47,-9,33
Perth Glory,4828,8,10,2,15,37,50,-13,32
Wellington P,4828,9,5,6,16,31,55,-24,21
CC Mariners,4828,10,4,8,15,28,49,-21,20
Sydney FC,4829,1,20,4,4,65,24,41,64
N'castle Jet,4829,2,15,6,7,58,38,20,51
Melbourne C,4829,3,14,5,10,44,34,10,47
Melbourne V,4829,4,14,5,10,47,39,8,47
Adelaide Utd,4829,5,11,6,11,37,40,-3,39
Brisbane,4829,6,10,5,13,33,42,-9,35
Western Sydn,4829,7,8,9,10,38,47,-9,33
Perth Glory,4829,8,10,2,15,37,50,-13,32
Wellington P,4829,9,5,6,16,31,55,-24,21
CC Mariners,4829,10,4,8,15,28,49,-21,20
Sydney FC,4830,1,21,4,3,66,22,44,67
N'castle Jet,4830,2,15,5,8,58,40,18,50
Melbourne C,4830,3,15,4,10,46,34,12,49
Melbourne V,4830,4,13,5,11,45,40,5,44
Adelaide Utd,4830,5,11,6,11,37,40,-3,39
Brisbane,4830,6,10,5,13,33,42,-9,35
Western Sydn,4830,7,8,9,10,38,47,-9,33
Perth Glory,4830,8,10,2,15,37,50,-13,32
Wellington P,4830,9,5,6,16,31,55,-24,21
CC Mariners,4830,10,4,8,15,28,49,-21,20
Sydney FC,4831,1,21,4,3,69,22,47,67
N'castle Jet,4831,2,15,6,7,58,38,20,51
Melbourne C,4831,3,14,5,10,44,34,10,47
Melbourne V,4831,4,13,5,11,45,43,2,44
Adelaide Utd,4831,5,11,6,11,37,40,-3,39
Brisbane,4831,6,10,5,13,33,42,-9,35
Western Sydn,4831,7,8,9,10,38,47,-9,33
Perth Glory,4831,8,10,2,15,37,50,-13,32
Wellington P,4831,9,5,6,16,31,55,-24,21
CC Mariners,4831,10,4,8,15,28,49,-21,20
Sydney FC,4832,1,21,4,3,66,23,43,67
N'castle Jet,4832,2,15,6,7,58,38,20,51
Melbourne C,4832,3,14,5,10,44,34,10,47
Melbourne V,4832,4,13,5,11,46,40,6,44
Adelaide Utd,4832,5,11,6,11,37,40,-3,39
Brisbane,4832,6,10,5,13,33,42,-9,35
Western Sydn,4832,7,8,9,10,38,47,-9,33
Perth Glory,4832,8,10,2,15,37,50,-13,32
Wellington P,4832,9,5,6,16,31,55,-24,21
CC Mariners,4832,10,4,8,15,28,49,-21,20
Sydney FC,4833,1,21,4,3,69,22,47,67
N'castle Jet,4833,2,15,5,8,57,39,18,50
Melbourne C,4833,3,15,4,10,45,33,12,49
Melbourne V,4833,4,13,5,11,45,43,2,44
Adelaide Utd,4833,5,11,6,11,37,40,-3,39
Brisbane,4833,6,10,5,13,33,42,-9,35
Western Sydn,4833,7,8,9,10,38,47,-9,33
Perth Glory,4833,8,10,2,15,37,50,-13,32
Wellington P,4833,9,5,6,16,31,55,-24,21
CC Mariners,4833,10,4,8,15,28,49,-21,20
Sydney FC,4834,1,21,4,3,68,25,43,67
N'castle Jet,4834,2,16,5,7,61,39,22,53
Melbourne C,4834,3,14,4,11,45,37,8,46
Melbourne V,4834,4,13,5,11,48,42,6,44
Adelaide Utd,4834,5,11,6,11,37,40,-3,39
Brisbane,4834,6,10,5,13,33,42,-9,35
Western Sydn,4834,7,8,9,10,38,47,-9,33
Perth Glory,4834,8,10,2,15,37,50,-13,32
Wellington P,4834,9,5,6,16,31,55,-24,21
CC Mariners,4834,10,4,8,15,28,49,-21,20
Sydney FC,4835,1,20,5,3,64,22,42,65
N'castle Jet,4835,2,16,5,7,60,39,21,53
Melbourne C,4835,3,14,4,11,45,36,9,46
Melbourne V,4835,4,13,6,10,45,38,7,45
Adelaide Utd,4835,5,11,6,11,37,40,-3,39
Brisbane,4835,6,10,5,13,33,42,-9,35
Western Sydn,4835,7,8,9,10,38,47,-9,33
Perth Glory,4835,8,10,2,15,37,50,-13,32
Wellington P,4835,9,5,6,16,31,55,-24,21
CC Mariners,4835,10,4,8,15,28,49,-21,20
Sydney FC,4836,1,21,4,3,67,24,43,67
N'castle Jet,4836,2,15,6,7,58,38,20,51
Melbourne C,4836,3,14,5,10,44,34,10,47
Melbourne V,4836,4,13,5,11,47,41,6,44
Adelaide Utd,4836,5,11,6,11,37,40,-3,39
Brisbane,4836,6,10,5,13,33,42,-9,35
Western Sydn,4836,7,8,9,10,38,47,-9,33
Perth Glory,4836,8,10,2,15,37,50,-13,32
Wellington P,4836,9,5,6,16,31,55,-24,21
CC Mariners,4836,10,4,8,15,28,49,-21,20
Sydney FC,4837,1,21,4,3,65,22,43,67
N'castle Jet,4837,2,15,5,8,58,40,18,50
Melbourne C,4837,3,15,4,10,46,34,12,49
Melbourne V,4837,4,13,5,11,45,39,6,44
Adelaide Utd,4837,5,11,6,11,37,40,-3,39
Brisbane,4837,6,10,5,13,33,42,-9,35
Western Sydn,4837,7,8,9,10,38,47,-9,33
Perth Glory,4837,8,10,2,15,37,50,-13,32
Wellington P,4837,9,5,6,16,31,55,-24,21
CC Mariners,4837,10,4,8,15,28,49,-21,20
Sydney FC,4838,1,20,5,3,65,23,42,65
N'castle Jet,4838,2,16,5,7,60,37,23,53
Melbourne C,4838,3,14,4,11,43,36,7,46
Melbourne V,4838,4,13,6,10,46,39,7,45
Adelaide Utd,4838,5,11,6,11,37,40,-3,39
Brisbane,4838,6,10,5,13,33,42,-9,35
Western Sydn,4838,7,8,9,10,38,47,-9,33
Perth Glory,4838,8,10,2,15,37,50,-13,32
Wellington P,4838,9,5,6,16,31,55,-24,21
CC Mariners,4838,10,4,8,15,28,49,-21,20
Sydney FC,4839,1,20,4,4,65,24,41,64
N'castle Jet,4839,2,16,5,7,60,38,22,53
Melbourne V,4839,3,14,5,10,47,39,8,47
Melbourne C,4839,4,14,4,11,44,36,8,46
Adelaide Utd,4839,5,11,6,11,37,40,-3,39
Brisbane,4839,6,10,5,13,33,42,-9,35
Western Sydn,4839,7,8,9,10,38,47,-9,33
Perth Glory,4839,8,10,2,15,37,50,-13,32
Wellington P,4839,9,5,6,16,31,55,-24,21
CC Mariners,4839,10,4,8,15,28,49,-21,20
Sydney FC,4840,1,20,4,4,65,24,41,64
N'castle Jet,4840,2,16,5,7,59,38,21,53
Melbourne V,4840,3,14,5,10,47,39,8,47
Melbourne C,4840,4,14,4,11,44,35,9,46
Adelaide Utd,4840,5,11,6,11,37,40,-3,39
Brisbane,4840,6,10,5,13,33,42,-9,35
Western Sydn,4840,7,8,9,10,38,47,-9,33
Perth Glory,4840,8,10,2,15,37,50,-13,32
Wellington P,4840,9,5,6,16,31,55,-24,21
CC Mariners,4840,10,4,8,15,28,49,-21,20
Sydney FC,4841,1,20,5,3,64,22,42,65
N'castle Jet,4841,2,16,5,7,60,38,22,53
Melbourne C,4841,3,14,4,11,44,36,8,46
Melbourne V,4841,4,13,6,10,45,38,7,45
Adelaide Utd,4841,5,11,6,11,37,40,-3,39
Brisbane,4841,6,10,5,13,33,42,-9,35
Western Sydn,4841,7,8,9,10,38,47,-9,33
Perth Glory,4841,8,10,2,15,37,50,-13,32
Wellington P,4841,9,5,6,16,31,55,-24,21
CC Mariners,4841,10,4,8,15,28,49,-21,20
Sydney FC,4842,1,20,5,3,67,25,42,65
N'castle Jet,4842,2,16,5,7,59,38,21,53
Melbourne C,4842,3,14,4,11,44,35,9,46
Melbourne V,4842,4,13,6,10,48,41,7,45
Adelaide Utd,4842,5,11,6,11,37,40,-3,39
Brisbane,4842,6,10,5,13,33,42,-9,35
Western Sydn,4842,7,8,9,10,38,47,-9,33
Perth Glory,4842,8,10,2,15,37,50,-13,32
Wellington P,4842,9,5,6,16,31,55,-24,21
CC Mariners,4842,10,4,8,15,28,49,-21,20
Sydney FC,4843,1,20,5,3,65,23,42,65
N'castle Jet,4843,2,16,5,7,58,37,21,53
Melbourne C,4843,3,14,4,11,43,34,9,46
Melbourne V,4843,4,13,6,10,46,39,7,45
Adelaide Utd,4843,5,11,6,11,37,40,-3,39
Brisbane,4843,6,10,5,13,33,42,-9,35
Western Sydn,4843,7,8,9,10,38,47,-9,33
Perth Glory,4843,8,10,2,15,37,50,-13,32
Wellington P,4843,9,5,6,16,31,55,-24,21
CC Mariners,4843,10,4,8,15,28,49,-21,20
Sydney FC,4844,1,21,4,3,66,23,43,67
N'castle Jet,4844,2,15,5,8,57,38,19,50
Melbourne C,4844,3,15,4,10,44,33,11,49
Melbourne V,4844,4,13,5,11,46,40,6,44
Adelaide Utd,4844,5,11,6,11,37,40,-3,39
Brisbane,4844,6,10,5,13,33,42,-9,35
Western Sydn,4844,7,8,9,10,38,47,-9,33
Perth Glory,4844,8,10,2,15,37,50,-13,32
Wellington P,4844,9,5,6,16,31,55,-24,21
CC Mariners,4844,10,4,8,15,28,49,-21,20
Sydney FC,4845,1,20,5,3,66,24,42,65
N'castle Jet,4845,2,16,5,7,58,37,21,53
Melbourne C,4845,3,14,4,11,43,34,9,46
Melbourne V,4845,4,13,6,10,47,40,7,45
Adelaide Utd,4845,5,11,6,11,37,40,-3,39
Brisbane,4845,6,10,5,13,33,42,-9,35
Western Sydn,4845,7,8,9,10,38,47,-9,33
Perth Glory,4845,8,10,2,15,37,50,-13,32
Wellington P,4845,9,5,6,16,31,55,-24,21
CC Mariners,4845,10,4,8,15,28,49,-21,20
Sydney FC,4846,1,20,4,4,64,24,40,64
N'castle Jet,4846,2,16,5,7,58,37,21,53
Melbourne V,4846,3,14,5,10,47,38,9,47
Melbourne C,4846,4,14,4,11,43,34,9,46
Adelaide Utd,4846,5,11,6,11,37,40,-3,39
Brisbane,4846,6,10,5,13,33,42,-9,35
Western Sydn,4846,7,8,9,10,38,47,-9,33
Perth Glory,4846,8,10,2,15,37,50,-13,32
Wellington P,4846,9,5,6,16,31,55,-24,21
CC Mariners,4846,10,4,8,15,28,49,-21,20
Sydney FC,4847,1,21,4,3,66,22,44,67
N'castle Jet,4847,2,15,5,8,58,40,18,50
Melbourne C,4847,3,15,4,10,46,34,12,49
Melbourne V,4847,4,13,5,11,45,40,5,44
Adelaide Utd,4847,5,11,6,11,37,40,-3,39
Brisbane,4847,6,10,5,13,33,42,-9,35
Western Sydn,4847,7,8,9,10,38,47,-9,33
Perth Glory,4847,8,10,2,15,37,50,-13,32
Wellington P,4847,9,5,6,16,31,55,-24,21
CC Mariners,4847,10,4,8,15,28,49,-21,20
Sydney FC,4848,1,20,4,4,64,24,40,64
N'castle Jet,4848,2,16,5,7,60,38,22,53
Melbourne V,4848,3,14,5,10,47,38,9,47
Melbourne C,4848,4,14,4,11,44,36,8,46
Adelaide Utd,4848,5,11,6,11,37,40,-3,39
Brisbane,4848,6,10,5,13,33,42,-9,35
Western Sydn,4848,7,8,9,10,38,47,-9,33
Perth Glory,4848,8,10,2,15,37,50,-13,32
Wellington P,4848,9,5,6,16,31,55,-24,21
CC Mariners,4848,10,4,8,15,28,49,-21,20
Sydney FC,4849,1,21,4,3,67,23,44,67
N'castle Jet,4849,2,15,6,7,60,40,20,51
Melbourne C,4849,3,14,5,10,46,36,10,47
Melbourne V,4849,4,13,5,11,46,41,5,44
Adelaide Utd,4849,5,11,6,11,37,40,-3,39
Brisbane,4849,6,10,5,13,33,42,-9,35
Western Sydn,4849,7,8,9,10,38,47,-9,33
Perth Glory,4849,8,10,2,15,37,50,-13,32
Wellington P,4849,9,5,6,16,31,55,-24,21
CC Mariners,4849,10,4,8,15,28,49,-21,20
Sydney FC,4850,1,21,4,3,66,22,44,67
N'castle Jet,4850,2,15,6,7,58,38,20,51
Melbourne C,4850,3,14,5,10,44,34,10,47
Melbourne V,4850,4,13,5,11,45,40,5,44
Adelaide Utd,4850,5,11,6,11,37,40,-3,39
Brisbane,4850,6,10,5,13,33,42,-9,35
Western Sydn,4850,7,8,9,10,38,47,-9,33
Perth Glory,4850,8,10,2,15,37,50,-13,32
Wellington P,4850,9,5,6,16,31,55,-24,21
CC Mariners,4850,10,4,8,15,28,49,-21,20
Sydney FC,4851,1,20,4,4,66,25,41,64
N'castle Jet,4851,2,16,5,7,58,37,21,53
Melbourne V,4851,3,14,5,10,48,40,8,47
Melbourne C,4851,4,14,4,11,43,34,9,46
Adelaide Utd,4851,5,11,6,11,37,40,-3,39
Brisbane,4851,6,10,5,13,33,42,-9,35
Western Sydn,4851,7,8,9,10,38,47,-9,33
Perth Glory,4851,8,10,2,15,37,50,-13,32
Wellington P,4851,9,5,6,16,31,55,-24,21
CC Mariners,4851,10,4,8,15,28,49,-21,20
Sydney FC,4852,1,20,5,3,65,23,42,65
N'castle Jet,4852,2,15,6,7,60,40,20,51
Melbourne C,4852,3,14,5,10,46,36,10,47
Melbourne V,4852,4,13,6,10,46,39,7,45
Adelaide Utd,4852,5,11,6,11,37,40,-3,39
Brisbane,4852,6,10,5,13,33,42,-9,35
Western Sydn,4852,7,8,9,10,38,47,-9,33
Perth Glory,4852,8,10,2,15,37,50,-13,32
Wellington P,4852,9,5,6,16,31,55,-24,21
CC Mariners,4852,10,4,8,15,28,49,-21,20
Sydney FC,4853,1,21,4,3,66,23,43,67
N'castle Jet,4853,2,15,6,7,57,37,20,51
Melbourne C,4853,3,14,5,10,43,33,10,47
Melbourne V,4853,4,13,5,11,46,40,6,44
Adelaide Utd,4853,5,11,6,11,37,40,-3,39
Brisbane,4853,6,10,5,13,33,42,-9,35
Western Sydn,4853,7,8,9,10,38,47,-9,33
Perth Glory,4853,8,10,2,15,37,50,-13,32
Wellington P,4853,9,5,6,16,31,55,-24,21
CC Mariners,4853,10,4,8,15,28,49,-21,20
Sydney FC,4854,1,20,5,3,65,23,42,65
N'castle Jet,4854,2,15,6,7,58,38,20,51
Melbourne C,4854,3,14,5,10,44,34,10,47
Melbourne V,4854,4,13,6,10,46,39,7,45
Adelaide Utd,4854,5,11,6,11,37,40,-3,39
Brisbane,4854,6,10,5,13,33,42,-9,35
Western Sydn,4854,7,8,9,10,38,47,-9,33
Perth Glory,4854,8,10,2,15,37,50,-13,32
Wellington P,4854,9,5,6,16,31,55,-24,21
CC Mariners,4854,10,4,8,15,28,49,-21,20
Sydney FC,4855,1,21,4,3,65,22,43,67
N'castle Jet,4855,2,16,5,7,59,38,21,53
Melbourne C,4855,3,14,4,11,44,35,9,46
Melbourne V,4855,4,13,5,11,45,39,6,44
Adelaide Utd,4855,5,11,6,11,37,40,-3,39
Brisbane,4855,6,10,5,13,33,42,-9,35
Western Sydn,4855,7,8,9,10,38,47,-9,33
Perth Glory,4855,8,10,2,15,37,50,-13,32
Wellington P,4855,9,5,6,16,31,55,-24,21
CC Mariners,4855,10,4,8,15,28,49,-21,20
Sydney FC,4856,1,20,4,4,66,25,41,64
N'castle Jet,4856,2,16,5,7,58,37,21,53
Melbourne V,4856,3,14,5,10,48,40,8,47
Melbourne C,4856,4,14,4,11,43,34,9,46
Adelaide Utd,4856,5,11,6,11,37,40,-3,39
Brisbane,4856,6,10,5,13,33,42,-9,35
Western Sydn,4856,7,8,9,10,38,47,-9,33
Perth Glory,4856,8,10,2,15,37,50,-13,32
Wellington P,4856,9,5,6,16,31,55,-24,21
CC Mariners,4856,10,4,8,15,28,49,-21,20
Sydney FC,4857,1,20,5,3,64,22,42,65
N'castle Jet,4857,2,16,5,7,58,37,21,53
Melbourne C,4857,3,14,4,11,43,34,9,46
Melbourne V,4857,4,13,6,10,45,38,7,45
Adelaide Utd,4857,5,11,6,11,37,40,-3,39
Brisbane,4857,6,10,5,13,33,42,-9,35
Western Sydn,4857,7,8,9,10,38,47,-9,33
Perth Glory,4857,8,10,2,15,37,50,-13,32
Wellington P,4857,9,5,6,16,31,55,-24,21
CC Mariners,4857,10,4,8,15,28,49,-21,20
Sydney FC,4858,1,20,5,3,64,22,42,65
N'castle Jet,4858,2,16,5,7,62,39,23,53
Melbourne C,4858,3,14,4,11,45,38,7,46
Melbourne V,4858,4,13,6,10,45,38,7,45
Adelaide Utd,4858,5,11,6,11,37,40,-3,39
Brisbane,4858,6,10,5,13,33,42,-9,35
Western Sydn,4858,7,8,9,10,38,47,-9,33
Perth Glory,4858,8,10,2,15,37,50,-13,32
Wellington P,4858,9,5,6,16,31,55,-24,21
CC Mariners,4858,10,4,8,15,28,49,-21,20
Sydney FC,4859,1,20,4,4,64,26,38,64
N'castle Jet,4859,2,16,5,7,58,37,21,53
Melbourne V,4859,3,14,5,10,49,38,11,47
Melbourne C,4859,4,14,4,11,43,34,9,46
Adelaide Utd,4859,5,11,6,11,37,40,-3,39
Brisbane,4859,6,10,5,13,33,42,-9,35
Western Sydn,4859,7,8,9,10,38,47,-9,33
Perth Glory,4859,8,10,2,15,37,50,-13,32
Wellington P,4859,9,5,6,16,31,55,-24,21
CC Mariners,4859,10,4,8,15,28,49,-21,20
Sydney FC,4860,1,21,4,3,67,22,45,67
N'castle Jet,4860,2,16,5,7,61,39,22,53
Melbourne C,4860,3,14,4,11,45,37,8,46
Melbourne V,4860,4,13,5,11,45,41,4,44
Adelaide Utd,4860,5,11,6,11,37,40,-3,39
Brisbane,4860,6,10,5,13,33,42,-9,35
Western Sydn,4860,7,8,9,10,38,47,-9,33
Perth Glory,4860,8,10,2,15,37,50,-13,32
Wellington P,4860,9,5,6,16,31,55,-24,21
CC Mariners,4860,10,4,8,15,28,49,-21,20
Sydney FC,4861,1,21,4,3,67,23,44,67
N'castle Jet,4861,2,15,5,8,58,39,19,50
Melbourne C,4861,3,15,4,10,45,34,11,49
Melbourne V,4861,4,13,5,11,46,41,5,44
Adelaide Utd,4861,5,11,6,11,37,40,-3,39
Brisbane,4861,6,10,5,13,33,42,-9,35
Western Sydn,4861,7,8,9,10,38,47,-9,33
Perth Glory,4861,8,10,2,15,37,50,-13,32
Wellington P,4861,9,5,6,16,31,55,-24,21
CC Mariners,4861,10,4,8,15,28,49,-21,20
Sydney FC,4862,1,20,4,4,65,24,41,64
N'castle Jet,4862,2,16,5,7,60,39,21,53
Melbourne V,4862,3,14,5,10,47,39,8,47
Melbourne C,4862,4,14,4,11,45,36,9,46
Adelaide Utd,4862,5,11,6,11,37,40,-3,39
Brisbane,4862,6,10,5,13,33,42,-9,35
Western Sydn,4862,7,8,9,10,38,47,-9,33
Perth Glory,4862,8,10,2,15,37,50,-13,32
Wellington P,4862,9,5,6,16,31,55,-24,21
CC Mariners,4862,10,4,8,15,28,49,-21,20
Sydney FC,4863,1,21,4,3,69,22,47,67
N'castle Jet,4863,2,16,5,7,63,38,25,53
Melbourne C,4863,3,14,4,11,44,39,5,46
Melbourne V,4863,4,13,5,11,45,43,2,44
Adelaide Utd,4863,5,11,6,11,37,40,-3,39
Brisbane,4863,6,10,5,13,33,42,-9,35
Western Sydn,4863,7,8,9,10,38,47,-9,33
Perth Glory,4863,8,10,2,15,37,50,-13,32
Wellington P,4863,9,5,6,16,31,55,-24,21
CC Mariners,4863,10,4,8,15,28,49,-21,20
Sydney FC,4864,1,21,4,3,68,24,44,67
N'castle Jet,4864,2,15,5,8,57,38,19,50
Melbourne C,4864,3,15,4,10,44,33,11,49
Melbourne V,4864,4,13,5,11,47,42,5,44
Adelaide Utd,4864,5,11,6,11,37,40,-3,39
Brisbane,4864,6,10,5,13,33,42,-9,35
Western Sydn,4864,7,8,9,10,38,47,-9,33
Perth Glory,4864,8,10,2,15,37,50,-13,32
Wellington P,4864,9,5,6,16,31,55,-24,21
CC Mariners,4864,10,4,8,15,28,49,-21,20
Sydney FC,4865,1,21,4,3,66,22,44,67
N'castle Jet,4865,2,16,5,7,60,39,21,53
Melbourne C,4865,3,14,4,11,45,36,9,46
Melbourne V,4865,4,13,5,11,45,40,5,44
Adelaide Utd,4865,5,11,6,11,37,40,-3,39
Brisbane,4865,6,10,5,13,33,42,-9,35
Western Sydn,4865,7,8,9,10,38,47,-9,33
Perth Glory,4865,8,10,2,15,37,50,-13,32
Wellington P,4865,9,5,6,16,31,55,-24,21
CC Mariners,4865,10,4,8,15,28,49,-21,20
Sydney FC,4866,1,20,5,3,64,22,42,65
N'castle Jet,4866,2,16,5,7,60,38,22,53
Melbourne C,4866,3,14,4,11,44,36,8,46
Melbourne V,4866,4,13,6,10,45,38,7,45
Adelaide Utd,4866,5,11,6,11,37,40,-3,39
Brisbane,4866,6,10,5,13,33,42,-9,35
Western Sydn,4866,7,8,9,10,38,47,-9,33
Perth Glory,4866,8,10,2,15,37,50,-13,32
Wellington P,4866,9,5,6,16,31,55,-24,21
CC Mariners,4866,10,4,8,15,28,49,-21,20
Sydney FC,4867,1,21,4,3,65,22,43,67
N'castle Jet,4867,2,15,5,8,57,38,19,50
Melbourne C,4867,3,15,4,10,44,33,11,49
Melbourne V,4867,4,13,5,11,45,39,6,44
Adelaide Utd,4867,5,11,6,11,37,40,-3,39
Brisbane,4867,6,10,5,13,33,42,-9,35
Western Sydn,4867,7,8,9,10,38,47,-9,33
Perth Glory,4867,8,10,2,15,37,50,-13,32
Wellington P,4867,9,5,6,16,31,55,-24,21
CC Mariners,4867,10,4,8,15,28,49,-21,20
Sydney FC,4868,1,20,4,4,64,23,41,64
N'castle Jet,4868,2,16,5,7,59,38,21,53
Melbourne V,4868,3,14,5,10,46,38,8,47
Melbourne C,4868,4,14,4,11,44,35,9,46
Adelaide Utd,4868,5,11,6,11,37,40,-3,39
Brisbane,4868,6,10,5,13,33,42,-9,35
Western Sydn,4868,7,8,9,10,38,47,-9,33
Perth Glory,4868,8,10,2,15,37,50,-13,32
Wellington P,4868,9,5,6,16,31,55,-24,21
CC Mariners,4868,10,4,8,15,28,49,-21,20
Sydney FC,4869,1,20,4,4,64,23,41,64
N'castle Jet,4869,2,16,5,7,59,37,22,53
Melbourne V,4869,3,14,5,10,46,38,8,47
Melbourne C,4869,4,14,4,11,43,35,8,46
Adelaide Utd,4869,5,11,6,11,37,40,-3,39
Brisbane,4869,6,10,5,13,33,42,-9,35
Western Sydn,4869,7,8,9,10,38,47,-9,33
Perth Glory,4869,8,10,2,15,37,50,-13,32
Wellington P,4869,9,5,6,16,31,55,-24,21
CC Mariners,4869,10,4,8,15,28,49,-21,20
Sydney FC,4870,1,21,4,3,67,23,44,67
N'castle Jet,4870,2,15,6,7,58,38,20,51
Melbourne C,4870,3,14,5,10,44,34,10,47
Melbourne V,4870,4,13,5,11,46,41,5,44
Adelaide Utd,4870,5,11,6,11,37,40,-3,39
Brisbane,4870,6,10,5,13,33,42,-9,35
Western Sydn,4870,7,8,9,10,38,47,-9,33
Perth Glory,4870,8,10,2,15,37,50,-13,32
Wellington P,4870,9,5,6,16,31,55,-24,21
CC Mariners,4870,10,4,8,15,28,49,-21,20
Sydney FC,4871,1,20,4,4,64,23,41,64
N'castle Jet,4871,2,16,5,7,58,37,21,53
Melbourne V,4871,3,14,5,10,46,38,8,47
Melbourne C,4871,4,14,4,11,43,34,9,46
Adelaide Utd,4871,5,11,6,11,37,40,-3,39
Brisbane,4871,6,10,5,13,33,42,-9,35
Western Sydn,4871,7,8,9,10,38,47,-9,33
Perth Glory,4871,8,10,2,15,37,50,-13,32
Wellington P,4871,9,5,6,16,31,55,-24,21
CC Mariners,4871,10,4,8,15,28,49,-21,20
Sydney FC,4872,1,21,4,3,68,22,46,67
N'castle Jet,4872,2,15,5,8,58,40,18,50
Melbourne C,4872,3,15,4,10,46,34,12,49
Melbourne V,4872,4,13,5,11,45,42,3,44
Adelaide Utd,4872,5,11,6,11,37,40,-3,39
Brisbane,4872,6,10,5,13,33,42,-9,35
Western Sydn,4872,7,8,9,10,38,47,-9,33
Perth Glory,4872,8,10,2,15,37,50,-13,32
Wellington P,4872,9,5,6,16,31,55,-24,21
CC Mariners,4872,10,4,8,15,28,49,-21,20
Sydney FC,4873,1,21,4,3,66,23,43,67
N'castle Jet,4873,2,16,5,7,58,37,21,53
Melbourne C,4873,3,14,4,11,43,34,9,46
Melbourne V,4873,4,13,5,11,46,40,6,44
Adelaide Utd,4873,5,11,6,11,37,40,-3,39
Brisbane,4873,6,10,5,13,33,42,-9,35
Western Sydn,4873,7,8,9,10,38,47,-9,33
Perth Glory,4873,8,10,2,15,37,50,-13,32
Wellington P,4873,9,5,6,16,31,55,-24,21
CC Mariners,4873,10,4,8,15,28,49,-21,20
Sydney FC,4874,1,21,4,3,71,22,49,67
N'castle Jet,4874,2,15,6,7,59,39,20,51
Melbourne C,4874,3,14,5,10,45,35,10,47
Melbourne V,4874,4,13,5,11,45,45,0,44
Adelaide Utd,4874,5,11,6,11,37,40,-3,39
Brisbane,4874,6,10,5,13,33,42,-9,35
Western Sydn,4874,7,8,9,10,38,47,-9,33
Perth Glory,4874,8,10,2,15,37,50,-13,32
Wellington P,4874,9,5,6,16,31,55,-24,21
CC Mariners,4874,10,4,8,15,28,49,-21,20
Sydney FC,4875,1,20,4,4,66,25,41,64
N'castle Jet,4875,2,16,5,7,62,38,24,53
Melbourne V,4875,3,14,5,10,48,40,8,47
Melbourne C,4875,4,14,4,11,44,38,6,46
Adelaide Utd,4875,5,11,6,11,37,40,-3,39
Brisbane,4875,6,10,5,13,33,42,-9,35
Western Sydn,4875,7,8,9,10,38,47,-9,33
Perth Glory,4875,8,10,2,15,37,50,-13,32
Wellington P,4875,9,5,6,16,31,55,-24,21
CC Mariners,4875,10,4,8,15,28,49,-21,20
Sydney FC,4876,1,20,5,3,65,23,42,65
N'castle Jet,4876,2,15,6,7,58,38,20,51
Melbourne C,4876,3,14,5,10,44,34,10,47
Melbourne V,4876,4,13,6,10,46,39,7,45
Adelaide Utd,4876,5,11,6,11,37,40,-3,39
Brisbane,4876,6,10,5,13,33,42,-9,35
Western Sydn,4876,7,8,9,10,38,47,-9,33
Perth Glory,4876,8,10,2,15,37,50,-13,32
Wellington P,4876,9,5,6,16,31,55,-24,21
CC Mariners,4876,10,4,8,15,28,49,-21,20
Sydney FC,4877,1,21,4,3,67,22,45,67
N'castle Jet,4877,2,15,5,8,58,39,19,50
Melbourne C,4877,3,15,4,10,45,34,11,49
Melbourne V,4877,4,13,5,11,45,41,4,44
Adelaide Utd,4877,5,11,6,11,37,40,-3,39
Brisbane,4877,6,10,5,13,33,42,-9,35
Western Sydn,4877,7,8,9,10,38,47,-9,33
Perth Glory,4877,8,10,2,15,37,50,-13,32
Wellington P,4877,9,5,6,16,31,55,-24,21
CC Mariners,4877,10,4,8,15,28,49,-21,20
Sydney FC,4878,1,20,5,3,67,25,42,65
N'castle Jet,4878,2,16,5,7,59,37,22,53
Melbourne C,4878,3,14,4,11,43,35,8,46
Melbourne V,4878,4,13,6,10,48,41,7,45
Adelaide Utd,4878,5,11,6,11,37,40,-3,39
Brisbane,4878,6,10,5,13,33,42,-9,35
Western Sydn,4878,7,8,9,10,38,47,-9,33
Perth Glory,4878,8,10,2,15,37,50,-13,32
Wellington P,4878,9,5,6,16,31,55,-24,21
CC Mariners,4878,10,4,8,15,28,49,-21,20
Sydney FC,4879,1,21,4,3,66,22,44,67
N'castle Jet,4879,2,16,5,7,59,37,22,53
Melbourne C,4879,3,14,4,11,43,35,8,46
Melbourne V,4879,4,13,5,11,45,40,5,44
Adelaide Utd,4879,5,11,6,11,37,40,-3,39
Brisbane,4879,6,10,5,13,33,42,-9,35
Western Sydn,4879,7,8,9,10,38,47,-9,33
Perth Glory,4879,8,10,2,15,37,50,-13,32
Wellington P,4879,9,5,6,16,31,55,-24,21
CC Mariners,4879,10,4,8,15,28,49,-21,20
Sydney FC,4880,1,21,4,3,67,22,45,67
N'castle Jet,4880,2,16,5,7,60,38,22,53
Melbourne C,4880,3,14,4,11,44,36,8,46
Melbourne V,4880,4,13,5,11,45,41,4,44
Adelaide Utd,4880,5,11,6,11,37,40,-3,39
Brisbane,4880,6,10,5,13,33,42,-9,35
Western Sydn,4880,7,8,9,10,38,47,-9,33
Perth Glory,4880,8,10,2,15,37,50,-13,32
Wellington P,4880,9,5,6,16,31,55,-24,21
CC Mariners,4880,10,4,8,15,28,49,-21,20
Sydney FC,4881,1,20,5,3,67,25,42,65
N'castle Jet,4881,2,15,5,8,58,39,19,50
Melbourne C,4881,3,15,4,10,45,34,11,49
Melbourne V,4881,4,13,6,10,48,41,7,45
Adelaide Utd,4881,5,11,6,11,37,40,-3,39
Brisbane,4881,6,10,5,13,33,42,-9,35
Western Sydn,4881,7,8,9,10,38,47,-9,33
Perth Glory,4881,8,10,2,15,37,50,-13,32
Wellington P,4881,9,5,6,16,31,55,-24,21
CC Mariners,4881,10,4,8,15,28,49,-21,20
Sydney FC,4882,1,21,4,3,68,23,45,67
N'castle Jet,4882,2,16,5,7,59,37,22,53
Melbourne C,4882,3,14,4,11,43,35,8,46
Melbourne V,4882,4,13,5,11,46,42,4,44
Adelaide Utd,4882,5,11,6,11,37,40,-3,39
Brisbane,4882,6,10,5,13,33,42,-9,35
Western Sydn,4882,7,8,9,10,38,47,-9,33
Perth Glory,4882,8,10,2,15,37,50,-13,32
Wellington P,4882,9,5,6,16,31,55,-24,21
CC Mariners,4882,10,4,8,15,28,49,-21,20
Sydney FC,4883,1,21,4,3,68,22,46,67
N'castle Jet,4883,2,16,5,7,60,37,23,53
Melbourne C,4883,3,14,4,11,43,36,7,46
Melbourne V,4883,4,13,5,11,45,42,3,44
Adelaide Utd,4883,5,11,6,11,37,40,-3,39
Brisbane,4883,6,10,5,13,33,42,-9,35
Western Sydn,4883,7,8,9,10,38,47,-9,33
Perth Glory,4883,8,10,2,15,37,50,-13,32
Wellington P,4883,9,5,6,16,31,55,-24,21
CC Mariners,4883,10,4,8,15,28,49,-21,20
Sydney FC,4884,1,21,4,3,70,22,48,67
N'castle Jet,4884,2,15,5,8,57,39,18,50
Melbourne C,4884,3,15,4,10,45,33,12,49
Melbourne V,4884,4,13,5,11,45,44,1,44
Adelaide Utd,4884,5,11,6,11,37,40,-3,39
Brisbane,4884,6,10,5,13,33,42,-9,35
Western Sydn,4884,7,8,9,10,38,47,-9,33
Perth Glory,4884,8,10,2,15,37,50,-13,32
Wellington P,4884,9,5,6,16,31,55,-24,21
CC Mariners,4884,10,4,8,15,28,49,-21,20
Sydney FC,4885,1,21,4,3,67,22,45,67
N'castle Jet,4885,2,15,6,7,59,39,20,51
Melbourne C,4885,3,14,5,10,45,35,10,47
Melbourne V,4885,4,13,5,11,45,41,4,44
Adelaide Utd,4885,5,11,6,11,37,40,-3,39
Brisbane,4885,6,10,5,13,33,42,-9,35
Western Sydn,4885,7,8,9,10,38,47,-9,33
Perth Glory,4885,8,10,2,15,37,50,-13,32
Wellington P,4885,9,5,6,16,31,55,-24,21
CC Mariners,4885,10,4,8,15,28,49,-21,20
Sydney FC,4886,1,21,4,3,68,25,43,67
N'castle Jet,4886,2,15,6,7,58,38,20,51
Melbourne C,4886,3,14,5,10,44,34,10,47
Melbourne V,4886,4,13,5,11,48,42,6,44
Adelaide Utd,4886,5,11,6,11,37,40,-3,39
Brisbane,4886,6,10,5,13,33,42,-9,35
Western Sydn,4886,7,8,9,10,38,47,-9,33
Perth Glory,4886,8,10,2,15,37,50,-13,32
Wellington P,4886,9,5,6,16,31,55,-24,21
CC Mariners,4886,10,4,8,15,28,49,-21,20
Sydney FC,4887,1,21,4,3,67,23,44,67
N'castle Jet,4887,2,16,5,7,58,37,21,53
Melbourne C,4887,3,14,4,11,43,34,9,46
Melbourne V,4887,4,13,5,11,46,41,5,44
Adelaide Utd,4887,5,11,6,11,37,40,-3,39
Brisbane,4887,6,10,5,13,33,42,-9,35
Western Sydn,4887,7,8,9,10,38,47,-9,33
Perth Glory,4887,8,10,2,15,37,50,-13,32
Wellington P,4887,9,5,6,16,31,55,-24,21
CC Mariners,4887,10,4,8,15,28,49,-21,20
Sydney FC,4888,1,20,5,3,66,24,42,65
N'castle Jet,4888,2,16,5,7,59,38,21,53
Melbourne C,4888,3,14,4,11,44,35,9,46
Melbourne V,4888,4,13,6,10,47,40,7,45
Adelaide Utd,4888,5,11,6,11,37,40,-3,39
Brisbane,4888,6,10,5,13,33,42,-9,35
Western Sydn,4888,7,8,9,10,38,47,-9,33
Perth Glory,4888,8,10,2,15,37,50,-13,32
Wellington P,4888,9,5,6,16,31,55,-24,21
CC Mariners,4888,10,4,8,15,28,49,-21,20
Sydney FC,4889,1,21,4,3,66,22,44,67
N'castle Jet,4889,2,16,5,7,60,37,23,53
Melbourne C,4889,3,14,4,11,43,36,7,46
Melbourne V,4889,4,13,5,11,45,40,5,44
Adelaide Utd,4889,5,11,6,11,37,40,-3,39
Brisbane,4889,6,10,5,13,33,42,-9,35
Western Sydn,4889,7,8,9,10,38,47,-9,33
Perth Glory,4889,8,10,2,15,37,50,-13,32
Wellington P,4889,9,5,6,16,31,55,-24,21
CC Mariners,4889,10,4,8,15,28,49,-21,20
Sydney FC,4890,1,21,4,3,66,22,44,67
N'castle Jet,4890,2,16,5,7,59,37,22,53
Melbourne C,4890,3,14,4,11,43,35,8,46
Melbourne V,4890,4,13,5,11,45,40,5,44
Adelaide Utd,4890,5,11,6,11,37,40,-3,39
Brisbane,4890,6,10,5,13,33,42,-9,35
Western Sydn,4890,7,8,9,10,38,47,-9,33
Perth Glory,4890,8,10,2,15,37,50,-13,32
Wellington P,4890,9,5,6,16,31,55,-24,21
CC Mariners,4890,10,4,8,15,28,49,-21,20
Sydney FC,4891,1,21,4,3,71,23,48,67
N'castle Jet,4891,2,16,5,7,59,38,21,53
Melbourne C,4891,3,14,4,11,44,35,9,46
Melbourne V,4891,4,13,5,11,46,45,1,44
Adelaide Utd,4891,5,11,6,11,37,40,-3,39
Brisbane,4891,6,10,5,13,33,42,-9,35
Western Sydn,4891,7,8,9,10,38,47,-9,33
Perth Glory,4891,8,10,2,15,37,50,-13,32
Wellington P,4891,9,5,6,16,31,55,-24,21
CC Mariners,4891,10,4,8,15,28,49,-21,20
Sydney FC,4892,1,21,4,3,66,23,43,67
N'castle Jet,4892,2,16,5,7,60,38,22,53
Melbourne C,4892,3,14,4,11,44,36,8,46
Melbourne V,4892,4,13,5,11,46,40,6,44
Adelaide Utd,4892,5,11,6,11,37,40,-3,39
Brisbane,4892,6,10,5,13,33,42,-9,35
Western Sydn,4892,7,8,9,10,38,47,-9,33
Perth Glory,4892,8,10,2,15,37,50,-13,32
Wellington P,4892,9,5,6,16,31,55,-24,21
CC Mariners,4892,10,4,8,15,28,49,-21,20
Sydney FC,4893,1,21,4,3,67,22,45,67
N'castle Jet,4893,2,16,5,7,61,37,24,53
Melbourne C,4893,3,14,4,11,43,37,6,46
Melbourne V,4893,4,13,5,11,45,41,4,44
Adelaide Utd,4893,5,11,6,11,37,40,-3,39
Brisbane,4893,6,10,5,13,33,42,-9,35
Western Sydn,4893,7,8,9,10,38,47,-9,33
Perth Glory,4893,8,10,2,15,37,50,-13,32
Wellington P,4893,9,5,6,16,31,55,-24,21
CC Mariners,4893,10,4,8,15,28,49,-21,20
Sydney FC,4894,1,20,4,4,65,25,40,64
N'castle Jet,4894,2,16,5,7,60,39,21,53
Melbourne V,4894,3,14,5,10,48,39,9,47
Melbourne C,4894,4,14,4,11,45,36,9,46
Adelaide Utd,4894,5,11,6,11,37,40,-3,39
Brisbane,4894,6,10,5,13,33,42,-9,35
Western Sydn,4894,7,8,9,10,38,47,-9,33
Perth Glory,4894,8,10,2,15,37,50,-13,32
Wellington P,4894,9,5,6,16,31,55,-24,21
CC Mariners,4894,10,4,8,15,28,49,-21,20
Sydney FC,4895,1,21,4,3,66,22,44,67
N'castle Jet,4895,2,15,6,7,58,38,20,51
Melbourne C,4895,3,14,5,10,44,34,10,47
Melbourne V,4895,4,13,5,11,45,40,5,44
Adelaide Utd,4895,5,11,6,11,37,40,-3,39
Brisbane,4895,6,10,5,13,33,42,-9,35
Western Sydn,4895,7,8,9,10,38,47,-9,33
Perth Glory,4895,8,10,2,15,37,50,-13,32
Wellington P,4895,9,5,6,16,31,55,-24,21
CC Mariners,4895,10,4,8,15,28,49,-21,20
Sydney FC,4896,1,21,4,3,67,23,44,67
N'castle Jet,4896,2,15,6,7,57,37,20,51
Melbourne C,4896,3,14,5,10,43,33,10,47
Melbourne V,4896,4,13,5,11,46,41,5,44
Adelaide Utd,4896,5,11,6,11,37,40,-3,39
Brisbane,4896,6,10,5,13,33,42,-9,35
Western Sydn,4896,7,8,9,10,38,47,-9,33
Perth Glory,4896,8,10,2,15,37,50,-13,32
Wellington P,4896,9,5,6,16,31,55,-24,21
CC Mariners,4896,10,4,8,15,28,49,-21,20
Sydney FC,4897,1,21,4,3,66,22,44,67
N'castle Jet,4897,2,16,5,7,59,38,21,53
Melbourne C,4897,3,14,4,11,44,35,9,46
Melbourne V,4897,4,13,5,11,45,40,5,44
Adelaide Utd,4897,5,11,6,11,37,40,-3,39
Brisbane,4897,6,10,5,13,33,42,-9,35
Western Sydn,4897,7,8,9,10,38,47,-9,33
Perth Glory,4897,8,10,2,15,37,50,-13,32
Wellington P,4897,9,5,6,16,31,55,-24,21
CC Mariners,4897,10,4,8,15,28,49,-21,20
Sydney FC,4898,1,21,4,3,67,22,45,67
N'castle Jet,4898,2,15,6,7,59,39,20,51
Melbourne C,4898,3,14,5,10,45,35,10,47
Melbourne V,4898,4,13,5,11,45,41,4,44
Adelaide Utd,4898,5,11,6,11,37,40,-3,39
Brisbane,4898,6,10,5,13,33,42,-9,35
Western Sydn,4898,7,8,9,10,38,47,-9,33
Perth Glory,4898,8,10,2,15,37,50,-13,32
Wellington P,4898,9,5,6,16,31,55,-24,21
CC Mariners,4898,10,4,8,15,28,49,-21,20
Sydney FC,4899,1,20,4,4,64,23,41,64
N'castle Jet,4899,2,16,5,7,61,39,22,53
Melbourne V,4899,3,14,5,10,46,38,8,47
Melbourne C,4899,4,14,4,11,45,37,8,46
Adelaide Utd,4899,5,11,6,11,37,40,-3,39
Brisbane,4899,6,10,5,13,33,42,-9,35
Western Sydn,4899,7,8,9,10,38,47,-9,33
Perth Glory,4899,8,10,2,15,37,50,-13,32
Wellington P,4899,9,5,6,16,31,55,-24,21
CC Mariners,4899,10,4,8,15,28,49,-21,20
Sydney FC,4900,1,20,5,3,65,23,42,65
N'castle Jet,4900,2,16,5,7,59,38,21,53
Melbourne C,4900,3,14,4,11,44,35,9,46
Melbourne V,4900,4,13,6,10,46,39,7,45
Adelaide Utd,4900,5,11,6,11,37,40,-3,39
Brisbane,4900,6,10,5,13,33,42,-9,35
Western Sydn,4900,7,8,9,10,38,47,-9,33
Perth Glory,4900,8,10,2,15,37,50,-13,32
Wellington P,4900,9,5,6,16,31,55,-24,21
CC Mariners,4900,10,4,8,15,28,49,-21,20
Sydney FC,4901,1,20,4,4,64,23,41,64
N'castle Jet,4901,2,16,5,7,60,38,22,53
Melbourne V,4901,3,14,5,10,46,38,8,47
Melbourne C,4901,4,14,4,11,44,36,8,46
Adelaide Utd,4901,5,11,6,11,37,40,-3,39
Brisbane,4901,6,10,5,13,33,42,-9,35
Western Sydn,4901,7,8,9,10,38,47,-9,33
Perth Glory,4901,8,10,2,15,37,50,-13,32
Wellington P,4901,9,5,6,16,31,55,-24,21
CC Mariners,4901,10,4,8,15,28,49,-21,20
Sydney FC,4902,1,21,4,3,66,22,44,67
N'castle Jet,4902,2,15,6,7,57,37,20,51
Melbourne C,4902,3,14,5,10,43,33,10,47
Melbourne V,4902,4,13,5,11,45,40,5,44
Adelaide Utd,4902,5,11,6,11,37,40,-3,39
Brisbane,4902,6,10,5,13,33,42,-9,35
Western Sydn,4902,7,8,9,10,38,47,-9,33
Perth Glory,4902,8,10,2,15,37,50,-13,32
Wellington P,4902,9,5,6,16,31,55,-24,21
CC Mariners,4902,10,4,8,15,28,49,-21,20
Sydney FC,4903,1,21,4,3,66,22,44,67
N'castle Jet,4903,2,16,5,7,60,38,22,53
Melbourne C,4903,3,14,4,11,44,36,8,46
Melbourne V,4903,4,13,5,11,45,40,5,44
Adelaide Utd,4903,5,11,6,11,37,40,-3,39
Brisbane,4903,6,10,5,13,33,42,-9,35
Western Sydn,4903,7,8,9,10,38,47,-9,33
Perth Glory,4903,8,10,2,15,37,50,-13,32
Wellington P,4903,9,5,6,16,31,55,-24,21
CC Mariners,4903,10,4,8,15,28,49,-21,20
Sydney FC,4904,1,20,4,4,64,24,40,64
N'castle Jet,4904,2,15,6,7,59,39,20,51
Melbourne C,4904,3,14,5,10,45,35,10,47
Melbourne V,4904,4,14,5,10,47,38,9,47
Adelaide Utd,4904,5,11,6,11,37,40,-3,39
Brisbane,4904,6,10,5,13,33,42,-9,35
Western Sydn,4904,7,8,9,10,38,47,-9,33
Perth Glory,4904,8,10,2,15,37,50,-13,32
Wellington P,4904,9,5,6,16,31,55,-24,21
CC Mariners,4904,10,4,8,15,28,49,-21,20
Sydney FC,4905,1,20,5,3,64,22,42,65
N'castle Jet,4905,2,16,5,7,60,39,21,53
Melbourne C,4905,3,14,4,11,45,36,9,46
Melbourne V,4905,4,13,6,10,45,38,7,45
Adelaide Utd,4905,5,11,6,11,37,40,-3,39
Brisbane,4905,6,10,5,13,33,42,-9,35
Western Sydn,4905,7,8,9,10,38,47,-9,33
Perth Glory,4905,8,10,2,15,37,50,-13,32
Wellington P,4905,9,5,6,16,31,55,-24,21
CC Mariners,4905,10,4,8,15,28,49,-21,20
Sydney FC,4906,1,21,4,3,66,22,44,67
N'castle Jet,4906,2,16,5,7,58,37,21,53
Melbourne C,4906,3,14,4,11,43,34,9,46
Melbourne V,4906,4,13,5,11,45,40,5,44
Adelaide Utd,4906,5,11,6,11,37,40,-3,39
Brisbane,4906,6,10,5,13,33,42,-9,35
Western Sydn,4906,7,8,9,10,38,47,-9,33
Perth Glory,4906,8,10,2,15,37,50,-13,32
Wellington P,4906,9,5,6,16,31,55,-24,21
CC Mariners,4906,10,4,8,15,28,49,-21,20
Sydney FC,4907,1,21,4,3,66,23,43,67
N'castle Jet,4907,2,16,5,7,58,37,21,53
Melbourne C,4907,3,14,4,11,43,34,9,46
Melbourne V,4907,4,13,5,11,46,40,6,44
Adelaide Utd,4907,5,11,6,11,37,40,-3,39
Brisbane,4907,6,10,5,13,33,42,-9,35
Western Sydn,4907,7,8,9,10,38,47,-9,33
Perth Glory,4907,8,10,2,15,37,50,-13,32
Wellington P,4907,9,5,6,16,31,55,-24,21
CC Mariners,4907,10,4,8,15,28,49,-21,20
Sydney FC,4908,1,21,4,3,68,23,45,67
N'castle Jet,4908,2,15,6,7,59,39,20,51
Melbourne C,4908,3,14,5,10,45,35,10,47
Melbourne V,4908,4,13,5,11,46,42,4,44
Adelaide Utd,4908,5,11,6,11,37,40,-3,39
Brisbane,4908,6,10,5,13,33,42,-9,35
Western Sydn,4908,7,8,9,10,38,47,-9,33
Perth Glory,4908,8,10,2,15,37,50,-13,32
Wellington P,4908,9,5,6,16,31,55,-24,21
CC Mariners,4908,10,4,8,15,28,49,-21,20
Sydney FC,4909,1,20,5,3,65,23,42,65
N'castle Jet,4909,2,16,5,7,59,38,21,53
Melbourne C,4909,3,14,4,11,44,35,9,46
Melbourne V,4909,4,13,6,10,46,39,7,45
Adelaide Utd,4909,5,11,6,11,37,40,-3,39
Brisbane,4909,6,10,5,13,33,42,-9,35
Western Sydn,4909,7,8,9,10,38,47,-9,33
Perth Glory,4909,8,10,2,15,37,50,-13,32
Wellington P,4909,9,5,6,16,31,55,-24,21
CC Mariners,4909,10,4,8,15,28,49,-21,20
Sydney FC,4910,1,21,4,3,68,22,46,67
N'castle Jet,4910,2,15,5,8,59,40,19,50
Melbourne C,4910,3,15,4,10,46,35,11,49
Melbourne V,4910,4,13,5,11,45,42,3,44
Adelaide Utd,4910,5,11,6,11,37,40,-3,39
Brisbane,4910,6,10,5,13,33,42,-9,35
Western Sydn,4910,7,8,9,10,38,47,-9,33
Perth Glory,4910,8,10,2,15,37,50,-13,32
Wellington P,4910,9,5,6,16,31,55,-24,21
CC Mariners,4910,10,4,8,15,28,49,-21,20
Sydney FC,4911,1,20,5,3,65,23,42,65
N'castle Jet,4911,2,16,5,7,61,37,24,53
Melbourne C,4911,3,14,4,11,43,37,6,46
Melbourne V,4911,4,13,6,10,46,39,7,45
Adelaide Utd,4911,5,11,6,11,37,40,-3,39
Brisbane,4911,6,10,5,13,33,42,-9,35
Western Sydn,4911,7,8,9,10,38,47,-9,33
Perth Glory,4911,8,10,2,15,37,50,-13,32
Wellington P,4911,9,5,6,16,31,55,-24,21
CC Mariners,4911,10,4,8,15,28,49,-21,20
Sydney FC,4912,1,21,4,3,67,24,43,67
N'castle Jet,4912,2,16,5,7,59,38,21,53
Melbourne C,4912,3,14,4,11,44,35,9,46
Melbourne V,4912,4,13,5,11,47,41,6,44
Adelaide Utd,4912,5,11,6,11,37,40,-3,39
Brisbane,4912,6,10,5,13,33,42,-9,35
Western Sydn,4912,7,8,9,10,38,47,-9,33
Perth Glory,4912,8,10,2,15,37,50,-13,32
Wellington P,4912,9,5,6,16,31,55,-24,21
CC Mariners,4912,10,4,8,15,28,49,-21,20
Sydney FC,4913,1,21,4,3,68,23,45,67
N'castle Jet,4913,2,16,5,7,60,37,23,53
Melbourne C,4913,3,14,4,11,43,36,7,46
Melbourne V,4913,4,13,5,11,46,42,4,44
Adelaide Utd,4913,5,11,6,11,37,40,-3,39
Brisbane,4913,6,10,5,13,33,42,-9,35
Western Sydn,4913,7,8,9,10,38,47,-9,33
Perth Glory,4913,8,10,2,15,37,50,-13,32
Wellington P,4913,9,5,6,16,31,55,-24,21
CC Mariners,4913,10,4,8,15,28,49,-21,20
Sydney FC,4914,1,21,4,3,67,23,44,67
N'castle Jet,4914,2,16,5,7,60,37,23,53
Melbourne C,4914,3,14,4,11,43,36,7,46
Melbourne V,4914,4,13,5,11,46,41,5,44
Adelaide Utd,4914,5,11,6,11,37,40,-3,39
Brisbane,4914,6,10,5,13,33,42,-9,35
Western Sydn,4914,7,8,9,10,38,47,-9,33
Perth Glory,4914,8,10,2,15,37,50,-13,32
Wellington P,4914,9,5,6,16,31,55,-24,21
CC Mariners,4914,10,4,8,15,28,49,-21,20
Sydney FC,4915,1,21,4,3,66,22,44,67
N'castle Jet,4915,2,16,5,7,59,37,22,53
Melbourne C,4915,3,14,4,11,43,35,8,46
Melbourne V,4915,4,13,5,11,45,40,5,44
Adelaide Utd,4915,5,11,6,11,37,40,-3,39
Brisbane,4915,6,10,5,13,33,42,-9,35
Western Sydn,4915,7,8,9,10,38,47,-9,33
Perth Glory,4915,8,10,2,15,37,50,-13,32
Wellington P,4915,9,5,6,16,31,55,-24,21
CC Mariners,4915,10,4,8,15,28,49,-21,20
Sydney FC,4916,1,21,4,3,69,22,47,67
N'castle Jet,4916,2,15,6,7,59,39,20,51
Melbourne C,4916,3,14,5,10,45,35,10,47
Melbourne V,4916,4,13,5,11,45,43,2,44
Adelaide Utd,4916,5,11,6,11,37,40,-3,39
Brisbane,4916,6,10,5,13,33,42,-9,35
Western Sydn,4916,7,8,9,10,38,47,-9,33
Perth Glory,4916,8,10,2,15,37,50,-13,32
Wellington P,4916,9,5,6,16,31,55,-24,21
CC Mariners,4916,10,4,8,15,28,49,-21,20
Sydney FC,4917,1,20,5,3,64,22,42,65
N'castle Jet,4917,2,16,5,7,59,37,22,53
Melbourne C,4917,3,14,4,11,43,35,8,46
Melbourne V,4917,4,13,6,10,45,38,7,45
Adelaide Utd,4917,5,11,6,11,37,40,-3,39
Brisbane,4917,6,10,5,13,33,42,-9,35
Western Sydn,4917,7,8,9,10,38,47,-9,33
Perth Glory,4917,8,10,2,15,37,50,-13,32
Wellington P,4917,9,5,6,16,31,55,-24,21
CC Mariners,4917,10,4,8,15,28,49,-21,20
Sydney FC,4918,1,21,4,3,68,23,45,67
N'castle Jet,4918,2,15,5,8,58,40,18,50
Melbourne C,4918,3,15,4,10,46,34,12,49
Melbourne V,4918,4,13,5,11,46,42,4,44
Adelaide Utd,4918,5,11,6,11,37,40,-3,39
Brisbane,4918,6,10,5,13,33,42,-9,35
Western Sydn,4918,7,8,9,10,38,47,-9,33
Perth Glory,4918,8,10,2,15,37,50,-13,32
Wellington P,4918,9,5,6,16,31,55,-24,21
CC Mariners,4918,10,4,8,15,28,49,-21,20
Sydney FC,4919,1,20,4,4,64,25,39,64
N'castle Jet,4919,2,15,6,7,59,39,20,51
Melbourne V,4919,3,14,5,10,48,38,10,47
Melbourne C,4919,4,14,5,10,45,35,10,47
Adelaide Utd,4919,5,11,6,11,37,40,-3,39
Brisbane,4919,6,10,5,13,33,42,-9,35
Western Sydn,4919,7,8,9,10,38,47,-9,33
Perth Glory,4919,8,10,2,15,37,50,-13,32
Wellington P,4919,9,5,6,16,31,55,-24,21
CC Mariners,4919,10,4,8,15,28,49,-21,20
Sydney FC,4920,1,21,4,3,66,23,43,67
N'castle Jet,4920,2,15,6,7,57,37,20,51
Melbourne C,4920,3,14,5,10,43,33,10,47
Melbourne V,4920,4,13,5,11,46,40,6,44
Adelaide Utd,4920,5,11,6,11,37,40,-3,39
Brisbane,4920,6,10,5,13,33,42,-9,35
Western Sydn,4920,7,8,9,10,38,47,-9,33
Perth Glory,4920,8,10,2,15,37,50,-13,32
Wellington P,4920,9,5,6,16,31,55,-24,21
CC Mariners,4920,10,4,8,15,28,49,-21,20
Sydney FC,4921,1,21,4,3,67,23,44,67
N'castle Jet,4921,2,15,6,7,57,37,20,51
Melbourne C,4921,3,14,5,10,43,33,10,47
Melbourne V,4921,4,13,5,11,46,41,5,44
Adelaide Utd,4921,5,11,6,11,37,40,-3,39
Brisbane,4921,6,10,5,13,33,42,-9,35
Western Sydn,4921,7,8,9,10,38,47,-9,33
Perth Glory,4921,8,10,2,15,37,50,-13,32
Wellington P,4921,9,5,6,16,31,55,-24,21
CC Mariners,4921,10,4,8,15,28,49,-21,20
Sydney FC,4922,1,21,4,3,65,22,43,67
N'castle Jet,4922,2,15,6,7,59,39,20,51
Melbourne C,4922,3,14,5,10,45,35,10,47
Melbourne V,4922,4,13,5,11,45,39,6,44
Adelaide Utd,4922,5,11,6,11,37,40,-3,39
Brisbane,4922,6,10,5,13,33,42,-9,35
Western Sydn,4922,7,8,9,10,38,47,-9,33
Perth Glory,4922,8,10,2,15,37,50,-13,32
Wellington P,4922,9,5,6,16,31,55,-24,21
CC Mariners,4922,10,4,8,15,28,49,-21,20
Sydney FC,4923,1,20,4,4,64,26,38,64
N'castle Jet,4923,2,15,5,8,58,39,19,50
Melbourne C,4923,3,15,4,10,45,34,11,49
Melbourne V,4923,4,14,5,10,49,38,11,47
Adelaide Utd,4923,5,11,6,11,37,40,-3,39
Brisbane,4923,6,10,5,13,33,42,-9,35
Western Sydn,4923,7,8,9,10,38,47,-9,33
Perth Glory,4923,8,10,2,15,37,50,-13,32
Wellington P,4923,9,5,6,16,31,55,-24,21
CC Mariners,4923,10,4,8,15,28,49,-21,20
Sydney FC,4924,1,20,5,3,65,23,42,65
N'castle Jet,4924,2,16,5,7,60,39,21,53
Melbourne C,4924,3,14,4,11,45,36,9,46
Melbourne V,4924,4,13,6,10,46,39,7,45
Adelaide Utd,4924,5,11,6,11,37,40,-3,39
Brisbane,4924,6,10,5,13,33,42,-9,35
Western Sydn,4924,7,8,9,10,38,47,-9,33
Perth Glory,4924,8,10,2,15,37,50,-13,32
Wellington P,4924,9,5,6,16,31,55,-24,21
CC Mariners,4924,10,4,8,15,28,49,-21,20
Sydney FC,4925,1,21,4,3,66,23,43,67
N'castle Jet,4925,2,15,5,8,57,38,19,50
Melbourne C,4925,3,15,4,10,44,33,11,49
Melbourne V,4925,4,13,5,11,46,40,6,44
Adelaide Utd,4925,5,11,6,11,37,40,-3,39
Brisbane,4925,6,10,5,13,33,42,-9,35
Western Sydn,4925,7,8,9,10,38,47,-9,33
Perth Glory,4925,8,10,2,15,37,50,-13,32
Wellington P,4925,9,5,6,16,31,55,-24,21
CC Mariners,4925,10,4,8,15,28,49,-21,20
Sydney FC,4926,1,20,5,3,65,23,42,65
N'castle Jet,4926,2,16,5,7,60,38,22,53
Melbourne C,4926,3,14,4,11,44,36,8,46
Melbourne V,4926,4,13,6,10,46,39,7,45
Adelaide Utd,4926,5,11,6,11,37,40,-3,39
Brisbane,4926,6,10,5,13,33,42,-9,35
Western Sydn,4926,7,8,9,10,38,47,-9,33
Perth Glory,4926,8,10,2,15,37,50,-13,32
Wellington P,4926,9,5,6,16,31,55,-24,21
CC Mariners,4926,10,4,8,15,28,49,-21,20
Sydney FC,4927,1,21,4,3,73,22,51,67
N'castle Jet,4927,2,15,6,7,60,40,20,51
Melbourne C,4927,3,14,5,10,46,36,10,47
Melbourne V,4927,4,13,5,11,45,47,-2,44
Adelaide Utd,4927,5,11,6,11,37,40,-3,39
Brisbane,4927,6,10,5,13,33,42,-9,35
Western Sydn,4927,7,8,9,10,38,47,-9,33
Perth Glory,4927,8,10,2,15,37,50,-13,32
Wellington P,4927,9,5,6,16,31,55,-24,21
CC Mariners,4927,10,4,8,15,28,49,-21,20
Sydney FC,4928,1,21,4,3,65,22,43,67
N'castle Jet,4928,2,15,6,7,57,37,20,51
Melbourne C,4928,3,14,5,10,43,33,10,47
Melbourne V,4928,4,13,5,11,45,39,6,44
Adelaide Utd,4928,5,11,6,11,37,40,-3,39
Brisbane,4928,6,10,5,13,33,42,-9,35
Western Sydn,4928,7,8,9,10,38,47,-9,33
Perth Glory,4928,8,10,2,15,37,50,-13,32
Wellington P,4928,9,5,6,16,31,55,-24,21
CC Mariners,4928,10,4,8,15,28,49,-21,20
Sydney FC,4929,1,21,4,3,66,22,44,67
N'castle Jet,4929,2,16,5,7,60,37,23,53
Melbourne C,4929,3,14,4,11,43,36,7,46
Melbourne V,4929,4,13,5,11,45,40,5,44
Adelaide Utd,4929,5,11,6,11,37,40,-3,39
Brisbane,4929,6,10,5,13,33,42,-9,35
Western Sydn,4929,7,8,9,10,38,47,-9,33
Perth Glory,4929,8,10,2,15,37,50,-13,32
Wellington P,4929,9,5,6,16,31,55,-24,21
CC Mariners,4929,10,4,8,15,28,49,-21,20
Sydney FC,4930,1,20,5,3,64,22,42,65
N'castle Jet,4930,2,16,5,7,58,37,21,53
Melbourne C,4930,3,14,4,11,43,34,9,46
Melbourne V,4930,4,13,6,10,45,38,7,45
Adelaide Utd,4930,5,11,6,11,37,40,-3,39
Brisbane,4930,6,10,5,13,33,42,-9,35
Western Sydn,4930,7,8,9,10,38,47,-9,33
Perth Glory,4930,8,10,2,15,37,50,-13,32
Wellington P,4930,9,5,6,16,31,55,-24,21
CC Mariners,4930,10,4,8,15,28,49,-21,20
Sydney FC,4931,1,21,4,3,67,23,44,67
N'castle Jet,4931,2,16,5,7,61,37,24,53
Melbourne C,4931,3,14,4,11,43,37,6,46
Melbourne V,4931,4,13,5,11,46,41,5,44
Adelaide Utd,4931,5,11,6,11,37,40,-3,39
Brisbane,4931,6,10,5,13,33,42,-9,35
Western Sydn,4931,7,8,9,10,38,47,-9,33
Perth Glory,4931,8,10,2,15,37,50,-13,32
Wellington P,4931,9,5,6,16,31,55,-24,21
CC Mariners,4931,10,4,8,15,28,49,-21,20
Sydney FC,4932,1,21,4,3,68,23,45,67
N'castle Jet,4932,2,16,5,7,59,38,21,53
Melbourne C,4932,3,14,4,11,44,35,9,46
Melbourne V,4932,4,13,5,11,46,42,4,44
Adelaide Utd,4932,5,11,6,11,37,40,-3,39
Brisbane,4932,6,10,5,13,33,42,-9,35
Western Sydn,4932,7,8,9,10,38,47,-9,33
Perth Glory,4932,8,10,2,15,37,50,-13,32
Wellington P,4932,9,5,6,16,31,55,-24,21
CC Mariners,4932,10,4,8,15,28,49,-21,20
Sydney FC,4933,1,21,4,3,68,22,46,67
N'castle Jet,4933,2,15,5,8,58,42,16,50
Melbourne C,4933,3,15,4,10,48,34,14,49
Melbourne V,4933,4,13,5,11,45,42,3,44
Adelaide Utd,4933,5,11,6,11,37,40,-3,39
Brisbane,4933,6,10,5,13,33,42,-9,35
Western Sydn,4933,7,8,9,10,38,47,-9,33
Perth Glory,4933,8,10,2,15,37,50,-13,32
Wellington P,4933,9,5,6,16,31,55,-24,21
CC Mariners,4933,10,4,8,15,28,49,-21,20
Sydney FC,4934,1,20,4,4,65,24,41,64
N'castle Jet,4934,2,16,5,7,61,38,23,53
Melbourne V,4934,3,14,5,10,47,39,8,47
Melbourne C,4934,4,14,4,11,44,37,7,46
Adelaide Utd,4934,5,11,6,11,37,40,-3,39
Brisbane,4934,6,10,5,13,33,42,-9,35
Western Sydn,4934,7,8,9,10,38,47,-9,33
Perth Glory,4934,8,10,2,15,37,50,-13,32
Wellington P,4934,9,5,6,16,31,55,-24,21
CC Mariners,4934,10,4,8,15,28,49,-21,20
Sydney FC,4935,1,20,4,4,64,23,41,64
N'castle Jet,4935,2,16,5,7,62,39,23,53
Melbourne V,4935,3,14,5,10,46,38,8,47
Melbourne C,4935,4,14,4,11,45,38,7,46
Adelaide Utd,4935,5,11,6,11,37,40,-3,39
Brisbane,4935,6,10,5,13,33,42,-9,35
Western Sydn,4935,7,8,9,10,38,47,-9,33
Perth Glory,4935,8,10,2,15,37,50,-13,32
Wellington P,4935,9,5,6,16,31,55,-24,21
CC Mariners,4935,10,4,8,15,28,49,-21,20
Sydney FC,4936,1,21,4,3,67,23,44,67
N'castle Jet,4936,2,16,5,7,59,37,22,53
Melbourne C,4936,3,14,4,11,43,35,8,46
Melbourne V,4936,4,13,5,11,46,41,5,44
Adelaide Utd,4936,5,11,6,11,37,40,-3,39
Brisbane,4936,6,10,5,13,33,42,-9,35
Western Sydn,4936,7,8,9,10,38,47,-9,33
Perth Glory,4936,8,10,2,15,37,50,-13,32
Wellington P,4936,9,5,6,16,31,55,-24,21
CC Mariners,4936,10,4,8,15,28,49,-21,20
Sydney FC,4937,1,21,4,3,67,22,45,67
N'castle Jet,4937,2,16,5,7,60,37,23,53
Melbourne C,4937,3,14,4,11,43,36,7,46
Melbourne V,4937,4,13,5,11,45,41,4,44
Adelaide Utd,4937,5,11,6,11,37,40,-3,39
Brisbane,4937,6,10,5,13,33,42,-9,35
Western Sydn,4937,7,8,9,10,38,47,-9,33
Perth Glory,4937,8,10,2,15,37,50,-13,32
Wellington P,4937,9,5,6,16,31,55,-24,21
CC Mariners,4937,10,4,8,15,28,49,-21,20
Sydney FC,4938,1,21,4,3,65,22,43,67
N'castle Jet,4938,2,16,5,7,58,37,21,53
Melbourne C,4938,3,14,4,11,43,34,9,46
Melbourne V,4938,4,13,5,11,45,39,6,44
Adelaide Utd,4938,5,11,6,11,37,40,-3,39
Brisbane,4938,6,10,5,13,33,42,-9,35
Western Sydn,4938,7,8,9,10,38,47,-9,33
Perth Glory,4938,8,10,2,15,37,50,-13,32
Wellington P,4938,9,5,6,16,31,55,-24,21
CC Mariners,4938,10,4,8,15,28,49,-21,20
Sydney FC,4939,1,20,4,4,65,24,41,64
N'castle Jet,4939,2,15,6,7,58,38,20,51
Melbourne C,4939,3,14,5,10,44,34,10,47
Melbourne V,4939,4,14,5,10,47,39,8,47
Adelaide Utd,4939,5,11,6,11,37,40,-3,39
Brisbane,4939,6,10,5,13,33,42,-9,35
Western Sydn,4939,7,8,9,10,38,47,-9,33
Perth Glory,4939,8,10,2,15,37,50,-13,32
Wellington P,4939,9,5,6,16,31,55,-24,21
CC Mariners,4939,10,4,8,15,28,49,-21,20
Sydney FC,4940,1,20,4,4,65,25,40,64
N'castle Jet,4940,2,15,5,8,57,38,19,50
Melbourne C,4940,3,15,4,10,44,33,11,49
Melbourne V,4940,4,14,5,10,48,39,9,47
Adelaide Utd,4940,5,11,6,11,37,40,-3,39
Brisbane,4940,6,10,5,13,33,42,-9,35
Western Sydn,4940,7,8,9,10,38,47,-9,33
Perth Glory,4940,8,10,2,15,37,50,-13,32
Wellington P,4940,9,5,6,16,31,55,-24,21
CC Mariners,4940,10,4,8,15,28,49,-21,20
Sydney FC,4941,1,21,4,3,68,22,46,67
N'castle Jet,4941,2,16,5,7,59,38,21,53
Melbourne C,4941,3,14,4,11,44,35,9,46
Melbourne V,4941,4,13,5,11,45,42,3,44
Adelaide Utd,4941,5,11,6,11,37,40,-3,39
Brisbane,4941,6,10,5,13,33,42,-9,35
Western Sydn,4941,7,8,9,10,38,47,-9,33
Perth Glory,4941,8,10,2,15,37,50,-13,32
Wellington P,4941,9,5,6,16,31,55,-24,21
CC Mariners,4941,10,4,8,15,28,49,-21,20
Sydney FC,4942,1,20,5,3,66,24,42,65
N'castle Jet,4942,2,16,5,7,60,38,22,53
Melbourne C,4942,3,14,4,11,44,36,8,46
Melbourne V,4942,4,13,6,10,47,40,7,45
Adelaide Utd,4942,5,11,6,11,37,40,-3,39
Brisbane,4942,6,10,5,13,33,42,-9,35
Western Sydn,4942,7,8,9,10,38,47,-9,33
Perth Glory,4942,8,10,2,15,37,50,-13,32
Wellington P,4942,9,5,6,16,31,55,-24,21
CC Mariners,4942,10,4,8,15,28,49,-21,20
Sydney FC,4943,1,20,5,3,65,23,42,65
N'castle Jet,4943,2,15,6,7,58,38,20,51
Melbourne C,4943,3,14,5,10,44,34,10,47
Melbourne V,4943,4,13,6,10,46,39,7,45
Adelaide Utd,4943,5,11,6,11,37,40,-3,39
Brisbane,4943,6,10,5,13,33,42,-9,35
Western Sydn,4943,7,8,9,10,38,47,-9,33
Perth Glory,4943,8,10,2,15,37,50,-13,32
Wellington P,4943,9,5,6,16,31,55,-24,21
CC Mariners,4943,10,4,8,15,28,49,-21,20
Sydney FC,4944,1,21,4,3,68,24,44,67
N'castle Jet,4944,2,16,5,7,59,37,22,53
Melbourne C,4944,3,14,4,11,43,35,8,46
Melbourne V,4944,4,13,5,11,47,42,5,44
Adelaide Utd,4944,5,11,6,11,37,40,-3,39
Brisbane,4944,6,10,5,13,33,42,-9,35
Western Sydn,4944,7,8,9,10,38,47,-9,33
Perth Glory,4944,8,10,2,15,37,50,-13,32
Wellington P,4944,9,5,6,16,31,55,-24,21
CC Mariners,4944,10,4,8,15,28,49,-21,20
Sydney FC,4945,1,20,5,3,64,22,42,65
N'castle Jet,4945,2,16,5,7,62,39,23,53
Melbourne C,4945,3,14,4,11,45,38,7,46
Melbourne V,4945,4,13,6,10,45,38,7,45
Adelaide Utd,4945,5,11,6,11,37,40,-3,39
Brisbane,4945,6,10,5,13,33,42,-9,35
Western Sydn,4945,7,8,9,10,38,47,-9,33
Perth Glory,4945,8,10,2,15,37,50,-13,32
Wellington P,4945,9,5,6,16,31,55,-24,21
CC Mariners,4945,10,4,8,15,28,49,-21,20
Sydney FC,4946,1,21,4,3,66,22,44,67
N'castle Jet,4946,2,16,5,7,60,37,23,53
Melbourne C,4946,3,14,4,11,43,36,7,46
Melbourne V,4946,4,13,5,11,45,40,5,44
Adelaide Utd,4946,5,11,6,11,37,40,-3,39
Brisbane,4946,6,10,5,13,33,42,-9,35
Western Sydn,4946,7,8,9,10,38,47,-9,33
Perth Glory,4946,8,10,2,15,37,50,-13,32
Wellington P,4946,9,5,6,16,31,55,-24,21
CC Mariners,4946,10,4,8,15,28,49,-21,20
Sydney FC,4947,1,20,5,3,64,22,42,65
N'castle Jet,4947,2,16,5,7,62,38,24,53
Melbourne C,4947,3,14,4,11,44,38,6,46
Melbourne V,4947,4,13,6,10,45,38,7,45
Adelaide Utd,4947,5,11,6,11,37,40,-3,39
Brisbane,4947,6,10,5,13,33,42,-9,35
Western Sydn,4947,7,8,9,10,38,47,-9,33
Perth Glory,4947,8,10,2,15,37,50,-13,32
Wellington P,4947,9,5,6,16,31,55,-24,21
CC Mariners,4947,10,4,8,15,28,49,-21,20
Sydney FC,4948,1,21,4,3,65,22,43,67
N'castle Jet,4948,2,16,5,7,61,40,21,53
Melbourne C,4948,3,14,4,11,46,37,9,46
Melbourne V,4948,4,13,5,11,45,39,6,44
Adelaide Utd,4948,5,11,6,11,37,40,-3,39
Brisbane,4948,6,10,5,13,33,42,-9,35
Western Sydn,4948,7,8,9,10,38,47,-9,33
Perth Glory,4948,8,10,2,15,37,50,-13,32
Wellington P,4948,9,5,6,16,31,55,-24,21
CC Mariners,4948,10,4,8,15,28,49,-21,20
Sydney FC,4949,1,20,5,3,65,23,42,65
N'castle Jet,4949,2,15,5,8,58,39,19,50
Melbourne C,4949,3,15,4,10,45,34,11,49
Melbourne V,4949,4,13,6,10,46,39,7,45
Adelaide Utd,4949,5,11,6,11,37,40,-3,39
Brisbane,4949,6,10,5,13,33,42,-9,35
Western Sydn,4949,7,8,9,10,38,47,-9,33
Perth Glory,4949,8,10,2,15,37,50,-13,32
Wellington P,4949,9,5,6,16,31,55,-24,21
CC Mariners,4949,10,4,8,15,28,49,-21,20
Sydney FC,4950,1,20,5,3,66,24,42,65
N'castle Jet,4950,2,16,5,7,61,37,24,53
Melbourne C,4950,3,14,4,11,43,37,6,46
Melbourne V,4950,4,13,6,10,47,40,7,45
Adelaide Utd,4950,5,11,6,11,37,40,-3,39
Brisbane,4950,6,10,5,13,33,42,-9,35
Western Sydn,4950,7,8,9,10,38,47,-9,33
Perth Glory,4950,8,10,2,15,37,50,-13,32
Wellington P,4950,9,5,6,16,31,55,-24,21
CC Mariners,4950,10,4,8,15,28,49,-21,20
Sydney FC,4951,1,20,4,4,65,24,41,64
N'castle Jet,4951,2,15,6,7,57,37,20,51
Melbourne C,4951,3,14,5,10,43,33,10,47
Melbourne V,4951,4,14,5,10,47,39,8,47
Adelaide Utd,4951,5,11,6,11,37,40,-3,39
Brisbane,4951,6,10,5,13,33,42,-9,35
Western Sydn,4951,7,8,9,10,38,47,-9,33
Perth Glory,4951,8,10,2,15,37,50,-13,32
Wellington P,4951,9,5,6,16,31,55,-24,21
CC Mariners,4951,10,4,8,15,28,49,-21,20
Sydney FC,4952,1,21,4,3,67,23,44,67
N'castle Jet,4952,2,15,6,7,57,37,20,51
Melbourne C,4952,3,14,5,10,43,33,10,47
Melbourne V,4952,4,13,5,11,46,41,5,44
Adelaide Utd,4952,5,11,6,11,37,40,-3,39
Brisbane,4952,6,10,5,13,33,42,-9,35
Western Sydn,4952,7,8,9,10,38,47,-9,33
Perth Glory,4952,8,10,2,15,37,50,-13,32
Wellington P,4952,9,5,6,16,31,55,-24,21
CC Mariners,4952,10,4,8,15,28,49,-21,20
Sydney FC,4953,1,20,4,4,65,24,41,64
N'castle Jet,4953,2,15,6,7,59,39,20,51
Melbourne C,4953,3,14,5,10,45,35,10,47
Melbourne V,4953,4,14,5,10,47,39,8,47
Adelaide Utd,4953,5,11,6,11,37,40,-3,39
Brisbane,4953,6,10,5,13,33,42,-9,35
Western Sydn,4953,7,8,9,10,38,47,-9,33
Perth Glory,4953,8,10,2,15,37,50,-13,32
Wellington P,4953,9,5,6,16,31,55,-24,21
CC Mariners,4953,10,4,8,15,28,49,-21,20
Sydney FC,4954,1,21,4,3,65,22,43,67
N'castle Jet,4954,2,15,6,7,59,39,20,51
Melbourne C,4954,3,14,5,10,45,35,10,47
Melbourne V,4954,4,13,5,11,45,39,6,44
Adelaide Utd,4954,5,11,6,11,37,40,-3,39
Brisbane,4954,6,10,5,13,33,42,-9,35
Western Sydn,4954,7,8,9,10,38,47,-9,33
Perth Glory,4954,8,10,2,15,37,50,-13,32
Wellington P,4954,9,5,6,16,31,55,-24,21
CC Mariners,4954,10,4,8,15,28,49,-21,20
Sydney FC,4955,1,21,4,3,67,24,43,67
N'castle Jet,4955,2,15,6,7,58,38,20,51
Melbourne C,4955,3,14,5,10,44,34,10,47
Melbourne V,4955,4,13,5,11,47,41,6,44
Adelaide Utd,4955,5,11,6,11,37,40,-3,39
Brisbane,4955,6,10,5,13,33,42,-9,35
Western Sydn,4955,7,8,9,10,38,47,-9,33
Perth Glory,4955,8,10,2,15,37,50,-13,32
Wellington P,4955,9,5,6,16,31,55,-24,21
CC Mariners,4955,10,4,8,15,28,49,-21,20
Sydney FC,4956,1,20,5,3,67,25,42,65
N'castle Jet,4956,2,15,6,7,58,38,20,51
Melbourne C,4956,3,14,5,10,44,34,10,47
Melbourne V,4956,4,13,6,10,48,41,7,45
Adelaide Utd,4956,5,11,6,11,37,40,-3,39
Brisbane,4956,6,10,5,13,33,42,-9,35
Western Sydn,4956,7,8,9,10,38,47,-9,33
Perth Glory,4956,8,10,2,15,37,50,-13,32
Wellington P,4956,9,5,6,16,31,55,-24,21
CC Mariners,4956,10,4,8,15,28,49,-21,20
Sydney FC,4957,1,21,4,3,70,22,48,67
N'castle Jet,4957,2,15,6,7,60,40,20,51
Melbourne C,4957,3,14,5,10,46,36,10,47
Melbourne V,4957,4,13,5,11,45,44,1,44
Adelaide Utd,4957,5,11,6,11,37,40,-3,39
Brisbane,4957,6,10,5,13,33,42,-9,35
Western Sydn,4957,7,8,9,10,38,47,-9,33
Perth Glory,4957,8,10,2,15,37,50,-13,32
Wellington P,4957,9,5,6,16,31,55,-24,21
CC Mariners,4957,10,4,8,15,28,49,-21,20
Sydney FC,4958,1,20,4,4,65,25,40,64
N'castle Jet,4958,2,15,5,8,57,41,16,50
Melbourne C,4958,3,15,4,10,47,33,14,49
Melbourne V,4958,4,14,5,10,48,39,9,47
Adelaide Utd,4958,5,11,6,11,37,40,-3,39
Brisbane,4958,6,10,5,13,33,42,-9,35
Western Sydn,4958,7,8,9,10,38,47,-9,33
Perth Glory,4958,8,10,2,15,37,50,-13,32
Wellington P,4958,9,5,6,16,31,55,-24,21
CC Mariners,4958,10,4,8,15,28,49,-21,20
Sydney FC,4959,1,21,4,3,67,23,44,67
N'castle Jet,4959,2,15,6,7,57,37,20,51
Melbourne C,4959,3,14,5,10,43,33,10,47
Melbourne V,4959,4,13,5,11,46,41,5,44
Adelaide Utd,4959,5,11,6,11,37,40,-3,39
Brisbane,4959,6,10,5,13,33,42,-9,35
Western Sydn,4959,7,8,9,10,38,47,-9,33
Perth Glory,4959,8,10,2,15,37,50,-13,32
Wellington P,4959,9,5,6,16,31,55,-24,21
CC Mariners,4959,10,4,8,15,28,49,-21,20
Sydney FC,4960,1,20,5,3,64,22,42,65
N'castle Jet,4960,2,16,5,7,59,37,22,53
Melbourne C,4960,3,14,4,11,43,35,8,46
Melbourne V,4960,4,13,6,10,45,38,7,45
Adelaide Utd,4960,5,11,6,11,37,40,-3,39
Brisbane,4960,6,10,5,13,33,42,-9,35
Western Sydn,4960,7,8,9,10,38,47,-9,33
Perth Glory,4960,8,10,2,15,37,50,-13,32
Wellington P,4960,9,5,6,16,31,55,-24,21
CC Mariners,4960,10,4,8,15,28,49,-21,20
Sydney FC,4961,1,20,5,3,66,24,42,65
N'castle Jet,4961,2,16,5,7,62,38,24,53
Melbourne C,4961,3,14,4,11,44,38,6,46
Melbourne V,4961,4,13,6,10,47,40,7,45
Adelaide Utd,4961,5,11,6,11,37,40,-3,39
Brisbane,4961,6,10,5,13,33,42,-9,35
Western Sydn,4961,7,8,9,10,38,47,-9,33
Perth Glory,4961,8,10,2,15,37,50,-13,32
Wellington P,4961,9,5,6,16,31,55,-24,21
CC Mariners,4961,10,4,8,15,28,49,-21,20
Sydney FC,4962,1,20,5,3,66,24,42,65
N'castle Jet,4962,2,16,5,7,59,37,22,53
Melbourne C,4962,3,14,4,11,43,35,8,46
Melbourne V,4962,4,13,6,10,47,40,7,45
Adelaide Utd,4962,5,11,6,11,37,40,-3,39
Brisbane,4962,6,10,5,13,33,42,-9,35
Western Sydn,4962,7,8,9,10,38,47,-9,33
Perth Glory,4962,8,10,2,15,37,50,-13,32
Wellington P,4962,9,5,6,16,31,55,-24,21
CC Mariners,4962,10,4,8,15,28,49,-21,20
Sydney FC,4963,1,20,4,4,65,26,39,64
N'castle Jet,4963,2,15,5,8,58,40,18,50
Melbourne C,4963,3,15,4,10,46,34,12,49
Melbourne V,4963,4,14,5,10,49,39,10,47
Adelaide Utd,4963,5,11,6,11,37,40,-3,39
Brisbane,4963,6,10,5,13,33,42,-9,35
Western Sydn,4963,7,8,9,10,38,47,-9,33
Perth Glory,4963,8,10,2,15,37,50,-13,32
Wellington P,4963,9,5,6,16,31,55,-24,21
CC Mariners,4963,10,4,8,15,28,49,-21,20
Sydney FC,4964,1,20,4,4,65,24,41,64
N'castle Jet,4964,2,15,6,7,59,39,20,51
Melbourne C,4964,3,14,5,10,45,35,10,47
Melbourne V,4964,4,14,5,10,47,39,8,47
Adelaide Utd,4964,5,11,6,11,37,40,-3,39
Brisbane,4964,6,10,5,13,33,42,-9,35
Western Sydn,4964,7,8,9,10,38,47,-9,33
Perth Glory,4964,8,10,2,15,37,50,-13,32
Wellington P,4964,9,5,6,16,31,55,-24,21
CC Mariners,4964,10,4,8,15,28,49,-21,20
Sydney FC,4965,1,20,4,4,65,24,41,64
N'castle Jet,4965,2,15,6,7,59,39,20,51
Melbourne C,4965,3,14,5,10,45,35,10,47
Melbourne V,4965,4,14,5,10,47,39,8,47
Adelaide Utd,4965,5,11,6,11,37,40,-3,39
Brisbane,4965,6,10,5,13,33,42,-9,35
Western Sydn,4965,7,8,9,10,38,47,-9,33
Perth Glory,4965,8,10,2,15,37,50,-13,32
Wellington P,4965,9,5,6,16,31,55,-24,21
CC Mariners,4965,10,4,8,15,28,49,-21,20
Sydney FC,4966,1,21,4,3,67,22,45,67
N'castle Jet,4966,2,16,5,7,58,37,21,53
Melbourne C,4966,3,14,4,11,43,34,9,46
Melbourne V,4966,4,13,5,11,45,41,4,44
Adelaide Utd,4966,5,11,6,11,37,40,-3,39
Brisbane,4966,6,10,5,13,33,42,-9,35
Western Sydn,4966,7,8,9,10,38,47,-9,33
Perth Glory,4966,8,10,2,15,37,50,-13,32
Wellington P,4966,9,5,6,16,31,55,-24,21
CC Mariners,4966,10,4,8,15,28,49,-21,20
Sydney FC,4967,1,20,5,3,65,23,42,65
N'castle Jet,4967,2,15,5,8,57,38,19,50
Melbourne C,4967,3,15,4,10,44,33,11,49
Melbourne V,4967,4,13,6,10,46,39,7,45
Adelaide Utd,4967,5,11,6,11,37,40,-3,39
Brisbane,4967,6,10,5,13,33,42,-9,35
Western Sydn,4967,7,8,9,10,38,47,-9,33
Perth Glory,4967,8,10,2,15,37,50,-13,32
Wellington P,4967,9,5,6,16,31,55,-24,21
CC Mariners,4967,10,4,8,15,28,49,-21,20
Sydney FC,4968,1,20,4,4,67,26,41,64
N'castle Jet,4968,2,15,6,7,58,38,20,51
Melbourne C,4968,3,14,5,10,44,34,10,47
Melbourne V,4968,4,14,5,10,49,41,8,47
Adelaide Utd,4968,5,11,6,11,37,40,-3,39
Brisbane,4968,6,10,5,13,33,42,-9,35
Western Sydn,4968,7,8,9,10,38,47,-9,33
Perth Glory,4968,8,10,2,15,37,50,-13,32
Wellington P,4968,9,5,6,16,31,55,-24,21
CC Mariners,4968,10,4,8,15,28,49,-21,20
Sydney FC,4969,1,21,4,3,65,22,43,67
N'castle Jet,4969,2,16,5,7,59,37,22,53
Melbourne C,4969,3,14,4,11,43,35,8,46
Melbourne V,4969,4,13,5,11,45,39,6,44
Adelaide Utd,4969,5,11,6,11,37,40,-3,39
Brisbane,4969,6,10,5,13,33,42,-9,35
Western Sydn,4969,7,8,9,10,38,47,-9,33
Perth Glory,4969,8,10,2,15,37,50,-13,32
Wellington P,4969,9,5,6,16,31,55,-24,21
CC Mariners,4969,10,4,8,15,28,49,-21,20
Sydney FC,4970,1,21,4,3,66,23,43,67
N'castle Jet,4970,2,15,6,7,59,39,20,51
Melbourne C,4970,3,14,5,10,45,35,10,47
Melbourne V,4970,4,13,5,11,46,40,6,44
Adelaide Utd,4970,5,11,6,11,37,40,-3,39
Brisbane,4970,6,10,5,13,33,42,-9,35
Western Sydn,4970,7,8,9,10,38,47,-9,33
Perth Glory,4970,8,10,2,15,37,50,-13,32
Wellington P,4970,9,5,6,16,31,55,-24,21
CC Mariners,4970,10,4,8,15,28,49,-21,20
Sydney FC,4971,1,20,5,3,66,24,42,65
N'castle Jet,4971,2,15,6,7,57,37,20,51
Melbourne C,4971,3,14,5,10,43,33,10,47
Melbourne V,4971,4,13,6,10,47,40,7,45
Adelaide Utd,4971,5,11,6,11,37,40,-3,39
Brisbane,4971,6,10,5,13,33,42,-9,35
Western Sydn,4971,7,8,9,10,38,47,-9,33
Perth Glory,4971,8,10,2,15,37,50,-13,32
Wellington P,4971,9,5,6,16,31,55,-24,21
CC Mariners,4971,10,4,8,15,28,49,-21,20
Sydney FC,4972,1,21,4,3,67,22,45,67
N'castle Jet,4972,2,15,5,8,58,40,18,50
Melbourne C,4972,3,15,4,10,46,34,12,49
Melbourne V,4972,4,13,5,11,45,41,4,44
Adelaide Utd,4972,5,11,6,11,37,40,-3,39
Brisbane,4972,6,10,5,13,33,42,-9,35
Western Sydn,4972,7,8,9,10,38,47,-9,33
Perth Glory,4972,8,10,2,15,37,50,-13,32
Wellington P,4972,9,5,6,16,31,55,-24,21
CC Mariners,4972,10,4,8,15,28,49,-21,20
Sydney FC,4973,1,20,5,3,64,22,42,65
N'castle Jet,4973,2,16,5,7,60,37,23,53
Melbourne C,4973,3,14,4,11,43,36,7,46
Melbourne V,4973,4,13,6,10,45,38,7,45
Adelaide Utd,4973,5,11,6,11,37,40,-3,39
Brisbane,4973,6,10,5,13,33,42,-9,35
Western Sydn,4973,7,8,9,10,38,47,-9,33
Perth Glory,4973,8,10,2,15,37,50,-13,32
Wellington P,4973,9,5,6,16,31,55,-24,21
CC Mariners,4973,10,4,8,15,28,49,-21,20
Sydney FC,4974,1,20,4,4,64,24,40,64
N'castle Jet,4974,2,16,5,7,59,37,22,53
Melbourne V,4974,3,14,5,10,47,38,9,47
Melbourne C,4974,4,14,4,11,43,35,8,46
Adelaide Utd,4974,5,11,6,11,37,40,-3,39
Brisbane,4974,6,10,5,13,33,42,-9,35
Western Sydn,4974,7,8,9,10,38,47,-9,33
Perth Glory,4974,8,10,2,15,37,50,-13,32
Wellington P,4974,9,5,6,16,31,55,-24,21
CC Mariners,4974,10,4,8,15,28,49,-21,20
Sydney FC,4975,1,21,4,3,66,22,44,67
N'castle Jet,4975,2,16,5,7,59,38,21,53
Melbourne C,4975,3,14,4,11,44,35,9,46
Melbourne V,4975,4,13,5,11,45,40,5,44
Adelaide Utd,4975,5,11,6,11,37,40,-3,39
Brisbane,4975,6,10,5,13,33,42,-9,35
Western Sydn,4975,7,8,9,10,38,47,-9,33
Perth Glory,4975,8,10,2,15,37,50,-13,32
Wellington P,4975,9,5,6,16,31,55,-24,21
CC Mariners,4975,10,4,8,15,28,49,-21,20
Sydney FC,4976,1,20,4,4,64,23,41,64
N'castle Jet,4976,2,16,5,7,60,39,21,53
Melbourne V,4976,3,14,5,10,46,38,8,47
Melbourne C,4976,4,14,4,11,45,36,9,46
Adelaide Utd,4976,5,11,6,11,37,40,-3,39
Brisbane,4976,6,10,5,13,33,42,-9,35
Western Sydn,4976,7,8,9,10,38,47,-9,33
Perth Glory,4976,8,10,2,15,37,50,-13,32
Wellington P,4976,9,5,6,16,31,55,-24,21
CC Mariners,4976,10,4,8,15,28,49,-21,20
Sydney FC,4977,1,21,4,3,66,23,43,67
N'castle Jet,4977,2,16,5,7,59,37,22,53
Melbourne C,4977,3,14,4,11,43,35,8,46
Melbourne V,4977,4,13,5,11,46,40,6,44
Adelaide Utd,4977,5,11,6,11,37,40,-3,39
Brisbane,4977,6,10,5,13,33,42,-9,35
Western Sydn,4977,7,8,9,10,38,47,-9,33
Perth Glory,4977,8,10,2,15,37,50,-13,32
Wellington P,4977,9,5,6,16,31,55,-24,21
CC Mariners,4977,10,4,8,15,28,49,-21,20
Sydney FC,4978,1,20,4,4,64,23,41,64
N'castle Jet,4978,2,15,5,8,58,39,19,50
Melbourne C,4978,3,15,4,10,45,34,11,49
Melbourne V,4978,4,14,5,10,46,38,8,47
Adelaide Utd,4978,5,11,6,11,37,40,-3,39
Brisbane,4978,6,10,5,13,33,42,-9,35
Western Sydn,4978,7,8,9,10,38,47,-9,33
Perth Glory,4978,8,10,2,15,37,50,-13,32
Wellington P,4978,9,5,6,16,31,55,-24,21
CC Mariners,4978,10,4,8,15,28,49,-21,20
Sydney FC,4979,1,20,5,3,64,22,42,65
N'castle Jet,4979,2,15,5,8,57,38,19,50
Melbourne C,4979,3,15,4,10,44,33,11,49
Melbourne V,4979,4,13,6,10,45,38,7,45
Adelaide Utd,4979,5,11,6,11,37,40,-3,39
Brisbane,4979,6,10,5,13,33,42,-9,35
Western Sydn,4979,7,8,9,10,38,47,-9,33
Perth Glory,4979,8,10,2,15,37,50,-13,32
Wellington P,4979,9,5,6,16,31,55,-24,21
CC Mariners,4979,10,4,8,15,28,49,-21,20
Sydney FC,4980,1,20,5,3,67,25,42,65
N'castle Jet,4980,2,15,5,8,57,40,17,50
Melbourne C,4980,3,15,4,10,46,33,13,49
Melbourne V,4980,4,13,6,10,48,41,7,45
Adelaide Utd,4980,5,11,6,11,37,40,-3,39
Brisbane,4980,6,10,5,13,33,42,-9,35
Western Sydn,4980,7,8,9,10,38,47,-9,33
Perth Glory,4980,8,10,2,15,37,50,-13,32
Wellington P,4980,9,5,6,16,31,55,-24,21
CC Mariners,4980,10,4,8,15,28,49,-21,20
Sydney FC,4981,1,21,4,3,67,22,45,67
N'castle Jet,4981,2,16,5,7,58,37,21,53
Melbourne C,4981,3,14,4,11,43,34,9,46
Melbourne V,4981,4,13,5,11,45,41,4,44
Adelaide Utd,4981,5,11,6,11,37,40,-3,39
Brisbane,4981,6,10,5,13,33,42,-9,35
Western Sydn,4981,7,8,9,10,38,47,-9,33
Perth Glory,4981,8,10,2,15,37,50,-13,32
Wellington P,4981,9,5,6,16,31,55,-24,21
CC Mariners,4981,10,4,8,15,28,49,-21,20
Sydney FC,4982,1,20,4,4,65,24,41,64
N'castle Jet,4982,2,16,5,7,60,39,21,53
Melbourne V,4982,3,14,5,10,47,39,8,47
Melbourne C,4982,4,14,4,11,45,36,9,46
Adelaide Utd,4982,5,11,6,11,37,40,-3,39
Brisbane,4982,6,10,5,13,33,42,-9,35
Western Sydn,4982,7,8,9,10,38,47,-9,33
Perth Glory,4982,8,10,2,15,37,50,-13,32
Wellington P,4982,9,5,6,16,31,55,-24,21
CC Mariners,4982,10,4,8,15,28,49,-21,20
Sydney FC,4983,1,20,4,4,64,26,38,64
N'castle Jet,4983,2,15,5,8,58,40,18,50
Melbourne C,4983,3,15,4,10,46,34,12,49
Melbourne V,4983,4,14,5,10,49,38,11,47
Adelaide Utd,4983,5,11,6,11,37,40,-3,39
Brisbane,4983,6,10,5,13,33,42,-9,35
Western Sydn,4983,7,8,9,10,38,47,-9,33
Perth Glory,4983,8,10,2,15,37,50,-13,32
Wellington P,4983,9,5,6,16,31,55,-24,21
CC Mariners,4983,10,4,8,15,28,49,-21,20
Sydney FC,4984,1,21,4,3,66,22,44,67
N'castle Jet,4984,2,15,6,7,58,38,20,51
Melbourne C,4984,3,14,5,10,44,34,10,47
Melbourne V,4984,4,13,5,11,45,40,5,44
Adelaide Utd,4984,5,11,6,11,37,40,-3,39
Brisbane,4984,6,10,5,13,33,42,-9,35
Western Sydn,4984,7,8,9,10,38,47,-9,33
Perth Glory,4984,8,10,2,15,37,50,-13,32
Wellington P,4984,9,5,6,16,31,55,-24,21
CC Mariners,4984,10,4,8,15,28,49,-21,20
Sydney FC,4985,1,21,4,3,67,22,45,67
N'castle Jet,4985,2,15,6,7,58,38,20,51
Melbourne C,4985,3,14,5,10,44,34,10,47
Melbourne V,4985,4,13,5,11,45,41,4,44
Adelaide Utd,4985,5,11,6,11,37,40,-3,39
Brisbane,4985,6,10,5,13,33,42,-9,35
Western Sydn,4985,7,8,9,10,38,47,-9,33
Perth Glory,4985,8,10,2,15,37,50,-13,32
Wellington P,4985,9,5,6,16,31,55,-24,21
CC Mariners,4985,10,4,8,15,28,49,-21,20
Sydney FC,4986,1,20,5,3,65,23,42,65
N'castle Jet,4986,2,16,5,7,59,37,22,53
Melbourne C,4986,3,14,4,11,43,35,8,46
Melbourne V,4986,4,13,6,10,46,39,7,45
Adelaide Utd,4986,5,11,6,11,37,40,-3,39
Brisbane,4986,6,10,5,13,33,42,-9,35
Western Sydn,4986,7,8,9,10,38,47,-9,33
Perth Glory,4986,8,10,2,15,37,50,-13,32
Wellington P,4986,9,5,6,16,31,55,-24,21
CC Mariners,4986,10,4,8,15,28,49,-21,20
Sydney FC,4987,1,20,4,4,64,23,41,64
N'castle Jet,4987,2,16,5,7,59,38,21,53
Melbourne V,4987,3,14,5,10,46,38,8,47
Melbourne C,4987,4,14,4,11,44,35,9,46
Adelaide Utd,4987,5,11,6,11,37,40,-3,39
Brisbane,4987,6,10,5,13,33,42,-9,35
Western Sydn,4987,7,8,9,10,38,47,-9,33
Perth Glory,4987,8,10,2,15,37,50,-13,32
Wellington P,4987,9,5,6,16,31,55,-24,21
CC Mariners,4987,10,4,8,15,28,49,-21,20
Sydney FC,4988,1,21,4,3,66,22,44,67
N'castle Jet,4988,2,15,6,7,58,38,20,51
Melbourne C,4988,3,14,5,10,44,34,10,47
Melbourne V,4988,4,13,5,11,45,40,5,44
Adelaide Utd,4988,5,11,6,11,37,40,-3,39
Brisbane,4988,6,10,5,13,33,42,-9,35
Western Sydn,4988,7,8,9,10,38,47,-9,33
Perth Glory,4988,8,10,2,15,37,50,-13,32
Wellington P,4988,9,5,6,16,31,55,-24,21
CC Mariners,4988,10,4,8,15,28,49,-21,20
Sydney FC,4989,1,21,4,3,68,22,46,67
N'castle Jet,4989,2,15,6,7,59,39,20,51
Melbourne C,4989,3,14,5,10,45,35,10,47
Melbourne V,4989,4,13,5,11,45,42,3,44
Adelaide Utd,4989,5,11,6,11,37,40,-3,39
Brisbane,4989,6,10,5,13,33,42,-9,35
Western Sydn,4989,7,8,9,10,38,47,-9,33
Perth Glory,4989,8,10,2,15,37,50,-13,32
Wellington P,4989,9,5,6,16,31,55,-24,21
CC Mariners,4989,10,4,8,15,28,49,-21,20
Sydney FC,4990,1,21,4,3,65,22,43,67
N'castle Jet,4990,2,16,5,7,60,38,22,53
Melbourne C,4990,3,14,4,11,44,36,8,46
Melbourne V,4990,4,13,5,11,45,39,6,44
Adelaide Utd,4990,5,11,6,11,37,40,-3,39
Brisbane,4990,6,10,5,13,33,42,-9,35
Western Sydn,4990,7,8,9,10,38,47,-9,33
Perth Glory,4990,8,10,2,15,37,50,-13,32
Wellington P,4990,9,5,6,16,31,55,-24,21
CC Mariners,4990,10,4,8,15,28,49,-21,20
Sydney FC,4991,1,21,4,3,66,22,44,67
N'castle Jet,4991,2,16,5,7,58,37,21,53
Melbourne C,4991,3,14,4,11,43,34,9,46
Melbourne V,4991,4,13,5,11,45,40,5,44
Adelaide Utd,4991,5,11,6,11,37,40,-3,39
Brisbane,4991,6,10,5,13,33,42,-9,35
Western Sydn,4991,7,8,9,10,38,47,-9,33
Perth Glory,4991,8,10,2,15,37,50,-13,32
Wellington P,4991,9,5,6,16,31,55,-24,21
CC Mariners,4991,10,4,8,15,28,49,-21,20
Sydney FC,4992,1,21,4,3,67,23,44,67
N'castle Jet,4992,2,15,5,8,59,40,19,50
Melbourne C,4992,3,15,4,10,46,35,11,49
Melbourne V,4992,4,13,5,11,46,41,5,44
Adelaide Utd,4992,5,11,6,11,37,40,-3,39
Brisbane,4992,6,10,5,13,33,42,-9,35
Western Sydn,4992,7,8,9,10,38,47,-9,33
Perth Glory,4992,8,10,2,15,37,50,-13,32
Wellington P,4992,9,5,6,16,31,55,-24,21
CC Mariners,4992,10,4,8,15,28,49,-21,20
Sydney FC,4993,1,20,5,3,65,23,42,65
N'castle Jet,4993,2,15,5,8,58,39,19,50
Melbourne C,4993,3,15,4,10,45,34,11,49
Melbourne V,4993,4,13,6,10,46,39,7,45
Adelaide Utd,4993,5,11,6,11,37,40,-3,39
Brisbane,4993,6,10,5,13,33,42,-9,35
Western Sydn,4993,7,8,9,10,38,47,-9,33
Perth Glory,4993,8,10,2,15,37,50,-13,32
Wellington P,4993,9,5,6,16,31,55,-24,21
CC Mariners,4993,10,4,8,15,28,49,-21,20
Sydney FC,4994,1,21,4,3,66,22,44,67
N'castle Jet,4994,2,15,5,8,57,38,19,50
Melbourne C,4994,3,15,4,10,44,33,11,49
Melbourne V,4994,4,13,5,11,45,40,5,44
Adelaide Utd,4994,5,11,6,11,37,40,-3,39
Brisbane,4994,6,10,5,13,33,42,-9,35
Western Sydn,4994,7,8,9,10,38,47,-9,33
Perth Glory,4994,8,10,2,15,37,50,-13,32
Wellington P,4994,9,5,6,16,31,55,-24,21
CC Mariners,4994,10,4,8,15,28,49,-21,20
Sydney FC,4995,1,21,4,3,69,24,45,67
N'castle Jet,4995,2,15,6,7,57,37,20,51
Melbourne C,4995,3,14,5,10,43,33,10,47
Melbourne V,4995,4,13,5,11,47,43,4,44
Adelaide Utd,4995,5,11,6,11,37,40,-3,39
Brisbane,4995,6,10,5,13,33,42,-9,35
Western Sydn,4995,7,8,9,10,38,47,-9,33
Perth Glory,4995,8,10,2,15,37,50,-13,32
Wellington P,4995,9,5,6,16,31,55,-24,21
CC Mariners,4995,10,4,8,15,28,49,-21,20
Sydney FC,4996,1,21,4,3,65,22,43,67
N'castle Jet,4996,2,16,5,7,59,37,22,53
Melbourne C,4996,3,14,4,11,43,35,8,46
Melbourne V,4996,4,13,5,11,45,39,6,44
Adelaide Utd,4996,5,11,6,11,37,40,-3,39
Brisbane,4996,6,10,5,13,33,42,-9,35
Western Sydn,4996,7,8,9,10,38,47,-9,33
Perth Glory,4996,8,10,2,15,37,50,-13,32
Wellington P,4996,9,5,6,16,31,55,-24,21
CC Mariners,4996,10,4,8,15,28,49,-21,20
Sydney FC,4997,1,21,4,3,68,25,43,67
N'castle Jet,4997,2,15,5,8,58,39,19,50
Melbourne C,4997,3,15,4,10,45,34,11,49
Melbourne V,4997,4,13,5,11,48,42,6,44
Adelaide Utd,4997,5,11,6,11,37,40,-3,39
Brisbane,4997,6,10,5,13,33,42,-9,35
Western Sydn,4997,7,8,9,10,38,47,-9,33
Perth Glory,4997,8,10,2,15,37,50,-13,32
Wellington P,4997,9,5,6,16,31,55,-24,21
CC Mariners,4997,10,4,8,15,28,49,-21,20
Sydney FC,4998,1,21,4,3,67,22,45,67
N'castle Jet,4998,2,15,6,7,58,38,20,51
Melbourne C,4998,3,14,5,10,44,34,10,47
Melbourne V,4998,4,13,5,11,45,41,4,44
Adelaide Utd,4998,5,11,6,11,37,40,-3,39
Brisbane,4998,6,10,5,13,33,42,-9,35
Western Sydn,4998,7,8,9,10,38,47,-9,33
Perth Glory,4998,8,10,2,15,37,50,-13,32
Wellington P,4998,9,5,6,16,31,55,-24,21
CC Mariners,4998,10,4,8,15,28,49,-21,20
Sydney FC,4999,1,21,4,3,66,22,44,67
N'castle Jet,4999,2,16,5,7,60,37,23,53
Melbourne C,4999,3,14,4,11,43,36,7,46
Melbourne V,4999,4,13,5,11,45,40,5,44
Adelaide Utd,4999,5,11,6,11,37,40,-3,39
Brisbane,4999,6,10,5,13,33,42,-9,35
Western Sydn,4999,7,8,9,10,38,47,-9,33
Perth Glory,4999,8,10,2,15,37,50,-13,32
Wellington P,4999,9,5,6,16,31,55,-24,21
CC Mariners,4999,10,4,8,15,28,49,-21,20
Sydney FC,5000,1,20,5,3,65,23,42,65
N'castle Jet,5000,2,16,5,7,60,38,22,53
Melbourne C,5000,3,14,4,11,44,36,8,46
Melbourne V,5000,4,13,6,10,46,39,7,45
Adelaide Utd,5000,5,11,6,11,37,40,-3,39
Brisbane,5000,6,10,5,13,33,42,-9,35
Western Sydn,5000,7,8,9,10,38,47,-9,33
Perth Glory,5000,8,10,2,15,37,50,-13,32
Wellington P,5000,9,5,6,16,31,55,-24,21
CC Mariners,5000,10,4,8,15,28,49,-21,20
Sydney FC,5001,1,21,4,3,66,22,44,67
N'castle Jet,5001,2,15,6,7,59,39,20,51
Melbourne C,5001,3,14,5,10,45,35,10,47
Melbourne V,5001,4,13,5,11,45,40,5,44
Adelaide Utd,5001,5,11,6,11,37,40,-3,39
Brisbane,5001,6,10,5,13,33,42,-9,35
Western Sydn,5001,7,8,9,10,38,47,-9,33
Perth Glory,5001,8,10,2,15,37,50,-13,32
Wellington P,5001,9,5,6,16,31,55,-24,21
CC Mariners,5001,10,4,8,15,28,49,-21,20
Sydney FC,5002,1,21,4,3,68,22,46,67
N'castle Jet,5002,2,15,6,7,58,38,20,51
Melbourne C,5002,3,14,5,10,44,34,10,47
Melbourne V,5002,4,13,5,11,45,42,3,44
Adelaide Utd,5002,5,11,6,11,37,40,-3,39
Brisbane,5002,6,10,5,13,33,42,-9,35
Western Sydn,5002,7,8,9,10,38,47,-9,33
Perth Glory,5002,8,10,2,15,37,50,-13,32
Wellington P,5002,9,5,6,16,31,55,-24,21
CC Mariners,5002,10,4,8,15,28,49,-21,20
Sydney FC,5003,1,21,4,3,65,22,43,67
N'castle Jet,5003,2,16,5,7,59,38,21,53
Melbourne C,5003,3,14,4,11,44,35,9,46
Melbourne V,5003,4,13,5,11,45,39,6,44
Adelaide Utd,5003,5,11,6,11,37,40,-3,39
Brisbane,5003,6,10,5,13,33,42,-9,35
Western Sydn,5003,7,8,9,10,38,47,-9,33
Perth Glory,5003,8,10,2,15,37,50,-13,32
Wellington P,5003,9,5,6,16,31,55,-24,21
CC Mariners,5003,10,4,8,15,28,49,-21,20
Sydney FC,5004,1,20,4,4,65,24,41,64
N'castle Jet,5004,2,15,6,7,60,40,20,51
Melbourne C,5004,3,14,5,10,46,36,10,47
Melbourne V,5004,4,14,5,10,47,39,8,47
Adelaide Utd,5004,5,11,6,11,37,40,-3,39
Brisbane,5004,6,10,5,13,33,42,-9,35
Western Sydn,5004,7,8,9,10,38,47,-9,33
Perth Glory,5004,8,10,2,15,37,50,-13,32
Wellington P,5004,9,5,6,16,31,55,-24,21
CC Mariners,5004,10,4,8,15,28,49,-21,20
Sydney FC,5005,1,21,4,3,68,23,45,67
N'castle Jet,5005,2,16,5,7,59,38,21,53
Melbourne C,5005,3,14,4,11,44,35,9,46
Melbourne V,5005,4,13,5,11,46,42,4,44
Adelaide Utd,5005,5,11,6,11,37,40,-3,39
Brisbane,5005,6,10,5,13,33,42,-9,35
Western Sydn,5005,7,8,9,10,38,47,-9,33
Perth Glory,5005,8,10,2,15,37,50,-13,32
Wellington P,5005,9,5,6,16,31,55,-24,21
CC Mariners,5005,10,4,8,15,28,49,-21,20
Sydney FC,5006,1,21,4,3,66,22,44,67
N'castle Jet,5006,2,16,5,7,59,37,22,53
Melbourne C,5006,3,14,4,11,43,35,8,46
Melbourne V,5006,4,13,5,11,45,40,5,44
Adelaide Utd,5006,5,11,6,11,37,40,-3,39
Brisbane,5006,6,10,5,13,33,42,-9,35
Western Sydn,5006,7,8,9,10,38,47,-9,33
Perth Glory,5006,8,10,2,15,37,50,-13,32
Wellington P,5006,9,5,6,16,31,55,-24,21
CC Mariners,5006,10,4,8,15,28,49,-21,20
Sydney FC,5007,1,20,4,4,65,24,41,64
N'castle Jet,5007,2,15,6,7,57,37,20,51
Melbourne C,5007,3,14,5,10,43,33,10,47
Melbourne V,5007,4,14,5,10,47,39,8,47
Adelaide Utd,5007,5,11,6,11,37,40,-3,39
Brisbane,5007,6,10,5,13,33,42,-9,35
Western Sydn,5007,7,8,9,10,38,47,-9,33
Perth Glory,5007,8,10,2,15,37,50,-13,32
Wellington P,5007,9,5,6,16,31,55,-24,21
CC Mariners,5007,10,4,8,15,28,49,-21,20
Sydney FC,5008,1,20,4,4,65,24,41,64
N'castle Jet,5008,2,16,5,7,60,38,22,53
Melbourne V,5008,3,14,5,10,47,39,8,47
Melbourne C,5008,4,14,4,11,44,36,8,46
Adelaide Utd,5008,5,11,6,11,37,40,-3,39
Brisbane,5008,6,10,5,13,33,42,-9,35
Western Sydn,5008,7,8,9,10,38,47,-9,33
Perth Glory,5008,8,10,2,15,37,50,-13,32
Wellington P,5008,9,5,6,16,31,55,-24,21
CC Mariners,5008,10,4,8,15,28,49,-21,20
Sydney FC,5009,1,21,4,3,66,22,44,67
N'castle Jet,5009,2,16,5,7,60,37,23,53
Melbourne C,5009,3,14,4,11,43,36,7,46
Melbourne V,5009,4,13,5,11,45,40,5,44
Adelaide Utd,5009,5,11,6,11,37,40,-3,39
Brisbane,5009,6,10,5,13,33,42,-9,35
Western Sydn,5009,7,8,9,10,38,47,-9,33
Perth Glory,5009,8,10,2,15,37,50,-13,32
Wellington P,5009,9,5,6,16,31,55,-24,21
CC Mariners,5009,10,4,8,15,28,49,-21,20
Sydney FC,5010,1,21,4,3,68,23,45,67
N'castle Jet,5010,2,16,5,7,59,37,22,53
Melbourne C,5010,3,14,4,11,43,35,8,46
Melbourne V,5010,4,13,5,11,46,42,4,44
Adelaide Utd,5010,5,11,6,11,37,40,-3,39
Brisbane,5010,6,10,5,13,33,42,-9,35
Western Sydn,5010,7,8,9,10,38,47,-9,33
Perth Glory,5010,8,10,2,15,37,50,-13,32
Wellington P,5010,9,5,6,16,31,55,-24,21
CC Mariners,5010,10,4,8,15,28,49,-21,20
Sydney FC,5011,1,21,4,3,66,23,43,67
N'castle Jet,5011,2,16,5,7,58,37,21,53
Melbourne C,5011,3,14,4,11,43,34,9,46
Melbourne V,5011,4,13,5,11,46,40,6,44
Adelaide Utd,5011,5,11,6,11,37,40,-3,39
Brisbane,5011,6,10,5,13,33,42,-9,35
Western Sydn,5011,7,8,9,10,38,47,-9,33
Perth Glory,5011,8,10,2,15,37,50,-13,32
Wellington P,5011,9,5,6,16,31,55,-24,21
CC Mariners,5011,10,4,8,15,28,49,-21,20
Sydney FC,5012,1,21,4,3,69,22,47,67
N'castle Jet,5012,2,16,5,7,58,37,21,53
Melbourne C,5012,3,14,4,11,43,34,9,46
Melbourne V,5012,4,13,5,11,45,43,2,44
Adelaide Utd,5012,5,11,6,11,37,40,-3,39
Brisbane,5012,6,10,5,13,33,42,-9,35
Western Sydn,5012,7,8,9,10,38,47,-9,33
Perth Glory,5012,8,10,2,15,37,50,-13,32
Wellington P,5012,9,5,6,16,31,55,-24,21
CC Mariners,5012,10,4,8,15,28,49,-21,20
Sydney FC,5013,1,20,5,3,65,23,42,65
N'castle Jet,5013,2,15,6,7,58,38,20,51
Melbourne C,5013,3,14,5,10,44,34,10,47
Melbourne V,5013,4,13,6,10,46,39,7,45
Adelaide Utd,5013,5,11,6,11,37,40,-3,39
Brisbane,5013,6,10,5,13,33,42,-9,35
Western Sydn,5013,7,8,9,10,38,47,-9,33
Perth Glory,5013,8,10,2,15,37,50,-13,32
Wellington P,5013,9,5,6,16,31,55,-24,21
CC Mariners,5013,10,4,8,15,28,49,-21,20
Sydney FC,5014,1,21,4,3,66,23,43,67
N'castle Jet,5014,2,16,5,7,60,39,21,53
Melbourne C,5014,3,14,4,11,45,36,9,46
Melbourne V,5014,4,13,5,11,46,40,6,44
Adelaide Utd,5014,5,11,6,11,37,40,-3,39
Brisbane,5014,6,10,5,13,33,42,-9,35
Western Sydn,5014,7,8,9,10,38,47,-9,33
Perth Glory,5014,8,10,2,15,37,50,-13,32
Wellington P,5014,9,5,6,16,31,55,-24,21
CC Mariners,5014,10,4,8,15,28,49,-21,20
Sydney FC,5015,1,21,4,3,67,22,45,67
N'castle Jet,5015,2,15,6,7,57,37,20,51
Melbourne C,5015,3,14,5,10,43,33,10,47
Melbourne V,5015,4,13,5,11,45,41,4,44
Adelaide Utd,5015,5,11,6,11,37,40,-3,39
Brisbane,5015,6,10,5,13,33,42,-9,35
Western Sydn,5015,7,8,9,10,38,47,-9,33
Perth Glory,5015,8,10,2,15,37,50,-13,32
Wellington P,5015,9,5,6,16,31,55,-24,21
CC Mariners,5015,10,4,8,15,28,49,-21,20
Sydney FC,5016,1,21,4,3,67,22,45,67
N'castle Jet,5016,2,15,5,8,58,39,19,50
Melbourne C,5016,3,15,4,10,45,34,11,49
Melbourne V,5016,4,13,5,11,45,41,4,44
Adelaide Utd,5016,5,11,6,11,37,40,-3,39
Brisbane,5016,6,10,5,13,33,42,-9,35
Western Sydn,5016,7,8,9,10,38,47,-9,33
Perth Glory,5016,8,10,2,15,37,50,-13,32
Wellington P,5016,9,5,6,16,31,55,-24,21
CC Mariners,5016,10,4,8,15,28,49,-21,20
Sydney FC,5017,1,20,5,3,66,24,42,65
N'castle Jet,5017,2,15,6,7,61,41,20,51
Melbourne C,5017,3,14,5,10,47,37,10,47
Melbourne V,5017,4,13,6,10,47,40,7,45
Adelaide Utd,5017,5,11,6,11,37,40,-3,39
Brisbane,5017,6,10,5,13,33,42,-9,35
Western Sydn,5017,7,8,9,10,38,47,-9,33
Perth Glory,5017,8,10,2,15,37,50,-13,32
Wellington P,5017,9,5,6,16,31,55,-24,21
CC Mariners,5017,10,4,8,15,28,49,-21,20
Sydney FC,5018,1,21,4,3,66,22,44,67
N'castle Jet,5018,2,16,5,7,58,37,21,53
Melbourne C,5018,3,14,4,11,43,34,9,46
Melbourne V,5018,4,13,5,11,45,40,5,44
Adelaide Utd,5018,5,11,6,11,37,40,-3,39
Brisbane,5018,6,10,5,13,33,42,-9,35
Western Sydn,5018,7,8,9,10,38,47,-9,33
Perth Glory,5018,8,10,2,15,37,50,-13,32
Wellington P,5018,9,5,6,16,31,55,-24,21
CC Mariners,5018,10,4,8,15,28,49,-21,20
Sydney FC,5019,1,20,5,3,66,24,42,65
N'castle Jet,5019,2,16,5,7,58,37,21,53
Melbourne C,5019,3,14,4,11,43,34,9,46
Melbourne V,5019,4,13,6,10,47,40,7,45
Adelaide Utd,5019,5,11,6,11,37,40,-3,39
Brisbane,5019,6,10,5,13,33,42,-9,35
Western Sydn,5019,7,8,9,10,38,47,-9,33
Perth Glory,5019,8,10,2,15,37,50,-13,32
Wellington P,5019,9,5,6,16,31,55,-24,21
CC Mariners,5019,10,4,8,15,28,49,-21,20
Sydney FC,5020,1,20,5,3,65,23,42,65
N'castle Jet,5020,2,15,6,7,59,39,20,51
Melbourne C,5020,3,14,5,10,45,35,10,47
Melbourne V,5020,4,13,6,10,46,39,7,45
Adelaide Utd,5020,5,11,6,11,37,40,-3,39
Brisbane,5020,6,10,5,13,33,42,-9,35
Western Sydn,5020,7,8,9,10,38,47,-9,33
Perth Glory,5020,8,10,2,15,37,50,-13,32
Wellington P,5020,9,5,6,16,31,55,-24,21
CC Mariners,5020,10,4,8,15,28,49,-21,20
Sydney FC,5021,1,21,4,3,65,22,43,67
N'castle Jet,5021,2,15,6,7,58,38,20,51
Melbourne C,5021,3,14,5,10,44,34,10,47
Melbourne V,5021,4,13,5,11,45,39,6,44
Adelaide Utd,5021,5,11,6,11,37,40,-3,39
Brisbane,5021,6,10,5,13,33,42,-9,35
Western Sydn,5021,7,8,9,10,38,47,-9,33
Perth Glory,5021,8,10,2,15,37,50,-13,32
Wellington P,5021,9,5,6,16,31,55,-24,21
CC Mariners,5021,10,4,8,15,28,49,-21,20
Sydney FC,5022,1,20,5,3,65,23,42,65
N'castle Jet,5022,2,16,5,7,59,37,22,53
Melbourne C,5022,3,14,4,11,43,35,8,46
Melbourne V,5022,4,13,6,10,46,39,7,45
Adelaide Utd,5022,5,11,6,11,37,40,-3,39
Brisbane,5022,6,10,5,13,33,42,-9,35
Western Sydn,5022,7,8,9,10,38,47,-9,33
Perth Glory,5022,8,10,2,15,37,50,-13,32
Wellington P,5022,9,5,6,16,31,55,-24,21
CC Mariners,5022,10,4,8,15,28,49,-21,20
Sydney FC,5023,1,20,5,3,65,23,42,65
N'castle Jet,5023,2,16,5,7,58,37,21,53
Melbourne C,5023,3,14,4,11,43,34,9,46
Melbourne V,5023,4,13,6,10,46,39,7,45
Adelaide Utd,5023,5,11,6,11,37,40,-3,39
Brisbane,5023,6,10,5,13,33,42,-9,35
Western Sydn,5023,7,8,9,10,38,47,-9,33
Perth Glory,5023,8,10,2,15,37,50,-13,32
Wellington P,5023,9,5,6,16,31,55,-24,21
CC Mariners,5023,10,4,8,15,28,49,-21,20
Sydney FC,5024,1,21,4,3,68,24,44,67
N'castle Jet,5024,2,16,5,7,58,37,21,53
Melbourne C,5024,3,14,4,11,43,34,9,46
Melbourne V,5024,4,13,5,11,47,42,5,44
Adelaide Utd,5024,5,11,6,11,37,40,-3,39
Brisbane,5024,6,10,5,13,33,42,-9,35
Western Sydn,5024,7,8,9,10,38,47,-9,33
Perth Glory,5024,8,10,2,15,37,50,-13,32
Wellington P,5024,9,5,6,16,31,55,-24,21
CC Mariners,5024,10,4,8,15,28,49,-21,20
Sydney FC,5025,1,21,4,3,66,22,44,67
N'castle Jet,5025,2,15,6,7,59,39,20,51
Melbourne C,5025,3,14,5,10,45,35,10,47
Melbourne V,5025,4,13,5,11,45,40,5,44
Adelaide Utd,5025,5,11,6,11,37,40,-3,39
Brisbane,5025,6,10,5,13,33,42,-9,35
Western Sydn,5025,7,8,9,10,38,47,-9,33
Perth Glory,5025,8,10,2,15,37,50,-13,32
Wellington P,5025,9,5,6,16,31,55,-24,21
CC Mariners,5025,10,4,8,15,28,49,-21,20
Sydney FC,5026,1,20,4,4,65,25,40,64
N'castle Jet,5026,2,16,5,7,62,38,24,53
Melbourne V,5026,3,14,5,10,48,39,9,47
Melbourne C,5026,4,14,4,11,44,38,6,46
Adelaide Utd,5026,5,11,6,11,37,40,-3,39
Brisbane,5026,6,10,5,13,33,42,-9,35
Western Sydn,5026,7,8,9,10,38,47,-9,33
Perth Glory,5026,8,10,2,15,37,50,-13,32
Wellington P,5026,9,5,6,16,31,55,-24,21
CC Mariners,5026,10,4,8,15,28,49,-21,20
Sydney FC,5027,1,20,5,3,65,23,42,65
N'castle Jet,5027,2,16,5,7,59,37,22,53
Melbourne C,5027,3,14,4,11,43,35,8,46
Melbourne V,5027,4,13,6,10,46,39,7,45
Adelaide Utd,5027,5,11,6,11,37,40,-3,39
Brisbane,5027,6,10,5,13,33,42,-9,35
Western Sydn,5027,7,8,9,10,38,47,-9,33
Perth Glory,5027,8,10,2,15,37,50,-13,32
Wellington P,5027,9,5,6,16,31,55,-24,21
CC Mariners,5027,10,4,8,15,28,49,-21,20
Sydney FC,5028,1,21,4,3,65,22,43,67
N'castle Jet,5028,2,15,5,8,59,40,19,50
Melbourne C,5028,3,15,4,10,46,35,11,49
Melbourne V,5028,4,13,5,11,45,39,6,44
Adelaide Utd,5028,5,11,6,11,37,40,-3,39
Brisbane,5028,6,10,5,13,33,42,-9,35
Western Sydn,5028,7,8,9,10,38,47,-9,33
Perth Glory,5028,8,10,2,15,37,50,-13,32
Wellington P,5028,9,5,6,16,31,55,-24,21
CC Mariners,5028,10,4,8,15,28,49,-21,20
Sydney FC,5029,1,21,4,3,65,22,43,67
N'castle Jet,5029,2,15,6,7,58,38,20,51
Melbourne C,5029,3,14,5,10,44,34,10,47
Melbourne V,5029,4,13,5,11,45,39,6,44
Adelaide Utd,5029,5,11,6,11,37,40,-3,39
Brisbane,5029,6,10,5,13,33,42,-9,35
Western Sydn,5029,7,8,9,10,38,47,-9,33
Perth Glory,5029,8,10,2,15,37,50,-13,32
Wellington P,5029,9,5,6,16,31,55,-24,21
CC Mariners,5029,10,4,8,15,28,49,-21,20
Sydney FC,5030,1,21,4,3,66,23,43,67
N'castle Jet,5030,2,16,5,7,58,37,21,53
Melbourne C,5030,3,14,4,11,43,34,9,46
Melbourne V,5030,4,13,5,11,46,40,6,44
Adelaide Utd,5030,5,11,6,11,37,40,-3,39
Brisbane,5030,6,10,5,13,33,42,-9,35
Western Sydn,5030,7,8,9,10,38,47,-9,33
Perth Glory,5030,8,10,2,15,37,50,-13,32
Wellington P,5030,9,5,6,16,31,55,-24,21
CC Mariners,5030,10,4,8,15,28,49,-21,20
Sydney FC,5031,1,20,5,3,67,25,42,65
N'castle Jet,5031,2,15,6,7,58,38,20,51
Melbourne C,5031,3,14,5,10,44,34,10,47
Melbourne V,5031,4,13,6,10,48,41,7,45
Adelaide Utd,5031,5,11,6,11,37,40,-3,39
Brisbane,5031,6,10,5,13,33,42,-9,35
Western Sydn,5031,7,8,9,10,38,47,-9,33
Perth Glory,5031,8,10,2,15,37,50,-13,32
Wellington P,5031,9,5,6,16,31,55,-24,21
CC Mariners,5031,10,4,8,15,28,49,-21,20
Sydney FC,5032,1,21,4,3,68,23,45,67
N'castle Jet,5032,2,16,5,7,58,37,21,53
Melbourne C,5032,3,14,4,11,43,34,9,46
Melbourne V,5032,4,13,5,11,46,42,4,44
Adelaide Utd,5032,5,11,6,11,37,40,-3,39
Brisbane,5032,6,10,5,13,33,42,-9,35
Western Sydn,5032,7,8,9,10,38,47,-9,33
Perth Glory,5032,8,10,2,15,37,50,-13,32
Wellington P,5032,9,5,6,16,31,55,-24,21
CC Mariners,5032,10,4,8,15,28,49,-21,20
Sydney FC,5033,1,21,4,3,66,23,43,67
N'castle Jet,5033,2,16,5,7,59,37,22,53
Melbourne C,5033,3,14,4,11,43,35,8,46
Melbourne V,5033,4,13,5,11,46,40,6,44
Adelaide Utd,5033,5,11,6,11,37,40,-3,39
Brisbane,5033,6,10,5,13,33,42,-9,35
Western Sydn,5033,7,8,9,10,38,47,-9,33
Perth Glory,5033,8,10,2,15,37,50,-13,32
Wellington P,5033,9,5,6,16,31,55,-24,21
CC Mariners,5033,10,4,8,15,28,49,-21,20
Sydney FC,5034,1,21,4,3,65,22,43,67
N'castle Jet,5034,2,16,5,7,58,37,21,53
Melbourne C,5034,3,14,4,11,43,34,9,46
Melbourne V,5034,4,13,5,11,45,39,6,44
Adelaide Utd,5034,5,11,6,11,37,40,-3,39
Brisbane,5034,6,10,5,13,33,42,-9,35
Western Sydn,5034,7,8,9,10,38,47,-9,33
Perth Glory,5034,8,10,2,15,37,50,-13,32
Wellington P,5034,9,5,6,16,31,55,-24,21
CC Mariners,5034,10,4,8,15,28,49,-21,20
Sydney FC,5035,1,21,4,3,66,22,44,67
N'castle Jet,5035,2,16,5,7,60,37,23,53
Melbourne C,5035,3,14,4,11,43,36,7,46
Melbourne V,5035,4,13,5,11,45,40,5,44
Adelaide Utd,5035,5,11,6,11,37,40,-3,39
Brisbane,5035,6,10,5,13,33,42,-9,35
Western Sydn,5035,7,8,9,10,38,47,-9,33
Perth Glory,5035,8,10,2,15,37,50,-13,32
Wellington P,5035,9,5,6,16,31,55,-24,21
CC Mariners,5035,10,4,8,15,28,49,-21,20
Sydney FC,5036,1,20,4,4,64,24,40,64
N'castle Jet,5036,2,16,5,7,59,38,21,53
Melbourne V,5036,3,14,5,10,47,38,9,47
Melbourne C,5036,4,14,4,11,44,35,9,46
Adelaide Utd,5036,5,11,6,11,37,40,-3,39
Brisbane,5036,6,10,5,13,33,42,-9,35
Western Sydn,5036,7,8,9,10,38,47,-9,33
Perth Glory,5036,8,10,2,15,37,50,-13,32
Wellington P,5036,9,5,6,16,31,55,-24,21
CC Mariners,5036,10,4,8,15,28,49,-21,20
Sydney FC,5037,1,21,4,3,68,22,46,67
N'castle Jet,5037,2,16,5,7,60,37,23,53
Melbourne C,5037,3,14,4,11,43,36,7,46
Melbourne V,5037,4,13,5,11,45,42,3,44
Adelaide Utd,5037,5,11,6,11,37,40,-3,39
Brisbane,5037,6,10,5,13,33,42,-9,35
Western Sydn,5037,7,8,9,10,38,47,-9,33
Perth Glory,5037,8,10,2,15,37,50,-13,32
Wellington P,5037,9,5,6,16,31,55,-24,21
CC Mariners,5037,10,4,8,15,28,49,-21,20
Sydney FC,5038,1,21,4,3,67,22,45,67
N'castle Jet,5038,2,15,5,8,58,42,16,50
Melbourne C,5038,3,15,4,10,48,34,14,49
Melbourne V,5038,4,13,5,11,45,41,4,44
Adelaide Utd,5038,5,11,6,11,37,40,-3,39
Brisbane,5038,6,10,5,13,33,42,-9,35
Western Sydn,5038,7,8,9,10,38,47,-9,33
Perth Glory,5038,8,10,2,15,37,50,-13,32
Wellington P,5038,9,5,6,16,31,55,-24,21
CC Mariners,5038,10,4,8,15,28,49,-21,20
Sydney FC,5039,1,21,4,3,68,22,46,67
N'castle Jet,5039,2,15,6,7,58,38,20,51
Melbourne C,5039,3,14,5,10,44,34,10,47
Melbourne V,5039,4,13,5,11,45,42,3,44
Adelaide Utd,5039,5,11,6,11,37,40,-3,39
Brisbane,5039,6,10,5,13,33,42,-9,35
Western Sydn,5039,7,8,9,10,38,47,-9,33
Perth Glory,5039,8,10,2,15,37,50,-13,32
Wellington P,5039,9,5,6,16,31,55,-24,21
CC Mariners,5039,10,4,8,15,28,49,-21,20
Sydney FC,5040,1,21,4,3,65,22,43,67
N'castle Jet,5040,2,15,6,7,58,38,20,51
Melbourne C,5040,3,14,5,10,44,34,10,47
Melbourne V,5040,4,13,5,11,45,39,6,44
Adelaide Utd,5040,5,11,6,11,37,40,-3,39
Brisbane,5040,6,10,5,13,33,42,-9,35
Western Sydn,5040,7,8,9,10,38,47,-9,33
Perth Glory,5040,8,10,2,15,37,50,-13,32
Wellington P,5040,9,5,6,16,31,55,-24,21
CC Mariners,5040,10,4,8,15,28,49,-21,20
Sydney FC,5041,1,20,4,4,64,23,41,64
N'castle Jet,5041,2,15,5,8,57,38,19,50
Melbourne C,5041,3,15,4,10,44,33,11,49
Melbourne V,5041,4,14,5,10,46,38,8,47
Adelaide Utd,5041,5,11,6,11,37,40,-3,39
Brisbane,5041,6,10,5,13,33,42,-9,35
Western Sydn,5041,7,8,9,10,38,47,-9,33
Perth Glory,5041,8,10,2,15,37,50,-13,32
Wellington P,5041,9,5,6,16,31,55,-24,21
CC Mariners,5041,10,4,8,15,28,49,-21,20
Sydney FC,5042,1,20,4,4,64,23,41,64
N'castle Jet,5042,2,15,5,8,59,40,19,50
Melbourne C,5042,3,15,4,10,46,35,11,49
Melbourne V,5042,4,14,5,10,46,38,8,47
Adelaide Utd,5042,5,11,6,11,37,40,-3,39
Brisbane,5042,6,10,5,13,33,42,-9,35
Western Sydn,5042,7,8,9,10,38,47,-9,33
Perth Glory,5042,8,10,2,15,37,50,-13,32
Wellington P,5042,9,5,6,16,31,55,-24,21
CC Mariners,5042,10,4,8,15,28,49,-21,20
Sydney FC,5043,1,20,4,4,65,24,41,64
N'castle Jet,5043,2,16,5,7,59,37,22,53
Melbourne V,5043,3,14,5,10,47,39,8,47
Melbourne C,5043,4,14,4,11,43,35,8,46
Adelaide Utd,5043,5,11,6,11,37,40,-3,39
Brisbane,5043,6,10,5,13,33,42,-9,35
Western Sydn,5043,7,8,9,10,38,47,-9,33
Perth Glory,5043,8,10,2,15,37,50,-13,32
Wellington P,5043,9,5,6,16,31,55,-24,21
CC Mariners,5043,10,4,8,15,28,49,-21,20
Sydney FC,5044,1,21,4,3,67,22,45,67
N'castle Jet,5044,2,16,5,7,59,38,21,53
Melbourne C,5044,3,14,4,11,44,35,9,46
Melbourne V,5044,4,13,5,11,45,41,4,44
Adelaide Utd,5044,5,11,6,11,37,40,-3,39
Brisbane,5044,6,10,5,13,33,42,-9,35
Western Sydn,5044,7,8,9,10,38,47,-9,33
Perth Glory,5044,8,10,2,15,37,50,-13,32
Wellington P,5044,9,5,6,16,31,55,-24,21
CC Mariners,5044,10,4,8,15,28,49,-21,20
Sydney FC,5045,1,20,4,4,65,24,41,64
N'castle Jet,5045,2,15,5,8,58,39,19,50
Melbourne C,5045,3,15,4,10,45,34,11,49
Melbourne V,5045,4,14,5,10,47,39,8,47
Adelaide Utd,5045,5,11,6,11,37,40,-3,39
Brisbane,5045,6,10,5,13,33,42,-9,35
Western Sydn,5045,7,8,9,10,38,47,-9,33
Perth Glory,5045,8,10,2,15,37,50,-13,32
Wellington P,5045,9,5,6,16,31,55,-24,21
CC Mariners,5045,10,4,8,15,28,49,-21,20
Sydney FC,5046,1,21,4,3,67,22,45,67
N'castle Jet,5046,2,15,5,8,57,38,19,50
Melbourne C,5046,3,15,4,10,44,33,11,49
Melbourne V,5046,4,13,5,11,45,41,4,44
Adelaide Utd,5046,5,11,6,11,37,40,-3,39
Brisbane,5046,6,10,5,13,33,42,-9,35
Western Sydn,5046,7,8,9,10,38,47,-9,33
Perth Glory,5046,8,10,2,15,37,50,-13,32
Wellington P,5046,9,5,6,16,31,55,-24,21
CC Mariners,5046,10,4,8,15,28,49,-21,20
Sydney FC,5047,1,20,5,3,66,24,42,65
N'castle Jet,5047,2,16,5,7,61,38,23,53
Melbourne C,5047,3,14,4,11,44,37,7,46
Melbourne V,5047,4,13,6,10,47,40,7,45
Adelaide Utd,5047,5,11,6,11,37,40,-3,39
Brisbane,5047,6,10,5,13,33,42,-9,35
Western Sydn,5047,7,8,9,10,38,47,-9,33
Perth Glory,5047,8,10,2,15,37,50,-13,32
Wellington P,5047,9,5,6,16,31,55,-24,21
CC Mariners,5047,10,4,8,15,28,49,-21,20
Sydney FC,5048,1,20,5,3,65,23,42,65
N'castle Jet,5048,2,15,6,7,57,37,20,51
Melbourne C,5048,3,14,5,10,43,33,10,47
Melbourne V,5048,4,13,6,10,46,39,7,45
Adelaide Utd,5048,5,11,6,11,37,40,-3,39
Brisbane,5048,6,10,5,13,33,42,-9,35
Western Sydn,5048,7,8,9,10,38,47,-9,33
Perth Glory,5048,8,10,2,15,37,50,-13,32
Wellington P,5048,9,5,6,16,31,55,-24,21
CC Mariners,5048,10,4,8,15,28,49,-21,20
Sydney FC,5049,1,21,4,3,67,22,45,67
N'castle Jet,5049,2,15,5,8,58,40,18,50
Melbourne C,5049,3,15,4,10,46,34,12,49
Melbourne V,5049,4,13,5,11,45,41,4,44
Adelaide Utd,5049,5,11,6,11,37,40,-3,39
Brisbane,5049,6,10,5,13,33,42,-9,35
Western Sydn,5049,7,8,9,10,38,47,-9,33
Perth Glory,5049,8,10,2,15,37,50,-13,32
Wellington P,5049,9,5,6,16,31,55,-24,21
CC Mariners,5049,10,4,8,15,28,49,-21,20
Sydney FC,5050,1,21,4,3,68,23,45,67
N'castle Jet,5050,2,15,6,7,60,40,20,51
Melbourne C,5050,3,14,5,10,46,36,10,47
Melbourne V,5050,4,13,5,11,46,42,4,44
Adelaide Utd,5050,5,11,6,11,37,40,-3,39
Brisbane,5050,6,10,5,13,33,42,-9,35
Western Sydn,5050,7,8,9,10,38,47,-9,33
Perth Glory,5050,8,10,2,15,37,50,-13,32
Wellington P,5050,9,5,6,16,31,55,-24,21
CC Mariners,5050,10,4,8,15,28,49,-21,20
Sydney FC,5051,1,21,4,3,67,22,45,67
N'castle Jet,5051,2,15,5,8,59,40,19,50
Melbourne C,5051,3,15,4,10,46,35,11,49
Melbourne V,5051,4,13,5,11,45,41,4,44
Adelaide Utd,5051,5,11,6,11,37,40,-3,39
Brisbane,5051,6,10,5,13,33,42,-9,35
Western Sydn,5051,7,8,9,10,38,47,-9,33
Perth Glory,5051,8,10,2,15,37,50,-13,32
Wellington P,5051,9,5,6,16,31,55,-24,21
CC Mariners,5051,10,4,8,15,28,49,-21,20
Sydney FC,5052,1,21,4,3,67,22,45,67
N'castle Jet,5052,2,15,6,7,59,39,20,51
Melbourne C,5052,3,14,5,10,45,35,10,47
Melbourne V,5052,4,13,5,11,45,41,4,44
Adelaide Utd,5052,5,11,6,11,37,40,-3,39
Brisbane,5052,6,10,5,13,33,42,-9,35
Western Sydn,5052,7,8,9,10,38,47,-9,33
Perth Glory,5052,8,10,2,15,37,50,-13,32
Wellington P,5052,9,5,6,16,31,55,-24,21
CC Mariners,5052,10,4,8,15,28,49,-21,20
Sydney FC,5053,1,20,5,3,66,24,42,65
N'castle Jet,5053,2,16,5,7,58,37,21,53
Melbourne C,5053,3,14,4,11,43,34,9,46
Melbourne V,5053,4,13,6,10,47,40,7,45
Adelaide Utd,5053,5,11,6,11,37,40,-3,39
Brisbane,5053,6,10,5,13,33,42,-9,35
Western Sydn,5053,7,8,9,10,38,47,-9,33
Perth Glory,5053,8,10,2,15,37,50,-13,32
Wellington P,5053,9,5,6,16,31,55,-24,21
CC Mariners,5053,10,4,8,15,28,49,-21,20
Sydney FC,5054,1,21,4,3,65,22,43,67
N'castle Jet,5054,2,15,5,8,57,38,19,50
Melbourne C,5054,3,15,4,10,44,33,11,49
Melbourne V,5054,4,13,5,11,45,39,6,44
Adelaide Utd,5054,5,11,6,11,37,40,-3,39
Brisbane,5054,6,10,5,13,33,42,-9,35
Western Sydn,5054,7,8,9,10,38,47,-9,33
Perth Glory,5054,8,10,2,15,37,50,-13,32
Wellington P,5054,9,5,6,16,31,55,-24,21
CC Mariners,5054,10,4,8,15,28,49,-21,20
Sydney FC,5055,1,20,5,3,66,24,42,65
N'castle Jet,5055,2,16,5,7,58,37,21,53
Melbourne C,5055,3,14,4,11,43,34,9,46
Melbourne V,5055,4,13,6,10,47,40,7,45
Adelaide Utd,5055,5,11,6,11,37,40,-3,39
Brisbane,5055,6,10,5,13,33,42,-9,35
Western Sydn,5055,7,8,9,10,38,47,-9,33
Perth Glory,5055,8,10,2,15,37,50,-13,32
Wellington P,5055,9,5,6,16,31,55,-24,21
CC Mariners,5055,10,4,8,15,28,49,-21,20
Sydney FC,5056,1,20,5,3,64,22,42,65
N'castle Jet,5056,2,15,6,7,58,38,20,51
Melbourne C,5056,3,14,5,10,44,34,10,47
Melbourne V,5056,4,13,6,10,45,38,7,45
Adelaide Utd,5056,5,11,6,11,37,40,-3,39
Brisbane,5056,6,10,5,13,33,42,-9,35
Western Sydn,5056,7,8,9,10,38,47,-9,33
Perth Glory,5056,8,10,2,15,37,50,-13,32
Wellington P,5056,9,5,6,16,31,55,-24,21
CC Mariners,5056,10,4,8,15,28,49,-21,20
Sydney FC,5057,1,20,4,4,65,24,41,64
N'castle Jet,5057,2,15,6,7,58,38,20,51
Melbourne C,5057,3,14,5,10,44,34,10,47
Melbourne V,5057,4,14,5,10,47,39,8,47
Adelaide Utd,5057,5,11,6,11,37,40,-3,39
Brisbane,5057,6,10,5,13,33,42,-9,35
Western Sydn,5057,7,8,9,10,38,47,-9,33
Perth Glory,5057,8,10,2,15,37,50,-13,32
Wellington P,5057,9,5,6,16,31,55,-24,21
CC Mariners,5057,10,4,8,15,28,49,-21,20
Sydney FC,5058,1,20,4,4,64,24,40,64
N'castle Jet,5058,2,15,6,7,57,37,20,51
Melbourne C,5058,3,14,5,10,43,33,10,47
Melbourne V,5058,4,14,5,10,47,38,9,47
Adelaide Utd,5058,5,11,6,11,37,40,-3,39
Brisbane,5058,6,10,5,13,33,42,-9,35
Western Sydn,5058,7,8,9,10,38,47,-9,33
Perth Glory,5058,8,10,2,15,37,50,-13,32
Wellington P,5058,9,5,6,16,31,55,-24,21
CC Mariners,5058,10,4,8,15,28,49,-21,20
Sydney FC,5059,1,21,4,3,69,23,46,67
N'castle Jet,5059,2,16,5,7,58,37,21,53
Melbourne C,5059,3,14,4,11,43,34,9,46
Melbourne V,5059,4,13,5,11,46,43,3,44
Adelaide Utd,5059,5,11,6,11,37,40,-3,39
Brisbane,5059,6,10,5,13,33,42,-9,35
Western Sydn,5059,7,8,9,10,38,47,-9,33
Perth Glory,5059,8,10,2,15,37,50,-13,32
Wellington P,5059,9,5,6,16,31,55,-24,21
CC Mariners,5059,10,4,8,15,28,49,-21,20
Sydney FC,5060,1,20,5,3,66,24,42,65
N'castle Jet,5060,2,16,5,7,61,38,23,53
Melbourne C,5060,3,14,4,11,44,37,7,46
Melbourne V,5060,4,13,6,10,47,40,7,45
Adelaide Utd,5060,5,11,6,11,37,40,-3,39
Brisbane,5060,6,10,5,13,33,42,-9,35
Western Sydn,5060,7,8,9,10,38,47,-9,33
Perth Glory,5060,8,10,2,15,37,50,-13,32
Wellington P,5060,9,5,6,16,31,55,-24,21
CC Mariners,5060,10,4,8,15,28,49,-21,20
Sydney FC,5061,1,21,4,3,68,23,45,67
N'castle Jet,5061,2,16,5,7,59,37,22,53
Melbourne C,5061,3,14,4,11,43,35,8,46
Melbourne V,5061,4,13,5,11,46,42,4,44
Adelaide Utd,5061,5,11,6,11,37,40,-3,39
Brisbane,5061,6,10,5,13,33,42,-9,35
Western Sydn,5061,7,8,9,10,38,47,-9,33
Perth Glory,5061,8,10,2,15,37,50,-13,32
Wellington P,5061,9,5,6,16,31,55,-24,21
CC Mariners,5061,10,4,8,15,28,49,-21,20
Sydney FC,5062,1,21,4,3,67,24,43,67
N'castle Jet,5062,2,16,5,7,59,37,22,53
Melbourne C,5062,3,14,4,11,43,35,8,46
Melbourne V,5062,4,13,5,11,47,41,6,44
Adelaide Utd,5062,5,11,6,11,37,40,-3,39
Brisbane,5062,6,10,5,13,33,42,-9,35
Western Sydn,5062,7,8,9,10,38,47,-9,33
Perth Glory,5062,8,10,2,15,37,50,-13,32
Wellington P,5062,9,5,6,16,31,55,-24,21
CC Mariners,5062,10,4,8,15,28,49,-21,20
Sydney FC,5063,1,20,4,4,65,27,38,64
N'castle Jet,5063,2,15,6,7,58,38,20,51
Melbourne V,5063,3,14,5,10,50,39,11,47
Melbourne C,5063,4,14,5,10,44,34,10,47
Adelaide Utd,5063,5,11,6,11,37,40,-3,39
Brisbane,5063,6,10,5,13,33,42,-9,35
Western Sydn,5063,7,8,9,10,38,47,-9,33
Perth Glory,5063,8,10,2,15,37,50,-13,32
Wellington P,5063,9,5,6,16,31,55,-24,21
CC Mariners,5063,10,4,8,15,28,49,-21,20
Sydney FC,5064,1,20,4,4,64,23,41,64
N'castle Jet,5064,2,16,5,7,61,39,22,53
Melbourne V,5064,3,14,5,10,46,38,8,47
Melbourne C,5064,4,14,4,11,45,37,8,46
Adelaide Utd,5064,5,11,6,11,37,40,-3,39
Brisbane,5064,6,10,5,13,33,42,-9,35
Western Sydn,5064,7,8,9,10,38,47,-9,33
Perth Glory,5064,8,10,2,15,37,50,-13,32
Wellington P,5064,9,5,6,16,31,55,-24,21
CC Mariners,5064,10,4,8,15,28,49,-21,20
Sydney FC,5065,1,21,4,3,67,22,45,67
N'castle Jet,5065,2,15,6,7,58,38,20,51
Melbourne C,5065,3,14,5,10,44,34,10,47
Melbourne V,5065,4,13,5,11,45,41,4,44
Adelaide Utd,5065,5,11,6,11,37,40,-3,39
Brisbane,5065,6,10,5,13,33,42,-9,35
Western Sydn,5065,7,8,9,10,38,47,-9,33
Perth Glory,5065,8,10,2,15,37,50,-13,32
Wellington P,5065,9,5,6,16,31,55,-24,21
CC Mariners,5065,10,4,8,15,28,49,-21,20
Sydney FC,5066,1,21,4,3,66,23,43,67
N'castle Jet,5066,2,16,5,7,61,40,21,53
Melbourne C,5066,3,14,4,11,46,37,9,46
Melbourne V,5066,4,13,5,11,46,40,6,44
Adelaide Utd,5066,5,11,6,11,37,40,-3,39
Brisbane,5066,6,10,5,13,33,42,-9,35
Western Sydn,5066,7,8,9,10,38,47,-9,33
Perth Glory,5066,8,10,2,15,37,50,-13,32
Wellington P,5066,9,5,6,16,31,55,-24,21
CC Mariners,5066,10,4,8,15,28,49,-21,20
Sydney FC,5067,1,21,4,3,67,23,44,67
N'castle Jet,5067,2,15,5,8,57,40,17,50
Melbourne C,5067,3,15,4,10,46,33,13,49
Melbourne V,5067,4,13,5,11,46,41,5,44
Adelaide Utd,5067,5,11,6,11,37,40,-3,39
Brisbane,5067,6,10,5,13,33,42,-9,35
Western Sydn,5067,7,8,9,10,38,47,-9,33
Perth Glory,5067,8,10,2,15,37,50,-13,32
Wellington P,5067,9,5,6,16,31,55,-24,21
CC Mariners,5067,10,4,8,15,28,49,-21,20
Sydney FC,5068,1,20,4,4,64,24,40,64
N'castle Jet,5068,2,15,5,8,57,39,18,50
Melbourne C,5068,3,15,4,10,45,33,12,49
Melbourne V,5068,4,14,5,10,47,38,9,47
Adelaide Utd,5068,5,11,6,11,37,40,-3,39
Brisbane,5068,6,10,5,13,33,42,-9,35
Western Sydn,5068,7,8,9,10,38,47,-9,33
Perth Glory,5068,8,10,2,15,37,50,-13,32
Wellington P,5068,9,5,6,16,31,55,-24,21
CC Mariners,5068,10,4,8,15,28,49,-21,20
Sydney FC,5069,1,20,5,3,65,23,42,65
N'castle Jet,5069,2,16,5,7,60,37,23,53
Melbourne C,5069,3,14,4,11,43,36,7,46
Melbourne V,5069,4,13,6,10,46,39,7,45
Adelaide Utd,5069,5,11,6,11,37,40,-3,39
Brisbane,5069,6,10,5,13,33,42,-9,35
Western Sydn,5069,7,8,9,10,38,47,-9,33
Perth Glory,5069,8,10,2,15,37,50,-13,32
Wellington P,5069,9,5,6,16,31,55,-24,21
CC Mariners,5069,10,4,8,15,28,49,-21,20
Sydney FC,5070,1,21,4,3,65,22,43,67
N'castle Jet,5070,2,15,5,8,57,39,18,50
Melbourne C,5070,3,15,4,10,45,33,12,49
Melbourne V,5070,4,13,5,11,45,39,6,44
Adelaide Utd,5070,5,11,6,11,37,40,-3,39
Brisbane,5070,6,10,5,13,33,42,-9,35
Western Sydn,5070,7,8,9,10,38,47,-9,33
Perth Glory,5070,8,10,2,15,37,50,-13,32
Wellington P,5070,9,5,6,16,31,55,-24,21
CC Mariners,5070,10,4,8,15,28,49,-21,20
Sydney FC,5071,1,20,4,4,65,24,41,64
N'castle Jet,5071,2,16,5,7,59,38,21,53
Melbourne V,5071,3,14,5,10,47,39,8,47
Melbourne C,5071,4,14,4,11,44,35,9,46
Adelaide Utd,5071,5,11,6,11,37,40,-3,39
Brisbane,5071,6,10,5,13,33,42,-9,35
Western Sydn,5071,7,8,9,10,38,47,-9,33
Perth Glory,5071,8,10,2,15,37,50,-13,32
Wellington P,5071,9,5,6,16,31,55,-24,21
CC Mariners,5071,10,4,8,15,28,49,-21,20
Sydney FC,5072,1,20,4,4,65,24,41,64
N'castle Jet,5072,2,16,5,7,61,38,23,53
Melbourne V,5072,3,14,5,10,47,39,8,47
Melbourne C,5072,4,14,4,11,44,37,7,46
Adelaide Utd,5072,5,11,6,11,37,40,-3,39
Brisbane,5072,6,10,5,13,33,42,-9,35
Western Sydn,5072,7,8,9,10,38,47,-9,33
Perth Glory,5072,8,10,2,15,37,50,-13,32
Wellington P,5072,9,5,6,16,31,55,-24,21
CC Mariners,5072,10,4,8,15,28,49,-21,20
Sydney FC,5073,1,20,4,4,65,24,41,64
N'castle Jet,5073,2,15,5,8,58,39,19,50
Melbourne C,5073,3,15,4,10,45,34,11,49
Melbourne V,5073,4,14,5,10,47,39,8,47
Adelaide Utd,5073,5,11,6,11,37,40,-3,39
Brisbane,5073,6,10,5,13,33,42,-9,35
Western Sydn,5073,7,8,9,10,38,47,-9,33
Perth Glory,5073,8,10,2,15,37,50,-13,32
Wellington P,5073,9,5,6,16,31,55,-24,21
CC Mariners,5073,10,4,8,15,28,49,-21,20
Sydney FC,5074,1,21,4,3,65,22,43,67
N'castle Jet,5074,2,15,5,8,57,38,19,50
Melbourne C,5074,3,15,4,10,44,33,11,49
Melbourne V,5074,4,13,5,11,45,39,6,44
Adelaide Utd,5074,5,11,6,11,37,40,-3,39
Brisbane,5074,6,10,5,13,33,42,-9,35
Western Sydn,5074,7,8,9,10,38,47,-9,33
Perth Glory,5074,8,10,2,15,37,50,-13,32
Wellington P,5074,9,5,6,16,31,55,-24,21
CC Mariners,5074,10,4,8,15,28,49,-21,20
Sydney FC,5075,1,21,4,3,67,23,44,67
N'castle Jet,5075,2,16,5,7,61,37,24,53
Melbourne C,5075,3,14,4,11,43,37,6,46
Melbourne V,5075,4,13,5,11,46,41,5,44
Adelaide Utd,5075,5,11,6,11,37,40,-3,39
Brisbane,5075,6,10,5,13,33,42,-9,35
Western Sydn,5075,7,8,9,10,38,47,-9,33
Perth Glory,5075,8,10,2,15,37,50,-13,32
Wellington P,5075,9,5,6,16,31,55,-24,21
CC Mariners,5075,10,4,8,15,28,49,-21,20
Sydney FC,5076,1,20,4,4,64,23,41,64
N'castle Jet,5076,2,15,5,8,58,39,19,50
Melbourne C,5076,3,15,4,10,45,34,11,49
Melbourne V,5076,4,14,5,10,46,38,8,47
Adelaide Utd,5076,5,11,6,11,37,40,-3,39
Brisbane,5076,6,10,5,13,33,42,-9,35
Western Sydn,5076,7,8,9,10,38,47,-9,33
Perth Glory,5076,8,10,2,15,37,50,-13,32
Wellington P,5076,9,5,6,16,31,55,-24,21
CC Mariners,5076,10,4,8,15,28,49,-21,20
Sydney FC,5077,1,21,4,3,68,23,45,67
N'castle Jet,5077,2,16,5,7,60,37,23,53
Melbourne C,5077,3,14,4,11,43,36,7,46
Melbourne V,5077,4,13,5,11,46,42,4,44
Adelaide Utd,5077,5,11,6,11,37,40,-3,39
Brisbane,5077,6,10,5,13,33,42,-9,35
Western Sydn,5077,7,8,9,10,38,47,-9,33
Perth Glory,5077,8,10,2,15,37,50,-13,32
Wellington P,5077,9,5,6,16,31,55,-24,21
CC Mariners,5077,10,4,8,15,28,49,-21,20
Sydney FC,5078,1,20,4,4,64,24,40,64
N'castle Jet,5078,2,16,5,7,58,37,21,53
Melbourne V,5078,3,14,5,10,47,38,9,47
Melbourne C,5078,4,14,4,11,43,34,9,46
Adelaide Utd,5078,5,11,6,11,37,40,-3,39
Brisbane,5078,6,10,5,13,33,42,-9,35
Western Sydn,5078,7,8,9,10,38,47,-9,33
Perth Glory,5078,8,10,2,15,37,50,-13,32
Wellington P,5078,9,5,6,16,31,55,-24,21
CC Mariners,5078,10,4,8,15,28,49,-21,20
Sydney FC,5079,1,20,5,3,64,22,42,65
N'castle Jet,5079,2,15,5,8,59,42,17,50
Melbourne C,5079,3,15,4,10,48,35,13,49
Melbourne V,5079,4,13,6,10,45,38,7,45
Adelaide Utd,5079,5,11,6,11,37,40,-3,39
Brisbane,5079,6,10,5,13,33,42,-9,35
Western Sydn,5079,7,8,9,10,38,47,-9,33
Perth Glory,5079,8,10,2,15,37,50,-13,32
Wellington P,5079,9,5,6,16,31,55,-24,21
CC Mariners,5079,10,4,8,15,28,49,-21,20
Sydney FC,5080,1,21,4,3,65,22,43,67
N'castle Jet,5080,2,16,5,7,60,37,23,53
Melbourne C,5080,3,14,4,11,43,36,7,46
Melbourne V,5080,4,13,5,11,45,39,6,44
Adelaide Utd,5080,5,11,6,11,37,40,-3,39
Brisbane,5080,6,10,5,13,33,42,-9,35
Western Sydn,5080,7,8,9,10,38,47,-9,33
Perth Glory,5080,8,10,2,15,37,50,-13,32
Wellington P,5080,9,5,6,16,31,55,-24,21
CC Mariners,5080,10,4,8,15,28,49,-21,20
Sydney FC,5081,1,21,4,3,67,22,45,67
N'castle Jet,5081,2,16,5,7,60,38,22,53
Melbourne C,5081,3,14,4,11,44,36,8,46
Melbourne V,5081,4,13,5,11,45,41,4,44
Adelaide Utd,5081,5,11,6,11,37,40,-3,39
Brisbane,5081,6,10,5,13,33,42,-9,35
Western Sydn,5081,7,8,9,10,38,47,-9,33
Perth Glory,5081,8,10,2,15,37,50,-13,32
Wellington P,5081,9,5,6,16,31,55,-24,21
CC Mariners,5081,10,4,8,15,28,49,-21,20
Sydney FC,5082,1,20,5,3,65,23,42,65
N'castle Jet,5082,2,16,5,7,61,39,22,53
Melbourne C,5082,3,14,4,11,45,37,8,46
Melbourne V,5082,4,13,6,10,46,39,7,45
Adelaide Utd,5082,5,11,6,11,37,40,-3,39
Brisbane,5082,6,10,5,13,33,42,-9,35
Western Sydn,5082,7,8,9,10,38,47,-9,33
Perth Glory,5082,8,10,2,15,37,50,-13,32
Wellington P,5082,9,5,6,16,31,55,-24,21
CC Mariners,5082,10,4,8,15,28,49,-21,20
Sydney FC,5083,1,21,4,3,65,22,43,67
N'castle Jet,5083,2,16,5,7,61,39,22,53
Melbourne C,5083,3,14,4,11,45,37,8,46
Melbourne V,5083,4,13,5,11,45,39,6,44
Adelaide Utd,5083,5,11,6,11,37,40,-3,39
Brisbane,5083,6,10,5,13,33,42,-9,35
Western Sydn,5083,7,8,9,10,38,47,-9,33
Perth Glory,5083,8,10,2,15,37,50,-13,32
Wellington P,5083,9,5,6,16,31,55,-24,21
CC Mariners,5083,10,4,8,15,28,49,-21,20
Sydney FC,5084,1,21,4,3,67,23,44,67
N'castle Jet,5084,2,16,5,7,58,37,21,53
Melbourne C,5084,3,14,4,11,43,34,9,46
Melbourne V,5084,4,13,5,11,46,41,5,44
Adelaide Utd,5084,5,11,6,11,37,40,-3,39
Brisbane,5084,6,10,5,13,33,42,-9,35
Western Sydn,5084,7,8,9,10,38,47,-9,33
Perth Glory,5084,8,10,2,15,37,50,-13,32
Wellington P,5084,9,5,6,16,31,55,-24,21
CC Mariners,5084,10,4,8,15,28,49,-21,20
Sydney FC,5085,1,21,4,3,67,22,45,67
N'castle Jet,5085,2,15,6,7,57,37,20,51
Melbourne C,5085,3,14,5,10,43,33,10,47
Melbourne V,5085,4,13,5,11,45,41,4,44
Adelaide Utd,5085,5,11,6,11,37,40,-3,39
Brisbane,5085,6,10,5,13,33,42,-9,35
Western Sydn,5085,7,8,9,10,38,47,-9,33
Perth Glory,5085,8,10,2,15,37,50,-13,32
Wellington P,5085,9,5,6,16,31,55,-24,21
CC Mariners,5085,10,4,8,15,28,49,-21,20
Sydney FC,5086,1,21,4,3,66,23,43,67
N'castle Jet,5086,2,15,6,7,59,39,20,51
Melbourne C,5086,3,14,5,10,45,35,10,47
Melbourne V,5086,4,13,5,11,46,40,6,44
Adelaide Utd,5086,5,11,6,11,37,40,-3,39
Brisbane,5086,6,10,5,13,33,42,-9,35
Western Sydn,5086,7,8,9,10,38,47,-9,33
Perth Glory,5086,8,10,2,15,37,50,-13,32
Wellington P,5086,9,5,6,16,31,55,-24,21
CC Mariners,5086,10,4,8,15,28,49,-21,20
Sydney FC,5087,1,21,4,3,66,22,44,67
N'castle Jet,5087,2,15,5,8,57,38,19,50
Melbourne C,5087,3,15,4,10,44,33,11,49
Melbourne V,5087,4,13,5,11,45,40,5,44
Adelaide Utd,5087,5,11,6,11,37,40,-3,39
Brisbane,5087,6,10,5,13,33,42,-9,35
Western Sydn,5087,7,8,9,10,38,47,-9,33
Perth Glory,5087,8,10,2,15,37,50,-13,32
Wellington P,5087,9,5,6,16,31,55,-24,21
CC Mariners,5087,10,4,8,15,28,49,-21,20
Sydney FC,5088,1,21,4,3,66,23,43,67
N'castle Jet,5088,2,16,5,7,59,37,22,53
Melbourne C,5088,3,14,4,11,43,35,8,46
Melbourne V,5088,4,13,5,11,46,40,6,44
Adelaide Utd,5088,5,11,6,11,37,40,-3,39
Brisbane,5088,6,10,5,13,33,42,-9,35
Western Sydn,5088,7,8,9,10,38,47,-9,33
Perth Glory,5088,8,10,2,15,37,50,-13,32
Wellington P,5088,9,5,6,16,31,55,-24,21
CC Mariners,5088,10,4,8,15,28,49,-21,20
Sydney FC,5089,1,21,4,3,66,22,44,67
N'castle Jet,5089,2,16,5,7,59,37,22,53
Melbourne C,5089,3,14,4,11,43,35,8,46
Melbourne V,5089,4,13,5,11,45,40,5,44
Adelaide Utd,5089,5,11,6,11,37,40,-3,39
Brisbane,5089,6,10,5,13,33,42,-9,35
Western Sydn,5089,7,8,9,10,38,47,-9,33
Perth Glory,5089,8,10,2,15,37,50,-13,32
Wellington P,5089,9,5,6,16,31,55,-24,21
CC Mariners,5089,10,4,8,15,28,49,-21,20
Sydney FC,5090,1,21,4,3,65,22,43,67
N'castle Jet,5090,2,16,5,7,59,38,21,53
Melbourne C,5090,3,14,4,11,44,35,9,46
Melbourne V,5090,4,13,5,11,45,39,6,44
Adelaide Utd,5090,5,11,6,11,37,40,-3,39
Brisbane,5090,6,10,5,13,33,42,-9,35
Western Sydn,5090,7,8,9,10,38,47,-9,33
Perth Glory,5090,8,10,2,15,37,50,-13,32
Wellington P,5090,9,5,6,16,31,55,-24,21
CC Mariners,5090,10,4,8,15,28,49,-21,20
Sydney FC,5091,1,21,4,3,65,22,43,67
N'castle Jet,5091,2,15,5,8,58,41,17,50
Melbourne C,5091,3,15,4,10,47,34,13,49
Melbourne V,5091,4,13,5,11,45,39,6,44
Adelaide Utd,5091,5,11,6,11,37,40,-3,39
Brisbane,5091,6,10,5,13,33,42,-9,35
Western Sydn,5091,7,8,9,10,38,47,-9,33
Perth Glory,5091,8,10,2,15,37,50,-13,32
Wellington P,5091,9,5,6,16,31,55,-24,21
CC Mariners,5091,10,4,8,15,28,49,-21,20
Sydney FC,5092,1,21,4,3,67,23,44,67
N'castle Jet,5092,2,15,6,7,58,38,20,51
Melbourne C,5092,3,14,5,10,44,34,10,47
Melbourne V,5092,4,13,5,11,46,41,5,44
Adelaide Utd,5092,5,11,6,11,37,40,-3,39
Brisbane,5092,6,10,5,13,33,42,-9,35
Western Sydn,5092,7,8,9,10,38,47,-9,33
Perth Glory,5092,8,10,2,15,37,50,-13,32
Wellington P,5092,9,5,6,16,31,55,-24,21
CC Mariners,5092,10,4,8,15,28,49,-21,20
Sydney FC,5093,1,21,4,3,68,22,46,67
N'castle Jet,5093,2,16,5,7,60,39,21,53
Melbourne C,5093,3,14,4,11,45,36,9,46
Melbourne V,5093,4,13,5,11,45,42,3,44
Adelaide Utd,5093,5,11,6,11,37,40,-3,39
Brisbane,5093,6,10,5,13,33,42,-9,35
Western Sydn,5093,7,8,9,10,38,47,-9,33
Perth Glory,5093,8,10,2,15,37,50,-13,32
Wellington P,5093,9,5,6,16,31,55,-24,21
CC Mariners,5093,10,4,8,15,28,49,-21,20
Sydney FC,5094,1,20,5,3,64,22,42,65
N'castle Jet,5094,2,16,5,7,58,37,21,53
Melbourne C,5094,3,14,4,11,43,34,9,46
Melbourne V,5094,4,13,6,10,45,38,7,45
Adelaide Utd,5094,5,11,6,11,37,40,-3,39
Brisbane,5094,6,10,5,13,33,42,-9,35
Western Sydn,5094,7,8,9,10,38,47,-9,33
Perth Glory,5094,8,10,2,15,37,50,-13,32
Wellington P,5094,9,5,6,16,31,55,-24,21
CC Mariners,5094,10,4,8,15,28,49,-21,20
Sydney FC,5095,1,20,5,3,65,23,42,65
N'castle Jet,5095,2,15,5,8,57,38,19,50
Melbourne C,5095,3,15,4,10,44,33,11,49
Melbourne V,5095,4,13,6,10,46,39,7,45
Adelaide Utd,5095,5,11,6,11,37,40,-3,39
Brisbane,5095,6,10,5,13,33,42,-9,35
Western Sydn,5095,7,8,9,10,38,47,-9,33
Perth Glory,5095,8,10,2,15,37,50,-13,32
Wellington P,5095,9,5,6,16,31,55,-24,21
CC Mariners,5095,10,4,8,15,28,49,-21,20
Sydney FC,5096,1,21,4,3,66,22,44,67
N'castle Jet,5096,2,16,5,7,59,38,21,53
Melbourne C,5096,3,14,4,11,44,35,9,46
Melbourne V,5096,4,13,5,11,45,40,5,44
Adelaide Utd,5096,5,11,6,11,37,40,-3,39
Brisbane,5096,6,10,5,13,33,42,-9,35
Western Sydn,5096,7,8,9,10,38,47,-9,33
Perth Glory,5096,8,10,2,15,37,50,-13,32
Wellington P,5096,9,5,6,16,31,55,-24,21
CC Mariners,5096,10,4,8,15,28,49,-21,20
Sydney FC,5097,1,21,4,3,66,22,44,67
N'castle Jet,5097,2,15,6,7,59,39,20,51
Melbourne C,5097,3,14,5,10,45,35,10,47
Melbourne V,5097,4,13,5,11,45,40,5,44
Adelaide Utd,5097,5,11,6,11,37,40,-3,39
Brisbane,5097,6,10,5,13,33,42,-9,35
Western Sydn,5097,7,8,9,10,38,47,-9,33
Perth Glory,5097,8,10,2,15,37,50,-13,32
Wellington P,5097,9,5,6,16,31,55,-24,21
CC Mariners,5097,10,4,8,15,28,49,-21,20
Sydney FC,5098,1,20,5,3,65,23,42,65
N'castle Jet,5098,2,15,5,8,57,38,19,50
Melbourne C,5098,3,15,4,10,44,33,11,49
Melbourne V,5098,4,13,6,10,46,39,7,45
Adelaide Utd,5098,5,11,6,11,37,40,-3,39
Brisbane,5098,6,10,5,13,33,42,-9,35
Western Sydn,5098,7,8,9,10,38,47,-9,33
Perth Glory,5098,8,10,2,15,37,50,-13,32
Wellington P,5098,9,5,6,16,31,55,-24,21
CC Mariners,5098,10,4,8,15,28,49,-21,20
Sydney FC,5099,1,20,4,4,64,23,41,64
N'castle Jet,5099,2,15,5,8,57,38,19,50
Melbourne C,5099,3,15,4,10,44,33,11,49
Melbourne V,5099,4,14,5,10,46,38,8,47
Adelaide Utd,5099,5,11,6,11,37,40,-3,39
Brisbane,5099,6,10,5,13,33,42,-9,35
Western Sydn,5099,7,8,9,10,38,47,-9,33
Perth Glory,5099,8,10,2,15,37,50,-13,32
Wellington P,5099,9,5,6,16,31,55,-24,21
CC Mariners,5099,10,4,8,15,28,49,-21,20
Sydney FC,5100,1,21,4,3,67,22,45,67
N'castle Jet,5100,2,16,5,7,58,37,21,53
Melbourne C,5100,3,14,4,11,43,34,9,46
Melbourne V,5100,4,13,5,11,45,41,4,44
Adelaide Utd,5100,5,11,6,11,37,40,-3,39
Brisbane,5100,6,10,5,13,33,42,-9,35
Western Sydn,5100,7,8,9,10,38,47,-9,33
Perth Glory,5100,8,10,2,15,37,50,-13,32
Wellington P,5100,9,5,6,16,31,55,-24,21
CC Mariners,5100,10,4,8,15,28,49,-21,20
Sydney FC,5101,1,21,4,3,67,23,44,67
N'castle Jet,5101,2,15,5,8,58,39,19,50
Melbourne C,5101,3,15,4,10,45,34,11,49
Melbourne V,5101,4,13,5,11,46,41,5,44
Adelaide Utd,5101,5,11,6,11,37,40,-3,39
Brisbane,5101,6,10,5,13,33,42,-9,35
Western Sydn,5101,7,8,9,10,38,47,-9,33
Perth Glory,5101,8,10,2,15,37,50,-13,32
Wellington P,5101,9,5,6,16,31,55,-24,21
CC Mariners,5101,10,4,8,15,28,49,-21,20
Sydney FC,5102,1,21,4,3,69,24,45,67
N'castle Jet,5102,2,16,5,7,59,38,21,53
Melbourne C,5102,3,14,4,11,44,35,9,46
Melbourne V,5102,4,13,5,11,47,43,4,44
Adelaide Utd,5102,5,11,6,11,37,40,-3,39
Brisbane,5102,6,10,5,13,33,42,-9,35
Western Sydn,5102,7,8,9,10,38,47,-9,33
Perth Glory,5102,8,10,2,15,37,50,-13,32
Wellington P,5102,9,5,6,16,31,55,-24,21
CC Mariners,5102,10,4,8,15,28,49,-21,20
Sydney FC,5103,1,21,4,3,69,22,47,67
N'castle Jet,5103,2,15,6,7,60,40,20,51
Melbourne C,5103,3,14,5,10,46,36,10,47
Melbourne V,5103,4,13,5,11,45,43,2,44
Adelaide Utd,5103,5,11,6,11,37,40,-3,39
Brisbane,5103,6,10,5,13,33,42,-9,35
Western Sydn,5103,7,8,9,10,38,47,-9,33
Perth Glory,5103,8,10,2,15,37,50,-13,32
Wellington P,5103,9,5,6,16,31,55,-24,21
CC Mariners,5103,10,4,8,15,28,49,-21,20
Sydney FC,5104,1,21,4,3,68,23,45,67
N'castle Jet,5104,2,16,5,7,59,38,21,53
Melbourne C,5104,3,14,4,11,44,35,9,46
Melbourne V,5104,4,13,5,11,46,42,4,44
Adelaide Utd,5104,5,11,6,11,37,40,-3,39
Brisbane,5104,6,10,5,13,33,42,-9,35
Western Sydn,5104,7,8,9,10,38,47,-9,33
Perth Glory,5104,8,10,2,15,37,50,-13,32
Wellington P,5104,9,5,6,16,31,55,-24,21
CC Mariners,5104,10,4,8,15,28,49,-21,20
Sydney FC,5105,1,21,4,3,66,23,43,67
N'castle Jet,5105,2,15,6,7,60,40,20,51
Melbourne C,5105,3,14,5,10,46,36,10,47
Melbourne V,5105,4,13,5,11,46,40,6,44
Adelaide Utd,5105,5,11,6,11,37,40,-3,39
Brisbane,5105,6,10,5,13,33,42,-9,35
Western Sydn,5105,7,8,9,10,38,47,-9,33
Perth Glory,5105,8,10,2,15,37,50,-13,32
Wellington P,5105,9,5,6,16,31,55,-24,21
CC Mariners,5105,10,4,8,15,28,49,-21,20
Sydney FC,5106,1,20,4,4,65,24,41,64
N'castle Jet,5106,2,16,5,7,59,38,21,53
Melbourne V,5106,3,14,5,10,47,39,8,47
Melbourne C,5106,4,14,4,11,44,35,9,46
Adelaide Utd,5106,5,11,6,11,37,40,-3,39
Brisbane,5106,6,10,5,13,33,42,-9,35
Western Sydn,5106,7,8,9,10,38,47,-9,33
Perth Glory,5106,8,10,2,15,37,50,-13,32
Wellington P,5106,9,5,6,16,31,55,-24,21
CC Mariners,5106,10,4,8,15,28,49,-21,20
Sydney FC,5107,1,21,4,3,65,22,43,67
N'castle Jet,5107,2,15,6,7,59,39,20,51
Melbourne C,5107,3,14,5,10,45,35,10,47
Melbourne V,5107,4,13,5,11,45,39,6,44
Adelaide Utd,5107,5,11,6,11,37,40,-3,39
Brisbane,5107,6,10,5,13,33,42,-9,35
Western Sydn,5107,7,8,9,10,38,47,-9,33
Perth Glory,5107,8,10,2,15,37,50,-13,32
Wellington P,5107,9,5,6,16,31,55,-24,21
CC Mariners,5107,10,4,8,15,28,49,-21,20
Sydney FC,5108,1,21,4,3,68,24,44,67
N'castle Jet,5108,2,16,5,7,60,39,21,53
Melbourne C,5108,3,14,4,11,45,36,9,46
Melbourne V,5108,4,13,5,11,47,42,5,44
Adelaide Utd,5108,5,11,6,11,37,40,-3,39
Brisbane,5108,6,10,5,13,33,42,-9,35
Western Sydn,5108,7,8,9,10,38,47,-9,33
Perth Glory,5108,8,10,2,15,37,50,-13,32
Wellington P,5108,9,5,6,16,31,55,-24,21
CC Mariners,5108,10,4,8,15,28,49,-21,20
Sydney FC,5109,1,21,4,3,68,23,45,67
N'castle Jet,5109,2,15,5,8,57,38,19,50
Melbourne C,5109,3,15,4,10,44,33,11,49
Melbourne V,5109,4,13,5,11,46,42,4,44
Adelaide Utd,5109,5,11,6,11,37,40,-3,39
Brisbane,5109,6,10,5,13,33,42,-9,35
Western Sydn,5109,7,8,9,10,38,47,-9,33
Perth Glory,5109,8,10,2,15,37,50,-13,32
Wellington P,5109,9,5,6,16,31,55,-24,21
CC Mariners,5109,10,4,8,15,28,49,-21,20
Sydney FC,5110,1,21,4,3,65,22,43,67
N'castle Jet,5110,2,15,6,7,59,39,20,51
Melbourne C,5110,3,14,5,10,45,35,10,47
Melbourne V,5110,4,13,5,11,45,39,6,44
Adelaide Utd,5110,5,11,6,11,37,40,-3,39
Brisbane,5110,6,10,5,13,33,42,-9,35
Western Sydn,5110,7,8,9,10,38,47,-9,33
Perth Glory,5110,8,10,2,15,37,50,-13,32
Wellington P,5110,9,5,6,16,31,55,-24,21
CC Mariners,5110,10,4,8,15,28,49,-21,20
Sydney FC,5111,1,20,4,4,64,24,40,64
N'castle Jet,5111,2,15,5,8,61,42,19,50
Melbourne C,5111,3,15,4,10,48,37,11,49
Melbourne V,5111,4,14,5,10,47,38,9,47
Adelaide Utd,5111,5,11,6,11,37,40,-3,39
Brisbane,5111,6,10,5,13,33,42,-9,35
Western Sydn,5111,7,8,9,10,38,47,-9,33
Perth Glory,5111,8,10,2,15,37,50,-13,32
Wellington P,5111,9,5,6,16,31,55,-24,21
CC Mariners,5111,10,4,8,15,28,49,-21,20
Sydney FC,5112,1,21,4,3,68,22,46,67
N'castle Jet,5112,2,15,5,8,57,38,19,50
Melbourne C,5112,3,15,4,10,44,33,11,49
Melbourne V,5112,4,13,5,11,45,42,3,44
Adelaide Utd,5112,5,11,6,11,37,40,-3,39
Brisbane,5112,6,10,5,13,33,42,-9,35
Western Sydn,5112,7,8,9,10,38,47,-9,33
Perth Glory,5112,8,10,2,15,37,50,-13,32
Wellington P,5112,9,5,6,16,31,55,-24,21
CC Mariners,5112,10,4,8,15,28,49,-21,20
Sydney FC,5113,1,21,4,3,71,22,49,67
N'castle Jet,5113,2,16,5,7,60,38,22,53
Melbourne C,5113,3,14,4,11,44,36,8,46
Melbourne V,5113,4,13,5,11,45,45,0,44
Adelaide Utd,5113,5,11,6,11,37,40,-3,39
Brisbane,5113,6,10,5,13,33,42,-9,35
Western Sydn,5113,7,8,9,10,38,47,-9,33
Perth Glory,5113,8,10,2,15,37,50,-13,32
Wellington P,5113,9,5,6,16,31,55,-24,21
CC Mariners,5113,10,4,8,15,28,49,-21,20
Sydney FC,5114,1,21,4,3,66,22,44,67
N'castle Jet,5114,2,15,5,8,58,39,19,50
Melbourne C,5114,3,15,4,10,45,34,11,49
Melbourne V,5114,4,13,5,11,45,40,5,44
Adelaide Utd,5114,5,11,6,11,37,40,-3,39
Brisbane,5114,6,10,5,13,33,42,-9,35
Western Sydn,5114,7,8,9,10,38,47,-9,33
Perth Glory,5114,8,10,2,15,37,50,-13,32
Wellington P,5114,9,5,6,16,31,55,-24,21
CC Mariners,5114,10,4,8,15,28,49,-21,20
Sydney FC,5115,1,21,4,3,68,23,45,67
N'castle Jet,5115,2,15,6,7,60,40,20,51
Melbourne C,5115,3,14,5,10,46,36,10,47
Melbourne V,5115,4,13,5,11,46,42,4,44
Adelaide Utd,5115,5,11,6,11,37,40,-3,39
Brisbane,5115,6,10,5,13,33,42,-9,35
Western Sydn,5115,7,8,9,10,38,47,-9,33
Perth Glory,5115,8,10,2,15,37,50,-13,32
Wellington P,5115,9,5,6,16,31,55,-24,21
CC Mariners,5115,10,4,8,15,28,49,-21,20
Sydney FC,5116,1,21,4,3,67,22,45,67
N'castle Jet,5116,2,15,6,7,59,39,20,51
Melbourne C,5116,3,14,5,10,45,35,10,47
Melbourne V,5116,4,13,5,11,45,41,4,44
Adelaide Utd,5116,5,11,6,11,37,40,-3,39
Brisbane,5116,6,10,5,13,33,42,-9,35
Western Sydn,5116,7,8,9,10,38,47,-9,33
Perth Glory,5116,8,10,2,15,37,50,-13,32
Wellington P,5116,9,5,6,16,31,55,-24,21
CC Mariners,5116,10,4,8,15,28,49,-21,20
Sydney FC,5117,1,21,4,3,68,22,46,67
N'castle Jet,5117,2,15,6,7,58,38,20,51
Melbourne C,5117,3,14,5,10,44,34,10,47
Melbourne V,5117,4,13,5,11,45,42,3,44
Adelaide Utd,5117,5,11,6,11,37,40,-3,39
Brisbane,5117,6,10,5,13,33,42,-9,35
Western Sydn,5117,7,8,9,10,38,47,-9,33
Perth Glory,5117,8,10,2,15,37,50,-13,32
Wellington P,5117,9,5,6,16,31,55,-24,21
CC Mariners,5117,10,4,8,15,28,49,-21,20
Sydney FC,5118,1,20,4,4,65,24,41,64
N'castle Jet,5118,2,16,5,7,59,38,21,53
Melbourne V,5118,3,14,5,10,47,39,8,47
Melbourne C,5118,4,14,4,11,44,35,9,46
Adelaide Utd,5118,5,11,6,11,37,40,-3,39
Brisbane,5118,6,10,5,13,33,42,-9,35
Western Sydn,5118,7,8,9,10,38,47,-9,33
Perth Glory,5118,8,10,2,15,37,50,-13,32
Wellington P,5118,9,5,6,16,31,55,-24,21
CC Mariners,5118,10,4,8,15,28,49,-21,20
Sydney FC,5119,1,20,5,3,65,23,42,65
N'castle Jet,5119,2,15,5,8,57,38,19,50
Melbourne C,5119,3,15,4,10,44,33,11,49
Melbourne V,5119,4,13,6,10,46,39,7,45
Adelaide Utd,5119,5,11,6,11,37,40,-3,39
Brisbane,5119,6,10,5,13,33,42,-9,35
Western Sydn,5119,7,8,9,10,38,47,-9,33
Perth Glory,5119,8,10,2,15,37,50,-13,32
Wellington P,5119,9,5,6,16,31,55,-24,21
CC Mariners,5119,10,4,8,15,28,49,-21,20
Sydney FC,5120,1,21,4,3,66,22,44,67
N'castle Jet,5120,2,16,5,7,58,37,21,53
Melbourne C,5120,3,14,4,11,43,34,9,46
Melbourne V,5120,4,13,5,11,45,40,5,44
Adelaide Utd,5120,5,11,6,11,37,40,-3,39
Brisbane,5120,6,10,5,13,33,42,-9,35
Western Sydn,5120,7,8,9,10,38,47,-9,33
Perth Glory,5120,8,10,2,15,37,50,-13,32
Wellington P,5120,9,5,6,16,31,55,-24,21
CC Mariners,5120,10,4,8,15,28,49,-21,20
Sydney FC,5121,1,21,4,3,66,23,43,67
N'castle Jet,5121,2,15,6,7,59,39,20,51
Melbourne C,5121,3,14,5,10,45,35,10,47
Melbourne V,5121,4,13,5,11,46,40,6,44
Adelaide Utd,5121,5,11,6,11,37,40,-3,39
Brisbane,5121,6,10,5,13,33,42,-9,35
Western Sydn,5121,7,8,9,10,38,47,-9,33
Perth Glory,5121,8,10,2,15,37,50,-13,32
Wellington P,5121,9,5,6,16,31,55,-24,21
CC Mariners,5121,10,4,8,15,28,49,-21,20
Sydney FC,5122,1,21,4,3,65,22,43,67
N'castle Jet,5122,2,15,5,8,58,40,18,50
Melbourne C,5122,3,15,4,10,46,34,12,49
Melbourne V,5122,4,13,5,11,45,39,6,44
Adelaide Utd,5122,5,11,6,11,37,40,-3,39
Brisbane,5122,6,10,5,13,33,42,-9,35
Western Sydn,5122,7,8,9,10,38,47,-9,33
Perth Glory,5122,8,10,2,15,37,50,-13,32
Wellington P,5122,9,5,6,16,31,55,-24,21
CC Mariners,5122,10,4,8,15,28,49,-21,20
Sydney FC,5123,1,20,5,3,65,23,42,65
N'castle Jet,5123,2,16,5,7,60,37,23,53
Melbourne C,5123,3,14,4,11,43,36,7,46
Melbourne V,5123,4,13,6,10,46,39,7,45
Adelaide Utd,5123,5,11,6,11,37,40,-3,39
Brisbane,5123,6,10,5,13,33,42,-9,35
Western Sydn,5123,7,8,9,10,38,47,-9,33
Perth Glory,5123,8,10,2,15,37,50,-13,32
Wellington P,5123,9,5,6,16,31,55,-24,21
CC Mariners,5123,10,4,8,15,28,49,-21,20
Sydney FC,5124,1,21,4,3,67,24,43,67
N'castle Jet,5124,2,16,5,7,59,37,22,53
Melbourne C,5124,3,14,4,11,43,35,8,46
Melbourne V,5124,4,13,5,11,47,41,6,44
Adelaide Utd,5124,5,11,6,11,37,40,-3,39
Brisbane,5124,6,10,5,13,33,42,-9,35
Western Sydn,5124,7,8,9,10,38,47,-9,33
Perth Glory,5124,8,10,2,15,37,50,-13,32
Wellington P,5124,9,5,6,16,31,55,-24,21
CC Mariners,5124,10,4,8,15,28,49,-21,20
Sydney FC,5125,1,21,4,3,66,23,43,67
N'castle Jet,5125,2,15,6,7,57,37,20,51
Melbourne C,5125,3,14,5,10,43,33,10,47
Melbourne V,5125,4,13,5,11,46,40,6,44
Adelaide Utd,5125,5,11,6,11,37,40,-3,39
Brisbane,5125,6,10,5,13,33,42,-9,35
Western Sydn,5125,7,8,9,10,38,47,-9,33
Perth Glory,5125,8,10,2,15,37,50,-13,32
Wellington P,5125,9,5,6,16,31,55,-24,21
CC Mariners,5125,10,4,8,15,28,49,-21,20
Sydney FC,5126,1,21,4,3,65,22,43,67
N'castle Jet,5126,2,15,6,7,58,38,20,51
Melbourne C,5126,3,14,5,10,44,34,10,47
Melbourne V,5126,4,13,5,11,45,39,6,44
Adelaide Utd,5126,5,11,6,11,37,40,-3,39
Brisbane,5126,6,10,5,13,33,42,-9,35
Western Sydn,5126,7,8,9,10,38,47,-9,33
Perth Glory,5126,8,10,2,15,37,50,-13,32
Wellington P,5126,9,5,6,16,31,55,-24,21
CC Mariners,5126,10,4,8,15,28,49,-21,20
Sydney FC,5127,1,20,4,4,65,25,40,64
N'castle Jet,5127,2,16,5,7,60,37,23,53
Melbourne V,5127,3,14,5,10,48,39,9,47
Melbourne C,5127,4,14,4,11,43,36,7,46
Adelaide Utd,5127,5,11,6,11,37,40,-3,39
Brisbane,5127,6,10,5,13,33,42,-9,35
Western Sydn,5127,7,8,9,10,38,47,-9,33
Perth Glory,5127,8,10,2,15,37,50,-13,32
Wellington P,5127,9,5,6,16,31,55,-24,21
CC Mariners,5127,10,4,8,15,28,49,-21,20
Sydney FC,5128,1,21,4,3,65,22,43,67
N'castle Jet,5128,2,15,6,7,57,37,20,51
Melbourne C,5128,3,14,5,10,43,33,10,47
Melbourne V,5128,4,13,5,11,45,39,6,44
Adelaide Utd,5128,5,11,6,11,37,40,-3,39
Brisbane,5128,6,10,5,13,33,42,-9,35
Western Sydn,5128,7,8,9,10,38,47,-9,33
Perth Glory,5128,8,10,2,15,37,50,-13,32
Wellington P,5128,9,5,6,16,31,55,-24,21
CC Mariners,5128,10,4,8,15,28,49,-21,20
Sydney FC,5129,1,21,4,3,66,22,44,67
N'castle Jet,5129,2,16,5,7,59,38,21,53
Melbourne C,5129,3,14,4,11,44,35,9,46
Melbourne V,5129,4,13,5,11,45,40,5,44
Adelaide Utd,5129,5,11,6,11,37,40,-3,39
Brisbane,5129,6,10,5,13,33,42,-9,35
Western Sydn,5129,7,8,9,10,38,47,-9,33
Perth Glory,5129,8,10,2,15,37,50,-13,32
Wellington P,5129,9,5,6,16,31,55,-24,21
CC Mariners,5129,10,4,8,15,28,49,-21,20
Sydney FC,5130,1,20,5,3,65,23,42,65
N'castle Jet,5130,2,15,6,7,58,38,20,51
Melbourne C,5130,3,14,5,10,44,34,10,47
Melbourne V,5130,4,13,6,10,46,39,7,45
Adelaide Utd,5130,5,11,6,11,37,40,-3,39
Brisbane,5130,6,10,5,13,33,42,-9,35
Western Sydn,5130,7,8,9,10,38,47,-9,33
Perth Glory,5130,8,10,2,15,37,50,-13,32
Wellington P,5130,9,5,6,16,31,55,-24,21
CC Mariners,5130,10,4,8,15,28,49,-21,20
Sydney FC,5131,1,21,4,3,67,22,45,67
N'castle Jet,5131,2,15,6,7,57,37,20,51
Melbourne C,5131,3,14,5,10,43,33,10,47
Melbourne V,5131,4,13,5,11,45,41,4,44
Adelaide Utd,5131,5,11,6,11,37,40,-3,39
Brisbane,5131,6,10,5,13,33,42,-9,35
Western Sydn,5131,7,8,9,10,38,47,-9,33
Perth Glory,5131,8,10,2,15,37,50,-13,32
Wellington P,5131,9,5,6,16,31,55,-24,21
CC Mariners,5131,10,4,8,15,28,49,-21,20
Sydney FC,5132,1,21,4,3,65,22,43,67
N'castle Jet,5132,2,15,5,8,57,38,19,50
Melbourne C,5132,3,15,4,10,44,33,11,49
Melbourne V,5132,4,13,5,11,45,39,6,44
Adelaide Utd,5132,5,11,6,11,37,40,-3,39
Brisbane,5132,6,10,5,13,33,42,-9,35
Western Sydn,5132,7,8,9,10,38,47,-9,33
Perth Glory,5132,8,10,2,15,37,50,-13,32
Wellington P,5132,9,5,6,16,31,55,-24,21
CC Mariners,5132,10,4,8,15,28,49,-21,20
Sydney FC,5133,1,21,4,3,66,22,44,67
N'castle Jet,5133,2,15,6,7,58,38,20,51
Melbourne C,5133,3,14,5,10,44,34,10,47
Melbourne V,5133,4,13,5,11,45,40,5,44
Adelaide Utd,5133,5,11,6,11,37,40,-3,39
Brisbane,5133,6,10,5,13,33,42,-9,35
Western Sydn,5133,7,8,9,10,38,47,-9,33
Perth Glory,5133,8,10,2,15,37,50,-13,32
Wellington P,5133,9,5,6,16,31,55,-24,21
CC Mariners,5133,10,4,8,15,28,49,-21,20
Sydney FC,5134,1,20,4,4,65,25,40,64
N'castle Jet,5134,2,16,5,7,61,38,23,53
Melbourne V,5134,3,14,5,10,48,39,9,47
Melbourne C,5134,4,14,4,11,44,37,7,46
Adelaide Utd,5134,5,11,6,11,37,40,-3,39
Brisbane,5134,6,10,5,13,33,42,-9,35
Western Sydn,5134,7,8,9,10,38,47,-9,33
Perth Glory,5134,8,10,2,15,37,50,-13,32
Wellington P,5134,9,5,6,16,31,55,-24,21
CC Mariners,5134,10,4,8,15,28,49,-21,20
Sydney FC,5135,1,20,4,4,66,25,41,64
N'castle Jet,5135,2,15,5,8,60,41,19,50
Melbourne C,5135,3,15,4,10,47,36,11,49
Melbourne V,5135,4,14,5,10,48,40,8,47
Adelaide Utd,5135,5,11,6,11,37,40,-3,39
Brisbane,5135,6,10,5,13,33,42,-9,35
Western Sydn,5135,7,8,9,10,38,47,-9,33
Perth Glory,5135,8,10,2,15,37,50,-13,32
Wellington P,5135,9,5,6,16,31,55,-24,21
CC Mariners,5135,10,4,8,15,28,49,-21,20
Sydney FC,5136,1,21,4,3,69,22,47,67
N'castle Jet,5136,2,16,5,7,59,38,21,53
Melbourne C,5136,3,14,4,11,44,35,9,46
Melbourne V,5136,4,13,5,11,45,43,2,44
Adelaide Utd,5136,5,11,6,11,37,40,-3,39
Brisbane,5136,6,10,5,13,33,42,-9,35
Western Sydn,5136,7,8,9,10,38,47,-9,33
Perth Glory,5136,8,10,2,15,37,50,-13,32
Wellington P,5136,9,5,6,16,31,55,-24,21
CC Mariners,5136,10,4,8,15,28,49,-21,20
Sydney FC,5137,1,20,5,3,65,23,42,65
N'castle Jet,5137,2,15,6,7,58,38,20,51
Melbourne C,5137,3,14,5,10,44,34,10,47
Melbourne V,5137,4,13,6,10,46,39,7,45
Adelaide Utd,5137,5,11,6,11,37,40,-3,39
Brisbane,5137,6,10,5,13,33,42,-9,35
Western Sydn,5137,7,8,9,10,38,47,-9,33
Perth Glory,5137,8,10,2,15,37,50,-13,32
Wellington P,5137,9,5,6,16,31,55,-24,21
CC Mariners,5137,10,4,8,15,28,49,-21,20
Sydney FC,5138,1,21,4,3,66,23,43,67
N'castle Jet,5138,2,15,5,8,59,40,19,50
Melbourne C,5138,3,15,4,10,46,35,11,49
Melbourne V,5138,4,13,5,11,46,40,6,44
Adelaide Utd,5138,5,11,6,11,37,40,-3,39
Brisbane,5138,6,10,5,13,33,42,-9,35
Western Sydn,5138,7,8,9,10,38,47,-9,33
Perth Glory,5138,8,10,2,15,37,50,-13,32
Wellington P,5138,9,5,6,16,31,55,-24,21
CC Mariners,5138,10,4,8,15,28,49,-21,20
Sydney FC,5139,1,21,4,3,70,23,47,67
N'castle Jet,5139,2,15,6,7,58,38,20,51
Melbourne C,5139,3,14,5,10,44,34,10,47
Melbourne V,5139,4,13,5,11,46,44,2,44
Adelaide Utd,5139,5,11,6,11,37,40,-3,39
Brisbane,5139,6,10,5,13,33,42,-9,35
Western Sydn,5139,7,8,9,10,38,47,-9,33
Perth Glory,5139,8,10,2,15,37,50,-13,32
Wellington P,5139,9,5,6,16,31,55,-24,21
CC Mariners,5139,10,4,8,15,28,49,-21,20
Sydney FC,5140,1,21,4,3,66,23,43,67
N'castle Jet,5140,2,16,5,7,58,37,21,53
Melbourne C,5140,3,14,4,11,43,34,9,46
Melbourne V,5140,4,13,5,11,46,40,6,44
Adelaide Utd,5140,5,11,6,11,37,40,-3,39
Brisbane,5140,6,10,5,13,33,42,-9,35
Western Sydn,5140,7,8,9,10,38,47,-9,33
Perth Glory,5140,8,10,2,15,37,50,-13,32
Wellington P,5140,9,5,6,16,31,55,-24,21
CC Mariners,5140,10,4,8,15,28,49,-21,20
Sydney FC,5141,1,20,5,3,65,23,42,65
N'castle Jet,5141,2,16,5,7,61,38,23,53
Melbourne C,5141,3,14,4,11,44,37,7,46
Melbourne V,5141,4,13,6,10,46,39,7,45
Adelaide Utd,5141,5,11,6,11,37,40,-3,39
Brisbane,5141,6,10,5,13,33,42,-9,35
Western Sydn,5141,7,8,9,10,38,47,-9,33
Perth Glory,5141,8,10,2,15,37,50,-13,32
Wellington P,5141,9,5,6,16,31,55,-24,21
CC Mariners,5141,10,4,8,15,28,49,-21,20
Sydney FC,5142,1,21,4,3,69,24,45,67
N'castle Jet,5142,2,15,5,8,57,40,17,50
Melbourne C,5142,3,15,4,10,46,33,13,49
Melbourne V,5142,4,13,5,11,47,43,4,44
Adelaide Utd,5142,5,11,6,11,37,40,-3,39
Brisbane,5142,6,10,5,13,33,42,-9,35
Western Sydn,5142,7,8,9,10,38,47,-9,33
Perth Glory,5142,8,10,2,15,37,50,-13,32
Wellington P,5142,9,5,6,16,31,55,-24,21
CC Mariners,5142,10,4,8,15,28,49,-21,20
Sydney FC,5143,1,20,5,3,65,23,42,65
N'castle Jet,5143,2,16,5,7,58,37,21,53
Melbourne C,5143,3,14,4,11,43,34,9,46
Melbourne V,5143,4,13,6,10,46,39,7,45
Adelaide Utd,5143,5,11,6,11,37,40,-3,39
Brisbane,5143,6,10,5,13,33,42,-9,35
Western Sydn,5143,7,8,9,10,38,47,-9,33
Perth Glory,5143,8,10,2,15,37,50,-13,32
Wellington P,5143,9,5,6,16,31,55,-24,21
CC Mariners,5143,10,4,8,15,28,49,-21,20
Sydney FC,5144,1,21,4,3,66,23,43,67
N'castle Jet,5144,2,15,6,7,58,38,20,51
Melbourne C,5144,3,14,5,10,44,34,10,47
Melbourne V,5144,4,13,5,11,46,40,6,44
Adelaide Utd,5144,5,11,6,11,37,40,-3,39
Brisbane,5144,6,10,5,13,33,42,-9,35
Western Sydn,5144,7,8,9,10,38,47,-9,33
Perth Glory,5144,8,10,2,15,37,50,-13,32
Wellington P,5144,9,5,6,16,31,55,-24,21
CC Mariners,5144,10,4,8,15,28,49,-21,20
Sydney FC,5145,1,21,4,3,65,22,43,67
N'castle Jet,5145,2,16,5,7,60,38,22,53
Melbourne C,5145,3,14,4,11,44,36,8,46
Melbourne V,5145,4,13,5,11,45,39,6,44
Adelaide Utd,5145,5,11,6,11,37,40,-3,39
Brisbane,5145,6,10,5,13,33,42,-9,35
Western Sydn,5145,7,8,9,10,38,47,-9,33
Perth Glory,5145,8,10,2,15,37,50,-13,32
Wellington P,5145,9,5,6,16,31,55,-24,21
CC Mariners,5145,10,4,8,15,28,49,-21,20
Sydney FC,5146,1,20,4,4,64,23,41,64
N'castle Jet,5146,2,16,5,7,59,38,21,53
Melbourne V,5146,3,14,5,10,46,38,8,47
Melbourne C,5146,4,14,4,11,44,35,9,46
Adelaide Utd,5146,5,11,6,11,37,40,-3,39
Brisbane,5146,6,10,5,13,33,42,-9,35
Western Sydn,5146,7,8,9,10,38,47,-9,33
Perth Glory,5146,8,10,2,15,37,50,-13,32
Wellington P,5146,9,5,6,16,31,55,-24,21
CC Mariners,5146,10,4,8,15,28,49,-21,20
Sydney FC,5147,1,21,4,3,66,22,44,67
N'castle Jet,5147,2,15,6,7,58,38,20,51
Melbourne C,5147,3,14,5,10,44,34,10,47
Melbourne V,5147,4,13,5,11,45,40,5,44
Adelaide Utd,5147,5,11,6,11,37,40,-3,39
Brisbane,5147,6,10,5,13,33,42,-9,35
Western Sydn,5147,7,8,9,10,38,47,-9,33
Perth Glory,5147,8,10,2,15,37,50,-13,32
Wellington P,5147,9,5,6,16,31,55,-24,21
CC Mariners,5147,10,4,8,15,28,49,-21,20
Sydney FC,5148,1,21,4,3,68,22,46,67
N'castle Jet,5148,2,15,6,7,59,39,20,51
Melbourne C,5148,3,14,5,10,45,35,10,47
Melbourne V,5148,4,13,5,11,45,42,3,44
Adelaide Utd,5148,5,11,6,11,37,40,-3,39
Brisbane,5148,6,10,5,13,33,42,-9,35
Western Sydn,5148,7,8,9,10,38,47,-9,33
Perth Glory,5148,8,10,2,15,37,50,-13,32
Wellington P,5148,9,5,6,16,31,55,-24,21
CC Mariners,5148,10,4,8,15,28,49,-21,20
Sydney FC,5149,1,21,4,3,66,23,43,67
N'castle Jet,5149,2,16,5,7,59,38,21,53
Melbourne C,5149,3,14,4,11,44,35,9,46
Melbourne V,5149,4,13,5,11,46,40,6,44
Adelaide Utd,5149,5,11,6,11,37,40,-3,39
Brisbane,5149,6,10,5,13,33,42,-9,35
Western Sydn,5149,7,8,9,10,38,47,-9,33
Perth Glory,5149,8,10,2,15,37,50,-13,32
Wellington P,5149,9,5,6,16,31,55,-24,21
CC Mariners,5149,10,4,8,15,28,49,-21,20
Sydney FC,5150,1,21,4,3,66,23,43,67
N'castle Jet,5150,2,16,5,7,60,38,22,53
Melbourne C,5150,3,14,4,11,44,36,8,46
Melbourne V,5150,4,13,5,11,46,40,6,44
Adelaide Utd,5150,5,11,6,11,37,40,-3,39
Brisbane,5150,6,10,5,13,33,42,-9,35
Western Sydn,5150,7,8,9,10,38,47,-9,33
Perth Glory,5150,8,10,2,15,37,50,-13,32
Wellington P,5150,9,5,6,16,31,55,-24,21
CC Mariners,5150,10,4,8,15,28,49,-21,20
Sydney FC,5151,1,20,4,4,65,26,39,64
N'castle Jet,5151,2,15,5,8,58,41,17,50
Melbourne C,5151,3,15,4,10,47,34,13,49
Melbourne V,5151,4,14,5,10,49,39,10,47
Adelaide Utd,5151,5,11,6,11,37,40,-3,39
Brisbane,5151,6,10,5,13,33,42,-9,35
Western Sydn,5151,7,8,9,10,38,47,-9,33
Perth Glory,5151,8,10,2,15,37,50,-13,32
Wellington P,5151,9,5,6,16,31,55,-24,21
CC Mariners,5151,10,4,8,15,28,49,-21,20
Sydney FC,5152,1,21,4,3,65,22,43,67
N'castle Jet,5152,2,15,5,8,57,42,15,50
Melbourne C,5152,3,15,4,10,48,33,15,49
Melbourne V,5152,4,13,5,11,45,39,6,44
Adelaide Utd,5152,5,11,6,11,37,40,-3,39
Brisbane,5152,6,10,5,13,33,42,-9,35
Western Sydn,5152,7,8,9,10,38,47,-9,33
Perth Glory,5152,8,10,2,15,37,50,-13,32
Wellington P,5152,9,5,6,16,31,55,-24,21
CC Mariners,5152,10,4,8,15,28,49,-21,20
Sydney FC,5153,1,20,5,3,66,24,42,65
N'castle Jet,5153,2,15,6,7,58,38,20,51
Melbourne C,5153,3,14,5,10,44,34,10,47
Melbourne V,5153,4,13,6,10,47,40,7,45
Adelaide Utd,5153,5,11,6,11,37,40,-3,39
Brisbane,5153,6,10,5,13,33,42,-9,35
Western Sydn,5153,7,8,9,10,38,47,-9,33
Perth Glory,5153,8,10,2,15,37,50,-13,32
Wellington P,5153,9,5,6,16,31,55,-24,21
CC Mariners,5153,10,4,8,15,28,49,-21,20
Sydney FC,5154,1,21,4,3,66,23,43,67
N'castle Jet,5154,2,16,5,7,59,37,22,53
Melbourne C,5154,3,14,4,11,43,35,8,46
Melbourne V,5154,4,13,5,11,46,40,6,44
Adelaide Utd,5154,5,11,6,11,37,40,-3,39
Brisbane,5154,6,10,5,13,33,42,-9,35
Western Sydn,5154,7,8,9,10,38,47,-9,33
Perth Glory,5154,8,10,2,15,37,50,-13,32
Wellington P,5154,9,5,6,16,31,55,-24,21
CC Mariners,5154,10,4,8,15,28,49,-21,20
Sydney FC,5155,1,20,4,4,65,24,41,64
N'castle Jet,5155,2,15,6,7,58,38,20,51
Melbourne C,5155,3,14,5,10,44,34,10,47
Melbourne V,5155,4,14,5,10,47,39,8,47
Adelaide Utd,5155,5,11,6,11,37,40,-3,39
Brisbane,5155,6,10,5,13,33,42,-9,35
Western Sydn,5155,7,8,9,10,38,47,-9,33
Perth Glory,5155,8,10,2,15,37,50,-13,32
Wellington P,5155,9,5,6,16,31,55,-24,21
CC Mariners,5155,10,4,8,15,28,49,-21,20
Sydney FC,5156,1,20,4,4,65,24,41,64
N'castle Jet,5156,2,15,5,8,58,40,18,50
Melbourne C,5156,3,15,4,10,46,34,12,49
Melbourne V,5156,4,14,5,10,47,39,8,47
Adelaide Utd,5156,5,11,6,11,37,40,-3,39
Brisbane,5156,6,10,5,13,33,42,-9,35
Western Sydn,5156,7,8,9,10,38,47,-9,33
Perth Glory,5156,8,10,2,15,37,50,-13,32
Wellington P,5156,9,5,6,16,31,55,-24,21
CC Mariners,5156,10,4,8,15,28,49,-21,20
Sydney FC,5157,1,21,4,3,68,24,44,67
N'castle Jet,5157,2,16,5,7,64,37,27,53
Melbourne C,5157,3,14,4,11,43,40,3,46
Melbourne V,5157,4,13,5,11,47,42,5,44
Adelaide Utd,5157,5,11,6,11,37,40,-3,39
Brisbane,5157,6,10,5,13,33,42,-9,35
Western Sydn,5157,7,8,9,10,38,47,-9,33
Perth Glory,5157,8,10,2,15,37,50,-13,32
Wellington P,5157,9,5,6,16,31,55,-24,21
CC Mariners,5157,10,4,8,15,28,49,-21,20
Sydney FC,5158,1,21,4,3,67,23,44,67
N'castle Jet,5158,2,15,5,8,57,40,17,50
Melbourne C,5158,3,15,4,10,46,33,13,49
Melbourne V,5158,4,13,5,11,46,41,5,44
Adelaide Utd,5158,5,11,6,11,37,40,-3,39
Brisbane,5158,6,10,5,13,33,42,-9,35
Western Sydn,5158,7,8,9,10,38,47,-9,33
Perth Glory,5158,8,10,2,15,37,50,-13,32
Wellington P,5158,9,5,6,16,31,55,-24,21
CC Mariners,5158,10,4,8,15,28,49,-21,20
Sydney FC,5159,1,21,4,3,67,24,43,67
N'castle Jet,5159,2,16,5,7,61,40,21,53
Melbourne C,5159,3,14,4,11,46,37,9,46
Melbourne V,5159,4,13,5,11,47,41,6,44
Adelaide Utd,5159,5,11,6,11,37,40,-3,39
Brisbane,5159,6,10,5,13,33,42,-9,35
Western Sydn,5159,7,8,9,10,38,47,-9,33
Perth Glory,5159,8,10,2,15,37,50,-13,32
Wellington P,5159,9,5,6,16,31,55,-24,21
CC Mariners,5159,10,4,8,15,28,49,-21,20
Sydney FC,5160,1,20,5,3,64,22,42,65
N'castle Jet,5160,2,15,5,8,59,40,19,50
Melbourne C,5160,3,15,4,10,46,35,11,49
Melbourne V,5160,4,13,6,10,45,38,7,45
Adelaide Utd,5160,5,11,6,11,37,40,-3,39
Brisbane,5160,6,10,5,13,33,42,-9,35
Western Sydn,5160,7,8,9,10,38,47,-9,33
Perth Glory,5160,8,10,2,15,37,50,-13,32
Wellington P,5160,9,5,6,16,31,55,-24,21
CC Mariners,5160,10,4,8,15,28,49,-21,20
Sydney FC,5161,1,20,5,3,65,23,42,65
N'castle Jet,5161,2,15,6,7,58,38,20,51
Melbourne C,5161,3,14,5,10,44,34,10,47
Melbourne V,5161,4,13,6,10,46,39,7,45
Adelaide Utd,5161,5,11,6,11,37,40,-3,39
Brisbane,5161,6,10,5,13,33,42,-9,35
Western Sydn,5161,7,8,9,10,38,47,-9,33
Perth Glory,5161,8,10,2,15,37,50,-13,32
Wellington P,5161,9,5,6,16,31,55,-24,21
CC Mariners,5161,10,4,8,15,28,49,-21,20
Sydney FC,5162,1,21,4,3,67,23,44,67
N'castle Jet,5162,2,15,5,8,58,39,19,50
Melbourne C,5162,3,15,4,10,45,34,11,49
Melbourne V,5162,4,13,5,11,46,41,5,44
Adelaide Utd,5162,5,11,6,11,37,40,-3,39
Brisbane,5162,6,10,5,13,33,42,-9,35
Western Sydn,5162,7,8,9,10,38,47,-9,33
Perth Glory,5162,8,10,2,15,37,50,-13,32
Wellington P,5162,9,5,6,16,31,55,-24,21
CC Mariners,5162,10,4,8,15,28,49,-21,20
Sydney FC,5163,1,20,5,3,64,22,42,65
N'castle Jet,5163,2,15,6,7,59,39,20,51
Melbourne C,5163,3,14,5,10,45,35,10,47
Melbourne V,5163,4,13,6,10,45,38,7,45
Adelaide Utd,5163,5,11,6,11,37,40,-3,39
Brisbane,5163,6,10,5,13,33,42,-9,35
Western Sydn,5163,7,8,9,10,38,47,-9,33
Perth Glory,5163,8,10,2,15,37,50,-13,32
Wellington P,5163,9,5,6,16,31,55,-24,21
CC Mariners,5163,10,4,8,15,28,49,-21,20
Sydney FC,5164,1,20,5,3,64,22,42,65
N'castle Jet,5164,2,16,5,7,60,38,22,53
Melbourne C,5164,3,14,4,11,44,36,8,46
Melbourne V,5164,4,13,6,10,45,38,7,45
Adelaide Utd,5164,5,11,6,11,37,40,-3,39
Brisbane,5164,6,10,5,13,33,42,-9,35
Western Sydn,5164,7,8,9,10,38,47,-9,33
Perth Glory,5164,8,10,2,15,37,50,-13,32
Wellington P,5164,9,5,6,16,31,55,-24,21
CC Mariners,5164,10,4,8,15,28,49,-21,20
Sydney FC,5165,1,21,4,3,66,22,44,67
N'castle Jet,5165,2,15,6,7,59,39,20,51
Melbourne C,5165,3,14,5,10,45,35,10,47
Melbourne V,5165,4,13,5,11,45,40,5,44
Adelaide Utd,5165,5,11,6,11,37,40,-3,39
Brisbane,5165,6,10,5,13,33,42,-9,35
Western Sydn,5165,7,8,9,10,38,47,-9,33
Perth Glory,5165,8,10,2,15,37,50,-13,32
Wellington P,5165,9,5,6,16,31,55,-24,21
CC Mariners,5165,10,4,8,15,28,49,-21,20
Sydney FC,5166,1,21,4,3,67,22,45,67
N'castle Jet,5166,2,15,6,7,58,38,20,51
Melbourne C,5166,3,14,5,10,44,34,10,47
Melbourne V,5166,4,13,5,11,45,41,4,44
Adelaide Utd,5166,5,11,6,11,37,40,-3,39
Brisbane,5166,6,10,5,13,33,42,-9,35
Western Sydn,5166,7,8,9,10,38,47,-9,33
Perth Glory,5166,8,10,2,15,37,50,-13,32
Wellington P,5166,9,5,6,16,31,55,-24,21
CC Mariners,5166,10,4,8,15,28,49,-21,20
Sydney FC,5167,1,21,4,3,65,22,43,67
N'castle Jet,5167,2,15,6,7,58,38,20,51
Melbourne C,5167,3,14,5,10,44,34,10,47
Melbourne V,5167,4,13,5,11,45,39,6,44
Adelaide Utd,5167,5,11,6,11,37,40,-3,39
Brisbane,5167,6,10,5,13,33,42,-9,35
Western Sydn,5167,7,8,9,10,38,47,-9,33
Perth Glory,5167,8,10,2,15,37,50,-13,32
Wellington P,5167,9,5,6,16,31,55,-24,21
CC Mariners,5167,10,4,8,15,28,49,-21,20
Sydney FC,5168,1,20,5,3,66,24,42,65
N'castle Jet,5168,2,16,5,7,58,37,21,53
Melbourne C,5168,3,14,4,11,43,34,9,46
Melbourne V,5168,4,13,6,10,47,40,7,45
Adelaide Utd,5168,5,11,6,11,37,40,-3,39
Brisbane,5168,6,10,5,13,33,42,-9,35
Western Sydn,5168,7,8,9,10,38,47,-9,33
Perth Glory,5168,8,10,2,15,37,50,-13,32
Wellington P,5168,9,5,6,16,31,55,-24,21
CC Mariners,5168,10,4,8,15,28,49,-21,20
Sydney FC,5169,1,21,4,3,68,23,45,67
N'castle Jet,5169,2,15,5,8,58,39,19,50
Melbourne C,5169,3,15,4,10,45,34,11,49
Melbourne V,5169,4,13,5,11,46,42,4,44
Adelaide Utd,5169,5,11,6,11,37,40,-3,39
Brisbane,5169,6,10,5,13,33,42,-9,35
Western Sydn,5169,7,8,9,10,38,47,-9,33
Perth Glory,5169,8,10,2,15,37,50,-13,32
Wellington P,5169,9,5,6,16,31,55,-24,21
CC Mariners,5169,10,4,8,15,28,49,-21,20
Sydney FC,5170,1,21,4,3,68,22,46,67
N'castle Jet,5170,2,15,5,8,57,38,19,50
Melbourne C,5170,3,15,4,10,44,33,11,49
Melbourne V,5170,4,13,5,11,45,42,3,44
Adelaide Utd,5170,5,11,6,11,37,40,-3,39
Brisbane,5170,6,10,5,13,33,42,-9,35
Western Sydn,5170,7,8,9,10,38,47,-9,33
Perth Glory,5170,8,10,2,15,37,50,-13,32
Wellington P,5170,9,5,6,16,31,55,-24,21
CC Mariners,5170,10,4,8,15,28,49,-21,20
Sydney FC,5171,1,20,5,3,65,23,42,65
N'castle Jet,5171,2,16,5,7,61,39,22,53
Melbourne C,5171,3,14,4,11,45,37,8,46
Melbourne V,5171,4,13,6,10,46,39,7,45
Adelaide Utd,5171,5,11,6,11,37,40,-3,39
Brisbane,5171,6,10,5,13,33,42,-9,35
Western Sydn,5171,7,8,9,10,38,47,-9,33
Perth Glory,5171,8,10,2,15,37,50,-13,32
Wellington P,5171,9,5,6,16,31,55,-24,21
CC Mariners,5171,10,4,8,15,28,49,-21,20
Sydney FC,5172,1,21,4,3,66,22,44,67
N'castle Jet,5172,2,15,6,7,58,38,20,51
Melbourne C,5172,3,14,5,10,44,34,10,47
Melbourne V,5172,4,13,5,11,45,40,5,44
Adelaide Utd,5172,5,11,6,11,37,40,-3,39
Brisbane,5172,6,10,5,13,33,42,-9,35
Western Sydn,5172,7,8,9,10,38,47,-9,33
Perth Glory,5172,8,10,2,15,37,50,-13,32
Wellington P,5172,9,5,6,16,31,55,-24,21
CC Mariners,5172,10,4,8,15,28,49,-21,20
Sydney FC,5173,1,21,4,3,68,22,46,67
N'castle Jet,5173,2,16,5,7,61,39,22,53
Melbourne C,5173,3,14,4,11,45,37,8,46
Melbourne V,5173,4,13,5,11,45,42,3,44
Adelaide Utd,5173,5,11,6,11,37,40,-3,39
Brisbane,5173,6,10,5,13,33,42,-9,35
Western Sydn,5173,7,8,9,10,38,47,-9,33
Perth Glory,5173,8,10,2,15,37,50,-13,32
Wellington P,5173,9,5,6,16,31,55,-24,21
CC Mariners,5173,10,4,8,15,28,49,-21,20
Sydney FC,5174,1,20,4,4,65,24,41,64
N'castle Jet,5174,2,15,6,7,58,38,20,51
Melbourne C,5174,3,14,5,10,44,34,10,47
Melbourne V,5174,4,14,5,10,47,39,8,47
Adelaide Utd,5174,5,11,6,11,37,40,-3,39
Brisbane,5174,6,10,5,13,33,42,-9,35
Western Sydn,5174,7,8,9,10,38,47,-9,33
Perth Glory,5174,8,10,2,15,37,50,-13,32
Wellington P,5174,9,5,6,16,31,55,-24,21
CC Mariners,5174,10,4,8,15,28,49,-21,20
Sydney FC,5175,1,20,5,3,67,25,42,65
N'castle Jet,5175,2,15,5,8,57,39,18,50
Melbourne C,5175,3,15,4,10,45,33,12,49
Melbourne V,5175,4,13,6,10,48,41,7,45
Adelaide Utd,5175,5,11,6,11,37,40,-3,39
Brisbane,5175,6,10,5,13,33,42,-9,35
Western Sydn,5175,7,8,9,10,38,47,-9,33
Perth Glory,5175,8,10,2,15,37,50,-13,32
Wellington P,5175,9,5,6,16,31,55,-24,21
CC Mariners,5175,10,4,8,15,28,49,-21,20
Sydney FC,5176,1,20,5,3,65,23,42,65
N'castle Jet,5176,2,15,6,7,57,37,20,51
Melbourne C,5176,3,14,5,10,43,33,10,47
Melbourne V,5176,4,13,6,10,46,39,7,45
Adelaide Utd,5176,5,11,6,11,37,40,-3,39
Brisbane,5176,6,10,5,13,33,42,-9,35
Western Sydn,5176,7,8,9,10,38,47,-9,33
Perth Glory,5176,8,10,2,15,37,50,-13,32
Wellington P,5176,9,5,6,16,31,55,-24,21
CC Mariners,5176,10,4,8,15,28,49,-21,20
Sydney FC,5177,1,20,4,4,64,24,40,64
N'castle Jet,5177,2,16,5,7,59,38,21,53
Melbourne V,5177,3,14,5,10,47,38,9,47
Melbourne C,5177,4,14,4,11,44,35,9,46
Adelaide Utd,5177,5,11,6,11,37,40,-3,39
Brisbane,5177,6,10,5,13,33,42,-9,35
Western Sydn,5177,7,8,9,10,38,47,-9,33
Perth Glory,5177,8,10,2,15,37,50,-13,32
Wellington P,5177,9,5,6,16,31,55,-24,21
CC Mariners,5177,10,4,8,15,28,49,-21,20
Sydney FC,5178,1,21,4,3,67,22,45,67
N'castle Jet,5178,2,16,5,7,61,40,21,53
Melbourne C,5178,3,14,4,11,46,37,9,46
Melbourne V,5178,4,13,5,11,45,41,4,44
Adelaide Utd,5178,5,11,6,11,37,40,-3,39
Brisbane,5178,6,10,5,13,33,42,-9,35
Western Sydn,5178,7,8,9,10,38,47,-9,33
Perth Glory,5178,8,10,2,15,37,50,-13,32
Wellington P,5178,9,5,6,16,31,55,-24,21
CC Mariners,5178,10,4,8,15,28,49,-21,20
Sydney FC,5179,1,20,4,4,65,24,41,64
N'castle Jet,5179,2,15,6,7,58,38,20,51
Melbourne C,5179,3,14,5,10,44,34,10,47
Melbourne V,5179,4,14,5,10,47,39,8,47
Adelaide Utd,5179,5,11,6,11,37,40,-3,39
Brisbane,5179,6,10,5,13,33,42,-9,35
Western Sydn,5179,7,8,9,10,38,47,-9,33
Perth Glory,5179,8,10,2,15,37,50,-13,32
Wellington P,5179,9,5,6,16,31,55,-24,21
CC Mariners,5179,10,4,8,15,28,49,-21,20
Sydney FC,5180,1,20,4,4,67,28,39,64
N'castle Jet,5180,2,16,5,7,60,38,22,53
Melbourne V,5180,3,14,5,10,51,41,10,47
Melbourne C,5180,4,14,4,11,44,36,8,46
Adelaide Utd,5180,5,11,6,11,37,40,-3,39
Brisbane,5180,6,10,5,13,33,42,-9,35
Western Sydn,5180,7,8,9,10,38,47,-9,33
Perth Glory,5180,8,10,2,15,37,50,-13,32
Wellington P,5180,9,5,6,16,31,55,-24,21
CC Mariners,5180,10,4,8,15,28,49,-21,20
Sydney FC,5181,1,20,5,3,65,23,42,65
N'castle Jet,5181,2,16,5,7,60,37,23,53
Melbourne C,5181,3,14,4,11,43,36,7,46
Melbourne V,5181,4,13,6,10,46,39,7,45
Adelaide Utd,5181,5,11,6,11,37,40,-3,39
Brisbane,5181,6,10,5,13,33,42,-9,35
Western Sydn,5181,7,8,9,10,38,47,-9,33
Perth Glory,5181,8,10,2,15,37,50,-13,32
Wellington P,5181,9,5,6,16,31,55,-24,21
CC Mariners,5181,10,4,8,15,28,49,-21,20
Sydney FC,5182,1,20,4,4,66,26,40,64
N'castle Jet,5182,2,16,5,7,61,37,24,53
Melbourne V,5182,3,14,5,10,49,40,9,47
Melbourne C,5182,4,14,4,11,43,37,6,46
Adelaide Utd,5182,5,11,6,11,37,40,-3,39
Brisbane,5182,6,10,5,13,33,42,-9,35
Western Sydn,5182,7,8,9,10,38,47,-9,33
Perth Glory,5182,8,10,2,15,37,50,-13,32
Wellington P,5182,9,5,6,16,31,55,-24,21
CC Mariners,5182,10,4,8,15,28,49,-21,20
Sydney FC,5183,1,21,4,3,68,22,46,67
N'castle Jet,5183,2,16,5,7,60,37,23,53
Melbourne C,5183,3,14,4,11,43,36,7,46
Melbourne V,5183,4,13,5,11,45,42,3,44
Adelaide Utd,5183,5,11,6,11,37,40,-3,39
Brisbane,5183,6,10,5,13,33,42,-9,35
Western Sydn,5183,7,8,9,10,38,47,-9,33
Perth Glory,5183,8,10,2,15,37,50,-13,32
Wellington P,5183,9,5,6,16,31,55,-24,21
CC Mariners,5183,10,4,8,15,28,49,-21,20
Sydney FC,5184,1,20,5,3,64,22,42,65
N'castle Jet,5184,2,16,5,7,60,38,22,53
Melbourne C,5184,3,14,4,11,44,36,8,46
Melbourne V,5184,4,13,6,10,45,38,7,45
Adelaide Utd,5184,5,11,6,11,37,40,-3,39
Brisbane,5184,6,10,5,13,33,42,-9,35
Western Sydn,5184,7,8,9,10,38,47,-9,33
Perth Glory,5184,8,10,2,15,37,50,-13,32
Wellington P,5184,9,5,6,16,31,55,-24,21
CC Mariners,5184,10,4,8,15,28,49,-21,20
Sydney FC,5185,1,20,4,4,64,23,41,64
N'castle Jet,5185,2,16,5,7,59,37,22,53
Melbourne V,5185,3,14,5,10,46,38,8,47
Melbourne C,5185,4,14,4,11,43,35,8,46
Adelaide Utd,5185,5,11,6,11,37,40,-3,39
Brisbane,5185,6,10,5,13,33,42,-9,35
Western Sydn,5185,7,8,9,10,38,47,-9,33
Perth Glory,5185,8,10,2,15,37,50,-13,32
Wellington P,5185,9,5,6,16,31,55,-24,21
CC Mariners,5185,10,4,8,15,28,49,-21,20
Sydney FC,5186,1,21,4,3,67,23,44,67
N'castle Jet,5186,2,16,5,7,59,37,22,53
Melbourne C,5186,3,14,4,11,43,35,8,46
Melbourne V,5186,4,13,5,11,46,41,5,44
Adelaide Utd,5186,5,11,6,11,37,40,-3,39
Brisbane,5186,6,10,5,13,33,42,-9,35
Western Sydn,5186,7,8,9,10,38,47,-9,33
Perth Glory,5186,8,10,2,15,37,50,-13,32
Wellington P,5186,9,5,6,16,31,55,-24,21
CC Mariners,5186,10,4,8,15,28,49,-21,20
Sydney FC,5187,1,21,4,3,66,23,43,67
N'castle Jet,5187,2,15,6,7,59,39,20,51
Melbourne C,5187,3,14,5,10,45,35,10,47
Melbourne V,5187,4,13,5,11,46,40,6,44
Adelaide Utd,5187,5,11,6,11,37,40,-3,39
Brisbane,5187,6,10,5,13,33,42,-9,35
Western Sydn,5187,7,8,9,10,38,47,-9,33
Perth Glory,5187,8,10,2,15,37,50,-13,32
Wellington P,5187,9,5,6,16,31,55,-24,21
CC Mariners,5187,10,4,8,15,28,49,-21,20
Sydney FC,5188,1,20,4,4,65,24,41,64
N'castle Jet,5188,2,15,6,7,59,39,20,51
Melbourne C,5188,3,14,5,10,45,35,10,47
Melbourne V,5188,4,14,5,10,47,39,8,47
Adelaide Utd,5188,5,11,6,11,37,40,-3,39
Brisbane,5188,6,10,5,13,33,42,-9,35
Western Sydn,5188,7,8,9,10,38,47,-9,33
Perth Glory,5188,8,10,2,15,37,50,-13,32
Wellington P,5188,9,5,6,16,31,55,-24,21
CC Mariners,5188,10,4,8,15,28,49,-21,20
Sydney FC,5189,1,21,4,3,69,24,45,67
N'castle Jet,5189,2,15,6,7,57,37,20,51
Melbourne C,5189,3,14,5,10,43,33,10,47
Melbourne V,5189,4,13,5,11,47,43,4,44
Adelaide Utd,5189,5,11,6,11,37,40,-3,39
Brisbane,5189,6,10,5,13,33,42,-9,35
Western Sydn,5189,7,8,9,10,38,47,-9,33
Perth Glory,5189,8,10,2,15,37,50,-13,32
Wellington P,5189,9,5,6,16,31,55,-24,21
CC Mariners,5189,10,4,8,15,28,49,-21,20
Sydney FC,5190,1,21,4,3,67,22,45,67
N'castle Jet,5190,2,16,5,7,60,38,22,53
Melbourne C,5190,3,14,4,11,44,36,8,46
Melbourne V,5190,4,13,5,11,45,41,4,44
Adelaide Utd,5190,5,11,6,11,37,40,-3,39
Brisbane,5190,6,10,5,13,33,42,-9,35
Western Sydn,5190,7,8,9,10,38,47,-9,33
Perth Glory,5190,8,10,2,15,37,50,-13,32
Wellington P,5190,9,5,6,16,31,55,-24,21
CC Mariners,5190,10,4,8,15,28,49,-21,20
Sydney FC,5191,1,20,5,3,64,22,42,65
N'castle Jet,5191,2,16,5,7,61,38,23,53
Melbourne C,5191,3,14,4,11,44,37,7,46
Melbourne V,5191,4,13,6,10,45,38,7,45
Adelaide Utd,5191,5,11,6,11,37,40,-3,39
Brisbane,5191,6,10,5,13,33,42,-9,35
Western Sydn,5191,7,8,9,10,38,47,-9,33
Perth Glory,5191,8,10,2,15,37,50,-13,32
Wellington P,5191,9,5,6,16,31,55,-24,21
CC Mariners,5191,10,4,8,15,28,49,-21,20
Sydney FC,5192,1,21,4,3,65,22,43,67
N'castle Jet,5192,2,15,5,8,57,40,17,50
Melbourne C,5192,3,15,4,10,46,33,13,49
Melbourne V,5192,4,13,5,11,45,39,6,44
Adelaide Utd,5192,5,11,6,11,37,40,-3,39
Brisbane,5192,6,10,5,13,33,42,-9,35
Western Sydn,5192,7,8,9,10,38,47,-9,33
Perth Glory,5192,8,10,2,15,37,50,-13,32
Wellington P,5192,9,5,6,16,31,55,-24,21
CC Mariners,5192,10,4,8,15,28,49,-21,20
Sydney FC,5193,1,21,4,3,66,23,43,67
N'castle Jet,5193,2,15,5,8,58,40,18,50
Melbourne C,5193,3,15,4,10,46,34,12,49
Melbourne V,5193,4,13,5,11,46,40,6,44
Adelaide Utd,5193,5,11,6,11,37,40,-3,39
Brisbane,5193,6,10,5,13,33,42,-9,35
Western Sydn,5193,7,8,9,10,38,47,-9,33
Perth Glory,5193,8,10,2,15,37,50,-13,32
Wellington P,5193,9,5,6,16,31,55,-24,21
CC Mariners,5193,10,4,8,15,28,49,-21,20
Sydney FC,5194,1,21,4,3,67,23,44,67
N'castle Jet,5194,2,16,5,7,59,38,21,53
Melbourne C,5194,3,14,4,11,44,35,9,46
Melbourne V,5194,4,13,5,11,46,41,5,44
Adelaide Utd,5194,5,11,6,11,37,40,-3,39
Brisbane,5194,6,10,5,13,33,42,-9,35
Western Sydn,5194,7,8,9,10,38,47,-9,33
Perth Glory,5194,8,10,2,15,37,50,-13,32
Wellington P,5194,9,5,6,16,31,55,-24,21
CC Mariners,5194,10,4,8,15,28,49,-21,20
Sydney FC,5195,1,21,4,3,68,23,45,67
N'castle Jet,5195,2,15,6,7,58,38,20,51
Melbourne C,5195,3,14,5,10,44,34,10,47
Melbourne V,5195,4,13,5,11,46,42,4,44
Adelaide Utd,5195,5,11,6,11,37,40,-3,39
Brisbane,5195,6,10,5,13,33,42,-9,35
Western Sydn,5195,7,8,9,10,38,47,-9,33
Perth Glory,5195,8,10,2,15,37,50,-13,32
Wellington P,5195,9,5,6,16,31,55,-24,21
CC Mariners,5195,10,4,8,15,28,49,-21,20
Sydney FC,5196,1,21,4,3,66,22,44,67
N'castle Jet,5196,2,15,5,8,57,38,19,50
Melbourne C,5196,3,15,4,10,44,33,11,49
Melbourne V,5196,4,13,5,11,45,40,5,44
Adelaide Utd,5196,5,11,6,11,37,40,-3,39
Brisbane,5196,6,10,5,13,33,42,-9,35
Western Sydn,5196,7,8,9,10,38,47,-9,33
Perth Glory,5196,8,10,2,15,37,50,-13,32
Wellington P,5196,9,5,6,16,31,55,-24,21
CC Mariners,5196,10,4,8,15,28,49,-21,20
Sydney FC,5197,1,20,5,3,66,24,42,65
N'castle Jet,5197,2,15,5,8,57,38,19,50
Melbourne C,5197,3,15,4,10,44,33,11,49
Melbourne V,5197,4,13,6,10,47,40,7,45
Adelaide Utd,5197,5,11,6,11,37,40,-3,39
Brisbane,5197,6,10,5,13,33,42,-9,35
Western Sydn,5197,7,8,9,10,38,47,-9,33
Perth Glory,5197,8,10,2,15,37,50,-13,32
Wellington P,5197,9,5,6,16,31,55,-24,21
CC Mariners,5197,10,4,8,15,28,49,-21,20
Sydney FC,5198,1,21,4,3,66,23,43,67
N'castle Jet,5198,2,15,5,8,57,38,19,50
Melbourne C,5198,3,15,4,10,44,33,11,49
Melbourne V,5198,4,13,5,11,46,40,6,44
Adelaide Utd,5198,5,11,6,11,37,40,-3,39
Brisbane,5198,6,10,5,13,33,42,-9,35
Western Sydn,5198,7,8,9,10,38,47,-9,33
Perth Glory,5198,8,10,2,15,37,50,-13,32
Wellington P,5198,9,5,6,16,31,55,-24,21
CC Mariners,5198,10,4,8,15,28,49,-21,20
Sydney FC,5199,1,21,4,3,69,22,47,67
N'castle Jet,5199,2,16,5,7,59,37,22,53
Melbourne C,5199,3,14,4,11,43,35,8,46
Melbourne V,5199,4,13,5,11,45,43,2,44
Adelaide Utd,5199,5,11,6,11,37,40,-3,39
Brisbane,5199,6,10,5,13,33,42,-9,35
Western Sydn,5199,7,8,9,10,38,47,-9,33
Perth Glory,5199,8,10,2,15,37,50,-13,32
Wellington P,5199,9,5,6,16,31,55,-24,21
CC Mariners,5199,10,4,8,15,28,49,-21,20
Sydney FC,5200,1,20,5,3,65,23,42,65
N'castle Jet,5200,2,16,5,7,58,37,21,53
Melbourne C,5200,3,14,4,11,43,34,9,46
Melbourne V,5200,4,13,6,10,46,39,7,45
Adelaide Utd,5200,5,11,6,11,37,40,-3,39
Brisbane,5200,6,10,5,13,33,42,-9,35
Western Sydn,5200,7,8,9,10,38,47,-9,33
Perth Glory,5200,8,10,2,15,37,50,-13,32
Wellington P,5200,9,5,6,16,31,55,-24,21
CC Mariners,5200,10,4,8,15,28,49,-21,20
Sydney FC,5201,1,21,4,3,66,23,43,67
N'castle Jet,5201,2,16,5,7,59,38,21,53
Melbourne C,5201,3,14,4,11,44,35,9,46
Melbourne V,5201,4,13,5,11,46,40,6,44
Adelaide Utd,5201,5,11,6,11,37,40,-3,39
Brisbane,5201,6,10,5,13,33,42,-9,35
Western Sydn,5201,7,8,9,10,38,47,-9,33
Perth Glory,5201,8,10,2,15,37,50,-13,32
Wellington P,5201,9,5,6,16,31,55,-24,21
CC Mariners,5201,10,4,8,15,28,49,-21,20
Sydney FC,5202,1,20,4,4,64,23,41,64
N'castle Jet,5202,2,15,5,8,57,40,17,50
Melbourne C,5202,3,15,4,10,46,33,13,49
Melbourne V,5202,4,14,5,10,46,38,8,47
Adelaide Utd,5202,5,11,6,11,37,40,-3,39
Brisbane,5202,6,10,5,13,33,42,-9,35
Western Sydn,5202,7,8,9,10,38,47,-9,33
Perth Glory,5202,8,10,2,15,37,50,-13,32
Wellington P,5202,9,5,6,16,31,55,-24,21
CC Mariners,5202,10,4,8,15,28,49,-21,20
Sydney FC,5203,1,20,4,4,66,25,41,64
N'castle Jet,5203,2,15,6,7,58,38,20,51
Melbourne C,5203,3,14,5,10,44,34,10,47
Melbourne V,5203,4,14,5,10,48,40,8,47
Adelaide Utd,5203,5,11,6,11,37,40,-3,39
Brisbane,5203,6,10,5,13,33,42,-9,35
Western Sydn,5203,7,8,9,10,38,47,-9,33
Perth Glory,5203,8,10,2,15,37,50,-13,32
Wellington P,5203,9,5,6,16,31,55,-24,21
CC Mariners,5203,10,4,8,15,28,49,-21,20
Sydney FC,5204,1,21,4,3,66,22,44,67
N'castle Jet,5204,2,15,5,8,57,39,18,50
Melbourne C,5204,3,15,4,10,45,33,12,49
Melbourne V,5204,4,13,5,11,45,40,5,44
Adelaide Utd,5204,5,11,6,11,37,40,-3,39
Brisbane,5204,6,10,5,13,33,42,-9,35
Western Sydn,5204,7,8,9,10,38,47,-9,33
Perth Glory,5204,8,10,2,15,37,50,-13,32
Wellington P,5204,9,5,6,16,31,55,-24,21
CC Mariners,5204,10,4,8,15,28,49,-21,20
Sydney FC,5205,1,21,4,3,68,23,45,67
N'castle Jet,5205,2,16,5,7,60,38,22,53
Melbourne C,5205,3,14,4,11,44,36,8,46
Melbourne V,5205,4,13,5,11,46,42,4,44
Adelaide Utd,5205,5,11,6,11,37,40,-3,39
Brisbane,5205,6,10,5,13,33,42,-9,35
Western Sydn,5205,7,8,9,10,38,47,-9,33
Perth Glory,5205,8,10,2,15,37,50,-13,32
Wellington P,5205,9,5,6,16,31,55,-24,21
CC Mariners,5205,10,4,8,15,28,49,-21,20
Sydney FC,5206,1,20,5,3,64,22,42,65
N'castle Jet,5206,2,15,6,7,58,38,20,51
Melbourne C,5206,3,14,5,10,44,34,10,47
Melbourne V,5206,4,13,6,10,45,38,7,45
Adelaide Utd,5206,5,11,6,11,37,40,-3,39
Brisbane,5206,6,10,5,13,33,42,-9,35
Western Sydn,5206,7,8,9,10,38,47,-9,33
Perth Glory,5206,8,10,2,15,37,50,-13,32
Wellington P,5206,9,5,6,16,31,55,-24,21
CC Mariners,5206,10,4,8,15,28,49,-21,20
Sydney FC,5207,1,21,4,3,67,24,43,67
N'castle Jet,5207,2,15,6,7,58,38,20,51
Melbourne C,5207,3,14,5,10,44,34,10,47
Melbourne V,5207,4,13,5,11,47,41,6,44
Adelaide Utd,5207,5,11,6,11,37,40,-3,39
Brisbane,5207,6,10,5,13,33,42,-9,35
Western Sydn,5207,7,8,9,10,38,47,-9,33
Perth Glory,5207,8,10,2,15,37,50,-13,32
Wellington P,5207,9,5,6,16,31,55,-24,21
CC Mariners,5207,10,4,8,15,28,49,-21,20
Sydney FC,5208,1,20,5,3,64,22,42,65
N'castle Jet,5208,2,16,5,7,61,39,22,53
Melbourne C,5208,3,14,4,11,45,37,8,46
Melbourne V,5208,4,13,6,10,45,38,7,45
Adelaide Utd,5208,5,11,6,11,37,40,-3,39
Brisbane,5208,6,10,5,13,33,42,-9,35
Western Sydn,5208,7,8,9,10,38,47,-9,33
Perth Glory,5208,8,10,2,15,37,50,-13,32
Wellington P,5208,9,5,6,16,31,55,-24,21
CC Mariners,5208,10,4,8,15,28,49,-21,20
Sydney FC,5209,1,21,4,3,65,22,43,67
N'castle Jet,5209,2,16,5,7,58,37,21,53
Melbourne C,5209,3,14,4,11,43,34,9,46
Melbourne V,5209,4,13,5,11,45,39,6,44
Adelaide Utd,5209,5,11,6,11,37,40,-3,39
Brisbane,5209,6,10,5,13,33,42,-9,35
Western Sydn,5209,7,8,9,10,38,47,-9,33
Perth Glory,5209,8,10,2,15,37,50,-13,32
Wellington P,5209,9,5,6,16,31,55,-24,21
CC Mariners,5209,10,4,8,15,28,49,-21,20
Sydney FC,5210,1,21,4,3,66,23,43,67
N'castle Jet,5210,2,16,5,7,61,37,24,53
Melbourne C,5210,3,14,4,11,43,37,6,46
Melbourne V,5210,4,13,5,11,46,40,6,44
Adelaide Utd,5210,5,11,6,11,37,40,-3,39
Brisbane,5210,6,10,5,13,33,42,-9,35
Western Sydn,5210,7,8,9,10,38,47,-9,33
Perth Glory,5210,8,10,2,15,37,50,-13,32
Wellington P,5210,9,5,6,16,31,55,-24,21
CC Mariners,5210,10,4,8,15,28,49,-21,20
Sydney FC,5211,1,20,4,4,65,24,41,64
N'castle Jet,5211,2,15,6,7,57,37,20,51
Melbourne C,5211,3,14,5,10,43,33,10,47
Melbourne V,5211,4,14,5,10,47,39,8,47
Adelaide Utd,5211,5,11,6,11,37,40,-3,39
Brisbane,5211,6,10,5,13,33,42,-9,35
Western Sydn,5211,7,8,9,10,38,47,-9,33
Perth Glory,5211,8,10,2,15,37,50,-13,32
Wellington P,5211,9,5,6,16,31,55,-24,21
CC Mariners,5211,10,4,8,15,28,49,-21,20
Sydney FC,5212,1,20,4,4,65,24,41,64
N'castle Jet,5212,2,15,5,8,57,39,18,50
Melbourne C,5212,3,15,4,10,45,33,12,49
Melbourne V,5212,4,14,5,10,47,39,8,47
Adelaide Utd,5212,5,11,6,11,37,40,-3,39
Brisbane,5212,6,10,5,13,33,42,-9,35
Western Sydn,5212,7,8,9,10,38,47,-9,33
Perth Glory,5212,8,10,2,15,37,50,-13,32
Wellington P,5212,9,5,6,16,31,55,-24,21
CC Mariners,5212,10,4,8,15,28,49,-21,20
Sydney FC,5213,1,21,4,3,66,22,44,67
N'castle Jet,5213,2,15,5,8,57,40,17,50
Melbourne C,5213,3,15,4,10,46,33,13,49
Melbourne V,5213,4,13,5,11,45,40,5,44
Adelaide Utd,5213,5,11,6,11,37,40,-3,39
Brisbane,5213,6,10,5,13,33,42,-9,35
Western Sydn,5213,7,8,9,10,38,47,-9,33
Perth Glory,5213,8,10,2,15,37,50,-13,32
Wellington P,5213,9,5,6,16,31,55,-24,21
CC Mariners,5213,10,4,8,15,28,49,-21,20
Sydney FC,5214,1,21,4,3,68,25,43,67
N'castle Jet,5214,2,15,6,7,59,39,20,51
Melbourne C,5214,3,14,5,10,45,35,10,47
Melbourne V,5214,4,13,5,11,48,42,6,44
Adelaide Utd,5214,5,11,6,11,37,40,-3,39
Brisbane,5214,6,10,5,13,33,42,-9,35
Western Sydn,5214,7,8,9,10,38,47,-9,33
Perth Glory,5214,8,10,2,15,37,50,-13,32
Wellington P,5214,9,5,6,16,31,55,-24,21
CC Mariners,5214,10,4,8,15,28,49,-21,20
Sydney FC,5215,1,20,5,3,66,24,42,65
N'castle Jet,5215,2,15,6,7,58,38,20,51
Melbourne C,5215,3,14,5,10,44,34,10,47
Melbourne V,5215,4,13,6,10,47,40,7,45
Adelaide Utd,5215,5,11,6,11,37,40,-3,39
Brisbane,5215,6,10,5,13,33,42,-9,35
Western Sydn,5215,7,8,9,10,38,47,-9,33
Perth Glory,5215,8,10,2,15,37,50,-13,32
Wellington P,5215,9,5,6,16,31,55,-24,21
CC Mariners,5215,10,4,8,15,28,49,-21,20
Sydney FC,5216,1,21,4,3,66,22,44,67
N'castle Jet,5216,2,15,6,7,59,39,20,51
Melbourne C,5216,3,14,5,10,45,35,10,47
Melbourne V,5216,4,13,5,11,45,40,5,44
Adelaide Utd,5216,5,11,6,11,37,40,-3,39
Brisbane,5216,6,10,5,13,33,42,-9,35
Western Sydn,5216,7,8,9,10,38,47,-9,33
Perth Glory,5216,8,10,2,15,37,50,-13,32
Wellington P,5216,9,5,6,16,31,55,-24,21
CC Mariners,5216,10,4,8,15,28,49,-21,20
Sydney FC,5217,1,21,4,3,66,22,44,67
N'castle Jet,5217,2,15,6,7,57,37,20,51
Melbourne C,5217,3,14,5,10,43,33,10,47
Melbourne V,5217,4,13,5,11,45,40,5,44
Adelaide Utd,5217,5,11,6,11,37,40,-3,39
Brisbane,5217,6,10,5,13,33,42,-9,35
Western Sydn,5217,7,8,9,10,38,47,-9,33
Perth Glory,5217,8,10,2,15,37,50,-13,32
Wellington P,5217,9,5,6,16,31,55,-24,21
CC Mariners,5217,10,4,8,15,28,49,-21,20
Sydney FC,5218,1,21,4,3,68,23,45,67
N'castle Jet,5218,2,16,5,7,59,37,22,53
Melbourne C,5218,3,14,4,11,43,35,8,46
Melbourne V,5218,4,13,5,11,46,42,4,44
Adelaide Utd,5218,5,11,6,11,37,40,-3,39
Brisbane,5218,6,10,5,13,33,42,-9,35
Western Sydn,5218,7,8,9,10,38,47,-9,33
Perth Glory,5218,8,10,2,15,37,50,-13,32
Wellington P,5218,9,5,6,16,31,55,-24,21
CC Mariners,5218,10,4,8,15,28,49,-21,20
Sydney FC,5219,1,20,5,3,65,23,42,65
N'castle Jet,5219,2,16,5,7,60,38,22,53
Melbourne C,5219,3,14,4,11,44,36,8,46
Melbourne V,5219,4,13,6,10,46,39,7,45
Adelaide Utd,5219,5,11,6,11,37,40,-3,39
Brisbane,5219,6,10,5,13,33,42,-9,35
Western Sydn,5219,7,8,9,10,38,47,-9,33
Perth Glory,5219,8,10,2,15,37,50,-13,32
Wellington P,5219,9,5,6,16,31,55,-24,21
CC Mariners,5219,10,4,8,15,28,49,-21,20
Sydney FC,5220,1,20,5,3,65,23,42,65
N'castle Jet,5220,2,15,5,8,58,39,19,50
Melbourne C,5220,3,15,4,10,45,34,11,49
Melbourne V,5220,4,13,6,10,46,39,7,45
Adelaide Utd,5220,5,11,6,11,37,40,-3,39
Brisbane,5220,6,10,5,13,33,42,-9,35
Western Sydn,5220,7,8,9,10,38,47,-9,33
Perth Glory,5220,8,10,2,15,37,50,-13,32
Wellington P,5220,9,5,6,16,31,55,-24,21
CC Mariners,5220,10,4,8,15,28,49,-21,20
Sydney FC,5221,1,21,4,3,66,22,44,67
N'castle Jet,5221,2,15,6,7,57,37,20,51
Melbourne C,5221,3,14,5,10,43,33,10,47
Melbourne V,5221,4,13,5,11,45,40,5,44
Adelaide Utd,5221,5,11,6,11,37,40,-3,39
Brisbane,5221,6,10,5,13,33,42,-9,35
Western Sydn,5221,7,8,9,10,38,47,-9,33
Perth Glory,5221,8,10,2,15,37,50,-13,32
Wellington P,5221,9,5,6,16,31,55,-24,21
CC Mariners,5221,10,4,8,15,28,49,-21,20
Sydney FC,5222,1,21,4,3,66,22,44,67
N'castle Jet,5222,2,15,6,7,57,37,20,51
Melbourne C,5222,3,14,5,10,43,33,10,47
Melbourne V,5222,4,13,5,11,45,40,5,44
Adelaide Utd,5222,5,11,6,11,37,40,-3,39
Brisbane,5222,6,10,5,13,33,42,-9,35
Western Sydn,5222,7,8,9,10,38,47,-9,33
Perth Glory,5222,8,10,2,15,37,50,-13,32
Wellington P,5222,9,5,6,16,31,55,-24,21
CC Mariners,5222,10,4,8,15,28,49,-21,20
Sydney FC,5223,1,21,4,3,68,25,43,67
N'castle Jet,5223,2,16,5,7,60,37,23,53
Melbourne C,5223,3,14,4,11,43,36,7,46
Melbourne V,5223,4,13,5,11,48,42,6,44
Adelaide Utd,5223,5,11,6,11,37,40,-3,39
Brisbane,5223,6,10,5,13,33,42,-9,35
Western Sydn,5223,7,8,9,10,38,47,-9,33
Perth Glory,5223,8,10,2,15,37,50,-13,32
Wellington P,5223,9,5,6,16,31,55,-24,21
CC Mariners,5223,10,4,8,15,28,49,-21,20
Sydney FC,5224,1,20,5,3,65,23,42,65
N'castle Jet,5224,2,16,5,7,60,38,22,53
Melbourne C,5224,3,14,4,11,44,36,8,46
Melbourne V,5224,4,13,6,10,46,39,7,45
Adelaide Utd,5224,5,11,6,11,37,40,-3,39
Brisbane,5224,6,10,5,13,33,42,-9,35
Western Sydn,5224,7,8,9,10,38,47,-9,33
Perth Glory,5224,8,10,2,15,37,50,-13,32
Wellington P,5224,9,5,6,16,31,55,-24,21
CC Mariners,5224,10,4,8,15,28,49,-21,20
Sydney FC,5225,1,21,4,3,68,23,45,67
N'castle Jet,5225,2,16,5,7,59,37,22,53
Melbourne C,5225,3,14,4,11,43,35,8,46
Melbourne V,5225,4,13,5,11,46,42,4,44
Adelaide Utd,5225,5,11,6,11,37,40,-3,39
Brisbane,5225,6,10,5,13,33,42,-9,35
Western Sydn,5225,7,8,9,10,38,47,-9,33
Perth Glory,5225,8,10,2,15,37,50,-13,32
Wellington P,5225,9,5,6,16,31,55,-24,21
CC Mariners,5225,10,4,8,15,28,49,-21,20
Sydney FC,5226,1,20,5,3,64,22,42,65
N'castle Jet,5226,2,16,5,7,61,40,21,53
Melbourne C,5226,3,14,4,11,46,37,9,46
Melbourne V,5226,4,13,6,10,45,38,7,45
Adelaide Utd,5226,5,11,6,11,37,40,-3,39
Brisbane,5226,6,10,5,13,33,42,-9,35
Western Sydn,5226,7,8,9,10,38,47,-9,33
Perth Glory,5226,8,10,2,15,37,50,-13,32
Wellington P,5226,9,5,6,16,31,55,-24,21
CC Mariners,5226,10,4,8,15,28,49,-21,20
Sydney FC,5227,1,20,5,3,65,23,42,65
N'castle Jet,5227,2,16,5,7,60,38,22,53
Melbourne C,5227,3,14,4,11,44,36,8,46
Melbourne V,5227,4,13,6,10,46,39,7,45
Adelaide Utd,5227,5,11,6,11,37,40,-3,39
Brisbane,5227,6,10,5,13,33,42,-9,35
Western Sydn,5227,7,8,9,10,38,47,-9,33
Perth Glory,5227,8,10,2,15,37,50,-13,32
Wellington P,5227,9,5,6,16,31,55,-24,21
CC Mariners,5227,10,4,8,15,28,49,-21,20
Sydney FC,5228,1,20,5,3,65,23,42,65
N'castle Jet,5228,2,16,5,7,58,37,21,53
Melbourne C,5228,3,14,4,11,43,34,9,46
Melbourne V,5228,4,13,6,10,46,39,7,45
Adelaide Utd,5228,5,11,6,11,37,40,-3,39
Brisbane,5228,6,10,5,13,33,42,-9,35
Western Sydn,5228,7,8,9,10,38,47,-9,33
Perth Glory,5228,8,10,2,15,37,50,-13,32
Wellington P,5228,9,5,6,16,31,55,-24,21
CC Mariners,5228,10,4,8,15,28,49,-21,20
Sydney FC,5229,1,21,4,3,68,24,44,67
N'castle Jet,5229,2,15,5,8,57,39,18,50
Melbourne C,5229,3,15,4,10,45,33,12,49
Melbourne V,5229,4,13,5,11,47,42,5,44
Adelaide Utd,5229,5,11,6,11,37,40,-3,39
Brisbane,5229,6,10,5,13,33,42,-9,35
Western Sydn,5229,7,8,9,10,38,47,-9,33
Perth Glory,5229,8,10,2,15,37,50,-13,32
Wellington P,5229,9,5,6,16,31,55,-24,21
CC Mariners,5229,10,4,8,15,28,49,-21,20
Sydney FC,5230,1,20,5,3,65,23,42,65
N'castle Jet,5230,2,16,5,7,61,40,21,53
Melbourne C,5230,3,14,4,11,46,37,9,46
Melbourne V,5230,4,13,6,10,46,39,7,45
Adelaide Utd,5230,5,11,6,11,37,40,-3,39
Brisbane,5230,6,10,5,13,33,42,-9,35
Western Sydn,5230,7,8,9,10,38,47,-9,33
Perth Glory,5230,8,10,2,15,37,50,-13,32
Wellington P,5230,9,5,6,16,31,55,-24,21
CC Mariners,5230,10,4,8,15,28,49,-21,20
Sydney FC,5231,1,21,4,3,67,23,44,67
N'castle Jet,5231,2,15,5,8,58,40,18,50
Melbourne C,5231,3,15,4,10,46,34,12,49
Melbourne V,5231,4,13,5,11,46,41,5,44
Adelaide Utd,5231,5,11,6,11,37,40,-3,39
Brisbane,5231,6,10,5,13,33,42,-9,35
Western Sydn,5231,7,8,9,10,38,47,-9,33
Perth Glory,5231,8,10,2,15,37,50,-13,32
Wellington P,5231,9,5,6,16,31,55,-24,21
CC Mariners,5231,10,4,8,15,28,49,-21,20
Sydney FC,5232,1,20,5,3,65,23,42,65
N'castle Jet,5232,2,15,6,7,59,39,20,51
Melbourne C,5232,3,14,5,10,45,35,10,47
Melbourne V,5232,4,13,6,10,46,39,7,45
Adelaide Utd,5232,5,11,6,11,37,40,-3,39
Brisbane,5232,6,10,5,13,33,42,-9,35
Western Sydn,5232,7,8,9,10,38,47,-9,33
Perth Glory,5232,8,10,2,15,37,50,-13,32
Wellington P,5232,9,5,6,16,31,55,-24,21
CC Mariners,5232,10,4,8,15,28,49,-21,20
Sydney FC,5233,1,21,4,3,68,23,45,67
N'castle Jet,5233,2,16,5,7,60,38,22,53
Melbourne C,5233,3,14,4,11,44,36,8,46
Melbourne V,5233,4,13,5,11,46,42,4,44
Adelaide Utd,5233,5,11,6,11,37,40,-3,39
Brisbane,5233,6,10,5,13,33,42,-9,35
Western Sydn,5233,7,8,9,10,38,47,-9,33
Perth Glory,5233,8,10,2,15,37,50,-13,32
Wellington P,5233,9,5,6,16,31,55,-24,21
CC Mariners,5233,10,4,8,15,28,49,-21,20
Sydney FC,5234,1,21,4,3,67,24,43,67
N'castle Jet,5234,2,16,5,7,60,38,22,53
Melbourne C,5234,3,14,4,11,44,36,8,46
Melbourne V,5234,4,13,5,11,47,41,6,44
Adelaide Utd,5234,5,11,6,11,37,40,-3,39
Brisbane,5234,6,10,5,13,33,42,-9,35
Western Sydn,5234,7,8,9,10,38,47,-9,33
Perth Glory,5234,8,10,2,15,37,50,-13,32
Wellington P,5234,9,5,6,16,31,55,-24,21
CC Mariners,5234,10,4,8,15,28,49,-21,20
Sydney FC,5235,1,21,4,3,66,22,44,67
N'castle Jet,5235,2,15,5,8,57,38,19,50
Melbourne C,5235,3,15,4,10,44,33,11,49
Melbourne V,5235,4,13,5,11,45,40,5,44
Adelaide Utd,5235,5,11,6,11,37,40,-3,39
Brisbane,5235,6,10,5,13,33,42,-9,35
Western Sydn,5235,7,8,9,10,38,47,-9,33
Perth Glory,5235,8,10,2,15,37,50,-13,32
Wellington P,5235,9,5,6,16,31,55,-24,21
CC Mariners,5235,10,4,8,15,28,49,-21,20
Sydney FC,5236,1,21,4,3,70,23,47,67
N'castle Jet,5236,2,16,5,7,60,39,21,53
Melbourne C,5236,3,14,4,11,45,36,9,46
Melbourne V,5236,4,13,5,11,46,44,2,44
Adelaide Utd,5236,5,11,6,11,37,40,-3,39
Brisbane,5236,6,10,5,13,33,42,-9,35
Western Sydn,5236,7,8,9,10,38,47,-9,33
Perth Glory,5236,8,10,2,15,37,50,-13,32
Wellington P,5236,9,5,6,16,31,55,-24,21
CC Mariners,5236,10,4,8,15,28,49,-21,20
Sydney FC,5237,1,21,4,3,66,23,43,67
N'castle Jet,5237,2,16,5,7,60,39,21,53
Melbourne C,5237,3,14,4,11,45,36,9,46
Melbourne V,5237,4,13,5,11,46,40,6,44
Adelaide Utd,5237,5,11,6,11,37,40,-3,39
Brisbane,5237,6,10,5,13,33,42,-9,35
Western Sydn,5237,7,8,9,10,38,47,-9,33
Perth Glory,5237,8,10,2,15,37,50,-13,32
Wellington P,5237,9,5,6,16,31,55,-24,21
CC Mariners,5237,10,4,8,15,28,49,-21,20
Sydney FC,5238,1,20,4,4,64,24,40,64
N'castle Jet,5238,2,16,5,7,60,37,23,53
Melbourne V,5238,3,14,5,10,47,38,9,47
Melbourne C,5238,4,14,4,11,43,36,7,46
Adelaide Utd,5238,5,11,6,11,37,40,-3,39
Brisbane,5238,6,10,5,13,33,42,-9,35
Western Sydn,5238,7,8,9,10,38,47,-9,33
Perth Glory,5238,8,10,2,15,37,50,-13,32
Wellington P,5238,9,5,6,16,31,55,-24,21
CC Mariners,5238,10,4,8,15,28,49,-21,20
Sydney FC,5239,1,21,4,3,66,23,43,67
N'castle Jet,5239,2,15,5,8,57,38,19,50
Melbourne C,5239,3,15,4,10,44,33,11,49
Melbourne V,5239,4,13,5,11,46,40,6,44
Adelaide Utd,5239,5,11,6,11,37,40,-3,39
Brisbane,5239,6,10,5,13,33,42,-9,35
Western Sydn,5239,7,8,9,10,38,47,-9,33
Perth Glory,5239,8,10,2,15,37,50,-13,32
Wellington P,5239,9,5,6,16,31,55,-24,21
CC Mariners,5239,10,4,8,15,28,49,-21,20
Sydney FC,5240,1,20,5,3,65,23,42,65
N'castle Jet,5240,2,16,5,7,59,38,21,53
Melbourne C,5240,3,14,4,11,44,35,9,46
Melbourne V,5240,4,13,6,10,46,39,7,45
Adelaide Utd,5240,5,11,6,11,37,40,-3,39
Brisbane,5240,6,10,5,13,33,42,-9,35
Western Sydn,5240,7,8,9,10,38,47,-9,33
Perth Glory,5240,8,10,2,15,37,50,-13,32
Wellington P,5240,9,5,6,16,31,55,-24,21
CC Mariners,5240,10,4,8,15,28,49,-21,20
Sydney FC,5241,1,20,5,3,64,22,42,65
N'castle Jet,5241,2,15,6,7,60,40,20,51
Melbourne C,5241,3,14,5,10,46,36,10,47
Melbourne V,5241,4,13,6,10,45,38,7,45
Adelaide Utd,5241,5,11,6,11,37,40,-3,39
Brisbane,5241,6,10,5,13,33,42,-9,35
Western Sydn,5241,7,8,9,10,38,47,-9,33
Perth Glory,5241,8,10,2,15,37,50,-13,32
Wellington P,5241,9,5,6,16,31,55,-24,21
CC Mariners,5241,10,4,8,15,28,49,-21,20
Sydney FC,5242,1,21,4,3,67,24,43,67
N'castle Jet,5242,2,15,6,7,58,38,20,51
Melbourne C,5242,3,14,5,10,44,34,10,47
Melbourne V,5242,4,13,5,11,47,41,6,44
Adelaide Utd,5242,5,11,6,11,37,40,-3,39
Brisbane,5242,6,10,5,13,33,42,-9,35
Western Sydn,5242,7,8,9,10,38,47,-9,33
Perth Glory,5242,8,10,2,15,37,50,-13,32
Wellington P,5242,9,5,6,16,31,55,-24,21
CC Mariners,5242,10,4,8,15,28,49,-21,20
Sydney FC,5243,1,20,5,3,64,22,42,65
N'castle Jet,5243,2,15,6,7,58,38,20,51
Melbourne C,5243,3,14,5,10,44,34,10,47
Melbourne V,5243,4,13,6,10,45,38,7,45
Adelaide Utd,5243,5,11,6,11,37,40,-3,39
Brisbane,5243,6,10,5,13,33,42,-9,35
Western Sydn,5243,7,8,9,10,38,47,-9,33
Perth Glory,5243,8,10,2,15,37,50,-13,32
Wellington P,5243,9,5,6,16,31,55,-24,21
CC Mariners,5243,10,4,8,15,28,49,-21,20
Sydney FC,5244,1,21,4,3,67,22,45,67
N'castle Jet,5244,2,15,6,7,58,38,20,51
Melbourne C,5244,3,14,5,10,44,34,10,47
Melbourne V,5244,4,13,5,11,45,41,4,44
Adelaide Utd,5244,5,11,6,11,37,40,-3,39
Brisbane,5244,6,10,5,13,33,42,-9,35
Western Sydn,5244,7,8,9,10,38,47,-9,33
Perth Glory,5244,8,10,2,15,37,50,-13,32
Wellington P,5244,9,5,6,16,31,55,-24,21
CC Mariners,5244,10,4,8,15,28,49,-21,20
Sydney FC,5245,1,21,4,3,67,22,45,67
N'castle Jet,5245,2,15,6,7,58,38,20,51
Melbourne C,5245,3,14,5,10,44,34,10,47
Melbourne V,5245,4,13,5,11,45,41,4,44
Adelaide Utd,5245,5,11,6,11,37,40,-3,39
Brisbane,5245,6,10,5,13,33,42,-9,35
Western Sydn,5245,7,8,9,10,38,47,-9,33
Perth Glory,5245,8,10,2,15,37,50,-13,32
Wellington P,5245,9,5,6,16,31,55,-24,21
CC Mariners,5245,10,4,8,15,28,49,-21,20
Sydney FC,5246,1,20,4,4,64,23,41,64
N'castle Jet,5246,2,16,5,7,60,37,23,53
Melbourne V,5246,3,14,5,10,46,38,8,47
Melbourne C,5246,4,14,4,11,43,36,7,46
Adelaide Utd,5246,5,11,6,11,37,40,-3,39
Brisbane,5246,6,10,5,13,33,42,-9,35
Western Sydn,5246,7,8,9,10,38,47,-9,33
Perth Glory,5246,8,10,2,15,37,50,-13,32
Wellington P,5246,9,5,6,16,31,55,-24,21
CC Mariners,5246,10,4,8,15,28,49,-21,20
Sydney FC,5247,1,21,4,3,65,22,43,67
N'castle Jet,5247,2,16,5,7,61,37,24,53
Melbourne C,5247,3,14,4,11,43,37,6,46
Melbourne V,5247,4,13,5,11,45,39,6,44
Adelaide Utd,5247,5,11,6,11,37,40,-3,39
Brisbane,5247,6,10,5,13,33,42,-9,35
Western Sydn,5247,7,8,9,10,38,47,-9,33
Perth Glory,5247,8,10,2,15,37,50,-13,32
Wellington P,5247,9,5,6,16,31,55,-24,21
CC Mariners,5247,10,4,8,15,28,49,-21,20
Sydney FC,5248,1,21,4,3,65,22,43,67
N'castle Jet,5248,2,16,5,7,60,38,22,53
Melbourne C,5248,3,14,4,11,44,36,8,46
Melbourne V,5248,4,13,5,11,45,39,6,44
Adelaide Utd,5248,5,11,6,11,37,40,-3,39
Brisbane,5248,6,10,5,13,33,42,-9,35
Western Sydn,5248,7,8,9,10,38,47,-9,33
Perth Glory,5248,8,10,2,15,37,50,-13,32
Wellington P,5248,9,5,6,16,31,55,-24,21
CC Mariners,5248,10,4,8,15,28,49,-21,20
Sydney FC,5249,1,20,5,3,65,23,42,65
N'castle Jet,5249,2,15,6,7,60,40,20,51
Melbourne C,5249,3,14,5,10,46,36,10,47
Melbourne V,5249,4,13,6,10,46,39,7,45
Adelaide Utd,5249,5,11,6,11,37,40,-3,39
Brisbane,5249,6,10,5,13,33,42,-9,35
Western Sydn,5249,7,8,9,10,38,47,-9,33
Perth Glory,5249,8,10,2,15,37,50,-13,32
Wellington P,5249,9,5,6,16,31,55,-24,21
CC Mariners,5249,10,4,8,15,28,49,-21,20
Sydney FC,5250,1,21,4,3,68,23,45,67
N'castle Jet,5250,2,16,5,7,61,38,23,53
Melbourne C,5250,3,14,4,11,44,37,7,46
Melbourne V,5250,4,13,5,11,46,42,4,44
Adelaide Utd,5250,5,11,6,11,37,40,-3,39
Brisbane,5250,6,10,5,13,33,42,-9,35
Western Sydn,5250,7,8,9,10,38,47,-9,33
Perth Glory,5250,8,10,2,15,37,50,-13,32
Wellington P,5250,9,5,6,16,31,55,-24,21
CC Mariners,5250,10,4,8,15,28,49,-21,20
Sydney FC,5251,1,21,4,3,66,23,43,67
N'castle Jet,5251,2,16,5,7,61,37,24,53
Melbourne C,5251,3,14,4,11,43,37,6,46
Melbourne V,5251,4,13,5,11,46,40,6,44
Adelaide Utd,5251,5,11,6,11,37,40,-3,39
Brisbane,5251,6,10,5,13,33,42,-9,35
Western Sydn,5251,7,8,9,10,38,47,-9,33
Perth Glory,5251,8,10,2,15,37,50,-13,32
Wellington P,5251,9,5,6,16,31,55,-24,21
CC Mariners,5251,10,4,8,15,28,49,-21,20
Sydney FC,5252,1,21,4,3,65,22,43,67
N'castle Jet,5252,2,15,5,8,57,40,17,50
Melbourne C,5252,3,15,4,10,46,33,13,49
Melbourne V,5252,4,13,5,11,45,39,6,44
Adelaide Utd,5252,5,11,6,11,37,40,-3,39
Brisbane,5252,6,10,5,13,33,42,-9,35
Western Sydn,5252,7,8,9,10,38,47,-9,33
Perth Glory,5252,8,10,2,15,37,50,-13,32
Wellington P,5252,9,5,6,16,31,55,-24,21
CC Mariners,5252,10,4,8,15,28,49,-21,20
Sydney FC,5253,1,21,4,3,68,25,43,67
N'castle Jet,5253,2,15,5,8,58,39,19,50
Melbourne C,5253,3,15,4,10,45,34,11,49
Melbourne V,5253,4,13,5,11,48,42,6,44
Adelaide Utd,5253,5,11,6,11,37,40,-3,39
Brisbane,5253,6,10,5,13,33,42,-9,35
Western Sydn,5253,7,8,9,10,38,47,-9,33
Perth Glory,5253,8,10,2,15,37,50,-13,32
Wellington P,5253,9,5,6,16,31,55,-24,21
CC Mariners,5253,10,4,8,15,28,49,-21,20
Sydney FC,5254,1,20,4,4,66,25,41,64
N'castle Jet,5254,2,16,5,7,60,38,22,53
Melbourne V,5254,3,14,5,10,48,40,8,47
Melbourne C,5254,4,14,4,11,44,36,8,46
Adelaide Utd,5254,5,11,6,11,37,40,-3,39
Brisbane,5254,6,10,5,13,33,42,-9,35
Western Sydn,5254,7,8,9,10,38,47,-9,33
Perth Glory,5254,8,10,2,15,37,50,-13,32
Wellington P,5254,9,5,6,16,31,55,-24,21
CC Mariners,5254,10,4,8,15,28,49,-21,20
Sydney FC,5255,1,21,4,3,66,23,43,67
N'castle Jet,5255,2,16,5,7,61,38,23,53
Melbourne C,5255,3,14,4,11,44,37,7,46
Melbourne V,5255,4,13,5,11,46,40,6,44
Adelaide Utd,5255,5,11,6,11,37,40,-3,39
Brisbane,5255,6,10,5,13,33,42,-9,35
Western Sydn,5255,7,8,9,10,38,47,-9,33
Perth Glory,5255,8,10,2,15,37,50,-13,32
Wellington P,5255,9,5,6,16,31,55,-24,21
CC Mariners,5255,10,4,8,15,28,49,-21,20
Sydney FC,5256,1,21,4,3,65,22,43,67
N'castle Jet,5256,2,16,5,7,60,38,22,53
Melbourne C,5256,3,14,4,11,44,36,8,46
Melbourne V,5256,4,13,5,11,45,39,6,44
Adelaide Utd,5256,5,11,6,11,37,40,-3,39
Brisbane,5256,6,10,5,13,33,42,-9,35
Western Sydn,5256,7,8,9,10,38,47,-9,33
Perth Glory,5256,8,10,2,15,37,50,-13,32
Wellington P,5256,9,5,6,16,31,55,-24,21
CC Mariners,5256,10,4,8,15,28,49,-21,20
Sydney FC,5257,1,21,4,3,67,23,44,67
N'castle Jet,5257,2,16,5,7,60,39,21,53
Melbourne C,5257,3,14,4,11,45,36,9,46
Melbourne V,5257,4,13,5,11,46,41,5,44
Adelaide Utd,5257,5,11,6,11,37,40,-3,39
Brisbane,5257,6,10,5,13,33,42,-9,35
Western Sydn,5257,7,8,9,10,38,47,-9,33
Perth Glory,5257,8,10,2,15,37,50,-13,32
Wellington P,5257,9,5,6,16,31,55,-24,21
CC Mariners,5257,10,4,8,15,28,49,-21,20
Sydney FC,5258,1,21,4,3,66,23,43,67
N'castle Jet,5258,2,15,5,8,58,39,19,50
Melbourne C,5258,3,15,4,10,45,34,11,49
Melbourne V,5258,4,13,5,11,46,40,6,44
Adelaide Utd,5258,5,11,6,11,37,40,-3,39
Brisbane,5258,6,10,5,13,33,42,-9,35
Western Sydn,5258,7,8,9,10,38,47,-9,33
Perth Glory,5258,8,10,2,15,37,50,-13,32
Wellington P,5258,9,5,6,16,31,55,-24,21
CC Mariners,5258,10,4,8,15,28,49,-21,20
Sydney FC,5259,1,21,4,3,67,24,43,67
N'castle Jet,5259,2,15,5,8,59,40,19,50
Melbourne C,5259,3,15,4,10,46,35,11,49
Melbourne V,5259,4,13,5,11,47,41,6,44
Adelaide Utd,5259,5,11,6,11,37,40,-3,39
Brisbane,5259,6,10,5,13,33,42,-9,35
Western Sydn,5259,7,8,9,10,38,47,-9,33
Perth Glory,5259,8,10,2,15,37,50,-13,32
Wellington P,5259,9,5,6,16,31,55,-24,21
CC Mariners,5259,10,4,8,15,28,49,-21,20
Sydney FC,5260,1,21,4,3,67,22,45,67
N'castle Jet,5260,2,15,5,8,57,38,19,50
Melbourne C,5260,3,15,4,10,44,33,11,49
Melbourne V,5260,4,13,5,11,45,41,4,44
Adelaide Utd,5260,5,11,6,11,37,40,-3,39
Brisbane,5260,6,10,5,13,33,42,-9,35
Western Sydn,5260,7,8,9,10,38,47,-9,33
Perth Glory,5260,8,10,2,15,37,50,-13,32
Wellington P,5260,9,5,6,16,31,55,-24,21
CC Mariners,5260,10,4,8,15,28,49,-21,20
Sydney FC,5261,1,20,5,3,66,24,42,65
N'castle Jet,5261,2,16,5,7,60,38,22,53
Melbourne C,5261,3,14,4,11,44,36,8,46
Melbourne V,5261,4,13,6,10,47,40,7,45
Adelaide Utd,5261,5,11,6,11,37,40,-3,39
Brisbane,5261,6,10,5,13,33,42,-9,35
Western Sydn,5261,7,8,9,10,38,47,-9,33
Perth Glory,5261,8,10,2,15,37,50,-13,32
Wellington P,5261,9,5,6,16,31,55,-24,21
CC Mariners,5261,10,4,8,15,28,49,-21,20
Sydney FC,5262,1,21,4,3,66,22,44,67
N'castle Jet,5262,2,16,5,7,61,39,22,53
Melbourne C,5262,3,14,4,11,45,37,8,46
Melbourne V,5262,4,13,5,11,45,40,5,44
Adelaide Utd,5262,5,11,6,11,37,40,-3,39
Brisbane,5262,6,10,5,13,33,42,-9,35
Western Sydn,5262,7,8,9,10,38,47,-9,33
Perth Glory,5262,8,10,2,15,37,50,-13,32
Wellington P,5262,9,5,6,16,31,55,-24,21
CC Mariners,5262,10,4,8,15,28,49,-21,20
Sydney FC,5263,1,21,4,3,68,24,44,67
N'castle Jet,5263,2,16,5,7,59,37,22,53
Melbourne C,5263,3,14,4,11,43,35,8,46
Melbourne V,5263,4,13,5,11,47,42,5,44
Adelaide Utd,5263,5,11,6,11,37,40,-3,39
Brisbane,5263,6,10,5,13,33,42,-9,35
Western Sydn,5263,7,8,9,10,38,47,-9,33
Perth Glory,5263,8,10,2,15,37,50,-13,32
Wellington P,5263,9,5,6,16,31,55,-24,21
CC Mariners,5263,10,4,8,15,28,49,-21,20
Sydney FC,5264,1,21,4,3,67,24,43,67
N'castle Jet,5264,2,16,5,7,60,37,23,53
Melbourne C,5264,3,14,4,11,43,36,7,46
Melbourne V,5264,4,13,5,11,47,41,6,44
Adelaide Utd,5264,5,11,6,11,37,40,-3,39
Brisbane,5264,6,10,5,13,33,42,-9,35
Western Sydn,5264,7,8,9,10,38,47,-9,33
Perth Glory,5264,8,10,2,15,37,50,-13,32
Wellington P,5264,9,5,6,16,31,55,-24,21
CC Mariners,5264,10,4,8,15,28,49,-21,20
Sydney FC,5265,1,20,4,4,66,25,41,64
N'castle Jet,5265,2,15,5,8,57,40,17,50
Melbourne C,5265,3,15,4,10,46,33,13,49
Melbourne V,5265,4,14,5,10,48,40,8,47
Adelaide Utd,5265,5,11,6,11,37,40,-3,39
Brisbane,5265,6,10,5,13,33,42,-9,35
Western Sydn,5265,7,8,9,10,38,47,-9,33
Perth Glory,5265,8,10,2,15,37,50,-13,32
Wellington P,5265,9,5,6,16,31,55,-24,21
CC Mariners,5265,10,4,8,15,28,49,-21,20
Sydney FC,5266,1,20,4,4,65,25,40,64
N'castle Jet,5266,2,15,6,7,58,38,20,51
Melbourne C,5266,3,14,5,10,44,34,10,47
Melbourne V,5266,4,14,5,10,48,39,9,47
Adelaide Utd,5266,5,11,6,11,37,40,-3,39
Brisbane,5266,6,10,5,13,33,42,-9,35
Western Sydn,5266,7,8,9,10,38,47,-9,33
Perth Glory,5266,8,10,2,15,37,50,-13,32
Wellington P,5266,9,5,6,16,31,55,-24,21
CC Mariners,5266,10,4,8,15,28,49,-21,20
Sydney FC,5267,1,20,4,4,65,25,40,64
N'castle Jet,5267,2,15,5,8,57,39,18,50
Melbourne C,5267,3,15,4,10,45,33,12,49
Melbourne V,5267,4,14,5,10,48,39,9,47
Adelaide Utd,5267,5,11,6,11,37,40,-3,39
Brisbane,5267,6,10,5,13,33,42,-9,35
Western Sydn,5267,7,8,9,10,38,47,-9,33
Perth Glory,5267,8,10,2,15,37,50,-13,32
Wellington P,5267,9,5,6,16,31,55,-24,21
CC Mariners,5267,10,4,8,15,28,49,-21,20
Sydney FC,5268,1,20,5,3,64,22,42,65
N'castle Jet,5268,2,16,5,7,62,38,24,53
Melbourne C,5268,3,14,4,11,44,38,6,46
Melbourne V,5268,4,13,6,10,45,38,7,45
Adelaide Utd,5268,5,11,6,11,37,40,-3,39
Brisbane,5268,6,10,5,13,33,42,-9,35
Western Sydn,5268,7,8,9,10,38,47,-9,33
Perth Glory,5268,8,10,2,15,37,50,-13,32
Wellington P,5268,9,5,6,16,31,55,-24,21
CC Mariners,5268,10,4,8,15,28,49,-21,20
Sydney FC,5269,1,21,4,3,67,22,45,67
N'castle Jet,5269,2,15,5,8,58,41,17,50
Melbourne C,5269,3,15,4,10,47,34,13,49
Melbourne V,5269,4,13,5,11,45,41,4,44
Adelaide Utd,5269,5,11,6,11,37,40,-3,39
Brisbane,5269,6,10,5,13,33,42,-9,35
Western Sydn,5269,7,8,9,10,38,47,-9,33
Perth Glory,5269,8,10,2,15,37,50,-13,32
Wellington P,5269,9,5,6,16,31,55,-24,21
CC Mariners,5269,10,4,8,15,28,49,-21,20
Sydney FC,5270,1,20,5,3,66,24,42,65
N'castle Jet,5270,2,15,6,7,58,38,20,51
Melbourne C,5270,3,14,5,10,44,34,10,47
Melbourne V,5270,4,13,6,10,47,40,7,45
Adelaide Utd,5270,5,11,6,11,37,40,-3,39
Brisbane,5270,6,10,5,13,33,42,-9,35
Western Sydn,5270,7,8,9,10,38,47,-9,33
Perth Glory,5270,8,10,2,15,37,50,-13,32
Wellington P,5270,9,5,6,16,31,55,-24,21
CC Mariners,5270,10,4,8,15,28,49,-21,20
Sydney FC,5271,1,21,4,3,66,23,43,67
N'castle Jet,5271,2,15,5,8,59,40,19,50
Melbourne C,5271,3,15,4,10,46,35,11,49
Melbourne V,5271,4,13,5,11,46,40,6,44
Adelaide Utd,5271,5,11,6,11,37,40,-3,39
Brisbane,5271,6,10,5,13,33,42,-9,35
Western Sydn,5271,7,8,9,10,38,47,-9,33
Perth Glory,5271,8,10,2,15,37,50,-13,32
Wellington P,5271,9,5,6,16,31,55,-24,21
CC Mariners,5271,10,4,8,15,28,49,-21,20
Sydney FC,5272,1,21,4,3,67,23,44,67
N'castle Jet,5272,2,15,5,8,59,41,18,50
Melbourne C,5272,3,15,4,10,47,35,12,49
Melbourne V,5272,4,13,5,11,46,41,5,44
Adelaide Utd,5272,5,11,6,11,37,40,-3,39
Brisbane,5272,6,10,5,13,33,42,-9,35
Western Sydn,5272,7,8,9,10,38,47,-9,33
Perth Glory,5272,8,10,2,15,37,50,-13,32
Wellington P,5272,9,5,6,16,31,55,-24,21
CC Mariners,5272,10,4,8,15,28,49,-21,20
Sydney FC,5273,1,21,4,3,66,22,44,67
N'castle Jet,5273,2,15,5,8,58,39,19,50
Melbourne C,5273,3,15,4,10,45,34,11,49
Melbourne V,5273,4,13,5,11,45,40,5,44
Adelaide Utd,5273,5,11,6,11,37,40,-3,39
Brisbane,5273,6,10,5,13,33,42,-9,35
Western Sydn,5273,7,8,9,10,38,47,-9,33
Perth Glory,5273,8,10,2,15,37,50,-13,32
Wellington P,5273,9,5,6,16,31,55,-24,21
CC Mariners,5273,10,4,8,15,28,49,-21,20
Sydney FC,5274,1,21,4,3,69,23,46,67
N'castle Jet,5274,2,15,5,8,58,39,19,50
Melbourne C,5274,3,15,4,10,45,34,11,49
Melbourne V,5274,4,13,5,11,46,43,3,44
Adelaide Utd,5274,5,11,6,11,37,40,-3,39
Brisbane,5274,6,10,5,13,33,42,-9,35
Western Sydn,5274,7,8,9,10,38,47,-9,33
Perth Glory,5274,8,10,2,15,37,50,-13,32
Wellington P,5274,9,5,6,16,31,55,-24,21
CC Mariners,5274,10,4,8,15,28,49,-21,20
Sydney FC,5275,1,21,4,3,66,23,43,67
N'castle Jet,5275,2,16,5,7,58,37,21,53
Melbourne C,5275,3,14,4,11,43,34,9,46
Melbourne V,5275,4,13,5,11,46,40,6,44
Adelaide Utd,5275,5,11,6,11,37,40,-3,39
Brisbane,5275,6,10,5,13,33,42,-9,35
Western Sydn,5275,7,8,9,10,38,47,-9,33
Perth Glory,5275,8,10,2,15,37,50,-13,32
Wellington P,5275,9,5,6,16,31,55,-24,21
CC Mariners,5275,10,4,8,15,28,49,-21,20
Sydney FC,5276,1,20,5,3,66,24,42,65
N'castle Jet,5276,2,15,5,8,58,39,19,50
Melbourne C,5276,3,15,4,10,45,34,11,49
Melbourne V,5276,4,13,6,10,47,40,7,45
Adelaide Utd,5276,5,11,6,11,37,40,-3,39
Brisbane,5276,6,10,5,13,33,42,-9,35
Western Sydn,5276,7,8,9,10,38,47,-9,33
Perth Glory,5276,8,10,2,15,37,50,-13,32
Wellington P,5276,9,5,6,16,31,55,-24,21
CC Mariners,5276,10,4,8,15,28,49,-21,20
Sydney FC,5277,1,21,4,3,68,23,45,67
N'castle Jet,5277,2,16,5,7,59,37,22,53
Melbourne C,5277,3,14,4,11,43,35,8,46
Melbourne V,5277,4,13,5,11,46,42,4,44
Adelaide Utd,5277,5,11,6,11,37,40,-3,39
Brisbane,5277,6,10,5,13,33,42,-9,35
Western Sydn,5277,7,8,9,10,38,47,-9,33
Perth Glory,5277,8,10,2,15,37,50,-13,32
Wellington P,5277,9,5,6,16,31,55,-24,21
CC Mariners,5277,10,4,8,15,28,49,-21,20
Sydney FC,5278,1,21,4,3,65,22,43,67
N'castle Jet,5278,2,15,5,8,58,39,19,50
Melbourne C,5278,3,15,4,10,45,34,11,49
Melbourne V,5278,4,13,5,11,45,39,6,44
Adelaide Utd,5278,5,11,6,11,37,40,-3,39
Brisbane,5278,6,10,5,13,33,42,-9,35
Western Sydn,5278,7,8,9,10,38,47,-9,33
Perth Glory,5278,8,10,2,15,37,50,-13,32
Wellington P,5278,9,5,6,16,31,55,-24,21
CC Mariners,5278,10,4,8,15,28,49,-21,20
Sydney FC,5279,1,20,4,4,64,23,41,64
N'castle Jet,5279,2,16,5,7,58,37,21,53
Melbourne V,5279,3,14,5,10,46,38,8,47
Melbourne C,5279,4,14,4,11,43,34,9,46
Adelaide Utd,5279,5,11,6,11,37,40,-3,39
Brisbane,5279,6,10,5,13,33,42,-9,35
Western Sydn,5279,7,8,9,10,38,47,-9,33
Perth Glory,5279,8,10,2,15,37,50,-13,32
Wellington P,5279,9,5,6,16,31,55,-24,21
CC Mariners,5279,10,4,8,15,28,49,-21,20
Sydney FC,5280,1,21,4,3,65,22,43,67
N'castle Jet,5280,2,16,5,7,61,38,23,53
Melbourne C,5280,3,14,4,11,44,37,7,46
Melbourne V,5280,4,13,5,11,45,39,6,44
Adelaide Utd,5280,5,11,6,11,37,40,-3,39
Brisbane,5280,6,10,5,13,33,42,-9,35
Western Sydn,5280,7,8,9,10,38,47,-9,33
Perth Glory,5280,8,10,2,15,37,50,-13,32
Wellington P,5280,9,5,6,16,31,55,-24,21
CC Mariners,5280,10,4,8,15,28,49,-21,20
Sydney FC,5281,1,21,4,3,66,23,43,67
N'castle Jet,5281,2,15,6,7,58,38,20,51
Melbourne C,5281,3,14,5,10,44,34,10,47
Melbourne V,5281,4,13,5,11,46,40,6,44
Adelaide Utd,5281,5,11,6,11,37,40,-3,39
Brisbane,5281,6,10,5,13,33,42,-9,35
Western Sydn,5281,7,8,9,10,38,47,-9,33
Perth Glory,5281,8,10,2,15,37,50,-13,32
Wellington P,5281,9,5,6,16,31,55,-24,21
CC Mariners,5281,10,4,8,15,28,49,-21,20
Sydney FC,5282,1,21,4,3,65,22,43,67
N'castle Jet,5282,2,15,6,7,58,38,20,51
Melbourne C,5282,3,14,5,10,44,34,10,47
Melbourne V,5282,4,13,5,11,45,39,6,44
Adelaide Utd,5282,5,11,6,11,37,40,-3,39
Brisbane,5282,6,10,5,13,33,42,-9,35
Western Sydn,5282,7,8,9,10,38,47,-9,33
Perth Glory,5282,8,10,2,15,37,50,-13,32
Wellington P,5282,9,5,6,16,31,55,-24,21
CC Mariners,5282,10,4,8,15,28,49,-21,20
Sydney FC,5283,1,21,4,3,66,23,43,67
N'castle Jet,5283,2,15,5,8,57,38,19,50
Melbourne C,5283,3,15,4,10,44,33,11,49
Melbourne V,5283,4,13,5,11,46,40,6,44
Adelaide Utd,5283,5,11,6,11,37,40,-3,39
Brisbane,5283,6,10,5,13,33,42,-9,35
Western Sydn,5283,7,8,9,10,38,47,-9,33
Perth Glory,5283,8,10,2,15,37,50,-13,32
Wellington P,5283,9,5,6,16,31,55,-24,21
CC Mariners,5283,10,4,8,15,28,49,-21,20
Sydney FC,5284,1,21,4,3,68,24,44,67
N'castle Jet,5284,2,15,5,8,58,40,18,50
Melbourne C,5284,3,15,4,10,46,34,12,49
Melbourne V,5284,4,13,5,11,47,42,5,44
Adelaide Utd,5284,5,11,6,11,37,40,-3,39
Brisbane,5284,6,10,5,13,33,42,-9,35
Western Sydn,5284,7,8,9,10,38,47,-9,33
Perth Glory,5284,8,10,2,15,37,50,-13,32
Wellington P,5284,9,5,6,16,31,55,-24,21
CC Mariners,5284,10,4,8,15,28,49,-21,20
Sydney FC,5285,1,21,4,3,66,22,44,67
N'castle Jet,5285,2,15,6,7,58,38,20,51
Melbourne C,5285,3,14,5,10,44,34,10,47
Melbourne V,5285,4,13,5,11,45,40,5,44
Adelaide Utd,5285,5,11,6,11,37,40,-3,39
Brisbane,5285,6,10,5,13,33,42,-9,35
Western Sydn,5285,7,8,9,10,38,47,-9,33
Perth Glory,5285,8,10,2,15,37,50,-13,32
Wellington P,5285,9,5,6,16,31,55,-24,21
CC Mariners,5285,10,4,8,15,28,49,-21,20
Sydney FC,5286,1,21,4,3,66,23,43,67
N'castle Jet,5286,2,16,5,7,58,37,21,53
Melbourne C,5286,3,14,4,11,43,34,9,46
Melbourne V,5286,4,13,5,11,46,40,6,44
Adelaide Utd,5286,5,11,6,11,37,40,-3,39
Brisbane,5286,6,10,5,13,33,42,-9,35
Western Sydn,5286,7,8,9,10,38,47,-9,33
Perth Glory,5286,8,10,2,15,37,50,-13,32
Wellington P,5286,9,5,6,16,31,55,-24,21
CC Mariners,5286,10,4,8,15,28,49,-21,20
Sydney FC,5287,1,20,4,4,65,24,41,64
N'castle Jet,5287,2,15,6,7,57,37,20,51
Melbourne C,5287,3,14,5,10,43,33,10,47
Melbourne V,5287,4,14,5,10,47,39,8,47
Adelaide Utd,5287,5,11,6,11,37,40,-3,39
Brisbane,5287,6,10,5,13,33,42,-9,35
Western Sydn,5287,7,8,9,10,38,47,-9,33
Perth Glory,5287,8,10,2,15,37,50,-13,32
Wellington P,5287,9,5,6,16,31,55,-24,21
CC Mariners,5287,10,4,8,15,28,49,-21,20
Sydney FC,5288,1,21,4,3,66,23,43,67
N'castle Jet,5288,2,16,5,7,60,39,21,53
Melbourne C,5288,3,14,4,11,45,36,9,46
Melbourne V,5288,4,13,5,11,46,40,6,44
Adelaide Utd,5288,5,11,6,11,37,40,-3,39
Brisbane,5288,6,10,5,13,33,42,-9,35
Western Sydn,5288,7,8,9,10,38,47,-9,33
Perth Glory,5288,8,10,2,15,37,50,-13,32
Wellington P,5288,9,5,6,16,31,55,-24,21
CC Mariners,5288,10,4,8,15,28,49,-21,20
Sydney FC,5289,1,20,5,3,65,23,42,65
N'castle Jet,5289,2,15,5,8,57,38,19,50
Melbourne C,5289,3,15,4,10,44,33,11,49
Melbourne V,5289,4,13,6,10,46,39,7,45
Adelaide Utd,5289,5,11,6,11,37,40,-3,39
Brisbane,5289,6,10,5,13,33,42,-9,35
Western Sydn,5289,7,8,9,10,38,47,-9,33
Perth Glory,5289,8,10,2,15,37,50,-13,32
Wellington P,5289,9,5,6,16,31,55,-24,21
CC Mariners,5289,10,4,8,15,28,49,-21,20
Sydney FC,5290,1,21,4,3,71,22,49,67
N'castle Jet,5290,2,16,5,7,58,37,21,53
Melbourne C,5290,3,14,4,11,43,34,9,46
Melbourne V,5290,4,13,5,11,45,45,0,44
Adelaide Utd,5290,5,11,6,11,37,40,-3,39
Brisbane,5290,6,10,5,13,33,42,-9,35
Western Sydn,5290,7,8,9,10,38,47,-9,33
Perth Glory,5290,8,10,2,15,37,50,-13,32
Wellington P,5290,9,5,6,16,31,55,-24,21
CC Mariners,5290,10,4,8,15,28,49,-21,20
Sydney FC,5291,1,21,4,3,69,22,47,67
N'castle Jet,5291,2,16,5,7,59,37,22,53
Melbourne C,5291,3,14,4,11,43,35,8,46
Melbourne V,5291,4,13,5,11,45,43,2,44
Adelaide Utd,5291,5,11,6,11,37,40,-3,39
Brisbane,5291,6,10,5,13,33,42,-9,35
Western Sydn,5291,7,8,9,10,38,47,-9,33
Perth Glory,5291,8,10,2,15,37,50,-13,32
Wellington P,5291,9,5,6,16,31,55,-24,21
CC Mariners,5291,10,4,8,15,28,49,-21,20
Sydney FC,5292,1,21,4,3,65,22,43,67
N'castle Jet,5292,2,15,5,8,58,39,19,50
Melbourne C,5292,3,15,4,10,45,34,11,49
Melbourne V,5292,4,13,5,11,45,39,6,44
Adelaide Utd,5292,5,11,6,11,37,40,-3,39
Brisbane,5292,6,10,5,13,33,42,-9,35
Western Sydn,5292,7,8,9,10,38,47,-9,33
Perth Glory,5292,8,10,2,15,37,50,-13,32
Wellington P,5292,9,5,6,16,31,55,-24,21
CC Mariners,5292,10,4,8,15,28,49,-21,20
Sydney FC,5293,1,20,4,4,66,25,41,64
N'castle Jet,5293,2,16,5,7,58,37,21,53
Melbourne V,5293,3,14,5,10,48,40,8,47
Melbourne C,5293,4,14,4,11,43,34,9,46
Adelaide Utd,5293,5,11,6,11,37,40,-3,39
Brisbane,5293,6,10,5,13,33,42,-9,35
Western Sydn,5293,7,8,9,10,38,47,-9,33
Perth Glory,5293,8,10,2,15,37,50,-13,32
Wellington P,5293,9,5,6,16,31,55,-24,21
CC Mariners,5293,10,4,8,15,28,49,-21,20
Sydney FC,5294,1,21,4,3,67,23,44,67
N'castle Jet,5294,2,16,5,7,61,37,24,53
Melbourne C,5294,3,14,4,11,43,37,6,46
Melbourne V,5294,4,13,5,11,46,41,5,44
Adelaide Utd,5294,5,11,6,11,37,40,-3,39
Brisbane,5294,6,10,5,13,33,42,-9,35
Western Sydn,5294,7,8,9,10,38,47,-9,33
Perth Glory,5294,8,10,2,15,37,50,-13,32
Wellington P,5294,9,5,6,16,31,55,-24,21
CC Mariners,5294,10,4,8,15,28,49,-21,20
Sydney FC,5295,1,20,4,4,64,23,41,64
N'castle Jet,5295,2,15,6,7,58,38,20,51
Melbourne C,5295,3,14,5,10,44,34,10,47
Melbourne V,5295,4,14,5,10,46,38,8,47
Adelaide Utd,5295,5,11,6,11,37,40,-3,39
Brisbane,5295,6,10,5,13,33,42,-9,35
Western Sydn,5295,7,8,9,10,38,47,-9,33
Perth Glory,5295,8,10,2,15,37,50,-13,32
Wellington P,5295,9,5,6,16,31,55,-24,21
CC Mariners,5295,10,4,8,15,28,49,-21,20
Sydney FC,5296,1,21,4,3,66,23,43,67
N'castle Jet,5296,2,15,6,7,60,40,20,51
Melbourne C,5296,3,14,5,10,46,36,10,47
Melbourne V,5296,4,13,5,11,46,40,6,44
Adelaide Utd,5296,5,11,6,11,37,40,-3,39
Brisbane,5296,6,10,5,13,33,42,-9,35
Western Sydn,5296,7,8,9,10,38,47,-9,33
Perth Glory,5296,8,10,2,15,37,50,-13,32
Wellington P,5296,9,5,6,16,31,55,-24,21
CC Mariners,5296,10,4,8,15,28,49,-21,20
Sydney FC,5297,1,21,4,3,66,22,44,67
N'castle Jet,5297,2,15,6,7,57,37,20,51
Melbourne C,5297,3,14,5,10,43,33,10,47
Melbourne V,5297,4,13,5,11,45,40,5,44
Adelaide Utd,5297,5,11,6,11,37,40,-3,39
Brisbane,5297,6,10,5,13,33,42,-9,35
Western Sydn,5297,7,8,9,10,38,47,-9,33
Perth Glory,5297,8,10,2,15,37,50,-13,32
Wellington P,5297,9,5,6,16,31,55,-24,21
CC Mariners,5297,10,4,8,15,28,49,-21,20
Sydney FC,5298,1,21,4,3,67,22,45,67
N'castle Jet,5298,2,15,5,8,57,38,19,50
Melbourne C,5298,3,15,4,10,44,33,11,49
Melbourne V,5298,4,13,5,11,45,41,4,44
Adelaide Utd,5298,5,11,6,11,37,40,-3,39
Brisbane,5298,6,10,5,13,33,42,-9,35
Western Sydn,5298,7,8,9,10,38,47,-9,33
Perth Glory,5298,8,10,2,15,37,50,-13,32
Wellington P,5298,9,5,6,16,31,55,-24,21
CC Mariners,5298,10,4,8,15,28,49,-21,20
Sydney FC,5299,1,21,4,3,71,22,49,67
N'castle Jet,5299,2,16,5,7,60,37,23,53
Melbourne C,5299,3,14,4,11,43,36,7,46
Melbourne V,5299,4,13,5,11,45,45,0,44
Adelaide Utd,5299,5,11,6,11,37,40,-3,39
Brisbane,5299,6,10,5,13,33,42,-9,35
Western Sydn,5299,7,8,9,10,38,47,-9,33
Perth Glory,5299,8,10,2,15,37,50,-13,32
Wellington P,5299,9,5,6,16,31,55,-24,21
CC Mariners,5299,10,4,8,15,28,49,-21,20
Sydney FC,5300,1,21,4,3,65,22,43,67
N'castle Jet,5300,2,15,5,8,58,39,19,50
Melbourne C,5300,3,15,4,10,45,34,11,49
Melbourne V,5300,4,13,5,11,45,39,6,44
Adelaide Utd,5300,5,11,6,11,37,40,-3,39
Brisbane,5300,6,10,5,13,33,42,-9,35
Western Sydn,5300,7,8,9,10,38,47,-9,33
Perth Glory,5300,8,10,2,15,37,50,-13,32
Wellington P,5300,9,5,6,16,31,55,-24,21
CC Mariners,5300,10,4,8,15,28,49,-21,20
Sydney FC,5301,1,20,4,4,66,25,41,64
N'castle Jet,5301,2,15,5,8,57,38,19,50
Melbourne C,5301,3,15,4,10,44,33,11,49
Melbourne V,5301,4,14,5,10,48,40,8,47
Adelaide Utd,5301,5,11,6,11,37,40,-3,39
Brisbane,5301,6,10,5,13,33,42,-9,35
Western Sydn,5301,7,8,9,10,38,47,-9,33
Perth Glory,5301,8,10,2,15,37,50,-13,32
Wellington P,5301,9,5,6,16,31,55,-24,21
CC Mariners,5301,10,4,8,15,28,49,-21,20
Sydney FC,5302,1,21,4,3,72,24,48,67
N'castle Jet,5302,2,16,5,7,60,38,22,53
Melbourne C,5302,3,14,4,11,44,36,8,46
Melbourne V,5302,4,13,5,11,47,46,1,44
Adelaide Utd,5302,5,11,6,11,37,40,-3,39
Brisbane,5302,6,10,5,13,33,42,-9,35
Western Sydn,5302,7,8,9,10,38,47,-9,33
Perth Glory,5302,8,10,2,15,37,50,-13,32
Wellington P,5302,9,5,6,16,31,55,-24,21
CC Mariners,5302,10,4,8,15,28,49,-21,20
Sydney FC,5303,1,20,5,3,65,23,42,65
N'castle Jet,5303,2,15,6,7,58,38,20,51
Melbourne C,5303,3,14,5,10,44,34,10,47
Melbourne V,5303,4,13,6,10,46,39,7,45
Adelaide Utd,5303,5,11,6,11,37,40,-3,39
Brisbane,5303,6,10,5,13,33,42,-9,35
Western Sydn,5303,7,8,9,10,38,47,-9,33
Perth Glory,5303,8,10,2,15,37,50,-13,32
Wellington P,5303,9,5,6,16,31,55,-24,21
CC Mariners,5303,10,4,8,15,28,49,-21,20
Sydney FC,5304,1,21,4,3,66,22,44,67
N'castle Jet,5304,2,16,5,7,60,38,22,53
Melbourne C,5304,3,14,4,11,44,36,8,46
Melbourne V,5304,4,13,5,11,45,40,5,44
Adelaide Utd,5304,5,11,6,11,37,40,-3,39
Brisbane,5304,6,10,5,13,33,42,-9,35
Western Sydn,5304,7,8,9,10,38,47,-9,33
Perth Glory,5304,8,10,2,15,37,50,-13,32
Wellington P,5304,9,5,6,16,31,55,-24,21
CC Mariners,5304,10,4,8,15,28,49,-21,20
Sydney FC,5305,1,21,4,3,69,24,45,67
N'castle Jet,5305,2,15,6,7,59,39,20,51
Melbourne C,5305,3,14,5,10,45,35,10,47
Melbourne V,5305,4,13,5,11,47,43,4,44
Adelaide Utd,5305,5,11,6,11,37,40,-3,39
Brisbane,5305,6,10,5,13,33,42,-9,35
Western Sydn,5305,7,8,9,10,38,47,-9,33
Perth Glory,5305,8,10,2,15,37,50,-13,32
Wellington P,5305,9,5,6,16,31,55,-24,21
CC Mariners,5305,10,4,8,15,28,49,-21,20
Sydney FC,5306,1,21,4,3,67,23,44,67
N'castle Jet,5306,2,15,5,8,57,40,17,50
Melbourne C,5306,3,15,4,10,46,33,13,49
Melbourne V,5306,4,13,5,11,46,41,5,44
Adelaide Utd,5306,5,11,6,11,37,40,-3,39
Brisbane,5306,6,10,5,13,33,42,-9,35
Western Sydn,5306,7,8,9,10,38,47,-9,33
Perth Glory,5306,8,10,2,15,37,50,-13,32
Wellington P,5306,9,5,6,16,31,55,-24,21
CC Mariners,5306,10,4,8,15,28,49,-21,20
Sydney FC,5307,1,21,4,3,67,22,45,67
N'castle Jet,5307,2,16,5,7,59,37,22,53
Melbourne C,5307,3,14,4,11,43,35,8,46
Melbourne V,5307,4,13,5,11,45,41,4,44
Adelaide Utd,5307,5,11,6,11,37,40,-3,39
Brisbane,5307,6,10,5,13,33,42,-9,35
Western Sydn,5307,7,8,9,10,38,47,-9,33
Perth Glory,5307,8,10,2,15,37,50,-13,32
Wellington P,5307,9,5,6,16,31,55,-24,21
CC Mariners,5307,10,4,8,15,28,49,-21,20
Sydney FC,5308,1,20,4,4,65,27,38,64
N'castle Jet,5308,2,15,5,8,57,41,16,50
Melbourne C,5308,3,15,4,10,47,33,14,49
Melbourne V,5308,4,14,5,10,50,39,11,47
Adelaide Utd,5308,5,11,6,11,37,40,-3,39
Brisbane,5308,6,10,5,13,33,42,-9,35
Western Sydn,5308,7,8,9,10,38,47,-9,33
Perth Glory,5308,8,10,2,15,37,50,-13,32
Wellington P,5308,9,5,6,16,31,55,-24,21
CC Mariners,5308,10,4,8,15,28,49,-21,20
Sydney FC,5309,1,21,4,3,68,22,46,67
N'castle Jet,5309,2,15,5,8,58,40,18,50
Melbourne C,5309,3,15,4,10,46,34,12,49
Melbourne V,5309,4,13,5,11,45,42,3,44
Adelaide Utd,5309,5,11,6,11,37,40,-3,39
Brisbane,5309,6,10,5,13,33,42,-9,35
Western Sydn,5309,7,8,9,10,38,47,-9,33
Perth Glory,5309,8,10,2,15,37,50,-13,32
Wellington P,5309,9,5,6,16,31,55,-24,21
CC Mariners,5309,10,4,8,15,28,49,-21,20
Sydney FC,5310,1,21,4,3,68,23,45,67
N'castle Jet,5310,2,16,5,7,58,37,21,53
Melbourne C,5310,3,14,4,11,43,34,9,46
Melbourne V,5310,4,13,5,11,46,42,4,44
Adelaide Utd,5310,5,11,6,11,37,40,-3,39
Brisbane,5310,6,10,5,13,33,42,-9,35
Western Sydn,5310,7,8,9,10,38,47,-9,33
Perth Glory,5310,8,10,2,15,37,50,-13,32
Wellington P,5310,9,5,6,16,31,55,-24,21
CC Mariners,5310,10,4,8,15,28,49,-21,20
Sydney FC,5311,1,21,4,3,67,23,44,67
N'castle Jet,5311,2,15,6,7,59,39,20,51
Melbourne C,5311,3,14,5,10,45,35,10,47
Melbourne V,5311,4,13,5,11,46,41,5,44
Adelaide Utd,5311,5,11,6,11,37,40,-3,39
Brisbane,5311,6,10,5,13,33,42,-9,35
Western Sydn,5311,7,8,9,10,38,47,-9,33
Perth Glory,5311,8,10,2,15,37,50,-13,32
Wellington P,5311,9,5,6,16,31,55,-24,21
CC Mariners,5311,10,4,8,15,28,49,-21,20
Sydney FC,5312,1,20,4,4,65,24,41,64
N'castle Jet,5312,2,16,5,7,59,37,22,53
Melbourne V,5312,3,14,5,10,47,39,8,47
Melbourne C,5312,4,14,4,11,43,35,8,46
Adelaide Utd,5312,5,11,6,11,37,40,-3,39
Brisbane,5312,6,10,5,13,33,42,-9,35
Western Sydn,5312,7,8,9,10,38,47,-9,33
Perth Glory,5312,8,10,2,15,37,50,-13,32
Wellington P,5312,9,5,6,16,31,55,-24,21
CC Mariners,5312,10,4,8,15,28,49,-21,20
Sydney FC,5313,1,20,5,3,65,23,42,65
N'castle Jet,5313,2,15,6,7,57,37,20,51
Melbourne C,5313,3,14,5,10,43,33,10,47
Melbourne V,5313,4,13,6,10,46,39,7,45
Adelaide Utd,5313,5,11,6,11,37,40,-3,39
Brisbane,5313,6,10,5,13,33,42,-9,35
Western Sydn,5313,7,8,9,10,38,47,-9,33
Perth Glory,5313,8,10,2,15,37,50,-13,32
Wellington P,5313,9,5,6,16,31,55,-24,21
CC Mariners,5313,10,4,8,15,28,49,-21,20
Sydney FC,5314,1,20,5,3,66,24,42,65
N'castle Jet,5314,2,16,5,7,59,37,22,53
Melbourne C,5314,3,14,4,11,43,35,8,46
Melbourne V,5314,4,13,6,10,47,40,7,45
Adelaide Utd,5314,5,11,6,11,37,40,-3,39
Brisbane,5314,6,10,5,13,33,42,-9,35
Western Sydn,5314,7,8,9,10,38,47,-9,33
Perth Glory,5314,8,10,2,15,37,50,-13,32
Wellington P,5314,9,5,6,16,31,55,-24,21
CC Mariners,5314,10,4,8,15,28,49,-21,20
Sydney FC,5315,1,21,4,3,68,24,44,67
N'castle Jet,5315,2,16,5,7,61,38,23,53
Melbourne C,5315,3,14,4,11,44,37,7,46
Melbourne V,5315,4,13,5,11,47,42,5,44
Adelaide Utd,5315,5,11,6,11,37,40,-3,39
Brisbane,5315,6,10,5,13,33,42,-9,35
Western Sydn,5315,7,8,9,10,38,47,-9,33
Perth Glory,5315,8,10,2,15,37,50,-13,32
Wellington P,5315,9,5,6,16,31,55,-24,21
CC Mariners,5315,10,4,8,15,28,49,-21,20
Sydney FC,5316,1,21,4,3,66,22,44,67
N'castle Jet,5316,2,15,6,7,57,37,20,51
Melbourne C,5316,3,14,5,10,43,33,10,47
Melbourne V,5316,4,13,5,11,45,40,5,44
Adelaide Utd,5316,5,11,6,11,37,40,-3,39
Brisbane,5316,6,10,5,13,33,42,-9,35
Western Sydn,5316,7,8,9,10,38,47,-9,33
Perth Glory,5316,8,10,2,15,37,50,-13,32
Wellington P,5316,9,5,6,16,31,55,-24,21
CC Mariners,5316,10,4,8,15,28,49,-21,20
Sydney FC,5317,1,20,5,3,65,23,42,65
N'castle Jet,5317,2,16,5,7,62,40,22,53
Melbourne C,5317,3,14,4,11,46,38,8,46
Melbourne V,5317,4,13,6,10,46,39,7,45
Adelaide Utd,5317,5,11,6,11,37,40,-3,39
Brisbane,5317,6,10,5,13,33,42,-9,35
Western Sydn,5317,7,8,9,10,38,47,-9,33
Perth Glory,5317,8,10,2,15,37,50,-13,32
Wellington P,5317,9,5,6,16,31,55,-24,21
CC Mariners,5317,10,4,8,15,28,49,-21,20
Sydney FC,5318,1,20,4,4,65,24,41,64
N'castle Jet,5318,2,15,5,8,57,39,18,50
Melbourne C,5318,3,15,4,10,45,33,12,49
Melbourne V,5318,4,14,5,10,47,39,8,47
Adelaide Utd,5318,5,11,6,11,37,40,-3,39
Brisbane,5318,6,10,5,13,33,42,-9,35
Western Sydn,5318,7,8,9,10,38,47,-9,33
Perth Glory,5318,8,10,2,15,37,50,-13,32
Wellington P,5318,9,5,6,16,31,55,-24,21
CC Mariners,5318,10,4,8,15,28,49,-21,20
Sydney FC,5319,1,20,5,3,65,23,42,65
N'castle Jet,5319,2,15,6,7,58,38,20,51
Melbourne C,5319,3,14,5,10,44,34,10,47
Melbourne V,5319,4,13,6,10,46,39,7,45
Adelaide Utd,5319,5,11,6,11,37,40,-3,39
Brisbane,5319,6,10,5,13,33,42,-9,35
Western Sydn,5319,7,8,9,10,38,47,-9,33
Perth Glory,5319,8,10,2,15,37,50,-13,32
Wellington P,5319,9,5,6,16,31,55,-24,21
CC Mariners,5319,10,4,8,15,28,49,-21,20
Sydney FC,5320,1,20,4,4,66,25,41,64
N'castle Jet,5320,2,16,5,7,59,37,22,53
Melbourne V,5320,3,14,5,10,48,40,8,47
Melbourne C,5320,4,14,4,11,43,35,8,46
Adelaide Utd,5320,5,11,6,11,37,40,-3,39
Brisbane,5320,6,10,5,13,33,42,-9,35
Western Sydn,5320,7,8,9,10,38,47,-9,33
Perth Glory,5320,8,10,2,15,37,50,-13,32
Wellington P,5320,9,5,6,16,31,55,-24,21
CC Mariners,5320,10,4,8,15,28,49,-21,20
Sydney FC,5321,1,21,4,3,68,23,45,67
N'castle Jet,5321,2,16,5,7,59,37,22,53
Melbourne C,5321,3,14,4,11,43,35,8,46
Melbourne V,5321,4,13,5,11,46,42,4,44
Adelaide Utd,5321,5,11,6,11,37,40,-3,39
Brisbane,5321,6,10,5,13,33,42,-9,35
Western Sydn,5321,7,8,9,10,38,47,-9,33
Perth Glory,5321,8,10,2,15,37,50,-13,32
Wellington P,5321,9,5,6,16,31,55,-24,21
CC Mariners,5321,10,4,8,15,28,49,-21,20
Sydney FC,5322,1,21,4,3,66,23,43,67
N'castle Jet,5322,2,16,5,7,60,38,22,53
Melbourne C,5322,3,14,4,11,44,36,8,46
Melbourne V,5322,4,13,5,11,46,40,6,44
Adelaide Utd,5322,5,11,6,11,37,40,-3,39
Brisbane,5322,6,10,5,13,33,42,-9,35
Western Sydn,5322,7,8,9,10,38,47,-9,33
Perth Glory,5322,8,10,2,15,37,50,-13,32
Wellington P,5322,9,5,6,16,31,55,-24,21
CC Mariners,5322,10,4,8,15,28,49,-21,20
Sydney FC,5323,1,21,4,3,66,23,43,67
N'castle Jet,5323,2,16,5,7,59,38,21,53
Melbourne C,5323,3,14,4,11,44,35,9,46
Melbourne V,5323,4,13,5,11,46,40,6,44
Adelaide Utd,5323,5,11,6,11,37,40,-3,39
Brisbane,5323,6,10,5,13,33,42,-9,35
Western Sydn,5323,7,8,9,10,38,47,-9,33
Perth Glory,5323,8,10,2,15,37,50,-13,32
Wellington P,5323,9,5,6,16,31,55,-24,21
CC Mariners,5323,10,4,8,15,28,49,-21,20
Sydney FC,5324,1,21,4,3,68,23,45,67
N'castle Jet,5324,2,15,5,8,58,39,19,50
Melbourne C,5324,3,15,4,10,45,34,11,49
Melbourne V,5324,4,13,5,11,46,42,4,44
Adelaide Utd,5324,5,11,6,11,37,40,-3,39
Brisbane,5324,6,10,5,13,33,42,-9,35
Western Sydn,5324,7,8,9,10,38,47,-9,33
Perth Glory,5324,8,10,2,15,37,50,-13,32
Wellington P,5324,9,5,6,16,31,55,-24,21
CC Mariners,5324,10,4,8,15,28,49,-21,20
Sydney FC,5325,1,20,4,4,64,25,39,64
N'castle Jet,5325,2,16,5,7,62,37,25,53
Melbourne V,5325,3,14,5,10,48,38,10,47
Melbourne C,5325,4,14,4,11,43,38,5,46
Adelaide Utd,5325,5,11,6,11,37,40,-3,39
Brisbane,5325,6,10,5,13,33,42,-9,35
Western Sydn,5325,7,8,9,10,38,47,-9,33
Perth Glory,5325,8,10,2,15,37,50,-13,32
Wellington P,5325,9,5,6,16,31,55,-24,21
CC Mariners,5325,10,4,8,15,28,49,-21,20
Sydney FC,5326,1,21,4,3,66,22,44,67
N'castle Jet,5326,2,15,5,8,57,39,18,50
Melbourne C,5326,3,15,4,10,45,33,12,49
Melbourne V,5326,4,13,5,11,45,40,5,44
Adelaide Utd,5326,5,11,6,11,37,40,-3,39
Brisbane,5326,6,10,5,13,33,42,-9,35
Western Sydn,5326,7,8,9,10,38,47,-9,33
Perth Glory,5326,8,10,2,15,37,50,-13,32
Wellington P,5326,9,5,6,16,31,55,-24,21
CC Mariners,5326,10,4,8,15,28,49,-21,20
Sydney FC,5327,1,20,5,3,67,25,42,65
N'castle Jet,5327,2,15,5,8,58,39,19,50
Melbourne C,5327,3,15,4,10,45,34,11,49
Melbourne V,5327,4,13,6,10,48,41,7,45
Adelaide Utd,5327,5,11,6,11,37,40,-3,39
Brisbane,5327,6,10,5,13,33,42,-9,35
Western Sydn,5327,7,8,9,10,38,47,-9,33
Perth Glory,5327,8,10,2,15,37,50,-13,32
Wellington P,5327,9,5,6,16,31,55,-24,21
CC Mariners,5327,10,4,8,15,28,49,-21,20
Sydney FC,5328,1,20,5,3,64,22,42,65
N'castle Jet,5328,2,15,5,8,57,38,19,50
Melbourne C,5328,3,15,4,10,44,33,11,49
Melbourne V,5328,4,13,6,10,45,38,7,45
Adelaide Utd,5328,5,11,6,11,37,40,-3,39
Brisbane,5328,6,10,5,13,33,42,-9,35
Western Sydn,5328,7,8,9,10,38,47,-9,33
Perth Glory,5328,8,10,2,15,37,50,-13,32
Wellington P,5328,9,5,6,16,31,55,-24,21
CC Mariners,5328,10,4,8,15,28,49,-21,20
Sydney FC,5329,1,21,4,3,67,22,45,67
N'castle Jet,5329,2,16,5,7,61,37,24,53
Melbourne C,5329,3,14,4,11,43,37,6,46
Melbourne V,5329,4,13,5,11,45,41,4,44
Adelaide Utd,5329,5,11,6,11,37,40,-3,39
Brisbane,5329,6,10,5,13,33,42,-9,35
Western Sydn,5329,7,8,9,10,38,47,-9,33
Perth Glory,5329,8,10,2,15,37,50,-13,32
Wellington P,5329,9,5,6,16,31,55,-24,21
CC Mariners,5329,10,4,8,15,28,49,-21,20
Sydney FC,5330,1,20,4,4,64,23,41,64
N'castle Jet,5330,2,16,5,7,59,38,21,53
Melbourne V,5330,3,14,5,10,46,38,8,47
Melbourne C,5330,4,14,4,11,44,35,9,46
Adelaide Utd,5330,5,11,6,11,37,40,-3,39
Brisbane,5330,6,10,5,13,33,42,-9,35
Western Sydn,5330,7,8,9,10,38,47,-9,33
Perth Glory,5330,8,10,2,15,37,50,-13,32
Wellington P,5330,9,5,6,16,31,55,-24,21
CC Mariners,5330,10,4,8,15,28,49,-21,20
Sydney FC,5331,1,20,5,3,65,23,42,65
N'castle Jet,5331,2,15,6,7,57,37,20,51
Melbourne C,5331,3,14,5,10,43,33,10,47
Melbourne V,5331,4,13,6,10,46,39,7,45
Adelaide Utd,5331,5,11,6,11,37,40,-3,39
Brisbane,5331,6,10,5,13,33,42,-9,35
Western Sydn,5331,7,8,9,10,38,47,-9,33
Perth Glory,5331,8,10,2,15,37,50,-13,32
Wellington P,5331,9,5,6,16,31,55,-24,21
CC Mariners,5331,10,4,8,15,28,49,-21,20
Sydney FC,5332,1,20,4,4,64,25,39,64
N'castle Jet,5332,2,16,5,7,60,37,23,53
Melbourne V,5332,3,14,5,10,48,38,10,47
Melbourne C,5332,4,14,4,11,43,36,7,46
Adelaide Utd,5332,5,11,6,11,37,40,-3,39
Brisbane,5332,6,10,5,13,33,42,-9,35
Western Sydn,5332,7,8,9,10,38,47,-9,33
Perth Glory,5332,8,10,2,15,37,50,-13,32
Wellington P,5332,9,5,6,16,31,55,-24,21
CC Mariners,5332,10,4,8,15,28,49,-21,20
Sydney FC,5333,1,20,4,4,65,24,41,64
N'castle Jet,5333,2,16,5,7,59,38,21,53
Melbourne V,5333,3,14,5,10,47,39,8,47
Melbourne C,5333,4,14,4,11,44,35,9,46
Adelaide Utd,5333,5,11,6,11,37,40,-3,39
Brisbane,5333,6,10,5,13,33,42,-9,35
Western Sydn,5333,7,8,9,10,38,47,-9,33
Perth Glory,5333,8,10,2,15,37,50,-13,32
Wellington P,5333,9,5,6,16,31,55,-24,21
CC Mariners,5333,10,4,8,15,28,49,-21,20
Sydney FC,5334,1,20,4,4,66,25,41,64
N'castle Jet,5334,2,16,5,7,59,37,22,53
Melbourne V,5334,3,14,5,10,48,40,8,47
Melbourne C,5334,4,14,4,11,43,35,8,46
Adelaide Utd,5334,5,11,6,11,37,40,-3,39
Brisbane,5334,6,10,5,13,33,42,-9,35
Western Sydn,5334,7,8,9,10,38,47,-9,33
Perth Glory,5334,8,10,2,15,37,50,-13,32
Wellington P,5334,9,5,6,16,31,55,-24,21
CC Mariners,5334,10,4,8,15,28,49,-21,20
Sydney FC,5335,1,21,4,3,66,22,44,67
N'castle Jet,5335,2,16,5,7,59,37,22,53
Melbourne C,5335,3,14,4,11,43,35,8,46
Melbourne V,5335,4,13,5,11,45,40,5,44
Adelaide Utd,5335,5,11,6,11,37,40,-3,39
Brisbane,5335,6,10,5,13,33,42,-9,35
Western Sydn,5335,7,8,9,10,38,47,-9,33
Perth Glory,5335,8,10,2,15,37,50,-13,32
Wellington P,5335,9,5,6,16,31,55,-24,21
CC Mariners,5335,10,4,8,15,28,49,-21,20
Sydney FC,5336,1,21,4,3,65,22,43,67
N'castle Jet,5336,2,16,5,7,61,37,24,53
Melbourne C,5336,3,14,4,11,43,37,6,46
Melbourne V,5336,4,13,5,11,45,39,6,44
Adelaide Utd,5336,5,11,6,11,37,40,-3,39
Brisbane,5336,6,10,5,13,33,42,-9,35
Western Sydn,5336,7,8,9,10,38,47,-9,33
Perth Glory,5336,8,10,2,15,37,50,-13,32
Wellington P,5336,9,5,6,16,31,55,-24,21
CC Mariners,5336,10,4,8,15,28,49,-21,20
Sydney FC,5337,1,21,4,3,68,23,45,67
N'castle Jet,5337,2,15,5,8,58,39,19,50
Melbourne C,5337,3,15,4,10,45,34,11,49
Melbourne V,5337,4,13,5,11,46,42,4,44
Adelaide Utd,5337,5,11,6,11,37,40,-3,39
Brisbane,5337,6,10,5,13,33,42,-9,35
Western Sydn,5337,7,8,9,10,38,47,-9,33
Perth Glory,5337,8,10,2,15,37,50,-13,32
Wellington P,5337,9,5,6,16,31,55,-24,21
CC Mariners,5337,10,4,8,15,28,49,-21,20
Sydney FC,5338,1,21,4,3,68,23,45,67
N'castle Jet,5338,2,16,5,7,59,38,21,53
Melbourne C,5338,3,14,4,11,44,35,9,46
Melbourne V,5338,4,13,5,11,46,42,4,44
Adelaide Utd,5338,5,11,6,11,37,40,-3,39
Brisbane,5338,6,10,5,13,33,42,-9,35
Western Sydn,5338,7,8,9,10,38,47,-9,33
Perth Glory,5338,8,10,2,15,37,50,-13,32
Wellington P,5338,9,5,6,16,31,55,-24,21
CC Mariners,5338,10,4,8,15,28,49,-21,20
Sydney FC,5339,1,20,4,4,64,24,40,64
N'castle Jet,5339,2,16,5,7,62,38,24,53
Melbourne V,5339,3,14,5,10,47,38,9,47
Melbourne C,5339,4,14,4,11,44,38,6,46
Adelaide Utd,5339,5,11,6,11,37,40,-3,39
Brisbane,5339,6,10,5,13,33,42,-9,35
Western Sydn,5339,7,8,9,10,38,47,-9,33
Perth Glory,5339,8,10,2,15,37,50,-13,32
Wellington P,5339,9,5,6,16,31,55,-24,21
CC Mariners,5339,10,4,8,15,28,49,-21,20
Sydney FC,5340,1,21,4,3,67,22,45,67
N'castle Jet,5340,2,15,5,8,58,39,19,50
Melbourne C,5340,3,15,4,10,45,34,11,49
Melbourne V,5340,4,13,5,11,45,41,4,44
Adelaide Utd,5340,5,11,6,11,37,40,-3,39
Brisbane,5340,6,10,5,13,33,42,-9,35
Western Sydn,5340,7,8,9,10,38,47,-9,33
Perth Glory,5340,8,10,2,15,37,50,-13,32
Wellington P,5340,9,5,6,16,31,55,-24,21
CC Mariners,5340,10,4,8,15,28,49,-21,20
Sydney FC,5341,1,21,4,3,65,22,43,67
N'castle Jet,5341,2,16,5,7,59,37,22,53
Melbourne C,5341,3,14,4,11,43,35,8,46
Melbourne V,5341,4,13,5,11,45,39,6,44
Adelaide Utd,5341,5,11,6,11,37,40,-3,39
Brisbane,5341,6,10,5,13,33,42,-9,35
Western Sydn,5341,7,8,9,10,38,47,-9,33
Perth Glory,5341,8,10,2,15,37,50,-13,32
Wellington P,5341,9,5,6,16,31,55,-24,21
CC Mariners,5341,10,4,8,15,28,49,-21,20
Sydney FC,5342,1,20,4,4,66,25,41,64
N'castle Jet,5342,2,16,5,7,59,38,21,53
Melbourne V,5342,3,14,5,10,48,40,8,47
Melbourne C,5342,4,14,4,11,44,35,9,46
Adelaide Utd,5342,5,11,6,11,37,40,-3,39
Brisbane,5342,6,10,5,13,33,42,-9,35
Western Sydn,5342,7,8,9,10,38,47,-9,33
Perth Glory,5342,8,10,2,15,37,50,-13,32
Wellington P,5342,9,5,6,16,31,55,-24,21
CC Mariners,5342,10,4,8,15,28,49,-21,20
Sydney FC,5343,1,21,4,3,67,22,45,67
N'castle Jet,5343,2,16,5,7,58,37,21,53
Melbourne C,5343,3,14,4,11,43,34,9,46
Melbourne V,5343,4,13,5,11,45,41,4,44
Adelaide Utd,5343,5,11,6,11,37,40,-3,39
Brisbane,5343,6,10,5,13,33,42,-9,35
Western Sydn,5343,7,8,9,10,38,47,-9,33
Perth Glory,5343,8,10,2,15,37,50,-13,32
Wellington P,5343,9,5,6,16,31,55,-24,21
CC Mariners,5343,10,4,8,15,28,49,-21,20
Sydney FC,5344,1,20,5,3,66,24,42,65
N'castle Jet,5344,2,16,5,7,59,38,21,53
Melbourne C,5344,3,14,4,11,44,35,9,46
Melbourne V,5344,4,13,6,10,47,40,7,45
Adelaide Utd,5344,5,11,6,11,37,40,-3,39
Brisbane,5344,6,10,5,13,33,42,-9,35
Western Sydn,5344,7,8,9,10,38,47,-9,33
Perth Glory,5344,8,10,2,15,37,50,-13,32
Wellington P,5344,9,5,6,16,31,55,-24,21
CC Mariners,5344,10,4,8,15,28,49,-21,20
Sydney FC,5345,1,21,4,3,66,22,44,67
N'castle Jet,5345,2,15,5,8,57,39,18,50
Melbourne C,5345,3,15,4,10,45,33,12,49
Melbourne V,5345,4,13,5,11,45,40,5,44
Adelaide Utd,5345,5,11,6,11,37,40,-3,39
Brisbane,5345,6,10,5,13,33,42,-9,35
Western Sydn,5345,7,8,9,10,38,47,-9,33
Perth Glory,5345,8,10,2,15,37,50,-13,32
Wellington P,5345,9,5,6,16,31,55,-24,21
CC Mariners,5345,10,4,8,15,28,49,-21,20
Sydney FC,5346,1,20,5,3,64,22,42,65
N'castle Jet,5346,2,16,5,7,59,37,22,53
Melbourne C,5346,3,14,4,11,43,35,8,46
Melbourne V,5346,4,13,6,10,45,38,7,45
Adelaide Utd,5346,5,11,6,11,37,40,-3,39
Brisbane,5346,6,10,5,13,33,42,-9,35
Western Sydn,5346,7,8,9,10,38,47,-9,33
Perth Glory,5346,8,10,2,15,37,50,-13,32
Wellington P,5346,9,5,6,16,31,55,-24,21
CC Mariners,5346,10,4,8,15,28,49,-21,20
Sydney FC,5347,1,21,4,3,66,22,44,67
N'castle Jet,5347,2,16,5,7,58,37,21,53
Melbourne C,5347,3,14,4,11,43,34,9,46
Melbourne V,5347,4,13,5,11,45,40,5,44
Adelaide Utd,5347,5,11,6,11,37,40,-3,39
Brisbane,5347,6,10,5,13,33,42,-9,35
Western Sydn,5347,7,8,9,10,38,47,-9,33
Perth Glory,5347,8,10,2,15,37,50,-13,32
Wellington P,5347,9,5,6,16,31,55,-24,21
CC Mariners,5347,10,4,8,15,28,49,-21,20
Sydney FC,5348,1,21,4,3,66,22,44,67
N'castle Jet,5348,2,15,5,8,58,39,19,50
Melbourne C,5348,3,15,4,10,45,34,11,49
Melbourne V,5348,4,13,5,11,45,40,5,44
Adelaide Utd,5348,5,11,6,11,37,40,-3,39
Brisbane,5348,6,10,5,13,33,42,-9,35
Western Sydn,5348,7,8,9,10,38,47,-9,33
Perth Glory,5348,8,10,2,15,37,50,-13,32
Wellington P,5348,9,5,6,16,31,55,-24,21
CC Mariners,5348,10,4,8,15,28,49,-21,20
Sydney FC,5349,1,20,5,3,64,22,42,65
N'castle Jet,5349,2,16,5,7,58,37,21,53
Melbourne C,5349,3,14,4,11,43,34,9,46
Melbourne V,5349,4,13,6,10,45,38,7,45
Adelaide Utd,5349,5,11,6,11,37,40,-3,39
Brisbane,5349,6,10,5,13,33,42,-9,35
Western Sydn,5349,7,8,9,10,38,47,-9,33
Perth Glory,5349,8,10,2,15,37,50,-13,32
Wellington P,5349,9,5,6,16,31,55,-24,21
CC Mariners,5349,10,4,8,15,28,49,-21,20
Sydney FC,5350,1,20,4,4,64,23,41,64
N'castle Jet,5350,2,16,5,7,59,38,21,53
Melbourne V,5350,3,14,5,10,46,38,8,47
Melbourne C,5350,4,14,4,11,44,35,9,46
Adelaide Utd,5350,5,11,6,11,37,40,-3,39
Brisbane,5350,6,10,5,13,33,42,-9,35
Western Sydn,5350,7,8,9,10,38,47,-9,33
Perth Glory,5350,8,10,2,15,37,50,-13,32
Wellington P,5350,9,5,6,16,31,55,-24,21
CC Mariners,5350,10,4,8,15,28,49,-21,20
Sydney FC,5351,1,20,4,4,65,28,37,64
N'castle Jet,5351,2,16,5,7,60,39,21,53
Melbourne V,5351,3,14,5,10,51,39,12,47
Melbourne C,5351,4,14,4,11,45,36,9,46
Adelaide Utd,5351,5,11,6,11,37,40,-3,39
Brisbane,5351,6,10,5,13,33,42,-9,35
Western Sydn,5351,7,8,9,10,38,47,-9,33
Perth Glory,5351,8,10,2,15,37,50,-13,32
Wellington P,5351,9,5,6,16,31,55,-24,21
CC Mariners,5351,10,4,8,15,28,49,-21,20
Sydney FC,5352,1,21,4,3,68,24,44,67
N'castle Jet,5352,2,16,5,7,63,38,25,53
Melbourne C,5352,3,14,4,11,44,39,5,46
Melbourne V,5352,4,13,5,11,47,42,5,44
Adelaide Utd,5352,5,11,6,11,37,40,-3,39
Brisbane,5352,6,10,5,13,33,42,-9,35
Western Sydn,5352,7,8,9,10,38,47,-9,33
Perth Glory,5352,8,10,2,15,37,50,-13,32
Wellington P,5352,9,5,6,16,31,55,-24,21
CC Mariners,5352,10,4,8,15,28,49,-21,20
Sydney FC,5353,1,21,4,3,66,22,44,67
N'castle Jet,5353,2,16,5,7,58,37,21,53
Melbourne C,5353,3,14,4,11,43,34,9,46
Melbourne V,5353,4,13,5,11,45,40,5,44
Adelaide Utd,5353,5,11,6,11,37,40,-3,39
Brisbane,5353,6,10,5,13,33,42,-9,35
Western Sydn,5353,7,8,9,10,38,47,-9,33
Perth Glory,5353,8,10,2,15,37,50,-13,32
Wellington P,5353,9,5,6,16,31,55,-24,21
CC Mariners,5353,10,4,8,15,28,49,-21,20
Sydney FC,5354,1,21,4,3,66,23,43,67
N'castle Jet,5354,2,15,5,8,59,40,19,50
Melbourne C,5354,3,15,4,10,46,35,11,49
Melbourne V,5354,4,13,5,11,46,40,6,44
Adelaide Utd,5354,5,11,6,11,37,40,-3,39
Brisbane,5354,6,10,5,13,33,42,-9,35
Western Sydn,5354,7,8,9,10,38,47,-9,33
Perth Glory,5354,8,10,2,15,37,50,-13,32
Wellington P,5354,9,5,6,16,31,55,-24,21
CC Mariners,5354,10,4,8,15,28,49,-21,20
Sydney FC,5355,1,21,4,3,65,22,43,67
N'castle Jet,5355,2,16,5,7,61,38,23,53
Melbourne C,5355,3,14,4,11,44,37,7,46
Melbourne V,5355,4,13,5,11,45,39,6,44
Adelaide Utd,5355,5,11,6,11,37,40,-3,39
Brisbane,5355,6,10,5,13,33,42,-9,35
Western Sydn,5355,7,8,9,10,38,47,-9,33
Perth Glory,5355,8,10,2,15,37,50,-13,32
Wellington P,5355,9,5,6,16,31,55,-24,21
CC Mariners,5355,10,4,8,15,28,49,-21,20
Sydney FC,5356,1,20,4,4,66,27,39,64
N'castle Jet,5356,2,15,5,8,58,39,19,50
Melbourne C,5356,3,15,4,10,45,34,11,49
Melbourne V,5356,4,14,5,10,50,40,10,47
Adelaide Utd,5356,5,11,6,11,37,40,-3,39
Brisbane,5356,6,10,5,13,33,42,-9,35
Western Sydn,5356,7,8,9,10,38,47,-9,33
Perth Glory,5356,8,10,2,15,37,50,-13,32
Wellington P,5356,9,5,6,16,31,55,-24,21
CC Mariners,5356,10,4,8,15,28,49,-21,20
Sydney FC,5357,1,21,4,3,66,22,44,67
N'castle Jet,5357,2,15,5,8,57,39,18,50
Melbourne C,5357,3,15,4,10,45,33,12,49
Melbourne V,5357,4,13,5,11,45,40,5,44
Adelaide Utd,5357,5,11,6,11,37,40,-3,39
Brisbane,5357,6,10,5,13,33,42,-9,35
Western Sydn,5357,7,8,9,10,38,47,-9,33
Perth Glory,5357,8,10,2,15,37,50,-13,32
Wellington P,5357,9,5,6,16,31,55,-24,21
CC Mariners,5357,10,4,8,15,28,49,-21,20
Sydney FC,5358,1,20,5,3,65,23,42,65
N'castle Jet,5358,2,15,5,8,57,38,19,50
Melbourne C,5358,3,15,4,10,44,33,11,49
Melbourne V,5358,4,13,6,10,46,39,7,45
Adelaide Utd,5358,5,11,6,11,37,40,-3,39
Brisbane,5358,6,10,5,13,33,42,-9,35
Western Sydn,5358,7,8,9,10,38,47,-9,33
Perth Glory,5358,8,10,2,15,37,50,-13,32
Wellington P,5358,9,5,6,16,31,55,-24,21
CC Mariners,5358,10,4,8,15,28,49,-21,20
Sydney FC,5359,1,21,4,3,67,22,45,67
N'castle Jet,5359,2,15,6,7,58,38,20,51
Melbourne C,5359,3,14,5,10,44,34,10,47
Melbourne V,5359,4,13,5,11,45,41,4,44
Adelaide Utd,5359,5,11,6,11,37,40,-3,39
Brisbane,5359,6,10,5,13,33,42,-9,35
Western Sydn,5359,7,8,9,10,38,47,-9,33
Perth Glory,5359,8,10,2,15,37,50,-13,32
Wellington P,5359,9,5,6,16,31,55,-24,21
CC Mariners,5359,10,4,8,15,28,49,-21,20
Sydney FC,5360,1,21,4,3,67,23,44,67
N'castle Jet,5360,2,15,6,7,58,38,20,51
Melbourne C,5360,3,14,5,10,44,34,10,47
Melbourne V,5360,4,13,5,11,46,41,5,44
Adelaide Utd,5360,5,11,6,11,37,40,-3,39
Brisbane,5360,6,10,5,13,33,42,-9,35
Western Sydn,5360,7,8,9,10,38,47,-9,33
Perth Glory,5360,8,10,2,15,37,50,-13,32
Wellington P,5360,9,5,6,16,31,55,-24,21
CC Mariners,5360,10,4,8,15,28,49,-21,20
Sydney FC,5361,1,21,4,3,66,23,43,67
N'castle Jet,5361,2,16,5,7,59,38,21,53
Melbourne C,5361,3,14,4,11,44,35,9,46
Melbourne V,5361,4,13,5,11,46,40,6,44
Adelaide Utd,5361,5,11,6,11,37,40,-3,39
Brisbane,5361,6,10,5,13,33,42,-9,35
Western Sydn,5361,7,8,9,10,38,47,-9,33
Perth Glory,5361,8,10,2,15,37,50,-13,32
Wellington P,5361,9,5,6,16,31,55,-24,21
CC Mariners,5361,10,4,8,15,28,49,-21,20
Sydney FC,5362,1,21,4,3,66,23,43,67
N'castle Jet,5362,2,15,6,7,57,37,20,51
Melbourne C,5362,3,14,5,10,43,33,10,47
Melbourne V,5362,4,13,5,11,46,40,6,44
Adelaide Utd,5362,5,11,6,11,37,40,-3,39
Brisbane,5362,6,10,5,13,33,42,-9,35
Western Sydn,5362,7,8,9,10,38,47,-9,33
Perth Glory,5362,8,10,2,15,37,50,-13,32
Wellington P,5362,9,5,6,16,31,55,-24,21
CC Mariners,5362,10,4,8,15,28,49,-21,20
Sydney FC,5363,1,21,4,3,66,23,43,67
N'castle Jet,5363,2,15,6,7,58,38,20,51
Melbourne C,5363,3,14,5,10,44,34,10,47
Melbourne V,5363,4,13,5,11,46,40,6,44
Adelaide Utd,5363,5,11,6,11,37,40,-3,39
Brisbane,5363,6,10,5,13,33,42,-9,35
Western Sydn,5363,7,8,9,10,38,47,-9,33
Perth Glory,5363,8,10,2,15,37,50,-13,32
Wellington P,5363,9,5,6,16,31,55,-24,21
CC Mariners,5363,10,4,8,15,28,49,-21,20
Sydney FC,5364,1,21,4,3,67,23,44,67
N'castle Jet,5364,2,15,5,8,57,38,19,50
Melbourne C,5364,3,15,4,10,44,33,11,49
Melbourne V,5364,4,13,5,11,46,41,5,44
Adelaide Utd,5364,5,11,6,11,37,40,-3,39
Brisbane,5364,6,10,5,13,33,42,-9,35
Western Sydn,5364,7,8,9,10,38,47,-9,33
Perth Glory,5364,8,10,2,15,37,50,-13,32
Wellington P,5364,9,5,6,16,31,55,-24,21
CC Mariners,5364,10,4,8,15,28,49,-21,20
Sydney FC,5365,1,20,5,3,65,23,42,65
N'castle Jet,5365,2,16,5,7,58,37,21,53
Melbourne C,5365,3,14,4,11,43,34,9,46
Melbourne V,5365,4,13,6,10,46,39,7,45
Adelaide Utd,5365,5,11,6,11,37,40,-3,39
Brisbane,5365,6,10,5,13,33,42,-9,35
Western Sydn,5365,7,8,9,10,38,47,-9,33
Perth Glory,5365,8,10,2,15,37,50,-13,32
Wellington P,5365,9,5,6,16,31,55,-24,21
CC Mariners,5365,10,4,8,15,28,49,-21,20
Sydney FC,5366,1,20,4,4,64,24,40,64
N'castle Jet,5366,2,16,5,7,59,38,21,53
Melbourne V,5366,3,14,5,10,47,38,9,47
Melbourne C,5366,4,14,4,11,44,35,9,46
Adelaide Utd,5366,5,11,6,11,37,40,-3,39
Brisbane,5366,6,10,5,13,33,42,-9,35
Western Sydn,5366,7,8,9,10,38,47,-9,33
Perth Glory,5366,8,10,2,15,37,50,-13,32
Wellington P,5366,9,5,6,16,31,55,-24,21
CC Mariners,5366,10,4,8,15,28,49,-21,20
Sydney FC,5367,1,21,4,3,66,22,44,67
N'castle Jet,5367,2,15,6,7,60,40,20,51
Melbourne C,5367,3,14,5,10,46,36,10,47
Melbourne V,5367,4,13,5,11,45,40,5,44
Adelaide Utd,5367,5,11,6,11,37,40,-3,39
Brisbane,5367,6,10,5,13,33,42,-9,35
Western Sydn,5367,7,8,9,10,38,47,-9,33
Perth Glory,5367,8,10,2,15,37,50,-13,32
Wellington P,5367,9,5,6,16,31,55,-24,21
CC Mariners,5367,10,4,8,15,28,49,-21,20
Sydney FC,5368,1,21,4,3,67,23,44,67
N'castle Jet,5368,2,16,5,7,64,37,27,53
Melbourne C,5368,3,14,4,11,43,40,3,46
Melbourne V,5368,4,13,5,11,46,41,5,44
Adelaide Utd,5368,5,11,6,11,37,40,-3,39
Brisbane,5368,6,10,5,13,33,42,-9,35
Western Sydn,5368,7,8,9,10,38,47,-9,33
Perth Glory,5368,8,10,2,15,37,50,-13,32
Wellington P,5368,9,5,6,16,31,55,-24,21
CC Mariners,5368,10,4,8,15,28,49,-21,20
Sydney FC,5369,1,21,4,3,66,22,44,67
N'castle Jet,5369,2,16,5,7,61,37,24,53
Melbourne C,5369,3,14,4,11,43,37,6,46
Melbourne V,5369,4,13,5,11,45,40,5,44
Adelaide Utd,5369,5,11,6,11,37,40,-3,39
Brisbane,5369,6,10,5,13,33,42,-9,35
Western Sydn,5369,7,8,9,10,38,47,-9,33
Perth Glory,5369,8,10,2,15,37,50,-13,32
Wellington P,5369,9,5,6,16,31,55,-24,21
CC Mariners,5369,10,4,8,15,28,49,-21,20
Sydney FC,5370,1,21,4,3,65,22,43,67
N'castle Jet,5370,2,15,5,8,57,38,19,50
Melbourne C,5370,3,15,4,10,44,33,11,49
Melbourne V,5370,4,13,5,11,45,39,6,44
Adelaide Utd,5370,5,11,6,11,37,40,-3,39
Brisbane,5370,6,10,5,13,33,42,-9,35
Western Sydn,5370,7,8,9,10,38,47,-9,33
Perth Glory,5370,8,10,2,15,37,50,-13,32
Wellington P,5370,9,5,6,16,31,55,-24,21
CC Mariners,5370,10,4,8,15,28,49,-21,20
Sydney FC,5371,1,21,4,3,66,22,44,67
N'castle Jet,5371,2,16,5,7,59,37,22,53
Melbourne C,5371,3,14,4,11,43,35,8,46
Melbourne V,5371,4,13,5,11,45,40,5,44
Adelaide Utd,5371,5,11,6,11,37,40,-3,39
Brisbane,5371,6,10,5,13,33,42,-9,35
Western Sydn,5371,7,8,9,10,38,47,-9,33
Perth Glory,5371,8,10,2,15,37,50,-13,32
Wellington P,5371,9,5,6,16,31,55,-24,21
CC Mariners,5371,10,4,8,15,28,49,-21,20
Sydney FC,5372,1,21,4,3,65,22,43,67
N'castle Jet,5372,2,15,5,8,57,38,19,50
Melbourne C,5372,3,15,4,10,44,33,11,49
Melbourne V,5372,4,13,5,11,45,39,6,44
Adelaide Utd,5372,5,11,6,11,37,40,-3,39
Brisbane,5372,6,10,5,13,33,42,-9,35
Western Sydn,5372,7,8,9,10,38,47,-9,33
Perth Glory,5372,8,10,2,15,37,50,-13,32
Wellington P,5372,9,5,6,16,31,55,-24,21
CC Mariners,5372,10,4,8,15,28,49,-21,20
Sydney FC,5373,1,21,4,3,66,23,43,67
N'castle Jet,5373,2,15,5,8,57,38,19,50
Melbourne C,5373,3,15,4,10,44,33,11,49
Melbourne V,5373,4,13,5,11,46,40,6,44
Adelaide Utd,5373,5,11,6,11,37,40,-3,39
Brisbane,5373,6,10,5,13,33,42,-9,35
Western Sydn,5373,7,8,9,10,38,47,-9,33
Perth Glory,5373,8,10,2,15,37,50,-13,32
Wellington P,5373,9,5,6,16,31,55,-24,21
CC Mariners,5373,10,4,8,15,28,49,-21,20
Sydney FC,5374,1,20,4,4,67,26,41,64
N'castle Jet,5374,2,16,5,7,60,38,22,53
Melbourne V,5374,3,14,5,10,49,41,8,47
Melbourne C,5374,4,14,4,11,44,36,8,46
Adelaide Utd,5374,5,11,6,11,37,40,-3,39
Brisbane,5374,6,10,5,13,33,42,-9,35
Western Sydn,5374,7,8,9,10,38,47,-9,33
Perth Glory,5374,8,10,2,15,37,50,-13,32
Wellington P,5374,9,5,6,16,31,55,-24,21
CC Mariners,5374,10,4,8,15,28,49,-21,20
Sydney FC,5375,1,20,4,4,65,24,41,64
N'castle Jet,5375,2,15,5,8,58,39,19,50
Melbourne C,5375,3,15,4,10,45,34,11,49
Melbourne V,5375,4,14,5,10,47,39,8,47
Adelaide Utd,5375,5,11,6,11,37,40,-3,39
Brisbane,5375,6,10,5,13,33,42,-9,35
Western Sydn,5375,7,8,9,10,38,47,-9,33
Perth Glory,5375,8,10,2,15,37,50,-13,32
Wellington P,5375,9,5,6,16,31,55,-24,21
CC Mariners,5375,10,4,8,15,28,49,-21,20
Sydney FC,5376,1,21,4,3,66,22,44,67
N'castle Jet,5376,2,16,5,7,61,37,24,53
Melbourne C,5376,3,14,4,11,43,37,6,46
Melbourne V,5376,4,13,5,11,45,40,5,44
Adelaide Utd,5376,5,11,6,11,37,40,-3,39
Brisbane,5376,6,10,5,13,33,42,-9,35
Western Sydn,5376,7,8,9,10,38,47,-9,33
Perth Glory,5376,8,10,2,15,37,50,-13,32
Wellington P,5376,9,5,6,16,31,55,-24,21
CC Mariners,5376,10,4,8,15,28,49,-21,20
Sydney FC,5377,1,20,4,4,65,24,41,64
N'castle Jet,5377,2,16,5,7,58,37,21,53
Melbourne V,5377,3,14,5,10,47,39,8,47
Melbourne C,5377,4,14,4,11,43,34,9,46
Adelaide Utd,5377,5,11,6,11,37,40,-3,39
Brisbane,5377,6,10,5,13,33,42,-9,35
Western Sydn,5377,7,8,9,10,38,47,-9,33
Perth Glory,5377,8,10,2,15,37,50,-13,32
Wellington P,5377,9,5,6,16,31,55,-24,21
CC Mariners,5377,10,4,8,15,28,49,-21,20
Sydney FC,5378,1,21,4,3,66,22,44,67
N'castle Jet,5378,2,16,5,7,62,38,24,53
Melbourne C,5378,3,14,4,11,44,38,6,46
Melbourne V,5378,4,13,5,11,45,40,5,44
Adelaide Utd,5378,5,11,6,11,37,40,-3,39
Brisbane,5378,6,10,5,13,33,42,-9,35
Western Sydn,5378,7,8,9,10,38,47,-9,33
Perth Glory,5378,8,10,2,15,37,50,-13,32
Wellington P,5378,9,5,6,16,31,55,-24,21
CC Mariners,5378,10,4,8,15,28,49,-21,20
Sydney FC,5379,1,21,4,3,66,22,44,67
N'castle Jet,5379,2,16,5,7,59,37,22,53
Melbourne C,5379,3,14,4,11,43,35,8,46
Melbourne V,5379,4,13,5,11,45,40,5,44
Adelaide Utd,5379,5,11,6,11,37,40,-3,39
Brisbane,5379,6,10,5,13,33,42,-9,35
Western Sydn,5379,7,8,9,10,38,47,-9,33
Perth Glory,5379,8,10,2,15,37,50,-13,32
Wellington P,5379,9,5,6,16,31,55,-24,21
CC Mariners,5379,10,4,8,15,28,49,-21,20
Sydney FC,5380,1,21,4,3,69,23,46,67
N'castle Jet,5380,2,16,5,7,60,37,23,53
Melbourne C,5380,3,14,4,11,43,36,7,46
Melbourne V,5380,4,13,5,11,46,43,3,44
Adelaide Utd,5380,5,11,6,11,37,40,-3,39
Brisbane,5380,6,10,5,13,33,42,-9,35
Western Sydn,5380,7,8,9,10,38,47,-9,33
Perth Glory,5380,8,10,2,15,37,50,-13,32
Wellington P,5380,9,5,6,16,31,55,-24,21
CC Mariners,5380,10,4,8,15,28,49,-21,20
Sydney FC,5381,1,21,4,3,69,22,47,67
N'castle Jet,5381,2,16,5,7,60,38,22,53
Melbourne C,5381,3,14,4,11,44,36,8,46
Melbourne V,5381,4,13,5,11,45,43,2,44
Adelaide Utd,5381,5,11,6,11,37,40,-3,39
Brisbane,5381,6,10,5,13,33,42,-9,35
Western Sydn,5381,7,8,9,10,38,47,-9,33
Perth Glory,5381,8,10,2,15,37,50,-13,32
Wellington P,5381,9,5,6,16,31,55,-24,21
CC Mariners,5381,10,4,8,15,28,49,-21,20
Sydney FC,5382,1,20,5,3,65,23,42,65
N'castle Jet,5382,2,16,5,7,58,37,21,53
Melbourne C,5382,3,14,4,11,43,34,9,46
Melbourne V,5382,4,13,6,10,46,39,7,45
Adelaide Utd,5382,5,11,6,11,37,40,-3,39
Brisbane,5382,6,10,5,13,33,42,-9,35
Western Sydn,5382,7,8,9,10,38,47,-9,33
Perth Glory,5382,8,10,2,15,37,50,-13,32
Wellington P,5382,9,5,6,16,31,55,-24,21
CC Mariners,5382,10,4,8,15,28,49,-21,20
Sydney FC,5383,1,21,4,3,66,23,43,67
N'castle Jet,5383,2,15,5,8,58,39,19,50
Melbourne C,5383,3,15,4,10,45,34,11,49
Melbourne V,5383,4,13,5,11,46,40,6,44
Adelaide Utd,5383,5,11,6,11,37,40,-3,39
Brisbane,5383,6,10,5,13,33,42,-9,35
Western Sydn,5383,7,8,9,10,38,47,-9,33
Perth Glory,5383,8,10,2,15,37,50,-13,32
Wellington P,5383,9,5,6,16,31,55,-24,21
CC Mariners,5383,10,4,8,15,28,49,-21,20
Sydney FC,5384,1,21,4,3,66,22,44,67
N'castle Jet,5384,2,16,5,7,59,37,22,53
Melbourne C,5384,3,14,4,11,43,35,8,46
Melbourne V,5384,4,13,5,11,45,40,5,44
Adelaide Utd,5384,5,11,6,11,37,40,-3,39
Brisbane,5384,6,10,5,13,33,42,-9,35
Western Sydn,5384,7,8,9,10,38,47,-9,33
Perth Glory,5384,8,10,2,15,37,50,-13,32
Wellington P,5384,9,5,6,16,31,55,-24,21
CC Mariners,5384,10,4,8,15,28,49,-21,20
Sydney FC,5385,1,20,4,4,64,23,41,64
N'castle Jet,5385,2,16,5,7,59,38,21,53
Melbourne V,5385,3,14,5,10,46,38,8,47
Melbourne C,5385,4,14,4,11,44,35,9,46
Adelaide Utd,5385,5,11,6,11,37,40,-3,39
Brisbane,5385,6,10,5,13,33,42,-9,35
Western Sydn,5385,7,8,9,10,38,47,-9,33
Perth Glory,5385,8,10,2,15,37,50,-13,32
Wellington P,5385,9,5,6,16,31,55,-24,21
CC Mariners,5385,10,4,8,15,28,49,-21,20
Sydney FC,5386,1,21,4,3,68,23,45,67
N'castle Jet,5386,2,16,5,7,58,37,21,53
Melbourne C,5386,3,14,4,11,43,34,9,46
Melbourne V,5386,4,13,5,11,46,42,4,44
Adelaide Utd,5386,5,11,6,11,37,40,-3,39
Brisbane,5386,6,10,5,13,33,42,-9,35
Western Sydn,5386,7,8,9,10,38,47,-9,33
Perth Glory,5386,8,10,2,15,37,50,-13,32
Wellington P,5386,9,5,6,16,31,55,-24,21
CC Mariners,5386,10,4,8,15,28,49,-21,20
Sydney FC,5387,1,20,5,3,65,23,42,65
N'castle Jet,5387,2,15,5,8,57,38,19,50
Melbourne C,5387,3,15,4,10,44,33,11,49
Melbourne V,5387,4,13,6,10,46,39,7,45
Adelaide Utd,5387,5,11,6,11,37,40,-3,39
Brisbane,5387,6,10,5,13,33,42,-9,35
Western Sydn,5387,7,8,9,10,38,47,-9,33
Perth Glory,5387,8,10,2,15,37,50,-13,32
Wellington P,5387,9,5,6,16,31,55,-24,21
CC Mariners,5387,10,4,8,15,28,49,-21,20
Sydney FC,5388,1,21,4,3,68,23,45,67
N'castle Jet,5388,2,15,6,7,58,38,20,51
Melbourne C,5388,3,14,5,10,44,34,10,47
Melbourne V,5388,4,13,5,11,46,42,4,44
Adelaide Utd,5388,5,11,6,11,37,40,-3,39
Brisbane,5388,6,10,5,13,33,42,-9,35
Western Sydn,5388,7,8,9,10,38,47,-9,33
Perth Glory,5388,8,10,2,15,37,50,-13,32
Wellington P,5388,9,5,6,16,31,55,-24,21
CC Mariners,5388,10,4,8,15,28,49,-21,20
Sydney FC,5389,1,21,4,3,66,22,44,67
N'castle Jet,5389,2,16,5,7,60,39,21,53
Melbourne C,5389,3,14,4,11,45,36,9,46
Melbourne V,5389,4,13,5,11,45,40,5,44
Adelaide Utd,5389,5,11,6,11,37,40,-3,39
Brisbane,5389,6,10,5,13,33,42,-9,35
Western Sydn,5389,7,8,9,10,38,47,-9,33
Perth Glory,5389,8,10,2,15,37,50,-13,32
Wellington P,5389,9,5,6,16,31,55,-24,21
CC Mariners,5389,10,4,8,15,28,49,-21,20
Sydney FC,5390,1,21,4,3,66,23,43,67
N'castle Jet,5390,2,16,5,7,60,38,22,53
Melbourne C,5390,3,14,4,11,44,36,8,46
Melbourne V,5390,4,13,5,11,46,40,6,44
Adelaide Utd,5390,5,11,6,11,37,40,-3,39
Brisbane,5390,6,10,5,13,33,42,-9,35
Western Sydn,5390,7,8,9,10,38,47,-9,33
Perth Glory,5390,8,10,2,15,37,50,-13,32
Wellington P,5390,9,5,6,16,31,55,-24,21
CC Mariners,5390,10,4,8,15,28,49,-21,20
Sydney FC,5391,1,20,4,4,64,23,41,64
N'castle Jet,5391,2,15,5,8,57,39,18,50
Melbourne C,5391,3,15,4,10,45,33,12,49
Melbourne V,5391,4,14,5,10,46,38,8,47
Adelaide Utd,5391,5,11,6,11,37,40,-3,39
Brisbane,5391,6,10,5,13,33,42,-9,35
Western Sydn,5391,7,8,9,10,38,47,-9,33
Perth Glory,5391,8,10,2,15,37,50,-13,32
Wellington P,5391,9,5,6,16,31,55,-24,21
CC Mariners,5391,10,4,8,15,28,49,-21,20
Sydney FC,5392,1,21,4,3,67,22,45,67
N'castle Jet,5392,2,15,6,7,58,38,20,51
Melbourne C,5392,3,14,5,10,44,34,10,47
Melbourne V,5392,4,13,5,11,45,41,4,44
Adelaide Utd,5392,5,11,6,11,37,40,-3,39
Brisbane,5392,6,10,5,13,33,42,-9,35
Western Sydn,5392,7,8,9,10,38,47,-9,33
Perth Glory,5392,8,10,2,15,37,50,-13,32
Wellington P,5392,9,5,6,16,31,55,-24,21
CC Mariners,5392,10,4,8,15,28,49,-21,20
Sydney FC,5393,1,21,4,3,67,22,45,67
N'castle Jet,5393,2,15,5,8,57,39,18,50
Melbourne C,5393,3,15,4,10,45,33,12,49
Melbourne V,5393,4,13,5,11,45,41,4,44
Adelaide Utd,5393,5,11,6,11,37,40,-3,39
Brisbane,5393,6,10,5,13,33,42,-9,35
Western Sydn,5393,7,8,9,10,38,47,-9,33
Perth Glory,5393,8,10,2,15,37,50,-13,32
Wellington P,5393,9,5,6,16,31,55,-24,21
CC Mariners,5393,10,4,8,15,28,49,-21,20
Sydney FC,5394,1,21,4,3,68,23,45,67
N'castle Jet,5394,2,15,5,8,59,40,19,50
Melbourne C,5394,3,15,4,10,46,35,11,49
Melbourne V,5394,4,13,5,11,46,42,4,44
Adelaide Utd,5394,5,11,6,11,37,40,-3,39
Brisbane,5394,6,10,5,13,33,42,-9,35
Western Sydn,5394,7,8,9,10,38,47,-9,33
Perth Glory,5394,8,10,2,15,37,50,-13,32
Wellington P,5394,9,5,6,16,31,55,-24,21
CC Mariners,5394,10,4,8,15,28,49,-21,20
Sydney FC,5395,1,21,4,3,67,22,45,67
N'castle Jet,5395,2,16,5,7,60,37,23,53
Melbourne C,5395,3,14,4,11,43,36,7,46
Melbourne V,5395,4,13,5,11,45,41,4,44
Adelaide Utd,5395,5,11,6,11,37,40,-3,39
Brisbane,5395,6,10,5,13,33,42,-9,35
Western Sydn,5395,7,8,9,10,38,47,-9,33
Perth Glory,5395,8,10,2,15,37,50,-13,32
Wellington P,5395,9,5,6,16,31,55,-24,21
CC Mariners,5395,10,4,8,15,28,49,-21,20
Sydney FC,5396,1,21,4,3,68,23,45,67
N'castle Jet,5396,2,16,5,7,62,38,24,53
Melbourne C,5396,3,14,4,11,44,38,6,46
Melbourne V,5396,4,13,5,11,46,42,4,44
Adelaide Utd,5396,5,11,6,11,37,40,-3,39
Brisbane,5396,6,10,5,13,33,42,-9,35
Western Sydn,5396,7,8,9,10,38,47,-9,33
Perth Glory,5396,8,10,2,15,37,50,-13,32
Wellington P,5396,9,5,6,16,31,55,-24,21
CC Mariners,5396,10,4,8,15,28,49,-21,20
Sydney FC,5397,1,21,4,3,67,23,44,67
N'castle Jet,5397,2,16,5,7,59,38,21,53
Melbourne C,5397,3,14,4,11,44,35,9,46
Melbourne V,5397,4,13,5,11,46,41,5,44
Adelaide Utd,5397,5,11,6,11,37,40,-3,39
Brisbane,5397,6,10,5,13,33,42,-9,35
Western Sydn,5397,7,8,9,10,38,47,-9,33
Perth Glory,5397,8,10,2,15,37,50,-13,32
Wellington P,5397,9,5,6,16,31,55,-24,21
CC Mariners,5397,10,4,8,15,28,49,-21,20
Sydney FC,5398,1,20,4,4,64,23,41,64
N'castle Jet,5398,2,15,6,7,58,38,20,51
Melbourne C,5398,3,14,5,10,44,34,10,47
Melbourne V,5398,4,14,5,10,46,38,8,47
Adelaide Utd,5398,5,11,6,11,37,40,-3,39
Brisbane,5398,6,10,5,13,33,42,-9,35
Western Sydn,5398,7,8,9,10,38,47,-9,33
Perth Glory,5398,8,10,2,15,37,50,-13,32
Wellington P,5398,9,5,6,16,31,55,-24,21
CC Mariners,5398,10,4,8,15,28,49,-21,20
Sydney FC,5399,1,21,4,3,67,22,45,67
N'castle Jet,5399,2,16,5,7,59,37,22,53
Melbourne C,5399,3,14,4,11,43,35,8,46
Melbourne V,5399,4,13,5,11,45,41,4,44
Adelaide Utd,5399,5,11,6,11,37,40,-3,39
Brisbane,5399,6,10,5,13,33,42,-9,35
Western Sydn,5399,7,8,9,10,38,47,-9,33
Perth Glory,5399,8,10,2,15,37,50,-13,32
Wellington P,5399,9,5,6,16,31,55,-24,21
CC Mariners,5399,10,4,8,15,28,49,-21,20
Sydney FC,5400,1,21,4,3,67,22,45,67
N'castle Jet,5400,2,16,5,7,58,37,21,53
Melbourne C,5400,3,14,4,11,43,34,9,46
Melbourne V,5400,4,13,5,11,45,41,4,44
Adelaide Utd,5400,5,11,6,11,37,40,-3,39
Brisbane,5400,6,10,5,13,33,42,-9,35
Western Sydn,5400,7,8,9,10,38,47,-9,33
Perth Glory,5400,8,10,2,15,37,50,-13,32
Wellington P,5400,9,5,6,16,31,55,-24,21
CC Mariners,5400,10,4,8,15,28,49,-21,20
Sydney FC,5401,1,20,5,3,66,24,42,65
N'castle Jet,5401,2,15,5,8,57,39,18,50
Melbourne C,5401,3,15,4,10,45,33,12,49
Melbourne V,5401,4,13,6,10,47,40,7,45
Adelaide Utd,5401,5,11,6,11,37,40,-3,39
Brisbane,5401,6,10,5,13,33,42,-9,35
Western Sydn,5401,7,8,9,10,38,47,-9,33
Perth Glory,5401,8,10,2,15,37,50,-13,32
Wellington P,5401,9,5,6,16,31,55,-24,21
CC Mariners,5401,10,4,8,15,28,49,-21,20
Sydney FC,5402,1,20,5,3,65,23,42,65
N'castle Jet,5402,2,15,5,8,57,38,19,50
Melbourne C,5402,3,15,4,10,44,33,11,49
Melbourne V,5402,4,13,6,10,46,39,7,45
Adelaide Utd,5402,5,11,6,11,37,40,-3,39
Brisbane,5402,6,10,5,13,33,42,-9,35
Western Sydn,5402,7,8,9,10,38,47,-9,33
Perth Glory,5402,8,10,2,15,37,50,-13,32
Wellington P,5402,9,5,6,16,31,55,-24,21
CC Mariners,5402,10,4,8,15,28,49,-21,20
Sydney FC,5403,1,21,4,3,68,23,45,67
N'castle Jet,5403,2,16,5,7,60,38,22,53
Melbourne C,5403,3,14,4,11,44,36,8,46
Melbourne V,5403,4,13,5,11,46,42,4,44
Adelaide Utd,5403,5,11,6,11,37,40,-3,39
Brisbane,5403,6,10,5,13,33,42,-9,35
Western Sydn,5403,7,8,9,10,38,47,-9,33
Perth Glory,5403,8,10,2,15,37,50,-13,32
Wellington P,5403,9,5,6,16,31,55,-24,21
CC Mariners,5403,10,4,8,15,28,49,-21,20
Sydney FC,5404,1,21,4,3,65,22,43,67
N'castle Jet,5404,2,15,5,8,57,39,18,50
Melbourne C,5404,3,15,4,10,45,33,12,49
Melbourne V,5404,4,13,5,11,45,39,6,44
Adelaide Utd,5404,5,11,6,11,37,40,-3,39
Brisbane,5404,6,10,5,13,33,42,-9,35
Western Sydn,5404,7,8,9,10,38,47,-9,33
Perth Glory,5404,8,10,2,15,37,50,-13,32
Wellington P,5404,9,5,6,16,31,55,-24,21
CC Mariners,5404,10,4,8,15,28,49,-21,20
Sydney FC,5405,1,21,4,3,66,23,43,67
N'castle Jet,5405,2,15,5,8,57,39,18,50
Melbourne C,5405,3,15,4,10,45,33,12,49
Melbourne V,5405,4,13,5,11,46,40,6,44
Adelaide Utd,5405,5,11,6,11,37,40,-3,39
Brisbane,5405,6,10,5,13,33,42,-9,35
Western Sydn,5405,7,8,9,10,38,47,-9,33
Perth Glory,5405,8,10,2,15,37,50,-13,32
Wellington P,5405,9,5,6,16,31,55,-24,21
CC Mariners,5405,10,4,8,15,28,49,-21,20
Sydney FC,5406,1,20,4,4,65,24,41,64
N'castle Jet,5406,2,15,6,7,59,39,20,51
Melbourne C,5406,3,14,5,10,45,35,10,47
Melbourne V,5406,4,14,5,10,47,39,8,47
Adelaide Utd,5406,5,11,6,11,37,40,-3,39
Brisbane,5406,6,10,5,13,33,42,-9,35
Western Sydn,5406,7,8,9,10,38,47,-9,33
Perth Glory,5406,8,10,2,15,37,50,-13,32
Wellington P,5406,9,5,6,16,31,55,-24,21
CC Mariners,5406,10,4,8,15,28,49,-21,20
Sydney FC,5407,1,21,4,3,69,23,46,67
N'castle Jet,5407,2,15,5,8,57,38,19,50
Melbourne C,5407,3,15,4,10,44,33,11,49
Melbourne V,5407,4,13,5,11,46,43,3,44
Adelaide Utd,5407,5,11,6,11,37,40,-3,39
Brisbane,5407,6,10,5,13,33,42,-9,35
Western Sydn,5407,7,8,9,10,38,47,-9,33
Perth Glory,5407,8,10,2,15,37,50,-13,32
Wellington P,5407,9,5,6,16,31,55,-24,21
CC Mariners,5407,10,4,8,15,28,49,-21,20
Sydney FC,5408,1,20,5,3,66,24,42,65
N'castle Jet,5408,2,15,6,7,59,39,20,51
Melbourne C,5408,3,14,5,10,45,35,10,47
Melbourne V,5408,4,13,6,10,47,40,7,45
Adelaide Utd,5408,5,11,6,11,37,40,-3,39
Brisbane,5408,6,10,5,13,33,42,-9,35
Western Sydn,5408,7,8,9,10,38,47,-9,33
Perth Glory,5408,8,10,2,15,37,50,-13,32
Wellington P,5408,9,5,6,16,31,55,-24,21
CC Mariners,5408,10,4,8,15,28,49,-21,20
Sydney FC,5409,1,20,4,4,64,23,41,64
N'castle Jet,5409,2,15,6,7,59,39,20,51
Melbourne C,5409,3,14,5,10,45,35,10,47
Melbourne V,5409,4,14,5,10,46,38,8,47
Adelaide Utd,5409,5,11,6,11,37,40,-3,39
Brisbane,5409,6,10,5,13,33,42,-9,35
Western Sydn,5409,7,8,9,10,38,47,-9,33
Perth Glory,5409,8,10,2,15,37,50,-13,32
Wellington P,5409,9,5,6,16,31,55,-24,21
CC Mariners,5409,10,4,8,15,28,49,-21,20
Sydney FC,5410,1,21,4,3,65,22,43,67
N'castle Jet,5410,2,16,5,7,60,37,23,53
Melbourne C,5410,3,14,4,11,43,36,7,46
Melbourne V,5410,4,13,5,11,45,39,6,44
Adelaide Utd,5410,5,11,6,11,37,40,-3,39
Brisbane,5410,6,10,5,13,33,42,-9,35
Western Sydn,5410,7,8,9,10,38,47,-9,33
Perth Glory,5410,8,10,2,15,37,50,-13,32
Wellington P,5410,9,5,6,16,31,55,-24,21
CC Mariners,5410,10,4,8,15,28,49,-21,20
Sydney FC,5411,1,20,5,3,65,23,42,65
N'castle Jet,5411,2,16,5,7,58,37,21,53
Melbourne C,5411,3,14,4,11,43,34,9,46
Melbourne V,5411,4,13,6,10,46,39,7,45
Adelaide Utd,5411,5,11,6,11,37,40,-3,39
Brisbane,5411,6,10,5,13,33,42,-9,35
Western Sydn,5411,7,8,9,10,38,47,-9,33
Perth Glory,5411,8,10,2,15,37,50,-13,32
Wellington P,5411,9,5,6,16,31,55,-24,21
CC Mariners,5411,10,4,8,15,28,49,-21,20
Sydney FC,5412,1,20,4,4,65,24,41,64
N'castle Jet,5412,2,15,5,8,58,39,19,50
Melbourne C,5412,3,15,4,10,45,34,11,49
Melbourne V,5412,4,14,5,10,47,39,8,47
Adelaide Utd,5412,5,11,6,11,37,40,-3,39
Brisbane,5412,6,10,5,13,33,42,-9,35
Western Sydn,5412,7,8,9,10,38,47,-9,33
Perth Glory,5412,8,10,2,15,37,50,-13,32
Wellington P,5412,9,5,6,16,31,55,-24,21
CC Mariners,5412,10,4,8,15,28,49,-21,20
Sydney FC,5413,1,21,4,3,66,22,44,67
N'castle Jet,5413,2,15,5,8,58,40,18,50
Melbourne C,5413,3,15,4,10,46,34,12,49
Melbourne V,5413,4,13,5,11,45,40,5,44
Adelaide Utd,5413,5,11,6,11,37,40,-3,39
Brisbane,5413,6,10,5,13,33,42,-9,35
Western Sydn,5413,7,8,9,10,38,47,-9,33
Perth Glory,5413,8,10,2,15,37,50,-13,32
Wellington P,5413,9,5,6,16,31,55,-24,21
CC Mariners,5413,10,4,8,15,28,49,-21,20
Sydney FC,5414,1,20,4,4,64,23,41,64
N'castle Jet,5414,2,16,5,7,60,37,23,53
Melbourne V,5414,3,14,5,10,46,38,8,47
Melbourne C,5414,4,14,4,11,43,36,7,46
Adelaide Utd,5414,5,11,6,11,37,40,-3,39
Brisbane,5414,6,10,5,13,33,42,-9,35
Western Sydn,5414,7,8,9,10,38,47,-9,33
Perth Glory,5414,8,10,2,15,37,50,-13,32
Wellington P,5414,9,5,6,16,31,55,-24,21
CC Mariners,5414,10,4,8,15,28,49,-21,20
Sydney FC,5415,1,20,5,3,65,23,42,65
N'castle Jet,5415,2,15,6,7,58,38,20,51
Melbourne C,5415,3,14,5,10,44,34,10,47
Melbourne V,5415,4,13,6,10,46,39,7,45
Adelaide Utd,5415,5,11,6,11,37,40,-3,39
Brisbane,5415,6,10,5,13,33,42,-9,35
Western Sydn,5415,7,8,9,10,38,47,-9,33
Perth Glory,5415,8,10,2,15,37,50,-13,32
Wellington P,5415,9,5,6,16,31,55,-24,21
CC Mariners,5415,10,4,8,15,28,49,-21,20
Sydney FC,5416,1,20,5,3,64,22,42,65
N'castle Jet,5416,2,15,5,8,57,38,19,50
Melbourne C,5416,3,15,4,10,44,33,11,49
Melbourne V,5416,4,13,6,10,45,38,7,45
Adelaide Utd,5416,5,11,6,11,37,40,-3,39
Brisbane,5416,6,10,5,13,33,42,-9,35
Western Sydn,5416,7,8,9,10,38,47,-9,33
Perth Glory,5416,8,10,2,15,37,50,-13,32
Wellington P,5416,9,5,6,16,31,55,-24,21
CC Mariners,5416,10,4,8,15,28,49,-21,20
Sydney FC,5417,1,20,5,3,66,24,42,65
N'castle Jet,5417,2,16,5,7,58,37,21,53
Melbourne C,5417,3,14,4,11,43,34,9,46
Melbourne V,5417,4,13,6,10,47,40,7,45
Adelaide Utd,5417,5,11,6,11,37,40,-3,39
Brisbane,5417,6,10,5,13,33,42,-9,35
Western Sydn,5417,7,8,9,10,38,47,-9,33
Perth Glory,5417,8,10,2,15,37,50,-13,32
Wellington P,5417,9,5,6,16,31,55,-24,21
CC Mariners,5417,10,4,8,15,28,49,-21,20
Sydney FC,5418,1,21,4,3,66,23,43,67
N'castle Jet,5418,2,15,6,7,57,37,20,51
Melbourne C,5418,3,14,5,10,43,33,10,47
Melbourne V,5418,4,13,5,11,46,40,6,44
Adelaide Utd,5418,5,11,6,11,37,40,-3,39
Brisbane,5418,6,10,5,13,33,42,-9,35
Western Sydn,5418,7,8,9,10,38,47,-9,33
Perth Glory,5418,8,10,2,15,37,50,-13,32
Wellington P,5418,9,5,6,16,31,55,-24,21
CC Mariners,5418,10,4,8,15,28,49,-21,20
Sydney FC,5419,1,20,5,3,67,25,42,65
N'castle Jet,5419,2,16,5,7,60,39,21,53
Melbourne C,5419,3,14,4,11,45,36,9,46
Melbourne V,5419,4,13,6,10,48,41,7,45
Adelaide Utd,5419,5,11,6,11,37,40,-3,39
Brisbane,5419,6,10,5,13,33,42,-9,35
Western Sydn,5419,7,8,9,10,38,47,-9,33
Perth Glory,5419,8,10,2,15,37,50,-13,32
Wellington P,5419,9,5,6,16,31,55,-24,21
CC Mariners,5419,10,4,8,15,28,49,-21,20
Sydney FC,5420,1,20,4,4,65,24,41,64
N'castle Jet,5420,2,16,5,7,60,37,23,53
Melbourne V,5420,3,14,5,10,47,39,8,47
Melbourne C,5420,4,14,4,11,43,36,7,46
Adelaide Utd,5420,5,11,6,11,37,40,-3,39
Brisbane,5420,6,10,5,13,33,42,-9,35
Western Sydn,5420,7,8,9,10,38,47,-9,33
Perth Glory,5420,8,10,2,15,37,50,-13,32
Wellington P,5420,9,5,6,16,31,55,-24,21
CC Mariners,5420,10,4,8,15,28,49,-21,20
Sydney FC,5421,1,21,4,3,66,22,44,67
N'castle Jet,5421,2,16,5,7,59,37,22,53
Melbourne C,5421,3,14,4,11,43,35,8,46
Melbourne V,5421,4,13,5,11,45,40,5,44
Adelaide Utd,5421,5,11,6,11,37,40,-3,39
Brisbane,5421,6,10,5,13,33,42,-9,35
Western Sydn,5421,7,8,9,10,38,47,-9,33
Perth Glory,5421,8,10,2,15,37,50,-13,32
Wellington P,5421,9,5,6,16,31,55,-24,21
CC Mariners,5421,10,4,8,15,28,49,-21,20
Sydney FC,5422,1,21,4,3,66,23,43,67
N'castle Jet,5422,2,16,5,7,58,37,21,53
Melbourne C,5422,3,14,4,11,43,34,9,46
Melbourne V,5422,4,13,5,11,46,40,6,44
Adelaide Utd,5422,5,11,6,11,37,40,-3,39
Brisbane,5422,6,10,5,13,33,42,-9,35
Western Sydn,5422,7,8,9,10,38,47,-9,33
Perth Glory,5422,8,10,2,15,37,50,-13,32
Wellington P,5422,9,5,6,16,31,55,-24,21
CC Mariners,5422,10,4,8,15,28,49,-21,20
Sydney FC,5423,1,21,4,3,65,22,43,67
N'castle Jet,5423,2,16,5,7,60,37,23,53
Melbourne C,5423,3,14,4,11,43,36,7,46
Melbourne V,5423,4,13,5,11,45,39,6,44
Adelaide Utd,5423,5,11,6,11,37,40,-3,39
Brisbane,5423,6,10,5,13,33,42,-9,35
Western Sydn,5423,7,8,9,10,38,47,-9,33
Perth Glory,5423,8,10,2,15,37,50,-13,32
Wellington P,5423,9,5,6,16,31,55,-24,21
CC Mariners,5423,10,4,8,15,28,49,-21,20
Sydney FC,5424,1,21,4,3,65,22,43,67
N'castle Jet,5424,2,15,6,7,61,41,20,51
Melbourne C,5424,3,14,5,10,47,37,10,47
Melbourne V,5424,4,13,5,11,45,39,6,44
Adelaide Utd,5424,5,11,6,11,37,40,-3,39
Brisbane,5424,6,10,5,13,33,42,-9,35
Western Sydn,5424,7,8,9,10,38,47,-9,33
Perth Glory,5424,8,10,2,15,37,50,-13,32
Wellington P,5424,9,5,6,16,31,55,-24,21
CC Mariners,5424,10,4,8,15,28,49,-21,20
Sydney FC,5425,1,21,4,3,67,24,43,67
N'castle Jet,5425,2,15,5,8,58,39,19,50
Melbourne C,5425,3,15,4,10,45,34,11,49
Melbourne V,5425,4,13,5,11,47,41,6,44
Adelaide Utd,5425,5,11,6,11,37,40,-3,39
Brisbane,5425,6,10,5,13,33,42,-9,35
Western Sydn,5425,7,8,9,10,38,47,-9,33
Perth Glory,5425,8,10,2,15,37,50,-13,32
Wellington P,5425,9,5,6,16,31,55,-24,21
CC Mariners,5425,10,4,8,15,28,49,-21,20
Sydney FC,5426,1,20,4,4,65,24,41,64
N'castle Jet,5426,2,16,5,7,61,40,21,53
Melbourne V,5426,3,14,5,10,47,39,8,47
Melbourne C,5426,4,14,4,11,46,37,9,46
Adelaide Utd,5426,5,11,6,11,37,40,-3,39
Brisbane,5426,6,10,5,13,33,42,-9,35
Western Sydn,5426,7,8,9,10,38,47,-9,33
Perth Glory,5426,8,10,2,15,37,50,-13,32
Wellington P,5426,9,5,6,16,31,55,-24,21
CC Mariners,5426,10,4,8,15,28,49,-21,20
Sydney FC,5427,1,21,4,3,67,23,44,67
N'castle Jet,5427,2,16,5,7,58,37,21,53
Melbourne C,5427,3,14,4,11,43,34,9,46
Melbourne V,5427,4,13,5,11,46,41,5,44
Adelaide Utd,5427,5,11,6,11,37,40,-3,39
Brisbane,5427,6,10,5,13,33,42,-9,35
Western Sydn,5427,7,8,9,10,38,47,-9,33
Perth Glory,5427,8,10,2,15,37,50,-13,32
Wellington P,5427,9,5,6,16,31,55,-24,21
CC Mariners,5427,10,4,8,15,28,49,-21,20
Sydney FC,5428,1,21,4,3,65,22,43,67
N'castle Jet,5428,2,15,6,7,58,38,20,51
Melbourne C,5428,3,14,5,10,44,34,10,47
Melbourne V,5428,4,13,5,11,45,39,6,44
Adelaide Utd,5428,5,11,6,11,37,40,-3,39
Brisbane,5428,6,10,5,13,33,42,-9,35
Western Sydn,5428,7,8,9,10,38,47,-9,33
Perth Glory,5428,8,10,2,15,37,50,-13,32
Wellington P,5428,9,5,6,16,31,55,-24,21
CC Mariners,5428,10,4,8,15,28,49,-21,20
Sydney FC,5429,1,21,4,3,66,22,44,67
N'castle Jet,5429,2,15,5,8,57,38,19,50
Melbourne C,5429,3,15,4,10,44,33,11,49
Melbourne V,5429,4,13,5,11,45,40,5,44
Adelaide Utd,5429,5,11,6,11,37,40,-3,39
Brisbane,5429,6,10,5,13,33,42,-9,35
Western Sydn,5429,7,8,9,10,38,47,-9,33
Perth Glory,5429,8,10,2,15,37,50,-13,32
Wellington P,5429,9,5,6,16,31,55,-24,21
CC Mariners,5429,10,4,8,15,28,49,-21,20
Sydney FC,5430,1,21,4,3,65,22,43,67
N'castle Jet,5430,2,16,5,7,59,37,22,53
Melbourne C,5430,3,14,4,11,43,35,8,46
Melbourne V,5430,4,13,5,11,45,39,6,44
Adelaide Utd,5430,5,11,6,11,37,40,-3,39
Brisbane,5430,6,10,5,13,33,42,-9,35
Western Sydn,5430,7,8,9,10,38,47,-9,33
Perth Glory,5430,8,10,2,15,37,50,-13,32
Wellington P,5430,9,5,6,16,31,55,-24,21
CC Mariners,5430,10,4,8,15,28,49,-21,20
Sydney FC,5431,1,20,5,3,66,24,42,65
N'castle Jet,5431,2,15,6,7,57,37,20,51
Melbourne C,5431,3,14,5,10,43,33,10,47
Melbourne V,5431,4,13,6,10,47,40,7,45
Adelaide Utd,5431,5,11,6,11,37,40,-3,39
Brisbane,5431,6,10,5,13,33,42,-9,35
Western Sydn,5431,7,8,9,10,38,47,-9,33
Perth Glory,5431,8,10,2,15,37,50,-13,32
Wellington P,5431,9,5,6,16,31,55,-24,21
CC Mariners,5431,10,4,8,15,28,49,-21,20
Sydney FC,5432,1,20,4,4,64,25,39,64
N'castle Jet,5432,2,15,5,8,58,40,18,50
Melbourne C,5432,3,15,4,10,46,34,12,49
Melbourne V,5432,4,14,5,10,48,38,10,47
Adelaide Utd,5432,5,11,6,11,37,40,-3,39
Brisbane,5432,6,10,5,13,33,42,-9,35
Western Sydn,5432,7,8,9,10,38,47,-9,33
Perth Glory,5432,8,10,2,15,37,50,-13,32
Wellington P,5432,9,5,6,16,31,55,-24,21
CC Mariners,5432,10,4,8,15,28,49,-21,20
Sydney FC,5433,1,21,4,3,66,22,44,67
N'castle Jet,5433,2,15,6,7,57,37,20,51
Melbourne C,5433,3,14,5,10,43,33,10,47
Melbourne V,5433,4,13,5,11,45,40,5,44
Adelaide Utd,5433,5,11,6,11,37,40,-3,39
Brisbane,5433,6,10,5,13,33,42,-9,35
Western Sydn,5433,7,8,9,10,38,47,-9,33
Perth Glory,5433,8,10,2,15,37,50,-13,32
Wellington P,5433,9,5,6,16,31,55,-24,21
CC Mariners,5433,10,4,8,15,28,49,-21,20
Sydney FC,5434,1,20,5,3,66,24,42,65
N'castle Jet,5434,2,15,5,8,57,40,17,50
Melbourne C,5434,3,15,4,10,46,33,13,49
Melbourne V,5434,4,13,6,10,47,40,7,45
Adelaide Utd,5434,5,11,6,11,37,40,-3,39
Brisbane,5434,6,10,5,13,33,42,-9,35
Western Sydn,5434,7,8,9,10,38,47,-9,33
Perth Glory,5434,8,10,2,15,37,50,-13,32
Wellington P,5434,9,5,6,16,31,55,-24,21
CC Mariners,5434,10,4,8,15,28,49,-21,20
Sydney FC,5435,1,20,5,3,65,23,42,65
N'castle Jet,5435,2,16,5,7,60,39,21,53
Melbourne C,5435,3,14,4,11,45,36,9,46
Melbourne V,5435,4,13,6,10,46,39,7,45
Adelaide Utd,5435,5,11,6,11,37,40,-3,39
Brisbane,5435,6,10,5,13,33,42,-9,35
Western Sydn,5435,7,8,9,10,38,47,-9,33
Perth Glory,5435,8,10,2,15,37,50,-13,32
Wellington P,5435,9,5,6,16,31,55,-24,21
CC Mariners,5435,10,4,8,15,28,49,-21,20
Sydney FC,5436,1,21,4,3,67,22,45,67
N'castle Jet,5436,2,16,5,7,58,37,21,53
Melbourne C,5436,3,14,4,11,43,34,9,46
Melbourne V,5436,4,13,5,11,45,41,4,44
Adelaide Utd,5436,5,11,6,11,37,40,-3,39
Brisbane,5436,6,10,5,13,33,42,-9,35
Western Sydn,5436,7,8,9,10,38,47,-9,33
Perth Glory,5436,8,10,2,15,37,50,-13,32
Wellington P,5436,9,5,6,16,31,55,-24,21
CC Mariners,5436,10,4,8,15,28,49,-21,20
Sydney FC,5437,1,21,4,3,67,22,45,67
N'castle Jet,5437,2,16,5,7,59,38,21,53
Melbourne C,5437,3,14,4,11,44,35,9,46
Melbourne V,5437,4,13,5,11,45,41,4,44
Adelaide Utd,5437,5,11,6,11,37,40,-3,39
Brisbane,5437,6,10,5,13,33,42,-9,35
Western Sydn,5437,7,8,9,10,38,47,-9,33
Perth Glory,5437,8,10,2,15,37,50,-13,32
Wellington P,5437,9,5,6,16,31,55,-24,21
CC Mariners,5437,10,4,8,15,28,49,-21,20
Sydney FC,5438,1,20,5,3,65,23,42,65
N'castle Jet,5438,2,16,5,7,60,39,21,53
Melbourne C,5438,3,14,4,11,45,36,9,46
Melbourne V,5438,4,13,6,10,46,39,7,45
Adelaide Utd,5438,5,11,6,11,37,40,-3,39
Brisbane,5438,6,10,5,13,33,42,-9,35
Western Sydn,5438,7,8,9,10,38,47,-9,33
Perth Glory,5438,8,10,2,15,37,50,-13,32
Wellington P,5438,9,5,6,16,31,55,-24,21
CC Mariners,5438,10,4,8,15,28,49,-21,20
Sydney FC,5439,1,20,4,4,64,24,40,64
N'castle Jet,5439,2,15,6,7,58,38,20,51
Melbourne C,5439,3,14,5,10,44,34,10,47
Melbourne V,5439,4,14,5,10,47,38,9,47
Adelaide Utd,5439,5,11,6,11,37,40,-3,39
Brisbane,5439,6,10,5,13,33,42,-9,35
Western Sydn,5439,7,8,9,10,38,47,-9,33
Perth Glory,5439,8,10,2,15,37,50,-13,32
Wellington P,5439,9,5,6,16,31,55,-24,21
CC Mariners,5439,10,4,8,15,28,49,-21,20
Sydney FC,5440,1,20,5,3,65,23,42,65
N'castle Jet,5440,2,15,6,7,58,38,20,51
Melbourne C,5440,3,14,5,10,44,34,10,47
Melbourne V,5440,4,13,6,10,46,39,7,45
Adelaide Utd,5440,5,11,6,11,37,40,-3,39
Brisbane,5440,6,10,5,13,33,42,-9,35
Western Sydn,5440,7,8,9,10,38,47,-9,33
Perth Glory,5440,8,10,2,15,37,50,-13,32
Wellington P,5440,9,5,6,16,31,55,-24,21
CC Mariners,5440,10,4,8,15,28,49,-21,20
Sydney FC,5441,1,21,4,3,68,22,46,67
N'castle Jet,5441,2,15,5,8,58,39,19,50
Melbourne C,5441,3,15,4,10,45,34,11,49
Melbourne V,5441,4,13,5,11,45,42,3,44
Adelaide Utd,5441,5,11,6,11,37,40,-3,39
Brisbane,5441,6,10,5,13,33,42,-9,35
Western Sydn,5441,7,8,9,10,38,47,-9,33
Perth Glory,5441,8,10,2,15,37,50,-13,32
Wellington P,5441,9,5,6,16,31,55,-24,21
CC Mariners,5441,10,4,8,15,28,49,-21,20
Sydney FC,5442,1,21,4,3,66,23,43,67
N'castle Jet,5442,2,15,6,7,59,39,20,51
Melbourne C,5442,3,14,5,10,45,35,10,47
Melbourne V,5442,4,13,5,11,46,40,6,44
Adelaide Utd,5442,5,11,6,11,37,40,-3,39
Brisbane,5442,6,10,5,13,33,42,-9,35
Western Sydn,5442,7,8,9,10,38,47,-9,33
Perth Glory,5442,8,10,2,15,37,50,-13,32
Wellington P,5442,9,5,6,16,31,55,-24,21
CC Mariners,5442,10,4,8,15,28,49,-21,20
Sydney FC,5443,1,21,4,3,67,23,44,67
N'castle Jet,5443,2,16,5,7,60,38,22,53
Melbourne C,5443,3,14,4,11,44,36,8,46
Melbourne V,5443,4,13,5,11,46,41,5,44
Adelaide Utd,5443,5,11,6,11,37,40,-3,39
Brisbane,5443,6,10,5,13,33,42,-9,35
Western Sydn,5443,7,8,9,10,38,47,-9,33
Perth Glory,5443,8,10,2,15,37,50,-13,32
Wellington P,5443,9,5,6,16,31,55,-24,21
CC Mariners,5443,10,4,8,15,28,49,-21,20
Sydney FC,5444,1,21,4,3,68,23,45,67
N'castle Jet,5444,2,16,5,7,59,38,21,53
Melbourne C,5444,3,14,4,11,44,35,9,46
Melbourne V,5444,4,13,5,11,46,42,4,44
Adelaide Utd,5444,5,11,6,11,37,40,-3,39
Brisbane,5444,6,10,5,13,33,42,-9,35
Western Sydn,5444,7,8,9,10,38,47,-9,33
Perth Glory,5444,8,10,2,15,37,50,-13,32
Wellington P,5444,9,5,6,16,31,55,-24,21
CC Mariners,5444,10,4,8,15,28,49,-21,20
Sydney FC,5445,1,20,4,4,65,24,41,64
N'castle Jet,5445,2,15,6,7,58,38,20,51
Melbourne C,5445,3,14,5,10,44,34,10,47
Melbourne V,5445,4,14,5,10,47,39,8,47
Adelaide Utd,5445,5,11,6,11,37,40,-3,39
Brisbane,5445,6,10,5,13,33,42,-9,35
Western Sydn,5445,7,8,9,10,38,47,-9,33
Perth Glory,5445,8,10,2,15,37,50,-13,32
Wellington P,5445,9,5,6,16,31,55,-24,21
CC Mariners,5445,10,4,8,15,28,49,-21,20
Sydney FC,5446,1,21,4,3,66,22,44,67
N'castle Jet,5446,2,16,5,7,58,37,21,53
Melbourne C,5446,3,14,4,11,43,34,9,46
Melbourne V,5446,4,13,5,11,45,40,5,44
Adelaide Utd,5446,5,11,6,11,37,40,-3,39
Brisbane,5446,6,10,5,13,33,42,-9,35
Western Sydn,5446,7,8,9,10,38,47,-9,33
Perth Glory,5446,8,10,2,15,37,50,-13,32
Wellington P,5446,9,5,6,16,31,55,-24,21
CC Mariners,5446,10,4,8,15,28,49,-21,20
Sydney FC,5447,1,20,4,4,66,25,41,64
N'castle Jet,5447,2,16,5,7,64,39,25,53
Melbourne V,5447,3,14,5,10,48,40,8,47
Melbourne C,5447,4,14,4,11,45,40,5,46
Adelaide Utd,5447,5,11,6,11,37,40,-3,39
Brisbane,5447,6,10,5,13,33,42,-9,35
Western Sydn,5447,7,8,9,10,38,47,-9,33
Perth Glory,5447,8,10,2,15,37,50,-13,32
Wellington P,5447,9,5,6,16,31,55,-24,21
CC Mariners,5447,10,4,8,15,28,49,-21,20
Sydney FC,5448,1,20,4,4,65,24,41,64
N'castle Jet,5448,2,15,5,8,58,39,19,50
Melbourne C,5448,3,15,4,10,45,34,11,49
Melbourne V,5448,4,14,5,10,47,39,8,47
Adelaide Utd,5448,5,11,6,11,37,40,-3,39
Brisbane,5448,6,10,5,13,33,42,-9,35
Western Sydn,5448,7,8,9,10,38,47,-9,33
Perth Glory,5448,8,10,2,15,37,50,-13,32
Wellington P,5448,9,5,6,16,31,55,-24,21
CC Mariners,5448,10,4,8,15,28,49,-21,20
Sydney FC,5449,1,21,4,3,68,23,45,67
N'castle Jet,5449,2,15,5,8,57,39,18,50
Melbourne C,5449,3,15,4,10,45,33,12,49
Melbourne V,5449,4,13,5,11,46,42,4,44
Adelaide Utd,5449,5,11,6,11,37,40,-3,39
Brisbane,5449,6,10,5,13,33,42,-9,35
Western Sydn,5449,7,8,9,10,38,47,-9,33
Perth Glory,5449,8,10,2,15,37,50,-13,32
Wellington P,5449,9,5,6,16,31,55,-24,21
CC Mariners,5449,10,4,8,15,28,49,-21,20
Sydney FC,5450,1,20,5,3,67,25,42,65
N'castle Jet,5450,2,15,6,7,60,40,20,51
Melbourne C,5450,3,14,5,10,46,36,10,47
Melbourne V,5450,4,13,6,10,48,41,7,45
Adelaide Utd,5450,5,11,6,11,37,40,-3,39
Brisbane,5450,6,10,5,13,33,42,-9,35
Western Sydn,5450,7,8,9,10,38,47,-9,33
Perth Glory,5450,8,10,2,15,37,50,-13,32
Wellington P,5450,9,5,6,16,31,55,-24,21
CC Mariners,5450,10,4,8,15,28,49,-21,20
Sydney FC,5451,1,21,4,3,66,23,43,67
N'castle Jet,5451,2,16,5,7,59,37,22,53
Melbourne C,5451,3,14,4,11,43,35,8,46
Melbourne V,5451,4,13,5,11,46,40,6,44
Adelaide Utd,5451,5,11,6,11,37,40,-3,39
Brisbane,5451,6,10,5,13,33,42,-9,35
Western Sydn,5451,7,8,9,10,38,47,-9,33
Perth Glory,5451,8,10,2,15,37,50,-13,32
Wellington P,5451,9,5,6,16,31,55,-24,21
CC Mariners,5451,10,4,8,15,28,49,-21,20
Sydney FC,5452,1,21,4,3,65,22,43,67
N'castle Jet,5452,2,15,5,8,58,39,19,50
Melbourne C,5452,3,15,4,10,45,34,11,49
Melbourne V,5452,4,13,5,11,45,39,6,44
Adelaide Utd,5452,5,11,6,11,37,40,-3,39
Brisbane,5452,6,10,5,13,33,42,-9,35
Western Sydn,5452,7,8,9,10,38,47,-9,33
Perth Glory,5452,8,10,2,15,37,50,-13,32
Wellington P,5452,9,5,6,16,31,55,-24,21
CC Mariners,5452,10,4,8,15,28,49,-21,20
Sydney FC,5453,1,21,4,3,65,22,43,67
N'castle Jet,5453,2,15,6,7,58,38,20,51
Melbourne C,5453,3,14,5,10,44,34,10,47
Melbourne V,5453,4,13,5,11,45,39,6,44
Adelaide Utd,5453,5,11,6,11,37,40,-3,39
Brisbane,5453,6,10,5,13,33,42,-9,35
Western Sydn,5453,7,8,9,10,38,47,-9,33
Perth Glory,5453,8,10,2,15,37,50,-13,32
Wellington P,5453,9,5,6,16,31,55,-24,21
CC Mariners,5453,10,4,8,15,28,49,-21,20
Sydney FC,5454,1,21,4,3,69,23,46,67
N'castle Jet,5454,2,15,5,8,58,41,17,50
Melbourne C,5454,3,15,4,10,47,34,13,49
Melbourne V,5454,4,13,5,11,46,43,3,44
Adelaide Utd,5454,5,11,6,11,37,40,-3,39
Brisbane,5454,6,10,5,13,33,42,-9,35
Western Sydn,5454,7,8,9,10,38,47,-9,33
Perth Glory,5454,8,10,2,15,37,50,-13,32
Wellington P,5454,9,5,6,16,31,55,-24,21
CC Mariners,5454,10,4,8,15,28,49,-21,20
Sydney FC,5455,1,20,5,3,64,22,42,65
N'castle Jet,5455,2,15,5,8,58,40,18,50
Melbourne C,5455,3,15,4,10,46,34,12,49
Melbourne V,5455,4,13,6,10,45,38,7,45
Adelaide Utd,5455,5,11,6,11,37,40,-3,39
Brisbane,5455,6,10,5,13,33,42,-9,35
Western Sydn,5455,7,8,9,10,38,47,-9,33
Perth Glory,5455,8,10,2,15,37,50,-13,32
Wellington P,5455,9,5,6,16,31,55,-24,21
CC Mariners,5455,10,4,8,15,28,49,-21,20
Sydney FC,5456,1,20,5,3,67,25,42,65
N'castle Jet,5456,2,16,5,7,59,38,21,53
Melbourne C,5456,3,14,4,11,44,35,9,46
Melbourne V,5456,4,13,6,10,48,41,7,45
Adelaide Utd,5456,5,11,6,11,37,40,-3,39
Brisbane,5456,6,10,5,13,33,42,-9,35
Western Sydn,5456,7,8,9,10,38,47,-9,33
Perth Glory,5456,8,10,2,15,37,50,-13,32
Wellington P,5456,9,5,6,16,31,55,-24,21
CC Mariners,5456,10,4,8,15,28,49,-21,20
Sydney FC,5457,1,21,4,3,66,23,43,67
N'castle Jet,5457,2,15,6,7,58,38,20,51
Melbourne C,5457,3,14,5,10,44,34,10,47
Melbourne V,5457,4,13,5,11,46,40,6,44
Adelaide Utd,5457,5,11,6,11,37,40,-3,39
Brisbane,5457,6,10,5,13,33,42,-9,35
Western Sydn,5457,7,8,9,10,38,47,-9,33
Perth Glory,5457,8,10,2,15,37,50,-13,32
Wellington P,5457,9,5,6,16,31,55,-24,21
CC Mariners,5457,10,4,8,15,28,49,-21,20
Sydney FC,5458,1,21,4,3,65,22,43,67
N'castle Jet,5458,2,15,5,8,57,40,17,50
Melbourne C,5458,3,15,4,10,46,33,13,49
Melbourne V,5458,4,13,5,11,45,39,6,44
Adelaide Utd,5458,5,11,6,11,37,40,-3,39
Brisbane,5458,6,10,5,13,33,42,-9,35
Western Sydn,5458,7,8,9,10,38,47,-9,33
Perth Glory,5458,8,10,2,15,37,50,-13,32
Wellington P,5458,9,5,6,16,31,55,-24,21
CC Mariners,5458,10,4,8,15,28,49,-21,20
Sydney FC,5459,1,21,4,3,65,22,43,67
N'castle Jet,5459,2,15,6,7,60,40,20,51
Melbourne C,5459,3,14,5,10,46,36,10,47
Melbourne V,5459,4,13,5,11,45,39,6,44
Adelaide Utd,5459,5,11,6,11,37,40,-3,39
Brisbane,5459,6,10,5,13,33,42,-9,35
Western Sydn,5459,7,8,9,10,38,47,-9,33
Perth Glory,5459,8,10,2,15,37,50,-13,32
Wellington P,5459,9,5,6,16,31,55,-24,21
CC Mariners,5459,10,4,8,15,28,49,-21,20
Sydney FC,5460,1,21,4,3,66,22,44,67
N'castle Jet,5460,2,15,6,7,58,38,20,51
Melbourne C,5460,3,14,5,10,44,34,10,47
Melbourne V,5460,4,13,5,11,45,40,5,44
Adelaide Utd,5460,5,11,6,11,37,40,-3,39
Brisbane,5460,6,10,5,13,33,42,-9,35
Western Sydn,5460,7,8,9,10,38,47,-9,33
Perth Glory,5460,8,10,2,15,37,50,-13,32
Wellington P,5460,9,5,6,16,31,55,-24,21
CC Mariners,5460,10,4,8,15,28,49,-21,20
Sydney FC,5461,1,20,4,4,65,25,40,64
N'castle Jet,5461,2,15,5,8,57,40,17,50
Melbourne C,5461,3,15,4,10,46,33,13,49
Melbourne V,5461,4,14,5,10,48,39,9,47
Adelaide Utd,5461,5,11,6,11,37,40,-3,39
Brisbane,5461,6,10,5,13,33,42,-9,35
Western Sydn,5461,7,8,9,10,38,47,-9,33
Perth Glory,5461,8,10,2,15,37,50,-13,32
Wellington P,5461,9,5,6,16,31,55,-24,21
CC Mariners,5461,10,4,8,15,28,49,-21,20
Sydney FC,5462,1,20,5,3,66,24,42,65
N'castle Jet,5462,2,15,6,7,57,37,20,51
Melbourne C,5462,3,14,5,10,43,33,10,47
Melbourne V,5462,4,13,6,10,47,40,7,45
Adelaide Utd,5462,5,11,6,11,37,40,-3,39
Brisbane,5462,6,10,5,13,33,42,-9,35
Western Sydn,5462,7,8,9,10,38,47,-9,33
Perth Glory,5462,8,10,2,15,37,50,-13,32
Wellington P,5462,9,5,6,16,31,55,-24,21
CC Mariners,5462,10,4,8,15,28,49,-21,20
Sydney FC,5463,1,20,4,4,64,23,41,64
N'castle Jet,5463,2,16,5,7,62,38,24,53
Melbourne V,5463,3,14,5,10,46,38,8,47
Melbourne C,5463,4,14,4,11,44,38,6,46
Adelaide Utd,5463,5,11,6,11,37,40,-3,39
Brisbane,5463,6,10,5,13,33,42,-9,35
Western Sydn,5463,7,8,9,10,38,47,-9,33
Perth Glory,5463,8,10,2,15,37,50,-13,32
Wellington P,5463,9,5,6,16,31,55,-24,21
CC Mariners,5463,10,4,8,15,28,49,-21,20
Sydney FC,5464,1,21,4,3,66,22,44,67
N'castle Jet,5464,2,15,6,7,59,39,20,51
Melbourne C,5464,3,14,5,10,45,35,10,47
Melbourne V,5464,4,13,5,11,45,40,5,44
Adelaide Utd,5464,5,11,6,11,37,40,-3,39
Brisbane,5464,6,10,5,13,33,42,-9,35
Western Sydn,5464,7,8,9,10,38,47,-9,33
Perth Glory,5464,8,10,2,15,37,50,-13,32
Wellington P,5464,9,5,6,16,31,55,-24,21
CC Mariners,5464,10,4,8,15,28,49,-21,20
Sydney FC,5465,1,21,4,3,66,23,43,67
N'castle Jet,5465,2,15,5,8,58,39,19,50
Melbourne C,5465,3,15,4,10,45,34,11,49
Melbourne V,5465,4,13,5,11,46,40,6,44
Adelaide Utd,5465,5,11,6,11,37,40,-3,39
Brisbane,5465,6,10,5,13,33,42,-9,35
Western Sydn,5465,7,8,9,10,38,47,-9,33
Perth Glory,5465,8,10,2,15,37,50,-13,32
Wellington P,5465,9,5,6,16,31,55,-24,21
CC Mariners,5465,10,4,8,15,28,49,-21,20
Sydney FC,5466,1,21,4,3,66,22,44,67
N'castle Jet,5466,2,16,5,7,60,39,21,53
Melbourne C,5466,3,14,4,11,45,36,9,46
Melbourne V,5466,4,13,5,11,45,40,5,44
Adelaide Utd,5466,5,11,6,11,37,40,-3,39
Brisbane,5466,6,10,5,13,33,42,-9,35
Western Sydn,5466,7,8,9,10,38,47,-9,33
Perth Glory,5466,8,10,2,15,37,50,-13,32
Wellington P,5466,9,5,6,16,31,55,-24,21
CC Mariners,5466,10,4,8,15,28,49,-21,20
Sydney FC,5467,1,20,4,4,64,23,41,64
N'castle Jet,5467,2,16,5,7,61,38,23,53
Melbourne V,5467,3,14,5,10,46,38,8,47
Melbourne C,5467,4,14,4,11,44,37,7,46
Adelaide Utd,5467,5,11,6,11,37,40,-3,39
Brisbane,5467,6,10,5,13,33,42,-9,35
Western Sydn,5467,7,8,9,10,38,47,-9,33
Perth Glory,5467,8,10,2,15,37,50,-13,32
Wellington P,5467,9,5,6,16,31,55,-24,21
CC Mariners,5467,10,4,8,15,28,49,-21,20
Sydney FC,5468,1,21,4,3,65,22,43,67
N'castle Jet,5468,2,16,5,7,60,38,22,53
Melbourne C,5468,3,14,4,11,44,36,8,46
Melbourne V,5468,4,13,5,11,45,39,6,44
Adelaide Utd,5468,5,11,6,11,37,40,-3,39
Brisbane,5468,6,10,5,13,33,42,-9,35
Western Sydn,5468,7,8,9,10,38,47,-9,33
Perth Glory,5468,8,10,2,15,37,50,-13,32
Wellington P,5468,9,5,6,16,31,55,-24,21
CC Mariners,5468,10,4,8,15,28,49,-21,20
Sydney FC,5469,1,21,4,3,66,23,43,67
N'castle Jet,5469,2,16,5,7,58,37,21,53
Melbourne C,5469,3,14,4,11,43,34,9,46
Melbourne V,5469,4,13,5,11,46,40,6,44
Adelaide Utd,5469,5,11,6,11,37,40,-3,39
Brisbane,5469,6,10,5,13,33,42,-9,35
Western Sydn,5469,7,8,9,10,38,47,-9,33
Perth Glory,5469,8,10,2,15,37,50,-13,32
Wellington P,5469,9,5,6,16,31,55,-24,21
CC Mariners,5469,10,4,8,15,28,49,-21,20
Sydney FC,5470,1,21,4,3,66,23,43,67
N'castle Jet,5470,2,16,5,7,58,37,21,53
Melbourne C,5470,3,14,4,11,43,34,9,46
Melbourne V,5470,4,13,5,11,46,40,6,44
Adelaide Utd,5470,5,11,6,11,37,40,-3,39
Brisbane,5470,6,10,5,13,33,42,-9,35
Western Sydn,5470,7,8,9,10,38,47,-9,33
Perth Glory,5470,8,10,2,15,37,50,-13,32
Wellington P,5470,9,5,6,16,31,55,-24,21
CC Mariners,5470,10,4,8,15,28,49,-21,20
Sydney FC,5471,1,21,4,3,69,22,47,67
N'castle Jet,5471,2,15,6,7,57,37,20,51
Melbourne C,5471,3,14,5,10,43,33,10,47
Melbourne V,5471,4,13,5,11,45,43,2,44
Adelaide Utd,5471,5,11,6,11,37,40,-3,39
Brisbane,5471,6,10,5,13,33,42,-9,35
Western Sydn,5471,7,8,9,10,38,47,-9,33
Perth Glory,5471,8,10,2,15,37,50,-13,32
Wellington P,5471,9,5,6,16,31,55,-24,21
CC Mariners,5471,10,4,8,15,28,49,-21,20
Sydney FC,5472,1,20,5,3,67,25,42,65
N'castle Jet,5472,2,16,5,7,58,37,21,53
Melbourne C,5472,3,14,4,11,43,34,9,46
Melbourne V,5472,4,13,6,10,48,41,7,45
Adelaide Utd,5472,5,11,6,11,37,40,-3,39
Brisbane,5472,6,10,5,13,33,42,-9,35
Western Sydn,5472,7,8,9,10,38,47,-9,33
Perth Glory,5472,8,10,2,15,37,50,-13,32
Wellington P,5472,9,5,6,16,31,55,-24,21
CC Mariners,5472,10,4,8,15,28,49,-21,20
Sydney FC,5473,1,20,5,3,65,23,42,65
N'castle Jet,5473,2,15,6,7,58,38,20,51
Melbourne C,5473,3,14,5,10,44,34,10,47
Melbourne V,5473,4,13,6,10,46,39,7,45
Adelaide Utd,5473,5,11,6,11,37,40,-3,39
Brisbane,5473,6,10,5,13,33,42,-9,35
Western Sydn,5473,7,8,9,10,38,47,-9,33
Perth Glory,5473,8,10,2,15,37,50,-13,32
Wellington P,5473,9,5,6,16,31,55,-24,21
CC Mariners,5473,10,4,8,15,28,49,-21,20
Sydney FC,5474,1,20,4,4,65,24,41,64
N'castle Jet,5474,2,16,5,7,59,37,22,53
Melbourne V,5474,3,14,5,10,47,39,8,47
Melbourne C,5474,4,14,4,11,43,35,8,46
Adelaide Utd,5474,5,11,6,11,37,40,-3,39
Brisbane,5474,6,10,5,13,33,42,-9,35
Western Sydn,5474,7,8,9,10,38,47,-9,33
Perth Glory,5474,8,10,2,15,37,50,-13,32
Wellington P,5474,9,5,6,16,31,55,-24,21
CC Mariners,5474,10,4,8,15,28,49,-21,20
Sydney FC,5475,1,20,4,4,65,25,40,64
N'castle Jet,5475,2,15,6,7,58,38,20,51
Melbourne C,5475,3,14,5,10,44,34,10,47
Melbourne V,5475,4,14,5,10,48,39,9,47
Adelaide Utd,5475,5,11,6,11,37,40,-3,39
Brisbane,5475,6,10,5,13,33,42,-9,35
Western Sydn,5475,7,8,9,10,38,47,-9,33
Perth Glory,5475,8,10,2,15,37,50,-13,32
Wellington P,5475,9,5,6,16,31,55,-24,21
CC Mariners,5475,10,4,8,15,28,49,-21,20
Sydney FC,5476,1,20,5,3,64,22,42,65
N'castle Jet,5476,2,16,5,7,61,40,21,53
Melbourne C,5476,3,14,4,11,46,37,9,46
Melbourne V,5476,4,13,6,10,45,38,7,45
Adelaide Utd,5476,5,11,6,11,37,40,-3,39
Brisbane,5476,6,10,5,13,33,42,-9,35
Western Sydn,5476,7,8,9,10,38,47,-9,33
Perth Glory,5476,8,10,2,15,37,50,-13,32
Wellington P,5476,9,5,6,16,31,55,-24,21
CC Mariners,5476,10,4,8,15,28,49,-21,20
Sydney FC,5477,1,21,4,3,68,22,46,67
N'castle Jet,5477,2,15,6,7,57,37,20,51
Melbourne C,5477,3,14,5,10,43,33,10,47
Melbourne V,5477,4,13,5,11,45,42,3,44
Adelaide Utd,5477,5,11,6,11,37,40,-3,39
Brisbane,5477,6,10,5,13,33,42,-9,35
Western Sydn,5477,7,8,9,10,38,47,-9,33
Perth Glory,5477,8,10,2,15,37,50,-13,32
Wellington P,5477,9,5,6,16,31,55,-24,21
CC Mariners,5477,10,4,8,15,28,49,-21,20
Sydney FC,5478,1,20,5,3,64,22,42,65
N'castle Jet,5478,2,16,5,7,58,37,21,53
Melbourne C,5478,3,14,4,11,43,34,9,46
Melbourne V,5478,4,13,6,10,45,38,7,45
Adelaide Utd,5478,5,11,6,11,37,40,-3,39
Brisbane,5478,6,10,5,13,33,42,-9,35
Western Sydn,5478,7,8,9,10,38,47,-9,33
Perth Glory,5478,8,10,2,15,37,50,-13,32
Wellington P,5478,9,5,6,16,31,55,-24,21
CC Mariners,5478,10,4,8,15,28,49,-21,20
Sydney FC,5479,1,21,4,3,66,22,44,67
N'castle Jet,5479,2,16,5,7,59,37,22,53
Melbourne C,5479,3,14,4,11,43,35,8,46
Melbourne V,5479,4,13,5,11,45,40,5,44
Adelaide Utd,5479,5,11,6,11,37,40,-3,39
Brisbane,5479,6,10,5,13,33,42,-9,35
Western Sydn,5479,7,8,9,10,38,47,-9,33
Perth Glory,5479,8,10,2,15,37,50,-13,32
Wellington P,5479,9,5,6,16,31,55,-24,21
CC Mariners,5479,10,4,8,15,28,49,-21,20
Sydney FC,5480,1,20,4,4,64,23,41,64
N'castle Jet,5480,2,16,5,7,60,38,22,53
Melbourne V,5480,3,14,5,10,46,38,8,47
Melbourne C,5480,4,14,4,11,44,36,8,46
Adelaide Utd,5480,5,11,6,11,37,40,-3,39
Brisbane,5480,6,10,5,13,33,42,-9,35
Western Sydn,5480,7,8,9,10,38,47,-9,33
Perth Glory,5480,8,10,2,15,37,50,-13,32
Wellington P,5480,9,5,6,16,31,55,-24,21
CC Mariners,5480,10,4,8,15,28,49,-21,20
Sydney FC,5481,1,21,4,3,66,22,44,67
N'castle Jet,5481,2,15,6,7,58,38,20,51
Melbourne C,5481,3,14,5,10,44,34,10,47
Melbourne V,5481,4,13,5,11,45,40,5,44
Adelaide Utd,5481,5,11,6,11,37,40,-3,39
Brisbane,5481,6,10,5,13,33,42,-9,35
Western Sydn,5481,7,8,9,10,38,47,-9,33
Perth Glory,5481,8,10,2,15,37,50,-13,32
Wellington P,5481,9,5,6,16,31,55,-24,21
CC Mariners,5481,10,4,8,15,28,49,-21,20
Sydney FC,5482,1,21,4,3,66,22,44,67
N'castle Jet,5482,2,16,5,7,60,38,22,53
Melbourne C,5482,3,14,4,11,44,36,8,46
Melbourne V,5482,4,13,5,11,45,40,5,44
Adelaide Utd,5482,5,11,6,11,37,40,-3,39
Brisbane,5482,6,10,5,13,33,42,-9,35
Western Sydn,5482,7,8,9,10,38,47,-9,33
Perth Glory,5482,8,10,2,15,37,50,-13,32
Wellington P,5482,9,5,6,16,31,55,-24,21
CC Mariners,5482,10,4,8,15,28,49,-21,20
Sydney FC,5483,1,21,4,3,69,25,44,67
N'castle Jet,5483,2,15,5,8,58,40,18,50
Melbourne C,5483,3,15,4,10,46,34,12,49
Melbourne V,5483,4,13,5,11,48,43,5,44
Adelaide Utd,5483,5,11,6,11,37,40,-3,39
Brisbane,5483,6,10,5,13,33,42,-9,35
Western Sydn,5483,7,8,9,10,38,47,-9,33
Perth Glory,5483,8,10,2,15,37,50,-13,32
Wellington P,5483,9,5,6,16,31,55,-24,21
CC Mariners,5483,10,4,8,15,28,49,-21,20
Sydney FC,5484,1,21,4,3,69,23,46,67
N'castle Jet,5484,2,15,6,7,58,38,20,51
Melbourne C,5484,3,14,5,10,44,34,10,47
Melbourne V,5484,4,13,5,11,46,43,3,44
Adelaide Utd,5484,5,11,6,11,37,40,-3,39
Brisbane,5484,6,10,5,13,33,42,-9,35
Western Sydn,5484,7,8,9,10,38,47,-9,33
Perth Glory,5484,8,10,2,15,37,50,-13,32
Wellington P,5484,9,5,6,16,31,55,-24,21
CC Mariners,5484,10,4,8,15,28,49,-21,20
Sydney FC,5485,1,21,4,3,67,22,45,67
N'castle Jet,5485,2,15,5,8,57,38,19,50
Melbourne C,5485,3,15,4,10,44,33,11,49
Melbourne V,5485,4,13,5,11,45,41,4,44
Adelaide Utd,5485,5,11,6,11,37,40,-3,39
Brisbane,5485,6,10,5,13,33,42,-9,35
Western Sydn,5485,7,8,9,10,38,47,-9,33
Perth Glory,5485,8,10,2,15,37,50,-13,32
Wellington P,5485,9,5,6,16,31,55,-24,21
CC Mariners,5485,10,4,8,15,28,49,-21,20
Sydney FC,5486,1,21,4,3,67,22,45,67
N'castle Jet,5486,2,15,5,8,59,40,19,50
Melbourne C,5486,3,15,4,10,46,35,11,49
Melbourne V,5486,4,13,5,11,45,41,4,44
Adelaide Utd,5486,5,11,6,11,37,40,-3,39
Brisbane,5486,6,10,5,13,33,42,-9,35
Western Sydn,5486,7,8,9,10,38,47,-9,33
Perth Glory,5486,8,10,2,15,37,50,-13,32
Wellington P,5486,9,5,6,16,31,55,-24,21
CC Mariners,5486,10,4,8,15,28,49,-21,20
Sydney FC,5487,1,21,4,3,65,22,43,67
N'castle Jet,5487,2,15,6,7,58,38,20,51
Melbourne C,5487,3,14,5,10,44,34,10,47
Melbourne V,5487,4,13,5,11,45,39,6,44
Adelaide Utd,5487,5,11,6,11,37,40,-3,39
Brisbane,5487,6,10,5,13,33,42,-9,35
Western Sydn,5487,7,8,9,10,38,47,-9,33
Perth Glory,5487,8,10,2,15,37,50,-13,32
Wellington P,5487,9,5,6,16,31,55,-24,21
CC Mariners,5487,10,4,8,15,28,49,-21,20
Sydney FC,5488,1,21,4,3,65,22,43,67
N'castle Jet,5488,2,16,5,7,59,38,21,53
Melbourne C,5488,3,14,4,11,44,35,9,46
Melbourne V,5488,4,13,5,11,45,39,6,44
Adelaide Utd,5488,5,11,6,11,37,40,-3,39
Brisbane,5488,6,10,5,13,33,42,-9,35
Western Sydn,5488,7,8,9,10,38,47,-9,33
Perth Glory,5488,8,10,2,15,37,50,-13,32
Wellington P,5488,9,5,6,16,31,55,-24,21
CC Mariners,5488,10,4,8,15,28,49,-21,20
Sydney FC,5489,1,20,4,4,64,23,41,64
N'castle Jet,5489,2,15,5,8,58,39,19,50
Melbourne C,5489,3,15,4,10,45,34,11,49
Melbourne V,5489,4,14,5,10,46,38,8,47
Adelaide Utd,5489,5,11,6,11,37,40,-3,39
Brisbane,5489,6,10,5,13,33,42,-9,35
Western Sydn,5489,7,8,9,10,38,47,-9,33
Perth Glory,5489,8,10,2,15,37,50,-13,32
Wellington P,5489,9,5,6,16,31,55,-24,21
CC Mariners,5489,10,4,8,15,28,49,-21,20
Sydney FC,5490,1,21,4,3,67,23,44,67
N'castle Jet,5490,2,16,5,7,59,38,21,53
Melbourne C,5490,3,14,4,11,44,35,9,46
Melbourne V,5490,4,13,5,11,46,41,5,44
Adelaide Utd,5490,5,11,6,11,37,40,-3,39
Brisbane,5490,6,10,5,13,33,42,-9,35
Western Sydn,5490,7,8,9,10,38,47,-9,33
Perth Glory,5490,8,10,2,15,37,50,-13,32
Wellington P,5490,9,5,6,16,31,55,-24,21
CC Mariners,5490,10,4,8,15,28,49,-21,20
Sydney FC,5491,1,21,4,3,66,23,43,67
N'castle Jet,5491,2,16,5,7,61,38,23,53
Melbourne C,5491,3,14,4,11,44,37,7,46
Melbourne V,5491,4,13,5,11,46,40,6,44
Adelaide Utd,5491,5,11,6,11,37,40,-3,39
Brisbane,5491,6,10,5,13,33,42,-9,35
Western Sydn,5491,7,8,9,10,38,47,-9,33
Perth Glory,5491,8,10,2,15,37,50,-13,32
Wellington P,5491,9,5,6,16,31,55,-24,21
CC Mariners,5491,10,4,8,15,28,49,-21,20
Sydney FC,5492,1,21,4,3,66,23,43,67
N'castle Jet,5492,2,16,5,7,61,37,24,53
Melbourne C,5492,3,14,4,11,43,37,6,46
Melbourne V,5492,4,13,5,11,46,40,6,44
Adelaide Utd,5492,5,11,6,11,37,40,-3,39
Brisbane,5492,6,10,5,13,33,42,-9,35
Western Sydn,5492,7,8,9,10,38,47,-9,33
Perth Glory,5492,8,10,2,15,37,50,-13,32
Wellington P,5492,9,5,6,16,31,55,-24,21
CC Mariners,5492,10,4,8,15,28,49,-21,20
Sydney FC,5493,1,20,5,3,65,23,42,65
N'castle Jet,5493,2,15,6,7,58,38,20,51
Melbourne C,5493,3,14,5,10,44,34,10,47
Melbourne V,5493,4,13,6,10,46,39,7,45
Adelaide Utd,5493,5,11,6,11,37,40,-3,39
Brisbane,5493,6,10,5,13,33,42,-9,35
Western Sydn,5493,7,8,9,10,38,47,-9,33
Perth Glory,5493,8,10,2,15,37,50,-13,32
Wellington P,5493,9,5,6,16,31,55,-24,21
CC Mariners,5493,10,4,8,15,28,49,-21,20
Sydney FC,5494,1,21,4,3,68,22,46,67
N'castle Jet,5494,2,15,5,8,57,40,17,50
Melbourne C,5494,3,15,4,10,46,33,13,49
Melbourne V,5494,4,13,5,11,45,42,3,44
Adelaide Utd,5494,5,11,6,11,37,40,-3,39
Brisbane,5494,6,10,5,13,33,42,-9,35
Western Sydn,5494,7,8,9,10,38,47,-9,33
Perth Glory,5494,8,10,2,15,37,50,-13,32
Wellington P,5494,9,5,6,16,31,55,-24,21
CC Mariners,5494,10,4,8,15,28,49,-21,20
Sydney FC,5495,1,21,4,3,65,22,43,67
N'castle Jet,5495,2,15,6,7,58,38,20,51
Melbourne C,5495,3,14,5,10,44,34,10,47
Melbourne V,5495,4,13,5,11,45,39,6,44
Adelaide Utd,5495,5,11,6,11,37,40,-3,39
Brisbane,5495,6,10,5,13,33,42,-9,35
Western Sydn,5495,7,8,9,10,38,47,-9,33
Perth Glory,5495,8,10,2,15,37,50,-13,32
Wellington P,5495,9,5,6,16,31,55,-24,21
CC Mariners,5495,10,4,8,15,28,49,-21,20
Sydney FC,5496,1,21,4,3,66,22,44,67
N'castle Jet,5496,2,16,5,7,60,39,21,53
Melbourne C,5496,3,14,4,11,45,36,9,46
Melbourne V,5496,4,13,5,11,45,40,5,44
Adelaide Utd,5496,5,11,6,11,37,40,-3,39
Brisbane,5496,6,10,5,13,33,42,-9,35
Western Sydn,5496,7,8,9,10,38,47,-9,33
Perth Glory,5496,8,10,2,15,37,50,-13,32
Wellington P,5496,9,5,6,16,31,55,-24,21
CC Mariners,5496,10,4,8,15,28,49,-21,20
Sydney FC,5497,1,20,4,4,64,23,41,64
N'castle Jet,5497,2,16,5,7,58,37,21,53
Melbourne V,5497,3,14,5,10,46,38,8,47
Melbourne C,5497,4,14,4,11,43,34,9,46
Adelaide Utd,5497,5,11,6,11,37,40,-3,39
Brisbane,5497,6,10,5,13,33,42,-9,35
Western Sydn,5497,7,8,9,10,38,47,-9,33
Perth Glory,5497,8,10,2,15,37,50,-13,32
Wellington P,5497,9,5,6,16,31,55,-24,21
CC Mariners,5497,10,4,8,15,28,49,-21,20
Sydney FC,5498,1,21,4,3,68,22,46,67
N'castle Jet,5498,2,15,6,7,57,37,20,51
Melbourne C,5498,3,14,5,10,43,33,10,47
Melbourne V,5498,4,13,5,11,45,42,3,44
Adelaide Utd,5498,5,11,6,11,37,40,-3,39
Brisbane,5498,6,10,5,13,33,42,-9,35
Western Sydn,5498,7,8,9,10,38,47,-9,33
Perth Glory,5498,8,10,2,15,37,50,-13,32
Wellington P,5498,9,5,6,16,31,55,-24,21
CC Mariners,5498,10,4,8,15,28,49,-21,20
Sydney FC,5499,1,21,4,3,69,22,47,67
N'castle Jet,5499,2,15,6,7,58,38,20,51
Melbourne C,5499,3,14,5,10,44,34,10,47
Melbourne V,5499,4,13,5,11,45,43,2,44
Adelaide Utd,5499,5,11,6,11,37,40,-3,39
Brisbane,5499,6,10,5,13,33,42,-9,35
Western Sydn,5499,7,8,9,10,38,47,-9,33
Perth Glory,5499,8,10,2,15,37,50,-13,32
Wellington P,5499,9,5,6,16,31,55,-24,21
CC Mariners,5499,10,4,8,15,28,49,-21,20
Sydney FC,5500,1,21,4,3,69,24,45,67
N'castle Jet,5500,2,15,6,7,58,38,20,51
Melbourne C,5500,3,14,5,10,44,34,10,47
Melbourne V,5500,4,13,5,11,47,43,4,44
Adelaide Utd,5500,5,11,6,11,37,40,-3,39
Brisbane,5500,6,10,5,13,33,42,-9,35
Western Sydn,5500,7,8,9,10,38,47,-9,33
Perth Glory,5500,8,10,2,15,37,50,-13,32
Wellington P,5500,9,5,6,16,31,55,-24,21
CC Mariners,5500,10,4,8,15,28,49,-21,20
Sydney FC,5501,1,21,4,3,69,23,46,67
N'castle Jet,5501,2,16,5,7,58,37,21,53
Melbourne C,5501,3,14,4,11,43,34,9,46
Melbourne V,5501,4,13,5,11,46,43,3,44
Adelaide Utd,5501,5,11,6,11,37,40,-3,39
Brisbane,5501,6,10,5,13,33,42,-9,35
Western Sydn,5501,7,8,9,10,38,47,-9,33
Perth Glory,5501,8,10,2,15,37,50,-13,32
Wellington P,5501,9,5,6,16,31,55,-24,21
CC Mariners,5501,10,4,8,15,28,49,-21,20
Sydney FC,5502,1,21,4,3,67,23,44,67
N'castle Jet,5502,2,15,5,8,57,38,19,50
Melbourne C,5502,3,15,4,10,44,33,11,49
Melbourne V,5502,4,13,5,11,46,41,5,44
Adelaide Utd,5502,5,11,6,11,37,40,-3,39
Brisbane,5502,6,10,5,13,33,42,-9,35
Western Sydn,5502,7,8,9,10,38,47,-9,33
Perth Glory,5502,8,10,2,15,37,50,-13,32
Wellington P,5502,9,5,6,16,31,55,-24,21
CC Mariners,5502,10,4,8,15,28,49,-21,20
Sydney FC,5503,1,21,4,3,67,23,44,67
N'castle Jet,5503,2,16,5,7,59,37,22,53
Melbourne C,5503,3,14,4,11,43,35,8,46
Melbourne V,5503,4,13,5,11,46,41,5,44
Adelaide Utd,5503,5,11,6,11,37,40,-3,39
Brisbane,5503,6,10,5,13,33,42,-9,35
Western Sydn,5503,7,8,9,10,38,47,-9,33
Perth Glory,5503,8,10,2,15,37,50,-13,32
Wellington P,5503,9,5,6,16,31,55,-24,21
CC Mariners,5503,10,4,8,15,28,49,-21,20
Sydney FC,5504,1,20,4,4,66,25,41,64
N'castle Jet,5504,2,15,5,8,57,38,19,50
Melbourne C,5504,3,15,4,10,44,33,11,49
Melbourne V,5504,4,14,5,10,48,40,8,47
Adelaide Utd,5504,5,11,6,11,37,40,-3,39
Brisbane,5504,6,10,5,13,33,42,-9,35
Western Sydn,5504,7,8,9,10,38,47,-9,33
Perth Glory,5504,8,10,2,15,37,50,-13,32
Wellington P,5504,9,5,6,16,31,55,-24,21
CC Mariners,5504,10,4,8,15,28,49,-21,20
Sydney FC,5505,1,21,4,3,68,24,44,67
N'castle Jet,5505,2,16,5,7,60,39,21,53
Melbourne C,5505,3,14,4,11,45,36,9,46
Melbourne V,5505,4,13,5,11,47,42,5,44
Adelaide Utd,5505,5,11,6,11,37,40,-3,39
Brisbane,5505,6,10,5,13,33,42,-9,35
Western Sydn,5505,7,8,9,10,38,47,-9,33
Perth Glory,5505,8,10,2,15,37,50,-13,32
Wellington P,5505,9,5,6,16,31,55,-24,21
CC Mariners,5505,10,4,8,15,28,49,-21,20
Sydney FC,5506,1,21,4,3,65,22,43,67
N'castle Jet,5506,2,15,6,7,58,38,20,51
Melbourne C,5506,3,14,5,10,44,34,10,47
Melbourne V,5506,4,13,5,11,45,39,6,44
Adelaide Utd,5506,5,11,6,11,37,40,-3,39
Brisbane,5506,6,10,5,13,33,42,-9,35
Western Sydn,5506,7,8,9,10,38,47,-9,33
Perth Glory,5506,8,10,2,15,37,50,-13,32
Wellington P,5506,9,5,6,16,31,55,-24,21
CC Mariners,5506,10,4,8,15,28,49,-21,20
Sydney FC,5507,1,21,4,3,67,24,43,67
N'castle Jet,5507,2,16,5,7,59,38,21,53
Melbourne C,5507,3,14,4,11,44,35,9,46
Melbourne V,5507,4,13,5,11,47,41,6,44
Adelaide Utd,5507,5,11,6,11,37,40,-3,39
Brisbane,5507,6,10,5,13,33,42,-9,35
Western Sydn,5507,7,8,9,10,38,47,-9,33
Perth Glory,5507,8,10,2,15,37,50,-13,32
Wellington P,5507,9,5,6,16,31,55,-24,21
CC Mariners,5507,10,4,8,15,28,49,-21,20
Sydney FC,5508,1,21,4,3,65,22,43,67
N'castle Jet,5508,2,16,5,7,58,37,21,53
Melbourne C,5508,3,14,4,11,43,34,9,46
Melbourne V,5508,4,13,5,11,45,39,6,44
Adelaide Utd,5508,5,11,6,11,37,40,-3,39
Brisbane,5508,6,10,5,13,33,42,-9,35
Western Sydn,5508,7,8,9,10,38,47,-9,33
Perth Glory,5508,8,10,2,15,37,50,-13,32
Wellington P,5508,9,5,6,16,31,55,-24,21
CC Mariners,5508,10,4,8,15,28,49,-21,20
Sydney FC,5509,1,20,5,3,65,23,42,65
N'castle Jet,5509,2,15,5,8,58,39,19,50
Melbourne C,5509,3,15,4,10,45,34,11,49
Melbourne V,5509,4,13,6,10,46,39,7,45
Adelaide Utd,5509,5,11,6,11,37,40,-3,39
Brisbane,5509,6,10,5,13,33,42,-9,35
Western Sydn,5509,7,8,9,10,38,47,-9,33
Perth Glory,5509,8,10,2,15,37,50,-13,32
Wellington P,5509,9,5,6,16,31,55,-24,21
CC Mariners,5509,10,4,8,15,28,49,-21,20
Sydney FC,5510,1,20,4,4,65,25,40,64
N'castle Jet,5510,2,16,5,7,58,37,21,53
Melbourne V,5510,3,14,5,10,48,39,9,47
Melbourne C,5510,4,14,4,11,43,34,9,46
Adelaide Utd,5510,5,11,6,11,37,40,-3,39
Brisbane,5510,6,10,5,13,33,42,-9,35
Western Sydn,5510,7,8,9,10,38,47,-9,33
Perth Glory,5510,8,10,2,15,37,50,-13,32
Wellington P,5510,9,5,6,16,31,55,-24,21
CC Mariners,5510,10,4,8,15,28,49,-21,20
Sydney FC,5511,1,20,4,4,65,28,37,64
N'castle Jet,5511,2,15,5,8,57,38,19,50
Melbourne C,5511,3,15,4,10,44,33,11,49
Melbourne V,5511,4,14,5,10,51,39,12,47
Adelaide Utd,5511,5,11,6,11,37,40,-3,39
Brisbane,5511,6,10,5,13,33,42,-9,35
Western Sydn,5511,7,8,9,10,38,47,-9,33
Perth Glory,5511,8,10,2,15,37,50,-13,32
Wellington P,5511,9,5,6,16,31,55,-24,21
CC Mariners,5511,10,4,8,15,28,49,-21,20
Sydney FC,5512,1,21,4,3,66,23,43,67
N'castle Jet,5512,2,16,5,7,59,37,22,53
Melbourne C,5512,3,14,4,11,43,35,8,46
Melbourne V,5512,4,13,5,11,46,40,6,44
Adelaide Utd,5512,5,11,6,11,37,40,-3,39
Brisbane,5512,6,10,5,13,33,42,-9,35
Western Sydn,5512,7,8,9,10,38,47,-9,33
Perth Glory,5512,8,10,2,15,37,50,-13,32
Wellington P,5512,9,5,6,16,31,55,-24,21
CC Mariners,5512,10,4,8,15,28,49,-21,20
Sydney FC,5513,1,20,5,3,64,22,42,65
N'castle Jet,5513,2,15,6,7,57,37,20,51
Melbourne C,5513,3,14,5,10,43,33,10,47
Melbourne V,5513,4,13,6,10,45,38,7,45
Adelaide Utd,5513,5,11,6,11,37,40,-3,39
Brisbane,5513,6,10,5,13,33,42,-9,35
Western Sydn,5513,7,8,9,10,38,47,-9,33
Perth Glory,5513,8,10,2,15,37,50,-13,32
Wellington P,5513,9,5,6,16,31,55,-24,21
CC Mariners,5513,10,4,8,15,28,49,-21,20
Sydney FC,5514,1,21,4,3,67,23,44,67
N'castle Jet,5514,2,16,5,7,59,37,22,53
Melbourne C,5514,3,14,4,11,43,35,8,46
Melbourne V,5514,4,13,5,11,46,41,5,44
Adelaide Utd,5514,5,11,6,11,37,40,-3,39
Brisbane,5514,6,10,5,13,33,42,-9,35
Western Sydn,5514,7,8,9,10,38,47,-9,33
Perth Glory,5514,8,10,2,15,37,50,-13,32
Wellington P,5514,9,5,6,16,31,55,-24,21
CC Mariners,5514,10,4,8,15,28,49,-21,20
Sydney FC,5515,1,21,4,3,67,23,44,67
N'castle Jet,5515,2,16,5,7,58,37,21,53
Melbourne C,5515,3,14,4,11,43,34,9,46
Melbourne V,5515,4,13,5,11,46,41,5,44
Adelaide Utd,5515,5,11,6,11,37,40,-3,39
Brisbane,5515,6,10,5,13,33,42,-9,35
Western Sydn,5515,7,8,9,10,38,47,-9,33
Perth Glory,5515,8,10,2,15,37,50,-13,32
Wellington P,5515,9,5,6,16,31,55,-24,21
CC Mariners,5515,10,4,8,15,28,49,-21,20
Sydney FC,5516,1,20,5,3,64,22,42,65
N'castle Jet,5516,2,15,5,8,59,40,19,50
Melbourne C,5516,3,15,4,10,46,35,11,49
Melbourne V,5516,4,13,6,10,45,38,7,45
Adelaide Utd,5516,5,11,6,11,37,40,-3,39
Brisbane,5516,6,10,5,13,33,42,-9,35
Western Sydn,5516,7,8,9,10,38,47,-9,33
Perth Glory,5516,8,10,2,15,37,50,-13,32
Wellington P,5516,9,5,6,16,31,55,-24,21
CC Mariners,5516,10,4,8,15,28,49,-21,20
Sydney FC,5517,1,20,5,3,65,23,42,65
N'castle Jet,5517,2,16,5,7,62,38,24,53
Melbourne C,5517,3,14,4,11,44,38,6,46
Melbourne V,5517,4,13,6,10,46,39,7,45
Adelaide Utd,5517,5,11,6,11,37,40,-3,39
Brisbane,5517,6,10,5,13,33,42,-9,35
Western Sydn,5517,7,8,9,10,38,47,-9,33
Perth Glory,5517,8,10,2,15,37,50,-13,32
Wellington P,5517,9,5,6,16,31,55,-24,21
CC Mariners,5517,10,4,8,15,28,49,-21,20
Sydney FC,5518,1,21,4,3,65,22,43,67
N'castle Jet,5518,2,15,6,7,58,38,20,51
Melbourne C,5518,3,14,5,10,44,34,10,47
Melbourne V,5518,4,13,5,11,45,39,6,44
Adelaide Utd,5518,5,11,6,11,37,40,-3,39
Brisbane,5518,6,10,5,13,33,42,-9,35
Western Sydn,5518,7,8,9,10,38,47,-9,33
Perth Glory,5518,8,10,2,15,37,50,-13,32
Wellington P,5518,9,5,6,16,31,55,-24,21
CC Mariners,5518,10,4,8,15,28,49,-21,20
Sydney FC,5519,1,21,4,3,70,22,48,67
N'castle Jet,5519,2,15,5,8,58,39,19,50
Melbourne C,5519,3,15,4,10,45,34,11,49
Melbourne V,5519,4,13,5,11,45,44,1,44
Adelaide Utd,5519,5,11,6,11,37,40,-3,39
Brisbane,5519,6,10,5,13,33,42,-9,35
Western Sydn,5519,7,8,9,10,38,47,-9,33
Perth Glory,5519,8,10,2,15,37,50,-13,32
Wellington P,5519,9,5,6,16,31,55,-24,21
CC Mariners,5519,10,4,8,15,28,49,-21,20
Sydney FC,5520,1,20,4,4,64,23,41,64
N'castle Jet,5520,2,15,5,8,57,39,18,50
Melbourne C,5520,3,15,4,10,45,33,12,49
Melbourne V,5520,4,14,5,10,46,38,8,47
Adelaide Utd,5520,5,11,6,11,37,40,-3,39
Brisbane,5520,6,10,5,13,33,42,-9,35
Western Sydn,5520,7,8,9,10,38,47,-9,33
Perth Glory,5520,8,10,2,15,37,50,-13,32
Wellington P,5520,9,5,6,16,31,55,-24,21
CC Mariners,5520,10,4,8,15,28,49,-21,20
Sydney FC,5521,1,20,5,3,65,23,42,65
N'castle Jet,5521,2,15,6,7,59,39,20,51
Melbourne C,5521,3,14,5,10,45,35,10,47
Melbourne V,5521,4,13,6,10,46,39,7,45
Adelaide Utd,5521,5,11,6,11,37,40,-3,39
Brisbane,5521,6,10,5,13,33,42,-9,35
Western Sydn,5521,7,8,9,10,38,47,-9,33
Perth Glory,5521,8,10,2,15,37,50,-13,32
Wellington P,5521,9,5,6,16,31,55,-24,21
CC Mariners,5521,10,4,8,15,28,49,-21,20
Sydney FC,5522,1,21,4,3,66,22,44,67
N'castle Jet,5522,2,15,5,8,58,39,19,50
Melbourne C,5522,3,15,4,10,45,34,11,49
Melbourne V,5522,4,13,5,11,45,40,5,44
Adelaide Utd,5522,5,11,6,11,37,40,-3,39
Brisbane,5522,6,10,5,13,33,42,-9,35
Western Sydn,5522,7,8,9,10,38,47,-9,33
Perth Glory,5522,8,10,2,15,37,50,-13,32
Wellington P,5522,9,5,6,16,31,55,-24,21
CC Mariners,5522,10,4,8,15,28,49,-21,20
Sydney FC,5523,1,21,4,3,66,22,44,67
N'castle Jet,5523,2,16,5,7,60,39,21,53
Melbourne C,5523,3,14,4,11,45,36,9,46
Melbourne V,5523,4,13,5,11,45,40,5,44
Adelaide Utd,5523,5,11,6,11,37,40,-3,39
Brisbane,5523,6,10,5,13,33,42,-9,35
Western Sydn,5523,7,8,9,10,38,47,-9,33
Perth Glory,5523,8,10,2,15,37,50,-13,32
Wellington P,5523,9,5,6,16,31,55,-24,21
CC Mariners,5523,10,4,8,15,28,49,-21,20
Sydney FC,5524,1,20,4,4,65,24,41,64
N'castle Jet,5524,2,16,5,7,60,38,22,53
Melbourne V,5524,3,14,5,10,47,39,8,47
Melbourne C,5524,4,14,4,11,44,36,8,46
Adelaide Utd,5524,5,11,6,11,37,40,-3,39
Brisbane,5524,6,10,5,13,33,42,-9,35
Western Sydn,5524,7,8,9,10,38,47,-9,33
Perth Glory,5524,8,10,2,15,37,50,-13,32
Wellington P,5524,9,5,6,16,31,55,-24,21
CC Mariners,5524,10,4,8,15,28,49,-21,20
Sydney FC,5525,1,21,4,3,67,22,45,67
N'castle Jet,5525,2,15,5,8,57,39,18,50
Melbourne C,5525,3,15,4,10,45,33,12,49
Melbourne V,5525,4,13,5,11,45,41,4,44
Adelaide Utd,5525,5,11,6,11,37,40,-3,39
Brisbane,5525,6,10,5,13,33,42,-9,35
Western Sydn,5525,7,8,9,10,38,47,-9,33
Perth Glory,5525,8,10,2,15,37,50,-13,32
Wellington P,5525,9,5,6,16,31,55,-24,21
CC Mariners,5525,10,4,8,15,28,49,-21,20
Sydney FC,5526,1,21,4,3,65,22,43,67
N'castle Jet,5526,2,15,5,8,58,39,19,50
Melbourne C,5526,3,15,4,10,45,34,11,49
Melbourne V,5526,4,13,5,11,45,39,6,44
Adelaide Utd,5526,5,11,6,11,37,40,-3,39
Brisbane,5526,6,10,5,13,33,42,-9,35
Western Sydn,5526,7,8,9,10,38,47,-9,33
Perth Glory,5526,8,10,2,15,37,50,-13,32
Wellington P,5526,9,5,6,16,31,55,-24,21
CC Mariners,5526,10,4,8,15,28,49,-21,20
Sydney FC,5527,1,20,4,4,66,26,40,64
N'castle Jet,5527,2,15,5,8,57,39,18,50
Melbourne C,5527,3,15,4,10,45,33,12,49
Melbourne V,5527,4,14,5,10,49,40,9,47
Adelaide Utd,5527,5,11,6,11,37,40,-3,39
Brisbane,5527,6,10,5,13,33,42,-9,35
Western Sydn,5527,7,8,9,10,38,47,-9,33
Perth Glory,5527,8,10,2,15,37,50,-13,32
Wellington P,5527,9,5,6,16,31,55,-24,21
CC Mariners,5527,10,4,8,15,28,49,-21,20
Sydney FC,5528,1,21,4,3,67,23,44,67
N'castle Jet,5528,2,15,6,7,57,37,20,51
Melbourne C,5528,3,14,5,10,43,33,10,47
Melbourne V,5528,4,13,5,11,46,41,5,44
Adelaide Utd,5528,5,11,6,11,37,40,-3,39
Brisbane,5528,6,10,5,13,33,42,-9,35
Western Sydn,5528,7,8,9,10,38,47,-9,33
Perth Glory,5528,8,10,2,15,37,50,-13,32
Wellington P,5528,9,5,6,16,31,55,-24,21
CC Mariners,5528,10,4,8,15,28,49,-21,20
Sydney FC,5529,1,20,4,4,64,24,40,64
N'castle Jet,5529,2,15,5,8,57,38,19,50
Melbourne C,5529,3,15,4,10,44,33,11,49
Melbourne V,5529,4,14,5,10,47,38,9,47
Adelaide Utd,5529,5,11,6,11,37,40,-3,39
Brisbane,5529,6,10,5,13,33,42,-9,35
Western Sydn,5529,7,8,9,10,38,47,-9,33
Perth Glory,5529,8,10,2,15,37,50,-13,32
Wellington P,5529,9,5,6,16,31,55,-24,21
CC Mariners,5529,10,4,8,15,28,49,-21,20
Sydney FC,5530,1,21,4,3,66,23,43,67
N'castle Jet,5530,2,15,5,8,57,38,19,50
Melbourne C,5530,3,15,4,10,44,33,11,49
Melbourne V,5530,4,13,5,11,46,40,6,44
Adelaide Utd,5530,5,11,6,11,37,40,-3,39
Brisbane,5530,6,10,5,13,33,42,-9,35
Western Sydn,5530,7,8,9,10,38,47,-9,33
Perth Glory,5530,8,10,2,15,37,50,-13,32
Wellington P,5530,9,5,6,16,31,55,-24,21
CC Mariners,5530,10,4,8,15,28,49,-21,20
Sydney FC,5531,1,21,4,3,65,22,43,67
N'castle Jet,5531,2,15,5,8,57,39,18,50
Melbourne C,5531,3,15,4,10,45,33,12,49
Melbourne V,5531,4,13,5,11,45,39,6,44
Adelaide Utd,5531,5,11,6,11,37,40,-3,39
Brisbane,5531,6,10,5,13,33,42,-9,35
Western Sydn,5531,7,8,9,10,38,47,-9,33
Perth Glory,5531,8,10,2,15,37,50,-13,32
Wellington P,5531,9,5,6,16,31,55,-24,21
CC Mariners,5531,10,4,8,15,28,49,-21,20
Sydney FC,5532,1,21,4,3,67,22,45,67
N'castle Jet,5532,2,15,6,7,58,38,20,51
Melbourne C,5532,3,14,5,10,44,34,10,47
Melbourne V,5532,4,13,5,11,45,41,4,44
Adelaide Utd,5532,5,11,6,11,37,40,-3,39
Brisbane,5532,6,10,5,13,33,42,-9,35
Western Sydn,5532,7,8,9,10,38,47,-9,33
Perth Glory,5532,8,10,2,15,37,50,-13,32
Wellington P,5532,9,5,6,16,31,55,-24,21
CC Mariners,5532,10,4,8,15,28,49,-21,20
Sydney FC,5533,1,21,4,3,66,22,44,67
N'castle Jet,5533,2,15,6,7,58,38,20,51
Melbourne C,5533,3,14,5,10,44,34,10,47
Melbourne V,5533,4,13,5,11,45,40,5,44
Adelaide Utd,5533,5,11,6,11,37,40,-3,39
Brisbane,5533,6,10,5,13,33,42,-9,35
Western Sydn,5533,7,8,9,10,38,47,-9,33
Perth Glory,5533,8,10,2,15,37,50,-13,32
Wellington P,5533,9,5,6,16,31,55,-24,21
CC Mariners,5533,10,4,8,15,28,49,-21,20
Sydney FC,5534,1,21,4,3,67,23,44,67
N'castle Jet,5534,2,15,6,7,60,40,20,51
Melbourne C,5534,3,14,5,10,46,36,10,47
Melbourne V,5534,4,13,5,11,46,41,5,44
Adelaide Utd,5534,5,11,6,11,37,40,-3,39
Brisbane,5534,6,10,5,13,33,42,-9,35
Western Sydn,5534,7,8,9,10,38,47,-9,33
Perth Glory,5534,8,10,2,15,37,50,-13,32
Wellington P,5534,9,5,6,16,31,55,-24,21
CC Mariners,5534,10,4,8,15,28,49,-21,20
Sydney FC,5535,1,21,4,3,67,24,43,67
N'castle Jet,5535,2,15,6,7,58,38,20,51
Melbourne C,5535,3,14,5,10,44,34,10,47
Melbourne V,5535,4,13,5,11,47,41,6,44
Adelaide Utd,5535,5,11,6,11,37,40,-3,39
Brisbane,5535,6,10,5,13,33,42,-9,35
Western Sydn,5535,7,8,9,10,38,47,-9,33
Perth Glory,5535,8,10,2,15,37,50,-13,32
Wellington P,5535,9,5,6,16,31,55,-24,21
CC Mariners,5535,10,4,8,15,28,49,-21,20
Sydney FC,5536,1,21,4,3,66,23,43,67
N'castle Jet,5536,2,15,6,7,57,37,20,51
Melbourne C,5536,3,14,5,10,43,33,10,47
Melbourne V,5536,4,13,5,11,46,40,6,44
Adelaide Utd,5536,5,11,6,11,37,40,-3,39
Brisbane,5536,6,10,5,13,33,42,-9,35
Western Sydn,5536,7,8,9,10,38,47,-9,33
Perth Glory,5536,8,10,2,15,37,50,-13,32
Wellington P,5536,9,5,6,16,31,55,-24,21
CC Mariners,5536,10,4,8,15,28,49,-21,20
Sydney FC,5537,1,21,4,3,67,23,44,67
N'castle Jet,5537,2,15,6,7,58,38,20,51
Melbourne C,5537,3,14,5,10,44,34,10,47
Melbourne V,5537,4,13,5,11,46,41,5,44
Adelaide Utd,5537,5,11,6,11,37,40,-3,39
Brisbane,5537,6,10,5,13,33,42,-9,35
Western Sydn,5537,7,8,9,10,38,47,-9,33
Perth Glory,5537,8,10,2,15,37,50,-13,32
Wellington P,5537,9,5,6,16,31,55,-24,21
CC Mariners,5537,10,4,8,15,28,49,-21,20
Sydney FC,5538,1,20,4,4,64,24,40,64
N'castle Jet,5538,2,16,5,7,60,38,22,53
Melbourne V,5538,3,14,5,10,47,38,9,47
Melbourne C,5538,4,14,4,11,44,36,8,46
Adelaide Utd,5538,5,11,6,11,37,40,-3,39
Brisbane,5538,6,10,5,13,33,42,-9,35
Western Sydn,5538,7,8,9,10,38,47,-9,33
Perth Glory,5538,8,10,2,15,37,50,-13,32
Wellington P,5538,9,5,6,16,31,55,-24,21
CC Mariners,5538,10,4,8,15,28,49,-21,20
Sydney FC,5539,1,20,5,3,66,24,42,65
N'castle Jet,5539,2,15,6,7,58,38,20,51
Melbourne C,5539,3,14,5,10,44,34,10,47
Melbourne V,5539,4,13,6,10,47,40,7,45
Adelaide Utd,5539,5,11,6,11,37,40,-3,39
Brisbane,5539,6,10,5,13,33,42,-9,35
Western Sydn,5539,7,8,9,10,38,47,-9,33
Perth Glory,5539,8,10,2,15,37,50,-13,32
Wellington P,5539,9,5,6,16,31,55,-24,21
CC Mariners,5539,10,4,8,15,28,49,-21,20
Sydney FC,5540,1,21,4,3,67,24,43,67
N'castle Jet,5540,2,15,6,7,58,38,20,51
Melbourne C,5540,3,14,5,10,44,34,10,47
Melbourne V,5540,4,13,5,11,47,41,6,44
Adelaide Utd,5540,5,11,6,11,37,40,-3,39
Brisbane,5540,6,10,5,13,33,42,-9,35
Western Sydn,5540,7,8,9,10,38,47,-9,33
Perth Glory,5540,8,10,2,15,37,50,-13,32
Wellington P,5540,9,5,6,16,31,55,-24,21
CC Mariners,5540,10,4,8,15,28,49,-21,20
Sydney FC,5541,1,20,4,4,64,24,40,64
N'castle Jet,5541,2,16,5,7,60,39,21,53
Melbourne V,5541,3,14,5,10,47,38,9,47
Melbourne C,5541,4,14,4,11,45,36,9,46
Adelaide Utd,5541,5,11,6,11,37,40,-3,39
Brisbane,5541,6,10,5,13,33,42,-9,35
Western Sydn,5541,7,8,9,10,38,47,-9,33
Perth Glory,5541,8,10,2,15,37,50,-13,32
Wellington P,5541,9,5,6,16,31,55,-24,21
CC Mariners,5541,10,4,8,15,28,49,-21,20
Sydney FC,5542,1,20,5,3,64,22,42,65
N'castle Jet,5542,2,15,5,8,57,38,19,50
Melbourne C,5542,3,15,4,10,44,33,11,49
Melbourne V,5542,4,13,6,10,45,38,7,45
Adelaide Utd,5542,5,11,6,11,37,40,-3,39
Brisbane,5542,6,10,5,13,33,42,-9,35
Western Sydn,5542,7,8,9,10,38,47,-9,33
Perth Glory,5542,8,10,2,15,37,50,-13,32
Wellington P,5542,9,5,6,16,31,55,-24,21
CC Mariners,5542,10,4,8,15,28,49,-21,20
Sydney FC,5543,1,21,4,3,66,22,44,67
N'castle Jet,5543,2,16,5,7,58,37,21,53
Melbourne C,5543,3,14,4,11,43,34,9,46
Melbourne V,5543,4,13,5,11,45,40,5,44
Adelaide Utd,5543,5,11,6,11,37,40,-3,39
Brisbane,5543,6,10,5,13,33,42,-9,35
Western Sydn,5543,7,8,9,10,38,47,-9,33
Perth Glory,5543,8,10,2,15,37,50,-13,32
Wellington P,5543,9,5,6,16,31,55,-24,21
CC Mariners,5543,10,4,8,15,28,49,-21,20
Sydney FC,5544,1,21,4,3,69,23,46,67
N'castle Jet,5544,2,16,5,7,62,39,23,53
Melbourne C,5544,3,14,4,11,45,38,7,46
Melbourne V,5544,4,13,5,11,46,43,3,44
Adelaide Utd,5544,5,11,6,11,37,40,-3,39
Brisbane,5544,6,10,5,13,33,42,-9,35
Western Sydn,5544,7,8,9,10,38,47,-9,33
Perth Glory,5544,8,10,2,15,37,50,-13,32
Wellington P,5544,9,5,6,16,31,55,-24,21
CC Mariners,5544,10,4,8,15,28,49,-21,20
Sydney FC,5545,1,21,4,3,66,23,43,67
N'castle Jet,5545,2,16,5,7,60,37,23,53
Melbourne C,5545,3,14,4,11,43,36,7,46
Melbourne V,5545,4,13,5,11,46,40,6,44
Adelaide Utd,5545,5,11,6,11,37,40,-3,39
Brisbane,5545,6,10,5,13,33,42,-9,35
Western Sydn,5545,7,8,9,10,38,47,-9,33
Perth Glory,5545,8,10,2,15,37,50,-13,32
Wellington P,5545,9,5,6,16,31,55,-24,21
CC Mariners,5545,10,4,8,15,28,49,-21,20
Sydney FC,5546,1,21,4,3,66,22,44,67
N'castle Jet,5546,2,16,5,7,60,38,22,53
Melbourne C,5546,3,14,4,11,44,36,8,46
Melbourne V,5546,4,13,5,11,45,40,5,44
Adelaide Utd,5546,5,11,6,11,37,40,-3,39
Brisbane,5546,6,10,5,13,33,42,-9,35
Western Sydn,5546,7,8,9,10,38,47,-9,33
Perth Glory,5546,8,10,2,15,37,50,-13,32
Wellington P,5546,9,5,6,16,31,55,-24,21
CC Mariners,5546,10,4,8,15,28,49,-21,20
Sydney FC,5547,1,21,4,3,66,22,44,67
N'castle Jet,5547,2,16,5,7,60,38,22,53
Melbourne C,5547,3,14,4,11,44,36,8,46
Melbourne V,5547,4,13,5,11,45,40,5,44
Adelaide Utd,5547,5,11,6,11,37,40,-3,39
Brisbane,5547,6,10,5,13,33,42,-9,35
Western Sydn,5547,7,8,9,10,38,47,-9,33
Perth Glory,5547,8,10,2,15,37,50,-13,32
Wellington P,5547,9,5,6,16,31,55,-24,21
CC Mariners,5547,10,4,8,15,28,49,-21,20
Sydney FC,5548,1,21,4,3,68,23,45,67
N'castle Jet,5548,2,15,5,8,57,40,17,50
Melbourne C,5548,3,15,4,10,46,33,13,49
Melbourne V,5548,4,13,5,11,46,42,4,44
Adelaide Utd,5548,5,11,6,11,37,40,-3,39
Brisbane,5548,6,10,5,13,33,42,-9,35
Western Sydn,5548,7,8,9,10,38,47,-9,33
Perth Glory,5548,8,10,2,15,37,50,-13,32
Wellington P,5548,9,5,6,16,31,55,-24,21
CC Mariners,5548,10,4,8,15,28,49,-21,20
Sydney FC,5549,1,21,4,3,66,22,44,67
N'castle Jet,5549,2,15,6,7,58,38,20,51
Melbourne C,5549,3,14,5,10,44,34,10,47
Melbourne V,5549,4,13,5,11,45,40,5,44
Adelaide Utd,5549,5,11,6,11,37,40,-3,39
Brisbane,5549,6,10,5,13,33,42,-9,35
Western Sydn,5549,7,8,9,10,38,47,-9,33
Perth Glory,5549,8,10,2,15,37,50,-13,32
Wellington P,5549,9,5,6,16,31,55,-24,21
CC Mariners,5549,10,4,8,15,28,49,-21,20
Sydney FC,5550,1,20,5,3,66,24,42,65
N'castle Jet,5550,2,15,5,8,57,38,19,50
Melbourne C,5550,3,15,4,10,44,33,11,49
Melbourne V,5550,4,13,6,10,47,40,7,45
Adelaide Utd,5550,5,11,6,11,37,40,-3,39
Brisbane,5550,6,10,5,13,33,42,-9,35
Western Sydn,5550,7,8,9,10,38,47,-9,33
Perth Glory,5550,8,10,2,15,37,50,-13,32
Wellington P,5550,9,5,6,16,31,55,-24,21
CC Mariners,5550,10,4,8,15,28,49,-21,20
Sydney FC,5551,1,20,4,4,64,23,41,64
N'castle Jet,5551,2,15,5,8,59,40,19,50
Melbourne C,5551,3,15,4,10,46,35,11,49
Melbourne V,5551,4,14,5,10,46,38,8,47
Adelaide Utd,5551,5,11,6,11,37,40,-3,39
Brisbane,5551,6,10,5,13,33,42,-9,35
Western Sydn,5551,7,8,9,10,38,47,-9,33
Perth Glory,5551,8,10,2,15,37,50,-13,32
Wellington P,5551,9,5,6,16,31,55,-24,21
CC Mariners,5551,10,4,8,15,28,49,-21,20
Sydney FC,5552,1,21,4,3,67,22,45,67
N'castle Jet,5552,2,15,6,7,58,38,20,51
Melbourne C,5552,3,14,5,10,44,34,10,47
Melbourne V,5552,4,13,5,11,45,41,4,44
Adelaide Utd,5552,5,11,6,11,37,40,-3,39
Brisbane,5552,6,10,5,13,33,42,-9,35
Western Sydn,5552,7,8,9,10,38,47,-9,33
Perth Glory,5552,8,10,2,15,37,50,-13,32
Wellington P,5552,9,5,6,16,31,55,-24,21
CC Mariners,5552,10,4,8,15,28,49,-21,20
Sydney FC,5553,1,21,4,3,66,23,43,67
N'castle Jet,5553,2,16,5,7,59,37,22,53
Melbourne C,5553,3,14,4,11,43,35,8,46
Melbourne V,5553,4,13,5,11,46,40,6,44
Adelaide Utd,5553,5,11,6,11,37,40,-3,39
Brisbane,5553,6,10,5,13,33,42,-9,35
Western Sydn,5553,7,8,9,10,38,47,-9,33
Perth Glory,5553,8,10,2,15,37,50,-13,32
Wellington P,5553,9,5,6,16,31,55,-24,21
CC Mariners,5553,10,4,8,15,28,49,-21,20
Sydney FC,5554,1,21,4,3,68,22,46,67
N'castle Jet,5554,2,15,6,7,57,37,20,51
Melbourne C,5554,3,14,5,10,43,33,10,47
Melbourne V,5554,4,13,5,11,45,42,3,44
Adelaide Utd,5554,5,11,6,11,37,40,-3,39
Brisbane,5554,6,10,5,13,33,42,-9,35
Western Sydn,5554,7,8,9,10,38,47,-9,33
Perth Glory,5554,8,10,2,15,37,50,-13,32
Wellington P,5554,9,5,6,16,31,55,-24,21
CC Mariners,5554,10,4,8,15,28,49,-21,20
Sydney FC,5555,1,21,4,3,65,22,43,67
N'castle Jet,5555,2,16,5,7,60,37,23,53
Melbourne C,5555,3,14,4,11,43,36,7,46
Melbourne V,5555,4,13,5,11,45,39,6,44
Adelaide Utd,5555,5,11,6,11,37,40,-3,39
Brisbane,5555,6,10,5,13,33,42,-9,35
Western Sydn,5555,7,8,9,10,38,47,-9,33
Perth Glory,5555,8,10,2,15,37,50,-13,32
Wellington P,5555,9,5,6,16,31,55,-24,21
CC Mariners,5555,10,4,8,15,28,49,-21,20
Sydney FC,5556,1,20,4,4,65,24,41,64
N'castle Jet,5556,2,15,5,8,57,38,19,50
Melbourne C,5556,3,15,4,10,44,33,11,49
Melbourne V,5556,4,14,5,10,47,39,8,47
Adelaide Utd,5556,5,11,6,11,37,40,-3,39
Brisbane,5556,6,10,5,13,33,42,-9,35
Western Sydn,5556,7,8,9,10,38,47,-9,33
Perth Glory,5556,8,10,2,15,37,50,-13,32
Wellington P,5556,9,5,6,16,31,55,-24,21
CC Mariners,5556,10,4,8,15,28,49,-21,20
Sydney FC,5557,1,21,4,3,67,23,44,67
N'castle Jet,5557,2,16,5,7,60,39,21,53
Melbourne C,5557,3,14,4,11,45,36,9,46
Melbourne V,5557,4,13,5,11,46,41,5,44
Adelaide Utd,5557,5,11,6,11,37,40,-3,39
Brisbane,5557,6,10,5,13,33,42,-9,35
Western Sydn,5557,7,8,9,10,38,47,-9,33
Perth Glory,5557,8,10,2,15,37,50,-13,32
Wellington P,5557,9,5,6,16,31,55,-24,21
CC Mariners,5557,10,4,8,15,28,49,-21,20
Sydney FC,5558,1,20,4,4,66,27,39,64
N'castle Jet,5558,2,16,5,7,59,37,22,53
Melbourne V,5558,3,14,5,10,50,40,10,47
Melbourne C,5558,4,14,4,11,43,35,8,46
Adelaide Utd,5558,5,11,6,11,37,40,-3,39
Brisbane,5558,6,10,5,13,33,42,-9,35
Western Sydn,5558,7,8,9,10,38,47,-9,33
Perth Glory,5558,8,10,2,15,37,50,-13,32
Wellington P,5558,9,5,6,16,31,55,-24,21
CC Mariners,5558,10,4,8,15,28,49,-21,20
Sydney FC,5559,1,21,4,3,66,23,43,67
N'castle Jet,5559,2,16,5,7,61,38,23,53
Melbourne C,5559,3,14,4,11,44,37,7,46
Melbourne V,5559,4,13,5,11,46,40,6,44
Adelaide Utd,5559,5,11,6,11,37,40,-3,39
Brisbane,5559,6,10,5,13,33,42,-9,35
Western Sydn,5559,7,8,9,10,38,47,-9,33
Perth Glory,5559,8,10,2,15,37,50,-13,32
Wellington P,5559,9,5,6,16,31,55,-24,21
CC Mariners,5559,10,4,8,15,28,49,-21,20
Sydney FC,5560,1,21,4,3,66,22,44,67
N'castle Jet,5560,2,15,5,8,59,41,18,50
Melbourne C,5560,3,15,4,10,47,35,12,49
Melbourne V,5560,4,13,5,11,45,40,5,44
Adelaide Utd,5560,5,11,6,11,37,40,-3,39
Brisbane,5560,6,10,5,13,33,42,-9,35
Western Sydn,5560,7,8,9,10,38,47,-9,33
Perth Glory,5560,8,10,2,15,37,50,-13,32
Wellington P,5560,9,5,6,16,31,55,-24,21
CC Mariners,5560,10,4,8,15,28,49,-21,20
Sydney FC,5561,1,20,5,3,66,24,42,65
N'castle Jet,5561,2,15,5,8,58,39,19,50
Melbourne C,5561,3,15,4,10,45,34,11,49
Melbourne V,5561,4,13,6,10,47,40,7,45
Adelaide Utd,5561,5,11,6,11,37,40,-3,39
Brisbane,5561,6,10,5,13,33,42,-9,35
Western Sydn,5561,7,8,9,10,38,47,-9,33
Perth Glory,5561,8,10,2,15,37,50,-13,32
Wellington P,5561,9,5,6,16,31,55,-24,21
CC Mariners,5561,10,4,8,15,28,49,-21,20
Sydney FC,5562,1,20,4,4,65,25,40,64
N'castle Jet,5562,2,15,5,8,57,38,19,50
Melbourne C,5562,3,15,4,10,44,33,11,49
Melbourne V,5562,4,14,5,10,48,39,9,47
Adelaide Utd,5562,5,11,6,11,37,40,-3,39
Brisbane,5562,6,10,5,13,33,42,-9,35
Western Sydn,5562,7,8,9,10,38,47,-9,33
Perth Glory,5562,8,10,2,15,37,50,-13,32
Wellington P,5562,9,5,6,16,31,55,-24,21
CC Mariners,5562,10,4,8,15,28,49,-21,20
Sydney FC,5563,1,20,5,3,65,23,42,65
N'castle Jet,5563,2,16,5,7,60,38,22,53
Melbourne C,5563,3,14,4,11,44,36,8,46
Melbourne V,5563,4,13,6,10,46,39,7,45
Adelaide Utd,5563,5,11,6,11,37,40,-3,39
Brisbane,5563,6,10,5,13,33,42,-9,35
Western Sydn,5563,7,8,9,10,38,47,-9,33
Perth Glory,5563,8,10,2,15,37,50,-13,32
Wellington P,5563,9,5,6,16,31,55,-24,21
CC Mariners,5563,10,4,8,15,28,49,-21,20
Sydney FC,5564,1,21,4,3,67,22,45,67
N'castle Jet,5564,2,16,5,7,59,38,21,53
Melbourne C,5564,3,14,4,11,44,35,9,46
Melbourne V,5564,4,13,5,11,45,41,4,44
Adelaide Utd,5564,5,11,6,11,37,40,-3,39
Brisbane,5564,6,10,5,13,33,42,-9,35
Western Sydn,5564,7,8,9,10,38,47,-9,33
Perth Glory,5564,8,10,2,15,37,50,-13,32
Wellington P,5564,9,5,6,16,31,55,-24,21
CC Mariners,5564,10,4,8,15,28,49,-21,20
Sydney FC,5565,1,20,5,3,65,23,42,65
N'castle Jet,5565,2,15,5,8,58,39,19,50
Melbourne C,5565,3,15,4,10,45,34,11,49
Melbourne V,5565,4,13,6,10,46,39,7,45
Adelaide Utd,5565,5,11,6,11,37,40,-3,39
Brisbane,5565,6,10,5,13,33,42,-9,35
Western Sydn,5565,7,8,9,10,38,47,-9,33
Perth Glory,5565,8,10,2,15,37,50,-13,32
Wellington P,5565,9,5,6,16,31,55,-24,21
CC Mariners,5565,10,4,8,15,28,49,-21,20
Sydney FC,5566,1,21,4,3,66,23,43,67
N'castle Jet,5566,2,16,5,7,60,37,23,53
Melbourne C,5566,3,14,4,11,43,36,7,46
Melbourne V,5566,4,13,5,11,46,40,6,44
Adelaide Utd,5566,5,11,6,11,37,40,-3,39
Brisbane,5566,6,10,5,13,33,42,-9,35
Western Sydn,5566,7,8,9,10,38,47,-9,33
Perth Glory,5566,8,10,2,15,37,50,-13,32
Wellington P,5566,9,5,6,16,31,55,-24,21
CC Mariners,5566,10,4,8,15,28,49,-21,20
Sydney FC,5567,1,21,4,3,67,23,44,67
N'castle Jet,5567,2,16,5,7,60,39,21,53
Melbourne C,5567,3,14,4,11,45,36,9,46
Melbourne V,5567,4,13,5,11,46,41,5,44
Adelaide Utd,5567,5,11,6,11,37,40,-3,39
Brisbane,5567,6,10,5,13,33,42,-9,35
Western Sydn,5567,7,8,9,10,38,47,-9,33
Perth Glory,5567,8,10,2,15,37,50,-13,32
Wellington P,5567,9,5,6,16,31,55,-24,21
CC Mariners,5567,10,4,8,15,28,49,-21,20
Sydney FC,5568,1,21,4,3,66,22,44,67
N'castle Jet,5568,2,15,6,7,58,38,20,51
Melbourne C,5568,3,14,5,10,44,34,10,47
Melbourne V,5568,4,13,5,11,45,40,5,44
Adelaide Utd,5568,5,11,6,11,37,40,-3,39
Brisbane,5568,6,10,5,13,33,42,-9,35
Western Sydn,5568,7,8,9,10,38,47,-9,33
Perth Glory,5568,8,10,2,15,37,50,-13,32
Wellington P,5568,9,5,6,16,31,55,-24,21
CC Mariners,5568,10,4,8,15,28,49,-21,20
Sydney FC,5569,1,21,4,3,68,23,45,67
N'castle Jet,5569,2,16,5,7,64,38,26,53
Melbourne C,5569,3,14,4,11,44,40,4,46
Melbourne V,5569,4,13,5,11,46,42,4,44
Adelaide Utd,5569,5,11,6,11,37,40,-3,39
Brisbane,5569,6,10,5,13,33,42,-9,35
Western Sydn,5569,7,8,9,10,38,47,-9,33
Perth Glory,5569,8,10,2,15,37,50,-13,32
Wellington P,5569,9,5,6,16,31,55,-24,21
CC Mariners,5569,10,4,8,15,28,49,-21,20
Sydney FC,5570,1,20,5,3,67,25,42,65
N'castle Jet,5570,2,16,5,7,61,38,23,53
Melbourne C,5570,3,14,4,11,44,37,7,46
Melbourne V,5570,4,13,6,10,48,41,7,45
Adelaide Utd,5570,5,11,6,11,37,40,-3,39
Brisbane,5570,6,10,5,13,33,42,-9,35
Western Sydn,5570,7,8,9,10,38,47,-9,33
Perth Glory,5570,8,10,2,15,37,50,-13,32
Wellington P,5570,9,5,6,16,31,55,-24,21
CC Mariners,5570,10,4,8,15,28,49,-21,20
Sydney FC,5571,1,21,4,3,66,22,44,67
N'castle Jet,5571,2,15,6,7,58,38,20,51
Melbourne C,5571,3,14,5,10,44,34,10,47
Melbourne V,5571,4,13,5,11,45,40,5,44
Adelaide Utd,5571,5,11,6,11,37,40,-3,39
Brisbane,5571,6,10,5,13,33,42,-9,35
Western Sydn,5571,7,8,9,10,38,47,-9,33
Perth Glory,5571,8,10,2,15,37,50,-13,32
Wellington P,5571,9,5,6,16,31,55,-24,21
CC Mariners,5571,10,4,8,15,28,49,-21,20
Sydney FC,5572,1,20,4,4,65,24,41,64
N'castle Jet,5572,2,16,5,7,60,39,21,53
Melbourne V,5572,3,14,5,10,47,39,8,47
Melbourne C,5572,4,14,4,11,45,36,9,46
Adelaide Utd,5572,5,11,6,11,37,40,-3,39
Brisbane,5572,6,10,5,13,33,42,-9,35
Western Sydn,5572,7,8,9,10,38,47,-9,33
Perth Glory,5572,8,10,2,15,37,50,-13,32
Wellington P,5572,9,5,6,16,31,55,-24,21
CC Mariners,5572,10,4,8,15,28,49,-21,20
Sydney FC,5573,1,21,4,3,66,23,43,67
N'castle Jet,5573,2,16,5,7,58,37,21,53
Melbourne C,5573,3,14,4,11,43,34,9,46
Melbourne V,5573,4,13,5,11,46,40,6,44
Adelaide Utd,5573,5,11,6,11,37,40,-3,39
Brisbane,5573,6,10,5,13,33,42,-9,35
Western Sydn,5573,7,8,9,10,38,47,-9,33
Perth Glory,5573,8,10,2,15,37,50,-13,32
Wellington P,5573,9,5,6,16,31,55,-24,21
CC Mariners,5573,10,4,8,15,28,49,-21,20
Sydney FC,5574,1,20,5,3,66,24,42,65
N'castle Jet,5574,2,15,5,8,59,40,19,50
Melbourne C,5574,3,15,4,10,46,35,11,49
Melbourne V,5574,4,13,6,10,47,40,7,45
Adelaide Utd,5574,5,11,6,11,37,40,-3,39
Brisbane,5574,6,10,5,13,33,42,-9,35
Western Sydn,5574,7,8,9,10,38,47,-9,33
Perth Glory,5574,8,10,2,15,37,50,-13,32
Wellington P,5574,9,5,6,16,31,55,-24,21
CC Mariners,5574,10,4,8,15,28,49,-21,20
Sydney FC,5575,1,21,4,3,68,23,45,67
N'castle Jet,5575,2,16,5,7,59,38,21,53
Melbourne C,5575,3,14,4,11,44,35,9,46
Melbourne V,5575,4,13,5,11,46,42,4,44
Adelaide Utd,5575,5,11,6,11,37,40,-3,39
Brisbane,5575,6,10,5,13,33,42,-9,35
Western Sydn,5575,7,8,9,10,38,47,-9,33
Perth Glory,5575,8,10,2,15,37,50,-13,32
Wellington P,5575,9,5,6,16,31,55,-24,21
CC Mariners,5575,10,4,8,15,28,49,-21,20
Sydney FC,5576,1,21,4,3,68,23,45,67
N'castle Jet,5576,2,15,5,8,59,40,19,50
Melbourne C,5576,3,15,4,10,46,35,11,49
Melbourne V,5576,4,13,5,11,46,42,4,44
Adelaide Utd,5576,5,11,6,11,37,40,-3,39
Brisbane,5576,6,10,5,13,33,42,-9,35
Western Sydn,5576,7,8,9,10,38,47,-9,33
Perth Glory,5576,8,10,2,15,37,50,-13,32
Wellington P,5576,9,5,6,16,31,55,-24,21
CC Mariners,5576,10,4,8,15,28,49,-21,20
Sydney FC,5577,1,21,4,3,66,23,43,67
N'castle Jet,5577,2,16,5,7,59,38,21,53
Melbourne C,5577,3,14,4,11,44,35,9,46
Melbourne V,5577,4,13,5,11,46,40,6,44
Adelaide Utd,5577,5,11,6,11,37,40,-3,39
Brisbane,5577,6,10,5,13,33,42,-9,35
Western Sydn,5577,7,8,9,10,38,47,-9,33
Perth Glory,5577,8,10,2,15,37,50,-13,32
Wellington P,5577,9,5,6,16,31,55,-24,21
CC Mariners,5577,10,4,8,15,28,49,-21,20
Sydney FC,5578,1,21,4,3,70,23,47,67
N'castle Jet,5578,2,15,5,8,58,40,18,50
Melbourne C,5578,3,15,4,10,46,34,12,49
Melbourne V,5578,4,13,5,11,46,44,2,44
Adelaide Utd,5578,5,11,6,11,37,40,-3,39
Brisbane,5578,6,10,5,13,33,42,-9,35
Western Sydn,5578,7,8,9,10,38,47,-9,33
Perth Glory,5578,8,10,2,15,37,50,-13,32
Wellington P,5578,9,5,6,16,31,55,-24,21
CC Mariners,5578,10,4,8,15,28,49,-21,20
Sydney FC,5579,1,20,4,4,65,24,41,64
N'castle Jet,5579,2,15,5,8,57,38,19,50
Melbourne C,5579,3,15,4,10,44,33,11,49
Melbourne V,5579,4,14,5,10,47,39,8,47
Adelaide Utd,5579,5,11,6,11,37,40,-3,39
Brisbane,5579,6,10,5,13,33,42,-9,35
Western Sydn,5579,7,8,9,10,38,47,-9,33
Perth Glory,5579,8,10,2,15,37,50,-13,32
Wellington P,5579,9,5,6,16,31,55,-24,21
CC Mariners,5579,10,4,8,15,28,49,-21,20
Sydney FC,5580,1,20,5,3,65,23,42,65
N'castle Jet,5580,2,15,6,7,60,40,20,51
Melbourne C,5580,3,14,5,10,46,36,10,47
Melbourne V,5580,4,13,6,10,46,39,7,45
Adelaide Utd,5580,5,11,6,11,37,40,-3,39
Brisbane,5580,6,10,5,13,33,42,-9,35
Western Sydn,5580,7,8,9,10,38,47,-9,33
Perth Glory,5580,8,10,2,15,37,50,-13,32
Wellington P,5580,9,5,6,16,31,55,-24,21
CC Mariners,5580,10,4,8,15,28,49,-21,20
Sydney FC,5581,1,21,4,3,66,22,44,67
N'castle Jet,5581,2,15,6,7,58,38,20,51
Melbourne C,5581,3,14,5,10,44,34,10,47
Melbourne V,5581,4,13,5,11,45,40,5,44
Adelaide Utd,5581,5,11,6,11,37,40,-3,39
Brisbane,5581,6,10,5,13,33,42,-9,35
Western Sydn,5581,7,8,9,10,38,47,-9,33
Perth Glory,5581,8,10,2,15,37,50,-13,32
Wellington P,5581,9,5,6,16,31,55,-24,21
CC Mariners,5581,10,4,8,15,28,49,-21,20
Sydney FC,5582,1,21,4,3,65,22,43,67
N'castle Jet,5582,2,16,5,7,61,39,22,53
Melbourne C,5582,3,14,4,11,45,37,8,46
Melbourne V,5582,4,13,5,11,45,39,6,44
Adelaide Utd,5582,5,11,6,11,37,40,-3,39
Brisbane,5582,6,10,5,13,33,42,-9,35
Western Sydn,5582,7,8,9,10,38,47,-9,33
Perth Glory,5582,8,10,2,15,37,50,-13,32
Wellington P,5582,9,5,6,16,31,55,-24,21
CC Mariners,5582,10,4,8,15,28,49,-21,20
Sydney FC,5583,1,21,4,3,70,23,47,67
N'castle Jet,5583,2,15,5,8,57,39,18,50
Melbourne C,5583,3,15,4,10,45,33,12,49
Melbourne V,5583,4,13,5,11,46,44,2,44
Adelaide Utd,5583,5,11,6,11,37,40,-3,39
Brisbane,5583,6,10,5,13,33,42,-9,35
Western Sydn,5583,7,8,9,10,38,47,-9,33
Perth Glory,5583,8,10,2,15,37,50,-13,32
Wellington P,5583,9,5,6,16,31,55,-24,21
CC Mariners,5583,10,4,8,15,28,49,-21,20
Sydney FC,5584,1,21,4,3,66,23,43,67
N'castle Jet,5584,2,15,6,7,57,37,20,51
Melbourne C,5584,3,14,5,10,43,33,10,47
Melbourne V,5584,4,13,5,11,46,40,6,44
Adelaide Utd,5584,5,11,6,11,37,40,-3,39
Brisbane,5584,6,10,5,13,33,42,-9,35
Western Sydn,5584,7,8,9,10,38,47,-9,33
Perth Glory,5584,8,10,2,15,37,50,-13,32
Wellington P,5584,9,5,6,16,31,55,-24,21
CC Mariners,5584,10,4,8,15,28,49,-21,20
Sydney FC,5585,1,21,4,3,68,23,45,67
N'castle Jet,5585,2,16,5,7,59,38,21,53
Melbourne C,5585,3,14,4,11,44,35,9,46
Melbourne V,5585,4,13,5,11,46,42,4,44
Adelaide Utd,5585,5,11,6,11,37,40,-3,39
Brisbane,5585,6,10,5,13,33,42,-9,35
Western Sydn,5585,7,8,9,10,38,47,-9,33
Perth Glory,5585,8,10,2,15,37,50,-13,32
Wellington P,5585,9,5,6,16,31,55,-24,21
CC Mariners,5585,10,4,8,15,28,49,-21,20
Sydney FC,5586,1,20,4,4,66,25,41,64
N'castle Jet,5586,2,16,5,7,60,38,22,53
Melbourne V,5586,3,14,5,10,48,40,8,47
Melbourne C,5586,4,14,4,11,44,36,8,46
Adelaide Utd,5586,5,11,6,11,37,40,-3,39
Brisbane,5586,6,10,5,13,33,42,-9,35
Western Sydn,5586,7,8,9,10,38,47,-9,33
Perth Glory,5586,8,10,2,15,37,50,-13,32
Wellington P,5586,9,5,6,16,31,55,-24,21
CC Mariners,5586,10,4,8,15,28,49,-21,20
Sydney FC,5587,1,20,4,4,64,24,40,64
N'castle Jet,5587,2,15,6,7,60,40,20,51
Melbourne C,5587,3,14,5,10,46,36,10,47
Melbourne V,5587,4,14,5,10,47,38,9,47
Adelaide Utd,5587,5,11,6,11,37,40,-3,39
Brisbane,5587,6,10,5,13,33,42,-9,35
Western Sydn,5587,7,8,9,10,38,47,-9,33
Perth Glory,5587,8,10,2,15,37,50,-13,32
Wellington P,5587,9,5,6,16,31,55,-24,21
CC Mariners,5587,10,4,8,15,28,49,-21,20
Sydney FC,5588,1,20,5,3,66,24,42,65
N'castle Jet,5588,2,16,5,7,60,38,22,53
Melbourne C,5588,3,14,4,11,44,36,8,46
Melbourne V,5588,4,13,6,10,47,40,7,45
Adelaide Utd,5588,5,11,6,11,37,40,-3,39
Brisbane,5588,6,10,5,13,33,42,-9,35
Western Sydn,5588,7,8,9,10,38,47,-9,33
Perth Glory,5588,8,10,2,15,37,50,-13,32
Wellington P,5588,9,5,6,16,31,55,-24,21
CC Mariners,5588,10,4,8,15,28,49,-21,20
Sydney FC,5589,1,21,4,3,66,22,44,67
N'castle Jet,5589,2,15,5,8,57,38,19,50
Melbourne C,5589,3,15,4,10,44,33,11,49
Melbourne V,5589,4,13,5,11,45,40,5,44
Adelaide Utd,5589,5,11,6,11,37,40,-3,39
Brisbane,5589,6,10,5,13,33,42,-9,35
Western Sydn,5589,7,8,9,10,38,47,-9,33
Perth Glory,5589,8,10,2,15,37,50,-13,32
Wellington P,5589,9,5,6,16,31,55,-24,21
CC Mariners,5589,10,4,8,15,28,49,-21,20
Sydney FC,5590,1,20,5,3,66,24,42,65
N'castle Jet,5590,2,16,5,7,59,37,22,53
Melbourne C,5590,3,14,4,11,43,35,8,46
Melbourne V,5590,4,13,6,10,47,40,7,45
Adelaide Utd,5590,5,11,6,11,37,40,-3,39
Brisbane,5590,6,10,5,13,33,42,-9,35
Western Sydn,5590,7,8,9,10,38,47,-9,33
Perth Glory,5590,8,10,2,15,37,50,-13,32
Wellington P,5590,9,5,6,16,31,55,-24,21
CC Mariners,5590,10,4,8,15,28,49,-21,20
Sydney FC,5591,1,20,5,3,64,22,42,65
N'castle Jet,5591,2,16,5,7,59,38,21,53
Melbourne C,5591,3,14,4,11,44,35,9,46
Melbourne V,5591,4,13,6,10,45,38,7,45
Adelaide Utd,5591,5,11,6,11,37,40,-3,39
Brisbane,5591,6,10,5,13,33,42,-9,35
Western Sydn,5591,7,8,9,10,38,47,-9,33
Perth Glory,5591,8,10,2,15,37,50,-13,32
Wellington P,5591,9,5,6,16,31,55,-24,21
CC Mariners,5591,10,4,8,15,28,49,-21,20
Sydney FC,5592,1,20,5,3,65,23,42,65
N'castle Jet,5592,2,16,5,7,59,38,21,53
Melbourne C,5592,3,14,4,11,44,35,9,46
Melbourne V,5592,4,13,6,10,46,39,7,45
Adelaide Utd,5592,5,11,6,11,37,40,-3,39
Brisbane,5592,6,10,5,13,33,42,-9,35
Western Sydn,5592,7,8,9,10,38,47,-9,33
Perth Glory,5592,8,10,2,15,37,50,-13,32
Wellington P,5592,9,5,6,16,31,55,-24,21
CC Mariners,5592,10,4,8,15,28,49,-21,20
Sydney FC,5593,1,21,4,3,67,23,44,67
N'castle Jet,5593,2,16,5,7,58,37,21,53
Melbourne C,5593,3,14,4,11,43,34,9,46
Melbourne V,5593,4,13,5,11,46,41,5,44
Adelaide Utd,5593,5,11,6,11,37,40,-3,39
Brisbane,5593,6,10,5,13,33,42,-9,35
Western Sydn,5593,7,8,9,10,38,47,-9,33
Perth Glory,5593,8,10,2,15,37,50,-13,32
Wellington P,5593,9,5,6,16,31,55,-24,21
CC Mariners,5593,10,4,8,15,28,49,-21,20
Sydney FC,5594,1,21,4,3,67,24,43,67
N'castle Jet,5594,2,15,5,8,58,40,18,50
Melbourne C,5594,3,15,4,10,46,34,12,49
Melbourne V,5594,4,13,5,11,47,41,6,44
Adelaide Utd,5594,5,11,6,11,37,40,-3,39
Brisbane,5594,6,10,5,13,33,42,-9,35
Western Sydn,5594,7,8,9,10,38,47,-9,33
Perth Glory,5594,8,10,2,15,37,50,-13,32
Wellington P,5594,9,5,6,16,31,55,-24,21
CC Mariners,5594,10,4,8,15,28,49,-21,20
Sydney FC,5595,1,21,4,3,65,22,43,67
N'castle Jet,5595,2,16,5,7,59,38,21,53
Melbourne C,5595,3,14,4,11,44,35,9,46
Melbourne V,5595,4,13,5,11,45,39,6,44
Adelaide Utd,5595,5,11,6,11,37,40,-3,39
Brisbane,5595,6,10,5,13,33,42,-9,35
Western Sydn,5595,7,8,9,10,38,47,-9,33
Perth Glory,5595,8,10,2,15,37,50,-13,32
Wellington P,5595,9,5,6,16,31,55,-24,21
CC Mariners,5595,10,4,8,15,28,49,-21,20
Sydney FC,5596,1,21,4,3,66,23,43,67
N'castle Jet,5596,2,15,5,8,59,40,19,50
Melbourne C,5596,3,15,4,10,46,35,11,49
Melbourne V,5596,4,13,5,11,46,40,6,44
Adelaide Utd,5596,5,11,6,11,37,40,-3,39
Brisbane,5596,6,10,5,13,33,42,-9,35
Western Sydn,5596,7,8,9,10,38,47,-9,33
Perth Glory,5596,8,10,2,15,37,50,-13,32
Wellington P,5596,9,5,6,16,31,55,-24,21
CC Mariners,5596,10,4,8,15,28,49,-21,20
Sydney FC,5597,1,20,4,4,64,23,41,64
N'castle Jet,5597,2,16,5,7,60,38,22,53
Melbourne V,5597,3,14,5,10,46,38,8,47
Melbourne C,5597,4,14,4,11,44,36,8,46
Adelaide Utd,5597,5,11,6,11,37,40,-3,39
Brisbane,5597,6,10,5,13,33,42,-9,35
Western Sydn,5597,7,8,9,10,38,47,-9,33
Perth Glory,5597,8,10,2,15,37,50,-13,32
Wellington P,5597,9,5,6,16,31,55,-24,21
CC Mariners,5597,10,4,8,15,28,49,-21,20
Sydney FC,5598,1,20,4,4,65,24,41,64
N'castle Jet,5598,2,15,6,7,58,38,20,51
Melbourne C,5598,3,14,5,10,44,34,10,47
Melbourne V,5598,4,14,5,10,47,39,8,47
Adelaide Utd,5598,5,11,6,11,37,40,-3,39
Brisbane,5598,6,10,5,13,33,42,-9,35
Western Sydn,5598,7,8,9,10,38,47,-9,33
Perth Glory,5598,8,10,2,15,37,50,-13,32
Wellington P,5598,9,5,6,16,31,55,-24,21
CC Mariners,5598,10,4,8,15,28,49,-21,20
Sydney FC,5599,1,21,4,3,69,22,47,67
N'castle Jet,5599,2,16,5,7,63,39,24,53
Melbourne C,5599,3,14,4,11,45,39,6,46
Melbourne V,5599,4,13,5,11,45,43,2,44
Adelaide Utd,5599,5,11,6,11,37,40,-3,39
Brisbane,5599,6,10,5,13,33,42,-9,35
Western Sydn,5599,7,8,9,10,38,47,-9,33
Perth Glory,5599,8,10,2,15,37,50,-13,32
Wellington P,5599,9,5,6,16,31,55,-24,21
CC Mariners,5599,10,4,8,15,28,49,-21,20
Sydney FC,5600,1,20,4,4,64,23,41,64
N'castle Jet,5600,2,16,5,7,60,38,22,53
Melbourne V,5600,3,14,5,10,46,38,8,47
Melbourne C,5600,4,14,4,11,44,36,8,46
Adelaide Utd,5600,5,11,6,11,37,40,-3,39
Brisbane,5600,6,10,5,13,33,42,-9,35
Western Sydn,5600,7,8,9,10,38,47,-9,33
Perth Glory,5600,8,10,2,15,37,50,-13,32
Wellington P,5600,9,5,6,16,31,55,-24,21
CC Mariners,5600,10,4,8,15,28,49,-21,20
Sydney FC,5601,1,20,4,4,65,24,41,64
N'castle Jet,5601,2,15,5,8,58,40,18,50
Melbourne C,5601,3,15,4,10,46,34,12,49
Melbourne V,5601,4,14,5,10,47,39,8,47
Adelaide Utd,5601,5,11,6,11,37,40,-3,39
Brisbane,5601,6,10,5,13,33,42,-9,35
Western Sydn,5601,7,8,9,10,38,47,-9,33
Perth Glory,5601,8,10,2,15,37,50,-13,32
Wellington P,5601,9,5,6,16,31,55,-24,21
CC Mariners,5601,10,4,8,15,28,49,-21,20
Sydney FC,5602,1,20,5,3,66,24,42,65
N'castle Jet,5602,2,15,5,8,57,38,19,50
Melbourne C,5602,3,15,4,10,44,33,11,49
Melbourne V,5602,4,13,6,10,47,40,7,45
Adelaide Utd,5602,5,11,6,11,37,40,-3,39
Brisbane,5602,6,10,5,13,33,42,-9,35
Western Sydn,5602,7,8,9,10,38,47,-9,33
Perth Glory,5602,8,10,2,15,37,50,-13,32
Wellington P,5602,9,5,6,16,31,55,-24,21
CC Mariners,5602,10,4,8,15,28,49,-21,20
Sydney FC,5603,1,21,4,3,68,22,46,67
N'castle Jet,5603,2,15,6,7,59,39,20,51
Melbourne C,5603,3,14,5,10,45,35,10,47
Melbourne V,5603,4,13,5,11,45,42,3,44
Adelaide Utd,5603,5,11,6,11,37,40,-3,39
Brisbane,5603,6,10,5,13,33,42,-9,35
Western Sydn,5603,7,8,9,10,38,47,-9,33
Perth Glory,5603,8,10,2,15,37,50,-13,32
Wellington P,5603,9,5,6,16,31,55,-24,21
CC Mariners,5603,10,4,8,15,28,49,-21,20
Sydney FC,5604,1,20,5,3,64,22,42,65
N'castle Jet,5604,2,16,5,7,60,38,22,53
Melbourne C,5604,3,14,4,11,44,36,8,46
Melbourne V,5604,4,13,6,10,45,38,7,45
Adelaide Utd,5604,5,11,6,11,37,40,-3,39
Brisbane,5604,6,10,5,13,33,42,-9,35
Western Sydn,5604,7,8,9,10,38,47,-9,33
Perth Glory,5604,8,10,2,15,37,50,-13,32
Wellington P,5604,9,5,6,16,31,55,-24,21
CC Mariners,5604,10,4,8,15,28,49,-21,20
Sydney FC,5605,1,20,4,4,66,26,40,64
N'castle Jet,5605,2,15,5,8,59,41,18,50
Melbourne C,5605,3,15,4,10,47,35,12,49
Melbourne V,5605,4,14,5,10,49,40,9,47
Adelaide Utd,5605,5,11,6,11,37,40,-3,39
Brisbane,5605,6,10,5,13,33,42,-9,35
Western Sydn,5605,7,8,9,10,38,47,-9,33
Perth Glory,5605,8,10,2,15,37,50,-13,32
Wellington P,5605,9,5,6,16,31,55,-24,21
CC Mariners,5605,10,4,8,15,28,49,-21,20
Sydney FC,5606,1,21,4,3,66,23,43,67
N'castle Jet,5606,2,16,5,7,58,37,21,53
Melbourne C,5606,3,14,4,11,43,34,9,46
Melbourne V,5606,4,13,5,11,46,40,6,44
Adelaide Utd,5606,5,11,6,11,37,40,-3,39
Brisbane,5606,6,10,5,13,33,42,-9,35
Western Sydn,5606,7,8,9,10,38,47,-9,33
Perth Glory,5606,8,10,2,15,37,50,-13,32
Wellington P,5606,9,5,6,16,31,55,-24,21
CC Mariners,5606,10,4,8,15,28,49,-21,20
Sydney FC,5607,1,21,4,3,67,24,43,67
N'castle Jet,5607,2,15,6,7,58,38,20,51
Melbourne C,5607,3,14,5,10,44,34,10,47
Melbourne V,5607,4,13,5,11,47,41,6,44
Adelaide Utd,5607,5,11,6,11,37,40,-3,39
Brisbane,5607,6,10,5,13,33,42,-9,35
Western Sydn,5607,7,8,9,10,38,47,-9,33
Perth Glory,5607,8,10,2,15,37,50,-13,32
Wellington P,5607,9,5,6,16,31,55,-24,21
CC Mariners,5607,10,4,8,15,28,49,-21,20
Sydney FC,5608,1,20,5,3,65,23,42,65
N'castle Jet,5608,2,15,6,7,57,37,20,51
Melbourne C,5608,3,14,5,10,43,33,10,47
Melbourne V,5608,4,13,6,10,46,39,7,45
Adelaide Utd,5608,5,11,6,11,37,40,-3,39
Brisbane,5608,6,10,5,13,33,42,-9,35
Western Sydn,5608,7,8,9,10,38,47,-9,33
Perth Glory,5608,8,10,2,15,37,50,-13,32
Wellington P,5608,9,5,6,16,31,55,-24,21
CC Mariners,5608,10,4,8,15,28,49,-21,20
Sydney FC,5609,1,20,4,4,65,25,40,64
N'castle Jet,5609,2,15,6,7,60,40,20,51
Melbourne C,5609,3,14,5,10,46,36,10,47
Melbourne V,5609,4,14,5,10,48,39,9,47
Adelaide Utd,5609,5,11,6,11,37,40,-3,39
Brisbane,5609,6,10,5,13,33,42,-9,35
Western Sydn,5609,7,8,9,10,38,47,-9,33
Perth Glory,5609,8,10,2,15,37,50,-13,32
Wellington P,5609,9,5,6,16,31,55,-24,21
CC Mariners,5609,10,4,8,15,28,49,-21,20
Sydney FC,5610,1,21,4,3,66,23,43,67
N'castle Jet,5610,2,15,6,7,59,39,20,51
Melbourne C,5610,3,14,5,10,45,35,10,47
Melbourne V,5610,4,13,5,11,46,40,6,44
Adelaide Utd,5610,5,11,6,11,37,40,-3,39
Brisbane,5610,6,10,5,13,33,42,-9,35
Western Sydn,5610,7,8,9,10,38,47,-9,33
Perth Glory,5610,8,10,2,15,37,50,-13,32
Wellington P,5610,9,5,6,16,31,55,-24,21
CC Mariners,5610,10,4,8,15,28,49,-21,20
Sydney FC,5611,1,21,4,3,65,22,43,67
N'castle Jet,5611,2,15,6,7,58,38,20,51
Melbourne C,5611,3,14,5,10,44,34,10,47
Melbourne V,5611,4,13,5,11,45,39,6,44
Adelaide Utd,5611,5,11,6,11,37,40,-3,39
Brisbane,5611,6,10,5,13,33,42,-9,35
Western Sydn,5611,7,8,9,10,38,47,-9,33
Perth Glory,5611,8,10,2,15,37,50,-13,32
Wellington P,5611,9,5,6,16,31,55,-24,21
CC Mariners,5611,10,4,8,15,28,49,-21,20
Sydney FC,5612,1,20,4,4,64,24,40,64
N'castle Jet,5612,2,15,5,8,58,40,18,50
Melbourne C,5612,3,15,4,10,46,34,12,49
Melbourne V,5612,4,14,5,10,47,38,9,47
Adelaide Utd,5612,5,11,6,11,37,40,-3,39
Brisbane,5612,6,10,5,13,33,42,-9,35
Western Sydn,5612,7,8,9,10,38,47,-9,33
Perth Glory,5612,8,10,2,15,37,50,-13,32
Wellington P,5612,9,5,6,16,31,55,-24,21
CC Mariners,5612,10,4,8,15,28,49,-21,20
Sydney FC,5613,1,21,4,3,67,23,44,67
N'castle Jet,5613,2,16,5,7,58,37,21,53
Melbourne C,5613,3,14,4,11,43,34,9,46
Melbourne V,5613,4,13,5,11,46,41,5,44
Adelaide Utd,5613,5,11,6,11,37,40,-3,39
Brisbane,5613,6,10,5,13,33,42,-9,35
Western Sydn,5613,7,8,9,10,38,47,-9,33
Perth Glory,5613,8,10,2,15,37,50,-13,32
Wellington P,5613,9,5,6,16,31,55,-24,21
CC Mariners,5613,10,4,8,15,28,49,-21,20
Sydney FC,5614,1,21,4,3,66,23,43,67
N'castle Jet,5614,2,16,5,7,59,38,21,53
Melbourne C,5614,3,14,4,11,44,35,9,46
Melbourne V,5614,4,13,5,11,46,40,6,44
Adelaide Utd,5614,5,11,6,11,37,40,-3,39
Brisbane,5614,6,10,5,13,33,42,-9,35
Western Sydn,5614,7,8,9,10,38,47,-9,33
Perth Glory,5614,8,10,2,15,37,50,-13,32
Wellington P,5614,9,5,6,16,31,55,-24,21
CC Mariners,5614,10,4,8,15,28,49,-21,20
Sydney FC,5615,1,20,4,4,65,24,41,64
N'castle Jet,5615,2,15,5,8,57,38,19,50
Melbourne C,5615,3,15,4,10,44,33,11,49
Melbourne V,5615,4,14,5,10,47,39,8,47
Adelaide Utd,5615,5,11,6,11,37,40,-3,39
Brisbane,5615,6,10,5,13,33,42,-9,35
Western Sydn,5615,7,8,9,10,38,47,-9,33
Perth Glory,5615,8,10,2,15,37,50,-13,32
Wellington P,5615,9,5,6,16,31,55,-24,21
CC Mariners,5615,10,4,8,15,28,49,-21,20
Sydney FC,5616,1,21,4,3,66,23,43,67
N'castle Jet,5616,2,15,6,7,60,40,20,51
Melbourne C,5616,3,14,5,10,46,36,10,47
Melbourne V,5616,4,13,5,11,46,40,6,44
Adelaide Utd,5616,5,11,6,11,37,40,-3,39
Brisbane,5616,6,10,5,13,33,42,-9,35
Western Sydn,5616,7,8,9,10,38,47,-9,33
Perth Glory,5616,8,10,2,15,37,50,-13,32
Wellington P,5616,9,5,6,16,31,55,-24,21
CC Mariners,5616,10,4,8,15,28,49,-21,20
Sydney FC,5617,1,20,4,4,65,25,40,64
N'castle Jet,5617,2,15,5,8,57,38,19,50
Melbourne C,5617,3,15,4,10,44,33,11,49
Melbourne V,5617,4,14,5,10,48,39,9,47
Adelaide Utd,5617,5,11,6,11,37,40,-3,39
Brisbane,5617,6,10,5,13,33,42,-9,35
Western Sydn,5617,7,8,9,10,38,47,-9,33
Perth Glory,5617,8,10,2,15,37,50,-13,32
Wellington P,5617,9,5,6,16,31,55,-24,21
CC Mariners,5617,10,4,8,15,28,49,-21,20
Sydney FC,5618,1,20,5,3,67,25,42,65
N'castle Jet,5618,2,15,5,8,58,40,18,50
Melbourne C,5618,3,15,4,10,46,34,12,49
Melbourne V,5618,4,13,6,10,48,41,7,45
Adelaide Utd,5618,5,11,6,11,37,40,-3,39
Brisbane,5618,6,10,5,13,33,42,-9,35
Western Sydn,5618,7,8,9,10,38,47,-9,33
Perth Glory,5618,8,10,2,15,37,50,-13,32
Wellington P,5618,9,5,6,16,31,55,-24,21
CC Mariners,5618,10,4,8,15,28,49,-21,20
Sydney FC,5619,1,21,4,3,68,22,46,67
N'castle Jet,5619,2,15,6,7,59,39,20,51
Melbourne C,5619,3,14,5,10,45,35,10,47
Melbourne V,5619,4,13,5,11,45,42,3,44
Adelaide Utd,5619,5,11,6,11,37,40,-3,39
Brisbane,5619,6,10,5,13,33,42,-9,35
Western Sydn,5619,7,8,9,10,38,47,-9,33
Perth Glory,5619,8,10,2,15,37,50,-13,32
Wellington P,5619,9,5,6,16,31,55,-24,21
CC Mariners,5619,10,4,8,15,28,49,-21,20
Sydney FC,5620,1,20,4,4,64,24,40,64
N'castle Jet,5620,2,15,5,8,57,38,19,50
Melbourne C,5620,3,15,4,10,44,33,11,49
Melbourne V,5620,4,14,5,10,47,38,9,47
Adelaide Utd,5620,5,11,6,11,37,40,-3,39
Brisbane,5620,6,10,5,13,33,42,-9,35
Western Sydn,5620,7,8,9,10,38,47,-9,33
Perth Glory,5620,8,10,2,15,37,50,-13,32
Wellington P,5620,9,5,6,16,31,55,-24,21
CC Mariners,5620,10,4,8,15,28,49,-21,20
Sydney FC,5621,1,20,5,3,64,22,42,65
N'castle Jet,5621,2,16,5,7,59,38,21,53
Melbourne C,5621,3,14,4,11,44,35,9,46
Melbourne V,5621,4,13,6,10,45,38,7,45
Adelaide Utd,5621,5,11,6,11,37,40,-3,39
Brisbane,5621,6,10,5,13,33,42,-9,35
Western Sydn,5621,7,8,9,10,38,47,-9,33
Perth Glory,5621,8,10,2,15,37,50,-13,32
Wellington P,5621,9,5,6,16,31,55,-24,21
CC Mariners,5621,10,4,8,15,28,49,-21,20
Sydney FC,5622,1,20,4,4,66,25,41,64
N'castle Jet,5622,2,16,5,7,61,38,23,53
Melbourne V,5622,3,14,5,10,48,40,8,47
Melbourne C,5622,4,14,4,11,44,37,7,46
Adelaide Utd,5622,5,11,6,11,37,40,-3,39
Brisbane,5622,6,10,5,13,33,42,-9,35
Western Sydn,5622,7,8,9,10,38,47,-9,33
Perth Glory,5622,8,10,2,15,37,50,-13,32
Wellington P,5622,9,5,6,16,31,55,-24,21
CC Mariners,5622,10,4,8,15,28,49,-21,20
Sydney FC,5623,1,20,5,3,67,25,42,65
N'castle Jet,5623,2,15,6,7,57,37,20,51
Melbourne C,5623,3,14,5,10,43,33,10,47
Melbourne V,5623,4,13,6,10,48,41,7,45
Adelaide Utd,5623,5,11,6,11,37,40,-3,39
Brisbane,5623,6,10,5,13,33,42,-9,35
Western Sydn,5623,7,8,9,10,38,47,-9,33
Perth Glory,5623,8,10,2,15,37,50,-13,32
Wellington P,5623,9,5,6,16,31,55,-24,21
CC Mariners,5623,10,4,8,15,28,49,-21,20
Sydney FC,5624,1,21,4,3,69,25,44,67
N'castle Jet,5624,2,15,6,7,59,39,20,51
Melbourne C,5624,3,14,5,10,45,35,10,47
Melbourne V,5624,4,13,5,11,48,43,5,44
Adelaide Utd,5624,5,11,6,11,37,40,-3,39
Brisbane,5624,6,10,5,13,33,42,-9,35
Western Sydn,5624,7,8,9,10,38,47,-9,33
Perth Glory,5624,8,10,2,15,37,50,-13,32
Wellington P,5624,9,5,6,16,31,55,-24,21
CC Mariners,5624,10,4,8,15,28,49,-21,20
Sydney FC,5625,1,20,5,3,64,22,42,65
N'castle Jet,5625,2,16,5,7,60,38,22,53
Melbourne C,5625,3,14,4,11,44,36,8,46
Melbourne V,5625,4,13,6,10,45,38,7,45
Adelaide Utd,5625,5,11,6,11,37,40,-3,39
Brisbane,5625,6,10,5,13,33,42,-9,35
Western Sydn,5625,7,8,9,10,38,47,-9,33
Perth Glory,5625,8,10,2,15,37,50,-13,32
Wellington P,5625,9,5,6,16,31,55,-24,21
CC Mariners,5625,10,4,8,15,28,49,-21,20
Sydney FC,5626,1,21,4,3,67,23,44,67
N'castle Jet,5626,2,16,5,7,60,38,22,53
Melbourne C,5626,3,14,4,11,44,36,8,46
Melbourne V,5626,4,13,5,11,46,41,5,44
Adelaide Utd,5626,5,11,6,11,37,40,-3,39
Brisbane,5626,6,10,5,13,33,42,-9,35
Western Sydn,5626,7,8,9,10,38,47,-9,33
Perth Glory,5626,8,10,2,15,37,50,-13,32
Wellington P,5626,9,5,6,16,31,55,-24,21
CC Mariners,5626,10,4,8,15,28,49,-21,20
Sydney FC,5627,1,21,4,3,65,22,43,67
N'castle Jet,5627,2,15,5,8,57,38,19,50
Melbourne C,5627,3,15,4,10,44,33,11,49
Melbourne V,5627,4,13,5,11,45,39,6,44
Adelaide Utd,5627,5,11,6,11,37,40,-3,39
Brisbane,5627,6,10,5,13,33,42,-9,35
Western Sydn,5627,7,8,9,10,38,47,-9,33
Perth Glory,5627,8,10,2,15,37,50,-13,32
Wellington P,5627,9,5,6,16,31,55,-24,21
CC Mariners,5627,10,4,8,15,28,49,-21,20
Sydney FC,5628,1,21,4,3,65,22,43,67
N'castle Jet,5628,2,15,6,7,59,39,20,51
Melbourne C,5628,3,14,5,10,45,35,10,47
Melbourne V,5628,4,13,5,11,45,39,6,44
Adelaide Utd,5628,5,11,6,11,37,40,-3,39
Brisbane,5628,6,10,5,13,33,42,-9,35
Western Sydn,5628,7,8,9,10,38,47,-9,33
Perth Glory,5628,8,10,2,15,37,50,-13,32
Wellington P,5628,9,5,6,16,31,55,-24,21
CC Mariners,5628,10,4,8,15,28,49,-21,20
Sydney FC,5629,1,21,4,3,65,22,43,67
N'castle Jet,5629,2,16,5,7,59,38,21,53
Melbourne C,5629,3,14,4,11,44,35,9,46
Melbourne V,5629,4,13,5,11,45,39,6,44
Adelaide Utd,5629,5,11,6,11,37,40,-3,39
Brisbane,5629,6,10,5,13,33,42,-9,35
Western Sydn,5629,7,8,9,10,38,47,-9,33
Perth Glory,5629,8,10,2,15,37,50,-13,32
Wellington P,5629,9,5,6,16,31,55,-24,21
CC Mariners,5629,10,4,8,15,28,49,-21,20
Sydney FC,5630,1,20,5,3,65,23,42,65
N'castle Jet,5630,2,16,5,7,58,37,21,53
Melbourne C,5630,3,14,4,11,43,34,9,46
Melbourne V,5630,4,13,6,10,46,39,7,45
Adelaide Utd,5630,5,11,6,11,37,40,-3,39
Brisbane,5630,6,10,5,13,33,42,-9,35
Western Sydn,5630,7,8,9,10,38,47,-9,33
Perth Glory,5630,8,10,2,15,37,50,-13,32
Wellington P,5630,9,5,6,16,31,55,-24,21
CC Mariners,5630,10,4,8,15,28,49,-21,20
Sydney FC,5631,1,20,5,3,66,24,42,65
N'castle Jet,5631,2,16,5,7,60,38,22,53
Melbourne C,5631,3,14,4,11,44,36,8,46
Melbourne V,5631,4,13,6,10,47,40,7,45
Adelaide Utd,5631,5,11,6,11,37,40,-3,39
Brisbane,5631,6,10,5,13,33,42,-9,35
Western Sydn,5631,7,8,9,10,38,47,-9,33
Perth Glory,5631,8,10,2,15,37,50,-13,32
Wellington P,5631,9,5,6,16,31,55,-24,21
CC Mariners,5631,10,4,8,15,28,49,-21,20
Sydney FC,5632,1,21,4,3,66,23,43,67
N'castle Jet,5632,2,16,5,7,59,38,21,53
Melbourne C,5632,3,14,4,11,44,35,9,46
Melbourne V,5632,4,13,5,11,46,40,6,44
Adelaide Utd,5632,5,11,6,11,37,40,-3,39
Brisbane,5632,6,10,5,13,33,42,-9,35
Western Sydn,5632,7,8,9,10,38,47,-9,33
Perth Glory,5632,8,10,2,15,37,50,-13,32
Wellington P,5632,9,5,6,16,31,55,-24,21
CC Mariners,5632,10,4,8,15,28,49,-21,20
Sydney FC,5633,1,21,4,3,65,22,43,67
N'castle Jet,5633,2,16,5,7,60,37,23,53
Melbourne C,5633,3,14,4,11,43,36,7,46
Melbourne V,5633,4,13,5,11,45,39,6,44
Adelaide Utd,5633,5,11,6,11,37,40,-3,39
Brisbane,5633,6,10,5,13,33,42,-9,35
Western Sydn,5633,7,8,9,10,38,47,-9,33
Perth Glory,5633,8,10,2,15,37,50,-13,32
Wellington P,5633,9,5,6,16,31,55,-24,21
CC Mariners,5633,10,4,8,15,28,49,-21,20
Sydney FC,5634,1,20,5,3,64,22,42,65
N'castle Jet,5634,2,15,6,7,60,40,20,51
Melbourne C,5634,3,14,5,10,46,36,10,47
Melbourne V,5634,4,13,6,10,45,38,7,45
Adelaide Utd,5634,5,11,6,11,37,40,-3,39
Brisbane,5634,6,10,5,13,33,42,-9,35
Western Sydn,5634,7,8,9,10,38,47,-9,33
Perth Glory,5634,8,10,2,15,37,50,-13,32
Wellington P,5634,9,5,6,16,31,55,-24,21
CC Mariners,5634,10,4,8,15,28,49,-21,20
Sydney FC,5635,1,20,5,3,64,22,42,65
N'castle Jet,5635,2,15,5,8,58,39,19,50
Melbourne C,5635,3,15,4,10,45,34,11,49
Melbourne V,5635,4,13,6,10,45,38,7,45
Adelaide Utd,5635,5,11,6,11,37,40,-3,39
Brisbane,5635,6,10,5,13,33,42,-9,35
Western Sydn,5635,7,8,9,10,38,47,-9,33
Perth Glory,5635,8,10,2,15,37,50,-13,32
Wellington P,5635,9,5,6,16,31,55,-24,21
CC Mariners,5635,10,4,8,15,28,49,-21,20
Sydney FC,5636,1,21,4,3,70,23,47,67
N'castle Jet,5636,2,16,5,7,59,38,21,53
Melbourne C,5636,3,14,4,11,44,35,9,46
Melbourne V,5636,4,13,5,11,46,44,2,44
Adelaide Utd,5636,5,11,6,11,37,40,-3,39
Brisbane,5636,6,10,5,13,33,42,-9,35
Western Sydn,5636,7,8,9,10,38,47,-9,33
Perth Glory,5636,8,10,2,15,37,50,-13,32
Wellington P,5636,9,5,6,16,31,55,-24,21
CC Mariners,5636,10,4,8,15,28,49,-21,20
Sydney FC,5637,1,21,4,3,66,23,43,67
N'castle Jet,5637,2,16,5,7,59,37,22,53
Melbourne C,5637,3,14,4,11,43,35,8,46
Melbourne V,5637,4,13,5,11,46,40,6,44
Adelaide Utd,5637,5,11,6,11,37,40,-3,39
Brisbane,5637,6,10,5,13,33,42,-9,35
Western Sydn,5637,7,8,9,10,38,47,-9,33
Perth Glory,5637,8,10,2,15,37,50,-13,32
Wellington P,5637,9,5,6,16,31,55,-24,21
CC Mariners,5637,10,4,8,15,28,49,-21,20
Sydney FC,5638,1,20,5,3,65,23,42,65
N'castle Jet,5638,2,16,5,7,60,38,22,53
Melbourne C,5638,3,14,4,11,44,36,8,46
Melbourne V,5638,4,13,6,10,46,39,7,45
Adelaide Utd,5638,5,11,6,11,37,40,-3,39
Brisbane,5638,6,10,5,13,33,42,-9,35
Western Sydn,5638,7,8,9,10,38,47,-9,33
Perth Glory,5638,8,10,2,15,37,50,-13,32
Wellington P,5638,9,5,6,16,31,55,-24,21
CC Mariners,5638,10,4,8,15,28,49,-21,20
Sydney FC,5639,1,21,4,3,67,23,44,67
N'castle Jet,5639,2,16,5,7,61,38,23,53
Melbourne C,5639,3,14,4,11,44,37,7,46
Melbourne V,5639,4,13,5,11,46,41,5,44
Adelaide Utd,5639,5,11,6,11,37,40,-3,39
Brisbane,5639,6,10,5,13,33,42,-9,35
Western Sydn,5639,7,8,9,10,38,47,-9,33
Perth Glory,5639,8,10,2,15,37,50,-13,32
Wellington P,5639,9,5,6,16,31,55,-24,21
CC Mariners,5639,10,4,8,15,28,49,-21,20
Sydney FC,5640,1,20,4,4,64,23,41,64
N'castle Jet,5640,2,15,5,8,58,40,18,50
Melbourne C,5640,3,15,4,10,46,34,12,49
Melbourne V,5640,4,14,5,10,46,38,8,47
Adelaide Utd,5640,5,11,6,11,37,40,-3,39
Brisbane,5640,6,10,5,13,33,42,-9,35
Western Sydn,5640,7,8,9,10,38,47,-9,33
Perth Glory,5640,8,10,2,15,37,50,-13,32
Wellington P,5640,9,5,6,16,31,55,-24,21
CC Mariners,5640,10,4,8,15,28,49,-21,20
Sydney FC,5641,1,21,4,3,65,22,43,67
N'castle Jet,5641,2,15,5,8,58,41,17,50
Melbourne C,5641,3,15,4,10,47,34,13,49
Melbourne V,5641,4,13,5,11,45,39,6,44
Adelaide Utd,5641,5,11,6,11,37,40,-3,39
Brisbane,5641,6,10,5,13,33,42,-9,35
Western Sydn,5641,7,8,9,10,38,47,-9,33
Perth Glory,5641,8,10,2,15,37,50,-13,32
Wellington P,5641,9,5,6,16,31,55,-24,21
CC Mariners,5641,10,4,8,15,28,49,-21,20
Sydney FC,5642,1,21,4,3,68,24,44,67
N'castle Jet,5642,2,15,5,8,57,39,18,50
Melbourne C,5642,3,15,4,10,45,33,12,49
Melbourne V,5642,4,13,5,11,47,42,5,44
Adelaide Utd,5642,5,11,6,11,37,40,-3,39
Brisbane,5642,6,10,5,13,33,42,-9,35
Western Sydn,5642,7,8,9,10,38,47,-9,33
Perth Glory,5642,8,10,2,15,37,50,-13,32
Wellington P,5642,9,5,6,16,31,55,-24,21
CC Mariners,5642,10,4,8,15,28,49,-21,20
Sydney FC,5643,1,21,4,3,68,23,45,67
N'castle Jet,5643,2,16,5,7,59,38,21,53
Melbourne C,5643,3,14,4,11,44,35,9,46
Melbourne V,5643,4,13,5,11,46,42,4,44
Adelaide Utd,5643,5,11,6,11,37,40,-3,39
Brisbane,5643,6,10,5,13,33,42,-9,35
Western Sydn,5643,7,8,9,10,38,47,-9,33
Perth Glory,5643,8,10,2,15,37,50,-13,32
Wellington P,5643,9,5,6,16,31,55,-24,21
CC Mariners,5643,10,4,8,15,28,49,-21,20
Sydney FC,5644,1,21,4,3,66,22,44,67
N'castle Jet,5644,2,16,5,7,60,39,21,53
Melbourne C,5644,3,14,4,11,45,36,9,46
Melbourne V,5644,4,13,5,11,45,40,5,44
Adelaide Utd,5644,5,11,6,11,37,40,-3,39
Brisbane,5644,6,10,5,13,33,42,-9,35
Western Sydn,5644,7,8,9,10,38,47,-9,33
Perth Glory,5644,8,10,2,15,37,50,-13,32
Wellington P,5644,9,5,6,16,31,55,-24,21
CC Mariners,5644,10,4,8,15,28,49,-21,20
Sydney FC,5645,1,21,4,3,66,23,43,67
N'castle Jet,5645,2,16,5,7,60,38,22,53
Melbourne C,5645,3,14,4,11,44,36,8,46
Melbourne V,5645,4,13,5,11,46,40,6,44
Adelaide Utd,5645,5,11,6,11,37,40,-3,39
Brisbane,5645,6,10,5,13,33,42,-9,35
Western Sydn,5645,7,8,9,10,38,47,-9,33
Perth Glory,5645,8,10,2,15,37,50,-13,32
Wellington P,5645,9,5,6,16,31,55,-24,21
CC Mariners,5645,10,4,8,15,28,49,-21,20
Sydney FC,5646,1,20,4,4,64,24,40,64
N'castle Jet,5646,2,16,5,7,60,38,22,53
Melbourne V,5646,3,14,5,10,47,38,9,47
Melbourne C,5646,4,14,4,11,44,36,8,46
Adelaide Utd,5646,5,11,6,11,37,40,-3,39
Brisbane,5646,6,10,5,13,33,42,-9,35
Western Sydn,5646,7,8,9,10,38,47,-9,33
Perth Glory,5646,8,10,2,15,37,50,-13,32
Wellington P,5646,9,5,6,16,31,55,-24,21
CC Mariners,5646,10,4,8,15,28,49,-21,20
Sydney FC,5647,1,20,4,4,65,24,41,64
N'castle Jet,5647,2,15,5,8,58,39,19,50
Melbourne C,5647,3,15,4,10,45,34,11,49
Melbourne V,5647,4,14,5,10,47,39,8,47
Adelaide Utd,5647,5,11,6,11,37,40,-3,39
Brisbane,5647,6,10,5,13,33,42,-9,35
Western Sydn,5647,7,8,9,10,38,47,-9,33
Perth Glory,5647,8,10,2,15,37,50,-13,32
Wellington P,5647,9,5,6,16,31,55,-24,21
CC Mariners,5647,10,4,8,15,28,49,-21,20
Sydney FC,5648,1,21,4,3,68,22,46,67
N'castle Jet,5648,2,15,5,8,57,38,19,50
Melbourne C,5648,3,15,4,10,44,33,11,49
Melbourne V,5648,4,13,5,11,45,42,3,44
Adelaide Utd,5648,5,11,6,11,37,40,-3,39
Brisbane,5648,6,10,5,13,33,42,-9,35
Western Sydn,5648,7,8,9,10,38,47,-9,33
Perth Glory,5648,8,10,2,15,37,50,-13,32
Wellington P,5648,9,5,6,16,31,55,-24,21
CC Mariners,5648,10,4,8,15,28,49,-21,20
Sydney FC,5649,1,21,4,3,67,23,44,67
N'castle Jet,5649,2,16,5,7,61,38,23,53
Melbourne C,5649,3,14,4,11,44,37,7,46
Melbourne V,5649,4,13,5,11,46,41,5,44
Adelaide Utd,5649,5,11,6,11,37,40,-3,39
Brisbane,5649,6,10,5,13,33,42,-9,35
Western Sydn,5649,7,8,9,10,38,47,-9,33
Perth Glory,5649,8,10,2,15,37,50,-13,32
Wellington P,5649,9,5,6,16,31,55,-24,21
CC Mariners,5649,10,4,8,15,28,49,-21,20
Sydney FC,5650,1,21,4,3,68,23,45,67
N'castle Jet,5650,2,15,5,8,57,38,19,50
Melbourne C,5650,3,15,4,10,44,33,11,49
Melbourne V,5650,4,13,5,11,46,42,4,44
Adelaide Utd,5650,5,11,6,11,37,40,-3,39
Brisbane,5650,6,10,5,13,33,42,-9,35
Western Sydn,5650,7,8,9,10,38,47,-9,33
Perth Glory,5650,8,10,2,15,37,50,-13,32
Wellington P,5650,9,5,6,16,31,55,-24,21
CC Mariners,5650,10,4,8,15,28,49,-21,20
Sydney FC,5651,1,21,4,3,68,23,45,67
N'castle Jet,5651,2,15,6,7,57,37,20,51
Melbourne C,5651,3,14,5,10,43,33,10,47
Melbourne V,5651,4,13,5,11,46,42,4,44
Adelaide Utd,5651,5,11,6,11,37,40,-3,39
Brisbane,5651,6,10,5,13,33,42,-9,35
Western Sydn,5651,7,8,9,10,38,47,-9,33
Perth Glory,5651,8,10,2,15,37,50,-13,32
Wellington P,5651,9,5,6,16,31,55,-24,21
CC Mariners,5651,10,4,8,15,28,49,-21,20
Sydney FC,5652,1,20,4,4,65,25,40,64
N'castle Jet,5652,2,15,5,8,59,40,19,50
Melbourne C,5652,3,15,4,10,46,35,11,49
Melbourne V,5652,4,14,5,10,48,39,9,47
Adelaide Utd,5652,5,11,6,11,37,40,-3,39
Brisbane,5652,6,10,5,13,33,42,-9,35
Western Sydn,5652,7,8,9,10,38,47,-9,33
Perth Glory,5652,8,10,2,15,37,50,-13,32
Wellington P,5652,9,5,6,16,31,55,-24,21
CC Mariners,5652,10,4,8,15,28,49,-21,20
Sydney FC,5653,1,21,4,3,67,23,44,67
N'castle Jet,5653,2,15,6,7,57,37,20,51
Melbourne C,5653,3,14,5,10,43,33,10,47
Melbourne V,5653,4,13,5,11,46,41,5,44
Adelaide Utd,5653,5,11,6,11,37,40,-3,39
Brisbane,5653,6,10,5,13,33,42,-9,35
Western Sydn,5653,7,8,9,10,38,47,-9,33
Perth Glory,5653,8,10,2,15,37,50,-13,32
Wellington P,5653,9,5,6,16,31,55,-24,21
CC Mariners,5653,10,4,8,15,28,49,-21,20
Sydney FC,5654,1,21,4,3,68,22,46,67
N'castle Jet,5654,2,16,5,7,59,38,21,53
Melbourne C,5654,3,14,4,11,44,35,9,46
Melbourne V,5654,4,13,5,11,45,42,3,44
Adelaide Utd,5654,5,11,6,11,37,40,-3,39
Brisbane,5654,6,10,5,13,33,42,-9,35
Western Sydn,5654,7,8,9,10,38,47,-9,33
Perth Glory,5654,8,10,2,15,37,50,-13,32
Wellington P,5654,9,5,6,16,31,55,-24,21
CC Mariners,5654,10,4,8,15,28,49,-21,20
Sydney FC,5655,1,21,4,3,66,23,43,67
N'castle Jet,5655,2,15,6,7,58,38,20,51
Melbourne C,5655,3,14,5,10,44,34,10,47
Melbourne V,5655,4,13,5,11,46,40,6,44
Adelaide Utd,5655,5,11,6,11,37,40,-3,39
Brisbane,5655,6,10,5,13,33,42,-9,35
Western Sydn,5655,7,8,9,10,38,47,-9,33
Perth Glory,5655,8,10,2,15,37,50,-13,32
Wellington P,5655,9,5,6,16,31,55,-24,21
CC Mariners,5655,10,4,8,15,28,49,-21,20
Sydney FC,5656,1,20,4,4,65,25,40,64
N'castle Jet,5656,2,16,5,7,58,37,21,53
Melbourne V,5656,3,14,5,10,48,39,9,47
Melbourne C,5656,4,14,4,11,43,34,9,46
Adelaide Utd,5656,5,11,6,11,37,40,-3,39
Brisbane,5656,6,10,5,13,33,42,-9,35
Western Sydn,5656,7,8,9,10,38,47,-9,33
Perth Glory,5656,8,10,2,15,37,50,-13,32
Wellington P,5656,9,5,6,16,31,55,-24,21
CC Mariners,5656,10,4,8,15,28,49,-21,20
Sydney FC,5657,1,21,4,3,68,24,44,67
N'castle Jet,5657,2,15,5,8,57,39,18,50
Melbourne C,5657,3,15,4,10,45,33,12,49
Melbourne V,5657,4,13,5,11,47,42,5,44
Adelaide Utd,5657,5,11,6,11,37,40,-3,39
Brisbane,5657,6,10,5,13,33,42,-9,35
Western Sydn,5657,7,8,9,10,38,47,-9,33
Perth Glory,5657,8,10,2,15,37,50,-13,32
Wellington P,5657,9,5,6,16,31,55,-24,21
CC Mariners,5657,10,4,8,15,28,49,-21,20
Sydney FC,5658,1,21,4,3,67,24,43,67
N'castle Jet,5658,2,16,5,7,60,38,22,53
Melbourne C,5658,3,14,4,11,44,36,8,46
Melbourne V,5658,4,13,5,11,47,41,6,44
Adelaide Utd,5658,5,11,6,11,37,40,-3,39
Brisbane,5658,6,10,5,13,33,42,-9,35
Western Sydn,5658,7,8,9,10,38,47,-9,33
Perth Glory,5658,8,10,2,15,37,50,-13,32
Wellington P,5658,9,5,6,16,31,55,-24,21
CC Mariners,5658,10,4,8,15,28,49,-21,20
Sydney FC,5659,1,21,4,3,67,23,44,67
N'castle Jet,5659,2,15,5,8,57,39,18,50
Melbourne C,5659,3,15,4,10,45,33,12,49
Melbourne V,5659,4,13,5,11,46,41,5,44
Adelaide Utd,5659,5,11,6,11,37,40,-3,39
Brisbane,5659,6,10,5,13,33,42,-9,35
Western Sydn,5659,7,8,9,10,38,47,-9,33
Perth Glory,5659,8,10,2,15,37,50,-13,32
Wellington P,5659,9,5,6,16,31,55,-24,21
CC Mariners,5659,10,4,8,15,28,49,-21,20
Sydney FC,5660,1,21,4,3,69,22,47,67
N'castle Jet,5660,2,15,5,8,59,40,19,50
Melbourne C,5660,3,15,4,10,46,35,11,49
Melbourne V,5660,4,13,5,11,45,43,2,44
Adelaide Utd,5660,5,11,6,11,37,40,-3,39
Brisbane,5660,6,10,5,13,33,42,-9,35
Western Sydn,5660,7,8,9,10,38,47,-9,33
Perth Glory,5660,8,10,2,15,37,50,-13,32
Wellington P,5660,9,5,6,16,31,55,-24,21
CC Mariners,5660,10,4,8,15,28,49,-21,20
Sydney FC,5661,1,21,4,3,66,22,44,67
N'castle Jet,5661,2,16,5,7,59,38,21,53
Melbourne C,5661,3,14,4,11,44,35,9,46
Melbourne V,5661,4,13,5,11,45,40,5,44
Adelaide Utd,5661,5,11,6,11,37,40,-3,39
Brisbane,5661,6,10,5,13,33,42,-9,35
Western Sydn,5661,7,8,9,10,38,47,-9,33
Perth Glory,5661,8,10,2,15,37,50,-13,32
Wellington P,5661,9,5,6,16,31,55,-24,21
CC Mariners,5661,10,4,8,15,28,49,-21,20
Sydney FC,5662,1,21,4,3,65,22,43,67
N'castle Jet,5662,2,15,5,8,58,39,19,50
Melbourne C,5662,3,15,4,10,45,34,11,49
Melbourne V,5662,4,13,5,11,45,39,6,44
Adelaide Utd,5662,5,11,6,11,37,40,-3,39
Brisbane,5662,6,10,5,13,33,42,-9,35
Western Sydn,5662,7,8,9,10,38,47,-9,33
Perth Glory,5662,8,10,2,15,37,50,-13,32
Wellington P,5662,9,5,6,16,31,55,-24,21
CC Mariners,5662,10,4,8,15,28,49,-21,20
Sydney FC,5663,1,21,4,3,66,22,44,67
N'castle Jet,5663,2,15,6,7,57,37,20,51
Melbourne C,5663,3,14,5,10,43,33,10,47
Melbourne V,5663,4,13,5,11,45,40,5,44
Adelaide Utd,5663,5,11,6,11,37,40,-3,39
Brisbane,5663,6,10,5,13,33,42,-9,35
Western Sydn,5663,7,8,9,10,38,47,-9,33
Perth Glory,5663,8,10,2,15,37,50,-13,32
Wellington P,5663,9,5,6,16,31,55,-24,21
CC Mariners,5663,10,4,8,15,28,49,-21,20
Sydney FC,5664,1,21,4,3,66,22,44,67
N'castle Jet,5664,2,15,6,7,58,38,20,51
Melbourne C,5664,3,14,5,10,44,34,10,47
Melbourne V,5664,4,13,5,11,45,40,5,44
Adelaide Utd,5664,5,11,6,11,37,40,-3,39
Brisbane,5664,6,10,5,13,33,42,-9,35
Western Sydn,5664,7,8,9,10,38,47,-9,33
Perth Glory,5664,8,10,2,15,37,50,-13,32
Wellington P,5664,9,5,6,16,31,55,-24,21
CC Mariners,5664,10,4,8,15,28,49,-21,20
Sydney FC,5665,1,21,4,3,66,22,44,67
N'castle Jet,5665,2,16,5,7,58,37,21,53
Melbourne C,5665,3,14,4,11,43,34,9,46
Melbourne V,5665,4,13,5,11,45,40,5,44
Adelaide Utd,5665,5,11,6,11,37,40,-3,39
Brisbane,5665,6,10,5,13,33,42,-9,35
Western Sydn,5665,7,8,9,10,38,47,-9,33
Perth Glory,5665,8,10,2,15,37,50,-13,32
Wellington P,5665,9,5,6,16,31,55,-24,21
CC Mariners,5665,10,4,8,15,28,49,-21,20
Sydney FC,5666,1,21,4,3,67,24,43,67
N'castle Jet,5666,2,16,5,7,59,37,22,53
Melbourne C,5666,3,14,4,11,43,35,8,46
Melbourne V,5666,4,13,5,11,47,41,6,44
Adelaide Utd,5666,5,11,6,11,37,40,-3,39
Brisbane,5666,6,10,5,13,33,42,-9,35
Western Sydn,5666,7,8,9,10,38,47,-9,33
Perth Glory,5666,8,10,2,15,37,50,-13,32
Wellington P,5666,9,5,6,16,31,55,-24,21
CC Mariners,5666,10,4,8,15,28,49,-21,20
Sydney FC,5667,1,20,5,3,67,25,42,65
N'castle Jet,5667,2,15,6,7,59,39,20,51
Melbourne C,5667,3,14,5,10,45,35,10,47
Melbourne V,5667,4,13,6,10,48,41,7,45
Adelaide Utd,5667,5,11,6,11,37,40,-3,39
Brisbane,5667,6,10,5,13,33,42,-9,35
Western Sydn,5667,7,8,9,10,38,47,-9,33
Perth Glory,5667,8,10,2,15,37,50,-13,32
Wellington P,5667,9,5,6,16,31,55,-24,21
CC Mariners,5667,10,4,8,15,28,49,-21,20
Sydney FC,5668,1,20,4,4,65,24,41,64
N'castle Jet,5668,2,16,5,7,59,37,22,53
Melbourne V,5668,3,14,5,10,47,39,8,47
Melbourne C,5668,4,14,4,11,43,35,8,46
Adelaide Utd,5668,5,11,6,11,37,40,-3,39
Brisbane,5668,6,10,5,13,33,42,-9,35
Western Sydn,5668,7,8,9,10,38,47,-9,33
Perth Glory,5668,8,10,2,15,37,50,-13,32
Wellington P,5668,9,5,6,16,31,55,-24,21
CC Mariners,5668,10,4,8,15,28,49,-21,20
Sydney FC,5669,1,21,4,3,67,22,45,67
N'castle Jet,5669,2,15,6,7,57,37,20,51
Melbourne C,5669,3,14,5,10,43,33,10,47
Melbourne V,5669,4,13,5,11,45,41,4,44
Adelaide Utd,5669,5,11,6,11,37,40,-3,39
Brisbane,5669,6,10,5,13,33,42,-9,35
Western Sydn,5669,7,8,9,10,38,47,-9,33
Perth Glory,5669,8,10,2,15,37,50,-13,32
Wellington P,5669,9,5,6,16,31,55,-24,21
CC Mariners,5669,10,4,8,15,28,49,-21,20
Sydney FC,5670,1,21,4,3,68,23,45,67
N'castle Jet,5670,2,15,6,7,58,38,20,51
Melbourne C,5670,3,14,5,10,44,34,10,47
Melbourne V,5670,4,13,5,11,46,42,4,44
Adelaide Utd,5670,5,11,6,11,37,40,-3,39
Brisbane,5670,6,10,5,13,33,42,-9,35
Western Sydn,5670,7,8,9,10,38,47,-9,33
Perth Glory,5670,8,10,2,15,37,50,-13,32
Wellington P,5670,9,5,6,16,31,55,-24,21
CC Mariners,5670,10,4,8,15,28,49,-21,20
Sydney FC,5671,1,21,4,3,66,23,43,67
N'castle Jet,5671,2,16,5,7,59,38,21,53
Melbourne C,5671,3,14,4,11,44,35,9,46
Melbourne V,5671,4,13,5,11,46,40,6,44
Adelaide Utd,5671,5,11,6,11,37,40,-3,39
Brisbane,5671,6,10,5,13,33,42,-9,35
Western Sydn,5671,7,8,9,10,38,47,-9,33
Perth Glory,5671,8,10,2,15,37,50,-13,32
Wellington P,5671,9,5,6,16,31,55,-24,21
CC Mariners,5671,10,4,8,15,28,49,-21,20
Sydney FC,5672,1,20,5,3,65,23,42,65
N'castle Jet,5672,2,16,5,7,59,37,22,53
Melbourne C,5672,3,14,4,11,43,35,8,46
Melbourne V,5672,4,13,6,10,46,39,7,45
Adelaide Utd,5672,5,11,6,11,37,40,-3,39
Brisbane,5672,6,10,5,13,33,42,-9,35
Western Sydn,5672,7,8,9,10,38,47,-9,33
Perth Glory,5672,8,10,2,15,37,50,-13,32
Wellington P,5672,9,5,6,16,31,55,-24,21
CC Mariners,5672,10,4,8,15,28,49,-21,20
Sydney FC,5673,1,20,5,3,65,23,42,65
N'castle Jet,5673,2,16,5,7,60,38,22,53
Melbourne C,5673,3,14,4,11,44,36,8,46
Melbourne V,5673,4,13,6,10,46,39,7,45
Adelaide Utd,5673,5,11,6,11,37,40,-3,39
Brisbane,5673,6,10,5,13,33,42,-9,35
Western Sydn,5673,7,8,9,10,38,47,-9,33
Perth Glory,5673,8,10,2,15,37,50,-13,32
Wellington P,5673,9,5,6,16,31,55,-24,21
CC Mariners,5673,10,4,8,15,28,49,-21,20
Sydney FC,5674,1,20,4,4,65,24,41,64
N'castle Jet,5674,2,15,6,7,58,38,20,51
Melbourne C,5674,3,14,5,10,44,34,10,47
Melbourne V,5674,4,14,5,10,47,39,8,47
Adelaide Utd,5674,5,11,6,11,37,40,-3,39
Brisbane,5674,6,10,5,13,33,42,-9,35
Western Sydn,5674,7,8,9,10,38,47,-9,33
Perth Glory,5674,8,10,2,15,37,50,-13,32
Wellington P,5674,9,5,6,16,31,55,-24,21
CC Mariners,5674,10,4,8,15,28,49,-21,20
Sydney FC,5675,1,20,5,3,65,23,42,65
N'castle Jet,5675,2,16,5,7,60,38,22,53
Melbourne C,5675,3,14,4,11,44,36,8,46
Melbourne V,5675,4,13,6,10,46,39,7,45
Adelaide Utd,5675,5,11,6,11,37,40,-3,39
Brisbane,5675,6,10,5,13,33,42,-9,35
Western Sydn,5675,7,8,9,10,38,47,-9,33
Perth Glory,5675,8,10,2,15,37,50,-13,32
Wellington P,5675,9,5,6,16,31,55,-24,21
CC Mariners,5675,10,4,8,15,28,49,-21,20
Sydney FC,5676,1,20,5,3,65,23,42,65
N'castle Jet,5676,2,15,5,8,57,38,19,50
Melbourne C,5676,3,15,4,10,44,33,11,49
Melbourne V,5676,4,13,6,10,46,39,7,45
Adelaide Utd,5676,5,11,6,11,37,40,-3,39
Brisbane,5676,6,10,5,13,33,42,-9,35
Western Sydn,5676,7,8,9,10,38,47,-9,33
Perth Glory,5676,8,10,2,15,37,50,-13,32
Wellington P,5676,9,5,6,16,31,55,-24,21
CC Mariners,5676,10,4,8,15,28,49,-21,20
Sydney FC,5677,1,21,4,3,66,22,44,67
N'castle Jet,5677,2,15,6,7,58,38,20,51
Melbourne C,5677,3,14,5,10,44,34,10,47
Melbourne V,5677,4,13,5,11,45,40,5,44
Adelaide Utd,5677,5,11,6,11,37,40,-3,39
Brisbane,5677,6,10,5,13,33,42,-9,35
Western Sydn,5677,7,8,9,10,38,47,-9,33
Perth Glory,5677,8,10,2,15,37,50,-13,32
Wellington P,5677,9,5,6,16,31,55,-24,21
CC Mariners,5677,10,4,8,15,28,49,-21,20
Sydney FC,5678,1,21,4,3,65,22,43,67
N'castle Jet,5678,2,15,6,7,59,39,20,51
Melbourne C,5678,3,14,5,10,45,35,10,47
Melbourne V,5678,4,13,5,11,45,39,6,44
Adelaide Utd,5678,5,11,6,11,37,40,-3,39
Brisbane,5678,6,10,5,13,33,42,-9,35
Western Sydn,5678,7,8,9,10,38,47,-9,33
Perth Glory,5678,8,10,2,15,37,50,-13,32
Wellington P,5678,9,5,6,16,31,55,-24,21
CC Mariners,5678,10,4,8,15,28,49,-21,20
Sydney FC,5679,1,21,4,3,67,22,45,67
N'castle Jet,5679,2,15,5,8,57,38,19,50
Melbourne C,5679,3,15,4,10,44,33,11,49
Melbourne V,5679,4,13,5,11,45,41,4,44
Adelaide Utd,5679,5,11,6,11,37,40,-3,39
Brisbane,5679,6,10,5,13,33,42,-9,35
Western Sydn,5679,7,8,9,10,38,47,-9,33
Perth Glory,5679,8,10,2,15,37,50,-13,32
Wellington P,5679,9,5,6,16,31,55,-24,21
CC Mariners,5679,10,4,8,15,28,49,-21,20
Sydney FC,5680,1,21,4,3,67,23,44,67
N'castle Jet,5680,2,16,5,7,58,37,21,53
Melbourne C,5680,3,14,4,11,43,34,9,46
Melbourne V,5680,4,13,5,11,46,41,5,44
Adelaide Utd,5680,5,11,6,11,37,40,-3,39
Brisbane,5680,6,10,5,13,33,42,-9,35
Western Sydn,5680,7,8,9,10,38,47,-9,33
Perth Glory,5680,8,10,2,15,37,50,-13,32
Wellington P,5680,9,5,6,16,31,55,-24,21
CC Mariners,5680,10,4,8,15,28,49,-21,20
Sydney FC,5681,1,20,4,4,66,25,41,64
N'castle Jet,5681,2,16,5,7,60,38,22,53
Melbourne V,5681,3,14,5,10,48,40,8,47
Melbourne C,5681,4,14,4,11,44,36,8,46
Adelaide Utd,5681,5,11,6,11,37,40,-3,39
Brisbane,5681,6,10,5,13,33,42,-9,35
Western Sydn,5681,7,8,9,10,38,47,-9,33
Perth Glory,5681,8,10,2,15,37,50,-13,32
Wellington P,5681,9,5,6,16,31,55,-24,21
CC Mariners,5681,10,4,8,15,28,49,-21,20
Sydney FC,5682,1,20,5,3,65,23,42,65
N'castle Jet,5682,2,15,5,8,57,40,17,50
Melbourne C,5682,3,15,4,10,46,33,13,49
Melbourne V,5682,4,13,6,10,46,39,7,45
Adelaide Utd,5682,5,11,6,11,37,40,-3,39
Brisbane,5682,6,10,5,13,33,42,-9,35
Western Sydn,5682,7,8,9,10,38,47,-9,33
Perth Glory,5682,8,10,2,15,37,50,-13,32
Wellington P,5682,9,5,6,16,31,55,-24,21
CC Mariners,5682,10,4,8,15,28,49,-21,20
Sydney FC,5683,1,21,4,3,66,22,44,67
N'castle Jet,5683,2,16,5,7,59,38,21,53
Melbourne C,5683,3,14,4,11,44,35,9,46
Melbourne V,5683,4,13,5,11,45,40,5,44
Adelaide Utd,5683,5,11,6,11,37,40,-3,39
Brisbane,5683,6,10,5,13,33,42,-9,35
Western Sydn,5683,7,8,9,10,38,47,-9,33
Perth Glory,5683,8,10,2,15,37,50,-13,32
Wellington P,5683,9,5,6,16,31,55,-24,21
CC Mariners,5683,10,4,8,15,28,49,-21,20
Sydney FC,5684,1,21,4,3,69,22,47,67
N'castle Jet,5684,2,16,5,7,60,39,21,53
Melbourne C,5684,3,14,4,11,45,36,9,46
Melbourne V,5684,4,13,5,11,45,43,2,44
Adelaide Utd,5684,5,11,6,11,37,40,-3,39
Brisbane,5684,6,10,5,13,33,42,-9,35
Western Sydn,5684,7,8,9,10,38,47,-9,33
Perth Glory,5684,8,10,2,15,37,50,-13,32
Wellington P,5684,9,5,6,16,31,55,-24,21
CC Mariners,5684,10,4,8,15,28,49,-21,20
Sydney FC,5685,1,20,4,4,65,24,41,64
N'castle Jet,5685,2,16,5,7,60,39,21,53
Melbourne V,5685,3,14,5,10,47,39,8,47
Melbourne C,5685,4,14,4,11,45,36,9,46
Adelaide Utd,5685,5,11,6,11,37,40,-3,39
Brisbane,5685,6,10,5,13,33,42,-9,35
Western Sydn,5685,7,8,9,10,38,47,-9,33
Perth Glory,5685,8,10,2,15,37,50,-13,32
Wellington P,5685,9,5,6,16,31,55,-24,21
CC Mariners,5685,10,4,8,15,28,49,-21,20
Sydney FC,5686,1,21,4,3,67,22,45,67
N'castle Jet,5686,2,15,5,8,58,41,17,50
Melbourne C,5686,3,15,4,10,47,34,13,49
Melbourne V,5686,4,13,5,11,45,41,4,44
Adelaide Utd,5686,5,11,6,11,37,40,-3,39
Brisbane,5686,6,10,5,13,33,42,-9,35
Western Sydn,5686,7,8,9,10,38,47,-9,33
Perth Glory,5686,8,10,2,15,37,50,-13,32
Wellington P,5686,9,5,6,16,31,55,-24,21
CC Mariners,5686,10,4,8,15,28,49,-21,20
Sydney FC,5687,1,20,4,4,65,25,40,64
N'castle Jet,5687,2,15,5,8,57,38,19,50
Melbourne C,5687,3,15,4,10,44,33,11,49
Melbourne V,5687,4,14,5,10,48,39,9,47
Adelaide Utd,5687,5,11,6,11,37,40,-3,39
Brisbane,5687,6,10,5,13,33,42,-9,35
Western Sydn,5687,7,8,9,10,38,47,-9,33
Perth Glory,5687,8,10,2,15,37,50,-13,32
Wellington P,5687,9,5,6,16,31,55,-24,21
CC Mariners,5687,10,4,8,15,28,49,-21,20
Sydney FC,5688,1,21,4,3,68,22,46,67
N'castle Jet,5688,2,15,6,7,58,38,20,51
Melbourne C,5688,3,14,5,10,44,34,10,47
Melbourne V,5688,4,13,5,11,45,42,3,44
Adelaide Utd,5688,5,11,6,11,37,40,-3,39
Brisbane,5688,6,10,5,13,33,42,-9,35
Western Sydn,5688,7,8,9,10,38,47,-9,33
Perth Glory,5688,8,10,2,15,37,50,-13,32
Wellington P,5688,9,5,6,16,31,55,-24,21
CC Mariners,5688,10,4,8,15,28,49,-21,20
Sydney FC,5689,1,20,5,3,65,23,42,65
N'castle Jet,5689,2,15,5,8,57,39,18,50
Melbourne C,5689,3,15,4,10,45,33,12,49
Melbourne V,5689,4,13,6,10,46,39,7,45
Adelaide Utd,5689,5,11,6,11,37,40,-3,39
Brisbane,5689,6,10,5,13,33,42,-9,35
Western Sydn,5689,7,8,9,10,38,47,-9,33
Perth Glory,5689,8,10,2,15,37,50,-13,32
Wellington P,5689,9,5,6,16,31,55,-24,21
CC Mariners,5689,10,4,8,15,28,49,-21,20
Sydney FC,5690,1,20,5,3,65,23,42,65
N'castle Jet,5690,2,15,5,8,57,40,17,50
Melbourne C,5690,3,15,4,10,46,33,13,49
Melbourne V,5690,4,13,6,10,46,39,7,45
Adelaide Utd,5690,5,11,6,11,37,40,-3,39
Brisbane,5690,6,10,5,13,33,42,-9,35
Western Sydn,5690,7,8,9,10,38,47,-9,33
Perth Glory,5690,8,10,2,15,37,50,-13,32
Wellington P,5690,9,5,6,16,31,55,-24,21
CC Mariners,5690,10,4,8,15,28,49,-21,20
Sydney FC,5691,1,20,5,3,66,24,42,65
N'castle Jet,5691,2,16,5,7,60,38,22,53
Melbourne C,5691,3,14,4,11,44,36,8,46
Melbourne V,5691,4,13,6,10,47,40,7,45
Adelaide Utd,5691,5,11,6,11,37,40,-3,39
Brisbane,5691,6,10,5,13,33,42,-9,35
Western Sydn,5691,7,8,9,10,38,47,-9,33
Perth Glory,5691,8,10,2,15,37,50,-13,32
Wellington P,5691,9,5,6,16,31,55,-24,21
CC Mariners,5691,10,4,8,15,28,49,-21,20
Sydney FC,5692,1,21,4,3,66,23,43,67
N'castle Jet,5692,2,15,6,7,59,39,20,51
Melbourne C,5692,3,14,5,10,45,35,10,47
Melbourne V,5692,4,13,5,11,46,40,6,44
Adelaide Utd,5692,5,11,6,11,37,40,-3,39
Brisbane,5692,6,10,5,13,33,42,-9,35
Western Sydn,5692,7,8,9,10,38,47,-9,33
Perth Glory,5692,8,10,2,15,37,50,-13,32
Wellington P,5692,9,5,6,16,31,55,-24,21
CC Mariners,5692,10,4,8,15,28,49,-21,20
Sydney FC,5693,1,20,4,4,65,24,41,64
N'castle Jet,5693,2,16,5,7,59,37,22,53
Melbourne V,5693,3,14,5,10,47,39,8,47
Melbourne C,5693,4,14,4,11,43,35,8,46
Adelaide Utd,5693,5,11,6,11,37,40,-3,39
Brisbane,5693,6,10,5,13,33,42,-9,35
Western Sydn,5693,7,8,9,10,38,47,-9,33
Perth Glory,5693,8,10,2,15,37,50,-13,32
Wellington P,5693,9,5,6,16,31,55,-24,21
CC Mariners,5693,10,4,8,15,28,49,-21,20
Sydney FC,5694,1,21,4,3,66,23,43,67
N'castle Jet,5694,2,15,5,8,57,40,17,50
Melbourne C,5694,3,15,4,10,46,33,13,49
Melbourne V,5694,4,13,5,11,46,40,6,44
Adelaide Utd,5694,5,11,6,11,37,40,-3,39
Brisbane,5694,6,10,5,13,33,42,-9,35
Western Sydn,5694,7,8,9,10,38,47,-9,33
Perth Glory,5694,8,10,2,15,37,50,-13,32
Wellington P,5694,9,5,6,16,31,55,-24,21
CC Mariners,5694,10,4,8,15,28,49,-21,20
Sydney FC,5695,1,21,4,3,67,22,45,67
N'castle Jet,5695,2,16,5,7,59,37,22,53
Melbourne C,5695,3,14,4,11,43,35,8,46
Melbourne V,5695,4,13,5,11,45,41,4,44
Adelaide Utd,5695,5,11,6,11,37,40,-3,39
Brisbane,5695,6,10,5,13,33,42,-9,35
Western Sydn,5695,7,8,9,10,38,47,-9,33
Perth Glory,5695,8,10,2,15,37,50,-13,32
Wellington P,5695,9,5,6,16,31,55,-24,21
CC Mariners,5695,10,4,8,15,28,49,-21,20
Sydney FC,5696,1,20,5,3,66,24,42,65
N'castle Jet,5696,2,16,5,7,59,37,22,53
Melbourne C,5696,3,14,4,11,43,35,8,46
Melbourne V,5696,4,13,6,10,47,40,7,45
Adelaide Utd,5696,5,11,6,11,37,40,-3,39
Brisbane,5696,6,10,5,13,33,42,-9,35
Western Sydn,5696,7,8,9,10,38,47,-9,33
Perth Glory,5696,8,10,2,15,37,50,-13,32
Wellington P,5696,9,5,6,16,31,55,-24,21
CC Mariners,5696,10,4,8,15,28,49,-21,20
Sydney FC,5697,1,20,5,3,66,24,42,65
N'castle Jet,5697,2,16,5,7,59,37,22,53
Melbourne C,5697,3,14,4,11,43,35,8,46
Melbourne V,5697,4,13,6,10,47,40,7,45
Adelaide Utd,5697,5,11,6,11,37,40,-3,39
Brisbane,5697,6,10,5,13,33,42,-9,35
Western Sydn,5697,7,8,9,10,38,47,-9,33
Perth Glory,5697,8,10,2,15,37,50,-13,32
Wellington P,5697,9,5,6,16,31,55,-24,21
CC Mariners,5697,10,4,8,15,28,49,-21,20
Sydney FC,5698,1,21,4,3,67,22,45,67
N'castle Jet,5698,2,16,5,7,59,37,22,53
Melbourne C,5698,3,14,4,11,43,35,8,46
Melbourne V,5698,4,13,5,11,45,41,4,44
Adelaide Utd,5698,5,11,6,11,37,40,-3,39
Brisbane,5698,6,10,5,13,33,42,-9,35
Western Sydn,5698,7,8,9,10,38,47,-9,33
Perth Glory,5698,8,10,2,15,37,50,-13,32
Wellington P,5698,9,5,6,16,31,55,-24,21
CC Mariners,5698,10,4,8,15,28,49,-21,20
Sydney FC,5699,1,20,4,4,64,24,40,64
N'castle Jet,5699,2,16,5,7,60,38,22,53
Melbourne V,5699,3,14,5,10,47,38,9,47
Melbourne C,5699,4,14,4,11,44,36,8,46
Adelaide Utd,5699,5,11,6,11,37,40,-3,39
Brisbane,5699,6,10,5,13,33,42,-9,35
Western Sydn,5699,7,8,9,10,38,47,-9,33
Perth Glory,5699,8,10,2,15,37,50,-13,32
Wellington P,5699,9,5,6,16,31,55,-24,21
CC Mariners,5699,10,4,8,15,28,49,-21,20
Sydney FC,5700,1,20,4,4,64,24,40,64
N'castle Jet,5700,2,15,6,7,59,39,20,51
Melbourne C,5700,3,14,5,10,45,35,10,47
Melbourne V,5700,4,14,5,10,47,38,9,47
Adelaide Utd,5700,5,11,6,11,37,40,-3,39
Brisbane,5700,6,10,5,13,33,42,-9,35
Western Sydn,5700,7,8,9,10,38,47,-9,33
Perth Glory,5700,8,10,2,15,37,50,-13,32
Wellington P,5700,9,5,6,16,31,55,-24,21
CC Mariners,5700,10,4,8,15,28,49,-21,20
Sydney FC,5701,1,20,5,3,66,24,42,65
N'castle Jet,5701,2,15,6,7,59,39,20,51
Melbourne C,5701,3,14,5,10,45,35,10,47
Melbourne V,5701,4,13,6,10,47,40,7,45
Adelaide Utd,5701,5,11,6,11,37,40,-3,39
Brisbane,5701,6,10,5,13,33,42,-9,35
Western Sydn,5701,7,8,9,10,38,47,-9,33
Perth Glory,5701,8,10,2,15,37,50,-13,32
Wellington P,5701,9,5,6,16,31,55,-24,21
CC Mariners,5701,10,4,8,15,28,49,-21,20
Sydney FC,5702,1,21,4,3,68,22,46,67
N'castle Jet,5702,2,16,5,7,58,37,21,53
Melbourne C,5702,3,14,4,11,43,34,9,46
Melbourne V,5702,4,13,5,11,45,42,3,44
Adelaide Utd,5702,5,11,6,11,37,40,-3,39
Brisbane,5702,6,10,5,13,33,42,-9,35
Western Sydn,5702,7,8,9,10,38,47,-9,33
Perth Glory,5702,8,10,2,15,37,50,-13,32
Wellington P,5702,9,5,6,16,31,55,-24,21
CC Mariners,5702,10,4,8,15,28,49,-21,20
Sydney FC,5703,1,21,4,3,66,23,43,67
N'castle Jet,5703,2,15,5,8,57,38,19,50
Melbourne C,5703,3,15,4,10,44,33,11,49
Melbourne V,5703,4,13,5,11,46,40,6,44
Adelaide Utd,5703,5,11,6,11,37,40,-3,39
Brisbane,5703,6,10,5,13,33,42,-9,35
Western Sydn,5703,7,8,9,10,38,47,-9,33
Perth Glory,5703,8,10,2,15,37,50,-13,32
Wellington P,5703,9,5,6,16,31,55,-24,21
CC Mariners,5703,10,4,8,15,28,49,-21,20
Sydney FC,5704,1,21,4,3,68,23,45,67
N'castle Jet,5704,2,16,5,7,59,38,21,53
Melbourne C,5704,3,14,4,11,44,35,9,46
Melbourne V,5704,4,13,5,11,46,42,4,44
Adelaide Utd,5704,5,11,6,11,37,40,-3,39
Brisbane,5704,6,10,5,13,33,42,-9,35
Western Sydn,5704,7,8,9,10,38,47,-9,33
Perth Glory,5704,8,10,2,15,37,50,-13,32
Wellington P,5704,9,5,6,16,31,55,-24,21
CC Mariners,5704,10,4,8,15,28,49,-21,20
Sydney FC,5705,1,21,4,3,68,22,46,67
N'castle Jet,5705,2,16,5,7,59,37,22,53
Melbourne C,5705,3,14,4,11,43,35,8,46
Melbourne V,5705,4,13,5,11,45,42,3,44
Adelaide Utd,5705,5,11,6,11,37,40,-3,39
Brisbane,5705,6,10,5,13,33,42,-9,35
Western Sydn,5705,7,8,9,10,38,47,-9,33
Perth Glory,5705,8,10,2,15,37,50,-13,32
Wellington P,5705,9,5,6,16,31,55,-24,21
CC Mariners,5705,10,4,8,15,28,49,-21,20
Sydney FC,5706,1,20,5,3,65,23,42,65
N'castle Jet,5706,2,16,5,7,62,38,24,53
Melbourne C,5706,3,14,4,11,44,38,6,46
Melbourne V,5706,4,13,6,10,46,39,7,45
Adelaide Utd,5706,5,11,6,11,37,40,-3,39
Brisbane,5706,6,10,5,13,33,42,-9,35
Western Sydn,5706,7,8,9,10,38,47,-9,33
Perth Glory,5706,8,10,2,15,37,50,-13,32
Wellington P,5706,9,5,6,16,31,55,-24,21
CC Mariners,5706,10,4,8,15,28,49,-21,20
Sydney FC,5707,1,21,4,3,67,23,44,67
N'castle Jet,5707,2,15,6,7,59,39,20,51
Melbourne C,5707,3,14,5,10,45,35,10,47
Melbourne V,5707,4,13,5,11,46,41,5,44
Adelaide Utd,5707,5,11,6,11,37,40,-3,39
Brisbane,5707,6,10,5,13,33,42,-9,35
Western Sydn,5707,7,8,9,10,38,47,-9,33
Perth Glory,5707,8,10,2,15,37,50,-13,32
Wellington P,5707,9,5,6,16,31,55,-24,21
CC Mariners,5707,10,4,8,15,28,49,-21,20
Sydney FC,5708,1,21,4,3,65,22,43,67
N'castle Jet,5708,2,16,5,7,59,38,21,53
Melbourne C,5708,3,14,4,11,44,35,9,46
Melbourne V,5708,4,13,5,11,45,39,6,44
Adelaide Utd,5708,5,11,6,11,37,40,-3,39
Brisbane,5708,6,10,5,13,33,42,-9,35
Western Sydn,5708,7,8,9,10,38,47,-9,33
Perth Glory,5708,8,10,2,15,37,50,-13,32
Wellington P,5708,9,5,6,16,31,55,-24,21
CC Mariners,5708,10,4,8,15,28,49,-21,20
Sydney FC,5709,1,21,4,3,66,22,44,67
N'castle Jet,5709,2,16,5,7,58,37,21,53
Melbourne C,5709,3,14,4,11,43,34,9,46
Melbourne V,5709,4,13,5,11,45,40,5,44
Adelaide Utd,5709,5,11,6,11,37,40,-3,39
Brisbane,5709,6,10,5,13,33,42,-9,35
Western Sydn,5709,7,8,9,10,38,47,-9,33
Perth Glory,5709,8,10,2,15,37,50,-13,32
Wellington P,5709,9,5,6,16,31,55,-24,21
CC Mariners,5709,10,4,8,15,28,49,-21,20
Sydney FC,5710,1,21,4,3,68,22,46,67
N'castle Jet,5710,2,15,6,7,59,39,20,51
Melbourne C,5710,3,14,5,10,45,35,10,47
Melbourne V,5710,4,13,5,11,45,42,3,44
Adelaide Utd,5710,5,11,6,11,37,40,-3,39
Brisbane,5710,6,10,5,13,33,42,-9,35
Western Sydn,5710,7,8,9,10,38,47,-9,33
Perth Glory,5710,8,10,2,15,37,50,-13,32
Wellington P,5710,9,5,6,16,31,55,-24,21
CC Mariners,5710,10,4,8,15,28,49,-21,20
Sydney FC,5711,1,21,4,3,67,22,45,67
N'castle Jet,5711,2,16,5,7,60,38,22,53
Melbourne C,5711,3,14,4,11,44,36,8,46
Melbourne V,5711,4,13,5,11,45,41,4,44
Adelaide Utd,5711,5,11,6,11,37,40,-3,39
Brisbane,5711,6,10,5,13,33,42,-9,35
Western Sydn,5711,7,8,9,10,38,47,-9,33
Perth Glory,5711,8,10,2,15,37,50,-13,32
Wellington P,5711,9,5,6,16,31,55,-24,21
CC Mariners,5711,10,4,8,15,28,49,-21,20
Sydney FC,5712,1,20,5,3,65,23,42,65
N'castle Jet,5712,2,15,5,8,57,42,15,50
Melbourne C,5712,3,15,4,10,48,33,15,49
Melbourne V,5712,4,13,6,10,46,39,7,45
Adelaide Utd,5712,5,11,6,11,37,40,-3,39
Brisbane,5712,6,10,5,13,33,42,-9,35
Western Sydn,5712,7,8,9,10,38,47,-9,33
Perth Glory,5712,8,10,2,15,37,50,-13,32
Wellington P,5712,9,5,6,16,31,55,-24,21
CC Mariners,5712,10,4,8,15,28,49,-21,20
Sydney FC,5713,1,21,4,3,68,23,45,67
N'castle Jet,5713,2,15,6,7,57,37,20,51
Melbourne C,5713,3,14,5,10,43,33,10,47
Melbourne V,5713,4,13,5,11,46,42,4,44
Adelaide Utd,5713,5,11,6,11,37,40,-3,39
Brisbane,5713,6,10,5,13,33,42,-9,35
Western Sydn,5713,7,8,9,10,38,47,-9,33
Perth Glory,5713,8,10,2,15,37,50,-13,32
Wellington P,5713,9,5,6,16,31,55,-24,21
CC Mariners,5713,10,4,8,15,28,49,-21,20
Sydney FC,5714,1,21,4,3,66,23,43,67
N'castle Jet,5714,2,16,5,7,60,37,23,53
Melbourne C,5714,3,14,4,11,43,36,7,46
Melbourne V,5714,4,13,5,11,46,40,6,44
Adelaide Utd,5714,5,11,6,11,37,40,-3,39
Brisbane,5714,6,10,5,13,33,42,-9,35
Western Sydn,5714,7,8,9,10,38,47,-9,33
Perth Glory,5714,8,10,2,15,37,50,-13,32
Wellington P,5714,9,5,6,16,31,55,-24,21
CC Mariners,5714,10,4,8,15,28,49,-21,20
Sydney FC,5715,1,20,4,4,64,24,40,64
N'castle Jet,5715,2,15,6,7,57,37,20,51
Melbourne C,5715,3,14,5,10,43,33,10,47
Melbourne V,5715,4,14,5,10,47,38,9,47
Adelaide Utd,5715,5,11,6,11,37,40,-3,39
Brisbane,5715,6,10,5,13,33,42,-9,35
Western Sydn,5715,7,8,9,10,38,47,-9,33
Perth Glory,5715,8,10,2,15,37,50,-13,32
Wellington P,5715,9,5,6,16,31,55,-24,21
CC Mariners,5715,10,4,8,15,28,49,-21,20
Sydney FC,5716,1,21,4,3,66,22,44,67
N'castle Jet,5716,2,16,5,7,58,37,21,53
Melbourne C,5716,3,14,4,11,43,34,9,46
Melbourne V,5716,4,13,5,11,45,40,5,44
Adelaide Utd,5716,5,11,6,11,37,40,-3,39
Brisbane,5716,6,10,5,13,33,42,-9,35
Western Sydn,5716,7,8,9,10,38,47,-9,33
Perth Glory,5716,8,10,2,15,37,50,-13,32
Wellington P,5716,9,5,6,16,31,55,-24,21
CC Mariners,5716,10,4,8,15,28,49,-21,20
Sydney FC,5717,1,21,4,3,65,22,43,67
N'castle Jet,5717,2,16,5,7,60,37,23,53
Melbourne C,5717,3,14,4,11,43,36,7,46
Melbourne V,5717,4,13,5,11,45,39,6,44
Adelaide Utd,5717,5,11,6,11,37,40,-3,39
Brisbane,5717,6,10,5,13,33,42,-9,35
Western Sydn,5717,7,8,9,10,38,47,-9,33
Perth Glory,5717,8,10,2,15,37,50,-13,32
Wellington P,5717,9,5,6,16,31,55,-24,21
CC Mariners,5717,10,4,8,15,28,49,-21,20
Sydney FC,5718,1,21,4,3,65,22,43,67
N'castle Jet,5718,2,15,6,7,58,38,20,51
Melbourne C,5718,3,14,5,10,44,34,10,47
Melbourne V,5718,4,13,5,11,45,39,6,44
Adelaide Utd,5718,5,11,6,11,37,40,-3,39
Brisbane,5718,6,10,5,13,33,42,-9,35
Western Sydn,5718,7,8,9,10,38,47,-9,33
Perth Glory,5718,8,10,2,15,37,50,-13,32
Wellington P,5718,9,5,6,16,31,55,-24,21
CC Mariners,5718,10,4,8,15,28,49,-21,20
Sydney FC,5719,1,21,4,3,67,22,45,67
N'castle Jet,5719,2,16,5,7,58,37,21,53
Melbourne C,5719,3,14,4,11,43,34,9,46
Melbourne V,5719,4,13,5,11,45,41,4,44
Adelaide Utd,5719,5,11,6,11,37,40,-3,39
Brisbane,5719,6,10,5,13,33,42,-9,35
Western Sydn,5719,7,8,9,10,38,47,-9,33
Perth Glory,5719,8,10,2,15,37,50,-13,32
Wellington P,5719,9,5,6,16,31,55,-24,21
CC Mariners,5719,10,4,8,15,28,49,-21,20
Sydney FC,5720,1,21,4,3,65,22,43,67
N'castle Jet,5720,2,15,5,8,58,39,19,50
Melbourne C,5720,3,15,4,10,45,34,11,49
Melbourne V,5720,4,13,5,11,45,39,6,44
Adelaide Utd,5720,5,11,6,11,37,40,-3,39
Brisbane,5720,6,10,5,13,33,42,-9,35
Western Sydn,5720,7,8,9,10,38,47,-9,33
Perth Glory,5720,8,10,2,15,37,50,-13,32
Wellington P,5720,9,5,6,16,31,55,-24,21
CC Mariners,5720,10,4,8,15,28,49,-21,20
Sydney FC,5721,1,21,4,3,67,22,45,67
N'castle Jet,5721,2,15,5,8,58,40,18,50
Melbourne C,5721,3,15,4,10,46,34,12,49
Melbourne V,5721,4,13,5,11,45,41,4,44
Adelaide Utd,5721,5,11,6,11,37,40,-3,39
Brisbane,5721,6,10,5,13,33,42,-9,35
Western Sydn,5721,7,8,9,10,38,47,-9,33
Perth Glory,5721,8,10,2,15,37,50,-13,32
Wellington P,5721,9,5,6,16,31,55,-24,21
CC Mariners,5721,10,4,8,15,28,49,-21,20
Sydney FC,5722,1,20,5,3,66,24,42,65
N'castle Jet,5722,2,16,5,7,62,37,25,53
Melbourne C,5722,3,14,4,11,43,38,5,46
Melbourne V,5722,4,13,6,10,47,40,7,45
Adelaide Utd,5722,5,11,6,11,37,40,-3,39
Brisbane,5722,6,10,5,13,33,42,-9,35
Western Sydn,5722,7,8,9,10,38,47,-9,33
Perth Glory,5722,8,10,2,15,37,50,-13,32
Wellington P,5722,9,5,6,16,31,55,-24,21
CC Mariners,5722,10,4,8,15,28,49,-21,20
Sydney FC,5723,1,21,4,3,65,22,43,67
N'castle Jet,5723,2,15,6,7,57,37,20,51
Melbourne C,5723,3,14,5,10,43,33,10,47
Melbourne V,5723,4,13,5,11,45,39,6,44
Adelaide Utd,5723,5,11,6,11,37,40,-3,39
Brisbane,5723,6,10,5,13,33,42,-9,35
Western Sydn,5723,7,8,9,10,38,47,-9,33
Perth Glory,5723,8,10,2,15,37,50,-13,32
Wellington P,5723,9,5,6,16,31,55,-24,21
CC Mariners,5723,10,4,8,15,28,49,-21,20
Sydney FC,5724,1,21,4,3,69,23,46,67
N'castle Jet,5724,2,16,5,7,59,38,21,53
Melbourne C,5724,3,14,4,11,44,35,9,46
Melbourne V,5724,4,13,5,11,46,43,3,44
Adelaide Utd,5724,5,11,6,11,37,40,-3,39
Brisbane,5724,6,10,5,13,33,42,-9,35
Western Sydn,5724,7,8,9,10,38,47,-9,33
Perth Glory,5724,8,10,2,15,37,50,-13,32
Wellington P,5724,9,5,6,16,31,55,-24,21
CC Mariners,5724,10,4,8,15,28,49,-21,20
Sydney FC,5725,1,20,5,3,65,23,42,65
N'castle Jet,5725,2,16,5,7,61,37,24,53
Melbourne C,5725,3,14,4,11,43,37,6,46
Melbourne V,5725,4,13,6,10,46,39,7,45
Adelaide Utd,5725,5,11,6,11,37,40,-3,39
Brisbane,5725,6,10,5,13,33,42,-9,35
Western Sydn,5725,7,8,9,10,38,47,-9,33
Perth Glory,5725,8,10,2,15,37,50,-13,32
Wellington P,5725,9,5,6,16,31,55,-24,21
CC Mariners,5725,10,4,8,15,28,49,-21,20
Sydney FC,5726,1,20,4,4,64,23,41,64
N'castle Jet,5726,2,15,6,7,58,38,20,51
Melbourne C,5726,3,14,5,10,44,34,10,47
Melbourne V,5726,4,14,5,10,46,38,8,47
Adelaide Utd,5726,5,11,6,11,37,40,-3,39
Brisbane,5726,6,10,5,13,33,42,-9,35
Western Sydn,5726,7,8,9,10,38,47,-9,33
Perth Glory,5726,8,10,2,15,37,50,-13,32
Wellington P,5726,9,5,6,16,31,55,-24,21
CC Mariners,5726,10,4,8,15,28,49,-21,20
Sydney FC,5727,1,21,4,3,66,23,43,67
N'castle Jet,5727,2,16,5,7,59,37,22,53
Melbourne C,5727,3,14,4,11,43,35,8,46
Melbourne V,5727,4,13,5,11,46,40,6,44
Adelaide Utd,5727,5,11,6,11,37,40,-3,39
Brisbane,5727,6,10,5,13,33,42,-9,35
Western Sydn,5727,7,8,9,10,38,47,-9,33
Perth Glory,5727,8,10,2,15,37,50,-13,32
Wellington P,5727,9,5,6,16,31,55,-24,21
CC Mariners,5727,10,4,8,15,28,49,-21,20
Sydney FC,5728,1,21,4,3,66,22,44,67
N'castle Jet,5728,2,15,6,7,58,38,20,51
Melbourne C,5728,3,14,5,10,44,34,10,47
Melbourne V,5728,4,13,5,11,45,40,5,44
Adelaide Utd,5728,5,11,6,11,37,40,-3,39
Brisbane,5728,6,10,5,13,33,42,-9,35
Western Sydn,5728,7,8,9,10,38,47,-9,33
Perth Glory,5728,8,10,2,15,37,50,-13,32
Wellington P,5728,9,5,6,16,31,55,-24,21
CC Mariners,5728,10,4,8,15,28,49,-21,20
Sydney FC,5729,1,20,5,3,64,22,42,65
N'castle Jet,5729,2,15,5,8,57,39,18,50
Melbourne C,5729,3,15,4,10,45,33,12,49
Melbourne V,5729,4,13,6,10,45,38,7,45
Adelaide Utd,5729,5,11,6,11,37,40,-3,39
Brisbane,5729,6,10,5,13,33,42,-9,35
Western Sydn,5729,7,8,9,10,38,47,-9,33
Perth Glory,5729,8,10,2,15,37,50,-13,32
Wellington P,5729,9,5,6,16,31,55,-24,21
CC Mariners,5729,10,4,8,15,28,49,-21,20
Sydney FC,5730,1,21,4,3,65,22,43,67
N'castle Jet,5730,2,15,6,7,58,38,20,51
Melbourne C,5730,3,14,5,10,44,34,10,47
Melbourne V,5730,4,13,5,11,45,39,6,44
Adelaide Utd,5730,5,11,6,11,37,40,-3,39
Brisbane,5730,6,10,5,13,33,42,-9,35
Western Sydn,5730,7,8,9,10,38,47,-9,33
Perth Glory,5730,8,10,2,15,37,50,-13,32
Wellington P,5730,9,5,6,16,31,55,-24,21
CC Mariners,5730,10,4,8,15,28,49,-21,20
Sydney FC,5731,1,20,4,4,66,25,41,64
N'castle Jet,5731,2,16,5,7,59,38,21,53
Melbourne V,5731,3,14,5,10,48,40,8,47
Melbourne C,5731,4,14,4,11,44,35,9,46
Adelaide Utd,5731,5,11,6,11,37,40,-3,39
Brisbane,5731,6,10,5,13,33,42,-9,35
Western Sydn,5731,7,8,9,10,38,47,-9,33
Perth Glory,5731,8,10,2,15,37,50,-13,32
Wellington P,5731,9,5,6,16,31,55,-24,21
CC Mariners,5731,10,4,8,15,28,49,-21,20
Sydney FC,5732,1,20,5,3,64,22,42,65
N'castle Jet,5732,2,15,5,8,57,38,19,50
Melbourne C,5732,3,15,4,10,44,33,11,49
Melbourne V,5732,4,13,6,10,45,38,7,45
Adelaide Utd,5732,5,11,6,11,37,40,-3,39
Brisbane,5732,6,10,5,13,33,42,-9,35
Western Sydn,5732,7,8,9,10,38,47,-9,33
Perth Glory,5732,8,10,2,15,37,50,-13,32
Wellington P,5732,9,5,6,16,31,55,-24,21
CC Mariners,5732,10,4,8,15,28,49,-21,20
Sydney FC,5733,1,21,4,3,68,22,46,67
N'castle Jet,5733,2,16,5,7,60,37,23,53
Melbourne C,5733,3,14,4,11,43,36,7,46
Melbourne V,5733,4,13,5,11,45,42,3,44
Adelaide Utd,5733,5,11,6,11,37,40,-3,39
Brisbane,5733,6,10,5,13,33,42,-9,35
Western Sydn,5733,7,8,9,10,38,47,-9,33
Perth Glory,5733,8,10,2,15,37,50,-13,32
Wellington P,5733,9,5,6,16,31,55,-24,21
CC Mariners,5733,10,4,8,15,28,49,-21,20
Sydney FC,5734,1,21,4,3,67,23,44,67
N'castle Jet,5734,2,15,5,8,57,39,18,50
Melbourne C,5734,3,15,4,10,45,33,12,49
Melbourne V,5734,4,13,5,11,46,41,5,44
Adelaide Utd,5734,5,11,6,11,37,40,-3,39
Brisbane,5734,6,10,5,13,33,42,-9,35
Western Sydn,5734,7,8,9,10,38,47,-9,33
Perth Glory,5734,8,10,2,15,37,50,-13,32
Wellington P,5734,9,5,6,16,31,55,-24,21
CC Mariners,5734,10,4,8,15,28,49,-21,20
Sydney FC,5735,1,21,4,3,68,23,45,67
N'castle Jet,5735,2,15,5,8,58,39,19,50
Melbourne C,5735,3,15,4,10,45,34,11,49
Melbourne V,5735,4,13,5,11,46,42,4,44
Adelaide Utd,5735,5,11,6,11,37,40,-3,39
Brisbane,5735,6,10,5,13,33,42,-9,35
Western Sydn,5735,7,8,9,10,38,47,-9,33
Perth Glory,5735,8,10,2,15,37,50,-13,32
Wellington P,5735,9,5,6,16,31,55,-24,21
CC Mariners,5735,10,4,8,15,28,49,-21,20
Sydney FC,5736,1,20,4,4,64,24,40,64
N'castle Jet,5736,2,16,5,7,61,38,23,53
Melbourne V,5736,3,14,5,10,47,38,9,47
Melbourne C,5736,4,14,4,11,44,37,7,46
Adelaide Utd,5736,5,11,6,11,37,40,-3,39
Brisbane,5736,6,10,5,13,33,42,-9,35
Western Sydn,5736,7,8,9,10,38,47,-9,33
Perth Glory,5736,8,10,2,15,37,50,-13,32
Wellington P,5736,9,5,6,16,31,55,-24,21
CC Mariners,5736,10,4,8,15,28,49,-21,20
Sydney FC,5737,1,21,4,3,65,22,43,67
N'castle Jet,5737,2,16,5,7,59,38,21,53
Melbourne C,5737,3,14,4,11,44,35,9,46
Melbourne V,5737,4,13,5,11,45,39,6,44
Adelaide Utd,5737,5,11,6,11,37,40,-3,39
Brisbane,5737,6,10,5,13,33,42,-9,35
Western Sydn,5737,7,8,9,10,38,47,-9,33
Perth Glory,5737,8,10,2,15,37,50,-13,32
Wellington P,5737,9,5,6,16,31,55,-24,21
CC Mariners,5737,10,4,8,15,28,49,-21,20
Sydney FC,5738,1,21,4,3,67,24,43,67
N'castle Jet,5738,2,15,5,8,59,40,19,50
Melbourne C,5738,3,15,4,10,46,35,11,49
Melbourne V,5738,4,13,5,11,47,41,6,44
Adelaide Utd,5738,5,11,6,11,37,40,-3,39
Brisbane,5738,6,10,5,13,33,42,-9,35
Western Sydn,5738,7,8,9,10,38,47,-9,33
Perth Glory,5738,8,10,2,15,37,50,-13,32
Wellington P,5738,9,5,6,16,31,55,-24,21
CC Mariners,5738,10,4,8,15,28,49,-21,20
Sydney FC,5739,1,21,4,3,67,22,45,67
N'castle Jet,5739,2,16,5,7,60,39,21,53
Melbourne C,5739,3,14,4,11,45,36,9,46
Melbourne V,5739,4,13,5,11,45,41,4,44
Adelaide Utd,5739,5,11,6,11,37,40,-3,39
Brisbane,5739,6,10,5,13,33,42,-9,35
Western Sydn,5739,7,8,9,10,38,47,-9,33
Perth Glory,5739,8,10,2,15,37,50,-13,32
Wellington P,5739,9,5,6,16,31,55,-24,21
CC Mariners,5739,10,4,8,15,28,49,-21,20
Sydney FC,5740,1,21,4,3,66,23,43,67
N'castle Jet,5740,2,15,5,8,57,39,18,50
Melbourne C,5740,3,15,4,10,45,33,12,49
Melbourne V,5740,4,13,5,11,46,40,6,44
Adelaide Utd,5740,5,11,6,11,37,40,-3,39
Brisbane,5740,6,10,5,13,33,42,-9,35
Western Sydn,5740,7,8,9,10,38,47,-9,33
Perth Glory,5740,8,10,2,15,37,50,-13,32
Wellington P,5740,9,5,6,16,31,55,-24,21
CC Mariners,5740,10,4,8,15,28,49,-21,20
Sydney FC,5741,1,20,4,4,65,24,41,64
N'castle Jet,5741,2,16,5,7,58,37,21,53
Melbourne V,5741,3,14,5,10,47,39,8,47
Melbourne C,5741,4,14,4,11,43,34,9,46
Adelaide Utd,5741,5,11,6,11,37,40,-3,39
Brisbane,5741,6,10,5,13,33,42,-9,35
Western Sydn,5741,7,8,9,10,38,47,-9,33
Perth Glory,5741,8,10,2,15,37,50,-13,32
Wellington P,5741,9,5,6,16,31,55,-24,21
CC Mariners,5741,10,4,8,15,28,49,-21,20
Sydney FC,5742,1,21,4,3,67,23,44,67
N'castle Jet,5742,2,16,5,7,60,38,22,53
Melbourne C,5742,3,14,4,11,44,36,8,46
Melbourne V,5742,4,13,5,11,46,41,5,44
Adelaide Utd,5742,5,11,6,11,37,40,-3,39
Brisbane,5742,6,10,5,13,33,42,-9,35
Western Sydn,5742,7,8,9,10,38,47,-9,33
Perth Glory,5742,8,10,2,15,37,50,-13,32
Wellington P,5742,9,5,6,16,31,55,-24,21
CC Mariners,5742,10,4,8,15,28,49,-21,20
Sydney FC,5743,1,21,4,3,66,22,44,67
N'castle Jet,5743,2,15,6,7,58,38,20,51
Melbourne C,5743,3,14,5,10,44,34,10,47
Melbourne V,5743,4,13,5,11,45,40,5,44
Adelaide Utd,5743,5,11,6,11,37,40,-3,39
Brisbane,5743,6,10,5,13,33,42,-9,35
Western Sydn,5743,7,8,9,10,38,47,-9,33
Perth Glory,5743,8,10,2,15,37,50,-13,32
Wellington P,5743,9,5,6,16,31,55,-24,21
CC Mariners,5743,10,4,8,15,28,49,-21,20
Sydney FC,5744,1,21,4,3,65,22,43,67
N'castle Jet,5744,2,16,5,7,62,38,24,53
Melbourne C,5744,3,14,4,11,44,38,6,46
Melbourne V,5744,4,13,5,11,45,39,6,44
Adelaide Utd,5744,5,11,6,11,37,40,-3,39
Brisbane,5744,6,10,5,13,33,42,-9,35
Western Sydn,5744,7,8,9,10,38,47,-9,33
Perth Glory,5744,8,10,2,15,37,50,-13,32
Wellington P,5744,9,5,6,16,31,55,-24,21
CC Mariners,5744,10,4,8,15,28,49,-21,20
Sydney FC,5745,1,20,4,4,64,23,41,64
N'castle Jet,5745,2,16,5,7,58,37,21,53
Melbourne V,5745,3,14,5,10,46,38,8,47
Melbourne C,5745,4,14,4,11,43,34,9,46
Adelaide Utd,5745,5,11,6,11,37,40,-3,39
Brisbane,5745,6,10,5,13,33,42,-9,35
Western Sydn,5745,7,8,9,10,38,47,-9,33
Perth Glory,5745,8,10,2,15,37,50,-13,32
Wellington P,5745,9,5,6,16,31,55,-24,21
CC Mariners,5745,10,4,8,15,28,49,-21,20
Sydney FC,5746,1,21,4,3,68,23,45,67
N'castle Jet,5746,2,16,5,7,59,37,22,53
Melbourne C,5746,3,14,4,11,43,35,8,46
Melbourne V,5746,4,13,5,11,46,42,4,44
Adelaide Utd,5746,5,11,6,11,37,40,-3,39
Brisbane,5746,6,10,5,13,33,42,-9,35
Western Sydn,5746,7,8,9,10,38,47,-9,33
Perth Glory,5746,8,10,2,15,37,50,-13,32
Wellington P,5746,9,5,6,16,31,55,-24,21
CC Mariners,5746,10,4,8,15,28,49,-21,20
Sydney FC,5747,1,20,4,4,65,24,41,64
N'castle Jet,5747,2,16,5,7,59,37,22,53
Melbourne V,5747,3,14,5,10,47,39,8,47
Melbourne C,5747,4,14,4,11,43,35,8,46
Adelaide Utd,5747,5,11,6,11,37,40,-3,39
Brisbane,5747,6,10,5,13,33,42,-9,35
Western Sydn,5747,7,8,9,10,38,47,-9,33
Perth Glory,5747,8,10,2,15,37,50,-13,32
Wellington P,5747,9,5,6,16,31,55,-24,21
CC Mariners,5747,10,4,8,15,28,49,-21,20
Sydney FC,5748,1,20,4,4,64,24,40,64
N'castle Jet,5748,2,16,5,7,59,37,22,53
Melbourne V,5748,3,14,5,10,47,38,9,47
Melbourne C,5748,4,14,4,11,43,35,8,46
Adelaide Utd,5748,5,11,6,11,37,40,-3,39
Brisbane,5748,6,10,5,13,33,42,-9,35
Western Sydn,5748,7,8,9,10,38,47,-9,33
Perth Glory,5748,8,10,2,15,37,50,-13,32
Wellington P,5748,9,5,6,16,31,55,-24,21
CC Mariners,5748,10,4,8,15,28,49,-21,20
Sydney FC,5749,1,21,4,3,69,26,43,67
N'castle Jet,5749,2,15,6,7,57,37,20,51
Melbourne C,5749,3,14,5,10,43,33,10,47
Melbourne V,5749,4,13,5,11,49,43,6,44
Adelaide Utd,5749,5,11,6,11,37,40,-3,39
Brisbane,5749,6,10,5,13,33,42,-9,35
Western Sydn,5749,7,8,9,10,38,47,-9,33
Perth Glory,5749,8,10,2,15,37,50,-13,32
Wellington P,5749,9,5,6,16,31,55,-24,21
CC Mariners,5749,10,4,8,15,28,49,-21,20
Sydney FC,5750,1,21,4,3,66,23,43,67
N'castle Jet,5750,2,15,6,7,58,38,20,51
Melbourne C,5750,3,14,5,10,44,34,10,47
Melbourne V,5750,4,13,5,11,46,40,6,44
Adelaide Utd,5750,5,11,6,11,37,40,-3,39
Brisbane,5750,6,10,5,13,33,42,-9,35
Western Sydn,5750,7,8,9,10,38,47,-9,33
Perth Glory,5750,8,10,2,15,37,50,-13,32
Wellington P,5750,9,5,6,16,31,55,-24,21
CC Mariners,5750,10,4,8,15,28,49,-21,20
Sydney FC,5751,1,21,4,3,68,23,45,67
N'castle Jet,5751,2,15,5,8,58,39,19,50
Melbourne C,5751,3,15,4,10,45,34,11,49
Melbourne V,5751,4,13,5,11,46,42,4,44
Adelaide Utd,5751,5,11,6,11,37,40,-3,39
Brisbane,5751,6,10,5,13,33,42,-9,35
Western Sydn,5751,7,8,9,10,38,47,-9,33
Perth Glory,5751,8,10,2,15,37,50,-13,32
Wellington P,5751,9,5,6,16,31,55,-24,21
CC Mariners,5751,10,4,8,15,28,49,-21,20
Sydney FC,5752,1,21,4,3,66,23,43,67
N'castle Jet,5752,2,15,6,7,60,40,20,51
Melbourne C,5752,3,14,5,10,46,36,10,47
Melbourne V,5752,4,13,5,11,46,40,6,44
Adelaide Utd,5752,5,11,6,11,37,40,-3,39
Brisbane,5752,6,10,5,13,33,42,-9,35
Western Sydn,5752,7,8,9,10,38,47,-9,33
Perth Glory,5752,8,10,2,15,37,50,-13,32
Wellington P,5752,9,5,6,16,31,55,-24,21
CC Mariners,5752,10,4,8,15,28,49,-21,20
Sydney FC,5753,1,21,4,3,67,24,43,67
N'castle Jet,5753,2,15,5,8,57,41,16,50
Melbourne C,5753,3,15,4,10,47,33,14,49
Melbourne V,5753,4,13,5,11,47,41,6,44
Adelaide Utd,5753,5,11,6,11,37,40,-3,39
Brisbane,5753,6,10,5,13,33,42,-9,35
Western Sydn,5753,7,8,9,10,38,47,-9,33
Perth Glory,5753,8,10,2,15,37,50,-13,32
Wellington P,5753,9,5,6,16,31,55,-24,21
CC Mariners,5753,10,4,8,15,28,49,-21,20
Sydney FC,5754,1,20,5,3,65,23,42,65
N'castle Jet,5754,2,15,6,7,59,39,20,51
Melbourne C,5754,3,14,5,10,45,35,10,47
Melbourne V,5754,4,13,6,10,46,39,7,45
Adelaide Utd,5754,5,11,6,11,37,40,-3,39
Brisbane,5754,6,10,5,13,33,42,-9,35
Western Sydn,5754,7,8,9,10,38,47,-9,33
Perth Glory,5754,8,10,2,15,37,50,-13,32
Wellington P,5754,9,5,6,16,31,55,-24,21
CC Mariners,5754,10,4,8,15,28,49,-21,20
Sydney FC,5755,1,21,4,3,66,23,43,67
N'castle Jet,5755,2,15,6,7,58,38,20,51
Melbourne C,5755,3,14,5,10,44,34,10,47
Melbourne V,5755,4,13,5,11,46,40,6,44
Adelaide Utd,5755,5,11,6,11,37,40,-3,39
Brisbane,5755,6,10,5,13,33,42,-9,35
Western Sydn,5755,7,8,9,10,38,47,-9,33
Perth Glory,5755,8,10,2,15,37,50,-13,32
Wellington P,5755,9,5,6,16,31,55,-24,21
CC Mariners,5755,10,4,8,15,28,49,-21,20
Sydney FC,5756,1,21,4,3,68,23,45,67
N'castle Jet,5756,2,15,6,7,57,37,20,51
Melbourne C,5756,3,14,5,10,43,33,10,47
Melbourne V,5756,4,13,5,11,46,42,4,44
Adelaide Utd,5756,5,11,6,11,37,40,-3,39
Brisbane,5756,6,10,5,13,33,42,-9,35
Western Sydn,5756,7,8,9,10,38,47,-9,33
Perth Glory,5756,8,10,2,15,37,50,-13,32
Wellington P,5756,9,5,6,16,31,55,-24,21
CC Mariners,5756,10,4,8,15,28,49,-21,20
Sydney FC,5757,1,20,5,3,67,25,42,65
N'castle Jet,5757,2,16,5,7,58,37,21,53
Melbourne C,5757,3,14,4,11,43,34,9,46
Melbourne V,5757,4,13,6,10,48,41,7,45
Adelaide Utd,5757,5,11,6,11,37,40,-3,39
Brisbane,5757,6,10,5,13,33,42,-9,35
Western Sydn,5757,7,8,9,10,38,47,-9,33
Perth Glory,5757,8,10,2,15,37,50,-13,32
Wellington P,5757,9,5,6,16,31,55,-24,21
CC Mariners,5757,10,4,8,15,28,49,-21,20
Sydney FC,5758,1,21,4,3,65,22,43,67
N'castle Jet,5758,2,15,5,8,59,40,19,50
Melbourne C,5758,3,15,4,10,46,35,11,49
Melbourne V,5758,4,13,5,11,45,39,6,44
Adelaide Utd,5758,5,11,6,11,37,40,-3,39
Brisbane,5758,6,10,5,13,33,42,-9,35
Western Sydn,5758,7,8,9,10,38,47,-9,33
Perth Glory,5758,8,10,2,15,37,50,-13,32
Wellington P,5758,9,5,6,16,31,55,-24,21
CC Mariners,5758,10,4,8,15,28,49,-21,20
Sydney FC,5759,1,21,4,3,66,23,43,67
N'castle Jet,5759,2,16,5,7,60,37,23,53
Melbourne C,5759,3,14,4,11,43,36,7,46
Melbourne V,5759,4,13,5,11,46,40,6,44
Adelaide Utd,5759,5,11,6,11,37,40,-3,39
Brisbane,5759,6,10,5,13,33,42,-9,35
Western Sydn,5759,7,8,9,10,38,47,-9,33
Perth Glory,5759,8,10,2,15,37,50,-13,32
Wellington P,5759,9,5,6,16,31,55,-24,21
CC Mariners,5759,10,4,8,15,28,49,-21,20
Sydney FC,5760,1,20,5,3,65,23,42,65
N'castle Jet,5760,2,15,5,8,58,39,19,50
Melbourne C,5760,3,15,4,10,45,34,11,49
Melbourne V,5760,4,13,6,10,46,39,7,45
Adelaide Utd,5760,5,11,6,11,37,40,-3,39
Brisbane,5760,6,10,5,13,33,42,-9,35
Western Sydn,5760,7,8,9,10,38,47,-9,33
Perth Glory,5760,8,10,2,15,37,50,-13,32
Wellington P,5760,9,5,6,16,31,55,-24,21
CC Mariners,5760,10,4,8,15,28,49,-21,20
Sydney FC,5761,1,21,4,3,66,22,44,67
N'castle Jet,5761,2,16,5,7,60,38,22,53
Melbourne C,5761,3,14,4,11,44,36,8,46
Melbourne V,5761,4,13,5,11,45,40,5,44
Adelaide Utd,5761,5,11,6,11,37,40,-3,39
Brisbane,5761,6,10,5,13,33,42,-9,35
Western Sydn,5761,7,8,9,10,38,47,-9,33
Perth Glory,5761,8,10,2,15,37,50,-13,32
Wellington P,5761,9,5,6,16,31,55,-24,21
CC Mariners,5761,10,4,8,15,28,49,-21,20
Sydney FC,5762,1,21,4,3,68,24,44,67
N'castle Jet,5762,2,16,5,7,59,38,21,53
Melbourne C,5762,3,14,4,11,44,35,9,46
Melbourne V,5762,4,13,5,11,47,42,5,44
Adelaide Utd,5762,5,11,6,11,37,40,-3,39
Brisbane,5762,6,10,5,13,33,42,-9,35
Western Sydn,5762,7,8,9,10,38,47,-9,33
Perth Glory,5762,8,10,2,15,37,50,-13,32
Wellington P,5762,9,5,6,16,31,55,-24,21
CC Mariners,5762,10,4,8,15,28,49,-21,20
Sydney FC,5763,1,20,5,3,66,24,42,65
N'castle Jet,5763,2,16,5,7,61,38,23,53
Melbourne C,5763,3,14,4,11,44,37,7,46
Melbourne V,5763,4,13,6,10,47,40,7,45
Adelaide Utd,5763,5,11,6,11,37,40,-3,39
Brisbane,5763,6,10,5,13,33,42,-9,35
Western Sydn,5763,7,8,9,10,38,47,-9,33
Perth Glory,5763,8,10,2,15,37,50,-13,32
Wellington P,5763,9,5,6,16,31,55,-24,21
CC Mariners,5763,10,4,8,15,28,49,-21,20
Sydney FC,5764,1,21,4,3,66,23,43,67
N'castle Jet,5764,2,15,5,8,58,39,19,50
Melbourne C,5764,3,15,4,10,45,34,11,49
Melbourne V,5764,4,13,5,11,46,40,6,44
Adelaide Utd,5764,5,11,6,11,37,40,-3,39
Brisbane,5764,6,10,5,13,33,42,-9,35
Western Sydn,5764,7,8,9,10,38,47,-9,33
Perth Glory,5764,8,10,2,15,37,50,-13,32
Wellington P,5764,9,5,6,16,31,55,-24,21
CC Mariners,5764,10,4,8,15,28,49,-21,20
Sydney FC,5765,1,21,4,3,69,24,45,67
N'castle Jet,5765,2,15,6,7,57,37,20,51
Melbourne C,5765,3,14,5,10,43,33,10,47
Melbourne V,5765,4,13,5,11,47,43,4,44
Adelaide Utd,5765,5,11,6,11,37,40,-3,39
Brisbane,5765,6,10,5,13,33,42,-9,35
Western Sydn,5765,7,8,9,10,38,47,-9,33
Perth Glory,5765,8,10,2,15,37,50,-13,32
Wellington P,5765,9,5,6,16,31,55,-24,21
CC Mariners,5765,10,4,8,15,28,49,-21,20
Sydney FC,5766,1,20,4,4,66,25,41,64
N'castle Jet,5766,2,16,5,7,60,39,21,53
Melbourne V,5766,3,14,5,10,48,40,8,47
Melbourne C,5766,4,14,4,11,45,36,9,46
Adelaide Utd,5766,5,11,6,11,37,40,-3,39
Brisbane,5766,6,10,5,13,33,42,-9,35
Western Sydn,5766,7,8,9,10,38,47,-9,33
Perth Glory,5766,8,10,2,15,37,50,-13,32
Wellington P,5766,9,5,6,16,31,55,-24,21
CC Mariners,5766,10,4,8,15,28,49,-21,20
Sydney FC,5767,1,20,5,3,66,24,42,65
N'castle Jet,5767,2,16,5,7,58,37,21,53
Melbourne C,5767,3,14,4,11,43,34,9,46
Melbourne V,5767,4,13,6,10,47,40,7,45
Adelaide Utd,5767,5,11,6,11,37,40,-3,39
Brisbane,5767,6,10,5,13,33,42,-9,35
Western Sydn,5767,7,8,9,10,38,47,-9,33
Perth Glory,5767,8,10,2,15,37,50,-13,32
Wellington P,5767,9,5,6,16,31,55,-24,21
CC Mariners,5767,10,4,8,15,28,49,-21,20
Sydney FC,5768,1,21,4,3,68,22,46,67
N'castle Jet,5768,2,16,5,7,60,38,22,53
Melbourne C,5768,3,14,4,11,44,36,8,46
Melbourne V,5768,4,13,5,11,45,42,3,44
Adelaide Utd,5768,5,11,6,11,37,40,-3,39
Brisbane,5768,6,10,5,13,33,42,-9,35
Western Sydn,5768,7,8,9,10,38,47,-9,33
Perth Glory,5768,8,10,2,15,37,50,-13,32
Wellington P,5768,9,5,6,16,31,55,-24,21
CC Mariners,5768,10,4,8,15,28,49,-21,20
Sydney FC,5769,1,20,5,3,66,24,42,65
N'castle Jet,5769,2,16,5,7,60,37,23,53
Melbourne C,5769,3,14,4,11,43,36,7,46
Melbourne V,5769,4,13,6,10,47,40,7,45
Adelaide Utd,5769,5,11,6,11,37,40,-3,39
Brisbane,5769,6,10,5,13,33,42,-9,35
Western Sydn,5769,7,8,9,10,38,47,-9,33
Perth Glory,5769,8,10,2,15,37,50,-13,32
Wellington P,5769,9,5,6,16,31,55,-24,21
CC Mariners,5769,10,4,8,15,28,49,-21,20
Sydney FC,5770,1,21,4,3,68,23,45,67
N'castle Jet,5770,2,16,5,7,60,38,22,53
Melbourne C,5770,3,14,4,11,44,36,8,46
Melbourne V,5770,4,13,5,11,46,42,4,44
Adelaide Utd,5770,5,11,6,11,37,40,-3,39
Brisbane,5770,6,10,5,13,33,42,-9,35
Western Sydn,5770,7,8,9,10,38,47,-9,33
Perth Glory,5770,8,10,2,15,37,50,-13,32
Wellington P,5770,9,5,6,16,31,55,-24,21
CC Mariners,5770,10,4,8,15,28,49,-21,20
Sydney FC,5771,1,21,4,3,67,23,44,67
N'castle Jet,5771,2,16,5,7,60,37,23,53
Melbourne C,5771,3,14,4,11,43,36,7,46
Melbourne V,5771,4,13,5,11,46,41,5,44
Adelaide Utd,5771,5,11,6,11,37,40,-3,39
Brisbane,5771,6,10,5,13,33,42,-9,35
Western Sydn,5771,7,8,9,10,38,47,-9,33
Perth Glory,5771,8,10,2,15,37,50,-13,32
Wellington P,5771,9,5,6,16,31,55,-24,21
CC Mariners,5771,10,4,8,15,28,49,-21,20
Sydney FC,5772,1,20,4,4,66,28,38,64
N'castle Jet,5772,2,15,5,8,57,39,18,50
Melbourne C,5772,3,15,4,10,45,33,12,49
Melbourne V,5772,4,14,5,10,51,40,11,47
Adelaide Utd,5772,5,11,6,11,37,40,-3,39
Brisbane,5772,6,10,5,13,33,42,-9,35
Western Sydn,5772,7,8,9,10,38,47,-9,33
Perth Glory,5772,8,10,2,15,37,50,-13,32
Wellington P,5772,9,5,6,16,31,55,-24,21
CC Mariners,5772,10,4,8,15,28,49,-21,20
Sydney FC,5773,1,20,5,3,64,22,42,65
N'castle Jet,5773,2,15,5,8,58,39,19,50
Melbourne C,5773,3,15,4,10,45,34,11,49
Melbourne V,5773,4,13,6,10,45,38,7,45
Adelaide Utd,5773,5,11,6,11,37,40,-3,39
Brisbane,5773,6,10,5,13,33,42,-9,35
Western Sydn,5773,7,8,9,10,38,47,-9,33
Perth Glory,5773,8,10,2,15,37,50,-13,32
Wellington P,5773,9,5,6,16,31,55,-24,21
CC Mariners,5773,10,4,8,15,28,49,-21,20
Sydney FC,5774,1,21,4,3,67,24,43,67
N'castle Jet,5774,2,16,5,7,59,38,21,53
Melbourne C,5774,3,14,4,11,44,35,9,46
Melbourne V,5774,4,13,5,11,47,41,6,44
Adelaide Utd,5774,5,11,6,11,37,40,-3,39
Brisbane,5774,6,10,5,13,33,42,-9,35
Western Sydn,5774,7,8,9,10,38,47,-9,33
Perth Glory,5774,8,10,2,15,37,50,-13,32
Wellington P,5774,9,5,6,16,31,55,-24,21
CC Mariners,5774,10,4,8,15,28,49,-21,20
Sydney FC,5775,1,20,4,4,64,25,39,64
N'castle Jet,5775,2,16,5,7,60,38,22,53
Melbourne V,5775,3,14,5,10,48,38,10,47
Melbourne C,5775,4,14,4,11,44,36,8,46
Adelaide Utd,5775,5,11,6,11,37,40,-3,39
Brisbane,5775,6,10,5,13,33,42,-9,35
Western Sydn,5775,7,8,9,10,38,47,-9,33
Perth Glory,5775,8,10,2,15,37,50,-13,32
Wellington P,5775,9,5,6,16,31,55,-24,21
CC Mariners,5775,10,4,8,15,28,49,-21,20
Sydney FC,5776,1,21,4,3,67,23,44,67
N'castle Jet,5776,2,16,5,7,58,37,21,53
Melbourne C,5776,3,14,4,11,43,34,9,46
Melbourne V,5776,4,13,5,11,46,41,5,44
Adelaide Utd,5776,5,11,6,11,37,40,-3,39
Brisbane,5776,6,10,5,13,33,42,-9,35
Western Sydn,5776,7,8,9,10,38,47,-9,33
Perth Glory,5776,8,10,2,15,37,50,-13,32
Wellington P,5776,9,5,6,16,31,55,-24,21
CC Mariners,5776,10,4,8,15,28,49,-21,20
Sydney FC,5777,1,21,4,3,66,23,43,67
N'castle Jet,5777,2,16,5,7,62,37,25,53
Melbourne C,5777,3,14,4,11,43,38,5,46
Melbourne V,5777,4,13,5,11,46,40,6,44
Adelaide Utd,5777,5,11,6,11,37,40,-3,39
Brisbane,5777,6,10,5,13,33,42,-9,35
Western Sydn,5777,7,8,9,10,38,47,-9,33
Perth Glory,5777,8,10,2,15,37,50,-13,32
Wellington P,5777,9,5,6,16,31,55,-24,21
CC Mariners,5777,10,4,8,15,28,49,-21,20
Sydney FC,5778,1,21,4,3,68,22,46,67
N'castle Jet,5778,2,15,6,7,57,37,20,51
Melbourne C,5778,3,14,5,10,43,33,10,47
Melbourne V,5778,4,13,5,11,45,42,3,44
Adelaide Utd,5778,5,11,6,11,37,40,-3,39
Brisbane,5778,6,10,5,13,33,42,-9,35
Western Sydn,5778,7,8,9,10,38,47,-9,33
Perth Glory,5778,8,10,2,15,37,50,-13,32
Wellington P,5778,9,5,6,16,31,55,-24,21
CC Mariners,5778,10,4,8,15,28,49,-21,20
Sydney FC,5779,1,21,4,3,67,23,44,67
N'castle Jet,5779,2,16,5,7,58,37,21,53
Melbourne C,5779,3,14,4,11,43,34,9,46
Melbourne V,5779,4,13,5,11,46,41,5,44
Adelaide Utd,5779,5,11,6,11,37,40,-3,39
Brisbane,5779,6,10,5,13,33,42,-9,35
Western Sydn,5779,7,8,9,10,38,47,-9,33
Perth Glory,5779,8,10,2,15,37,50,-13,32
Wellington P,5779,9,5,6,16,31,55,-24,21
CC Mariners,5779,10,4,8,15,28,49,-21,20
Sydney FC,5780,1,20,5,3,65,23,42,65
N'castle Jet,5780,2,15,5,8,59,40,19,50
Melbourne C,5780,3,15,4,10,46,35,11,49
Melbourne V,5780,4,13,6,10,46,39,7,45
Adelaide Utd,5780,5,11,6,11,37,40,-3,39
Brisbane,5780,6,10,5,13,33,42,-9,35
Western Sydn,5780,7,8,9,10,38,47,-9,33
Perth Glory,5780,8,10,2,15,37,50,-13,32
Wellington P,5780,9,5,6,16,31,55,-24,21
CC Mariners,5780,10,4,8,15,28,49,-21,20
Sydney FC,5781,1,21,4,3,68,23,45,67
N'castle Jet,5781,2,15,6,7,58,38,20,51
Melbourne C,5781,3,14,5,10,44,34,10,47
Melbourne V,5781,4,13,5,11,46,42,4,44
Adelaide Utd,5781,5,11,6,11,37,40,-3,39
Brisbane,5781,6,10,5,13,33,42,-9,35
Western Sydn,5781,7,8,9,10,38,47,-9,33
Perth Glory,5781,8,10,2,15,37,50,-13,32
Wellington P,5781,9,5,6,16,31,55,-24,21
CC Mariners,5781,10,4,8,15,28,49,-21,20
Sydney FC,5782,1,21,4,3,66,23,43,67
N'castle Jet,5782,2,16,5,7,58,37,21,53
Melbourne C,5782,3,14,4,11,43,34,9,46
Melbourne V,5782,4,13,5,11,46,40,6,44
Adelaide Utd,5782,5,11,6,11,37,40,-3,39
Brisbane,5782,6,10,5,13,33,42,-9,35
Western Sydn,5782,7,8,9,10,38,47,-9,33
Perth Glory,5782,8,10,2,15,37,50,-13,32
Wellington P,5782,9,5,6,16,31,55,-24,21
CC Mariners,5782,10,4,8,15,28,49,-21,20
Sydney FC,5783,1,21,4,3,66,22,44,67
N'castle Jet,5783,2,15,6,7,58,38,20,51
Melbourne C,5783,3,14,5,10,44,34,10,47
Melbourne V,5783,4,13,5,11,45,40,5,44
Adelaide Utd,5783,5,11,6,11,37,40,-3,39
Brisbane,5783,6,10,5,13,33,42,-9,35
Western Sydn,5783,7,8,9,10,38,47,-9,33
Perth Glory,5783,8,10,2,15,37,50,-13,32
Wellington P,5783,9,5,6,16,31,55,-24,21
CC Mariners,5783,10,4,8,15,28,49,-21,20
Sydney FC,5784,1,20,4,4,66,25,41,64
N'castle Jet,5784,2,16,5,7,58,37,21,53
Melbourne V,5784,3,14,5,10,48,40,8,47
Melbourne C,5784,4,14,4,11,43,34,9,46
Adelaide Utd,5784,5,11,6,11,37,40,-3,39
Brisbane,5784,6,10,5,13,33,42,-9,35
Western Sydn,5784,7,8,9,10,38,47,-9,33
Perth Glory,5784,8,10,2,15,37,50,-13,32
Wellington P,5784,9,5,6,16,31,55,-24,21
CC Mariners,5784,10,4,8,15,28,49,-21,20
Sydney FC,5785,1,21,4,3,66,22,44,67
N'castle Jet,5785,2,15,5,8,57,39,18,50
Melbourne C,5785,3,15,4,10,45,33,12,49
Melbourne V,5785,4,13,5,11,45,40,5,44
Adelaide Utd,5785,5,11,6,11,37,40,-3,39
Brisbane,5785,6,10,5,13,33,42,-9,35
Western Sydn,5785,7,8,9,10,38,47,-9,33
Perth Glory,5785,8,10,2,15,37,50,-13,32
Wellington P,5785,9,5,6,16,31,55,-24,21
CC Mariners,5785,10,4,8,15,28,49,-21,20
Sydney FC,5786,1,20,5,3,65,23,42,65
N'castle Jet,5786,2,16,5,7,58,37,21,53
Melbourne C,5786,3,14,4,11,43,34,9,46
Melbourne V,5786,4,13,6,10,46,39,7,45
Adelaide Utd,5786,5,11,6,11,37,40,-3,39
Brisbane,5786,6,10,5,13,33,42,-9,35
Western Sydn,5786,7,8,9,10,38,47,-9,33
Perth Glory,5786,8,10,2,15,37,50,-13,32
Wellington P,5786,9,5,6,16,31,55,-24,21
CC Mariners,5786,10,4,8,15,28,49,-21,20
Sydney FC,5787,1,21,4,3,69,23,46,67
N'castle Jet,5787,2,16,5,7,59,37,22,53
Melbourne C,5787,3,14,4,11,43,35,8,46
Melbourne V,5787,4,13,5,11,46,43,3,44
Adelaide Utd,5787,5,11,6,11,37,40,-3,39
Brisbane,5787,6,10,5,13,33,42,-9,35
Western Sydn,5787,7,8,9,10,38,47,-9,33
Perth Glory,5787,8,10,2,15,37,50,-13,32
Wellington P,5787,9,5,6,16,31,55,-24,21
CC Mariners,5787,10,4,8,15,28,49,-21,20
Sydney FC,5788,1,21,4,3,65,22,43,67
N'castle Jet,5788,2,15,5,8,57,39,18,50
Melbourne C,5788,3,15,4,10,45,33,12,49
Melbourne V,5788,4,13,5,11,45,39,6,44
Adelaide Utd,5788,5,11,6,11,37,40,-3,39
Brisbane,5788,6,10,5,13,33,42,-9,35
Western Sydn,5788,7,8,9,10,38,47,-9,33
Perth Glory,5788,8,10,2,15,37,50,-13,32
Wellington P,5788,9,5,6,16,31,55,-24,21
CC Mariners,5788,10,4,8,15,28,49,-21,20
Sydney FC,5789,1,21,4,3,67,23,44,67
N'castle Jet,5789,2,15,6,7,58,38,20,51
Melbourne C,5789,3,14,5,10,44,34,10,47
Melbourne V,5789,4,13,5,11,46,41,5,44
Adelaide Utd,5789,5,11,6,11,37,40,-3,39
Brisbane,5789,6,10,5,13,33,42,-9,35
Western Sydn,5789,7,8,9,10,38,47,-9,33
Perth Glory,5789,8,10,2,15,37,50,-13,32
Wellington P,5789,9,5,6,16,31,55,-24,21
CC Mariners,5789,10,4,8,15,28,49,-21,20
Sydney FC,5790,1,21,4,3,67,22,45,67
N'castle Jet,5790,2,15,6,7,60,40,20,51
Melbourne C,5790,3,14,5,10,46,36,10,47
Melbourne V,5790,4,13,5,11,45,41,4,44
Adelaide Utd,5790,5,11,6,11,37,40,-3,39
Brisbane,5790,6,10,5,13,33,42,-9,35
Western Sydn,5790,7,8,9,10,38,47,-9,33
Perth Glory,5790,8,10,2,15,37,50,-13,32
Wellington P,5790,9,5,6,16,31,55,-24,21
CC Mariners,5790,10,4,8,15,28,49,-21,20
Sydney FC,5791,1,21,4,3,65,22,43,67
N'castle Jet,5791,2,15,5,8,57,40,17,50
Melbourne C,5791,3,15,4,10,46,33,13,49
Melbourne V,5791,4,13,5,11,45,39,6,44
Adelaide Utd,5791,5,11,6,11,37,40,-3,39
Brisbane,5791,6,10,5,13,33,42,-9,35
Western Sydn,5791,7,8,9,10,38,47,-9,33
Perth Glory,5791,8,10,2,15,37,50,-13,32
Wellington P,5791,9,5,6,16,31,55,-24,21
CC Mariners,5791,10,4,8,15,28,49,-21,20
Sydney FC,5792,1,21,4,3,66,23,43,67
N'castle Jet,5792,2,16,5,7,61,39,22,53
Melbourne C,5792,3,14,4,11,45,37,8,46
Melbourne V,5792,4,13,5,11,46,40,6,44
Adelaide Utd,5792,5,11,6,11,37,40,-3,39
Brisbane,5792,6,10,5,13,33,42,-9,35
Western Sydn,5792,7,8,9,10,38,47,-9,33
Perth Glory,5792,8,10,2,15,37,50,-13,32
Wellington P,5792,9,5,6,16,31,55,-24,21
CC Mariners,5792,10,4,8,15,28,49,-21,20
Sydney FC,5793,1,21,4,3,65,22,43,67
N'castle Jet,5793,2,15,5,8,58,39,19,50
Melbourne C,5793,3,15,4,10,45,34,11,49
Melbourne V,5793,4,13,5,11,45,39,6,44
Adelaide Utd,5793,5,11,6,11,37,40,-3,39
Brisbane,5793,6,10,5,13,33,42,-9,35
Western Sydn,5793,7,8,9,10,38,47,-9,33
Perth Glory,5793,8,10,2,15,37,50,-13,32
Wellington P,5793,9,5,6,16,31,55,-24,21
CC Mariners,5793,10,4,8,15,28,49,-21,20
Sydney FC,5794,1,21,4,3,66,23,43,67
N'castle Jet,5794,2,15,5,8,57,40,17,50
Melbourne C,5794,3,15,4,10,46,33,13,49
Melbourne V,5794,4,13,5,11,46,40,6,44
Adelaide Utd,5794,5,11,6,11,37,40,-3,39
Brisbane,5794,6,10,5,13,33,42,-9,35
Western Sydn,5794,7,8,9,10,38,47,-9,33
Perth Glory,5794,8,10,2,15,37,50,-13,32
Wellington P,5794,9,5,6,16,31,55,-24,21
CC Mariners,5794,10,4,8,15,28,49,-21,20
Sydney FC,5795,1,21,4,3,70,22,48,67
N'castle Jet,5795,2,16,5,7,60,38,22,53
Melbourne C,5795,3,14,4,11,44,36,8,46
Melbourne V,5795,4,13,5,11,45,44,1,44
Adelaide Utd,5795,5,11,6,11,37,40,-3,39
Brisbane,5795,6,10,5,13,33,42,-9,35
Western Sydn,5795,7,8,9,10,38,47,-9,33
Perth Glory,5795,8,10,2,15,37,50,-13,32
Wellington P,5795,9,5,6,16,31,55,-24,21
CC Mariners,5795,10,4,8,15,28,49,-21,20
Sydney FC,5796,1,20,4,4,65,24,41,64
N'castle Jet,5796,2,16,5,7,59,38,21,53
Melbourne V,5796,3,14,5,10,47,39,8,47
Melbourne C,5796,4,14,4,11,44,35,9,46
Adelaide Utd,5796,5,11,6,11,37,40,-3,39
Brisbane,5796,6,10,5,13,33,42,-9,35
Western Sydn,5796,7,8,9,10,38,47,-9,33
Perth Glory,5796,8,10,2,15,37,50,-13,32
Wellington P,5796,9,5,6,16,31,55,-24,21
CC Mariners,5796,10,4,8,15,28,49,-21,20
Sydney FC,5797,1,21,4,3,69,22,47,67
N'castle Jet,5797,2,16,5,7,59,37,22,53
Melbourne C,5797,3,14,4,11,43,35,8,46
Melbourne V,5797,4,13,5,11,45,43,2,44
Adelaide Utd,5797,5,11,6,11,37,40,-3,39
Brisbane,5797,6,10,5,13,33,42,-9,35
Western Sydn,5797,7,8,9,10,38,47,-9,33
Perth Glory,5797,8,10,2,15,37,50,-13,32
Wellington P,5797,9,5,6,16,31,55,-24,21
CC Mariners,5797,10,4,8,15,28,49,-21,20
Sydney FC,5798,1,20,5,3,65,23,42,65
N'castle Jet,5798,2,16,5,7,59,38,21,53
Melbourne C,5798,3,14,4,11,44,35,9,46
Melbourne V,5798,4,13,6,10,46,39,7,45
Adelaide Utd,5798,5,11,6,11,37,40,-3,39
Brisbane,5798,6,10,5,13,33,42,-9,35
Western Sydn,5798,7,8,9,10,38,47,-9,33
Perth Glory,5798,8,10,2,15,37,50,-13,32
Wellington P,5798,9,5,6,16,31,55,-24,21
CC Mariners,5798,10,4,8,15,28,49,-21,20
Sydney FC,5799,1,21,4,3,69,24,45,67
N'castle Jet,5799,2,15,5,8,58,41,17,50
Melbourne C,5799,3,15,4,10,47,34,13,49
Melbourne V,5799,4,13,5,11,47,43,4,44
Adelaide Utd,5799,5,11,6,11,37,40,-3,39
Brisbane,5799,6,10,5,13,33,42,-9,35
Western Sydn,5799,7,8,9,10,38,47,-9,33
Perth Glory,5799,8,10,2,15,37,50,-13,32
Wellington P,5799,9,5,6,16,31,55,-24,21
CC Mariners,5799,10,4,8,15,28,49,-21,20
Sydney FC,5800,1,20,4,4,64,24,40,64
N'castle Jet,5800,2,15,6,7,60,40,20,51
Melbourne C,5800,3,14,5,10,46,36,10,47
Melbourne V,5800,4,14,5,10,47,38,9,47
Adelaide Utd,5800,5,11,6,11,37,40,-3,39
Brisbane,5800,6,10,5,13,33,42,-9,35
Western Sydn,5800,7,8,9,10,38,47,-9,33
Perth Glory,5800,8,10,2,15,37,50,-13,32
Wellington P,5800,9,5,6,16,31,55,-24,21
CC Mariners,5800,10,4,8,15,28,49,-21,20
Sydney FC,5801,1,20,4,4,64,24,40,64
N'castle Jet,5801,2,15,5,8,58,39,19,50
Melbourne C,5801,3,15,4,10,45,34,11,49
Melbourne V,5801,4,14,5,10,47,38,9,47
Adelaide Utd,5801,5,11,6,11,37,40,-3,39
Brisbane,5801,6,10,5,13,33,42,-9,35
Western Sydn,5801,7,8,9,10,38,47,-9,33
Perth Glory,5801,8,10,2,15,37,50,-13,32
Wellington P,5801,9,5,6,16,31,55,-24,21
CC Mariners,5801,10,4,8,15,28,49,-21,20
Sydney FC,5802,1,20,5,3,66,24,42,65
N'castle Jet,5802,2,16,5,7,61,38,23,53
Melbourne C,5802,3,14,4,11,44,37,7,46
Melbourne V,5802,4,13,6,10,47,40,7,45
Adelaide Utd,5802,5,11,6,11,37,40,-3,39
Brisbane,5802,6,10,5,13,33,42,-9,35
Western Sydn,5802,7,8,9,10,38,47,-9,33
Perth Glory,5802,8,10,2,15,37,50,-13,32
Wellington P,5802,9,5,6,16,31,55,-24,21
CC Mariners,5802,10,4,8,15,28,49,-21,20
Sydney FC,5803,1,20,5,3,66,24,42,65
N'castle Jet,5803,2,16,5,7,59,38,21,53
Melbourne C,5803,3,14,4,11,44,35,9,46
Melbourne V,5803,4,13,6,10,47,40,7,45
Adelaide Utd,5803,5,11,6,11,37,40,-3,39
Brisbane,5803,6,10,5,13,33,42,-9,35
Western Sydn,5803,7,8,9,10,38,47,-9,33
Perth Glory,5803,8,10,2,15,37,50,-13,32
Wellington P,5803,9,5,6,16,31,55,-24,21
CC Mariners,5803,10,4,8,15,28,49,-21,20
Sydney FC,5804,1,21,4,3,67,23,44,67
N'castle Jet,5804,2,15,6,7,58,38,20,51
Melbourne C,5804,3,14,5,10,44,34,10,47
Melbourne V,5804,4,13,5,11,46,41,5,44
Adelaide Utd,5804,5,11,6,11,37,40,-3,39
Brisbane,5804,6,10,5,13,33,42,-9,35
Western Sydn,5804,7,8,9,10,38,47,-9,33
Perth Glory,5804,8,10,2,15,37,50,-13,32
Wellington P,5804,9,5,6,16,31,55,-24,21
CC Mariners,5804,10,4,8,15,28,49,-21,20
Sydney FC,5805,1,21,4,3,66,23,43,67
N'castle Jet,5805,2,15,5,8,58,39,19,50
Melbourne C,5805,3,15,4,10,45,34,11,49
Melbourne V,5805,4,13,5,11,46,40,6,44
Adelaide Utd,5805,5,11,6,11,37,40,-3,39
Brisbane,5805,6,10,5,13,33,42,-9,35
Western Sydn,5805,7,8,9,10,38,47,-9,33
Perth Glory,5805,8,10,2,15,37,50,-13,32
Wellington P,5805,9,5,6,16,31,55,-24,21
CC Mariners,5805,10,4,8,15,28,49,-21,20
Sydney FC,5806,1,21,4,3,66,22,44,67
N'castle Jet,5806,2,15,5,8,57,39,18,50
Melbourne C,5806,3,15,4,10,45,33,12,49
Melbourne V,5806,4,13,5,11,45,40,5,44
Adelaide Utd,5806,5,11,6,11,37,40,-3,39
Brisbane,5806,6,10,5,13,33,42,-9,35
Western Sydn,5806,7,8,9,10,38,47,-9,33
Perth Glory,5806,8,10,2,15,37,50,-13,32
Wellington P,5806,9,5,6,16,31,55,-24,21
CC Mariners,5806,10,4,8,15,28,49,-21,20
Sydney FC,5807,1,20,5,3,66,24,42,65
N'castle Jet,5807,2,16,5,7,60,37,23,53
Melbourne C,5807,3,14,4,11,43,36,7,46
Melbourne V,5807,4,13,6,10,47,40,7,45
Adelaide Utd,5807,5,11,6,11,37,40,-3,39
Brisbane,5807,6,10,5,13,33,42,-9,35
Western Sydn,5807,7,8,9,10,38,47,-9,33
Perth Glory,5807,8,10,2,15,37,50,-13,32
Wellington P,5807,9,5,6,16,31,55,-24,21
CC Mariners,5807,10,4,8,15,28,49,-21,20
Sydney FC,5808,1,21,4,3,67,23,44,67
N'castle Jet,5808,2,15,6,7,58,38,20,51
Melbourne C,5808,3,14,5,10,44,34,10,47
Melbourne V,5808,4,13,5,11,46,41,5,44
Adelaide Utd,5808,5,11,6,11,37,40,-3,39
Brisbane,5808,6,10,5,13,33,42,-9,35
Western Sydn,5808,7,8,9,10,38,47,-9,33
Perth Glory,5808,8,10,2,15,37,50,-13,32
Wellington P,5808,9,5,6,16,31,55,-24,21
CC Mariners,5808,10,4,8,15,28,49,-21,20
Sydney FC,5809,1,21,4,3,65,22,43,67
N'castle Jet,5809,2,16,5,7,59,38,21,53
Melbourne C,5809,3,14,4,11,44,35,9,46
Melbourne V,5809,4,13,5,11,45,39,6,44
Adelaide Utd,5809,5,11,6,11,37,40,-3,39
Brisbane,5809,6,10,5,13,33,42,-9,35
Western Sydn,5809,7,8,9,10,38,47,-9,33
Perth Glory,5809,8,10,2,15,37,50,-13,32
Wellington P,5809,9,5,6,16,31,55,-24,21
CC Mariners,5809,10,4,8,15,28,49,-21,20
Sydney FC,5810,1,21,4,3,65,22,43,67
N'castle Jet,5810,2,15,6,7,59,39,20,51
Melbourne C,5810,3,14,5,10,45,35,10,47
Melbourne V,5810,4,13,5,11,45,39,6,44
Adelaide Utd,5810,5,11,6,11,37,40,-3,39
Brisbane,5810,6,10,5,13,33,42,-9,35
Western Sydn,5810,7,8,9,10,38,47,-9,33
Perth Glory,5810,8,10,2,15,37,50,-13,32
Wellington P,5810,9,5,6,16,31,55,-24,21
CC Mariners,5810,10,4,8,15,28,49,-21,20
Sydney FC,5811,1,21,4,3,67,24,43,67
N'castle Jet,5811,2,16,5,7,60,37,23,53
Melbourne C,5811,3,14,4,11,43,36,7,46
Melbourne V,5811,4,13,5,11,47,41,6,44
Adelaide Utd,5811,5,11,6,11,37,40,-3,39
Brisbane,5811,6,10,5,13,33,42,-9,35
Western Sydn,5811,7,8,9,10,38,47,-9,33
Perth Glory,5811,8,10,2,15,37,50,-13,32
Wellington P,5811,9,5,6,16,31,55,-24,21
CC Mariners,5811,10,4,8,15,28,49,-21,20
Sydney FC,5812,1,21,4,3,65,22,43,67
N'castle Jet,5812,2,16,5,7,62,38,24,53
Melbourne C,5812,3,14,4,11,44,38,6,46
Melbourne V,5812,4,13,5,11,45,39,6,44
Adelaide Utd,5812,5,11,6,11,37,40,-3,39
Brisbane,5812,6,10,5,13,33,42,-9,35
Western Sydn,5812,7,8,9,10,38,47,-9,33
Perth Glory,5812,8,10,2,15,37,50,-13,32
Wellington P,5812,9,5,6,16,31,55,-24,21
CC Mariners,5812,10,4,8,15,28,49,-21,20
Sydney FC,5813,1,21,4,3,67,22,45,67
N'castle Jet,5813,2,15,6,7,57,37,20,51
Melbourne C,5813,3,14,5,10,43,33,10,47
Melbourne V,5813,4,13,5,11,45,41,4,44
Adelaide Utd,5813,5,11,6,11,37,40,-3,39
Brisbane,5813,6,10,5,13,33,42,-9,35
Western Sydn,5813,7,8,9,10,38,47,-9,33
Perth Glory,5813,8,10,2,15,37,50,-13,32
Wellington P,5813,9,5,6,16,31,55,-24,21
CC Mariners,5813,10,4,8,15,28,49,-21,20
Sydney FC,5814,1,21,4,3,69,24,45,67
N'castle Jet,5814,2,16,5,7,58,37,21,53
Melbourne C,5814,3,14,4,11,43,34,9,46
Melbourne V,5814,4,13,5,11,47,43,4,44
Adelaide Utd,5814,5,11,6,11,37,40,-3,39
Brisbane,5814,6,10,5,13,33,42,-9,35
Western Sydn,5814,7,8,9,10,38,47,-9,33
Perth Glory,5814,8,10,2,15,37,50,-13,32
Wellington P,5814,9,5,6,16,31,55,-24,21
CC Mariners,5814,10,4,8,15,28,49,-21,20
Sydney FC,5815,1,21,4,3,67,24,43,67
N'castle Jet,5815,2,15,6,7,59,39,20,51
Melbourne C,5815,3,14,5,10,45,35,10,47
Melbourne V,5815,4,13,5,11,47,41,6,44
Adelaide Utd,5815,5,11,6,11,37,40,-3,39
Brisbane,5815,6,10,5,13,33,42,-9,35
Western Sydn,5815,7,8,9,10,38,47,-9,33
Perth Glory,5815,8,10,2,15,37,50,-13,32
Wellington P,5815,9,5,6,16,31,55,-24,21
CC Mariners,5815,10,4,8,15,28,49,-21,20
Sydney FC,5816,1,21,4,3,65,22,43,67
N'castle Jet,5816,2,15,5,8,57,38,19,50
Melbourne C,5816,3,15,4,10,44,33,11,49
Melbourne V,5816,4,13,5,11,45,39,6,44
Adelaide Utd,5816,5,11,6,11,37,40,-3,39
Brisbane,5816,6,10,5,13,33,42,-9,35
Western Sydn,5816,7,8,9,10,38,47,-9,33
Perth Glory,5816,8,10,2,15,37,50,-13,32
Wellington P,5816,9,5,6,16,31,55,-24,21
CC Mariners,5816,10,4,8,15,28,49,-21,20
Sydney FC,5817,1,21,4,3,65,22,43,67
N'castle Jet,5817,2,15,5,8,58,42,16,50
Melbourne C,5817,3,15,4,10,48,34,14,49
Melbourne V,5817,4,13,5,11,45,39,6,44
Adelaide Utd,5817,5,11,6,11,37,40,-3,39
Brisbane,5817,6,10,5,13,33,42,-9,35
Western Sydn,5817,7,8,9,10,38,47,-9,33
Perth Glory,5817,8,10,2,15,37,50,-13,32
Wellington P,5817,9,5,6,16,31,55,-24,21
CC Mariners,5817,10,4,8,15,28,49,-21,20
Sydney FC,5818,1,21,4,3,66,22,44,67
N'castle Jet,5818,2,16,5,7,58,37,21,53
Melbourne C,5818,3,14,4,11,43,34,9,46
Melbourne V,5818,4,13,5,11,45,40,5,44
Adelaide Utd,5818,5,11,6,11,37,40,-3,39
Brisbane,5818,6,10,5,13,33,42,-9,35
Western Sydn,5818,7,8,9,10,38,47,-9,33
Perth Glory,5818,8,10,2,15,37,50,-13,32
Wellington P,5818,9,5,6,16,31,55,-24,21
CC Mariners,5818,10,4,8,15,28,49,-21,20
Sydney FC,5819,1,21,4,3,66,22,44,67
N'castle Jet,5819,2,15,6,7,59,39,20,51
Melbourne C,5819,3,14,5,10,45,35,10,47
Melbourne V,5819,4,13,5,11,45,40,5,44
Adelaide Utd,5819,5,11,6,11,37,40,-3,39
Brisbane,5819,6,10,5,13,33,42,-9,35
Western Sydn,5819,7,8,9,10,38,47,-9,33
Perth Glory,5819,8,10,2,15,37,50,-13,32
Wellington P,5819,9,5,6,16,31,55,-24,21
CC Mariners,5819,10,4,8,15,28,49,-21,20
Sydney FC,5820,1,21,4,3,68,23,45,67
N'castle Jet,5820,2,15,5,8,58,39,19,50
Melbourne C,5820,3,15,4,10,45,34,11,49
Melbourne V,5820,4,13,5,11,46,42,4,44
Adelaide Utd,5820,5,11,6,11,37,40,-3,39
Brisbane,5820,6,10,5,13,33,42,-9,35
Western Sydn,5820,7,8,9,10,38,47,-9,33
Perth Glory,5820,8,10,2,15,37,50,-13,32
Wellington P,5820,9,5,6,16,31,55,-24,21
CC Mariners,5820,10,4,8,15,28,49,-21,20
Sydney FC,5821,1,21,4,3,66,22,44,67
N'castle Jet,5821,2,15,5,8,59,40,19,50
Melbourne C,5821,3,15,4,10,46,35,11,49
Melbourne V,5821,4,13,5,11,45,40,5,44
Adelaide Utd,5821,5,11,6,11,37,40,-3,39
Brisbane,5821,6,10,5,13,33,42,-9,35
Western Sydn,5821,7,8,9,10,38,47,-9,33
Perth Glory,5821,8,10,2,15,37,50,-13,32
Wellington P,5821,9,5,6,16,31,55,-24,21
CC Mariners,5821,10,4,8,15,28,49,-21,20
Sydney FC,5822,1,21,4,3,65,22,43,67
N'castle Jet,5822,2,15,5,8,58,39,19,50
Melbourne C,5822,3,15,4,10,45,34,11,49
Melbourne V,5822,4,13,5,11,45,39,6,44
Adelaide Utd,5822,5,11,6,11,37,40,-3,39
Brisbane,5822,6,10,5,13,33,42,-9,35
Western Sydn,5822,7,8,9,10,38,47,-9,33
Perth Glory,5822,8,10,2,15,37,50,-13,32
Wellington P,5822,9,5,6,16,31,55,-24,21
CC Mariners,5822,10,4,8,15,28,49,-21,20
Sydney FC,5823,1,21,4,3,67,22,45,67
N'castle Jet,5823,2,15,6,7,58,38,20,51
Melbourne C,5823,3,14,5,10,44,34,10,47
Melbourne V,5823,4,13,5,11,45,41,4,44
Adelaide Utd,5823,5,11,6,11,37,40,-3,39
Brisbane,5823,6,10,5,13,33,42,-9,35
Western Sydn,5823,7,8,9,10,38,47,-9,33
Perth Glory,5823,8,10,2,15,37,50,-13,32
Wellington P,5823,9,5,6,16,31,55,-24,21
CC Mariners,5823,10,4,8,15,28,49,-21,20
Sydney FC,5824,1,20,4,4,65,24,41,64
N'castle Jet,5824,2,16,5,7,59,37,22,53
Melbourne V,5824,3,14,5,10,47,39,8,47
Melbourne C,5824,4,14,4,11,43,35,8,46
Adelaide Utd,5824,5,11,6,11,37,40,-3,39
Brisbane,5824,6,10,5,13,33,42,-9,35
Western Sydn,5824,7,8,9,10,38,47,-9,33
Perth Glory,5824,8,10,2,15,37,50,-13,32
Wellington P,5824,9,5,6,16,31,55,-24,21
CC Mariners,5824,10,4,8,15,28,49,-21,20
Sydney FC,5825,1,21,4,3,66,22,44,67
N'castle Jet,5825,2,16,5,7,58,37,21,53
Melbourne C,5825,3,14,4,11,43,34,9,46
Melbourne V,5825,4,13,5,11,45,40,5,44
Adelaide Utd,5825,5,11,6,11,37,40,-3,39
Brisbane,5825,6,10,5,13,33,42,-9,35
Western Sydn,5825,7,8,9,10,38,47,-9,33
Perth Glory,5825,8,10,2,15,37,50,-13,32
Wellington P,5825,9,5,6,16,31,55,-24,21
CC Mariners,5825,10,4,8,15,28,49,-21,20
Sydney FC,5826,1,21,4,3,67,23,44,67
N'castle Jet,5826,2,15,6,7,57,37,20,51
Melbourne C,5826,3,14,5,10,43,33,10,47
Melbourne V,5826,4,13,5,11,46,41,5,44
Adelaide Utd,5826,5,11,6,11,37,40,-3,39
Brisbane,5826,6,10,5,13,33,42,-9,35
Western Sydn,5826,7,8,9,10,38,47,-9,33
Perth Glory,5826,8,10,2,15,37,50,-13,32
Wellington P,5826,9,5,6,16,31,55,-24,21
CC Mariners,5826,10,4,8,15,28,49,-21,20
Sydney FC,5827,1,20,5,3,66,24,42,65
N'castle Jet,5827,2,16,5,7,59,38,21,53
Melbourne C,5827,3,14,4,11,44,35,9,46
Melbourne V,5827,4,13,6,10,47,40,7,45
Adelaide Utd,5827,5,11,6,11,37,40,-3,39
Brisbane,5827,6,10,5,13,33,42,-9,35
Western Sydn,5827,7,8,9,10,38,47,-9,33
Perth Glory,5827,8,10,2,15,37,50,-13,32
Wellington P,5827,9,5,6,16,31,55,-24,21
CC Mariners,5827,10,4,8,15,28,49,-21,20
Sydney FC,5828,1,20,4,4,65,25,40,64
N'castle Jet,5828,2,15,5,8,58,40,18,50
Melbourne C,5828,3,15,4,10,46,34,12,49
Melbourne V,5828,4,14,5,10,48,39,9,47
Adelaide Utd,5828,5,11,6,11,37,40,-3,39
Brisbane,5828,6,10,5,13,33,42,-9,35
Western Sydn,5828,7,8,9,10,38,47,-9,33
Perth Glory,5828,8,10,2,15,37,50,-13,32
Wellington P,5828,9,5,6,16,31,55,-24,21
CC Mariners,5828,10,4,8,15,28,49,-21,20
Sydney FC,5829,1,21,4,3,65,22,43,67
N'castle Jet,5829,2,16,5,7,60,37,23,53
Melbourne C,5829,3,14,4,11,43,36,7,46
Melbourne V,5829,4,13,5,11,45,39,6,44
Adelaide Utd,5829,5,11,6,11,37,40,-3,39
Brisbane,5829,6,10,5,13,33,42,-9,35
Western Sydn,5829,7,8,9,10,38,47,-9,33
Perth Glory,5829,8,10,2,15,37,50,-13,32
Wellington P,5829,9,5,6,16,31,55,-24,21
CC Mariners,5829,10,4,8,15,28,49,-21,20
Sydney FC,5830,1,21,4,3,66,22,44,67
N'castle Jet,5830,2,16,5,7,60,37,23,53
Melbourne C,5830,3,14,4,11,43,36,7,46
Melbourne V,5830,4,13,5,11,45,40,5,44
Adelaide Utd,5830,5,11,6,11,37,40,-3,39
Brisbane,5830,6,10,5,13,33,42,-9,35
Western Sydn,5830,7,8,9,10,38,47,-9,33
Perth Glory,5830,8,10,2,15,37,50,-13,32
Wellington P,5830,9,5,6,16,31,55,-24,21
CC Mariners,5830,10,4,8,15,28,49,-21,20
Sydney FC,5831,1,21,4,3,68,22,46,67
N'castle Jet,5831,2,16,5,7,60,38,22,53
Melbourne C,5831,3,14,4,11,44,36,8,46
Melbourne V,5831,4,13,5,11,45,42,3,44
Adelaide Utd,5831,5,11,6,11,37,40,-3,39
Brisbane,5831,6,10,5,13,33,42,-9,35
Western Sydn,5831,7,8,9,10,38,47,-9,33
Perth Glory,5831,8,10,2,15,37,50,-13,32
Wellington P,5831,9,5,6,16,31,55,-24,21
CC Mariners,5831,10,4,8,15,28,49,-21,20
Sydney FC,5832,1,21,4,3,68,24,44,67
N'castle Jet,5832,2,15,6,7,57,37,20,51
Melbourne C,5832,3,14,5,10,43,33,10,47
Melbourne V,5832,4,13,5,11,47,42,5,44
Adelaide Utd,5832,5,11,6,11,37,40,-3,39
Brisbane,5832,6,10,5,13,33,42,-9,35
Western Sydn,5832,7,8,9,10,38,47,-9,33
Perth Glory,5832,8,10,2,15,37,50,-13,32
Wellington P,5832,9,5,6,16,31,55,-24,21
CC Mariners,5832,10,4,8,15,28,49,-21,20
Sydney FC,5833,1,20,5,3,66,24,42,65
N'castle Jet,5833,2,15,6,7,58,38,20,51
Melbourne C,5833,3,14,5,10,44,34,10,47
Melbourne V,5833,4,13,6,10,47,40,7,45
Adelaide Utd,5833,5,11,6,11,37,40,-3,39
Brisbane,5833,6,10,5,13,33,42,-9,35
Western Sydn,5833,7,8,9,10,38,47,-9,33
Perth Glory,5833,8,10,2,15,37,50,-13,32
Wellington P,5833,9,5,6,16,31,55,-24,21
CC Mariners,5833,10,4,8,15,28,49,-21,20
Sydney FC,5834,1,21,4,3,68,23,45,67
N'castle Jet,5834,2,15,6,7,58,38,20,51
Melbourne C,5834,3,14,5,10,44,34,10,47
Melbourne V,5834,4,13,5,11,46,42,4,44
Adelaide Utd,5834,5,11,6,11,37,40,-3,39
Brisbane,5834,6,10,5,13,33,42,-9,35
Western Sydn,5834,7,8,9,10,38,47,-9,33
Perth Glory,5834,8,10,2,15,37,50,-13,32
Wellington P,5834,9,5,6,16,31,55,-24,21
CC Mariners,5834,10,4,8,15,28,49,-21,20
Sydney FC,5835,1,20,4,4,64,24,40,64
N'castle Jet,5835,2,15,5,8,59,41,18,50
Melbourne C,5835,3,15,4,10,47,35,12,49
Melbourne V,5835,4,14,5,10,47,38,9,47
Adelaide Utd,5835,5,11,6,11,37,40,-3,39
Brisbane,5835,6,10,5,13,33,42,-9,35
Western Sydn,5835,7,8,9,10,38,47,-9,33
Perth Glory,5835,8,10,2,15,37,50,-13,32
Wellington P,5835,9,5,6,16,31,55,-24,21
CC Mariners,5835,10,4,8,15,28,49,-21,20
Sydney FC,5836,1,20,4,4,65,24,41,64
N'castle Jet,5836,2,15,6,7,57,37,20,51
Melbourne C,5836,3,14,5,10,43,33,10,47
Melbourne V,5836,4,14,5,10,47,39,8,47
Adelaide Utd,5836,5,11,6,11,37,40,-3,39
Brisbane,5836,6,10,5,13,33,42,-9,35
Western Sydn,5836,7,8,9,10,38,47,-9,33
Perth Glory,5836,8,10,2,15,37,50,-13,32
Wellington P,5836,9,5,6,16,31,55,-24,21
CC Mariners,5836,10,4,8,15,28,49,-21,20
Sydney FC,5837,1,21,4,3,69,22,47,67
N'castle Jet,5837,2,16,5,7,60,39,21,53
Melbourne C,5837,3,14,4,11,45,36,9,46
Melbourne V,5837,4,13,5,11,45,43,2,44
Adelaide Utd,5837,5,11,6,11,37,40,-3,39
Brisbane,5837,6,10,5,13,33,42,-9,35
Western Sydn,5837,7,8,9,10,38,47,-9,33
Perth Glory,5837,8,10,2,15,37,50,-13,32
Wellington P,5837,9,5,6,16,31,55,-24,21
CC Mariners,5837,10,4,8,15,28,49,-21,20
Sydney FC,5838,1,20,4,4,64,23,41,64
N'castle Jet,5838,2,16,5,7,59,37,22,53
Melbourne V,5838,3,14,5,10,46,38,8,47
Melbourne C,5838,4,14,4,11,43,35,8,46
Adelaide Utd,5838,5,11,6,11,37,40,-3,39
Brisbane,5838,6,10,5,13,33,42,-9,35
Western Sydn,5838,7,8,9,10,38,47,-9,33
Perth Glory,5838,8,10,2,15,37,50,-13,32
Wellington P,5838,9,5,6,16,31,55,-24,21
CC Mariners,5838,10,4,8,15,28,49,-21,20
Sydney FC,5839,1,21,4,3,65,22,43,67
N'castle Jet,5839,2,16,5,7,58,37,21,53
Melbourne C,5839,3,14,4,11,43,34,9,46
Melbourne V,5839,4,13,5,11,45,39,6,44
Adelaide Utd,5839,5,11,6,11,37,40,-3,39
Brisbane,5839,6,10,5,13,33,42,-9,35
Western Sydn,5839,7,8,9,10,38,47,-9,33
Perth Glory,5839,8,10,2,15,37,50,-13,32
Wellington P,5839,9,5,6,16,31,55,-24,21
CC Mariners,5839,10,4,8,15,28,49,-21,20
Sydney FC,5840,1,20,5,3,66,24,42,65
N'castle Jet,5840,2,15,6,7,59,39,20,51
Melbourne C,5840,3,14,5,10,45,35,10,47
Melbourne V,5840,4,13,6,10,47,40,7,45
Adelaide Utd,5840,5,11,6,11,37,40,-3,39
Brisbane,5840,6,10,5,13,33,42,-9,35
Western Sydn,5840,7,8,9,10,38,47,-9,33
Perth Glory,5840,8,10,2,15,37,50,-13,32
Wellington P,5840,9,5,6,16,31,55,-24,21
CC Mariners,5840,10,4,8,15,28,49,-21,20
Sydney FC,5841,1,21,4,3,66,22,44,67
N'castle Jet,5841,2,16,5,7,60,38,22,53
Melbourne C,5841,3,14,4,11,44,36,8,46
Melbourne V,5841,4,13,5,11,45,40,5,44
Adelaide Utd,5841,5,11,6,11,37,40,-3,39
Brisbane,5841,6,10,5,13,33,42,-9,35
Western Sydn,5841,7,8,9,10,38,47,-9,33
Perth Glory,5841,8,10,2,15,37,50,-13,32
Wellington P,5841,9,5,6,16,31,55,-24,21
CC Mariners,5841,10,4,8,15,28,49,-21,20
Sydney FC,5842,1,21,4,3,68,23,45,67
N'castle Jet,5842,2,16,5,7,60,37,23,53
Melbourne C,5842,3,14,4,11,43,36,7,46
Melbourne V,5842,4,13,5,11,46,42,4,44
Adelaide Utd,5842,5,11,6,11,37,40,-3,39
Brisbane,5842,6,10,5,13,33,42,-9,35
Western Sydn,5842,7,8,9,10,38,47,-9,33
Perth Glory,5842,8,10,2,15,37,50,-13,32
Wellington P,5842,9,5,6,16,31,55,-24,21
CC Mariners,5842,10,4,8,15,28,49,-21,20
Sydney FC,5843,1,21,4,3,66,23,43,67
N'castle Jet,5843,2,15,5,8,59,42,17,50
Melbourne C,5843,3,15,4,10,48,35,13,49
Melbourne V,5843,4,13,5,11,46,40,6,44
Adelaide Utd,5843,5,11,6,11,37,40,-3,39
Brisbane,5843,6,10,5,13,33,42,-9,35
Western Sydn,5843,7,8,9,10,38,47,-9,33
Perth Glory,5843,8,10,2,15,37,50,-13,32
Wellington P,5843,9,5,6,16,31,55,-24,21
CC Mariners,5843,10,4,8,15,28,49,-21,20
Sydney FC,5844,1,20,4,4,64,23,41,64
N'castle Jet,5844,2,15,5,8,57,41,16,50
Melbourne C,5844,3,15,4,10,47,33,14,49
Melbourne V,5844,4,14,5,10,46,38,8,47
Adelaide Utd,5844,5,11,6,11,37,40,-3,39
Brisbane,5844,6,10,5,13,33,42,-9,35
Western Sydn,5844,7,8,9,10,38,47,-9,33
Perth Glory,5844,8,10,2,15,37,50,-13,32
Wellington P,5844,9,5,6,16,31,55,-24,21
CC Mariners,5844,10,4,8,15,28,49,-21,20
Sydney FC,5845,1,20,4,4,66,25,41,64
N'castle Jet,5845,2,16,5,7,58,37,21,53
Melbourne V,5845,3,14,5,10,48,40,8,47
Melbourne C,5845,4,14,4,11,43,34,9,46
Adelaide Utd,5845,5,11,6,11,37,40,-3,39
Brisbane,5845,6,10,5,13,33,42,-9,35
Western Sydn,5845,7,8,9,10,38,47,-9,33
Perth Glory,5845,8,10,2,15,37,50,-13,32
Wellington P,5845,9,5,6,16,31,55,-24,21
CC Mariners,5845,10,4,8,15,28,49,-21,20
Sydney FC,5846,1,21,4,3,67,22,45,67
N'castle Jet,5846,2,16,5,7,59,38,21,53
Melbourne C,5846,3,14,4,11,44,35,9,46
Melbourne V,5846,4,13,5,11,45,41,4,44
Adelaide Utd,5846,5,11,6,11,37,40,-3,39
Brisbane,5846,6,10,5,13,33,42,-9,35
Western Sydn,5846,7,8,9,10,38,47,-9,33
Perth Glory,5846,8,10,2,15,37,50,-13,32
Wellington P,5846,9,5,6,16,31,55,-24,21
CC Mariners,5846,10,4,8,15,28,49,-21,20
Sydney FC,5847,1,21,4,3,65,22,43,67
N'castle Jet,5847,2,16,5,7,61,38,23,53
Melbourne C,5847,3,14,4,11,44,37,7,46
Melbourne V,5847,4,13,5,11,45,39,6,44
Adelaide Utd,5847,5,11,6,11,37,40,-3,39
Brisbane,5847,6,10,5,13,33,42,-9,35
Western Sydn,5847,7,8,9,10,38,47,-9,33
Perth Glory,5847,8,10,2,15,37,50,-13,32
Wellington P,5847,9,5,6,16,31,55,-24,21
CC Mariners,5847,10,4,8,15,28,49,-21,20
Sydney FC,5848,1,21,4,3,65,22,43,67
N'castle Jet,5848,2,16,5,7,60,38,22,53
Melbourne C,5848,3,14,4,11,44,36,8,46
Melbourne V,5848,4,13,5,11,45,39,6,44
Adelaide Utd,5848,5,11,6,11,37,40,-3,39
Brisbane,5848,6,10,5,13,33,42,-9,35
Western Sydn,5848,7,8,9,10,38,47,-9,33
Perth Glory,5848,8,10,2,15,37,50,-13,32
Wellington P,5848,9,5,6,16,31,55,-24,21
CC Mariners,5848,10,4,8,15,28,49,-21,20
Sydney FC,5849,1,20,5,3,64,22,42,65
N'castle Jet,5849,2,15,6,7,58,38,20,51
Melbourne C,5849,3,14,5,10,44,34,10,47
Melbourne V,5849,4,13,6,10,45,38,7,45
Adelaide Utd,5849,5,11,6,11,37,40,-3,39
Brisbane,5849,6,10,5,13,33,42,-9,35
Western Sydn,5849,7,8,9,10,38,47,-9,33
Perth Glory,5849,8,10,2,15,37,50,-13,32
Wellington P,5849,9,5,6,16,31,55,-24,21
CC Mariners,5849,10,4,8,15,28,49,-21,20
Sydney FC,5850,1,21,4,3,65,22,43,67
N'castle Jet,5850,2,15,6,7,58,38,20,51
Melbourne C,5850,3,14,5,10,44,34,10,47
Melbourne V,5850,4,13,5,11,45,39,6,44
Adelaide Utd,5850,5,11,6,11,37,40,-3,39
Brisbane,5850,6,10,5,13,33,42,-9,35
Western Sydn,5850,7,8,9,10,38,47,-9,33
Perth Glory,5850,8,10,2,15,37,50,-13,32
Wellington P,5850,9,5,6,16,31,55,-24,21
CC Mariners,5850,10,4,8,15,28,49,-21,20
Sydney FC,5851,1,20,5,3,66,24,42,65
N'castle Jet,5851,2,15,5,8,58,39,19,50
Melbourne C,5851,3,15,4,10,45,34,11,49
Melbourne V,5851,4,13,6,10,47,40,7,45
Adelaide Utd,5851,5,11,6,11,37,40,-3,39
Brisbane,5851,6,10,5,13,33,42,-9,35
Western Sydn,5851,7,8,9,10,38,47,-9,33
Perth Glory,5851,8,10,2,15,37,50,-13,32
Wellington P,5851,9,5,6,16,31,55,-24,21
CC Mariners,5851,10,4,8,15,28,49,-21,20
Sydney FC,5852,1,20,4,4,64,24,40,64
N'castle Jet,5852,2,15,5,8,58,39,19,50
Melbourne C,5852,3,15,4,10,45,34,11,49
Melbourne V,5852,4,14,5,10,47,38,9,47
Adelaide Utd,5852,5,11,6,11,37,40,-3,39
Brisbane,5852,6,10,5,13,33,42,-9,35
Western Sydn,5852,7,8,9,10,38,47,-9,33
Perth Glory,5852,8,10,2,15,37,50,-13,32
Wellington P,5852,9,5,6,16,31,55,-24,21
CC Mariners,5852,10,4,8,15,28,49,-21,20
Sydney FC,5853,1,20,4,4,66,27,39,64
N'castle Jet,5853,2,15,5,8,58,39,19,50
Melbourne C,5853,3,15,4,10,45,34,11,49
Melbourne V,5853,4,14,5,10,50,40,10,47
Adelaide Utd,5853,5,11,6,11,37,40,-3,39
Brisbane,5853,6,10,5,13,33,42,-9,35
Western Sydn,5853,7,8,9,10,38,47,-9,33
Perth Glory,5853,8,10,2,15,37,50,-13,32
Wellington P,5853,9,5,6,16,31,55,-24,21
CC Mariners,5853,10,4,8,15,28,49,-21,20
Sydney FC,5854,1,21,4,3,66,23,43,67
N'castle Jet,5854,2,15,6,7,57,37,20,51
Melbourne C,5854,3,14,5,10,43,33,10,47
Melbourne V,5854,4,13,5,11,46,40,6,44
Adelaide Utd,5854,5,11,6,11,37,40,-3,39
Brisbane,5854,6,10,5,13,33,42,-9,35
Western Sydn,5854,7,8,9,10,38,47,-9,33
Perth Glory,5854,8,10,2,15,37,50,-13,32
Wellington P,5854,9,5,6,16,31,55,-24,21
CC Mariners,5854,10,4,8,15,28,49,-21,20
Sydney FC,5855,1,21,4,3,67,22,45,67
N'castle Jet,5855,2,16,5,7,60,37,23,53
Melbourne C,5855,3,14,4,11,43,36,7,46
Melbourne V,5855,4,13,5,11,45,41,4,44
Adelaide Utd,5855,5,11,6,11,37,40,-3,39
Brisbane,5855,6,10,5,13,33,42,-9,35
Western Sydn,5855,7,8,9,10,38,47,-9,33
Perth Glory,5855,8,10,2,15,37,50,-13,32
Wellington P,5855,9,5,6,16,31,55,-24,21
CC Mariners,5855,10,4,8,15,28,49,-21,20
Sydney FC,5856,1,20,4,4,64,26,38,64
N'castle Jet,5856,2,15,6,7,57,37,20,51
Melbourne V,5856,3,14,5,10,49,38,11,47
Melbourne C,5856,4,14,5,10,43,33,10,47
Adelaide Utd,5856,5,11,6,11,37,40,-3,39
Brisbane,5856,6,10,5,13,33,42,-9,35
Western Sydn,5856,7,8,9,10,38,47,-9,33
Perth Glory,5856,8,10,2,15,37,50,-13,32
Wellington P,5856,9,5,6,16,31,55,-24,21
CC Mariners,5856,10,4,8,15,28,49,-21,20
Sydney FC,5857,1,21,4,3,68,22,46,67
N'castle Jet,5857,2,16,5,7,61,38,23,53
Melbourne C,5857,3,14,4,11,44,37,7,46
Melbourne V,5857,4,13,5,11,45,42,3,44
Adelaide Utd,5857,5,11,6,11,37,40,-3,39
Brisbane,5857,6,10,5,13,33,42,-9,35
Western Sydn,5857,7,8,9,10,38,47,-9,33
Perth Glory,5857,8,10,2,15,37,50,-13,32
Wellington P,5857,9,5,6,16,31,55,-24,21
CC Mariners,5857,10,4,8,15,28,49,-21,20
Sydney FC,5858,1,21,4,3,66,23,43,67
N'castle Jet,5858,2,16,5,7,60,39,21,53
Melbourne C,5858,3,14,4,11,45,36,9,46
Melbourne V,5858,4,13,5,11,46,40,6,44
Adelaide Utd,5858,5,11,6,11,37,40,-3,39
Brisbane,5858,6,10,5,13,33,42,-9,35
Western Sydn,5858,7,8,9,10,38,47,-9,33
Perth Glory,5858,8,10,2,15,37,50,-13,32
Wellington P,5858,9,5,6,16,31,55,-24,21
CC Mariners,5858,10,4,8,15,28,49,-21,20
Sydney FC,5859,1,21,4,3,65,22,43,67
N'castle Jet,5859,2,16,5,7,62,38,24,53
Melbourne C,5859,3,14,4,11,44,38,6,46
Melbourne V,5859,4,13,5,11,45,39,6,44
Adelaide Utd,5859,5,11,6,11,37,40,-3,39
Brisbane,5859,6,10,5,13,33,42,-9,35
Western Sydn,5859,7,8,9,10,38,47,-9,33
Perth Glory,5859,8,10,2,15,37,50,-13,32
Wellington P,5859,9,5,6,16,31,55,-24,21
CC Mariners,5859,10,4,8,15,28,49,-21,20
Sydney FC,5860,1,21,4,3,68,24,44,67
N'castle Jet,5860,2,15,6,7,58,38,20,51
Melbourne C,5860,3,14,5,10,44,34,10,47
Melbourne V,5860,4,13,5,11,47,42,5,44
Adelaide Utd,5860,5,11,6,11,37,40,-3,39
Brisbane,5860,6,10,5,13,33,42,-9,35
Western Sydn,5860,7,8,9,10,38,47,-9,33
Perth Glory,5860,8,10,2,15,37,50,-13,32
Wellington P,5860,9,5,6,16,31,55,-24,21
CC Mariners,5860,10,4,8,15,28,49,-21,20
Sydney FC,5861,1,20,5,3,64,22,42,65
N'castle Jet,5861,2,16,5,7,59,38,21,53
Melbourne C,5861,3,14,4,11,44,35,9,46
Melbourne V,5861,4,13,6,10,45,38,7,45
Adelaide Utd,5861,5,11,6,11,37,40,-3,39
Brisbane,5861,6,10,5,13,33,42,-9,35
Western Sydn,5861,7,8,9,10,38,47,-9,33
Perth Glory,5861,8,10,2,15,37,50,-13,32
Wellington P,5861,9,5,6,16,31,55,-24,21
CC Mariners,5861,10,4,8,15,28,49,-21,20
Sydney FC,5862,1,21,4,3,69,23,46,67
N'castle Jet,5862,2,16,5,7,59,38,21,53
Melbourne C,5862,3,14,4,11,44,35,9,46
Melbourne V,5862,4,13,5,11,46,43,3,44
Adelaide Utd,5862,5,11,6,11,37,40,-3,39
Brisbane,5862,6,10,5,13,33,42,-9,35
Western Sydn,5862,7,8,9,10,38,47,-9,33
Perth Glory,5862,8,10,2,15,37,50,-13,32
Wellington P,5862,9,5,6,16,31,55,-24,21
CC Mariners,5862,10,4,8,15,28,49,-21,20
Sydney FC,5863,1,21,4,3,66,22,44,67
N'castle Jet,5863,2,15,5,8,58,40,18,50
Melbourne C,5863,3,15,4,10,46,34,12,49
Melbourne V,5863,4,13,5,11,45,40,5,44
Adelaide Utd,5863,5,11,6,11,37,40,-3,39
Brisbane,5863,6,10,5,13,33,42,-9,35
Western Sydn,5863,7,8,9,10,38,47,-9,33
Perth Glory,5863,8,10,2,15,37,50,-13,32
Wellington P,5863,9,5,6,16,31,55,-24,21
CC Mariners,5863,10,4,8,15,28,49,-21,20
Sydney FC,5864,1,20,5,3,65,23,42,65
N'castle Jet,5864,2,15,5,8,57,40,17,50
Melbourne C,5864,3,15,4,10,46,33,13,49
Melbourne V,5864,4,13,6,10,46,39,7,45
Adelaide Utd,5864,5,11,6,11,37,40,-3,39
Brisbane,5864,6,10,5,13,33,42,-9,35
Western Sydn,5864,7,8,9,10,38,47,-9,33
Perth Glory,5864,8,10,2,15,37,50,-13,32
Wellington P,5864,9,5,6,16,31,55,-24,21
CC Mariners,5864,10,4,8,15,28,49,-21,20
Sydney FC,5865,1,20,4,4,64,23,41,64
N'castle Jet,5865,2,16,5,7,61,37,24,53
Melbourne V,5865,3,14,5,10,46,38,8,47
Melbourne C,5865,4,14,4,11,43,37,6,46
Adelaide Utd,5865,5,11,6,11,37,40,-3,39
Brisbane,5865,6,10,5,13,33,42,-9,35
Western Sydn,5865,7,8,9,10,38,47,-9,33
Perth Glory,5865,8,10,2,15,37,50,-13,32
Wellington P,5865,9,5,6,16,31,55,-24,21
CC Mariners,5865,10,4,8,15,28,49,-21,20
Sydney FC,5866,1,20,4,4,64,24,40,64
N'castle Jet,5866,2,15,6,7,58,38,20,51
Melbourne C,5866,3,14,5,10,44,34,10,47
Melbourne V,5866,4,14,5,10,47,38,9,47
Adelaide Utd,5866,5,11,6,11,37,40,-3,39
Brisbane,5866,6,10,5,13,33,42,-9,35
Western Sydn,5866,7,8,9,10,38,47,-9,33
Perth Glory,5866,8,10,2,15,37,50,-13,32
Wellington P,5866,9,5,6,16,31,55,-24,21
CC Mariners,5866,10,4,8,15,28,49,-21,20
Sydney FC,5867,1,21,4,3,65,22,43,67
N'castle Jet,5867,2,16,5,7,59,38,21,53
Melbourne C,5867,3,14,4,11,44,35,9,46
Melbourne V,5867,4,13,5,11,45,39,6,44
Adelaide Utd,5867,5,11,6,11,37,40,-3,39
Brisbane,5867,6,10,5,13,33,42,-9,35
Western Sydn,5867,7,8,9,10,38,47,-9,33
Perth Glory,5867,8,10,2,15,37,50,-13,32
Wellington P,5867,9,5,6,16,31,55,-24,21
CC Mariners,5867,10,4,8,15,28,49,-21,20
Sydney FC,5868,1,21,4,3,65,22,43,67
N'castle Jet,5868,2,15,6,7,59,39,20,51
Melbourne C,5868,3,14,5,10,45,35,10,47
Melbourne V,5868,4,13,5,11,45,39,6,44
Adelaide Utd,5868,5,11,6,11,37,40,-3,39
Brisbane,5868,6,10,5,13,33,42,-9,35
Western Sydn,5868,7,8,9,10,38,47,-9,33
Perth Glory,5868,8,10,2,15,37,50,-13,32
Wellington P,5868,9,5,6,16,31,55,-24,21
CC Mariners,5868,10,4,8,15,28,49,-21,20
Sydney FC,5869,1,21,4,3,66,22,44,67
N'castle Jet,5869,2,16,5,7,60,38,22,53
Melbourne C,5869,3,14,4,11,44,36,8,46
Melbourne V,5869,4,13,5,11,45,40,5,44
Adelaide Utd,5869,5,11,6,11,37,40,-3,39
Brisbane,5869,6,10,5,13,33,42,-9,35
Western Sydn,5869,7,8,9,10,38,47,-9,33
Perth Glory,5869,8,10,2,15,37,50,-13,32
Wellington P,5869,9,5,6,16,31,55,-24,21
CC Mariners,5869,10,4,8,15,28,49,-21,20
Sydney FC,5870,1,21,4,3,66,23,43,67
N'castle Jet,5870,2,15,5,8,58,39,19,50
Melbourne C,5870,3,15,4,10,45,34,11,49
Melbourne V,5870,4,13,5,11,46,40,6,44
Adelaide Utd,5870,5,11,6,11,37,40,-3,39
Brisbane,5870,6,10,5,13,33,42,-9,35
Western Sydn,5870,7,8,9,10,38,47,-9,33
Perth Glory,5870,8,10,2,15,37,50,-13,32
Wellington P,5870,9,5,6,16,31,55,-24,21
CC Mariners,5870,10,4,8,15,28,49,-21,20
Sydney FC,5871,1,21,4,3,69,22,47,67
N'castle Jet,5871,2,15,6,7,60,40,20,51
Melbourne C,5871,3,14,5,10,46,36,10,47
Melbourne V,5871,4,13,5,11,45,43,2,44
Adelaide Utd,5871,5,11,6,11,37,40,-3,39
Brisbane,5871,6,10,5,13,33,42,-9,35
Western Sydn,5871,7,8,9,10,38,47,-9,33
Perth Glory,5871,8,10,2,15,37,50,-13,32
Wellington P,5871,9,5,6,16,31,55,-24,21
CC Mariners,5871,10,4,8,15,28,49,-21,20
Sydney FC,5872,1,21,4,3,69,22,47,67
N'castle Jet,5872,2,15,6,7,60,40,20,51
Melbourne C,5872,3,14,5,10,46,36,10,47
Melbourne V,5872,4,13,5,11,45,43,2,44
Adelaide Utd,5872,5,11,6,11,37,40,-3,39
Brisbane,5872,6,10,5,13,33,42,-9,35
Western Sydn,5872,7,8,9,10,38,47,-9,33
Perth Glory,5872,8,10,2,15,37,50,-13,32
Wellington P,5872,9,5,6,16,31,55,-24,21
CC Mariners,5872,10,4,8,15,28,49,-21,20
Sydney FC,5873,1,21,4,3,66,22,44,67
N'castle Jet,5873,2,15,6,7,59,39,20,51
Melbourne C,5873,3,14,5,10,45,35,10,47
Melbourne V,5873,4,13,5,11,45,40,5,44
Adelaide Utd,5873,5,11,6,11,37,40,-3,39
Brisbane,5873,6,10,5,13,33,42,-9,35
Western Sydn,5873,7,8,9,10,38,47,-9,33
Perth Glory,5873,8,10,2,15,37,50,-13,32
Wellington P,5873,9,5,6,16,31,55,-24,21
CC Mariners,5873,10,4,8,15,28,49,-21,20
Sydney FC,5874,1,21,4,3,66,23,43,67
N'castle Jet,5874,2,16,5,7,61,37,24,53
Melbourne C,5874,3,14,4,11,43,37,6,46
Melbourne V,5874,4,13,5,11,46,40,6,44
Adelaide Utd,5874,5,11,6,11,37,40,-3,39
Brisbane,5874,6,10,5,13,33,42,-9,35
Western Sydn,5874,7,8,9,10,38,47,-9,33
Perth Glory,5874,8,10,2,15,37,50,-13,32
Wellington P,5874,9,5,6,16,31,55,-24,21
CC Mariners,5874,10,4,8,15,28,49,-21,20
Sydney FC,5875,1,20,5,3,64,22,42,65
N'castle Jet,5875,2,15,6,7,59,39,20,51
Melbourne C,5875,3,14,5,10,45,35,10,47
Melbourne V,5875,4,13,6,10,45,38,7,45
Adelaide Utd,5875,5,11,6,11,37,40,-3,39
Brisbane,5875,6,10,5,13,33,42,-9,35
Western Sydn,5875,7,8,9,10,38,47,-9,33
Perth Glory,5875,8,10,2,15,37,50,-13,32
Wellington P,5875,9,5,6,16,31,55,-24,21
CC Mariners,5875,10,4,8,15,28,49,-21,20
Sydney FC,5876,1,21,4,3,66,22,44,67
N'castle Jet,5876,2,15,6,7,58,38,20,51
Melbourne C,5876,3,14,5,10,44,34,10,47
Melbourne V,5876,4,13,5,11,45,40,5,44
Adelaide Utd,5876,5,11,6,11,37,40,-3,39
Brisbane,5876,6,10,5,13,33,42,-9,35
Western Sydn,5876,7,8,9,10,38,47,-9,33
Perth Glory,5876,8,10,2,15,37,50,-13,32
Wellington P,5876,9,5,6,16,31,55,-24,21
CC Mariners,5876,10,4,8,15,28,49,-21,20
Sydney FC,5877,1,20,4,4,65,24,41,64
N'castle Jet,5877,2,15,5,8,58,39,19,50
Melbourne C,5877,3,15,4,10,45,34,11,49
Melbourne V,5877,4,14,5,10,47,39,8,47
Adelaide Utd,5877,5,11,6,11,37,40,-3,39
Brisbane,5877,6,10,5,13,33,42,-9,35
Western Sydn,5877,7,8,9,10,38,47,-9,33
Perth Glory,5877,8,10,2,15,37,50,-13,32
Wellington P,5877,9,5,6,16,31,55,-24,21
CC Mariners,5877,10,4,8,15,28,49,-21,20
Sydney FC,5878,1,20,4,4,66,26,40,64
N'castle Jet,5878,2,16,5,7,63,40,23,53
Melbourne V,5878,3,14,5,10,49,40,9,47
Melbourne C,5878,4,14,4,11,46,39,7,46
Adelaide Utd,5878,5,11,6,11,37,40,-3,39
Brisbane,5878,6,10,5,13,33,42,-9,35
Western Sydn,5878,7,8,9,10,38,47,-9,33
Perth Glory,5878,8,10,2,15,37,50,-13,32
Wellington P,5878,9,5,6,16,31,55,-24,21
CC Mariners,5878,10,4,8,15,28,49,-21,20
Sydney FC,5879,1,20,5,3,64,22,42,65
N'castle Jet,5879,2,15,6,7,58,38,20,51
Melbourne C,5879,3,14,5,10,44,34,10,47
Melbourne V,5879,4,13,6,10,45,38,7,45
Adelaide Utd,5879,5,11,6,11,37,40,-3,39
Brisbane,5879,6,10,5,13,33,42,-9,35
Western Sydn,5879,7,8,9,10,38,47,-9,33
Perth Glory,5879,8,10,2,15,37,50,-13,32
Wellington P,5879,9,5,6,16,31,55,-24,21
CC Mariners,5879,10,4,8,15,28,49,-21,20
Sydney FC,5880,1,20,4,4,64,24,40,64
N'castle Jet,5880,2,15,6,7,59,39,20,51
Melbourne C,5880,3,14,5,10,45,35,10,47
Melbourne V,5880,4,14,5,10,47,38,9,47
Adelaide Utd,5880,5,11,6,11,37,40,-3,39
Brisbane,5880,6,10,5,13,33,42,-9,35
Western Sydn,5880,7,8,9,10,38,47,-9,33
Perth Glory,5880,8,10,2,15,37,50,-13,32
Wellington P,5880,9,5,6,16,31,55,-24,21
CC Mariners,5880,10,4,8,15,28,49,-21,20
Sydney FC,5881,1,20,5,3,65,23,42,65
N'castle Jet,5881,2,15,6,7,57,37,20,51
Melbourne C,5881,3,14,5,10,43,33,10,47
Melbourne V,5881,4,13,6,10,46,39,7,45
Adelaide Utd,5881,5,11,6,11,37,40,-3,39
Brisbane,5881,6,10,5,13,33,42,-9,35
Western Sydn,5881,7,8,9,10,38,47,-9,33
Perth Glory,5881,8,10,2,15,37,50,-13,32
Wellington P,5881,9,5,6,16,31,55,-24,21
CC Mariners,5881,10,4,8,15,28,49,-21,20
Sydney FC,5882,1,20,5,3,65,23,42,65
N'castle Jet,5882,2,15,5,8,58,41,17,50
Melbourne C,5882,3,15,4,10,47,34,13,49
Melbourne V,5882,4,13,6,10,46,39,7,45
Adelaide Utd,5882,5,11,6,11,37,40,-3,39
Brisbane,5882,6,10,5,13,33,42,-9,35
Western Sydn,5882,7,8,9,10,38,47,-9,33
Perth Glory,5882,8,10,2,15,37,50,-13,32
Wellington P,5882,9,5,6,16,31,55,-24,21
CC Mariners,5882,10,4,8,15,28,49,-21,20
Sydney FC,5883,1,21,4,3,65,22,43,67
N'castle Jet,5883,2,16,5,7,60,37,23,53
Melbourne C,5883,3,14,4,11,43,36,7,46
Melbourne V,5883,4,13,5,11,45,39,6,44
Adelaide Utd,5883,5,11,6,11,37,40,-3,39
Brisbane,5883,6,10,5,13,33,42,-9,35
Western Sydn,5883,7,8,9,10,38,47,-9,33
Perth Glory,5883,8,10,2,15,37,50,-13,32
Wellington P,5883,9,5,6,16,31,55,-24,21
CC Mariners,5883,10,4,8,15,28,49,-21,20
Sydney FC,5884,1,20,5,3,65,23,42,65
N'castle Jet,5884,2,16,5,7,58,37,21,53
Melbourne C,5884,3,14,4,11,43,34,9,46
Melbourne V,5884,4,13,6,10,46,39,7,45
Adelaide Utd,5884,5,11,6,11,37,40,-3,39
Brisbane,5884,6,10,5,13,33,42,-9,35
Western Sydn,5884,7,8,9,10,38,47,-9,33
Perth Glory,5884,8,10,2,15,37,50,-13,32
Wellington P,5884,9,5,6,16,31,55,-24,21
CC Mariners,5884,10,4,8,15,28,49,-21,20
Sydney FC,5885,1,21,4,3,66,22,44,67
N'castle Jet,5885,2,16,5,7,61,39,22,53
Melbourne C,5885,3,14,4,11,45,37,8,46
Melbourne V,5885,4,13,5,11,45,40,5,44
Adelaide Utd,5885,5,11,6,11,37,40,-3,39
Brisbane,5885,6,10,5,13,33,42,-9,35
Western Sydn,5885,7,8,9,10,38,47,-9,33
Perth Glory,5885,8,10,2,15,37,50,-13,32
Wellington P,5885,9,5,6,16,31,55,-24,21
CC Mariners,5885,10,4,8,15,28,49,-21,20
Sydney FC,5886,1,20,4,4,65,25,40,64
N'castle Jet,5886,2,15,6,7,58,38,20,51
Melbourne C,5886,3,14,5,10,44,34,10,47
Melbourne V,5886,4,14,5,10,48,39,9,47
Adelaide Utd,5886,5,11,6,11,37,40,-3,39
Brisbane,5886,6,10,5,13,33,42,-9,35
Western Sydn,5886,7,8,9,10,38,47,-9,33
Perth Glory,5886,8,10,2,15,37,50,-13,32
Wellington P,5886,9,5,6,16,31,55,-24,21
CC Mariners,5886,10,4,8,15,28,49,-21,20
Sydney FC,5887,1,21,4,3,66,22,44,67
N'castle Jet,5887,2,15,5,8,57,40,17,50
Melbourne C,5887,3,15,4,10,46,33,13,49
Melbourne V,5887,4,13,5,11,45,40,5,44
Adelaide Utd,5887,5,11,6,11,37,40,-3,39
Brisbane,5887,6,10,5,13,33,42,-9,35
Western Sydn,5887,7,8,9,10,38,47,-9,33
Perth Glory,5887,8,10,2,15,37,50,-13,32
Wellington P,5887,9,5,6,16,31,55,-24,21
CC Mariners,5887,10,4,8,15,28,49,-21,20
Sydney FC,5888,1,21,4,3,70,22,48,67
N'castle Jet,5888,2,15,5,8,58,39,19,50
Melbourne C,5888,3,15,4,10,45,34,11,49
Melbourne V,5888,4,13,5,11,45,44,1,44
Adelaide Utd,5888,5,11,6,11,37,40,-3,39
Brisbane,5888,6,10,5,13,33,42,-9,35
Western Sydn,5888,7,8,9,10,38,47,-9,33
Perth Glory,5888,8,10,2,15,37,50,-13,32
Wellington P,5888,9,5,6,16,31,55,-24,21
CC Mariners,5888,10,4,8,15,28,49,-21,20
Sydney FC,5889,1,20,5,3,66,24,42,65
N'castle Jet,5889,2,15,6,7,58,38,20,51
Melbourne C,5889,3,14,5,10,44,34,10,47
Melbourne V,5889,4,13,6,10,47,40,7,45
Adelaide Utd,5889,5,11,6,11,37,40,-3,39
Brisbane,5889,6,10,5,13,33,42,-9,35
Western Sydn,5889,7,8,9,10,38,47,-9,33
Perth Glory,5889,8,10,2,15,37,50,-13,32
Wellington P,5889,9,5,6,16,31,55,-24,21
CC Mariners,5889,10,4,8,15,28,49,-21,20
Sydney FC,5890,1,21,4,3,66,22,44,67
N'castle Jet,5890,2,15,5,8,58,39,19,50
Melbourne C,5890,3,15,4,10,45,34,11,49
Melbourne V,5890,4,13,5,11,45,40,5,44
Adelaide Utd,5890,5,11,6,11,37,40,-3,39
Brisbane,5890,6,10,5,13,33,42,-9,35
Western Sydn,5890,7,8,9,10,38,47,-9,33
Perth Glory,5890,8,10,2,15,37,50,-13,32
Wellington P,5890,9,5,6,16,31,55,-24,21
CC Mariners,5890,10,4,8,15,28,49,-21,20
Sydney FC,5891,1,20,5,3,65,23,42,65
N'castle Jet,5891,2,15,5,8,57,39,18,50
Melbourne C,5891,3,15,4,10,45,33,12,49
Melbourne V,5891,4,13,6,10,46,39,7,45
Adelaide Utd,5891,5,11,6,11,37,40,-3,39
Brisbane,5891,6,10,5,13,33,42,-9,35
Western Sydn,5891,7,8,9,10,38,47,-9,33
Perth Glory,5891,8,10,2,15,37,50,-13,32
Wellington P,5891,9,5,6,16,31,55,-24,21
CC Mariners,5891,10,4,8,15,28,49,-21,20
Sydney FC,5892,1,21,4,3,67,24,43,67
N'castle Jet,5892,2,15,5,8,57,38,19,50
Melbourne C,5892,3,15,4,10,44,33,11,49
Melbourne V,5892,4,13,5,11,47,41,6,44
Adelaide Utd,5892,5,11,6,11,37,40,-3,39
Brisbane,5892,6,10,5,13,33,42,-9,35
Western Sydn,5892,7,8,9,10,38,47,-9,33
Perth Glory,5892,8,10,2,15,37,50,-13,32
Wellington P,5892,9,5,6,16,31,55,-24,21
CC Mariners,5892,10,4,8,15,28,49,-21,20
Sydney FC,5893,1,21,4,3,66,23,43,67
N'castle Jet,5893,2,15,6,7,58,38,20,51
Melbourne C,5893,3,14,5,10,44,34,10,47
Melbourne V,5893,4,13,5,11,46,40,6,44
Adelaide Utd,5893,5,11,6,11,37,40,-3,39
Brisbane,5893,6,10,5,13,33,42,-9,35
Western Sydn,5893,7,8,9,10,38,47,-9,33
Perth Glory,5893,8,10,2,15,37,50,-13,32
Wellington P,5893,9,5,6,16,31,55,-24,21
CC Mariners,5893,10,4,8,15,28,49,-21,20
Sydney FC,5894,1,21,4,3,67,24,43,67
N'castle Jet,5894,2,16,5,7,58,37,21,53
Melbourne C,5894,3,14,4,11,43,34,9,46
Melbourne V,5894,4,13,5,11,47,41,6,44
Adelaide Utd,5894,5,11,6,11,37,40,-3,39
Brisbane,5894,6,10,5,13,33,42,-9,35
Western Sydn,5894,7,8,9,10,38,47,-9,33
Perth Glory,5894,8,10,2,15,37,50,-13,32
Wellington P,5894,9,5,6,16,31,55,-24,21
CC Mariners,5894,10,4,8,15,28,49,-21,20
Sydney FC,5895,1,20,5,3,65,23,42,65
N'castle Jet,5895,2,15,5,8,60,41,19,50
Melbourne C,5895,3,15,4,10,47,36,11,49
Melbourne V,5895,4,13,6,10,46,39,7,45
Adelaide Utd,5895,5,11,6,11,37,40,-3,39
Brisbane,5895,6,10,5,13,33,42,-9,35
Western Sydn,5895,7,8,9,10,38,47,-9,33
Perth Glory,5895,8,10,2,15,37,50,-13,32
Wellington P,5895,9,5,6,16,31,55,-24,21
CC Mariners,5895,10,4,8,15,28,49,-21,20
Sydney FC,5896,1,21,4,3,68,24,44,67
N'castle Jet,5896,2,16,5,7,59,38,21,53
Melbourne C,5896,3,14,4,11,44,35,9,46
Melbourne V,5896,4,13,5,11,47,42,5,44
Adelaide Utd,5896,5,11,6,11,37,40,-3,39
Brisbane,5896,6,10,5,13,33,42,-9,35
Western Sydn,5896,7,8,9,10,38,47,-9,33
Perth Glory,5896,8,10,2,15,37,50,-13,32
Wellington P,5896,9,5,6,16,31,55,-24,21
CC Mariners,5896,10,4,8,15,28,49,-21,20
Sydney FC,5897,1,21,4,3,66,23,43,67
N'castle Jet,5897,2,16,5,7,60,38,22,53
Melbourne C,5897,3,14,4,11,44,36,8,46
Melbourne V,5897,4,13,5,11,46,40,6,44
Adelaide Utd,5897,5,11,6,11,37,40,-3,39
Brisbane,5897,6,10,5,13,33,42,-9,35
Western Sydn,5897,7,8,9,10,38,47,-9,33
Perth Glory,5897,8,10,2,15,37,50,-13,32
Wellington P,5897,9,5,6,16,31,55,-24,21
CC Mariners,5897,10,4,8,15,28,49,-21,20
Sydney FC,5898,1,21,4,3,68,22,46,67
N'castle Jet,5898,2,16,5,7,59,37,22,53
Melbourne C,5898,3,14,4,11,43,35,8,46
Melbourne V,5898,4,13,5,11,45,42,3,44
Adelaide Utd,5898,5,11,6,11,37,40,-3,39
Brisbane,5898,6,10,5,13,33,42,-9,35
Western Sydn,5898,7,8,9,10,38,47,-9,33
Perth Glory,5898,8,10,2,15,37,50,-13,32
Wellington P,5898,9,5,6,16,31,55,-24,21
CC Mariners,5898,10,4,8,15,28,49,-21,20
Sydney FC,5899,1,20,5,3,65,23,42,65
N'castle Jet,5899,2,15,6,7,58,38,20,51
Melbourne C,5899,3,14,5,10,44,34,10,47
Melbourne V,5899,4,13,6,10,46,39,7,45
Adelaide Utd,5899,5,11,6,11,37,40,-3,39
Brisbane,5899,6,10,5,13,33,42,-9,35
Western Sydn,5899,7,8,9,10,38,47,-9,33
Perth Glory,5899,8,10,2,15,37,50,-13,32
Wellington P,5899,9,5,6,16,31,55,-24,21
CC Mariners,5899,10,4,8,15,28,49,-21,20
Sydney FC,5900,1,21,4,3,68,24,44,67
N'castle Jet,5900,2,15,5,8,57,38,19,50
Melbourne C,5900,3,15,4,10,44,33,11,49
Melbourne V,5900,4,13,5,11,47,42,5,44
Adelaide Utd,5900,5,11,6,11,37,40,-3,39
Brisbane,5900,6,10,5,13,33,42,-9,35
Western Sydn,5900,7,8,9,10,38,47,-9,33
Perth Glory,5900,8,10,2,15,37,50,-13,32
Wellington P,5900,9,5,6,16,31,55,-24,21
CC Mariners,5900,10,4,8,15,28,49,-21,20
Sydney FC,5901,1,21,4,3,68,23,45,67
N'castle Jet,5901,2,16,5,7,60,37,23,53
Melbourne C,5901,3,14,4,11,43,36,7,46
Melbourne V,5901,4,13,5,11,46,42,4,44
Adelaide Utd,5901,5,11,6,11,37,40,-3,39
Brisbane,5901,6,10,5,13,33,42,-9,35
Western Sydn,5901,7,8,9,10,38,47,-9,33
Perth Glory,5901,8,10,2,15,37,50,-13,32
Wellington P,5901,9,5,6,16,31,55,-24,21
CC Mariners,5901,10,4,8,15,28,49,-21,20
Sydney FC,5902,1,21,4,3,66,22,44,67
N'castle Jet,5902,2,16,5,7,59,38,21,53
Melbourne C,5902,3,14,4,11,44,35,9,46
Melbourne V,5902,4,13,5,11,45,40,5,44
Adelaide Utd,5902,5,11,6,11,37,40,-3,39
Brisbane,5902,6,10,5,13,33,42,-9,35
Western Sydn,5902,7,8,9,10,38,47,-9,33
Perth Glory,5902,8,10,2,15,37,50,-13,32
Wellington P,5902,9,5,6,16,31,55,-24,21
CC Mariners,5902,10,4,8,15,28,49,-21,20
Sydney FC,5903,1,20,4,4,64,23,41,64
N'castle Jet,5903,2,16,5,7,60,38,22,53
Melbourne V,5903,3,14,5,10,46,38,8,47
Melbourne C,5903,4,14,4,11,44,36,8,46
Adelaide Utd,5903,5,11,6,11,37,40,-3,39
Brisbane,5903,6,10,5,13,33,42,-9,35
Western Sydn,5903,7,8,9,10,38,47,-9,33
Perth Glory,5903,8,10,2,15,37,50,-13,32
Wellington P,5903,9,5,6,16,31,55,-24,21
CC Mariners,5903,10,4,8,15,28,49,-21,20
Sydney FC,5904,1,20,5,3,65,23,42,65
N'castle Jet,5904,2,16,5,7,60,37,23,53
Melbourne C,5904,3,14,4,11,43,36,7,46
Melbourne V,5904,4,13,6,10,46,39,7,45
Adelaide Utd,5904,5,11,6,11,37,40,-3,39
Brisbane,5904,6,10,5,13,33,42,-9,35
Western Sydn,5904,7,8,9,10,38,47,-9,33
Perth Glory,5904,8,10,2,15,37,50,-13,32
Wellington P,5904,9,5,6,16,31,55,-24,21
CC Mariners,5904,10,4,8,15,28,49,-21,20
Sydney FC,5905,1,21,4,3,67,22,45,67
N'castle Jet,5905,2,15,6,7,58,38,20,51
Melbourne C,5905,3,14,5,10,44,34,10,47
Melbourne V,5905,4,13,5,11,45,41,4,44
Adelaide Utd,5905,5,11,6,11,37,40,-3,39
Brisbane,5905,6,10,5,13,33,42,-9,35
Western Sydn,5905,7,8,9,10,38,47,-9,33
Perth Glory,5905,8,10,2,15,37,50,-13,32
Wellington P,5905,9,5,6,16,31,55,-24,21
CC Mariners,5905,10,4,8,15,28,49,-21,20
Sydney FC,5906,1,21,4,3,66,22,44,67
N'castle Jet,5906,2,15,6,7,57,37,20,51
Melbourne C,5906,3,14,5,10,43,33,10,47
Melbourne V,5906,4,13,5,11,45,40,5,44
Adelaide Utd,5906,5,11,6,11,37,40,-3,39
Brisbane,5906,6,10,5,13,33,42,-9,35
Western Sydn,5906,7,8,9,10,38,47,-9,33
Perth Glory,5906,8,10,2,15,37,50,-13,32
Wellington P,5906,9,5,6,16,31,55,-24,21
CC Mariners,5906,10,4,8,15,28,49,-21,20
Sydney FC,5907,1,21,4,3,68,24,44,67
N'castle Jet,5907,2,15,5,8,58,41,17,50
Melbourne C,5907,3,15,4,10,47,34,13,49
Melbourne V,5907,4,13,5,11,47,42,5,44
Adelaide Utd,5907,5,11,6,11,37,40,-3,39
Brisbane,5907,6,10,5,13,33,42,-9,35
Western Sydn,5907,7,8,9,10,38,47,-9,33
Perth Glory,5907,8,10,2,15,37,50,-13,32
Wellington P,5907,9,5,6,16,31,55,-24,21
CC Mariners,5907,10,4,8,15,28,49,-21,20
Sydney FC,5908,1,20,5,3,66,24,42,65
N'castle Jet,5908,2,16,5,7,59,38,21,53
Melbourne C,5908,3,14,4,11,44,35,9,46
Melbourne V,5908,4,13,6,10,47,40,7,45
Adelaide Utd,5908,5,11,6,11,37,40,-3,39
Brisbane,5908,6,10,5,13,33,42,-9,35
Western Sydn,5908,7,8,9,10,38,47,-9,33
Perth Glory,5908,8,10,2,15,37,50,-13,32
Wellington P,5908,9,5,6,16,31,55,-24,21
CC Mariners,5908,10,4,8,15,28,49,-21,20
Sydney FC,5909,1,21,4,3,65,22,43,67
N'castle Jet,5909,2,16,5,7,61,39,22,53
Melbourne C,5909,3,14,4,11,45,37,8,46
Melbourne V,5909,4,13,5,11,45,39,6,44
Adelaide Utd,5909,5,11,6,11,37,40,-3,39
Brisbane,5909,6,10,5,13,33,42,-9,35
Western Sydn,5909,7,8,9,10,38,47,-9,33
Perth Glory,5909,8,10,2,15,37,50,-13,32
Wellington P,5909,9,5,6,16,31,55,-24,21
CC Mariners,5909,10,4,8,15,28,49,-21,20
Sydney FC,5910,1,21,4,3,68,22,46,67
N'castle Jet,5910,2,15,5,8,59,40,19,50
Melbourne C,5910,3,15,4,10,46,35,11,49
Melbourne V,5910,4,13,5,11,45,42,3,44
Adelaide Utd,5910,5,11,6,11,37,40,-3,39
Brisbane,5910,6,10,5,13,33,42,-9,35
Western Sydn,5910,7,8,9,10,38,47,-9,33
Perth Glory,5910,8,10,2,15,37,50,-13,32
Wellington P,5910,9,5,6,16,31,55,-24,21
CC Mariners,5910,10,4,8,15,28,49,-21,20
Sydney FC,5911,1,21,4,3,67,24,43,67
N'castle Jet,5911,2,15,6,7,59,39,20,51
Melbourne C,5911,3,14,5,10,45,35,10,47
Melbourne V,5911,4,13,5,11,47,41,6,44
Adelaide Utd,5911,5,11,6,11,37,40,-3,39
Brisbane,5911,6,10,5,13,33,42,-9,35
Western Sydn,5911,7,8,9,10,38,47,-9,33
Perth Glory,5911,8,10,2,15,37,50,-13,32
Wellington P,5911,9,5,6,16,31,55,-24,21
CC Mariners,5911,10,4,8,15,28,49,-21,20
Sydney FC,5912,1,21,4,3,65,22,43,67
N'castle Jet,5912,2,16,5,7,60,39,21,53
Melbourne C,5912,3,14,4,11,45,36,9,46
Melbourne V,5912,4,13,5,11,45,39,6,44
Adelaide Utd,5912,5,11,6,11,37,40,-3,39
Brisbane,5912,6,10,5,13,33,42,-9,35
Western Sydn,5912,7,8,9,10,38,47,-9,33
Perth Glory,5912,8,10,2,15,37,50,-13,32
Wellington P,5912,9,5,6,16,31,55,-24,21
CC Mariners,5912,10,4,8,15,28,49,-21,20
Sydney FC,5913,1,21,4,3,65,22,43,67
N'castle Jet,5913,2,16,5,7,58,37,21,53
Melbourne C,5913,3,14,4,11,43,34,9,46
Melbourne V,5913,4,13,5,11,45,39,6,44
Adelaide Utd,5913,5,11,6,11,37,40,-3,39
Brisbane,5913,6,10,5,13,33,42,-9,35
Western Sydn,5913,7,8,9,10,38,47,-9,33
Perth Glory,5913,8,10,2,15,37,50,-13,32
Wellington P,5913,9,5,6,16,31,55,-24,21
CC Mariners,5913,10,4,8,15,28,49,-21,20
Sydney FC,5914,1,21,4,3,66,23,43,67
N'castle Jet,5914,2,16,5,7,58,37,21,53
Melbourne C,5914,3,14,4,11,43,34,9,46
Melbourne V,5914,4,13,5,11,46,40,6,44
Adelaide Utd,5914,5,11,6,11,37,40,-3,39
Brisbane,5914,6,10,5,13,33,42,-9,35
Western Sydn,5914,7,8,9,10,38,47,-9,33
Perth Glory,5914,8,10,2,15,37,50,-13,32
Wellington P,5914,9,5,6,16,31,55,-24,21
CC Mariners,5914,10,4,8,15,28,49,-21,20
Sydney FC,5915,1,20,5,3,66,24,42,65
N'castle Jet,5915,2,16,5,7,60,37,23,53
Melbourne C,5915,3,14,4,11,43,36,7,46
Melbourne V,5915,4,13,6,10,47,40,7,45
Adelaide Utd,5915,5,11,6,11,37,40,-3,39
Brisbane,5915,6,10,5,13,33,42,-9,35
Western Sydn,5915,7,8,9,10,38,47,-9,33
Perth Glory,5915,8,10,2,15,37,50,-13,32
Wellington P,5915,9,5,6,16,31,55,-24,21
CC Mariners,5915,10,4,8,15,28,49,-21,20
Sydney FC,5916,1,20,5,3,66,24,42,65
N'castle Jet,5916,2,16,5,7,61,39,22,53
Melbourne C,5916,3,14,4,11,45,37,8,46
Melbourne V,5916,4,13,6,10,47,40,7,45
Adelaide Utd,5916,5,11,6,11,37,40,-3,39
Brisbane,5916,6,10,5,13,33,42,-9,35
Western Sydn,5916,7,8,9,10,38,47,-9,33
Perth Glory,5916,8,10,2,15,37,50,-13,32
Wellington P,5916,9,5,6,16,31,55,-24,21
CC Mariners,5916,10,4,8,15,28,49,-21,20
Sydney FC,5917,1,21,4,3,68,22,46,67
N'castle Jet,5917,2,15,5,8,57,39,18,50
Melbourne C,5917,3,15,4,10,45,33,12,49
Melbourne V,5917,4,13,5,11,45,42,3,44
Adelaide Utd,5917,5,11,6,11,37,40,-3,39
Brisbane,5917,6,10,5,13,33,42,-9,35
Western Sydn,5917,7,8,9,10,38,47,-9,33
Perth Glory,5917,8,10,2,15,37,50,-13,32
Wellington P,5917,9,5,6,16,31,55,-24,21
CC Mariners,5917,10,4,8,15,28,49,-21,20
Sydney FC,5918,1,20,4,4,65,25,40,64
N'castle Jet,5918,2,15,5,8,59,40,19,50
Melbourne C,5918,3,15,4,10,46,35,11,49
Melbourne V,5918,4,14,5,10,48,39,9,47
Adelaide Utd,5918,5,11,6,11,37,40,-3,39
Brisbane,5918,6,10,5,13,33,42,-9,35
Western Sydn,5918,7,8,9,10,38,47,-9,33
Perth Glory,5918,8,10,2,15,37,50,-13,32
Wellington P,5918,9,5,6,16,31,55,-24,21
CC Mariners,5918,10,4,8,15,28,49,-21,20
Sydney FC,5919,1,20,5,3,66,24,42,65
N'castle Jet,5919,2,16,5,7,58,37,21,53
Melbourne C,5919,3,14,4,11,43,34,9,46
Melbourne V,5919,4,13,6,10,47,40,7,45
Adelaide Utd,5919,5,11,6,11,37,40,-3,39
Brisbane,5919,6,10,5,13,33,42,-9,35
Western Sydn,5919,7,8,9,10,38,47,-9,33
Perth Glory,5919,8,10,2,15,37,50,-13,32
Wellington P,5919,9,5,6,16,31,55,-24,21
CC Mariners,5919,10,4,8,15,28,49,-21,20
Sydney FC,5920,1,21,4,3,66,22,44,67
N'castle Jet,5920,2,16,5,7,58,37,21,53
Melbourne C,5920,3,14,4,11,43,34,9,46
Melbourne V,5920,4,13,5,11,45,40,5,44
Adelaide Utd,5920,5,11,6,11,37,40,-3,39
Brisbane,5920,6,10,5,13,33,42,-9,35
Western Sydn,5920,7,8,9,10,38,47,-9,33
Perth Glory,5920,8,10,2,15,37,50,-13,32
Wellington P,5920,9,5,6,16,31,55,-24,21
CC Mariners,5920,10,4,8,15,28,49,-21,20
Sydney FC,5921,1,20,4,4,64,25,39,64
N'castle Jet,5921,2,15,6,7,58,38,20,51
Melbourne V,5921,3,14,5,10,48,38,10,47
Melbourne C,5921,4,14,5,10,44,34,10,47
Adelaide Utd,5921,5,11,6,11,37,40,-3,39
Brisbane,5921,6,10,5,13,33,42,-9,35
Western Sydn,5921,7,8,9,10,38,47,-9,33
Perth Glory,5921,8,10,2,15,37,50,-13,32
Wellington P,5921,9,5,6,16,31,55,-24,21
CC Mariners,5921,10,4,8,15,28,49,-21,20
Sydney FC,5922,1,21,4,3,66,22,44,67
N'castle Jet,5922,2,16,5,7,60,38,22,53
Melbourne C,5922,3,14,4,11,44,36,8,46
Melbourne V,5922,4,13,5,11,45,40,5,44
Adelaide Utd,5922,5,11,6,11,37,40,-3,39
Brisbane,5922,6,10,5,13,33,42,-9,35
Western Sydn,5922,7,8,9,10,38,47,-9,33
Perth Glory,5922,8,10,2,15,37,50,-13,32
Wellington P,5922,9,5,6,16,31,55,-24,21
CC Mariners,5922,10,4,8,15,28,49,-21,20
Sydney FC,5923,1,20,4,4,64,25,39,64
N'castle Jet,5923,2,16,5,7,60,37,23,53
Melbourne V,5923,3,14,5,10,48,38,10,47
Melbourne C,5923,4,14,4,11,43,36,7,46
Adelaide Utd,5923,5,11,6,11,37,40,-3,39
Brisbane,5923,6,10,5,13,33,42,-9,35
Western Sydn,5923,7,8,9,10,38,47,-9,33
Perth Glory,5923,8,10,2,15,37,50,-13,32
Wellington P,5923,9,5,6,16,31,55,-24,21
CC Mariners,5923,10,4,8,15,28,49,-21,20
Sydney FC,5924,1,21,4,3,68,24,44,67
N'castle Jet,5924,2,15,6,7,58,38,20,51
Melbourne C,5924,3,14,5,10,44,34,10,47
Melbourne V,5924,4,13,5,11,47,42,5,44
Adelaide Utd,5924,5,11,6,11,37,40,-3,39
Brisbane,5924,6,10,5,13,33,42,-9,35
Western Sydn,5924,7,8,9,10,38,47,-9,33
Perth Glory,5924,8,10,2,15,37,50,-13,32
Wellington P,5924,9,5,6,16,31,55,-24,21
CC Mariners,5924,10,4,8,15,28,49,-21,20
Sydney FC,5925,1,21,4,3,66,23,43,67
N'castle Jet,5925,2,15,5,8,57,38,19,50
Melbourne C,5925,3,15,4,10,44,33,11,49
Melbourne V,5925,4,13,5,11,46,40,6,44
Adelaide Utd,5925,5,11,6,11,37,40,-3,39
Brisbane,5925,6,10,5,13,33,42,-9,35
Western Sydn,5925,7,8,9,10,38,47,-9,33
Perth Glory,5925,8,10,2,15,37,50,-13,32
Wellington P,5925,9,5,6,16,31,55,-24,21
CC Mariners,5925,10,4,8,15,28,49,-21,20
Sydney FC,5926,1,21,4,3,65,22,43,67
N'castle Jet,5926,2,16,5,7,59,38,21,53
Melbourne C,5926,3,14,4,11,44,35,9,46
Melbourne V,5926,4,13,5,11,45,39,6,44
Adelaide Utd,5926,5,11,6,11,37,40,-3,39
Brisbane,5926,6,10,5,13,33,42,-9,35
Western Sydn,5926,7,8,9,10,38,47,-9,33
Perth Glory,5926,8,10,2,15,37,50,-13,32
Wellington P,5926,9,5,6,16,31,55,-24,21
CC Mariners,5926,10,4,8,15,28,49,-21,20
Sydney FC,5927,1,21,4,3,68,22,46,67
N'castle Jet,5927,2,16,5,7,60,39,21,53
Melbourne C,5927,3,14,4,11,45,36,9,46
Melbourne V,5927,4,13,5,11,45,42,3,44
Adelaide Utd,5927,5,11,6,11,37,40,-3,39
Brisbane,5927,6,10,5,13,33,42,-9,35
Western Sydn,5927,7,8,9,10,38,47,-9,33
Perth Glory,5927,8,10,2,15,37,50,-13,32
Wellington P,5927,9,5,6,16,31,55,-24,21
CC Mariners,5927,10,4,8,15,28,49,-21,20
Sydney FC,5928,1,21,4,3,67,22,45,67
N'castle Jet,5928,2,16,5,7,58,37,21,53
Melbourne C,5928,3,14,4,11,43,34,9,46
Melbourne V,5928,4,13,5,11,45,41,4,44
Adelaide Utd,5928,5,11,6,11,37,40,-3,39
Brisbane,5928,6,10,5,13,33,42,-9,35
Western Sydn,5928,7,8,9,10,38,47,-9,33
Perth Glory,5928,8,10,2,15,37,50,-13,32
Wellington P,5928,9,5,6,16,31,55,-24,21
CC Mariners,5928,10,4,8,15,28,49,-21,20
Sydney FC,5929,1,20,5,3,65,23,42,65
N'castle Jet,5929,2,15,5,8,57,39,18,50
Melbourne C,5929,3,15,4,10,45,33,12,49
Melbourne V,5929,4,13,6,10,46,39,7,45
Adelaide Utd,5929,5,11,6,11,37,40,-3,39
Brisbane,5929,6,10,5,13,33,42,-9,35
Western Sydn,5929,7,8,9,10,38,47,-9,33
Perth Glory,5929,8,10,2,15,37,50,-13,32
Wellington P,5929,9,5,6,16,31,55,-24,21
CC Mariners,5929,10,4,8,15,28,49,-21,20
Sydney FC,5930,1,21,4,3,69,23,46,67
N'castle Jet,5930,2,15,6,7,59,39,20,51
Melbourne C,5930,3,14,5,10,45,35,10,47
Melbourne V,5930,4,13,5,11,46,43,3,44
Adelaide Utd,5930,5,11,6,11,37,40,-3,39
Brisbane,5930,6,10,5,13,33,42,-9,35
Western Sydn,5930,7,8,9,10,38,47,-9,33
Perth Glory,5930,8,10,2,15,37,50,-13,32
Wellington P,5930,9,5,6,16,31,55,-24,21
CC Mariners,5930,10,4,8,15,28,49,-21,20
Sydney FC,5931,1,20,5,3,65,23,42,65
N'castle Jet,5931,2,15,5,8,58,39,19,50
Melbourne C,5931,3,15,4,10,45,34,11,49
Melbourne V,5931,4,13,6,10,46,39,7,45
Adelaide Utd,5931,5,11,6,11,37,40,-3,39
Brisbane,5931,6,10,5,13,33,42,-9,35
Western Sydn,5931,7,8,9,10,38,47,-9,33
Perth Glory,5931,8,10,2,15,37,50,-13,32
Wellington P,5931,9,5,6,16,31,55,-24,21
CC Mariners,5931,10,4,8,15,28,49,-21,20
Sydney FC,5932,1,20,4,4,65,25,40,64
N'castle Jet,5932,2,16,5,7,59,37,22,53
Melbourne V,5932,3,14,5,10,48,39,9,47
Melbourne C,5932,4,14,4,11,43,35,8,46
Adelaide Utd,5932,5,11,6,11,37,40,-3,39
Brisbane,5932,6,10,5,13,33,42,-9,35
Western Sydn,5932,7,8,9,10,38,47,-9,33
Perth Glory,5932,8,10,2,15,37,50,-13,32
Wellington P,5932,9,5,6,16,31,55,-24,21
CC Mariners,5932,10,4,8,15,28,49,-21,20
Sydney FC,5933,1,20,4,4,64,23,41,64
N'castle Jet,5933,2,16,5,7,60,37,23,53
Melbourne V,5933,3,14,5,10,46,38,8,47
Melbourne C,5933,4,14,4,11,43,36,7,46
Adelaide Utd,5933,5,11,6,11,37,40,-3,39
Brisbane,5933,6,10,5,13,33,42,-9,35
Western Sydn,5933,7,8,9,10,38,47,-9,33
Perth Glory,5933,8,10,2,15,37,50,-13,32
Wellington P,5933,9,5,6,16,31,55,-24,21
CC Mariners,5933,10,4,8,15,28,49,-21,20
Sydney FC,5934,1,20,4,4,65,24,41,64
N'castle Jet,5934,2,15,6,7,57,37,20,51
Melbourne C,5934,3,14,5,10,43,33,10,47
Melbourne V,5934,4,14,5,10,47,39,8,47
Adelaide Utd,5934,5,11,6,11,37,40,-3,39
Brisbane,5934,6,10,5,13,33,42,-9,35
Western Sydn,5934,7,8,9,10,38,47,-9,33
Perth Glory,5934,8,10,2,15,37,50,-13,32
Wellington P,5934,9,5,6,16,31,55,-24,21
CC Mariners,5934,10,4,8,15,28,49,-21,20
Sydney FC,5935,1,21,4,3,67,24,43,67
N'castle Jet,5935,2,15,5,8,57,41,16,50
Melbourne C,5935,3,15,4,10,47,33,14,49
Melbourne V,5935,4,13,5,11,47,41,6,44
Adelaide Utd,5935,5,11,6,11,37,40,-3,39
Brisbane,5935,6,10,5,13,33,42,-9,35
Western Sydn,5935,7,8,9,10,38,47,-9,33
Perth Glory,5935,8,10,2,15,37,50,-13,32
Wellington P,5935,9,5,6,16,31,55,-24,21
CC Mariners,5935,10,4,8,15,28,49,-21,20
Sydney FC,5936,1,20,5,3,66,24,42,65
N'castle Jet,5936,2,15,6,7,58,38,20,51
Melbourne C,5936,3,14,5,10,44,34,10,47
Melbourne V,5936,4,13,6,10,47,40,7,45
Adelaide Utd,5936,5,11,6,11,37,40,-3,39
Brisbane,5936,6,10,5,13,33,42,-9,35
Western Sydn,5936,7,8,9,10,38,47,-9,33
Perth Glory,5936,8,10,2,15,37,50,-13,32
Wellington P,5936,9,5,6,16,31,55,-24,21
CC Mariners,5936,10,4,8,15,28,49,-21,20
Sydney FC,5937,1,21,4,3,66,22,44,67
N'castle Jet,5937,2,16,5,7,60,39,21,53
Melbourne C,5937,3,14,4,11,45,36,9,46
Melbourne V,5937,4,13,5,11,45,40,5,44
Adelaide Utd,5937,5,11,6,11,37,40,-3,39
Brisbane,5937,6,10,5,13,33,42,-9,35
Western Sydn,5937,7,8,9,10,38,47,-9,33
Perth Glory,5937,8,10,2,15,37,50,-13,32
Wellington P,5937,9,5,6,16,31,55,-24,21
CC Mariners,5937,10,4,8,15,28,49,-21,20
Sydney FC,5938,1,21,4,3,65,22,43,67
N'castle Jet,5938,2,15,6,7,58,38,20,51
Melbourne C,5938,3,14,5,10,44,34,10,47
Melbourne V,5938,4,13,5,11,45,39,6,44
Adelaide Utd,5938,5,11,6,11,37,40,-3,39
Brisbane,5938,6,10,5,13,33,42,-9,35
Western Sydn,5938,7,8,9,10,38,47,-9,33
Perth Glory,5938,8,10,2,15,37,50,-13,32
Wellington P,5938,9,5,6,16,31,55,-24,21
CC Mariners,5938,10,4,8,15,28,49,-21,20
Sydney FC,5939,1,21,4,3,69,22,47,67
N'castle Jet,5939,2,15,5,8,57,38,19,50
Melbourne C,5939,3,15,4,10,44,33,11,49
Melbourne V,5939,4,13,5,11,45,43,2,44
Adelaide Utd,5939,5,11,6,11,37,40,-3,39
Brisbane,5939,6,10,5,13,33,42,-9,35
Western Sydn,5939,7,8,9,10,38,47,-9,33
Perth Glory,5939,8,10,2,15,37,50,-13,32
Wellington P,5939,9,5,6,16,31,55,-24,21
CC Mariners,5939,10,4,8,15,28,49,-21,20
Sydney FC,5940,1,21,4,3,67,22,45,67
N'castle Jet,5940,2,15,5,8,59,40,19,50
Melbourne C,5940,3,15,4,10,46,35,11,49
Melbourne V,5940,4,13,5,11,45,41,4,44
Adelaide Utd,5940,5,11,6,11,37,40,-3,39
Brisbane,5940,6,10,5,13,33,42,-9,35
Western Sydn,5940,7,8,9,10,38,47,-9,33
Perth Glory,5940,8,10,2,15,37,50,-13,32
Wellington P,5940,9,5,6,16,31,55,-24,21
CC Mariners,5940,10,4,8,15,28,49,-21,20
Sydney FC,5941,1,21,4,3,67,23,44,67
N'castle Jet,5941,2,16,5,7,58,37,21,53
Melbourne C,5941,3,14,4,11,43,34,9,46
Melbourne V,5941,4,13,5,11,46,41,5,44
Adelaide Utd,5941,5,11,6,11,37,40,-3,39
Brisbane,5941,6,10,5,13,33,42,-9,35
Western Sydn,5941,7,8,9,10,38,47,-9,33
Perth Glory,5941,8,10,2,15,37,50,-13,32
Wellington P,5941,9,5,6,16,31,55,-24,21
CC Mariners,5941,10,4,8,15,28,49,-21,20
Sydney FC,5942,1,20,5,3,66,24,42,65
N'castle Jet,5942,2,15,6,7,59,39,20,51
Melbourne C,5942,3,14,5,10,45,35,10,47
Melbourne V,5942,4,13,6,10,47,40,7,45
Adelaide Utd,5942,5,11,6,11,37,40,-3,39
Brisbane,5942,6,10,5,13,33,42,-9,35
Western Sydn,5942,7,8,9,10,38,47,-9,33
Perth Glory,5942,8,10,2,15,37,50,-13,32
Wellington P,5942,9,5,6,16,31,55,-24,21
CC Mariners,5942,10,4,8,15,28,49,-21,20
Sydney FC,5943,1,21,4,3,65,22,43,67
N'castle Jet,5943,2,16,5,7,60,39,21,53
Melbourne C,5943,3,14,4,11,45,36,9,46
Melbourne V,5943,4,13,5,11,45,39,6,44
Adelaide Utd,5943,5,11,6,11,37,40,-3,39
Brisbane,5943,6,10,5,13,33,42,-9,35
Western Sydn,5943,7,8,9,10,38,47,-9,33
Perth Glory,5943,8,10,2,15,37,50,-13,32
Wellington P,5943,9,5,6,16,31,55,-24,21
CC Mariners,5943,10,4,8,15,28,49,-21,20
Sydney FC,5944,1,20,5,3,65,23,42,65
N'castle Jet,5944,2,15,5,8,58,39,19,50
Melbourne C,5944,3,15,4,10,45,34,11,49
Melbourne V,5944,4,13,6,10,46,39,7,45
Adelaide Utd,5944,5,11,6,11,37,40,-3,39
Brisbane,5944,6,10,5,13,33,42,-9,35
Western Sydn,5944,7,8,9,10,38,47,-9,33
Perth Glory,5944,8,10,2,15,37,50,-13,32
Wellington P,5944,9,5,6,16,31,55,-24,21
CC Mariners,5944,10,4,8,15,28,49,-21,20
Sydney FC,5945,1,21,4,3,66,22,44,67
N'castle Jet,5945,2,15,6,7,58,38,20,51
Melbourne C,5945,3,14,5,10,44,34,10,47
Melbourne V,5945,4,13,5,11,45,40,5,44
Adelaide Utd,5945,5,11,6,11,37,40,-3,39
Brisbane,5945,6,10,5,13,33,42,-9,35
Western Sydn,5945,7,8,9,10,38,47,-9,33
Perth Glory,5945,8,10,2,15,37,50,-13,32
Wellington P,5945,9,5,6,16,31,55,-24,21
CC Mariners,5945,10,4,8,15,28,49,-21,20
Sydney FC,5946,1,21,4,3,66,22,44,67
N'castle Jet,5946,2,15,5,8,58,41,17,50
Melbourne C,5946,3,15,4,10,47,34,13,49
Melbourne V,5946,4,13,5,11,45,40,5,44
Adelaide Utd,5946,5,11,6,11,37,40,-3,39
Brisbane,5946,6,10,5,13,33,42,-9,35
Western Sydn,5946,7,8,9,10,38,47,-9,33
Perth Glory,5946,8,10,2,15,37,50,-13,32
Wellington P,5946,9,5,6,16,31,55,-24,21
CC Mariners,5946,10,4,8,15,28,49,-21,20
Sydney FC,5947,1,21,4,3,65,22,43,67
N'castle Jet,5947,2,16,5,7,60,37,23,53
Melbourne C,5947,3,14,4,11,43,36,7,46
Melbourne V,5947,4,13,5,11,45,39,6,44
Adelaide Utd,5947,5,11,6,11,37,40,-3,39
Brisbane,5947,6,10,5,13,33,42,-9,35
Western Sydn,5947,7,8,9,10,38,47,-9,33
Perth Glory,5947,8,10,2,15,37,50,-13,32
Wellington P,5947,9,5,6,16,31,55,-24,21
CC Mariners,5947,10,4,8,15,28,49,-21,20
Sydney FC,5948,1,21,4,3,66,23,43,67
N'castle Jet,5948,2,16,5,7,58,37,21,53
Melbourne C,5948,3,14,4,11,43,34,9,46
Melbourne V,5948,4,13,5,11,46,40,6,44
Adelaide Utd,5948,5,11,6,11,37,40,-3,39
Brisbane,5948,6,10,5,13,33,42,-9,35
Western Sydn,5948,7,8,9,10,38,47,-9,33
Perth Glory,5948,8,10,2,15,37,50,-13,32
Wellington P,5948,9,5,6,16,31,55,-24,21
CC Mariners,5948,10,4,8,15,28,49,-21,20
Sydney FC,5949,1,21,4,3,66,22,44,67
N'castle Jet,5949,2,15,5,8,58,39,19,50
Melbourne C,5949,3,15,4,10,45,34,11,49
Melbourne V,5949,4,13,5,11,45,40,5,44
Adelaide Utd,5949,5,11,6,11,37,40,-3,39
Brisbane,5949,6,10,5,13,33,42,-9,35
Western Sydn,5949,7,8,9,10,38,47,-9,33
Perth Glory,5949,8,10,2,15,37,50,-13,32
Wellington P,5949,9,5,6,16,31,55,-24,21
CC Mariners,5949,10,4,8,15,28,49,-21,20
Sydney FC,5950,1,20,4,4,66,28,38,64
N'castle Jet,5950,2,16,5,7,58,37,21,53
Melbourne V,5950,3,14,5,10,51,40,11,47
Melbourne C,5950,4,14,4,11,43,34,9,46
Adelaide Utd,5950,5,11,6,11,37,40,-3,39
Brisbane,5950,6,10,5,13,33,42,-9,35
Western Sydn,5950,7,8,9,10,38,47,-9,33
Perth Glory,5950,8,10,2,15,37,50,-13,32
Wellington P,5950,9,5,6,16,31,55,-24,21
CC Mariners,5950,10,4,8,15,28,49,-21,20
Sydney FC,5951,1,20,5,3,66,24,42,65
N'castle Jet,5951,2,16,5,7,59,37,22,53
Melbourne C,5951,3,14,4,11,43,35,8,46
Melbourne V,5951,4,13,6,10,47,40,7,45
Adelaide Utd,5951,5,11,6,11,37,40,-3,39
Brisbane,5951,6,10,5,13,33,42,-9,35
Western Sydn,5951,7,8,9,10,38,47,-9,33
Perth Glory,5951,8,10,2,15,37,50,-13,32
Wellington P,5951,9,5,6,16,31,55,-24,21
CC Mariners,5951,10,4,8,15,28,49,-21,20
Sydney FC,5952,1,20,4,4,64,23,41,64
N'castle Jet,5952,2,15,6,7,58,38,20,51
Melbourne C,5952,3,14,5,10,44,34,10,47
Melbourne V,5952,4,14,5,10,46,38,8,47
Adelaide Utd,5952,5,11,6,11,37,40,-3,39
Brisbane,5952,6,10,5,13,33,42,-9,35
Western Sydn,5952,7,8,9,10,38,47,-9,33
Perth Glory,5952,8,10,2,15,37,50,-13,32
Wellington P,5952,9,5,6,16,31,55,-24,21
CC Mariners,5952,10,4,8,15,28,49,-21,20
Sydney FC,5953,1,20,5,3,65,23,42,65
N'castle Jet,5953,2,16,5,7,60,38,22,53
Melbourne C,5953,3,14,4,11,44,36,8,46
Melbourne V,5953,4,13,6,10,46,39,7,45
Adelaide Utd,5953,5,11,6,11,37,40,-3,39
Brisbane,5953,6,10,5,13,33,42,-9,35
Western Sydn,5953,7,8,9,10,38,47,-9,33
Perth Glory,5953,8,10,2,15,37,50,-13,32
Wellington P,5953,9,5,6,16,31,55,-24,21
CC Mariners,5953,10,4,8,15,28,49,-21,20
Sydney FC,5954,1,20,5,3,65,23,42,65
N'castle Jet,5954,2,15,5,8,57,38,19,50
Melbourne C,5954,3,15,4,10,44,33,11,49
Melbourne V,5954,4,13,6,10,46,39,7,45
Adelaide Utd,5954,5,11,6,11,37,40,-3,39
Brisbane,5954,6,10,5,13,33,42,-9,35
Western Sydn,5954,7,8,9,10,38,47,-9,33
Perth Glory,5954,8,10,2,15,37,50,-13,32
Wellington P,5954,9,5,6,16,31,55,-24,21
CC Mariners,5954,10,4,8,15,28,49,-21,20
Sydney FC,5955,1,20,5,3,66,24,42,65
N'castle Jet,5955,2,15,5,8,58,40,18,50
Melbourne C,5955,3,15,4,10,46,34,12,49
Melbourne V,5955,4,13,6,10,47,40,7,45
Adelaide Utd,5955,5,11,6,11,37,40,-3,39
Brisbane,5955,6,10,5,13,33,42,-9,35
Western Sydn,5955,7,8,9,10,38,47,-9,33
Perth Glory,5955,8,10,2,15,37,50,-13,32
Wellington P,5955,9,5,6,16,31,55,-24,21
CC Mariners,5955,10,4,8,15,28,49,-21,20
Sydney FC,5956,1,21,4,3,67,23,44,67
N'castle Jet,5956,2,15,6,7,57,37,20,51
Melbourne C,5956,3,14,5,10,43,33,10,47
Melbourne V,5956,4,13,5,11,46,41,5,44
Adelaide Utd,5956,5,11,6,11,37,40,-3,39
Brisbane,5956,6,10,5,13,33,42,-9,35
Western Sydn,5956,7,8,9,10,38,47,-9,33
Perth Glory,5956,8,10,2,15,37,50,-13,32
Wellington P,5956,9,5,6,16,31,55,-24,21
CC Mariners,5956,10,4,8,15,28,49,-21,20
Sydney FC,5957,1,20,5,3,65,23,42,65
N'castle Jet,5957,2,15,6,7,58,38,20,51
Melbourne C,5957,3,14,5,10,44,34,10,47
Melbourne V,5957,4,13,6,10,46,39,7,45
Adelaide Utd,5957,5,11,6,11,37,40,-3,39
Brisbane,5957,6,10,5,13,33,42,-9,35
Western Sydn,5957,7,8,9,10,38,47,-9,33
Perth Glory,5957,8,10,2,15,37,50,-13,32
Wellington P,5957,9,5,6,16,31,55,-24,21
CC Mariners,5957,10,4,8,15,28,49,-21,20
Sydney FC,5958,1,21,4,3,68,23,45,67
N'castle Jet,5958,2,16,5,7,63,37,26,53
Melbourne C,5958,3,14,4,11,43,39,4,46
Melbourne V,5958,4,13,5,11,46,42,4,44
Adelaide Utd,5958,5,11,6,11,37,40,-3,39
Brisbane,5958,6,10,5,13,33,42,-9,35
Western Sydn,5958,7,8,9,10,38,47,-9,33
Perth Glory,5958,8,10,2,15,37,50,-13,32
Wellington P,5958,9,5,6,16,31,55,-24,21
CC Mariners,5958,10,4,8,15,28,49,-21,20
Sydney FC,5959,1,20,4,4,65,24,41,64
N'castle Jet,5959,2,16,5,7,58,37,21,53
Melbourne V,5959,3,14,5,10,47,39,8,47
Melbourne C,5959,4,14,4,11,43,34,9,46
Adelaide Utd,5959,5,11,6,11,37,40,-3,39
Brisbane,5959,6,10,5,13,33,42,-9,35
Western Sydn,5959,7,8,9,10,38,47,-9,33
Perth Glory,5959,8,10,2,15,37,50,-13,32
Wellington P,5959,9,5,6,16,31,55,-24,21
CC Mariners,5959,10,4,8,15,28,49,-21,20
Sydney FC,5960,1,21,4,3,67,24,43,67
N'castle Jet,5960,2,15,6,7,57,37,20,51
Melbourne C,5960,3,14,5,10,43,33,10,47
Melbourne V,5960,4,13,5,11,47,41,6,44
Adelaide Utd,5960,5,11,6,11,37,40,-3,39
Brisbane,5960,6,10,5,13,33,42,-9,35
Western Sydn,5960,7,8,9,10,38,47,-9,33
Perth Glory,5960,8,10,2,15,37,50,-13,32
Wellington P,5960,9,5,6,16,31,55,-24,21
CC Mariners,5960,10,4,8,15,28,49,-21,20
Sydney FC,5961,1,21,4,3,68,23,45,67
N'castle Jet,5961,2,16,5,7,59,37,22,53
Melbourne C,5961,3,14,4,11,43,35,8,46
Melbourne V,5961,4,13,5,11,46,42,4,44
Adelaide Utd,5961,5,11,6,11,37,40,-3,39
Brisbane,5961,6,10,5,13,33,42,-9,35
Western Sydn,5961,7,8,9,10,38,47,-9,33
Perth Glory,5961,8,10,2,15,37,50,-13,32
Wellington P,5961,9,5,6,16,31,55,-24,21
CC Mariners,5961,10,4,8,15,28,49,-21,20
Sydney FC,5962,1,20,4,4,64,23,41,64
N'castle Jet,5962,2,16,5,7,59,38,21,53
Melbourne V,5962,3,14,5,10,46,38,8,47
Melbourne C,5962,4,14,4,11,44,35,9,46
Adelaide Utd,5962,5,11,6,11,37,40,-3,39
Brisbane,5962,6,10,5,13,33,42,-9,35
Western Sydn,5962,7,8,9,10,38,47,-9,33
Perth Glory,5962,8,10,2,15,37,50,-13,32
Wellington P,5962,9,5,6,16,31,55,-24,21
CC Mariners,5962,10,4,8,15,28,49,-21,20
Sydney FC,5963,1,20,5,3,66,24,42,65
N'castle Jet,5963,2,15,5,8,57,39,18,50
Melbourne C,5963,3,15,4,10,45,33,12,49
Melbourne V,5963,4,13,6,10,47,40,7,45
Adelaide Utd,5963,5,11,6,11,37,40,-3,39
Brisbane,5963,6,10,5,13,33,42,-9,35
Western Sydn,5963,7,8,9,10,38,47,-9,33
Perth Glory,5963,8,10,2,15,37,50,-13,32
Wellington P,5963,9,5,6,16,31,55,-24,21
CC Mariners,5963,10,4,8,15,28,49,-21,20
Sydney FC,5964,1,21,4,3,66,22,44,67
N'castle Jet,5964,2,16,5,7,59,37,22,53
Melbourne C,5964,3,14,4,11,43,35,8,46
Melbourne V,5964,4,13,5,11,45,40,5,44
Adelaide Utd,5964,5,11,6,11,37,40,-3,39
Brisbane,5964,6,10,5,13,33,42,-9,35
Western Sydn,5964,7,8,9,10,38,47,-9,33
Perth Glory,5964,8,10,2,15,37,50,-13,32
Wellington P,5964,9,5,6,16,31,55,-24,21
CC Mariners,5964,10,4,8,15,28,49,-21,20
Sydney FC,5965,1,21,4,3,66,22,44,67
N'castle Jet,5965,2,16,5,7,60,38,22,53
Melbourne C,5965,3,14,4,11,44,36,8,46
Melbourne V,5965,4,13,5,11,45,40,5,44
Adelaide Utd,5965,5,11,6,11,37,40,-3,39
Brisbane,5965,6,10,5,13,33,42,-9,35
Western Sydn,5965,7,8,9,10,38,47,-9,33
Perth Glory,5965,8,10,2,15,37,50,-13,32
Wellington P,5965,9,5,6,16,31,55,-24,21
CC Mariners,5965,10,4,8,15,28,49,-21,20
Sydney FC,5966,1,21,4,3,68,23,45,67
N'castle Jet,5966,2,15,5,8,57,38,19,50
Melbourne C,5966,3,15,4,10,44,33,11,49
Melbourne V,5966,4,13,5,11,46,42,4,44
Adelaide Utd,5966,5,11,6,11,37,40,-3,39
Brisbane,5966,6,10,5,13,33,42,-9,35
Western Sydn,5966,7,8,9,10,38,47,-9,33
Perth Glory,5966,8,10,2,15,37,50,-13,32
Wellington P,5966,9,5,6,16,31,55,-24,21
CC Mariners,5966,10,4,8,15,28,49,-21,20
Sydney FC,5967,1,20,5,3,65,23,42,65
N'castle Jet,5967,2,15,5,8,58,39,19,50
Melbourne C,5967,3,15,4,10,45,34,11,49
Melbourne V,5967,4,13,6,10,46,39,7,45
Adelaide Utd,5967,5,11,6,11,37,40,-3,39
Brisbane,5967,6,10,5,13,33,42,-9,35
Western Sydn,5967,7,8,9,10,38,47,-9,33
Perth Glory,5967,8,10,2,15,37,50,-13,32
Wellington P,5967,9,5,6,16,31,55,-24,21
CC Mariners,5967,10,4,8,15,28,49,-21,20
Sydney FC,5968,1,21,4,3,65,22,43,67
N'castle Jet,5968,2,16,5,7,59,37,22,53
Melbourne C,5968,3,14,4,11,43,35,8,46
Melbourne V,5968,4,13,5,11,45,39,6,44
Adelaide Utd,5968,5,11,6,11,37,40,-3,39
Brisbane,5968,6,10,5,13,33,42,-9,35
Western Sydn,5968,7,8,9,10,38,47,-9,33
Perth Glory,5968,8,10,2,15,37,50,-13,32
Wellington P,5968,9,5,6,16,31,55,-24,21
CC Mariners,5968,10,4,8,15,28,49,-21,20
Sydney FC,5969,1,20,4,4,64,24,40,64
N'castle Jet,5969,2,16,5,7,59,38,21,53
Melbourne V,5969,3,14,5,10,47,38,9,47
Melbourne C,5969,4,14,4,11,44,35,9,46
Adelaide Utd,5969,5,11,6,11,37,40,-3,39
Brisbane,5969,6,10,5,13,33,42,-9,35
Western Sydn,5969,7,8,9,10,38,47,-9,33
Perth Glory,5969,8,10,2,15,37,50,-13,32
Wellington P,5969,9,5,6,16,31,55,-24,21
CC Mariners,5969,10,4,8,15,28,49,-21,20
Sydney FC,5970,1,20,4,4,67,26,41,64
N'castle Jet,5970,2,16,5,7,62,39,23,53
Melbourne V,5970,3,14,5,10,49,41,8,47
Melbourne C,5970,4,14,4,11,45,38,7,46
Adelaide Utd,5970,5,11,6,11,37,40,-3,39
Brisbane,5970,6,10,5,13,33,42,-9,35
Western Sydn,5970,7,8,9,10,38,47,-9,33
Perth Glory,5970,8,10,2,15,37,50,-13,32
Wellington P,5970,9,5,6,16,31,55,-24,21
CC Mariners,5970,10,4,8,15,28,49,-21,20
Sydney FC,5971,1,20,5,3,67,25,42,65
N'castle Jet,5971,2,16,5,7,59,38,21,53
Melbourne C,5971,3,14,4,11,44,35,9,46
Melbourne V,5971,4,13,6,10,48,41,7,45
Adelaide Utd,5971,5,11,6,11,37,40,-3,39
Brisbane,5971,6,10,5,13,33,42,-9,35
Western Sydn,5971,7,8,9,10,38,47,-9,33
Perth Glory,5971,8,10,2,15,37,50,-13,32
Wellington P,5971,9,5,6,16,31,55,-24,21
CC Mariners,5971,10,4,8,15,28,49,-21,20
Sydney FC,5972,1,21,4,3,66,22,44,67
N'castle Jet,5972,2,15,6,7,60,40,20,51
Melbourne C,5972,3,14,5,10,46,36,10,47
Melbourne V,5972,4,13,5,11,45,40,5,44
Adelaide Utd,5972,5,11,6,11,37,40,-3,39
Brisbane,5972,6,10,5,13,33,42,-9,35
Western Sydn,5972,7,8,9,10,38,47,-9,33
Perth Glory,5972,8,10,2,15,37,50,-13,32
Wellington P,5972,9,5,6,16,31,55,-24,21
CC Mariners,5972,10,4,8,15,28,49,-21,20
Sydney FC,5973,1,20,5,3,65,23,42,65
N'castle Jet,5973,2,15,6,7,58,38,20,51
Melbourne C,5973,3,14,5,10,44,34,10,47
Melbourne V,5973,4,13,6,10,46,39,7,45
Adelaide Utd,5973,5,11,6,11,37,40,-3,39
Brisbane,5973,6,10,5,13,33,42,-9,35
Western Sydn,5973,7,8,9,10,38,47,-9,33
Perth Glory,5973,8,10,2,15,37,50,-13,32
Wellington P,5973,9,5,6,16,31,55,-24,21
CC Mariners,5973,10,4,8,15,28,49,-21,20
Sydney FC,5974,1,21,4,3,66,23,43,67
N'castle Jet,5974,2,16,5,7,59,38,21,53
Melbourne C,5974,3,14,4,11,44,35,9,46
Melbourne V,5974,4,13,5,11,46,40,6,44
Adelaide Utd,5974,5,11,6,11,37,40,-3,39
Brisbane,5974,6,10,5,13,33,42,-9,35
Western Sydn,5974,7,8,9,10,38,47,-9,33
Perth Glory,5974,8,10,2,15,37,50,-13,32
Wellington P,5974,9,5,6,16,31,55,-24,21
CC Mariners,5974,10,4,8,15,28,49,-21,20
Sydney FC,5975,1,21,4,3,66,22,44,67
N'castle Jet,5975,2,15,5,8,58,39,19,50
Melbourne C,5975,3,15,4,10,45,34,11,49
Melbourne V,5975,4,13,5,11,45,40,5,44
Adelaide Utd,5975,5,11,6,11,37,40,-3,39
Brisbane,5975,6,10,5,13,33,42,-9,35
Western Sydn,5975,7,8,9,10,38,47,-9,33
Perth Glory,5975,8,10,2,15,37,50,-13,32
Wellington P,5975,9,5,6,16,31,55,-24,21
CC Mariners,5975,10,4,8,15,28,49,-21,20
Sydney FC,5976,1,21,4,3,67,24,43,67
N'castle Jet,5976,2,15,5,8,59,41,18,50
Melbourne C,5976,3,15,4,10,47,35,12,49
Melbourne V,5976,4,13,5,11,47,41,6,44
Adelaide Utd,5976,5,11,6,11,37,40,-3,39
Brisbane,5976,6,10,5,13,33,42,-9,35
Western Sydn,5976,7,8,9,10,38,47,-9,33
Perth Glory,5976,8,10,2,15,37,50,-13,32
Wellington P,5976,9,5,6,16,31,55,-24,21
CC Mariners,5976,10,4,8,15,28,49,-21,20
Sydney FC,5977,1,20,5,3,65,23,42,65
N'castle Jet,5977,2,16,5,7,61,38,23,53
Melbourne C,5977,3,14,4,11,44,37,7,46
Melbourne V,5977,4,13,6,10,46,39,7,45
Adelaide Utd,5977,5,11,6,11,37,40,-3,39
Brisbane,5977,6,10,5,13,33,42,-9,35
Western Sydn,5977,7,8,9,10,38,47,-9,33
Perth Glory,5977,8,10,2,15,37,50,-13,32
Wellington P,5977,9,5,6,16,31,55,-24,21
CC Mariners,5977,10,4,8,15,28,49,-21,20
Sydney FC,5978,1,20,4,4,64,25,39,64
N'castle Jet,5978,2,16,5,7,59,37,22,53
Melbourne V,5978,3,14,5,10,48,38,10,47
Melbourne C,5978,4,14,4,11,43,35,8,46
Adelaide Utd,5978,5,11,6,11,37,40,-3,39
Brisbane,5978,6,10,5,13,33,42,-9,35
Western Sydn,5978,7,8,9,10,38,47,-9,33
Perth Glory,5978,8,10,2,15,37,50,-13,32
Wellington P,5978,9,5,6,16,31,55,-24,21
CC Mariners,5978,10,4,8,15,28,49,-21,20
Sydney FC,5979,1,21,4,3,69,23,46,67
N'castle Jet,5979,2,16,5,7,60,38,22,53
Melbourne C,5979,3,14,4,11,44,36,8,46
Melbourne V,5979,4,13,5,11,46,43,3,44
Adelaide Utd,5979,5,11,6,11,37,40,-3,39
Brisbane,5979,6,10,5,13,33,42,-9,35
Western Sydn,5979,7,8,9,10,38,47,-9,33
Perth Glory,5979,8,10,2,15,37,50,-13,32
Wellington P,5979,9,5,6,16,31,55,-24,21
CC Mariners,5979,10,4,8,15,28,49,-21,20
Sydney FC,5980,1,21,4,3,66,23,43,67
N'castle Jet,5980,2,15,6,7,59,39,20,51
Melbourne C,5980,3,14,5,10,45,35,10,47
Melbourne V,5980,4,13,5,11,46,40,6,44
Adelaide Utd,5980,5,11,6,11,37,40,-3,39
Brisbane,5980,6,10,5,13,33,42,-9,35
Western Sydn,5980,7,8,9,10,38,47,-9,33
Perth Glory,5980,8,10,2,15,37,50,-13,32
Wellington P,5980,9,5,6,16,31,55,-24,21
CC Mariners,5980,10,4,8,15,28,49,-21,20
Sydney FC,5981,1,20,5,3,65,23,42,65
N'castle Jet,5981,2,16,5,7,61,38,23,53
Melbourne C,5981,3,14,4,11,44,37,7,46
Melbourne V,5981,4,13,6,10,46,39,7,45
Adelaide Utd,5981,5,11,6,11,37,40,-3,39
Brisbane,5981,6,10,5,13,33,42,-9,35
Western Sydn,5981,7,8,9,10,38,47,-9,33
Perth Glory,5981,8,10,2,15,37,50,-13,32
Wellington P,5981,9,5,6,16,31,55,-24,21
CC Mariners,5981,10,4,8,15,28,49,-21,20
Sydney FC,5982,1,21,4,3,66,23,43,67
N'castle Jet,5982,2,15,5,8,57,39,18,50
Melbourne C,5982,3,15,4,10,45,33,12,49
Melbourne V,5982,4,13,5,11,46,40,6,44
Adelaide Utd,5982,5,11,6,11,37,40,-3,39
Brisbane,5982,6,10,5,13,33,42,-9,35
Western Sydn,5982,7,8,9,10,38,47,-9,33
Perth Glory,5982,8,10,2,15,37,50,-13,32
Wellington P,5982,9,5,6,16,31,55,-24,21
CC Mariners,5982,10,4,8,15,28,49,-21,20
Sydney FC,5983,1,20,5,3,65,23,42,65
N'castle Jet,5983,2,16,5,7,58,37,21,53
Melbourne C,5983,3,14,4,11,43,34,9,46
Melbourne V,5983,4,13,6,10,46,39,7,45
Adelaide Utd,5983,5,11,6,11,37,40,-3,39
Brisbane,5983,6,10,5,13,33,42,-9,35
Western Sydn,5983,7,8,9,10,38,47,-9,33
Perth Glory,5983,8,10,2,15,37,50,-13,32
Wellington P,5983,9,5,6,16,31,55,-24,21
CC Mariners,5983,10,4,8,15,28,49,-21,20
Sydney FC,5984,1,21,4,3,67,24,43,67
N'castle Jet,5984,2,16,5,7,58,37,21,53
Melbourne C,5984,3,14,4,11,43,34,9,46
Melbourne V,5984,4,13,5,11,47,41,6,44
Adelaide Utd,5984,5,11,6,11,37,40,-3,39
Brisbane,5984,6,10,5,13,33,42,-9,35
Western Sydn,5984,7,8,9,10,38,47,-9,33
Perth Glory,5984,8,10,2,15,37,50,-13,32
Wellington P,5984,9,5,6,16,31,55,-24,21
CC Mariners,5984,10,4,8,15,28,49,-21,20
Sydney FC,5985,1,20,5,3,65,23,42,65
N'castle Jet,5985,2,16,5,7,59,37,22,53
Melbourne C,5985,3,14,4,11,43,35,8,46
Melbourne V,5985,4,13,6,10,46,39,7,45
Adelaide Utd,5985,5,11,6,11,37,40,-3,39
Brisbane,5985,6,10,5,13,33,42,-9,35
Western Sydn,5985,7,8,9,10,38,47,-9,33
Perth Glory,5985,8,10,2,15,37,50,-13,32
Wellington P,5985,9,5,6,16,31,55,-24,21
CC Mariners,5985,10,4,8,15,28,49,-21,20
Sydney FC,5986,1,20,4,4,65,25,40,64
N'castle Jet,5986,2,16,5,7,58,37,21,53
Melbourne V,5986,3,14,5,10,48,39,9,47
Melbourne C,5986,4,14,4,11,43,34,9,46
Adelaide Utd,5986,5,11,6,11,37,40,-3,39
Brisbane,5986,6,10,5,13,33,42,-9,35
Western Sydn,5986,7,8,9,10,38,47,-9,33
Perth Glory,5986,8,10,2,15,37,50,-13,32
Wellington P,5986,9,5,6,16,31,55,-24,21
CC Mariners,5986,10,4,8,15,28,49,-21,20
Sydney FC,5987,1,21,4,3,66,22,44,67
N'castle Jet,5987,2,15,5,8,59,40,19,50
Melbourne C,5987,3,15,4,10,46,35,11,49
Melbourne V,5987,4,13,5,11,45,40,5,44
Adelaide Utd,5987,5,11,6,11,37,40,-3,39
Brisbane,5987,6,10,5,13,33,42,-9,35
Western Sydn,5987,7,8,9,10,38,47,-9,33
Perth Glory,5987,8,10,2,15,37,50,-13,32
Wellington P,5987,9,5,6,16,31,55,-24,21
CC Mariners,5987,10,4,8,15,28,49,-21,20
Sydney FC,5988,1,21,4,3,68,23,45,67
N'castle Jet,5988,2,15,5,8,59,40,19,50
Melbourne C,5988,3,15,4,10,46,35,11,49
Melbourne V,5988,4,13,5,11,46,42,4,44
Adelaide Utd,5988,5,11,6,11,37,40,-3,39
Brisbane,5988,6,10,5,13,33,42,-9,35
Western Sydn,5988,7,8,9,10,38,47,-9,33
Perth Glory,5988,8,10,2,15,37,50,-13,32
Wellington P,5988,9,5,6,16,31,55,-24,21
CC Mariners,5988,10,4,8,15,28,49,-21,20
Sydney FC,5989,1,21,4,3,66,22,44,67
N'castle Jet,5989,2,16,5,7,59,37,22,53
Melbourne C,5989,3,14,4,11,43,35,8,46
Melbourne V,5989,4,13,5,11,45,40,5,44
Adelaide Utd,5989,5,11,6,11,37,40,-3,39
Brisbane,5989,6,10,5,13,33,42,-9,35
Western Sydn,5989,7,8,9,10,38,47,-9,33
Perth Glory,5989,8,10,2,15,37,50,-13,32
Wellington P,5989,9,5,6,16,31,55,-24,21
CC Mariners,5989,10,4,8,15,28,49,-21,20
Sydney FC,5990,1,21,4,3,69,24,45,67
N'castle Jet,5990,2,16,5,7,60,37,23,53
Melbourne C,5990,3,14,4,11,43,36,7,46
Melbourne V,5990,4,13,5,11,47,43,4,44
Adelaide Utd,5990,5,11,6,11,37,40,-3,39
Brisbane,5990,6,10,5,13,33,42,-9,35
Western Sydn,5990,7,8,9,10,38,47,-9,33
Perth Glory,5990,8,10,2,15,37,50,-13,32
Wellington P,5990,9,5,6,16,31,55,-24,21
CC Mariners,5990,10,4,8,15,28,49,-21,20
Sydney FC,5991,1,20,5,3,64,22,42,65
N'castle Jet,5991,2,16,5,7,59,38,21,53
Melbourne C,5991,3,14,4,11,44,35,9,46
Melbourne V,5991,4,13,6,10,45,38,7,45
Adelaide Utd,5991,5,11,6,11,37,40,-3,39
Brisbane,5991,6,10,5,13,33,42,-9,35
Western Sydn,5991,7,8,9,10,38,47,-9,33
Perth Glory,5991,8,10,2,15,37,50,-13,32
Wellington P,5991,9,5,6,16,31,55,-24,21
CC Mariners,5991,10,4,8,15,28,49,-21,20
Sydney FC,5992,1,21,4,3,65,22,43,67
N'castle Jet,5992,2,16,5,7,58,37,21,53
Melbourne C,5992,3,14,4,11,43,34,9,46
Melbourne V,5992,4,13,5,11,45,39,6,44
Adelaide Utd,5992,5,11,6,11,37,40,-3,39
Brisbane,5992,6,10,5,13,33,42,-9,35
Western Sydn,5992,7,8,9,10,38,47,-9,33
Perth Glory,5992,8,10,2,15,37,50,-13,32
Wellington P,5992,9,5,6,16,31,55,-24,21
CC Mariners,5992,10,4,8,15,28,49,-21,20
Sydney FC,5993,1,21,4,3,66,23,43,67
N'castle Jet,5993,2,15,5,8,58,40,18,50
Melbourne C,5993,3,15,4,10,46,34,12,49
Melbourne V,5993,4,13,5,11,46,40,6,44
Adelaide Utd,5993,5,11,6,11,37,40,-3,39
Brisbane,5993,6,10,5,13,33,42,-9,35
Western Sydn,5993,7,8,9,10,38,47,-9,33
Perth Glory,5993,8,10,2,15,37,50,-13,32
Wellington P,5993,9,5,6,16,31,55,-24,21
CC Mariners,5993,10,4,8,15,28,49,-21,20
Sydney FC,5994,1,20,4,4,64,23,41,64
N'castle Jet,5994,2,16,5,7,59,37,22,53
Melbourne V,5994,3,14,5,10,46,38,8,47
Melbourne C,5994,4,14,4,11,43,35,8,46
Adelaide Utd,5994,5,11,6,11,37,40,-3,39
Brisbane,5994,6,10,5,13,33,42,-9,35
Western Sydn,5994,7,8,9,10,38,47,-9,33
Perth Glory,5994,8,10,2,15,37,50,-13,32
Wellington P,5994,9,5,6,16,31,55,-24,21
CC Mariners,5994,10,4,8,15,28,49,-21,20
Sydney FC,5995,1,20,5,3,65,23,42,65
N'castle Jet,5995,2,15,6,7,59,39,20,51
Melbourne C,5995,3,14,5,10,45,35,10,47
Melbourne V,5995,4,13,6,10,46,39,7,45
Adelaide Utd,5995,5,11,6,11,37,40,-3,39
Brisbane,5995,6,10,5,13,33,42,-9,35
Western Sydn,5995,7,8,9,10,38,47,-9,33
Perth Glory,5995,8,10,2,15,37,50,-13,32
Wellington P,5995,9,5,6,16,31,55,-24,21
CC Mariners,5995,10,4,8,15,28,49,-21,20
Sydney FC,5996,1,21,4,3,67,23,44,67
N'castle Jet,5996,2,16,5,7,59,38,21,53
Melbourne C,5996,3,14,4,11,44,35,9,46
Melbourne V,5996,4,13,5,11,46,41,5,44
Adelaide Utd,5996,5,11,6,11,37,40,-3,39
Brisbane,5996,6,10,5,13,33,42,-9,35
Western Sydn,5996,7,8,9,10,38,47,-9,33
Perth Glory,5996,8,10,2,15,37,50,-13,32
Wellington P,5996,9,5,6,16,31,55,-24,21
CC Mariners,5996,10,4,8,15,28,49,-21,20
Sydney FC,5997,1,20,4,4,65,24,41,64
N'castle Jet,5997,2,15,6,7,58,38,20,51
Melbourne C,5997,3,14,5,10,44,34,10,47
Melbourne V,5997,4,14,5,10,47,39,8,47
Adelaide Utd,5997,5,11,6,11,37,40,-3,39
Brisbane,5997,6,10,5,13,33,42,-9,35
Western Sydn,5997,7,8,9,10,38,47,-9,33
Perth Glory,5997,8,10,2,15,37,50,-13,32
Wellington P,5997,9,5,6,16,31,55,-24,21
CC Mariners,5997,10,4,8,15,28,49,-21,20
Sydney FC,5998,1,21,4,3,66,22,44,67
N'castle Jet,5998,2,15,5,8,59,41,18,50
Melbourne C,5998,3,15,4,10,47,35,12,49
Melbourne V,5998,4,13,5,11,45,40,5,44
Adelaide Utd,5998,5,11,6,11,37,40,-3,39
Brisbane,5998,6,10,5,13,33,42,-9,35
Western Sydn,5998,7,8,9,10,38,47,-9,33
Perth Glory,5998,8,10,2,15,37,50,-13,32
Wellington P,5998,9,5,6,16,31,55,-24,21
CC Mariners,5998,10,4,8,15,28,49,-21,20
Sydney FC,5999,1,21,4,3,72,22,50,67
N'castle Jet,5999,2,16,5,7,60,37,23,53
Melbourne C,5999,3,14,4,11,43,36,7,46
Melbourne V,5999,4,13,5,11,45,46,-1,44
Adelaide Utd,5999,5,11,6,11,37,40,-3,39
Brisbane,5999,6,10,5,13,33,42,-9,35
Western Sydn,5999,7,8,9,10,38,47,-9,33
Perth Glory,5999,8,10,2,15,37,50,-13,32
Wellington P,5999,9,5,6,16,31,55,-24,21
CC Mariners,5999,10,4,8,15,28,49,-21,20
Sydney FC,6000,1,21,4,3,66,22,44,67
N'castle Jet,6000,2,16,5,7,59,38,21,53
Melbourne C,6000,3,14,4,11,44,35,9,46
Melbourne V,6000,4,13,5,11,45,40,5,44
Adelaide Utd,6000,5,11,6,11,37,40,-3,39
Brisbane,6000,6,10,5,13,33,42,-9,35
Western Sydn,6000,7,8,9,10,38,47,-9,33
Perth Glory,6000,8,10,2,15,37,50,-13,32
Wellington P,6000,9,5,6,16,31,55,-24,21
CC Mariners,6000,10,4,8,15,28,49,-21,20
Sydney FC,6001,1,21,4,3,66,22,44,67
N'castle Jet,6001,2,15,5,8,57,38,19,50
Melbourne C,6001,3,15,4,10,44,33,11,49
Melbourne V,6001,4,13,5,11,45,40,5,44
Adelaide Utd,6001,5,11,6,11,37,40,-3,39
Brisbane,6001,6,10,5,13,33,42,-9,35
Western Sydn,6001,7,8,9,10,38,47,-9,33
Perth Glory,6001,8,10,2,15,37,50,-13,32
Wellington P,6001,9,5,6,16,31,55,-24,21
CC Mariners,6001,10,4,8,15,28,49,-21,20
Sydney FC,6002,1,20,4,4,64,25,39,64
N'castle Jet,6002,2,16,5,7,60,39,21,53
Melbourne V,6002,3,14,5,10,48,38,10,47
Melbourne C,6002,4,14,4,11,45,36,9,46
Adelaide Utd,6002,5,11,6,11,37,40,-3,39
Brisbane,6002,6,10,5,13,33,42,-9,35
Western Sydn,6002,7,8,9,10,38,47,-9,33
Perth Glory,6002,8,10,2,15,37,50,-13,32
Wellington P,6002,9,5,6,16,31,55,-24,21
CC Mariners,6002,10,4,8,15,28,49,-21,20
Sydney FC,6003,1,20,5,3,65,23,42,65
N'castle Jet,6003,2,15,5,8,57,38,19,50
Melbourne C,6003,3,15,4,10,44,33,11,49
Melbourne V,6003,4,13,6,10,46,39,7,45
Adelaide Utd,6003,5,11,6,11,37,40,-3,39
Brisbane,6003,6,10,5,13,33,42,-9,35
Western Sydn,6003,7,8,9,10,38,47,-9,33
Perth Glory,6003,8,10,2,15,37,50,-13,32
Wellington P,6003,9,5,6,16,31,55,-24,21
CC Mariners,6003,10,4,8,15,28,49,-21,20
Sydney FC,6004,1,21,4,3,67,22,45,67
N'castle Jet,6004,2,16,5,7,59,37,22,53
Melbourne C,6004,3,14,4,11,43,35,8,46
Melbourne V,6004,4,13,5,11,45,41,4,44
Adelaide Utd,6004,5,11,6,11,37,40,-3,39
Brisbane,6004,6,10,5,13,33,42,-9,35
Western Sydn,6004,7,8,9,10,38,47,-9,33
Perth Glory,6004,8,10,2,15,37,50,-13,32
Wellington P,6004,9,5,6,16,31,55,-24,21
CC Mariners,6004,10,4,8,15,28,49,-21,20
Sydney FC,6005,1,21,4,3,68,23,45,67
N'castle Jet,6005,2,15,6,7,58,38,20,51
Melbourne C,6005,3,14,5,10,44,34,10,47
Melbourne V,6005,4,13,5,11,46,42,4,44
Adelaide Utd,6005,5,11,6,11,37,40,-3,39
Brisbane,6005,6,10,5,13,33,42,-9,35
Western Sydn,6005,7,8,9,10,38,47,-9,33
Perth Glory,6005,8,10,2,15,37,50,-13,32
Wellington P,6005,9,5,6,16,31,55,-24,21
CC Mariners,6005,10,4,8,15,28,49,-21,20
Sydney FC,6006,1,21,4,3,67,23,44,67
N'castle Jet,6006,2,16,5,7,60,38,22,53
Melbourne C,6006,3,14,4,11,44,36,8,46
Melbourne V,6006,4,13,5,11,46,41,5,44
Adelaide Utd,6006,5,11,6,11,37,40,-3,39
Brisbane,6006,6,10,5,13,33,42,-9,35
Western Sydn,6006,7,8,9,10,38,47,-9,33
Perth Glory,6006,8,10,2,15,37,50,-13,32
Wellington P,6006,9,5,6,16,31,55,-24,21
CC Mariners,6006,10,4,8,15,28,49,-21,20
Sydney FC,6007,1,20,5,3,65,23,42,65
N'castle Jet,6007,2,15,6,7,58,38,20,51
Melbourne C,6007,3,14,5,10,44,34,10,47
Melbourne V,6007,4,13,6,10,46,39,7,45
Adelaide Utd,6007,5,11,6,11,37,40,-3,39
Brisbane,6007,6,10,5,13,33,42,-9,35
Western Sydn,6007,7,8,9,10,38,47,-9,33
Perth Glory,6007,8,10,2,15,37,50,-13,32
Wellington P,6007,9,5,6,16,31,55,-24,21
CC Mariners,6007,10,4,8,15,28,49,-21,20
Sydney FC,6008,1,20,4,4,64,23,41,64
N'castle Jet,6008,2,16,5,7,59,38,21,53
Melbourne V,6008,3,14,5,10,46,38,8,47
Melbourne C,6008,4,14,4,11,44,35,9,46
Adelaide Utd,6008,5,11,6,11,37,40,-3,39
Brisbane,6008,6,10,5,13,33,42,-9,35
Western Sydn,6008,7,8,9,10,38,47,-9,33
Perth Glory,6008,8,10,2,15,37,50,-13,32
Wellington P,6008,9,5,6,16,31,55,-24,21
CC Mariners,6008,10,4,8,15,28,49,-21,20
Sydney FC,6009,1,20,5,3,66,24,42,65
N'castle Jet,6009,2,16,5,7,59,37,22,53
Melbourne C,6009,3,14,4,11,43,35,8,46
Melbourne V,6009,4,13,6,10,47,40,7,45
Adelaide Utd,6009,5,11,6,11,37,40,-3,39
Brisbane,6009,6,10,5,13,33,42,-9,35
Western Sydn,6009,7,8,9,10,38,47,-9,33
Perth Glory,6009,8,10,2,15,37,50,-13,32
Wellington P,6009,9,5,6,16,31,55,-24,21
CC Mariners,6009,10,4,8,15,28,49,-21,20
Sydney FC,6010,1,20,5,3,66,24,42,65
N'castle Jet,6010,2,15,6,7,59,39,20,51
Melbourne C,6010,3,14,5,10,45,35,10,47
Melbourne V,6010,4,13,6,10,47,40,7,45
Adelaide Utd,6010,5,11,6,11,37,40,-3,39
Brisbane,6010,6,10,5,13,33,42,-9,35
Western Sydn,6010,7,8,9,10,38,47,-9,33
Perth Glory,6010,8,10,2,15,37,50,-13,32
Wellington P,6010,9,5,6,16,31,55,-24,21
CC Mariners,6010,10,4,8,15,28,49,-21,20
Sydney FC,6011,1,21,4,3,66,23,43,67
N'castle Jet,6011,2,16,5,7,59,38,21,53
Melbourne C,6011,3,14,4,11,44,35,9,46
Melbourne V,6011,4,13,5,11,46,40,6,44
Adelaide Utd,6011,5,11,6,11,37,40,-3,39
Brisbane,6011,6,10,5,13,33,42,-9,35
Western Sydn,6011,7,8,9,10,38,47,-9,33
Perth Glory,6011,8,10,2,15,37,50,-13,32
Wellington P,6011,9,5,6,16,31,55,-24,21
CC Mariners,6011,10,4,8,15,28,49,-21,20
Sydney FC,6012,1,20,5,3,65,23,42,65
N'castle Jet,6012,2,16,5,7,59,38,21,53
Melbourne C,6012,3,14,4,11,44,35,9,46
Melbourne V,6012,4,13,6,10,46,39,7,45
Adelaide Utd,6012,5,11,6,11,37,40,-3,39
Brisbane,6012,6,10,5,13,33,42,-9,35
Western Sydn,6012,7,8,9,10,38,47,-9,33
Perth Glory,6012,8,10,2,15,37,50,-13,32
Wellington P,6012,9,5,6,16,31,55,-24,21
CC Mariners,6012,10,4,8,15,28,49,-21,20
Sydney FC,6013,1,20,4,4,65,25,40,64
N'castle Jet,6013,2,16,5,7,59,38,21,53
Melbourne V,6013,3,14,5,10,48,39,9,47
Melbourne C,6013,4,14,4,11,44,35,9,46
Adelaide Utd,6013,5,11,6,11,37,40,-3,39
Brisbane,6013,6,10,5,13,33,42,-9,35
Western Sydn,6013,7,8,9,10,38,47,-9,33
Perth Glory,6013,8,10,2,15,37,50,-13,32
Wellington P,6013,9,5,6,16,31,55,-24,21
CC Mariners,6013,10,4,8,15,28,49,-21,20
Sydney FC,6014,1,20,5,3,66,24,42,65
N'castle Jet,6014,2,16,5,7,61,38,23,53
Melbourne C,6014,3,14,4,11,44,37,7,46
Melbourne V,6014,4,13,6,10,47,40,7,45
Adelaide Utd,6014,5,11,6,11,37,40,-3,39
Brisbane,6014,6,10,5,13,33,42,-9,35
Western Sydn,6014,7,8,9,10,38,47,-9,33
Perth Glory,6014,8,10,2,15,37,50,-13,32
Wellington P,6014,9,5,6,16,31,55,-24,21
CC Mariners,6014,10,4,8,15,28,49,-21,20
Sydney FC,6015,1,21,4,3,66,23,43,67
N'castle Jet,6015,2,15,6,7,59,39,20,51
Melbourne C,6015,3,14,5,10,45,35,10,47
Melbourne V,6015,4,13,5,11,46,40,6,44
Adelaide Utd,6015,5,11,6,11,37,40,-3,39
Brisbane,6015,6,10,5,13,33,42,-9,35
Western Sydn,6015,7,8,9,10,38,47,-9,33
Perth Glory,6015,8,10,2,15,37,50,-13,32
Wellington P,6015,9,5,6,16,31,55,-24,21
CC Mariners,6015,10,4,8,15,28,49,-21,20
Sydney FC,6016,1,20,5,3,65,23,42,65
N'castle Jet,6016,2,16,5,7,59,38,21,53
Melbourne C,6016,3,14,4,11,44,35,9,46
Melbourne V,6016,4,13,6,10,46,39,7,45
Adelaide Utd,6016,5,11,6,11,37,40,-3,39
Brisbane,6016,6,10,5,13,33,42,-9,35
Western Sydn,6016,7,8,9,10,38,47,-9,33
Perth Glory,6016,8,10,2,15,37,50,-13,32
Wellington P,6016,9,5,6,16,31,55,-24,21
CC Mariners,6016,10,4,8,15,28,49,-21,20
Sydney FC,6017,1,21,4,3,66,22,44,67
N'castle Jet,6017,2,16,5,7,60,37,23,53
Melbourne C,6017,3,14,4,11,43,36,7,46
Melbourne V,6017,4,13,5,11,45,40,5,44
Adelaide Utd,6017,5,11,6,11,37,40,-3,39
Brisbane,6017,6,10,5,13,33,42,-9,35
Western Sydn,6017,7,8,9,10,38,47,-9,33
Perth Glory,6017,8,10,2,15,37,50,-13,32
Wellington P,6017,9,5,6,16,31,55,-24,21
CC Mariners,6017,10,4,8,15,28,49,-21,20
Sydney FC,6018,1,20,4,4,64,23,41,64
N'castle Jet,6018,2,16,5,7,60,37,23,53
Melbourne V,6018,3,14,5,10,46,38,8,47
Melbourne C,6018,4,14,4,11,43,36,7,46
Adelaide Utd,6018,5,11,6,11,37,40,-3,39
Brisbane,6018,6,10,5,13,33,42,-9,35
Western Sydn,6018,7,8,9,10,38,47,-9,33
Perth Glory,6018,8,10,2,15,37,50,-13,32
Wellington P,6018,9,5,6,16,31,55,-24,21
CC Mariners,6018,10,4,8,15,28,49,-21,20
Sydney FC,6019,1,21,4,3,69,23,46,67
N'castle Jet,6019,2,16,5,7,59,38,21,53
Melbourne C,6019,3,14,4,11,44,35,9,46
Melbourne V,6019,4,13,5,11,46,43,3,44
Adelaide Utd,6019,5,11,6,11,37,40,-3,39
Brisbane,6019,6,10,5,13,33,42,-9,35
Western Sydn,6019,7,8,9,10,38,47,-9,33
Perth Glory,6019,8,10,2,15,37,50,-13,32
Wellington P,6019,9,5,6,16,31,55,-24,21
CC Mariners,6019,10,4,8,15,28,49,-21,20
Sydney FC,6020,1,20,5,3,65,23,42,65
N'castle Jet,6020,2,16,5,7,61,37,24,53
Melbourne C,6020,3,14,4,11,43,37,6,46
Melbourne V,6020,4,13,6,10,46,39,7,45
Adelaide Utd,6020,5,11,6,11,37,40,-3,39
Brisbane,6020,6,10,5,13,33,42,-9,35
Western Sydn,6020,7,8,9,10,38,47,-9,33
Perth Glory,6020,8,10,2,15,37,50,-13,32
Wellington P,6020,9,5,6,16,31,55,-24,21
CC Mariners,6020,10,4,8,15,28,49,-21,20
Sydney FC,6021,1,20,5,3,65,23,42,65
N'castle Jet,6021,2,15,5,8,58,40,18,50
Melbourne C,6021,3,15,4,10,46,34,12,49
Melbourne V,6021,4,13,6,10,46,39,7,45
Adelaide Utd,6021,5,11,6,11,37,40,-3,39
Brisbane,6021,6,10,5,13,33,42,-9,35
Western Sydn,6021,7,8,9,10,38,47,-9,33
Perth Glory,6021,8,10,2,15,37,50,-13,32
Wellington P,6021,9,5,6,16,31,55,-24,21
CC Mariners,6021,10,4,8,15,28,49,-21,20
Sydney FC,6022,1,21,4,3,65,22,43,67
N'castle Jet,6022,2,15,6,7,59,39,20,51
Melbourne C,6022,3,14,5,10,45,35,10,47
Melbourne V,6022,4,13,5,11,45,39,6,44
Adelaide Utd,6022,5,11,6,11,37,40,-3,39
Brisbane,6022,6,10,5,13,33,42,-9,35
Western Sydn,6022,7,8,9,10,38,47,-9,33
Perth Glory,6022,8,10,2,15,37,50,-13,32
Wellington P,6022,9,5,6,16,31,55,-24,21
CC Mariners,6022,10,4,8,15,28,49,-21,20
Sydney FC,6023,1,21,4,3,67,24,43,67
N'castle Jet,6023,2,15,5,8,57,39,18,50
Melbourne C,6023,3,15,4,10,45,33,12,49
Melbourne V,6023,4,13,5,11,47,41,6,44
Adelaide Utd,6023,5,11,6,11,37,40,-3,39
Brisbane,6023,6,10,5,13,33,42,-9,35
Western Sydn,6023,7,8,9,10,38,47,-9,33
Perth Glory,6023,8,10,2,15,37,50,-13,32
Wellington P,6023,9,5,6,16,31,55,-24,21
CC Mariners,6023,10,4,8,15,28,49,-21,20
Sydney FC,6024,1,21,4,3,65,22,43,67
N'castle Jet,6024,2,15,6,7,58,38,20,51
Melbourne C,6024,3,14,5,10,44,34,10,47
Melbourne V,6024,4,13,5,11,45,39,6,44
Adelaide Utd,6024,5,11,6,11,37,40,-3,39
Brisbane,6024,6,10,5,13,33,42,-9,35
Western Sydn,6024,7,8,9,10,38,47,-9,33
Perth Glory,6024,8,10,2,15,37,50,-13,32
Wellington P,6024,9,5,6,16,31,55,-24,21
CC Mariners,6024,10,4,8,15,28,49,-21,20
Sydney FC,6025,1,20,4,4,64,23,41,64
N'castle Jet,6025,2,16,5,7,59,37,22,53
Melbourne V,6025,3,14,5,10,46,38,8,47
Melbourne C,6025,4,14,4,11,43,35,8,46
Adelaide Utd,6025,5,11,6,11,37,40,-3,39
Brisbane,6025,6,10,5,13,33,42,-9,35
Western Sydn,6025,7,8,9,10,38,47,-9,33
Perth Glory,6025,8,10,2,15,37,50,-13,32
Wellington P,6025,9,5,6,16,31,55,-24,21
CC Mariners,6025,10,4,8,15,28,49,-21,20
Sydney FC,6026,1,21,4,3,67,22,45,67
N'castle Jet,6026,2,15,5,8,58,39,19,50
Melbourne C,6026,3,15,4,10,45,34,11,49
Melbourne V,6026,4,13,5,11,45,41,4,44
Adelaide Utd,6026,5,11,6,11,37,40,-3,39
Brisbane,6026,6,10,5,13,33,42,-9,35
Western Sydn,6026,7,8,9,10,38,47,-9,33
Perth Glory,6026,8,10,2,15,37,50,-13,32
Wellington P,6026,9,5,6,16,31,55,-24,21
CC Mariners,6026,10,4,8,15,28,49,-21,20
Sydney FC,6027,1,21,4,3,66,22,44,67
N'castle Jet,6027,2,15,5,8,57,40,17,50
Melbourne C,6027,3,15,4,10,46,33,13,49
Melbourne V,6027,4,13,5,11,45,40,5,44
Adelaide Utd,6027,5,11,6,11,37,40,-3,39
Brisbane,6027,6,10,5,13,33,42,-9,35
Western Sydn,6027,7,8,9,10,38,47,-9,33
Perth Glory,6027,8,10,2,15,37,50,-13,32
Wellington P,6027,9,5,6,16,31,55,-24,21
CC Mariners,6027,10,4,8,15,28,49,-21,20
Sydney FC,6028,1,21,4,3,66,23,43,67
N'castle Jet,6028,2,15,5,8,57,39,18,50
Melbourne C,6028,3,15,4,10,45,33,12,49
Melbourne V,6028,4,13,5,11,46,40,6,44
Adelaide Utd,6028,5,11,6,11,37,40,-3,39
Brisbane,6028,6,10,5,13,33,42,-9,35
Western Sydn,6028,7,8,9,10,38,47,-9,33
Perth Glory,6028,8,10,2,15,37,50,-13,32
Wellington P,6028,9,5,6,16,31,55,-24,21
CC Mariners,6028,10,4,8,15,28,49,-21,20
Sydney FC,6029,1,21,4,3,68,22,46,67
N'castle Jet,6029,2,16,5,7,58,37,21,53
Melbourne C,6029,3,14,4,11,43,34,9,46
Melbourne V,6029,4,13,5,11,45,42,3,44
Adelaide Utd,6029,5,11,6,11,37,40,-3,39
Brisbane,6029,6,10,5,13,33,42,-9,35
Western Sydn,6029,7,8,9,10,38,47,-9,33
Perth Glory,6029,8,10,2,15,37,50,-13,32
Wellington P,6029,9,5,6,16,31,55,-24,21
CC Mariners,6029,10,4,8,15,28,49,-21,20
Sydney FC,6030,1,21,4,3,66,22,44,67
N'castle Jet,6030,2,15,5,8,57,40,17,50
Melbourne C,6030,3,15,4,10,46,33,13,49
Melbourne V,6030,4,13,5,11,45,40,5,44
Adelaide Utd,6030,5,11,6,11,37,40,-3,39
Brisbane,6030,6,10,5,13,33,42,-9,35
Western Sydn,6030,7,8,9,10,38,47,-9,33
Perth Glory,6030,8,10,2,15,37,50,-13,32
Wellington P,6030,9,5,6,16,31,55,-24,21
CC Mariners,6030,10,4,8,15,28,49,-21,20
Sydney FC,6031,1,21,4,3,66,22,44,67
N'castle Jet,6031,2,16,5,7,59,38,21,53
Melbourne C,6031,3,14,4,11,44,35,9,46
Melbourne V,6031,4,13,5,11,45,40,5,44
Adelaide Utd,6031,5,11,6,11,37,40,-3,39
Brisbane,6031,6,10,5,13,33,42,-9,35
Western Sydn,6031,7,8,9,10,38,47,-9,33
Perth Glory,6031,8,10,2,15,37,50,-13,32
Wellington P,6031,9,5,6,16,31,55,-24,21
CC Mariners,6031,10,4,8,15,28,49,-21,20
Sydney FC,6032,1,21,4,3,69,25,44,67
N'castle Jet,6032,2,15,5,8,57,38,19,50
Melbourne C,6032,3,15,4,10,44,33,11,49
Melbourne V,6032,4,13,5,11,48,43,5,44
Adelaide Utd,6032,5,11,6,11,37,40,-3,39
Brisbane,6032,6,10,5,13,33,42,-9,35
Western Sydn,6032,7,8,9,10,38,47,-9,33
Perth Glory,6032,8,10,2,15,37,50,-13,32
Wellington P,6032,9,5,6,16,31,55,-24,21
CC Mariners,6032,10,4,8,15,28,49,-21,20
Sydney FC,6033,1,21,4,3,65,22,43,67
N'castle Jet,6033,2,15,5,8,58,39,19,50
Melbourne C,6033,3,15,4,10,45,34,11,49
Melbourne V,6033,4,13,5,11,45,39,6,44
Adelaide Utd,6033,5,11,6,11,37,40,-3,39
Brisbane,6033,6,10,5,13,33,42,-9,35
Western Sydn,6033,7,8,9,10,38,47,-9,33
Perth Glory,6033,8,10,2,15,37,50,-13,32
Wellington P,6033,9,5,6,16,31,55,-24,21
CC Mariners,6033,10,4,8,15,28,49,-21,20
Sydney FC,6034,1,21,4,3,65,22,43,67
N'castle Jet,6034,2,15,6,7,58,38,20,51
Melbourne C,6034,3,14,5,10,44,34,10,47
Melbourne V,6034,4,13,5,11,45,39,6,44
Adelaide Utd,6034,5,11,6,11,37,40,-3,39
Brisbane,6034,6,10,5,13,33,42,-9,35
Western Sydn,6034,7,8,9,10,38,47,-9,33
Perth Glory,6034,8,10,2,15,37,50,-13,32
Wellington P,6034,9,5,6,16,31,55,-24,21
CC Mariners,6034,10,4,8,15,28,49,-21,20
Sydney FC,6035,1,20,5,3,66,24,42,65
N'castle Jet,6035,2,16,5,7,60,37,23,53
Melbourne C,6035,3,14,4,11,43,36,7,46
Melbourne V,6035,4,13,6,10,47,40,7,45
Adelaide Utd,6035,5,11,6,11,37,40,-3,39
Brisbane,6035,6,10,5,13,33,42,-9,35
Western Sydn,6035,7,8,9,10,38,47,-9,33
Perth Glory,6035,8,10,2,15,37,50,-13,32
Wellington P,6035,9,5,6,16,31,55,-24,21
CC Mariners,6035,10,4,8,15,28,49,-21,20
Sydney FC,6036,1,21,4,3,67,23,44,67
N'castle Jet,6036,2,16,5,7,63,39,24,53
Melbourne C,6036,3,14,4,11,45,39,6,46
Melbourne V,6036,4,13,5,11,46,41,5,44
Adelaide Utd,6036,5,11,6,11,37,40,-3,39
Brisbane,6036,6,10,5,13,33,42,-9,35
Western Sydn,6036,7,8,9,10,38,47,-9,33
Perth Glory,6036,8,10,2,15,37,50,-13,32
Wellington P,6036,9,5,6,16,31,55,-24,21
CC Mariners,6036,10,4,8,15,28,49,-21,20
Sydney FC,6037,1,21,4,3,66,23,43,67
N'castle Jet,6037,2,15,6,7,58,38,20,51
Melbourne C,6037,3,14,5,10,44,34,10,47
Melbourne V,6037,4,13,5,11,46,40,6,44
Adelaide Utd,6037,5,11,6,11,37,40,-3,39
Brisbane,6037,6,10,5,13,33,42,-9,35
Western Sydn,6037,7,8,9,10,38,47,-9,33
Perth Glory,6037,8,10,2,15,37,50,-13,32
Wellington P,6037,9,5,6,16,31,55,-24,21
CC Mariners,6037,10,4,8,15,28,49,-21,20
Sydney FC,6038,1,20,5,3,65,23,42,65
N'castle Jet,6038,2,15,5,8,57,39,18,50
Melbourne C,6038,3,15,4,10,45,33,12,49
Melbourne V,6038,4,13,6,10,46,39,7,45
Adelaide Utd,6038,5,11,6,11,37,40,-3,39
Brisbane,6038,6,10,5,13,33,42,-9,35
Western Sydn,6038,7,8,9,10,38,47,-9,33
Perth Glory,6038,8,10,2,15,37,50,-13,32
Wellington P,6038,9,5,6,16,31,55,-24,21
CC Mariners,6038,10,4,8,15,28,49,-21,20
Sydney FC,6039,1,20,4,4,65,27,38,64
N'castle Jet,6039,2,16,5,7,62,38,24,53
Melbourne V,6039,3,14,5,10,50,39,11,47
Melbourne C,6039,4,14,4,11,44,38,6,46
Adelaide Utd,6039,5,11,6,11,37,40,-3,39
Brisbane,6039,6,10,5,13,33,42,-9,35
Western Sydn,6039,7,8,9,10,38,47,-9,33
Perth Glory,6039,8,10,2,15,37,50,-13,32
Wellington P,6039,9,5,6,16,31,55,-24,21
CC Mariners,6039,10,4,8,15,28,49,-21,20
Sydney FC,6040,1,21,4,3,66,22,44,67
N'castle Jet,6040,2,15,5,8,57,38,19,50
Melbourne C,6040,3,15,4,10,44,33,11,49
Melbourne V,6040,4,13,5,11,45,40,5,44
Adelaide Utd,6040,5,11,6,11,37,40,-3,39
Brisbane,6040,6,10,5,13,33,42,-9,35
Western Sydn,6040,7,8,9,10,38,47,-9,33
Perth Glory,6040,8,10,2,15,37,50,-13,32
Wellington P,6040,9,5,6,16,31,55,-24,21
CC Mariners,6040,10,4,8,15,28,49,-21,20
Sydney FC,6041,1,20,4,4,64,23,41,64
N'castle Jet,6041,2,15,5,8,57,38,19,50
Melbourne C,6041,3,15,4,10,44,33,11,49
Melbourne V,6041,4,14,5,10,46,38,8,47
Adelaide Utd,6041,5,11,6,11,37,40,-3,39
Brisbane,6041,6,10,5,13,33,42,-9,35
Western Sydn,6041,7,8,9,10,38,47,-9,33
Perth Glory,6041,8,10,2,15,37,50,-13,32
Wellington P,6041,9,5,6,16,31,55,-24,21
CC Mariners,6041,10,4,8,15,28,49,-21,20
Sydney FC,6042,1,20,4,4,65,24,41,64
N'castle Jet,6042,2,15,6,7,58,38,20,51
Melbourne C,6042,3,14,5,10,44,34,10,47
Melbourne V,6042,4,14,5,10,47,39,8,47
Adelaide Utd,6042,5,11,6,11,37,40,-3,39
Brisbane,6042,6,10,5,13,33,42,-9,35
Western Sydn,6042,7,8,9,10,38,47,-9,33
Perth Glory,6042,8,10,2,15,37,50,-13,32
Wellington P,6042,9,5,6,16,31,55,-24,21
CC Mariners,6042,10,4,8,15,28,49,-21,20
Sydney FC,6043,1,21,4,3,67,22,45,67
N'castle Jet,6043,2,16,5,7,58,37,21,53
Melbourne C,6043,3,14,4,11,43,34,9,46
Melbourne V,6043,4,13,5,11,45,41,4,44
Adelaide Utd,6043,5,11,6,11,37,40,-3,39
Brisbane,6043,6,10,5,13,33,42,-9,35
Western Sydn,6043,7,8,9,10,38,47,-9,33
Perth Glory,6043,8,10,2,15,37,50,-13,32
Wellington P,6043,9,5,6,16,31,55,-24,21
CC Mariners,6043,10,4,8,15,28,49,-21,20
Sydney FC,6044,1,20,5,3,65,23,42,65
N'castle Jet,6044,2,15,6,7,58,38,20,51
Melbourne C,6044,3,14,5,10,44,34,10,47
Melbourne V,6044,4,13,6,10,46,39,7,45
Adelaide Utd,6044,5,11,6,11,37,40,-3,39
Brisbane,6044,6,10,5,13,33,42,-9,35
Western Sydn,6044,7,8,9,10,38,47,-9,33
Perth Glory,6044,8,10,2,15,37,50,-13,32
Wellington P,6044,9,5,6,16,31,55,-24,21
CC Mariners,6044,10,4,8,15,28,49,-21,20
Sydney FC,6045,1,21,4,3,71,22,49,67
N'castle Jet,6045,2,15,5,8,58,39,19,50
Melbourne C,6045,3,15,4,10,45,34,11,49
Melbourne V,6045,4,13,5,11,45,45,0,44
Adelaide Utd,6045,5,11,6,11,37,40,-3,39
Brisbane,6045,6,10,5,13,33,42,-9,35
Western Sydn,6045,7,8,9,10,38,47,-9,33
Perth Glory,6045,8,10,2,15,37,50,-13,32
Wellington P,6045,9,5,6,16,31,55,-24,21
CC Mariners,6045,10,4,8,15,28,49,-21,20
Sydney FC,6046,1,20,4,4,64,25,39,64
N'castle Jet,6046,2,15,6,7,58,38,20,51
Melbourne V,6046,3,14,5,10,48,38,10,47
Melbourne C,6046,4,14,5,10,44,34,10,47
Adelaide Utd,6046,5,11,6,11,37,40,-3,39
Brisbane,6046,6,10,5,13,33,42,-9,35
Western Sydn,6046,7,8,9,10,38,47,-9,33
Perth Glory,6046,8,10,2,15,37,50,-13,32
Wellington P,6046,9,5,6,16,31,55,-24,21
CC Mariners,6046,10,4,8,15,28,49,-21,20
Sydney FC,6047,1,21,4,3,67,22,45,67
N'castle Jet,6047,2,16,5,7,60,37,23,53
Melbourne C,6047,3,14,4,11,43,36,7,46
Melbourne V,6047,4,13,5,11,45,41,4,44
Adelaide Utd,6047,5,11,6,11,37,40,-3,39
Brisbane,6047,6,10,5,13,33,42,-9,35
Western Sydn,6047,7,8,9,10,38,47,-9,33
Perth Glory,6047,8,10,2,15,37,50,-13,32
Wellington P,6047,9,5,6,16,31,55,-24,21
CC Mariners,6047,10,4,8,15,28,49,-21,20
Sydney FC,6048,1,21,4,3,66,23,43,67
N'castle Jet,6048,2,16,5,7,59,38,21,53
Melbourne C,6048,3,14,4,11,44,35,9,46
Melbourne V,6048,4,13,5,11,46,40,6,44
Adelaide Utd,6048,5,11,6,11,37,40,-3,39
Brisbane,6048,6,10,5,13,33,42,-9,35
Western Sydn,6048,7,8,9,10,38,47,-9,33
Perth Glory,6048,8,10,2,15,37,50,-13,32
Wellington P,6048,9,5,6,16,31,55,-24,21
CC Mariners,6048,10,4,8,15,28,49,-21,20
Sydney FC,6049,1,20,4,4,64,23,41,64
N'castle Jet,6049,2,15,5,8,58,41,17,50
Melbourne C,6049,3,15,4,10,47,34,13,49
Melbourne V,6049,4,14,5,10,46,38,8,47
Adelaide Utd,6049,5,11,6,11,37,40,-3,39
Brisbane,6049,6,10,5,13,33,42,-9,35
Western Sydn,6049,7,8,9,10,38,47,-9,33
Perth Glory,6049,8,10,2,15,37,50,-13,32
Wellington P,6049,9,5,6,16,31,55,-24,21
CC Mariners,6049,10,4,8,15,28,49,-21,20
Sydney FC,6050,1,20,4,4,64,23,41,64
N'castle Jet,6050,2,15,5,8,57,39,18,50
Melbourne C,6050,3,15,4,10,45,33,12,49
Melbourne V,6050,4,14,5,10,46,38,8,47
Adelaide Utd,6050,5,11,6,11,37,40,-3,39
Brisbane,6050,6,10,5,13,33,42,-9,35
Western Sydn,6050,7,8,9,10,38,47,-9,33
Perth Glory,6050,8,10,2,15,37,50,-13,32
Wellington P,6050,9,5,6,16,31,55,-24,21
CC Mariners,6050,10,4,8,15,28,49,-21,20
Sydney FC,6051,1,20,4,4,64,23,41,64
N'castle Jet,6051,2,15,5,8,58,40,18,50
Melbourne C,6051,3,15,4,10,46,34,12,49
Melbourne V,6051,4,14,5,10,46,38,8,47
Adelaide Utd,6051,5,11,6,11,37,40,-3,39
Brisbane,6051,6,10,5,13,33,42,-9,35
Western Sydn,6051,7,8,9,10,38,47,-9,33
Perth Glory,6051,8,10,2,15,37,50,-13,32
Wellington P,6051,9,5,6,16,31,55,-24,21
CC Mariners,6051,10,4,8,15,28,49,-21,20
Sydney FC,6052,1,21,4,3,67,24,43,67
N'castle Jet,6052,2,15,5,8,57,38,19,50
Melbourne C,6052,3,15,4,10,44,33,11,49
Melbourne V,6052,4,13,5,11,47,41,6,44
Adelaide Utd,6052,5,11,6,11,37,40,-3,39
Brisbane,6052,6,10,5,13,33,42,-9,35
Western Sydn,6052,7,8,9,10,38,47,-9,33
Perth Glory,6052,8,10,2,15,37,50,-13,32
Wellington P,6052,9,5,6,16,31,55,-24,21
CC Mariners,6052,10,4,8,15,28,49,-21,20
Sydney FC,6053,1,20,4,4,64,23,41,64
N'castle Jet,6053,2,16,5,7,59,38,21,53
Melbourne V,6053,3,14,5,10,46,38,8,47
Melbourne C,6053,4,14,4,11,44,35,9,46
Adelaide Utd,6053,5,11,6,11,37,40,-3,39
Brisbane,6053,6,10,5,13,33,42,-9,35
Western Sydn,6053,7,8,9,10,38,47,-9,33
Perth Glory,6053,8,10,2,15,37,50,-13,32
Wellington P,6053,9,5,6,16,31,55,-24,21
CC Mariners,6053,10,4,8,15,28,49,-21,20
Sydney FC,6054,1,21,4,3,67,22,45,67
N'castle Jet,6054,2,16,5,7,61,38,23,53
Melbourne C,6054,3,14,4,11,44,37,7,46
Melbourne V,6054,4,13,5,11,45,41,4,44
Adelaide Utd,6054,5,11,6,11,37,40,-3,39
Brisbane,6054,6,10,5,13,33,42,-9,35
Western Sydn,6054,7,8,9,10,38,47,-9,33
Perth Glory,6054,8,10,2,15,37,50,-13,32
Wellington P,6054,9,5,6,16,31,55,-24,21
CC Mariners,6054,10,4,8,15,28,49,-21,20
Sydney FC,6055,1,21,4,3,69,24,45,67
N'castle Jet,6055,2,16,5,7,59,37,22,53
Melbourne C,6055,3,14,4,11,43,35,8,46
Melbourne V,6055,4,13,5,11,47,43,4,44
Adelaide Utd,6055,5,11,6,11,37,40,-3,39
Brisbane,6055,6,10,5,13,33,42,-9,35
Western Sydn,6055,7,8,9,10,38,47,-9,33
Perth Glory,6055,8,10,2,15,37,50,-13,32
Wellington P,6055,9,5,6,16,31,55,-24,21
CC Mariners,6055,10,4,8,15,28,49,-21,20
Sydney FC,6056,1,21,4,3,67,23,44,67
N'castle Jet,6056,2,15,6,7,60,40,20,51
Melbourne C,6056,3,14,5,10,46,36,10,47
Melbourne V,6056,4,13,5,11,46,41,5,44
Adelaide Utd,6056,5,11,6,11,37,40,-3,39
Brisbane,6056,6,10,5,13,33,42,-9,35
Western Sydn,6056,7,8,9,10,38,47,-9,33
Perth Glory,6056,8,10,2,15,37,50,-13,32
Wellington P,6056,9,5,6,16,31,55,-24,21
CC Mariners,6056,10,4,8,15,28,49,-21,20
Sydney FC,6057,1,21,4,3,65,22,43,67
N'castle Jet,6057,2,15,5,8,58,39,19,50
Melbourne C,6057,3,15,4,10,45,34,11,49
Melbourne V,6057,4,13,5,11,45,39,6,44
Adelaide Utd,6057,5,11,6,11,37,40,-3,39
Brisbane,6057,6,10,5,13,33,42,-9,35
Western Sydn,6057,7,8,9,10,38,47,-9,33
Perth Glory,6057,8,10,2,15,37,50,-13,32
Wellington P,6057,9,5,6,16,31,55,-24,21
CC Mariners,6057,10,4,8,15,28,49,-21,20
Sydney FC,6058,1,20,4,4,65,24,41,64
N'castle Jet,6058,2,16,5,7,59,38,21,53
Melbourne V,6058,3,14,5,10,47,39,8,47
Melbourne C,6058,4,14,4,11,44,35,9,46
Adelaide Utd,6058,5,11,6,11,37,40,-3,39
Brisbane,6058,6,10,5,13,33,42,-9,35
Western Sydn,6058,7,8,9,10,38,47,-9,33
Perth Glory,6058,8,10,2,15,37,50,-13,32
Wellington P,6058,9,5,6,16,31,55,-24,21
CC Mariners,6058,10,4,8,15,28,49,-21,20
Sydney FC,6059,1,20,5,3,64,22,42,65
N'castle Jet,6059,2,15,6,7,60,40,20,51
Melbourne C,6059,3,14,5,10,46,36,10,47
Melbourne V,6059,4,13,6,10,45,38,7,45
Adelaide Utd,6059,5,11,6,11,37,40,-3,39
Brisbane,6059,6,10,5,13,33,42,-9,35
Western Sydn,6059,7,8,9,10,38,47,-9,33
Perth Glory,6059,8,10,2,15,37,50,-13,32
Wellington P,6059,9,5,6,16,31,55,-24,21
CC Mariners,6059,10,4,8,15,28,49,-21,20
Sydney FC,6060,1,20,5,3,67,25,42,65
N'castle Jet,6060,2,15,5,8,58,40,18,50
Melbourne C,6060,3,15,4,10,46,34,12,49
Melbourne V,6060,4,13,6,10,48,41,7,45
Adelaide Utd,6060,5,11,6,11,37,40,-3,39
Brisbane,6060,6,10,5,13,33,42,-9,35
Western Sydn,6060,7,8,9,10,38,47,-9,33
Perth Glory,6060,8,10,2,15,37,50,-13,32
Wellington P,6060,9,5,6,16,31,55,-24,21
CC Mariners,6060,10,4,8,15,28,49,-21,20
Sydney FC,6061,1,21,4,3,66,23,43,67
N'castle Jet,6061,2,16,5,7,61,40,21,53
Melbourne C,6061,3,14,4,11,46,37,9,46
Melbourne V,6061,4,13,5,11,46,40,6,44
Adelaide Utd,6061,5,11,6,11,37,40,-3,39
Brisbane,6061,6,10,5,13,33,42,-9,35
Western Sydn,6061,7,8,9,10,38,47,-9,33
Perth Glory,6061,8,10,2,15,37,50,-13,32
Wellington P,6061,9,5,6,16,31,55,-24,21
CC Mariners,6061,10,4,8,15,28,49,-21,20
Sydney FC,6062,1,20,5,3,68,26,42,65
N'castle Jet,6062,2,15,5,8,58,39,19,50
Melbourne C,6062,3,15,4,10,45,34,11,49
Melbourne V,6062,4,13,6,10,49,42,7,45
Adelaide Utd,6062,5,11,6,11,37,40,-3,39
Brisbane,6062,6,10,5,13,33,42,-9,35
Western Sydn,6062,7,8,9,10,38,47,-9,33
Perth Glory,6062,8,10,2,15,37,50,-13,32
Wellington P,6062,9,5,6,16,31,55,-24,21
CC Mariners,6062,10,4,8,15,28,49,-21,20
Sydney FC,6063,1,21,4,3,66,22,44,67
N'castle Jet,6063,2,15,6,7,58,38,20,51
Melbourne C,6063,3,14,5,10,44,34,10,47
Melbourne V,6063,4,13,5,11,45,40,5,44
Adelaide Utd,6063,5,11,6,11,37,40,-3,39
Brisbane,6063,6,10,5,13,33,42,-9,35
Western Sydn,6063,7,8,9,10,38,47,-9,33
Perth Glory,6063,8,10,2,15,37,50,-13,32
Wellington P,6063,9,5,6,16,31,55,-24,21
CC Mariners,6063,10,4,8,15,28,49,-21,20
Sydney FC,6064,1,21,4,3,66,23,43,67
N'castle Jet,6064,2,16,5,7,58,37,21,53
Melbourne C,6064,3,14,4,11,43,34,9,46
Melbourne V,6064,4,13,5,11,46,40,6,44
Adelaide Utd,6064,5,11,6,11,37,40,-3,39
Brisbane,6064,6,10,5,13,33,42,-9,35
Western Sydn,6064,7,8,9,10,38,47,-9,33
Perth Glory,6064,8,10,2,15,37,50,-13,32
Wellington P,6064,9,5,6,16,31,55,-24,21
CC Mariners,6064,10,4,8,15,28,49,-21,20
Sydney FC,6065,1,20,5,3,64,22,42,65
N'castle Jet,6065,2,16,5,7,60,38,22,53
Melbourne C,6065,3,14,4,11,44,36,8,46
Melbourne V,6065,4,13,6,10,45,38,7,45
Adelaide Utd,6065,5,11,6,11,37,40,-3,39
Brisbane,6065,6,10,5,13,33,42,-9,35
Western Sydn,6065,7,8,9,10,38,47,-9,33
Perth Glory,6065,8,10,2,15,37,50,-13,32
Wellington P,6065,9,5,6,16,31,55,-24,21
CC Mariners,6065,10,4,8,15,28,49,-21,20
Sydney FC,6066,1,20,5,3,66,24,42,65
N'castle Jet,6066,2,15,5,8,58,39,19,50
Melbourne C,6066,3,15,4,10,45,34,11,49
Melbourne V,6066,4,13,6,10,47,40,7,45
Adelaide Utd,6066,5,11,6,11,37,40,-3,39
Brisbane,6066,6,10,5,13,33,42,-9,35
Western Sydn,6066,7,8,9,10,38,47,-9,33
Perth Glory,6066,8,10,2,15,37,50,-13,32
Wellington P,6066,9,5,6,16,31,55,-24,21
CC Mariners,6066,10,4,8,15,28,49,-21,20
Sydney FC,6067,1,20,4,4,64,24,40,64
N'castle Jet,6067,2,15,5,8,58,41,17,50
Melbourne C,6067,3,15,4,10,47,34,13,49
Melbourne V,6067,4,14,5,10,47,38,9,47
Adelaide Utd,6067,5,11,6,11,37,40,-3,39
Brisbane,6067,6,10,5,13,33,42,-9,35
Western Sydn,6067,7,8,9,10,38,47,-9,33
Perth Glory,6067,8,10,2,15,37,50,-13,32
Wellington P,6067,9,5,6,16,31,55,-24,21
CC Mariners,6067,10,4,8,15,28,49,-21,20
Sydney FC,6068,1,21,4,3,67,23,44,67
N'castle Jet,6068,2,16,5,7,61,37,24,53
Melbourne C,6068,3,14,4,11,43,37,6,46
Melbourne V,6068,4,13,5,11,46,41,5,44
Adelaide Utd,6068,5,11,6,11,37,40,-3,39
Brisbane,6068,6,10,5,13,33,42,-9,35
Western Sydn,6068,7,8,9,10,38,47,-9,33
Perth Glory,6068,8,10,2,15,37,50,-13,32
Wellington P,6068,9,5,6,16,31,55,-24,21
CC Mariners,6068,10,4,8,15,28,49,-21,20
Sydney FC,6069,1,21,4,3,65,22,43,67
N'castle Jet,6069,2,15,5,8,59,40,19,50
Melbourne C,6069,3,15,4,10,46,35,11,49
Melbourne V,6069,4,13,5,11,45,39,6,44
Adelaide Utd,6069,5,11,6,11,37,40,-3,39
Brisbane,6069,6,10,5,13,33,42,-9,35
Western Sydn,6069,7,8,9,10,38,47,-9,33
Perth Glory,6069,8,10,2,15,37,50,-13,32
Wellington P,6069,9,5,6,16,31,55,-24,21
CC Mariners,6069,10,4,8,15,28,49,-21,20
Sydney FC,6070,1,20,5,3,65,23,42,65
N'castle Jet,6070,2,15,6,7,58,38,20,51
Melbourne C,6070,3,14,5,10,44,34,10,47
Melbourne V,6070,4,13,6,10,46,39,7,45
Adelaide Utd,6070,5,11,6,11,37,40,-3,39
Brisbane,6070,6,10,5,13,33,42,-9,35
Western Sydn,6070,7,8,9,10,38,47,-9,33
Perth Glory,6070,8,10,2,15,37,50,-13,32
Wellington P,6070,9,5,6,16,31,55,-24,21
CC Mariners,6070,10,4,8,15,28,49,-21,20
Sydney FC,6071,1,20,4,4,64,25,39,64
N'castle Jet,6071,2,16,5,7,60,37,23,53
Melbourne V,6071,3,14,5,10,48,38,10,47
Melbourne C,6071,4,14,4,11,43,36,7,46
Adelaide Utd,6071,5,11,6,11,37,40,-3,39
Brisbane,6071,6,10,5,13,33,42,-9,35
Western Sydn,6071,7,8,9,10,38,47,-9,33
Perth Glory,6071,8,10,2,15,37,50,-13,32
Wellington P,6071,9,5,6,16,31,55,-24,21
CC Mariners,6071,10,4,8,15,28,49,-21,20
Sydney FC,6072,1,20,5,3,64,22,42,65
N'castle Jet,6072,2,15,6,7,58,38,20,51
Melbourne C,6072,3,14,5,10,44,34,10,47
Melbourne V,6072,4,13,6,10,45,38,7,45
Adelaide Utd,6072,5,11,6,11,37,40,-3,39
Brisbane,6072,6,10,5,13,33,42,-9,35
Western Sydn,6072,7,8,9,10,38,47,-9,33
Perth Glory,6072,8,10,2,15,37,50,-13,32
Wellington P,6072,9,5,6,16,31,55,-24,21
CC Mariners,6072,10,4,8,15,28,49,-21,20
Sydney FC,6073,1,21,4,3,65,22,43,67
N'castle Jet,6073,2,16,5,7,59,37,22,53
Melbourne C,6073,3,14,4,11,43,35,8,46
Melbourne V,6073,4,13,5,11,45,39,6,44
Adelaide Utd,6073,5,11,6,11,37,40,-3,39
Brisbane,6073,6,10,5,13,33,42,-9,35
Western Sydn,6073,7,8,9,10,38,47,-9,33
Perth Glory,6073,8,10,2,15,37,50,-13,32
Wellington P,6073,9,5,6,16,31,55,-24,21
CC Mariners,6073,10,4,8,15,28,49,-21,20
Sydney FC,6074,1,21,4,3,66,22,44,67
N'castle Jet,6074,2,15,5,8,58,39,19,50
Melbourne C,6074,3,15,4,10,45,34,11,49
Melbourne V,6074,4,13,5,11,45,40,5,44
Adelaide Utd,6074,5,11,6,11,37,40,-3,39
Brisbane,6074,6,10,5,13,33,42,-9,35
Western Sydn,6074,7,8,9,10,38,47,-9,33
Perth Glory,6074,8,10,2,15,37,50,-13,32
Wellington P,6074,9,5,6,16,31,55,-24,21
CC Mariners,6074,10,4,8,15,28,49,-21,20
Sydney FC,6075,1,20,5,3,64,22,42,65
N'castle Jet,6075,2,16,5,7,59,37,22,53
Melbourne C,6075,3,14,4,11,43,35,8,46
Melbourne V,6075,4,13,6,10,45,38,7,45
Adelaide Utd,6075,5,11,6,11,37,40,-3,39
Brisbane,6075,6,10,5,13,33,42,-9,35
Western Sydn,6075,7,8,9,10,38,47,-9,33
Perth Glory,6075,8,10,2,15,37,50,-13,32
Wellington P,6075,9,5,6,16,31,55,-24,21
CC Mariners,6075,10,4,8,15,28,49,-21,20
Sydney FC,6076,1,20,4,4,65,24,41,64
N'castle Jet,6076,2,15,6,7,59,39,20,51
Melbourne C,6076,3,14,5,10,45,35,10,47
Melbourne V,6076,4,14,5,10,47,39,8,47
Adelaide Utd,6076,5,11,6,11,37,40,-3,39
Brisbane,6076,6,10,5,13,33,42,-9,35
Western Sydn,6076,7,8,9,10,38,47,-9,33
Perth Glory,6076,8,10,2,15,37,50,-13,32
Wellington P,6076,9,5,6,16,31,55,-24,21
CC Mariners,6076,10,4,8,15,28,49,-21,20
Sydney FC,6077,1,20,5,3,65,23,42,65
N'castle Jet,6077,2,16,5,7,59,37,22,53
Melbourne C,6077,3,14,4,11,43,35,8,46
Melbourne V,6077,4,13,6,10,46,39,7,45
Adelaide Utd,6077,5,11,6,11,37,40,-3,39
Brisbane,6077,6,10,5,13,33,42,-9,35
Western Sydn,6077,7,8,9,10,38,47,-9,33
Perth Glory,6077,8,10,2,15,37,50,-13,32
Wellington P,6077,9,5,6,16,31,55,-24,21
CC Mariners,6077,10,4,8,15,28,49,-21,20
Sydney FC,6078,1,21,4,3,68,23,45,67
N'castle Jet,6078,2,15,5,8,59,41,18,50
Melbourne C,6078,3,15,4,10,47,35,12,49
Melbourne V,6078,4,13,5,11,46,42,4,44
Adelaide Utd,6078,5,11,6,11,37,40,-3,39
Brisbane,6078,6,10,5,13,33,42,-9,35
Western Sydn,6078,7,8,9,10,38,47,-9,33
Perth Glory,6078,8,10,2,15,37,50,-13,32
Wellington P,6078,9,5,6,16,31,55,-24,21
CC Mariners,6078,10,4,8,15,28,49,-21,20
Sydney FC,6079,1,20,4,4,64,23,41,64
N'castle Jet,6079,2,16,5,7,58,37,21,53
Melbourne V,6079,3,14,5,10,46,38,8,47
Melbourne C,6079,4,14,4,11,43,34,9,46
Adelaide Utd,6079,5,11,6,11,37,40,-3,39
Brisbane,6079,6,10,5,13,33,42,-9,35
Western Sydn,6079,7,8,9,10,38,47,-9,33
Perth Glory,6079,8,10,2,15,37,50,-13,32
Wellington P,6079,9,5,6,16,31,55,-24,21
CC Mariners,6079,10,4,8,15,28,49,-21,20
Sydney FC,6080,1,21,4,3,67,23,44,67
N'castle Jet,6080,2,16,5,7,58,37,21,53
Melbourne C,6080,3,14,4,11,43,34,9,46
Melbourne V,6080,4,13,5,11,46,41,5,44
Adelaide Utd,6080,5,11,6,11,37,40,-3,39
Brisbane,6080,6,10,5,13,33,42,-9,35
Western Sydn,6080,7,8,9,10,38,47,-9,33
Perth Glory,6080,8,10,2,15,37,50,-13,32
Wellington P,6080,9,5,6,16,31,55,-24,21
CC Mariners,6080,10,4,8,15,28,49,-21,20
Sydney FC,6081,1,20,4,4,64,23,41,64
N'castle Jet,6081,2,16,5,7,59,38,21,53
Melbourne V,6081,3,14,5,10,46,38,8,47
Melbourne C,6081,4,14,4,11,44,35,9,46
Adelaide Utd,6081,5,11,6,11,37,40,-3,39
Brisbane,6081,6,10,5,13,33,42,-9,35
Western Sydn,6081,7,8,9,10,38,47,-9,33
Perth Glory,6081,8,10,2,15,37,50,-13,32
Wellington P,6081,9,5,6,16,31,55,-24,21
CC Mariners,6081,10,4,8,15,28,49,-21,20
Sydney FC,6082,1,21,4,3,67,22,45,67
N'castle Jet,6082,2,15,5,8,58,40,18,50
Melbourne C,6082,3,15,4,10,46,34,12,49
Melbourne V,6082,4,13,5,11,45,41,4,44
Adelaide Utd,6082,5,11,6,11,37,40,-3,39
Brisbane,6082,6,10,5,13,33,42,-9,35
Western Sydn,6082,7,8,9,10,38,47,-9,33
Perth Glory,6082,8,10,2,15,37,50,-13,32
Wellington P,6082,9,5,6,16,31,55,-24,21
CC Mariners,6082,10,4,8,15,28,49,-21,20
Sydney FC,6083,1,20,4,4,64,26,38,64
N'castle Jet,6083,2,15,5,8,57,38,19,50
Melbourne C,6083,3,15,4,10,44,33,11,49
Melbourne V,6083,4,14,5,10,49,38,11,47
Adelaide Utd,6083,5,11,6,11,37,40,-3,39
Brisbane,6083,6,10,5,13,33,42,-9,35
Western Sydn,6083,7,8,9,10,38,47,-9,33
Perth Glory,6083,8,10,2,15,37,50,-13,32
Wellington P,6083,9,5,6,16,31,55,-24,21
CC Mariners,6083,10,4,8,15,28,49,-21,20
Sydney FC,6084,1,21,4,3,69,23,46,67
N'castle Jet,6084,2,16,5,7,59,37,22,53
Melbourne C,6084,3,14,4,11,43,35,8,46
Melbourne V,6084,4,13,5,11,46,43,3,44
Adelaide Utd,6084,5,11,6,11,37,40,-3,39
Brisbane,6084,6,10,5,13,33,42,-9,35
Western Sydn,6084,7,8,9,10,38,47,-9,33
Perth Glory,6084,8,10,2,15,37,50,-13,32
Wellington P,6084,9,5,6,16,31,55,-24,21
CC Mariners,6084,10,4,8,15,28,49,-21,20
Sydney FC,6085,1,21,4,3,67,22,45,67
N'castle Jet,6085,2,15,5,8,57,38,19,50
Melbourne C,6085,3,15,4,10,44,33,11,49
Melbourne V,6085,4,13,5,11,45,41,4,44
Adelaide Utd,6085,5,11,6,11,37,40,-3,39
Brisbane,6085,6,10,5,13,33,42,-9,35
Western Sydn,6085,7,8,9,10,38,47,-9,33
Perth Glory,6085,8,10,2,15,37,50,-13,32
Wellington P,6085,9,5,6,16,31,55,-24,21
CC Mariners,6085,10,4,8,15,28,49,-21,20
Sydney FC,6086,1,21,4,3,65,22,43,67
N'castle Jet,6086,2,15,5,8,57,38,19,50
Melbourne C,6086,3,15,4,10,44,33,11,49
Melbourne V,6086,4,13,5,11,45,39,6,44
Adelaide Utd,6086,5,11,6,11,37,40,-3,39
Brisbane,6086,6,10,5,13,33,42,-9,35
Western Sydn,6086,7,8,9,10,38,47,-9,33
Perth Glory,6086,8,10,2,15,37,50,-13,32
Wellington P,6086,9,5,6,16,31,55,-24,21
CC Mariners,6086,10,4,8,15,28,49,-21,20
Sydney FC,6087,1,21,4,3,66,23,43,67
N'castle Jet,6087,2,16,5,7,59,38,21,53
Melbourne C,6087,3,14,4,11,44,35,9,46
Melbourne V,6087,4,13,5,11,46,40,6,44
Adelaide Utd,6087,5,11,6,11,37,40,-3,39
Brisbane,6087,6,10,5,13,33,42,-9,35
Western Sydn,6087,7,8,9,10,38,47,-9,33
Perth Glory,6087,8,10,2,15,37,50,-13,32
Wellington P,6087,9,5,6,16,31,55,-24,21
CC Mariners,6087,10,4,8,15,28,49,-21,20
Sydney FC,6088,1,21,4,3,66,23,43,67
N'castle Jet,6088,2,15,6,7,60,40,20,51
Melbourne C,6088,3,14,5,10,46,36,10,47
Melbourne V,6088,4,13,5,11,46,40,6,44
Adelaide Utd,6088,5,11,6,11,37,40,-3,39
Brisbane,6088,6,10,5,13,33,42,-9,35
Western Sydn,6088,7,8,9,10,38,47,-9,33
Perth Glory,6088,8,10,2,15,37,50,-13,32
Wellington P,6088,9,5,6,16,31,55,-24,21
CC Mariners,6088,10,4,8,15,28,49,-21,20
Sydney FC,6089,1,21,4,3,66,22,44,67
N'castle Jet,6089,2,15,5,8,57,39,18,50
Melbourne C,6089,3,15,4,10,45,33,12,49
Melbourne V,6089,4,13,5,11,45,40,5,44
Adelaide Utd,6089,5,11,6,11,37,40,-3,39
Brisbane,6089,6,10,5,13,33,42,-9,35
Western Sydn,6089,7,8,9,10,38,47,-9,33
Perth Glory,6089,8,10,2,15,37,50,-13,32
Wellington P,6089,9,5,6,16,31,55,-24,21
CC Mariners,6089,10,4,8,15,28,49,-21,20
Sydney FC,6090,1,20,5,3,64,22,42,65
N'castle Jet,6090,2,15,6,7,61,41,20,51
Melbourne C,6090,3,14,5,10,47,37,10,47
Melbourne V,6090,4,13,6,10,45,38,7,45
Adelaide Utd,6090,5,11,6,11,37,40,-3,39
Brisbane,6090,6,10,5,13,33,42,-9,35
Western Sydn,6090,7,8,9,10,38,47,-9,33
Perth Glory,6090,8,10,2,15,37,50,-13,32
Wellington P,6090,9,5,6,16,31,55,-24,21
CC Mariners,6090,10,4,8,15,28,49,-21,20
Sydney FC,6091,1,20,4,4,64,23,41,64
N'castle Jet,6091,2,15,6,7,59,39,20,51
Melbourne C,6091,3,14,5,10,45,35,10,47
Melbourne V,6091,4,14,5,10,46,38,8,47
Adelaide Utd,6091,5,11,6,11,37,40,-3,39
Brisbane,6091,6,10,5,13,33,42,-9,35
Western Sydn,6091,7,8,9,10,38,47,-9,33
Perth Glory,6091,8,10,2,15,37,50,-13,32
Wellington P,6091,9,5,6,16,31,55,-24,21
CC Mariners,6091,10,4,8,15,28,49,-21,20
Sydney FC,6092,1,21,4,3,67,23,44,67
N'castle Jet,6092,2,16,5,7,61,38,23,53
Melbourne C,6092,3,14,4,11,44,37,7,46
Melbourne V,6092,4,13,5,11,46,41,5,44
Adelaide Utd,6092,5,11,6,11,37,40,-3,39
Brisbane,6092,6,10,5,13,33,42,-9,35
Western Sydn,6092,7,8,9,10,38,47,-9,33
Perth Glory,6092,8,10,2,15,37,50,-13,32
Wellington P,6092,9,5,6,16,31,55,-24,21
CC Mariners,6092,10,4,8,15,28,49,-21,20
Sydney FC,6093,1,21,4,3,66,23,43,67
N'castle Jet,6093,2,16,5,7,62,38,24,53
Melbourne C,6093,3,14,4,11,44,38,6,46
Melbourne V,6093,4,13,5,11,46,40,6,44
Adelaide Utd,6093,5,11,6,11,37,40,-3,39
Brisbane,6093,6,10,5,13,33,42,-9,35
Western Sydn,6093,7,8,9,10,38,47,-9,33
Perth Glory,6093,8,10,2,15,37,50,-13,32
Wellington P,6093,9,5,6,16,31,55,-24,21
CC Mariners,6093,10,4,8,15,28,49,-21,20
Sydney FC,6094,1,20,4,4,64,23,41,64
N'castle Jet,6094,2,15,6,7,58,38,20,51
Melbourne C,6094,3,14,5,10,44,34,10,47
Melbourne V,6094,4,14,5,10,46,38,8,47
Adelaide Utd,6094,5,11,6,11,37,40,-3,39
Brisbane,6094,6,10,5,13,33,42,-9,35
Western Sydn,6094,7,8,9,10,38,47,-9,33
Perth Glory,6094,8,10,2,15,37,50,-13,32
Wellington P,6094,9,5,6,16,31,55,-24,21
CC Mariners,6094,10,4,8,15,28,49,-21,20
Sydney FC,6095,1,21,4,3,65,22,43,67
N'castle Jet,6095,2,16,5,7,58,37,21,53
Melbourne C,6095,3,14,4,11,43,34,9,46
Melbourne V,6095,4,13,5,11,45,39,6,44
Adelaide Utd,6095,5,11,6,11,37,40,-3,39
Brisbane,6095,6,10,5,13,33,42,-9,35
Western Sydn,6095,7,8,9,10,38,47,-9,33
Perth Glory,6095,8,10,2,15,37,50,-13,32
Wellington P,6095,9,5,6,16,31,55,-24,21
CC Mariners,6095,10,4,8,15,28,49,-21,20
Sydney FC,6096,1,20,4,4,65,24,41,64
N'castle Jet,6096,2,15,5,8,57,40,17,50
Melbourne C,6096,3,15,4,10,46,33,13,49
Melbourne V,6096,4,14,5,10,47,39,8,47
Adelaide Utd,6096,5,11,6,11,37,40,-3,39
Brisbane,6096,6,10,5,13,33,42,-9,35
Western Sydn,6096,7,8,9,10,38,47,-9,33
Perth Glory,6096,8,10,2,15,37,50,-13,32
Wellington P,6096,9,5,6,16,31,55,-24,21
CC Mariners,6096,10,4,8,15,28,49,-21,20
Sydney FC,6097,1,21,4,3,67,23,44,67
N'castle Jet,6097,2,15,5,8,58,40,18,50
Melbourne C,6097,3,15,4,10,46,34,12,49
Melbourne V,6097,4,13,5,11,46,41,5,44
Adelaide Utd,6097,5,11,6,11,37,40,-3,39
Brisbane,6097,6,10,5,13,33,42,-9,35
Western Sydn,6097,7,8,9,10,38,47,-9,33
Perth Glory,6097,8,10,2,15,37,50,-13,32
Wellington P,6097,9,5,6,16,31,55,-24,21
CC Mariners,6097,10,4,8,15,28,49,-21,20
Sydney FC,6098,1,21,4,3,68,22,46,67
N'castle Jet,6098,2,15,5,8,58,39,19,50
Melbourne C,6098,3,15,4,10,45,34,11,49
Melbourne V,6098,4,13,5,11,45,42,3,44
Adelaide Utd,6098,5,11,6,11,37,40,-3,39
Brisbane,6098,6,10,5,13,33,42,-9,35
Western Sydn,6098,7,8,9,10,38,47,-9,33
Perth Glory,6098,8,10,2,15,37,50,-13,32
Wellington P,6098,9,5,6,16,31,55,-24,21
CC Mariners,6098,10,4,8,15,28,49,-21,20
Sydney FC,6099,1,21,4,3,66,23,43,67
N'castle Jet,6099,2,15,5,8,57,39,18,50
Melbourne C,6099,3,15,4,10,45,33,12,49
Melbourne V,6099,4,13,5,11,46,40,6,44
Adelaide Utd,6099,5,11,6,11,37,40,-3,39
Brisbane,6099,6,10,5,13,33,42,-9,35
Western Sydn,6099,7,8,9,10,38,47,-9,33
Perth Glory,6099,8,10,2,15,37,50,-13,32
Wellington P,6099,9,5,6,16,31,55,-24,21
CC Mariners,6099,10,4,8,15,28,49,-21,20
Sydney FC,6100,1,21,4,3,66,22,44,67
N'castle Jet,6100,2,15,5,8,57,38,19,50
Melbourne C,6100,3,15,4,10,44,33,11,49
Melbourne V,6100,4,13,5,11,45,40,5,44
Adelaide Utd,6100,5,11,6,11,37,40,-3,39
Brisbane,6100,6,10,5,13,33,42,-9,35
Western Sydn,6100,7,8,9,10,38,47,-9,33
Perth Glory,6100,8,10,2,15,37,50,-13,32
Wellington P,6100,9,5,6,16,31,55,-24,21
CC Mariners,6100,10,4,8,15,28,49,-21,20
Sydney FC,6101,1,21,4,3,67,24,43,67
N'castle Jet,6101,2,15,5,8,59,40,19,50
Melbourne C,6101,3,15,4,10,46,35,11,49
Melbourne V,6101,4,13,5,11,47,41,6,44
Adelaide Utd,6101,5,11,6,11,37,40,-3,39
Brisbane,6101,6,10,5,13,33,42,-9,35
Western Sydn,6101,7,8,9,10,38,47,-9,33
Perth Glory,6101,8,10,2,15,37,50,-13,32
Wellington P,6101,9,5,6,16,31,55,-24,21
CC Mariners,6101,10,4,8,15,28,49,-21,20
Sydney FC,6102,1,21,4,3,67,22,45,67
N'castle Jet,6102,2,16,5,7,60,38,22,53
Melbourne C,6102,3,14,4,11,44,36,8,46
Melbourne V,6102,4,13,5,11,45,41,4,44
Adelaide Utd,6102,5,11,6,11,37,40,-3,39
Brisbane,6102,6,10,5,13,33,42,-9,35
Western Sydn,6102,7,8,9,10,38,47,-9,33
Perth Glory,6102,8,10,2,15,37,50,-13,32
Wellington P,6102,9,5,6,16,31,55,-24,21
CC Mariners,6102,10,4,8,15,28,49,-21,20
Sydney FC,6103,1,21,4,3,65,22,43,67
N'castle Jet,6103,2,15,6,7,58,38,20,51
Melbourne C,6103,3,14,5,10,44,34,10,47
Melbourne V,6103,4,13,5,11,45,39,6,44
Adelaide Utd,6103,5,11,6,11,37,40,-3,39
Brisbane,6103,6,10,5,13,33,42,-9,35
Western Sydn,6103,7,8,9,10,38,47,-9,33
Perth Glory,6103,8,10,2,15,37,50,-13,32
Wellington P,6103,9,5,6,16,31,55,-24,21
CC Mariners,6103,10,4,8,15,28,49,-21,20
Sydney FC,6104,1,21,4,3,68,22,46,67
N'castle Jet,6104,2,15,5,8,58,39,19,50
Melbourne C,6104,3,15,4,10,45,34,11,49
Melbourne V,6104,4,13,5,11,45,42,3,44
Adelaide Utd,6104,5,11,6,11,37,40,-3,39
Brisbane,6104,6,10,5,13,33,42,-9,35
Western Sydn,6104,7,8,9,10,38,47,-9,33
Perth Glory,6104,8,10,2,15,37,50,-13,32
Wellington P,6104,9,5,6,16,31,55,-24,21
CC Mariners,6104,10,4,8,15,28,49,-21,20
Sydney FC,6105,1,21,4,3,68,25,43,67
N'castle Jet,6105,2,16,5,7,58,37,21,53
Melbourne C,6105,3,14,4,11,43,34,9,46
Melbourne V,6105,4,13,5,11,48,42,6,44
Adelaide Utd,6105,5,11,6,11,37,40,-3,39
Brisbane,6105,6,10,5,13,33,42,-9,35
Western Sydn,6105,7,8,9,10,38,47,-9,33
Perth Glory,6105,8,10,2,15,37,50,-13,32
Wellington P,6105,9,5,6,16,31,55,-24,21
CC Mariners,6105,10,4,8,15,28,49,-21,20
Sydney FC,6106,1,21,4,3,67,22,45,67
N'castle Jet,6106,2,16,5,7,60,39,21,53
Melbourne C,6106,3,14,4,11,45,36,9,46
Melbourne V,6106,4,13,5,11,45,41,4,44
Adelaide Utd,6106,5,11,6,11,37,40,-3,39
Brisbane,6106,6,10,5,13,33,42,-9,35
Western Sydn,6106,7,8,9,10,38,47,-9,33
Perth Glory,6106,8,10,2,15,37,50,-13,32
Wellington P,6106,9,5,6,16,31,55,-24,21
CC Mariners,6106,10,4,8,15,28,49,-21,20
Sydney FC,6107,1,20,5,3,64,22,42,65
N'castle Jet,6107,2,15,5,8,59,40,19,50
Melbourne C,6107,3,15,4,10,46,35,11,49
Melbourne V,6107,4,13,6,10,45,38,7,45
Adelaide Utd,6107,5,11,6,11,37,40,-3,39
Brisbane,6107,6,10,5,13,33,42,-9,35
Western Sydn,6107,7,8,9,10,38,47,-9,33
Perth Glory,6107,8,10,2,15,37,50,-13,32
Wellington P,6107,9,5,6,16,31,55,-24,21
CC Mariners,6107,10,4,8,15,28,49,-21,20
Sydney FC,6108,1,21,4,3,70,22,48,67
N'castle Jet,6108,2,15,6,7,58,38,20,51
Melbourne C,6108,3,14,5,10,44,34,10,47
Melbourne V,6108,4,13,5,11,45,44,1,44
Adelaide Utd,6108,5,11,6,11,37,40,-3,39
Brisbane,6108,6,10,5,13,33,42,-9,35
Western Sydn,6108,7,8,9,10,38,47,-9,33
Perth Glory,6108,8,10,2,15,37,50,-13,32
Wellington P,6108,9,5,6,16,31,55,-24,21
CC Mariners,6108,10,4,8,15,28,49,-21,20
Sydney FC,6109,1,21,4,3,66,23,43,67
N'castle Jet,6109,2,15,6,7,58,38,20,51
Melbourne C,6109,3,14,5,10,44,34,10,47
Melbourne V,6109,4,13,5,11,46,40,6,44
Adelaide Utd,6109,5,11,6,11,37,40,-3,39
Brisbane,6109,6,10,5,13,33,42,-9,35
Western Sydn,6109,7,8,9,10,38,47,-9,33
Perth Glory,6109,8,10,2,15,37,50,-13,32
Wellington P,6109,9,5,6,16,31,55,-24,21
CC Mariners,6109,10,4,8,15,28,49,-21,20
Sydney FC,6110,1,20,4,4,66,27,39,64
N'castle Jet,6110,2,15,5,8,58,40,18,50
Melbourne C,6110,3,15,4,10,46,34,12,49
Melbourne V,6110,4,14,5,10,50,40,10,47
Adelaide Utd,6110,5,11,6,11,37,40,-3,39
Brisbane,6110,6,10,5,13,33,42,-9,35
Western Sydn,6110,7,8,9,10,38,47,-9,33
Perth Glory,6110,8,10,2,15,37,50,-13,32
Wellington P,6110,9,5,6,16,31,55,-24,21
CC Mariners,6110,10,4,8,15,28,49,-21,20
Sydney FC,6111,1,20,5,3,65,23,42,65
N'castle Jet,6111,2,15,6,7,58,38,20,51
Melbourne C,6111,3,14,5,10,44,34,10,47
Melbourne V,6111,4,13,6,10,46,39,7,45
Adelaide Utd,6111,5,11,6,11,37,40,-3,39
Brisbane,6111,6,10,5,13,33,42,-9,35
Western Sydn,6111,7,8,9,10,38,47,-9,33
Perth Glory,6111,8,10,2,15,37,50,-13,32
Wellington P,6111,9,5,6,16,31,55,-24,21
CC Mariners,6111,10,4,8,15,28,49,-21,20
Sydney FC,6112,1,20,5,3,65,23,42,65
N'castle Jet,6112,2,15,5,8,59,40,19,50
Melbourne C,6112,3,15,4,10,46,35,11,49
Melbourne V,6112,4,13,6,10,46,39,7,45
Adelaide Utd,6112,5,11,6,11,37,40,-3,39
Brisbane,6112,6,10,5,13,33,42,-9,35
Western Sydn,6112,7,8,9,10,38,47,-9,33
Perth Glory,6112,8,10,2,15,37,50,-13,32
Wellington P,6112,9,5,6,16,31,55,-24,21
CC Mariners,6112,10,4,8,15,28,49,-21,20
Sydney FC,6113,1,21,4,3,67,23,44,67
N'castle Jet,6113,2,15,5,8,58,39,19,50
Melbourne C,6113,3,15,4,10,45,34,11,49
Melbourne V,6113,4,13,5,11,46,41,5,44
Adelaide Utd,6113,5,11,6,11,37,40,-3,39
Brisbane,6113,6,10,5,13,33,42,-9,35
Western Sydn,6113,7,8,9,10,38,47,-9,33
Perth Glory,6113,8,10,2,15,37,50,-13,32
Wellington P,6113,9,5,6,16,31,55,-24,21
CC Mariners,6113,10,4,8,15,28,49,-21,20
Sydney FC,6114,1,21,4,3,67,24,43,67
N'castle Jet,6114,2,15,5,8,58,39,19,50
Melbourne C,6114,3,15,4,10,45,34,11,49
Melbourne V,6114,4,13,5,11,47,41,6,44
Adelaide Utd,6114,5,11,6,11,37,40,-3,39
Brisbane,6114,6,10,5,13,33,42,-9,35
Western Sydn,6114,7,8,9,10,38,47,-9,33
Perth Glory,6114,8,10,2,15,37,50,-13,32
Wellington P,6114,9,5,6,16,31,55,-24,21
CC Mariners,6114,10,4,8,15,28,49,-21,20
Sydney FC,6115,1,20,5,3,64,22,42,65
N'castle Jet,6115,2,16,5,7,59,37,22,53
Melbourne C,6115,3,14,4,11,43,35,8,46
Melbourne V,6115,4,13,6,10,45,38,7,45
Adelaide Utd,6115,5,11,6,11,37,40,-3,39
Brisbane,6115,6,10,5,13,33,42,-9,35
Western Sydn,6115,7,8,9,10,38,47,-9,33
Perth Glory,6115,8,10,2,15,37,50,-13,32
Wellington P,6115,9,5,6,16,31,55,-24,21
CC Mariners,6115,10,4,8,15,28,49,-21,20
Sydney FC,6116,1,21,4,3,66,22,44,67
N'castle Jet,6116,2,16,5,7,61,39,22,53
Melbourne C,6116,3,14,4,11,45,37,8,46
Melbourne V,6116,4,13,5,11,45,40,5,44
Adelaide Utd,6116,5,11,6,11,37,40,-3,39
Brisbane,6116,6,10,5,13,33,42,-9,35
Western Sydn,6116,7,8,9,10,38,47,-9,33
Perth Glory,6116,8,10,2,15,37,50,-13,32
Wellington P,6116,9,5,6,16,31,55,-24,21
CC Mariners,6116,10,4,8,15,28,49,-21,20
Sydney FC,6117,1,21,4,3,66,22,44,67
N'castle Jet,6117,2,16,5,7,59,38,21,53
Melbourne C,6117,3,14,4,11,44,35,9,46
Melbourne V,6117,4,13,5,11,45,40,5,44
Adelaide Utd,6117,5,11,6,11,37,40,-3,39
Brisbane,6117,6,10,5,13,33,42,-9,35
Western Sydn,6117,7,8,9,10,38,47,-9,33
Perth Glory,6117,8,10,2,15,37,50,-13,32
Wellington P,6117,9,5,6,16,31,55,-24,21
CC Mariners,6117,10,4,8,15,28,49,-21,20
Sydney FC,6118,1,21,4,3,67,22,45,67
N'castle Jet,6118,2,16,5,7,62,41,21,53
Melbourne C,6118,3,14,4,11,47,38,9,46
Melbourne V,6118,4,13,5,11,45,41,4,44
Adelaide Utd,6118,5,11,6,11,37,40,-3,39
Brisbane,6118,6,10,5,13,33,42,-9,35
Western Sydn,6118,7,8,9,10,38,47,-9,33
Perth Glory,6118,8,10,2,15,37,50,-13,32
Wellington P,6118,9,5,6,16,31,55,-24,21
CC Mariners,6118,10,4,8,15,28,49,-21,20
Sydney FC,6119,1,20,4,4,65,24,41,64
N'castle Jet,6119,2,16,5,7,60,37,23,53
Melbourne V,6119,3,14,5,10,47,39,8,47
Melbourne C,6119,4,14,4,11,43,36,7,46
Adelaide Utd,6119,5,11,6,11,37,40,-3,39
Brisbane,6119,6,10,5,13,33,42,-9,35
Western Sydn,6119,7,8,9,10,38,47,-9,33
Perth Glory,6119,8,10,2,15,37,50,-13,32
Wellington P,6119,9,5,6,16,31,55,-24,21
CC Mariners,6119,10,4,8,15,28,49,-21,20
Sydney FC,6120,1,21,4,3,67,23,44,67
N'castle Jet,6120,2,15,5,8,57,39,18,50
Melbourne C,6120,3,15,4,10,45,33,12,49
Melbourne V,6120,4,13,5,11,46,41,5,44
Adelaide Utd,6120,5,11,6,11,37,40,-3,39
Brisbane,6120,6,10,5,13,33,42,-9,35
Western Sydn,6120,7,8,9,10,38,47,-9,33
Perth Glory,6120,8,10,2,15,37,50,-13,32
Wellington P,6120,9,5,6,16,31,55,-24,21
CC Mariners,6120,10,4,8,15,28,49,-21,20
Sydney FC,6121,1,20,4,4,64,23,41,64
N'castle Jet,6121,2,16,5,7,59,38,21,53
Melbourne V,6121,3,14,5,10,46,38,8,47
Melbourne C,6121,4,14,4,11,44,35,9,46
Adelaide Utd,6121,5,11,6,11,37,40,-3,39
Brisbane,6121,6,10,5,13,33,42,-9,35
Western Sydn,6121,7,8,9,10,38,47,-9,33
Perth Glory,6121,8,10,2,15,37,50,-13,32
Wellington P,6121,9,5,6,16,31,55,-24,21
CC Mariners,6121,10,4,8,15,28,49,-21,20
Sydney FC,6122,1,20,4,4,65,25,40,64
N'castle Jet,6122,2,15,6,7,57,37,20,51
Melbourne C,6122,3,14,5,10,43,33,10,47
Melbourne V,6122,4,14,5,10,48,39,9,47
Adelaide Utd,6122,5,11,6,11,37,40,-3,39
Brisbane,6122,6,10,5,13,33,42,-9,35
Western Sydn,6122,7,8,9,10,38,47,-9,33
Perth Glory,6122,8,10,2,15,37,50,-13,32
Wellington P,6122,9,5,6,16,31,55,-24,21
CC Mariners,6122,10,4,8,15,28,49,-21,20
Sydney FC,6123,1,20,4,4,64,23,41,64
N'castle Jet,6123,2,15,5,8,58,41,17,50
Melbourne C,6123,3,15,4,10,47,34,13,49
Melbourne V,6123,4,14,5,10,46,38,8,47
Adelaide Utd,6123,5,11,6,11,37,40,-3,39
Brisbane,6123,6,10,5,13,33,42,-9,35
Western Sydn,6123,7,8,9,10,38,47,-9,33
Perth Glory,6123,8,10,2,15,37,50,-13,32
Wellington P,6123,9,5,6,16,31,55,-24,21
CC Mariners,6123,10,4,8,15,28,49,-21,20
Sydney FC,6124,1,20,4,4,65,25,40,64
N'castle Jet,6124,2,15,6,7,57,37,20,51
Melbourne C,6124,3,14,5,10,43,33,10,47
Melbourne V,6124,4,14,5,10,48,39,9,47
Adelaide Utd,6124,5,11,6,11,37,40,-3,39
Brisbane,6124,6,10,5,13,33,42,-9,35
Western Sydn,6124,7,8,9,10,38,47,-9,33
Perth Glory,6124,8,10,2,15,37,50,-13,32
Wellington P,6124,9,5,6,16,31,55,-24,21
CC Mariners,6124,10,4,8,15,28,49,-21,20
Sydney FC,6125,1,21,4,3,68,22,46,67
N'castle Jet,6125,2,16,5,7,58,37,21,53
Melbourne C,6125,3,14,4,11,43,34,9,46
Melbourne V,6125,4,13,5,11,45,42,3,44
Adelaide Utd,6125,5,11,6,11,37,40,-3,39
Brisbane,6125,6,10,5,13,33,42,-9,35
Western Sydn,6125,7,8,9,10,38,47,-9,33
Perth Glory,6125,8,10,2,15,37,50,-13,32
Wellington P,6125,9,5,6,16,31,55,-24,21
CC Mariners,6125,10,4,8,15,28,49,-21,20
Sydney FC,6126,1,21,4,3,70,24,46,67
N'castle Jet,6126,2,16,5,7,61,38,23,53
Melbourne C,6126,3,14,4,11,44,37,7,46
Melbourne V,6126,4,13,5,11,47,44,3,44
Adelaide Utd,6126,5,11,6,11,37,40,-3,39
Brisbane,6126,6,10,5,13,33,42,-9,35
Western Sydn,6126,7,8,9,10,38,47,-9,33
Perth Glory,6126,8,10,2,15,37,50,-13,32
Wellington P,6126,9,5,6,16,31,55,-24,21
CC Mariners,6126,10,4,8,15,28,49,-21,20
Sydney FC,6127,1,21,4,3,70,23,47,67
N'castle Jet,6127,2,16,5,7,59,38,21,53
Melbourne C,6127,3,14,4,11,44,35,9,46
Melbourne V,6127,4,13,5,11,46,44,2,44
Adelaide Utd,6127,5,11,6,11,37,40,-3,39
Brisbane,6127,6,10,5,13,33,42,-9,35
Western Sydn,6127,7,8,9,10,38,47,-9,33
Perth Glory,6127,8,10,2,15,37,50,-13,32
Wellington P,6127,9,5,6,16,31,55,-24,21
CC Mariners,6127,10,4,8,15,28,49,-21,20
Sydney FC,6128,1,21,4,3,68,23,45,67
N'castle Jet,6128,2,15,5,8,58,39,19,50
Melbourne C,6128,3,15,4,10,45,34,11,49
Melbourne V,6128,4,13,5,11,46,42,4,44
Adelaide Utd,6128,5,11,6,11,37,40,-3,39
Brisbane,6128,6,10,5,13,33,42,-9,35
Western Sydn,6128,7,8,9,10,38,47,-9,33
Perth Glory,6128,8,10,2,15,37,50,-13,32
Wellington P,6128,9,5,6,16,31,55,-24,21
CC Mariners,6128,10,4,8,15,28,49,-21,20
Sydney FC,6129,1,20,4,4,64,24,40,64
N'castle Jet,6129,2,15,6,7,59,39,20,51
Melbourne C,6129,3,14,5,10,45,35,10,47
Melbourne V,6129,4,14,5,10,47,38,9,47
Adelaide Utd,6129,5,11,6,11,37,40,-3,39
Brisbane,6129,6,10,5,13,33,42,-9,35
Western Sydn,6129,7,8,9,10,38,47,-9,33
Perth Glory,6129,8,10,2,15,37,50,-13,32
Wellington P,6129,9,5,6,16,31,55,-24,21
CC Mariners,6129,10,4,8,15,28,49,-21,20
Sydney FC,6130,1,21,4,3,66,23,43,67
N'castle Jet,6130,2,15,5,8,57,39,18,50
Melbourne C,6130,3,15,4,10,45,33,12,49
Melbourne V,6130,4,13,5,11,46,40,6,44
Adelaide Utd,6130,5,11,6,11,37,40,-3,39
Brisbane,6130,6,10,5,13,33,42,-9,35
Western Sydn,6130,7,8,9,10,38,47,-9,33
Perth Glory,6130,8,10,2,15,37,50,-13,32
Wellington P,6130,9,5,6,16,31,55,-24,21
CC Mariners,6130,10,4,8,15,28,49,-21,20
Sydney FC,6131,1,21,4,3,66,22,44,67
N'castle Jet,6131,2,15,5,8,58,39,19,50
Melbourne C,6131,3,15,4,10,45,34,11,49
Melbourne V,6131,4,13,5,11,45,40,5,44
Adelaide Utd,6131,5,11,6,11,37,40,-3,39
Brisbane,6131,6,10,5,13,33,42,-9,35
Western Sydn,6131,7,8,9,10,38,47,-9,33
Perth Glory,6131,8,10,2,15,37,50,-13,32
Wellington P,6131,9,5,6,16,31,55,-24,21
CC Mariners,6131,10,4,8,15,28,49,-21,20
Sydney FC,6132,1,21,4,3,66,23,43,67
N'castle Jet,6132,2,16,5,7,58,37,21,53
Melbourne C,6132,3,14,4,11,43,34,9,46
Melbourne V,6132,4,13,5,11,46,40,6,44
Adelaide Utd,6132,5,11,6,11,37,40,-3,39
Brisbane,6132,6,10,5,13,33,42,-9,35
Western Sydn,6132,7,8,9,10,38,47,-9,33
Perth Glory,6132,8,10,2,15,37,50,-13,32
Wellington P,6132,9,5,6,16,31,55,-24,21
CC Mariners,6132,10,4,8,15,28,49,-21,20
Sydney FC,6133,1,21,4,3,65,22,43,67
N'castle Jet,6133,2,16,5,7,58,37,21,53
Melbourne C,6133,3,14,4,11,43,34,9,46
Melbourne V,6133,4,13,5,11,45,39,6,44
Adelaide Utd,6133,5,11,6,11,37,40,-3,39
Brisbane,6133,6,10,5,13,33,42,-9,35
Western Sydn,6133,7,8,9,10,38,47,-9,33
Perth Glory,6133,8,10,2,15,37,50,-13,32
Wellington P,6133,9,5,6,16,31,55,-24,21
CC Mariners,6133,10,4,8,15,28,49,-21,20
Sydney FC,6134,1,21,4,3,66,22,44,67
N'castle Jet,6134,2,15,5,8,58,39,19,50
Melbourne C,6134,3,15,4,10,45,34,11,49
Melbourne V,6134,4,13,5,11,45,40,5,44
Adelaide Utd,6134,5,11,6,11,37,40,-3,39
Brisbane,6134,6,10,5,13,33,42,-9,35
Western Sydn,6134,7,8,9,10,38,47,-9,33
Perth Glory,6134,8,10,2,15,37,50,-13,32
Wellington P,6134,9,5,6,16,31,55,-24,21
CC Mariners,6134,10,4,8,15,28,49,-21,20
Sydney FC,6135,1,21,4,3,66,23,43,67
N'castle Jet,6135,2,15,5,8,58,39,19,50
Melbourne C,6135,3,15,4,10,45,34,11,49
Melbourne V,6135,4,13,5,11,46,40,6,44
Adelaide Utd,6135,5,11,6,11,37,40,-3,39
Brisbane,6135,6,10,5,13,33,42,-9,35
Western Sydn,6135,7,8,9,10,38,47,-9,33
Perth Glory,6135,8,10,2,15,37,50,-13,32
Wellington P,6135,9,5,6,16,31,55,-24,21
CC Mariners,6135,10,4,8,15,28,49,-21,20
Sydney FC,6136,1,20,5,3,64,22,42,65
N'castle Jet,6136,2,16,5,7,62,37,25,53
Melbourne C,6136,3,14,4,11,43,38,5,46
Melbourne V,6136,4,13,6,10,45,38,7,45
Adelaide Utd,6136,5,11,6,11,37,40,-3,39
Brisbane,6136,6,10,5,13,33,42,-9,35
Western Sydn,6136,7,8,9,10,38,47,-9,33
Perth Glory,6136,8,10,2,15,37,50,-13,32
Wellington P,6136,9,5,6,16,31,55,-24,21
CC Mariners,6136,10,4,8,15,28,49,-21,20
Sydney FC,6137,1,21,4,3,66,22,44,67
N'castle Jet,6137,2,16,5,7,59,37,22,53
Melbourne C,6137,3,14,4,11,43,35,8,46
Melbourne V,6137,4,13,5,11,45,40,5,44
Adelaide Utd,6137,5,11,6,11,37,40,-3,39
Brisbane,6137,6,10,5,13,33,42,-9,35
Western Sydn,6137,7,8,9,10,38,47,-9,33
Perth Glory,6137,8,10,2,15,37,50,-13,32
Wellington P,6137,9,5,6,16,31,55,-24,21
CC Mariners,6137,10,4,8,15,28,49,-21,20
Sydney FC,6138,1,20,5,3,65,23,42,65
N'castle Jet,6138,2,16,5,7,60,39,21,53
Melbourne C,6138,3,14,4,11,45,36,9,46
Melbourne V,6138,4,13,6,10,46,39,7,45
Adelaide Utd,6138,5,11,6,11,37,40,-3,39
Brisbane,6138,6,10,5,13,33,42,-9,35
Western Sydn,6138,7,8,9,10,38,47,-9,33
Perth Glory,6138,8,10,2,15,37,50,-13,32
Wellington P,6138,9,5,6,16,31,55,-24,21
CC Mariners,6138,10,4,8,15,28,49,-21,20
Sydney FC,6139,1,20,5,3,65,23,42,65
N'castle Jet,6139,2,16,5,7,59,38,21,53
Melbourne C,6139,3,14,4,11,44,35,9,46
Melbourne V,6139,4,13,6,10,46,39,7,45
Adelaide Utd,6139,5,11,6,11,37,40,-3,39
Brisbane,6139,6,10,5,13,33,42,-9,35
Western Sydn,6139,7,8,9,10,38,47,-9,33
Perth Glory,6139,8,10,2,15,37,50,-13,32
Wellington P,6139,9,5,6,16,31,55,-24,21
CC Mariners,6139,10,4,8,15,28,49,-21,20
Sydney FC,6140,1,21,4,3,67,23,44,67
N'castle Jet,6140,2,15,6,7,57,37,20,51
Melbourne C,6140,3,14,5,10,43,33,10,47
Melbourne V,6140,4,13,5,11,46,41,5,44
Adelaide Utd,6140,5,11,6,11,37,40,-3,39
Brisbane,6140,6,10,5,13,33,42,-9,35
Western Sydn,6140,7,8,9,10,38,47,-9,33
Perth Glory,6140,8,10,2,15,37,50,-13,32
Wellington P,6140,9,5,6,16,31,55,-24,21
CC Mariners,6140,10,4,8,15,28,49,-21,20
Sydney FC,6141,1,21,4,3,66,23,43,67
N'castle Jet,6141,2,15,6,7,57,37,20,51
Melbourne C,6141,3,14,5,10,43,33,10,47
Melbourne V,6141,4,13,5,11,46,40,6,44
Adelaide Utd,6141,5,11,6,11,37,40,-3,39
Brisbane,6141,6,10,5,13,33,42,-9,35
Western Sydn,6141,7,8,9,10,38,47,-9,33
Perth Glory,6141,8,10,2,15,37,50,-13,32
Wellington P,6141,9,5,6,16,31,55,-24,21
CC Mariners,6141,10,4,8,15,28,49,-21,20
Sydney FC,6142,1,21,4,3,67,22,45,67
N'castle Jet,6142,2,15,6,7,59,39,20,51
Melbourne C,6142,3,14,5,10,45,35,10,47
Melbourne V,6142,4,13,5,11,45,41,4,44
Adelaide Utd,6142,5,11,6,11,37,40,-3,39
Brisbane,6142,6,10,5,13,33,42,-9,35
Western Sydn,6142,7,8,9,10,38,47,-9,33
Perth Glory,6142,8,10,2,15,37,50,-13,32
Wellington P,6142,9,5,6,16,31,55,-24,21
CC Mariners,6142,10,4,8,15,28,49,-21,20
Sydney FC,6143,1,20,4,4,66,25,41,64
N'castle Jet,6143,2,15,5,8,58,39,19,50
Melbourne C,6143,3,15,4,10,45,34,11,49
Melbourne V,6143,4,14,5,10,48,40,8,47
Adelaide Utd,6143,5,11,6,11,37,40,-3,39
Brisbane,6143,6,10,5,13,33,42,-9,35
Western Sydn,6143,7,8,9,10,38,47,-9,33
Perth Glory,6143,8,10,2,15,37,50,-13,32
Wellington P,6143,9,5,6,16,31,55,-24,21
CC Mariners,6143,10,4,8,15,28,49,-21,20
Sydney FC,6144,1,21,4,3,67,22,45,67
N'castle Jet,6144,2,15,6,7,59,39,20,51
Melbourne C,6144,3,14,5,10,45,35,10,47
Melbourne V,6144,4,13,5,11,45,41,4,44
Adelaide Utd,6144,5,11,6,11,37,40,-3,39
Brisbane,6144,6,10,5,13,33,42,-9,35
Western Sydn,6144,7,8,9,10,38,47,-9,33
Perth Glory,6144,8,10,2,15,37,50,-13,32
Wellington P,6144,9,5,6,16,31,55,-24,21
CC Mariners,6144,10,4,8,15,28,49,-21,20
Sydney FC,6145,1,20,4,4,64,25,39,64
N'castle Jet,6145,2,15,6,7,60,40,20,51
Melbourne V,6145,3,14,5,10,48,38,10,47
Melbourne C,6145,4,14,5,10,46,36,10,47
Adelaide Utd,6145,5,11,6,11,37,40,-3,39
Brisbane,6145,6,10,5,13,33,42,-9,35
Western Sydn,6145,7,8,9,10,38,47,-9,33
Perth Glory,6145,8,10,2,15,37,50,-13,32
Wellington P,6145,9,5,6,16,31,55,-24,21
CC Mariners,6145,10,4,8,15,28,49,-21,20
Sydney FC,6146,1,21,4,3,67,23,44,67
N'castle Jet,6146,2,16,5,7,60,38,22,53
Melbourne C,6146,3,14,4,11,44,36,8,46
Melbourne V,6146,4,13,5,11,46,41,5,44
Adelaide Utd,6146,5,11,6,11,37,40,-3,39
Brisbane,6146,6,10,5,13,33,42,-9,35
Western Sydn,6146,7,8,9,10,38,47,-9,33
Perth Glory,6146,8,10,2,15,37,50,-13,32
Wellington P,6146,9,5,6,16,31,55,-24,21
CC Mariners,6146,10,4,8,15,28,49,-21,20
Sydney FC,6147,1,21,4,3,66,22,44,67
N'castle Jet,6147,2,15,5,8,59,40,19,50
Melbourne C,6147,3,15,4,10,46,35,11,49
Melbourne V,6147,4,13,5,11,45,40,5,44
Adelaide Utd,6147,5,11,6,11,37,40,-3,39
Brisbane,6147,6,10,5,13,33,42,-9,35
Western Sydn,6147,7,8,9,10,38,47,-9,33
Perth Glory,6147,8,10,2,15,37,50,-13,32
Wellington P,6147,9,5,6,16,31,55,-24,21
CC Mariners,6147,10,4,8,15,28,49,-21,20
Sydney FC,6148,1,21,4,3,69,22,47,67
N'castle Jet,6148,2,16,5,7,60,38,22,53
Melbourne C,6148,3,14,4,11,44,36,8,46
Melbourne V,6148,4,13,5,11,45,43,2,44
Adelaide Utd,6148,5,11,6,11,37,40,-3,39
Brisbane,6148,6,10,5,13,33,42,-9,35
Western Sydn,6148,7,8,9,10,38,47,-9,33
Perth Glory,6148,8,10,2,15,37,50,-13,32
Wellington P,6148,9,5,6,16,31,55,-24,21
CC Mariners,6148,10,4,8,15,28,49,-21,20
Sydney FC,6149,1,21,4,3,67,24,43,67
N'castle Jet,6149,2,15,6,7,58,38,20,51
Melbourne C,6149,3,14,5,10,44,34,10,47
Melbourne V,6149,4,13,5,11,47,41,6,44
Adelaide Utd,6149,5,11,6,11,37,40,-3,39
Brisbane,6149,6,10,5,13,33,42,-9,35
Western Sydn,6149,7,8,9,10,38,47,-9,33
Perth Glory,6149,8,10,2,15,37,50,-13,32
Wellington P,6149,9,5,6,16,31,55,-24,21
CC Mariners,6149,10,4,8,15,28,49,-21,20
Sydney FC,6150,1,20,5,3,67,25,42,65
N'castle Jet,6150,2,15,6,7,57,37,20,51
Melbourne C,6150,3,14,5,10,43,33,10,47
Melbourne V,6150,4,13,6,10,48,41,7,45
Adelaide Utd,6150,5,11,6,11,37,40,-3,39
Brisbane,6150,6,10,5,13,33,42,-9,35
Western Sydn,6150,7,8,9,10,38,47,-9,33
Perth Glory,6150,8,10,2,15,37,50,-13,32
Wellington P,6150,9,5,6,16,31,55,-24,21
CC Mariners,6150,10,4,8,15,28,49,-21,20
Sydney FC,6151,1,21,4,3,69,23,46,67
N'castle Jet,6151,2,16,5,7,61,37,24,53
Melbourne C,6151,3,14,4,11,43,37,6,46
Melbourne V,6151,4,13,5,11,46,43,3,44
Adelaide Utd,6151,5,11,6,11,37,40,-3,39
Brisbane,6151,6,10,5,13,33,42,-9,35
Western Sydn,6151,7,8,9,10,38,47,-9,33
Perth Glory,6151,8,10,2,15,37,50,-13,32
Wellington P,6151,9,5,6,16,31,55,-24,21
CC Mariners,6151,10,4,8,15,28,49,-21,20
Sydney FC,6152,1,20,5,3,65,23,42,65
N'castle Jet,6152,2,15,5,8,57,39,18,50
Melbourne C,6152,3,15,4,10,45,33,12,49
Melbourne V,6152,4,13,6,10,46,39,7,45
Adelaide Utd,6152,5,11,6,11,37,40,-3,39
Brisbane,6152,6,10,5,13,33,42,-9,35
Western Sydn,6152,7,8,9,10,38,47,-9,33
Perth Glory,6152,8,10,2,15,37,50,-13,32
Wellington P,6152,9,5,6,16,31,55,-24,21
CC Mariners,6152,10,4,8,15,28,49,-21,20
Sydney FC,6153,1,21,4,3,65,22,43,67
N'castle Jet,6153,2,15,6,7,58,38,20,51
Melbourne C,6153,3,14,5,10,44,34,10,47
Melbourne V,6153,4,13,5,11,45,39,6,44
Adelaide Utd,6153,5,11,6,11,37,40,-3,39
Brisbane,6153,6,10,5,13,33,42,-9,35
Western Sydn,6153,7,8,9,10,38,47,-9,33
Perth Glory,6153,8,10,2,15,37,50,-13,32
Wellington P,6153,9,5,6,16,31,55,-24,21
CC Mariners,6153,10,4,8,15,28,49,-21,20
Sydney FC,6154,1,21,4,3,66,23,43,67
N'castle Jet,6154,2,15,5,8,59,40,19,50
Melbourne C,6154,3,15,4,10,46,35,11,49
Melbourne V,6154,4,13,5,11,46,40,6,44
Adelaide Utd,6154,5,11,6,11,37,40,-3,39
Brisbane,6154,6,10,5,13,33,42,-9,35
Western Sydn,6154,7,8,9,10,38,47,-9,33
Perth Glory,6154,8,10,2,15,37,50,-13,32
Wellington P,6154,9,5,6,16,31,55,-24,21
CC Mariners,6154,10,4,8,15,28,49,-21,20
Sydney FC,6155,1,20,5,3,65,23,42,65
N'castle Jet,6155,2,16,5,7,60,37,23,53
Melbourne C,6155,3,14,4,11,43,36,7,46
Melbourne V,6155,4,13,6,10,46,39,7,45
Adelaide Utd,6155,5,11,6,11,37,40,-3,39
Brisbane,6155,6,10,5,13,33,42,-9,35
Western Sydn,6155,7,8,9,10,38,47,-9,33
Perth Glory,6155,8,10,2,15,37,50,-13,32
Wellington P,6155,9,5,6,16,31,55,-24,21
CC Mariners,6155,10,4,8,15,28,49,-21,20
Sydney FC,6156,1,21,4,3,66,22,44,67
N'castle Jet,6156,2,16,5,7,61,37,24,53
Melbourne C,6156,3,14,4,11,43,37,6,46
Melbourne V,6156,4,13,5,11,45,40,5,44
Adelaide Utd,6156,5,11,6,11,37,40,-3,39
Brisbane,6156,6,10,5,13,33,42,-9,35
Western Sydn,6156,7,8,9,10,38,47,-9,33
Perth Glory,6156,8,10,2,15,37,50,-13,32
Wellington P,6156,9,5,6,16,31,55,-24,21
CC Mariners,6156,10,4,8,15,28,49,-21,20
Sydney FC,6157,1,20,5,3,65,23,42,65
N'castle Jet,6157,2,16,5,7,58,37,21,53
Melbourne C,6157,3,14,4,11,43,34,9,46
Melbourne V,6157,4,13,6,10,46,39,7,45
Adelaide Utd,6157,5,11,6,11,37,40,-3,39
Brisbane,6157,6,10,5,13,33,42,-9,35
Western Sydn,6157,7,8,9,10,38,47,-9,33
Perth Glory,6157,8,10,2,15,37,50,-13,32
Wellington P,6157,9,5,6,16,31,55,-24,21
CC Mariners,6157,10,4,8,15,28,49,-21,20
Sydney FC,6158,1,21,4,3,68,22,46,67
N'castle Jet,6158,2,16,5,7,59,37,22,53
Melbourne C,6158,3,14,4,11,43,35,8,46
Melbourne V,6158,4,13,5,11,45,42,3,44
Adelaide Utd,6158,5,11,6,11,37,40,-3,39
Brisbane,6158,6,10,5,13,33,42,-9,35
Western Sydn,6158,7,8,9,10,38,47,-9,33
Perth Glory,6158,8,10,2,15,37,50,-13,32
Wellington P,6158,9,5,6,16,31,55,-24,21
CC Mariners,6158,10,4,8,15,28,49,-21,20
Sydney FC,6159,1,21,4,3,65,22,43,67
N'castle Jet,6159,2,15,6,7,57,37,20,51
Melbourne C,6159,3,14,5,10,43,33,10,47
Melbourne V,6159,4,13,5,11,45,39,6,44
Adelaide Utd,6159,5,11,6,11,37,40,-3,39
Brisbane,6159,6,10,5,13,33,42,-9,35
Western Sydn,6159,7,8,9,10,38,47,-9,33
Perth Glory,6159,8,10,2,15,37,50,-13,32
Wellington P,6159,9,5,6,16,31,55,-24,21
CC Mariners,6159,10,4,8,15,28,49,-21,20
Sydney FC,6160,1,20,4,4,65,26,39,64
N'castle Jet,6160,2,15,5,8,58,40,18,50
Melbourne C,6160,3,15,4,10,46,34,12,49
Melbourne V,6160,4,14,5,10,49,39,10,47
Adelaide Utd,6160,5,11,6,11,37,40,-3,39
Brisbane,6160,6,10,5,13,33,42,-9,35
Western Sydn,6160,7,8,9,10,38,47,-9,33
Perth Glory,6160,8,10,2,15,37,50,-13,32
Wellington P,6160,9,5,6,16,31,55,-24,21
CC Mariners,6160,10,4,8,15,28,49,-21,20
Sydney FC,6161,1,21,4,3,66,22,44,67
N'castle Jet,6161,2,16,5,7,59,37,22,53
Melbourne C,6161,3,14,4,11,43,35,8,46
Melbourne V,6161,4,13,5,11,45,40,5,44
Adelaide Utd,6161,5,11,6,11,37,40,-3,39
Brisbane,6161,6,10,5,13,33,42,-9,35
Western Sydn,6161,7,8,9,10,38,47,-9,33
Perth Glory,6161,8,10,2,15,37,50,-13,32
Wellington P,6161,9,5,6,16,31,55,-24,21
CC Mariners,6161,10,4,8,15,28,49,-21,20
Sydney FC,6162,1,20,4,4,64,23,41,64
N'castle Jet,6162,2,15,6,7,59,39,20,51
Melbourne C,6162,3,14,5,10,45,35,10,47
Melbourne V,6162,4,14,5,10,46,38,8,47
Adelaide Utd,6162,5,11,6,11,37,40,-3,39
Brisbane,6162,6,10,5,13,33,42,-9,35
Western Sydn,6162,7,8,9,10,38,47,-9,33
Perth Glory,6162,8,10,2,15,37,50,-13,32
Wellington P,6162,9,5,6,16,31,55,-24,21
CC Mariners,6162,10,4,8,15,28,49,-21,20
Sydney FC,6163,1,21,4,3,66,22,44,67
N'castle Jet,6163,2,16,5,7,60,37,23,53
Melbourne C,6163,3,14,4,11,43,36,7,46
Melbourne V,6163,4,13,5,11,45,40,5,44
Adelaide Utd,6163,5,11,6,11,37,40,-3,39
Brisbane,6163,6,10,5,13,33,42,-9,35
Western Sydn,6163,7,8,9,10,38,47,-9,33
Perth Glory,6163,8,10,2,15,37,50,-13,32
Wellington P,6163,9,5,6,16,31,55,-24,21
CC Mariners,6163,10,4,8,15,28,49,-21,20
Sydney FC,6164,1,21,4,3,67,23,44,67
N'castle Jet,6164,2,16,5,7,59,38,21,53
Melbourne C,6164,3,14,4,11,44,35,9,46
Melbourne V,6164,4,13,5,11,46,41,5,44
Adelaide Utd,6164,5,11,6,11,37,40,-3,39
Brisbane,6164,6,10,5,13,33,42,-9,35
Western Sydn,6164,7,8,9,10,38,47,-9,33
Perth Glory,6164,8,10,2,15,37,50,-13,32
Wellington P,6164,9,5,6,16,31,55,-24,21
CC Mariners,6164,10,4,8,15,28,49,-21,20
Sydney FC,6165,1,20,4,4,64,25,39,64
N'castle Jet,6165,2,16,5,7,60,37,23,53
Melbourne V,6165,3,14,5,10,48,38,10,47
Melbourne C,6165,4,14,4,11,43,36,7,46
Adelaide Utd,6165,5,11,6,11,37,40,-3,39
Brisbane,6165,6,10,5,13,33,42,-9,35
Western Sydn,6165,7,8,9,10,38,47,-9,33
Perth Glory,6165,8,10,2,15,37,50,-13,32
Wellington P,6165,9,5,6,16,31,55,-24,21
CC Mariners,6165,10,4,8,15,28,49,-21,20
Sydney FC,6166,1,21,4,3,66,23,43,67
N'castle Jet,6166,2,15,6,7,58,38,20,51
Melbourne C,6166,3,14,5,10,44,34,10,47
Melbourne V,6166,4,13,5,11,46,40,6,44
Adelaide Utd,6166,5,11,6,11,37,40,-3,39
Brisbane,6166,6,10,5,13,33,42,-9,35
Western Sydn,6166,7,8,9,10,38,47,-9,33
Perth Glory,6166,8,10,2,15,37,50,-13,32
Wellington P,6166,9,5,6,16,31,55,-24,21
CC Mariners,6166,10,4,8,15,28,49,-21,20
Sydney FC,6167,1,21,4,3,66,23,43,67
N'castle Jet,6167,2,15,5,8,58,40,18,50
Melbourne C,6167,3,15,4,10,46,34,12,49
Melbourne V,6167,4,13,5,11,46,40,6,44
Adelaide Utd,6167,5,11,6,11,37,40,-3,39
Brisbane,6167,6,10,5,13,33,42,-9,35
Western Sydn,6167,7,8,9,10,38,47,-9,33
Perth Glory,6167,8,10,2,15,37,50,-13,32
Wellington P,6167,9,5,6,16,31,55,-24,21
CC Mariners,6167,10,4,8,15,28,49,-21,20
Sydney FC,6168,1,21,4,3,68,23,45,67
N'castle Jet,6168,2,15,5,8,58,39,19,50
Melbourne C,6168,3,15,4,10,45,34,11,49
Melbourne V,6168,4,13,5,11,46,42,4,44
Adelaide Utd,6168,5,11,6,11,37,40,-3,39
Brisbane,6168,6,10,5,13,33,42,-9,35
Western Sydn,6168,7,8,9,10,38,47,-9,33
Perth Glory,6168,8,10,2,15,37,50,-13,32
Wellington P,6168,9,5,6,16,31,55,-24,21
CC Mariners,6168,10,4,8,15,28,49,-21,20
Sydney FC,6169,1,21,4,3,65,22,43,67
N'castle Jet,6169,2,16,5,7,59,38,21,53
Melbourne C,6169,3,14,4,11,44,35,9,46
Melbourne V,6169,4,13,5,11,45,39,6,44
Adelaide Utd,6169,5,11,6,11,37,40,-3,39
Brisbane,6169,6,10,5,13,33,42,-9,35
Western Sydn,6169,7,8,9,10,38,47,-9,33
Perth Glory,6169,8,10,2,15,37,50,-13,32
Wellington P,6169,9,5,6,16,31,55,-24,21
CC Mariners,6169,10,4,8,15,28,49,-21,20
Sydney FC,6170,1,20,5,3,65,23,42,65
N'castle Jet,6170,2,15,6,7,59,39,20,51
Melbourne C,6170,3,14,5,10,45,35,10,47
Melbourne V,6170,4,13,6,10,46,39,7,45
Adelaide Utd,6170,5,11,6,11,37,40,-3,39
Brisbane,6170,6,10,5,13,33,42,-9,35
Western Sydn,6170,7,8,9,10,38,47,-9,33
Perth Glory,6170,8,10,2,15,37,50,-13,32
Wellington P,6170,9,5,6,16,31,55,-24,21
CC Mariners,6170,10,4,8,15,28,49,-21,20
Sydney FC,6171,1,20,5,3,65,23,42,65
N'castle Jet,6171,2,16,5,7,59,37,22,53
Melbourne C,6171,3,14,4,11,43,35,8,46
Melbourne V,6171,4,13,6,10,46,39,7,45
Adelaide Utd,6171,5,11,6,11,37,40,-3,39
Brisbane,6171,6,10,5,13,33,42,-9,35
Western Sydn,6171,7,8,9,10,38,47,-9,33
Perth Glory,6171,8,10,2,15,37,50,-13,32
Wellington P,6171,9,5,6,16,31,55,-24,21
CC Mariners,6171,10,4,8,15,28,49,-21,20
Sydney FC,6172,1,20,5,3,64,22,42,65
N'castle Jet,6172,2,16,5,7,61,39,22,53
Melbourne C,6172,3,14,4,11,45,37,8,46
Melbourne V,6172,4,13,6,10,45,38,7,45
Adelaide Utd,6172,5,11,6,11,37,40,-3,39
Brisbane,6172,6,10,5,13,33,42,-9,35
Western Sydn,6172,7,8,9,10,38,47,-9,33
Perth Glory,6172,8,10,2,15,37,50,-13,32
Wellington P,6172,9,5,6,16,31,55,-24,21
CC Mariners,6172,10,4,8,15,28,49,-21,20
Sydney FC,6173,1,20,4,4,65,24,41,64
N'castle Jet,6173,2,16,5,7,59,37,22,53
Melbourne V,6173,3,14,5,10,47,39,8,47
Melbourne C,6173,4,14,4,11,43,35,8,46
Adelaide Utd,6173,5,11,6,11,37,40,-3,39
Brisbane,6173,6,10,5,13,33,42,-9,35
Western Sydn,6173,7,8,9,10,38,47,-9,33
Perth Glory,6173,8,10,2,15,37,50,-13,32
Wellington P,6173,9,5,6,16,31,55,-24,21
CC Mariners,6173,10,4,8,15,28,49,-21,20
Sydney FC,6174,1,21,4,3,65,22,43,67
N'castle Jet,6174,2,15,5,8,57,38,19,50
Melbourne C,6174,3,15,4,10,44,33,11,49
Melbourne V,6174,4,13,5,11,45,39,6,44
Adelaide Utd,6174,5,11,6,11,37,40,-3,39
Brisbane,6174,6,10,5,13,33,42,-9,35
Western Sydn,6174,7,8,9,10,38,47,-9,33
Perth Glory,6174,8,10,2,15,37,50,-13,32
Wellington P,6174,9,5,6,16,31,55,-24,21
CC Mariners,6174,10,4,8,15,28,49,-21,20
Sydney FC,6175,1,21,4,3,67,23,44,67
N'castle Jet,6175,2,16,5,7,58,37,21,53
Melbourne C,6175,3,14,4,11,43,34,9,46
Melbourne V,6175,4,13,5,11,46,41,5,44
Adelaide Utd,6175,5,11,6,11,37,40,-3,39
Brisbane,6175,6,10,5,13,33,42,-9,35
Western Sydn,6175,7,8,9,10,38,47,-9,33
Perth Glory,6175,8,10,2,15,37,50,-13,32
Wellington P,6175,9,5,6,16,31,55,-24,21
CC Mariners,6175,10,4,8,15,28,49,-21,20
Sydney FC,6176,1,21,4,3,65,22,43,67
N'castle Jet,6176,2,15,6,7,57,37,20,51
Melbourne C,6176,3,14,5,10,43,33,10,47
Melbourne V,6176,4,13,5,11,45,39,6,44
Adelaide Utd,6176,5,11,6,11,37,40,-3,39
Brisbane,6176,6,10,5,13,33,42,-9,35
Western Sydn,6176,7,8,9,10,38,47,-9,33
Perth Glory,6176,8,10,2,15,37,50,-13,32
Wellington P,6176,9,5,6,16,31,55,-24,21
CC Mariners,6176,10,4,8,15,28,49,-21,20
Sydney FC,6177,1,21,4,3,66,22,44,67
N'castle Jet,6177,2,15,5,8,57,39,18,50
Melbourne C,6177,3,15,4,10,45,33,12,49
Melbourne V,6177,4,13,5,11,45,40,5,44
Adelaide Utd,6177,5,11,6,11,37,40,-3,39
Brisbane,6177,6,10,5,13,33,42,-9,35
Western Sydn,6177,7,8,9,10,38,47,-9,33
Perth Glory,6177,8,10,2,15,37,50,-13,32
Wellington P,6177,9,5,6,16,31,55,-24,21
CC Mariners,6177,10,4,8,15,28,49,-21,20
Sydney FC,6178,1,20,4,4,65,24,41,64
N'castle Jet,6178,2,16,5,7,61,38,23,53
Melbourne V,6178,3,14,5,10,47,39,8,47
Melbourne C,6178,4,14,4,11,44,37,7,46
Adelaide Utd,6178,5,11,6,11,37,40,-3,39
Brisbane,6178,6,10,5,13,33,42,-9,35
Western Sydn,6178,7,8,9,10,38,47,-9,33
Perth Glory,6178,8,10,2,15,37,50,-13,32
Wellington P,6178,9,5,6,16,31,55,-24,21
CC Mariners,6178,10,4,8,15,28,49,-21,20
Sydney FC,6179,1,20,4,4,65,25,40,64
N'castle Jet,6179,2,16,5,7,60,37,23,53
Melbourne V,6179,3,14,5,10,48,39,9,47
Melbourne C,6179,4,14,4,11,43,36,7,46
Adelaide Utd,6179,5,11,6,11,37,40,-3,39
Brisbane,6179,6,10,5,13,33,42,-9,35
Western Sydn,6179,7,8,9,10,38,47,-9,33
Perth Glory,6179,8,10,2,15,37,50,-13,32
Wellington P,6179,9,5,6,16,31,55,-24,21
CC Mariners,6179,10,4,8,15,28,49,-21,20
Sydney FC,6180,1,21,4,3,67,22,45,67
N'castle Jet,6180,2,15,5,8,57,38,19,50
Melbourne C,6180,3,15,4,10,44,33,11,49
Melbourne V,6180,4,13,5,11,45,41,4,44
Adelaide Utd,6180,5,11,6,11,37,40,-3,39
Brisbane,6180,6,10,5,13,33,42,-9,35
Western Sydn,6180,7,8,9,10,38,47,-9,33
Perth Glory,6180,8,10,2,15,37,50,-13,32
Wellington P,6180,9,5,6,16,31,55,-24,21
CC Mariners,6180,10,4,8,15,28,49,-21,20
Sydney FC,6181,1,21,4,3,66,22,44,67
N'castle Jet,6181,2,16,5,7,62,40,22,53
Melbourne C,6181,3,14,4,11,46,38,8,46
Melbourne V,6181,4,13,5,11,45,40,5,44
Adelaide Utd,6181,5,11,6,11,37,40,-3,39
Brisbane,6181,6,10,5,13,33,42,-9,35
Western Sydn,6181,7,8,9,10,38,47,-9,33
Perth Glory,6181,8,10,2,15,37,50,-13,32
Wellington P,6181,9,5,6,16,31,55,-24,21
CC Mariners,6181,10,4,8,15,28,49,-21,20
Sydney FC,6182,1,21,4,3,66,23,43,67
N'castle Jet,6182,2,16,5,7,59,38,21,53
Melbourne C,6182,3,14,4,11,44,35,9,46
Melbourne V,6182,4,13,5,11,46,40,6,44
Adelaide Utd,6182,5,11,6,11,37,40,-3,39
Brisbane,6182,6,10,5,13,33,42,-9,35
Western Sydn,6182,7,8,9,10,38,47,-9,33
Perth Glory,6182,8,10,2,15,37,50,-13,32
Wellington P,6182,9,5,6,16,31,55,-24,21
CC Mariners,6182,10,4,8,15,28,49,-21,20
Sydney FC,6183,1,21,4,3,67,22,45,67
N'castle Jet,6183,2,15,5,8,58,39,19,50
Melbourne C,6183,3,15,4,10,45,34,11,49
Melbourne V,6183,4,13,5,11,45,41,4,44
Adelaide Utd,6183,5,11,6,11,37,40,-3,39
Brisbane,6183,6,10,5,13,33,42,-9,35
Western Sydn,6183,7,8,9,10,38,47,-9,33
Perth Glory,6183,8,10,2,15,37,50,-13,32
Wellington P,6183,9,5,6,16,31,55,-24,21
CC Mariners,6183,10,4,8,15,28,49,-21,20
Sydney FC,6184,1,21,4,3,66,23,43,67
N'castle Jet,6184,2,16,5,7,59,37,22,53
Melbourne C,6184,3,14,4,11,43,35,8,46
Melbourne V,6184,4,13,5,11,46,40,6,44
Adelaide Utd,6184,5,11,6,11,37,40,-3,39
Brisbane,6184,6,10,5,13,33,42,-9,35
Western Sydn,6184,7,8,9,10,38,47,-9,33
Perth Glory,6184,8,10,2,15,37,50,-13,32
Wellington P,6184,9,5,6,16,31,55,-24,21
CC Mariners,6184,10,4,8,15,28,49,-21,20
Sydney FC,6185,1,21,4,3,69,24,45,67
N'castle Jet,6185,2,16,5,7,59,38,21,53
Melbourne C,6185,3,14,4,11,44,35,9,46
Melbourne V,6185,4,13,5,11,47,43,4,44
Adelaide Utd,6185,5,11,6,11,37,40,-3,39
Brisbane,6185,6,10,5,13,33,42,-9,35
Western Sydn,6185,7,8,9,10,38,47,-9,33
Perth Glory,6185,8,10,2,15,37,50,-13,32
Wellington P,6185,9,5,6,16,31,55,-24,21
CC Mariners,6185,10,4,8,15,28,49,-21,20
Sydney FC,6186,1,21,4,3,68,22,46,67
N'castle Jet,6186,2,15,5,8,57,40,17,50
Melbourne C,6186,3,15,4,10,46,33,13,49
Melbourne V,6186,4,13,5,11,45,42,3,44
Adelaide Utd,6186,5,11,6,11,37,40,-3,39
Brisbane,6186,6,10,5,13,33,42,-9,35
Western Sydn,6186,7,8,9,10,38,47,-9,33
Perth Glory,6186,8,10,2,15,37,50,-13,32
Wellington P,6186,9,5,6,16,31,55,-24,21
CC Mariners,6186,10,4,8,15,28,49,-21,20
Sydney FC,6187,1,21,4,3,67,22,45,67
N'castle Jet,6187,2,16,5,7,58,37,21,53
Melbourne C,6187,3,14,4,11,43,34,9,46
Melbourne V,6187,4,13,5,11,45,41,4,44
Adelaide Utd,6187,5,11,6,11,37,40,-3,39
Brisbane,6187,6,10,5,13,33,42,-9,35
Western Sydn,6187,7,8,9,10,38,47,-9,33
Perth Glory,6187,8,10,2,15,37,50,-13,32
Wellington P,6187,9,5,6,16,31,55,-24,21
CC Mariners,6187,10,4,8,15,28,49,-21,20
Sydney FC,6188,1,20,5,3,65,23,42,65
N'castle Jet,6188,2,15,5,8,58,40,18,50
Melbourne C,6188,3,15,4,10,46,34,12,49
Melbourne V,6188,4,13,6,10,46,39,7,45
Adelaide Utd,6188,5,11,6,11,37,40,-3,39
Brisbane,6188,6,10,5,13,33,42,-9,35
Western Sydn,6188,7,8,9,10,38,47,-9,33
Perth Glory,6188,8,10,2,15,37,50,-13,32
Wellington P,6188,9,5,6,16,31,55,-24,21
CC Mariners,6188,10,4,8,15,28,49,-21,20
Sydney FC,6189,1,21,4,3,65,22,43,67
N'castle Jet,6189,2,15,6,7,58,38,20,51
Melbourne C,6189,3,14,5,10,44,34,10,47
Melbourne V,6189,4,13,5,11,45,39,6,44
Adelaide Utd,6189,5,11,6,11,37,40,-3,39
Brisbane,6189,6,10,5,13,33,42,-9,35
Western Sydn,6189,7,8,9,10,38,47,-9,33
Perth Glory,6189,8,10,2,15,37,50,-13,32
Wellington P,6189,9,5,6,16,31,55,-24,21
CC Mariners,6189,10,4,8,15,28,49,-21,20
Sydney FC,6190,1,20,5,3,66,24,42,65
N'castle Jet,6190,2,15,6,7,58,38,20,51
Melbourne C,6190,3,14,5,10,44,34,10,47
Melbourne V,6190,4,13,6,10,47,40,7,45
Adelaide Utd,6190,5,11,6,11,37,40,-3,39
Brisbane,6190,6,10,5,13,33,42,-9,35
Western Sydn,6190,7,8,9,10,38,47,-9,33
Perth Glory,6190,8,10,2,15,37,50,-13,32
Wellington P,6190,9,5,6,16,31,55,-24,21
CC Mariners,6190,10,4,8,15,28,49,-21,20
Sydney FC,6191,1,21,4,3,67,23,44,67
N'castle Jet,6191,2,15,6,7,59,39,20,51
Melbourne C,6191,3,14,5,10,45,35,10,47
Melbourne V,6191,4,13,5,11,46,41,5,44
Adelaide Utd,6191,5,11,6,11,37,40,-3,39
Brisbane,6191,6,10,5,13,33,42,-9,35
Western Sydn,6191,7,8,9,10,38,47,-9,33
Perth Glory,6191,8,10,2,15,37,50,-13,32
Wellington P,6191,9,5,6,16,31,55,-24,21
CC Mariners,6191,10,4,8,15,28,49,-21,20
Sydney FC,6192,1,20,4,4,66,25,41,64
N'castle Jet,6192,2,15,5,8,57,39,18,50
Melbourne C,6192,3,15,4,10,45,33,12,49
Melbourne V,6192,4,14,5,10,48,40,8,47
Adelaide Utd,6192,5,11,6,11,37,40,-3,39
Brisbane,6192,6,10,5,13,33,42,-9,35
Western Sydn,6192,7,8,9,10,38,47,-9,33
Perth Glory,6192,8,10,2,15,37,50,-13,32
Wellington P,6192,9,5,6,16,31,55,-24,21
CC Mariners,6192,10,4,8,15,28,49,-21,20
Sydney FC,6193,1,21,4,3,66,22,44,67
N'castle Jet,6193,2,16,5,7,62,37,25,53
Melbourne C,6193,3,14,4,11,43,38,5,46
Melbourne V,6193,4,13,5,11,45,40,5,44
Adelaide Utd,6193,5,11,6,11,37,40,-3,39
Brisbane,6193,6,10,5,13,33,42,-9,35
Western Sydn,6193,7,8,9,10,38,47,-9,33
Perth Glory,6193,8,10,2,15,37,50,-13,32
Wellington P,6193,9,5,6,16,31,55,-24,21
CC Mariners,6193,10,4,8,15,28,49,-21,20
Sydney FC,6194,1,21,4,3,68,22,46,67
N'castle Jet,6194,2,16,5,7,58,37,21,53
Melbourne C,6194,3,14,4,11,43,34,9,46
Melbourne V,6194,4,13,5,11,45,42,3,44
Adelaide Utd,6194,5,11,6,11,37,40,-3,39
Brisbane,6194,6,10,5,13,33,42,-9,35
Western Sydn,6194,7,8,9,10,38,47,-9,33
Perth Glory,6194,8,10,2,15,37,50,-13,32
Wellington P,6194,9,5,6,16,31,55,-24,21
CC Mariners,6194,10,4,8,15,28,49,-21,20
Sydney FC,6195,1,21,4,3,68,22,46,67
N'castle Jet,6195,2,15,5,8,58,39,19,50
Melbourne C,6195,3,15,4,10,45,34,11,49
Melbourne V,6195,4,13,5,11,45,42,3,44
Adelaide Utd,6195,5,11,6,11,37,40,-3,39
Brisbane,6195,6,10,5,13,33,42,-9,35
Western Sydn,6195,7,8,9,10,38,47,-9,33
Perth Glory,6195,8,10,2,15,37,50,-13,32
Wellington P,6195,9,5,6,16,31,55,-24,21
CC Mariners,6195,10,4,8,15,28,49,-21,20
Sydney FC,6196,1,20,5,3,66,24,42,65
N'castle Jet,6196,2,16,5,7,60,38,22,53
Melbourne C,6196,3,14,4,11,44,36,8,46
Melbourne V,6196,4,13,6,10,47,40,7,45
Adelaide Utd,6196,5,11,6,11,37,40,-3,39
Brisbane,6196,6,10,5,13,33,42,-9,35
Western Sydn,6196,7,8,9,10,38,47,-9,33
Perth Glory,6196,8,10,2,15,37,50,-13,32
Wellington P,6196,9,5,6,16,31,55,-24,21
CC Mariners,6196,10,4,8,15,28,49,-21,20
Sydney FC,6197,1,21,4,3,67,22,45,67
N'castle Jet,6197,2,16,5,7,58,37,21,53
Melbourne C,6197,3,14,4,11,43,34,9,46
Melbourne V,6197,4,13,5,11,45,41,4,44
Adelaide Utd,6197,5,11,6,11,37,40,-3,39
Brisbane,6197,6,10,5,13,33,42,-9,35
Western Sydn,6197,7,8,9,10,38,47,-9,33
Perth Glory,6197,8,10,2,15,37,50,-13,32
Wellington P,6197,9,5,6,16,31,55,-24,21
CC Mariners,6197,10,4,8,15,28,49,-21,20
Sydney FC,6198,1,20,5,3,65,23,42,65
N'castle Jet,6198,2,15,5,8,58,39,19,50
Melbourne C,6198,3,15,4,10,45,34,11,49
Melbourne V,6198,4,13,6,10,46,39,7,45
Adelaide Utd,6198,5,11,6,11,37,40,-3,39
Brisbane,6198,6,10,5,13,33,42,-9,35
Western Sydn,6198,7,8,9,10,38,47,-9,33
Perth Glory,6198,8,10,2,15,37,50,-13,32
Wellington P,6198,9,5,6,16,31,55,-24,21
CC Mariners,6198,10,4,8,15,28,49,-21,20
Sydney FC,6199,1,21,4,3,66,22,44,67
N'castle Jet,6199,2,15,6,7,57,37,20,51
Melbourne C,6199,3,14,5,10,43,33,10,47
Melbourne V,6199,4,13,5,11,45,40,5,44
Adelaide Utd,6199,5,11,6,11,37,40,-3,39
Brisbane,6199,6,10,5,13,33,42,-9,35
Western Sydn,6199,7,8,9,10,38,47,-9,33
Perth Glory,6199,8,10,2,15,37,50,-13,32
Wellington P,6199,9,5,6,16,31,55,-24,21
CC Mariners,6199,10,4,8,15,28,49,-21,20
Sydney FC,6200,1,20,4,4,64,24,40,64
N'castle Jet,6200,2,15,6,7,57,37,20,51
Melbourne C,6200,3,14,5,10,43,33,10,47
Melbourne V,6200,4,14,5,10,47,38,9,47
Adelaide Utd,6200,5,11,6,11,37,40,-3,39
Brisbane,6200,6,10,5,13,33,42,-9,35
Western Sydn,6200,7,8,9,10,38,47,-9,33
Perth Glory,6200,8,10,2,15,37,50,-13,32
Wellington P,6200,9,5,6,16,31,55,-24,21
CC Mariners,6200,10,4,8,15,28,49,-21,20
Sydney FC,6201,1,20,5,3,65,23,42,65
N'castle Jet,6201,2,16,5,7,62,37,25,53
Melbourne C,6201,3,14,4,11,43,38,5,46
Melbourne V,6201,4,13,6,10,46,39,7,45
Adelaide Utd,6201,5,11,6,11,37,40,-3,39
Brisbane,6201,6,10,5,13,33,42,-9,35
Western Sydn,6201,7,8,9,10,38,47,-9,33
Perth Glory,6201,8,10,2,15,37,50,-13,32
Wellington P,6201,9,5,6,16,31,55,-24,21
CC Mariners,6201,10,4,8,15,28,49,-21,20
Sydney FC,6202,1,21,4,3,67,24,43,67
N'castle Jet,6202,2,16,5,7,59,37,22,53
Melbourne C,6202,3,14,4,11,43,35,8,46
Melbourne V,6202,4,13,5,11,47,41,6,44
Adelaide Utd,6202,5,11,6,11,37,40,-3,39
Brisbane,6202,6,10,5,13,33,42,-9,35
Western Sydn,6202,7,8,9,10,38,47,-9,33
Perth Glory,6202,8,10,2,15,37,50,-13,32
Wellington P,6202,9,5,6,16,31,55,-24,21
CC Mariners,6202,10,4,8,15,28,49,-21,20
Sydney FC,6203,1,21,4,3,68,22,46,67
N'castle Jet,6203,2,15,6,7,58,38,20,51
Melbourne C,6203,3,14,5,10,44,34,10,47
Melbourne V,6203,4,13,5,11,45,42,3,44
Adelaide Utd,6203,5,11,6,11,37,40,-3,39
Brisbane,6203,6,10,5,13,33,42,-9,35
Western Sydn,6203,7,8,9,10,38,47,-9,33
Perth Glory,6203,8,10,2,15,37,50,-13,32
Wellington P,6203,9,5,6,16,31,55,-24,21
CC Mariners,6203,10,4,8,15,28,49,-21,20
Sydney FC,6204,1,20,5,3,65,23,42,65
N'castle Jet,6204,2,16,5,7,59,37,22,53
Melbourne C,6204,3,14,4,11,43,35,8,46
Melbourne V,6204,4,13,6,10,46,39,7,45
Adelaide Utd,6204,5,11,6,11,37,40,-3,39
Brisbane,6204,6,10,5,13,33,42,-9,35
Western Sydn,6204,7,8,9,10,38,47,-9,33
Perth Glory,6204,8,10,2,15,37,50,-13,32
Wellington P,6204,9,5,6,16,31,55,-24,21
CC Mariners,6204,10,4,8,15,28,49,-21,20
Sydney FC,6205,1,21,4,3,68,23,45,67
N'castle Jet,6205,2,15,6,7,58,38,20,51
Melbourne C,6205,3,14,5,10,44,34,10,47
Melbourne V,6205,4,13,5,11,46,42,4,44
Adelaide Utd,6205,5,11,6,11,37,40,-3,39
Brisbane,6205,6,10,5,13,33,42,-9,35
Western Sydn,6205,7,8,9,10,38,47,-9,33
Perth Glory,6205,8,10,2,15,37,50,-13,32
Wellington P,6205,9,5,6,16,31,55,-24,21
CC Mariners,6205,10,4,8,15,28,49,-21,20
Sydney FC,6206,1,20,4,4,66,26,40,64
N'castle Jet,6206,2,16,5,7,58,37,21,53
Melbourne V,6206,3,14,5,10,49,40,9,47
Melbourne C,6206,4,14,4,11,43,34,9,46
Adelaide Utd,6206,5,11,6,11,37,40,-3,39
Brisbane,6206,6,10,5,13,33,42,-9,35
Western Sydn,6206,7,8,9,10,38,47,-9,33
Perth Glory,6206,8,10,2,15,37,50,-13,32
Wellington P,6206,9,5,6,16,31,55,-24,21
CC Mariners,6206,10,4,8,15,28,49,-21,20
Sydney FC,6207,1,20,4,4,65,28,37,64
N'castle Jet,6207,2,16,5,7,60,37,23,53
Melbourne V,6207,3,14,5,10,51,39,12,47
Melbourne C,6207,4,14,4,11,43,36,7,46
Adelaide Utd,6207,5,11,6,11,37,40,-3,39
Brisbane,6207,6,10,5,13,33,42,-9,35
Western Sydn,6207,7,8,9,10,38,47,-9,33
Perth Glory,6207,8,10,2,15,37,50,-13,32
Wellington P,6207,9,5,6,16,31,55,-24,21
CC Mariners,6207,10,4,8,15,28,49,-21,20
Sydney FC,6208,1,21,4,3,69,23,46,67
N'castle Jet,6208,2,15,5,8,58,39,19,50
Melbourne C,6208,3,15,4,10,45,34,11,49
Melbourne V,6208,4,13,5,11,46,43,3,44
Adelaide Utd,6208,5,11,6,11,37,40,-3,39
Brisbane,6208,6,10,5,13,33,42,-9,35
Western Sydn,6208,7,8,9,10,38,47,-9,33
Perth Glory,6208,8,10,2,15,37,50,-13,32
Wellington P,6208,9,5,6,16,31,55,-24,21
CC Mariners,6208,10,4,8,15,28,49,-21,20
Sydney FC,6209,1,21,4,3,69,23,46,67
N'castle Jet,6209,2,16,5,7,61,37,24,53
Melbourne C,6209,3,14,4,11,43,37,6,46
Melbourne V,6209,4,13,5,11,46,43,3,44
Adelaide Utd,6209,5,11,6,11,37,40,-3,39
Brisbane,6209,6,10,5,13,33,42,-9,35
Western Sydn,6209,7,8,9,10,38,47,-9,33
Perth Glory,6209,8,10,2,15,37,50,-13,32
Wellington P,6209,9,5,6,16,31,55,-24,21
CC Mariners,6209,10,4,8,15,28,49,-21,20
Sydney FC,6210,1,21,4,3,67,22,45,67
N'castle Jet,6210,2,15,6,7,58,38,20,51
Melbourne C,6210,3,14,5,10,44,34,10,47
Melbourne V,6210,4,13,5,11,45,41,4,44
Adelaide Utd,6210,5,11,6,11,37,40,-3,39
Brisbane,6210,6,10,5,13,33,42,-9,35
Western Sydn,6210,7,8,9,10,38,47,-9,33
Perth Glory,6210,8,10,2,15,37,50,-13,32
Wellington P,6210,9,5,6,16,31,55,-24,21
CC Mariners,6210,10,4,8,15,28,49,-21,20
Sydney FC,6211,1,21,4,3,66,22,44,67
N'castle Jet,6211,2,16,5,7,60,39,21,53
Melbourne C,6211,3,14,4,11,45,36,9,46
Melbourne V,6211,4,13,5,11,45,40,5,44
Adelaide Utd,6211,5,11,6,11,37,40,-3,39
Brisbane,6211,6,10,5,13,33,42,-9,35
Western Sydn,6211,7,8,9,10,38,47,-9,33
Perth Glory,6211,8,10,2,15,37,50,-13,32
Wellington P,6211,9,5,6,16,31,55,-24,21
CC Mariners,6211,10,4,8,15,28,49,-21,20
Sydney FC,6212,1,21,4,3,66,23,43,67
N'castle Jet,6212,2,15,5,8,57,40,17,50
Melbourne C,6212,3,15,4,10,46,33,13,49
Melbourne V,6212,4,13,5,11,46,40,6,44
Adelaide Utd,6212,5,11,6,11,37,40,-3,39
Brisbane,6212,6,10,5,13,33,42,-9,35
Western Sydn,6212,7,8,9,10,38,47,-9,33
Perth Glory,6212,8,10,2,15,37,50,-13,32
Wellington P,6212,9,5,6,16,31,55,-24,21
CC Mariners,6212,10,4,8,15,28,49,-21,20
Sydney FC,6213,1,20,5,3,66,24,42,65
N'castle Jet,6213,2,16,5,7,59,38,21,53
Melbourne C,6213,3,14,4,11,44,35,9,46
Melbourne V,6213,4,13,6,10,47,40,7,45
Adelaide Utd,6213,5,11,6,11,37,40,-3,39
Brisbane,6213,6,10,5,13,33,42,-9,35
Western Sydn,6213,7,8,9,10,38,47,-9,33
Perth Glory,6213,8,10,2,15,37,50,-13,32
Wellington P,6213,9,5,6,16,31,55,-24,21
CC Mariners,6213,10,4,8,15,28,49,-21,20
Sydney FC,6214,1,21,4,3,67,22,45,67
N'castle Jet,6214,2,16,5,7,62,37,25,53
Melbourne C,6214,3,14,4,11,43,38,5,46
Melbourne V,6214,4,13,5,11,45,41,4,44
Adelaide Utd,6214,5,11,6,11,37,40,-3,39
Brisbane,6214,6,10,5,13,33,42,-9,35
Western Sydn,6214,7,8,9,10,38,47,-9,33
Perth Glory,6214,8,10,2,15,37,50,-13,32
Wellington P,6214,9,5,6,16,31,55,-24,21
CC Mariners,6214,10,4,8,15,28,49,-21,20
Sydney FC,6215,1,21,4,3,67,22,45,67
N'castle Jet,6215,2,16,5,7,59,38,21,53
Melbourne C,6215,3,14,4,11,44,35,9,46
Melbourne V,6215,4,13,5,11,45,41,4,44
Adelaide Utd,6215,5,11,6,11,37,40,-3,39
Brisbane,6215,6,10,5,13,33,42,-9,35
Western Sydn,6215,7,8,9,10,38,47,-9,33
Perth Glory,6215,8,10,2,15,37,50,-13,32
Wellington P,6215,9,5,6,16,31,55,-24,21
CC Mariners,6215,10,4,8,15,28,49,-21,20
Sydney FC,6216,1,21,4,3,68,24,44,67
N'castle Jet,6216,2,16,5,7,60,39,21,53
Melbourne C,6216,3,14,4,11,45,36,9,46
Melbourne V,6216,4,13,5,11,47,42,5,44
Adelaide Utd,6216,5,11,6,11,37,40,-3,39
Brisbane,6216,6,10,5,13,33,42,-9,35
Western Sydn,6216,7,8,9,10,38,47,-9,33
Perth Glory,6216,8,10,2,15,37,50,-13,32
Wellington P,6216,9,5,6,16,31,55,-24,21
CC Mariners,6216,10,4,8,15,28,49,-21,20
Sydney FC,6217,1,21,4,3,67,24,43,67
N'castle Jet,6217,2,16,5,7,60,37,23,53
Melbourne C,6217,3,14,4,11,43,36,7,46
Melbourne V,6217,4,13,5,11,47,41,6,44
Adelaide Utd,6217,5,11,6,11,37,40,-3,39
Brisbane,6217,6,10,5,13,33,42,-9,35
Western Sydn,6217,7,8,9,10,38,47,-9,33
Perth Glory,6217,8,10,2,15,37,50,-13,32
Wellington P,6217,9,5,6,16,31,55,-24,21
CC Mariners,6217,10,4,8,15,28,49,-21,20
Sydney FC,6218,1,20,5,3,65,23,42,65
N'castle Jet,6218,2,16,5,7,60,38,22,53
Melbourne C,6218,3,14,4,11,44,36,8,46
Melbourne V,6218,4,13,6,10,46,39,7,45
Adelaide Utd,6218,5,11,6,11,37,40,-3,39
Brisbane,6218,6,10,5,13,33,42,-9,35
Western Sydn,6218,7,8,9,10,38,47,-9,33
Perth Glory,6218,8,10,2,15,37,50,-13,32
Wellington P,6218,9,5,6,16,31,55,-24,21
CC Mariners,6218,10,4,8,15,28,49,-21,20
Sydney FC,6219,1,20,4,4,65,24,41,64
N'castle Jet,6219,2,15,6,7,60,40,20,51
Melbourne C,6219,3,14,5,10,46,36,10,47
Melbourne V,6219,4,14,5,10,47,39,8,47
Adelaide Utd,6219,5,11,6,11,37,40,-3,39
Brisbane,6219,6,10,5,13,33,42,-9,35
Western Sydn,6219,7,8,9,10,38,47,-9,33
Perth Glory,6219,8,10,2,15,37,50,-13,32
Wellington P,6219,9,5,6,16,31,55,-24,21
CC Mariners,6219,10,4,8,15,28,49,-21,20
Sydney FC,6220,1,21,4,3,66,22,44,67
N'castle Jet,6220,2,16,5,7,61,39,22,53
Melbourne C,6220,3,14,4,11,45,37,8,46
Melbourne V,6220,4,13,5,11,45,40,5,44
Adelaide Utd,6220,5,11,6,11,37,40,-3,39
Brisbane,6220,6,10,5,13,33,42,-9,35
Western Sydn,6220,7,8,9,10,38,47,-9,33
Perth Glory,6220,8,10,2,15,37,50,-13,32
Wellington P,6220,9,5,6,16,31,55,-24,21
CC Mariners,6220,10,4,8,15,28,49,-21,20
Sydney FC,6221,1,20,4,4,66,25,41,64
N'castle Jet,6221,2,16,5,7,59,37,22,53
Melbourne V,6221,3,14,5,10,48,40,8,47
Melbourne C,6221,4,14,4,11,43,35,8,46
Adelaide Utd,6221,5,11,6,11,37,40,-3,39
Brisbane,6221,6,10,5,13,33,42,-9,35
Western Sydn,6221,7,8,9,10,38,47,-9,33
Perth Glory,6221,8,10,2,15,37,50,-13,32
Wellington P,6221,9,5,6,16,31,55,-24,21
CC Mariners,6221,10,4,8,15,28,49,-21,20
Sydney FC,6222,1,20,4,4,64,24,40,64
N'castle Jet,6222,2,16,5,7,61,40,21,53
Melbourne V,6222,3,14,5,10,47,38,9,47
Melbourne C,6222,4,14,4,11,46,37,9,46
Adelaide Utd,6222,5,11,6,11,37,40,-3,39
Brisbane,6222,6,10,5,13,33,42,-9,35
Western Sydn,6222,7,8,9,10,38,47,-9,33
Perth Glory,6222,8,10,2,15,37,50,-13,32
Wellington P,6222,9,5,6,16,31,55,-24,21
CC Mariners,6222,10,4,8,15,28,49,-21,20
Sydney FC,6223,1,21,4,3,67,22,45,67
N'castle Jet,6223,2,15,6,7,58,38,20,51
Melbourne C,6223,3,14,5,10,44,34,10,47
Melbourne V,6223,4,13,5,11,45,41,4,44
Adelaide Utd,6223,5,11,6,11,37,40,-3,39
Brisbane,6223,6,10,5,13,33,42,-9,35
Western Sydn,6223,7,8,9,10,38,47,-9,33
Perth Glory,6223,8,10,2,15,37,50,-13,32
Wellington P,6223,9,5,6,16,31,55,-24,21
CC Mariners,6223,10,4,8,15,28,49,-21,20
Sydney FC,6224,1,20,5,3,64,22,42,65
N'castle Jet,6224,2,16,5,7,60,39,21,53
Melbourne C,6224,3,14,4,11,45,36,9,46
Melbourne V,6224,4,13,6,10,45,38,7,45
Adelaide Utd,6224,5,11,6,11,37,40,-3,39
Brisbane,6224,6,10,5,13,33,42,-9,35
Western Sydn,6224,7,8,9,10,38,47,-9,33
Perth Glory,6224,8,10,2,15,37,50,-13,32
Wellington P,6224,9,5,6,16,31,55,-24,21
CC Mariners,6224,10,4,8,15,28,49,-21,20
Sydney FC,6225,1,21,4,3,68,22,46,67
N'castle Jet,6225,2,16,5,7,59,38,21,53
Melbourne C,6225,3,14,4,11,44,35,9,46
Melbourne V,6225,4,13,5,11,45,42,3,44
Adelaide Utd,6225,5,11,6,11,37,40,-3,39
Brisbane,6225,6,10,5,13,33,42,-9,35
Western Sydn,6225,7,8,9,10,38,47,-9,33
Perth Glory,6225,8,10,2,15,37,50,-13,32
Wellington P,6225,9,5,6,16,31,55,-24,21
CC Mariners,6225,10,4,8,15,28,49,-21,20
Sydney FC,6226,1,20,5,3,65,23,42,65
N'castle Jet,6226,2,15,5,8,57,42,15,50
Melbourne C,6226,3,15,4,10,48,33,15,49
Melbourne V,6226,4,13,6,10,46,39,7,45
Adelaide Utd,6226,5,11,6,11,37,40,-3,39
Brisbane,6226,6,10,5,13,33,42,-9,35
Western Sydn,6226,7,8,9,10,38,47,-9,33
Perth Glory,6226,8,10,2,15,37,50,-13,32
Wellington P,6226,9,5,6,16,31,55,-24,21
CC Mariners,6226,10,4,8,15,28,49,-21,20
Sydney FC,6227,1,20,5,3,66,24,42,65
N'castle Jet,6227,2,15,5,8,59,40,19,50
Melbourne C,6227,3,15,4,10,46,35,11,49
Melbourne V,6227,4,13,6,10,47,40,7,45
Adelaide Utd,6227,5,11,6,11,37,40,-3,39
Brisbane,6227,6,10,5,13,33,42,-9,35
Western Sydn,6227,7,8,9,10,38,47,-9,33
Perth Glory,6227,8,10,2,15,37,50,-13,32
Wellington P,6227,9,5,6,16,31,55,-24,21
CC Mariners,6227,10,4,8,15,28,49,-21,20
Sydney FC,6228,1,20,4,4,64,25,39,64
N'castle Jet,6228,2,16,5,7,58,37,21,53
Melbourne V,6228,3,14,5,10,48,38,10,47
Melbourne C,6228,4,14,4,11,43,34,9,46
Adelaide Utd,6228,5,11,6,11,37,40,-3,39
Brisbane,6228,6,10,5,13,33,42,-9,35
Western Sydn,6228,7,8,9,10,38,47,-9,33
Perth Glory,6228,8,10,2,15,37,50,-13,32
Wellington P,6228,9,5,6,16,31,55,-24,21
CC Mariners,6228,10,4,8,15,28,49,-21,20
Sydney FC,6229,1,20,5,3,65,23,42,65
N'castle Jet,6229,2,16,5,7,59,38,21,53
Melbourne C,6229,3,14,4,11,44,35,9,46
Melbourne V,6229,4,13,6,10,46,39,7,45
Adelaide Utd,6229,5,11,6,11,37,40,-3,39
Brisbane,6229,6,10,5,13,33,42,-9,35
Western Sydn,6229,7,8,9,10,38,47,-9,33
Perth Glory,6229,8,10,2,15,37,50,-13,32
Wellington P,6229,9,5,6,16,31,55,-24,21
CC Mariners,6229,10,4,8,15,28,49,-21,20
Sydney FC,6230,1,21,4,3,66,23,43,67
N'castle Jet,6230,2,15,5,8,59,40,19,50
Melbourne C,6230,3,15,4,10,46,35,11,49
Melbourne V,6230,4,13,5,11,46,40,6,44
Adelaide Utd,6230,5,11,6,11,37,40,-3,39
Brisbane,6230,6,10,5,13,33,42,-9,35
Western Sydn,6230,7,8,9,10,38,47,-9,33
Perth Glory,6230,8,10,2,15,37,50,-13,32
Wellington P,6230,9,5,6,16,31,55,-24,21
CC Mariners,6230,10,4,8,15,28,49,-21,20
Sydney FC,6231,1,21,4,3,66,22,44,67
N'castle Jet,6231,2,16,5,7,60,38,22,53
Melbourne C,6231,3,14,4,11,44,36,8,46
Melbourne V,6231,4,13,5,11,45,40,5,44
Adelaide Utd,6231,5,11,6,11,37,40,-3,39
Brisbane,6231,6,10,5,13,33,42,-9,35
Western Sydn,6231,7,8,9,10,38,47,-9,33
Perth Glory,6231,8,10,2,15,37,50,-13,32
Wellington P,6231,9,5,6,16,31,55,-24,21
CC Mariners,6231,10,4,8,15,28,49,-21,20
Sydney FC,6232,1,21,4,3,65,22,43,67
N'castle Jet,6232,2,16,5,7,60,38,22,53
Melbourne C,6232,3,14,4,11,44,36,8,46
Melbourne V,6232,4,13,5,11,45,39,6,44
Adelaide Utd,6232,5,11,6,11,37,40,-3,39
Brisbane,6232,6,10,5,13,33,42,-9,35
Western Sydn,6232,7,8,9,10,38,47,-9,33
Perth Glory,6232,8,10,2,15,37,50,-13,32
Wellington P,6232,9,5,6,16,31,55,-24,21
CC Mariners,6232,10,4,8,15,28,49,-21,20
Sydney FC,6233,1,21,4,3,68,22,46,67
N'castle Jet,6233,2,15,5,8,59,40,19,50
Melbourne C,6233,3,15,4,10,46,35,11,49
Melbourne V,6233,4,13,5,11,45,42,3,44
Adelaide Utd,6233,5,11,6,11,37,40,-3,39
Brisbane,6233,6,10,5,13,33,42,-9,35
Western Sydn,6233,7,8,9,10,38,47,-9,33
Perth Glory,6233,8,10,2,15,37,50,-13,32
Wellington P,6233,9,5,6,16,31,55,-24,21
CC Mariners,6233,10,4,8,15,28,49,-21,20
Sydney FC,6234,1,21,4,3,67,22,45,67
N'castle Jet,6234,2,15,5,8,57,38,19,50
Melbourne C,6234,3,15,4,10,44,33,11,49
Melbourne V,6234,4,13,5,11,45,41,4,44
Adelaide Utd,6234,5,11,6,11,37,40,-3,39
Brisbane,6234,6,10,5,13,33,42,-9,35
Western Sydn,6234,7,8,9,10,38,47,-9,33
Perth Glory,6234,8,10,2,15,37,50,-13,32
Wellington P,6234,9,5,6,16,31,55,-24,21
CC Mariners,6234,10,4,8,15,28,49,-21,20
Sydney FC,6235,1,20,5,3,65,23,42,65
N'castle Jet,6235,2,15,5,8,58,42,16,50
Melbourne C,6235,3,15,4,10,48,34,14,49
Melbourne V,6235,4,13,6,10,46,39,7,45
Adelaide Utd,6235,5,11,6,11,37,40,-3,39
Brisbane,6235,6,10,5,13,33,42,-9,35
Western Sydn,6235,7,8,9,10,38,47,-9,33
Perth Glory,6235,8,10,2,15,37,50,-13,32
Wellington P,6235,9,5,6,16,31,55,-24,21
CC Mariners,6235,10,4,8,15,28,49,-21,20
Sydney FC,6236,1,20,5,3,65,23,42,65
N'castle Jet,6236,2,15,5,8,57,39,18,50
Melbourne C,6236,3,15,4,10,45,33,12,49
Melbourne V,6236,4,13,6,10,46,39,7,45
Adelaide Utd,6236,5,11,6,11,37,40,-3,39
Brisbane,6236,6,10,5,13,33,42,-9,35
Western Sydn,6236,7,8,9,10,38,47,-9,33
Perth Glory,6236,8,10,2,15,37,50,-13,32
Wellington P,6236,9,5,6,16,31,55,-24,21
CC Mariners,6236,10,4,8,15,28,49,-21,20
Sydney FC,6237,1,21,4,3,67,22,45,67
N'castle Jet,6237,2,15,5,8,59,40,19,50
Melbourne C,6237,3,15,4,10,46,35,11,49
Melbourne V,6237,4,13,5,11,45,41,4,44
Adelaide Utd,6237,5,11,6,11,37,40,-3,39
Brisbane,6237,6,10,5,13,33,42,-9,35
Western Sydn,6237,7,8,9,10,38,47,-9,33
Perth Glory,6237,8,10,2,15,37,50,-13,32
Wellington P,6237,9,5,6,16,31,55,-24,21
CC Mariners,6237,10,4,8,15,28,49,-21,20
Sydney FC,6238,1,21,4,3,66,22,44,67
N'castle Jet,6238,2,16,5,7,60,37,23,53
Melbourne C,6238,3,14,4,11,43,36,7,46
Melbourne V,6238,4,13,5,11,45,40,5,44
Adelaide Utd,6238,5,11,6,11,37,40,-3,39
Brisbane,6238,6,10,5,13,33,42,-9,35
Western Sydn,6238,7,8,9,10,38,47,-9,33
Perth Glory,6238,8,10,2,15,37,50,-13,32
Wellington P,6238,9,5,6,16,31,55,-24,21
CC Mariners,6238,10,4,8,15,28,49,-21,20
Sydney FC,6239,1,21,4,3,67,23,44,67
N'castle Jet,6239,2,15,6,7,58,38,20,51
Melbourne C,6239,3,14,5,10,44,34,10,47
Melbourne V,6239,4,13,5,11,46,41,5,44
Adelaide Utd,6239,5,11,6,11,37,40,-3,39
Brisbane,6239,6,10,5,13,33,42,-9,35
Western Sydn,6239,7,8,9,10,38,47,-9,33
Perth Glory,6239,8,10,2,15,37,50,-13,32
Wellington P,6239,9,5,6,16,31,55,-24,21
CC Mariners,6239,10,4,8,15,28,49,-21,20
Sydney FC,6240,1,20,4,4,64,24,40,64
N'castle Jet,6240,2,15,6,7,58,38,20,51
Melbourne C,6240,3,14,5,10,44,34,10,47
Melbourne V,6240,4,14,5,10,47,38,9,47
Adelaide Utd,6240,5,11,6,11,37,40,-3,39
Brisbane,6240,6,10,5,13,33,42,-9,35
Western Sydn,6240,7,8,9,10,38,47,-9,33
Perth Glory,6240,8,10,2,15,37,50,-13,32
Wellington P,6240,9,5,6,16,31,55,-24,21
CC Mariners,6240,10,4,8,15,28,49,-21,20
Sydney FC,6241,1,20,5,3,65,23,42,65
N'castle Jet,6241,2,16,5,7,58,37,21,53
Melbourne C,6241,3,14,4,11,43,34,9,46
Melbourne V,6241,4,13,6,10,46,39,7,45
Adelaide Utd,6241,5,11,6,11,37,40,-3,39
Brisbane,6241,6,10,5,13,33,42,-9,35
Western Sydn,6241,7,8,9,10,38,47,-9,33
Perth Glory,6241,8,10,2,15,37,50,-13,32
Wellington P,6241,9,5,6,16,31,55,-24,21
CC Mariners,6241,10,4,8,15,28,49,-21,20
Sydney FC,6242,1,20,4,4,64,24,40,64
N'castle Jet,6242,2,15,5,8,57,39,18,50
Melbourne C,6242,3,15,4,10,45,33,12,49
Melbourne V,6242,4,14,5,10,47,38,9,47
Adelaide Utd,6242,5,11,6,11,37,40,-3,39
Brisbane,6242,6,10,5,13,33,42,-9,35
Western Sydn,6242,7,8,9,10,38,47,-9,33
Perth Glory,6242,8,10,2,15,37,50,-13,32
Wellington P,6242,9,5,6,16,31,55,-24,21
CC Mariners,6242,10,4,8,15,28,49,-21,20
Sydney FC,6243,1,20,5,3,66,24,42,65
N'castle Jet,6243,2,15,5,8,57,38,19,50
Melbourne C,6243,3,15,4,10,44,33,11,49
Melbourne V,6243,4,13,6,10,47,40,7,45
Adelaide Utd,6243,5,11,6,11,37,40,-3,39
Brisbane,6243,6,10,5,13,33,42,-9,35
Western Sydn,6243,7,8,9,10,38,47,-9,33
Perth Glory,6243,8,10,2,15,37,50,-13,32
Wellington P,6243,9,5,6,16,31,55,-24,21
CC Mariners,6243,10,4,8,15,28,49,-21,20
Sydney FC,6244,1,21,4,3,65,22,43,67
N'castle Jet,6244,2,15,6,7,58,38,20,51
Melbourne C,6244,3,14,5,10,44,34,10,47
Melbourne V,6244,4,13,5,11,45,39,6,44
Adelaide Utd,6244,5,11,6,11,37,40,-3,39
Brisbane,6244,6,10,5,13,33,42,-9,35
Western Sydn,6244,7,8,9,10,38,47,-9,33
Perth Glory,6244,8,10,2,15,37,50,-13,32
Wellington P,6244,9,5,6,16,31,55,-24,21
CC Mariners,6244,10,4,8,15,28,49,-21,20
Sydney FC,6245,1,21,4,3,67,22,45,67
N'castle Jet,6245,2,16,5,7,58,37,21,53
Melbourne C,6245,3,14,4,11,43,34,9,46
Melbourne V,6245,4,13,5,11,45,41,4,44
Adelaide Utd,6245,5,11,6,11,37,40,-3,39
Brisbane,6245,6,10,5,13,33,42,-9,35
Western Sydn,6245,7,8,9,10,38,47,-9,33
Perth Glory,6245,8,10,2,15,37,50,-13,32
Wellington P,6245,9,5,6,16,31,55,-24,21
CC Mariners,6245,10,4,8,15,28,49,-21,20
Sydney FC,6246,1,21,4,3,68,24,44,67
N'castle Jet,6246,2,15,6,7,58,38,20,51
Melbourne C,6246,3,14,5,10,44,34,10,47
Melbourne V,6246,4,13,5,11,47,42,5,44
Adelaide Utd,6246,5,11,6,11,37,40,-3,39
Brisbane,6246,6,10,5,13,33,42,-9,35
Western Sydn,6246,7,8,9,10,38,47,-9,33
Perth Glory,6246,8,10,2,15,37,50,-13,32
Wellington P,6246,9,5,6,16,31,55,-24,21
CC Mariners,6246,10,4,8,15,28,49,-21,20
Sydney FC,6247,1,21,4,3,65,22,43,67
N'castle Jet,6247,2,15,6,7,58,38,20,51
Melbourne C,6247,3,14,5,10,44,34,10,47
Melbourne V,6247,4,13,5,11,45,39,6,44
Adelaide Utd,6247,5,11,6,11,37,40,-3,39
Brisbane,6247,6,10,5,13,33,42,-9,35
Western Sydn,6247,7,8,9,10,38,47,-9,33
Perth Glory,6247,8,10,2,15,37,50,-13,32
Wellington P,6247,9,5,6,16,31,55,-24,21
CC Mariners,6247,10,4,8,15,28,49,-21,20
Sydney FC,6248,1,21,4,3,68,23,45,67
N'castle Jet,6248,2,15,5,8,58,40,18,50
Melbourne C,6248,3,15,4,10,46,34,12,49
Melbourne V,6248,4,13,5,11,46,42,4,44
Adelaide Utd,6248,5,11,6,11,37,40,-3,39
Brisbane,6248,6,10,5,13,33,42,-9,35
Western Sydn,6248,7,8,9,10,38,47,-9,33
Perth Glory,6248,8,10,2,15,37,50,-13,32
Wellington P,6248,9,5,6,16,31,55,-24,21
CC Mariners,6248,10,4,8,15,28,49,-21,20
Sydney FC,6249,1,21,4,3,67,24,43,67
N'castle Jet,6249,2,15,6,7,58,38,20,51
Melbourne C,6249,3,14,5,10,44,34,10,47
Melbourne V,6249,4,13,5,11,47,41,6,44
Adelaide Utd,6249,5,11,6,11,37,40,-3,39
Brisbane,6249,6,10,5,13,33,42,-9,35
Western Sydn,6249,7,8,9,10,38,47,-9,33
Perth Glory,6249,8,10,2,15,37,50,-13,32
Wellington P,6249,9,5,6,16,31,55,-24,21
CC Mariners,6249,10,4,8,15,28,49,-21,20
Sydney FC,6250,1,21,4,3,65,22,43,67
N'castle Jet,6250,2,15,6,7,58,38,20,51
Melbourne C,6250,3,14,5,10,44,34,10,47
Melbourne V,6250,4,13,5,11,45,39,6,44
Adelaide Utd,6250,5,11,6,11,37,40,-3,39
Brisbane,6250,6,10,5,13,33,42,-9,35
Western Sydn,6250,7,8,9,10,38,47,-9,33
Perth Glory,6250,8,10,2,15,37,50,-13,32
Wellington P,6250,9,5,6,16,31,55,-24,21
CC Mariners,6250,10,4,8,15,28,49,-21,20
Sydney FC,6251,1,21,4,3,68,23,45,67
N'castle Jet,6251,2,15,5,8,57,38,19,50
Melbourne C,6251,3,15,4,10,44,33,11,49
Melbourne V,6251,4,13,5,11,46,42,4,44
Adelaide Utd,6251,5,11,6,11,37,40,-3,39
Brisbane,6251,6,10,5,13,33,42,-9,35
Western Sydn,6251,7,8,9,10,38,47,-9,33
Perth Glory,6251,8,10,2,15,37,50,-13,32
Wellington P,6251,9,5,6,16,31,55,-24,21
CC Mariners,6251,10,4,8,15,28,49,-21,20
Sydney FC,6252,1,21,4,3,66,23,43,67
N'castle Jet,6252,2,16,5,7,58,37,21,53
Melbourne C,6252,3,14,4,11,43,34,9,46
Melbourne V,6252,4,13,5,11,46,40,6,44
Adelaide Utd,6252,5,11,6,11,37,40,-3,39
Brisbane,6252,6,10,5,13,33,42,-9,35
Western Sydn,6252,7,8,9,10,38,47,-9,33
Perth Glory,6252,8,10,2,15,37,50,-13,32
Wellington P,6252,9,5,6,16,31,55,-24,21
CC Mariners,6252,10,4,8,15,28,49,-21,20
Sydney FC,6253,1,20,5,3,66,24,42,65
N'castle Jet,6253,2,15,6,7,57,37,20,51
Melbourne C,6253,3,14,5,10,43,33,10,47
Melbourne V,6253,4,13,6,10,47,40,7,45
Adelaide Utd,6253,5,11,6,11,37,40,-3,39
Brisbane,6253,6,10,5,13,33,42,-9,35
Western Sydn,6253,7,8,9,10,38,47,-9,33
Perth Glory,6253,8,10,2,15,37,50,-13,32
Wellington P,6253,9,5,6,16,31,55,-24,21
CC Mariners,6253,10,4,8,15,28,49,-21,20
Sydney FC,6254,1,21,4,3,69,22,47,67
N'castle Jet,6254,2,16,5,7,58,37,21,53
Melbourne C,6254,3,14,4,11,43,34,9,46
Melbourne V,6254,4,13,5,11,45,43,2,44
Adelaide Utd,6254,5,11,6,11,37,40,-3,39
Brisbane,6254,6,10,5,13,33,42,-9,35
Western Sydn,6254,7,8,9,10,38,47,-9,33
Perth Glory,6254,8,10,2,15,37,50,-13,32
Wellington P,6254,9,5,6,16,31,55,-24,21
CC Mariners,6254,10,4,8,15,28,49,-21,20
Sydney FC,6255,1,20,4,4,65,24,41,64
N'castle Jet,6255,2,15,6,7,57,37,20,51
Melbourne C,6255,3,14,5,10,43,33,10,47
Melbourne V,6255,4,14,5,10,47,39,8,47
Adelaide Utd,6255,5,11,6,11,37,40,-3,39
Brisbane,6255,6,10,5,13,33,42,-9,35
Western Sydn,6255,7,8,9,10,38,47,-9,33
Perth Glory,6255,8,10,2,15,37,50,-13,32
Wellington P,6255,9,5,6,16,31,55,-24,21
CC Mariners,6255,10,4,8,15,28,49,-21,20
Sydney FC,6256,1,20,4,4,64,24,40,64
N'castle Jet,6256,2,16,5,7,61,39,22,53
Melbourne V,6256,3,14,5,10,47,38,9,47
Melbourne C,6256,4,14,4,11,45,37,8,46
Adelaide Utd,6256,5,11,6,11,37,40,-3,39
Brisbane,6256,6,10,5,13,33,42,-9,35
Western Sydn,6256,7,8,9,10,38,47,-9,33
Perth Glory,6256,8,10,2,15,37,50,-13,32
Wellington P,6256,9,5,6,16,31,55,-24,21
CC Mariners,6256,10,4,8,15,28,49,-21,20
Sydney FC,6257,1,21,4,3,67,23,44,67
N'castle Jet,6257,2,16,5,7,60,38,22,53
Melbourne C,6257,3,14,4,11,44,36,8,46
Melbourne V,6257,4,13,5,11,46,41,5,44
Adelaide Utd,6257,5,11,6,11,37,40,-3,39
Brisbane,6257,6,10,5,13,33,42,-9,35
Western Sydn,6257,7,8,9,10,38,47,-9,33
Perth Glory,6257,8,10,2,15,37,50,-13,32
Wellington P,6257,9,5,6,16,31,55,-24,21
CC Mariners,6257,10,4,8,15,28,49,-21,20
Sydney FC,6258,1,21,4,3,66,22,44,67
N'castle Jet,6258,2,15,5,8,58,40,18,50
Melbourne C,6258,3,15,4,10,46,34,12,49
Melbourne V,6258,4,13,5,11,45,40,5,44
Adelaide Utd,6258,5,11,6,11,37,40,-3,39
Brisbane,6258,6,10,5,13,33,42,-9,35
Western Sydn,6258,7,8,9,10,38,47,-9,33
Perth Glory,6258,8,10,2,15,37,50,-13,32
Wellington P,6258,9,5,6,16,31,55,-24,21
CC Mariners,6258,10,4,8,15,28,49,-21,20
Sydney FC,6259,1,20,5,3,66,24,42,65
N'castle Jet,6259,2,15,5,8,58,40,18,50
Melbourne C,6259,3,15,4,10,46,34,12,49
Melbourne V,6259,4,13,6,10,47,40,7,45
Adelaide Utd,6259,5,11,6,11,37,40,-3,39
Brisbane,6259,6,10,5,13,33,42,-9,35
Western Sydn,6259,7,8,9,10,38,47,-9,33
Perth Glory,6259,8,10,2,15,37,50,-13,32
Wellington P,6259,9,5,6,16,31,55,-24,21
CC Mariners,6259,10,4,8,15,28,49,-21,20
Sydney FC,6260,1,20,4,4,66,25,41,64
N'castle Jet,6260,2,15,6,7,58,38,20,51
Melbourne C,6260,3,14,5,10,44,34,10,47
Melbourne V,6260,4,14,5,10,48,40,8,47
Adelaide Utd,6260,5,11,6,11,37,40,-3,39
Brisbane,6260,6,10,5,13,33,42,-9,35
Western Sydn,6260,7,8,9,10,38,47,-9,33
Perth Glory,6260,8,10,2,15,37,50,-13,32
Wellington P,6260,9,5,6,16,31,55,-24,21
CC Mariners,6260,10,4,8,15,28,49,-21,20
Sydney FC,6261,1,21,4,3,66,22,44,67
N'castle Jet,6261,2,16,5,7,59,37,22,53
Melbourne C,6261,3,14,4,11,43,35,8,46
Melbourne V,6261,4,13,5,11,45,40,5,44
Adelaide Utd,6261,5,11,6,11,37,40,-3,39
Brisbane,6261,6,10,5,13,33,42,-9,35
Western Sydn,6261,7,8,9,10,38,47,-9,33
Perth Glory,6261,8,10,2,15,37,50,-13,32
Wellington P,6261,9,5,6,16,31,55,-24,21
CC Mariners,6261,10,4,8,15,28,49,-21,20
Sydney FC,6262,1,21,4,3,67,22,45,67
N'castle Jet,6262,2,15,6,7,60,40,20,51
Melbourne C,6262,3,14,5,10,46,36,10,47
Melbourne V,6262,4,13,5,11,45,41,4,44
Adelaide Utd,6262,5,11,6,11,37,40,-3,39
Brisbane,6262,6,10,5,13,33,42,-9,35
Western Sydn,6262,7,8,9,10,38,47,-9,33
Perth Glory,6262,8,10,2,15,37,50,-13,32
Wellington P,6262,9,5,6,16,31,55,-24,21
CC Mariners,6262,10,4,8,15,28,49,-21,20
Sydney FC,6263,1,21,4,3,66,23,43,67
N'castle Jet,6263,2,15,6,7,58,38,20,51
Melbourne C,6263,3,14,5,10,44,34,10,47
Melbourne V,6263,4,13,5,11,46,40,6,44
Adelaide Utd,6263,5,11,6,11,37,40,-3,39
Brisbane,6263,6,10,5,13,33,42,-9,35
Western Sydn,6263,7,8,9,10,38,47,-9,33
Perth Glory,6263,8,10,2,15,37,50,-13,32
Wellington P,6263,9,5,6,16,31,55,-24,21
CC Mariners,6263,10,4,8,15,28,49,-21,20
Sydney FC,6264,1,21,4,3,66,23,43,67
N'castle Jet,6264,2,16,5,7,59,37,22,53
Melbourne C,6264,3,14,4,11,43,35,8,46
Melbourne V,6264,4,13,5,11,46,40,6,44
Adelaide Utd,6264,5,11,6,11,37,40,-3,39
Brisbane,6264,6,10,5,13,33,42,-9,35
Western Sydn,6264,7,8,9,10,38,47,-9,33
Perth Glory,6264,8,10,2,15,37,50,-13,32
Wellington P,6264,9,5,6,16,31,55,-24,21
CC Mariners,6264,10,4,8,15,28,49,-21,20
Sydney FC,6265,1,20,4,4,65,25,40,64
N'castle Jet,6265,2,16,5,7,60,38,22,53
Melbourne V,6265,3,14,5,10,48,39,9,47
Melbourne C,6265,4,14,4,11,44,36,8,46
Adelaide Utd,6265,5,11,6,11,37,40,-3,39
Brisbane,6265,6,10,5,13,33,42,-9,35
Western Sydn,6265,7,8,9,10,38,47,-9,33
Perth Glory,6265,8,10,2,15,37,50,-13,32
Wellington P,6265,9,5,6,16,31,55,-24,21
CC Mariners,6265,10,4,8,15,28,49,-21,20
Sydney FC,6266,1,20,4,4,64,24,40,64
N'castle Jet,6266,2,16,5,7,60,38,22,53
Melbourne V,6266,3,14,5,10,47,38,9,47
Melbourne C,6266,4,14,4,11,44,36,8,46
Adelaide Utd,6266,5,11,6,11,37,40,-3,39
Brisbane,6266,6,10,5,13,33,42,-9,35
Western Sydn,6266,7,8,9,10,38,47,-9,33
Perth Glory,6266,8,10,2,15,37,50,-13,32
Wellington P,6266,9,5,6,16,31,55,-24,21
CC Mariners,6266,10,4,8,15,28,49,-21,20
Sydney FC,6267,1,20,4,4,65,25,40,64
N'castle Jet,6267,2,15,6,7,58,38,20,51
Melbourne C,6267,3,14,5,10,44,34,10,47
Melbourne V,6267,4,14,5,10,48,39,9,47
Adelaide Utd,6267,5,11,6,11,37,40,-3,39
Brisbane,6267,6,10,5,13,33,42,-9,35
Western Sydn,6267,7,8,9,10,38,47,-9,33
Perth Glory,6267,8,10,2,15,37,50,-13,32
Wellington P,6267,9,5,6,16,31,55,-24,21
CC Mariners,6267,10,4,8,15,28,49,-21,20
Sydney FC,6268,1,20,5,3,65,23,42,65
N'castle Jet,6268,2,16,5,7,61,38,23,53
Melbourne C,6268,3,14,4,11,44,37,7,46
Melbourne V,6268,4,13,6,10,46,39,7,45
Adelaide Utd,6268,5,11,6,11,37,40,-3,39
Brisbane,6268,6,10,5,13,33,42,-9,35
Western Sydn,6268,7,8,9,10,38,47,-9,33
Perth Glory,6268,8,10,2,15,37,50,-13,32
Wellington P,6268,9,5,6,16,31,55,-24,21
CC Mariners,6268,10,4,8,15,28,49,-21,20
Sydney FC,6269,1,20,5,3,66,24,42,65
N'castle Jet,6269,2,16,5,7,62,41,21,53
Melbourne C,6269,3,14,4,11,47,38,9,46
Melbourne V,6269,4,13,6,10,47,40,7,45
Adelaide Utd,6269,5,11,6,11,37,40,-3,39
Brisbane,6269,6,10,5,13,33,42,-9,35
Western Sydn,6269,7,8,9,10,38,47,-9,33
Perth Glory,6269,8,10,2,15,37,50,-13,32
Wellington P,6269,9,5,6,16,31,55,-24,21
CC Mariners,6269,10,4,8,15,28,49,-21,20
Sydney FC,6270,1,21,4,3,68,23,45,67
N'castle Jet,6270,2,15,6,7,57,37,20,51
Melbourne C,6270,3,14,5,10,43,33,10,47
Melbourne V,6270,4,13,5,11,46,42,4,44
Adelaide Utd,6270,5,11,6,11,37,40,-3,39
Brisbane,6270,6,10,5,13,33,42,-9,35
Western Sydn,6270,7,8,9,10,38,47,-9,33
Perth Glory,6270,8,10,2,15,37,50,-13,32
Wellington P,6270,9,5,6,16,31,55,-24,21
CC Mariners,6270,10,4,8,15,28,49,-21,20
Sydney FC,6271,1,20,5,3,65,23,42,65
N'castle Jet,6271,2,15,6,7,58,38,20,51
Melbourne C,6271,3,14,5,10,44,34,10,47
Melbourne V,6271,4,13,6,10,46,39,7,45
Adelaide Utd,6271,5,11,6,11,37,40,-3,39
Brisbane,6271,6,10,5,13,33,42,-9,35
Western Sydn,6271,7,8,9,10,38,47,-9,33
Perth Glory,6271,8,10,2,15,37,50,-13,32
Wellington P,6271,9,5,6,16,31,55,-24,21
CC Mariners,6271,10,4,8,15,28,49,-21,20
Sydney FC,6272,1,20,5,3,67,25,42,65
N'castle Jet,6272,2,16,5,7,58,37,21,53
Melbourne C,6272,3,14,4,11,43,34,9,46
Melbourne V,6272,4,13,6,10,48,41,7,45
Adelaide Utd,6272,5,11,6,11,37,40,-3,39
Brisbane,6272,6,10,5,13,33,42,-9,35
Western Sydn,6272,7,8,9,10,38,47,-9,33
Perth Glory,6272,8,10,2,15,37,50,-13,32
Wellington P,6272,9,5,6,16,31,55,-24,21
CC Mariners,6272,10,4,8,15,28,49,-21,20
Sydney FC,6273,1,20,4,4,67,26,41,64
N'castle Jet,6273,2,15,6,7,60,40,20,51
Melbourne C,6273,3,14,5,10,46,36,10,47
Melbourne V,6273,4,14,5,10,49,41,8,47
Adelaide Utd,6273,5,11,6,11,37,40,-3,39
Brisbane,6273,6,10,5,13,33,42,-9,35
Western Sydn,6273,7,8,9,10,38,47,-9,33
Perth Glory,6273,8,10,2,15,37,50,-13,32
Wellington P,6273,9,5,6,16,31,55,-24,21
CC Mariners,6273,10,4,8,15,28,49,-21,20
Sydney FC,6274,1,21,4,3,71,23,48,67
N'castle Jet,6274,2,15,5,8,57,39,18,50
Melbourne C,6274,3,15,4,10,45,33,12,49
Melbourne V,6274,4,13,5,11,46,45,1,44
Adelaide Utd,6274,5,11,6,11,37,40,-3,39
Brisbane,6274,6,10,5,13,33,42,-9,35
Western Sydn,6274,7,8,9,10,38,47,-9,33
Perth Glory,6274,8,10,2,15,37,50,-13,32
Wellington P,6274,9,5,6,16,31,55,-24,21
CC Mariners,6274,10,4,8,15,28,49,-21,20
Sydney FC,6275,1,21,4,3,68,22,46,67
N'castle Jet,6275,2,16,5,7,59,38,21,53
Melbourne C,6275,3,14,4,11,44,35,9,46
Melbourne V,6275,4,13,5,11,45,42,3,44
Adelaide Utd,6275,5,11,6,11,37,40,-3,39
Brisbane,6275,6,10,5,13,33,42,-9,35
Western Sydn,6275,7,8,9,10,38,47,-9,33
Perth Glory,6275,8,10,2,15,37,50,-13,32
Wellington P,6275,9,5,6,16,31,55,-24,21
CC Mariners,6275,10,4,8,15,28,49,-21,20
Sydney FC,6276,1,20,5,3,67,25,42,65
N'castle Jet,6276,2,16,5,7,59,38,21,53
Melbourne C,6276,3,14,4,11,44,35,9,46
Melbourne V,6276,4,13,6,10,48,41,7,45
Adelaide Utd,6276,5,11,6,11,37,40,-3,39
Brisbane,6276,6,10,5,13,33,42,-9,35
Western Sydn,6276,7,8,9,10,38,47,-9,33
Perth Glory,6276,8,10,2,15,37,50,-13,32
Wellington P,6276,9,5,6,16,31,55,-24,21
CC Mariners,6276,10,4,8,15,28,49,-21,20
Sydney FC,6277,1,21,4,3,67,23,44,67
N'castle Jet,6277,2,16,5,7,59,38,21,53
Melbourne C,6277,3,14,4,11,44,35,9,46
Melbourne V,6277,4,13,5,11,46,41,5,44
Adelaide Utd,6277,5,11,6,11,37,40,-3,39
Brisbane,6277,6,10,5,13,33,42,-9,35
Western Sydn,6277,7,8,9,10,38,47,-9,33
Perth Glory,6277,8,10,2,15,37,50,-13,32
Wellington P,6277,9,5,6,16,31,55,-24,21
CC Mariners,6277,10,4,8,15,28,49,-21,20
Sydney FC,6278,1,21,4,3,66,23,43,67
N'castle Jet,6278,2,15,6,7,58,38,20,51
Melbourne C,6278,3,14,5,10,44,34,10,47
Melbourne V,6278,4,13,5,11,46,40,6,44
Adelaide Utd,6278,5,11,6,11,37,40,-3,39
Brisbane,6278,6,10,5,13,33,42,-9,35
Western Sydn,6278,7,8,9,10,38,47,-9,33
Perth Glory,6278,8,10,2,15,37,50,-13,32
Wellington P,6278,9,5,6,16,31,55,-24,21
CC Mariners,6278,10,4,8,15,28,49,-21,20
Sydney FC,6279,1,21,4,3,67,23,44,67
N'castle Jet,6279,2,16,5,7,59,37,22,53
Melbourne C,6279,3,14,4,11,43,35,8,46
Melbourne V,6279,4,13,5,11,46,41,5,44
Adelaide Utd,6279,5,11,6,11,37,40,-3,39
Brisbane,6279,6,10,5,13,33,42,-9,35
Western Sydn,6279,7,8,9,10,38,47,-9,33
Perth Glory,6279,8,10,2,15,37,50,-13,32
Wellington P,6279,9,5,6,16,31,55,-24,21
CC Mariners,6279,10,4,8,15,28,49,-21,20
Sydney FC,6280,1,20,5,3,65,23,42,65
N'castle Jet,6280,2,16,5,7,61,38,23,53
Melbourne C,6280,3,14,4,11,44,37,7,46
Melbourne V,6280,4,13,6,10,46,39,7,45
Adelaide Utd,6280,5,11,6,11,37,40,-3,39
Brisbane,6280,6,10,5,13,33,42,-9,35
Western Sydn,6280,7,8,9,10,38,47,-9,33
Perth Glory,6280,8,10,2,15,37,50,-13,32
Wellington P,6280,9,5,6,16,31,55,-24,21
CC Mariners,6280,10,4,8,15,28,49,-21,20
Sydney FC,6281,1,21,4,3,66,23,43,67
N'castle Jet,6281,2,16,5,7,60,38,22,53
Melbourne C,6281,3,14,4,11,44,36,8,46
Melbourne V,6281,4,13,5,11,46,40,6,44
Adelaide Utd,6281,5,11,6,11,37,40,-3,39
Brisbane,6281,6,10,5,13,33,42,-9,35
Western Sydn,6281,7,8,9,10,38,47,-9,33
Perth Glory,6281,8,10,2,15,37,50,-13,32
Wellington P,6281,9,5,6,16,31,55,-24,21
CC Mariners,6281,10,4,8,15,28,49,-21,20
Sydney FC,6282,1,20,4,4,64,25,39,64
N'castle Jet,6282,2,15,6,7,59,39,20,51
Melbourne V,6282,3,14,5,10,48,38,10,47
Melbourne C,6282,4,14,5,10,45,35,10,47
Adelaide Utd,6282,5,11,6,11,37,40,-3,39
Brisbane,6282,6,10,5,13,33,42,-9,35
Western Sydn,6282,7,8,9,10,38,47,-9,33
Perth Glory,6282,8,10,2,15,37,50,-13,32
Wellington P,6282,9,5,6,16,31,55,-24,21
CC Mariners,6282,10,4,8,15,28,49,-21,20
Sydney FC,6283,1,20,5,3,65,23,42,65
N'castle Jet,6283,2,16,5,7,60,37,23,53
Melbourne C,6283,3,14,4,11,43,36,7,46
Melbourne V,6283,4,13,6,10,46,39,7,45
Adelaide Utd,6283,5,11,6,11,37,40,-3,39
Brisbane,6283,6,10,5,13,33,42,-9,35
Western Sydn,6283,7,8,9,10,38,47,-9,33
Perth Glory,6283,8,10,2,15,37,50,-13,32
Wellington P,6283,9,5,6,16,31,55,-24,21
CC Mariners,6283,10,4,8,15,28,49,-21,20
Sydney FC,6284,1,21,4,3,66,22,44,67
N'castle Jet,6284,2,16,5,7,60,38,22,53
Melbourne C,6284,3,14,4,11,44,36,8,46
Melbourne V,6284,4,13,5,11,45,40,5,44
Adelaide Utd,6284,5,11,6,11,37,40,-3,39
Brisbane,6284,6,10,5,13,33,42,-9,35
Western Sydn,6284,7,8,9,10,38,47,-9,33
Perth Glory,6284,8,10,2,15,37,50,-13,32
Wellington P,6284,9,5,6,16,31,55,-24,21
CC Mariners,6284,10,4,8,15,28,49,-21,20
Sydney FC,6285,1,21,4,3,67,23,44,67
N'castle Jet,6285,2,15,5,8,58,40,18,50
Melbourne C,6285,3,15,4,10,46,34,12,49
Melbourne V,6285,4,13,5,11,46,41,5,44
Adelaide Utd,6285,5,11,6,11,37,40,-3,39
Brisbane,6285,6,10,5,13,33,42,-9,35
Western Sydn,6285,7,8,9,10,38,47,-9,33
Perth Glory,6285,8,10,2,15,37,50,-13,32
Wellington P,6285,9,5,6,16,31,55,-24,21
CC Mariners,6285,10,4,8,15,28,49,-21,20
Sydney FC,6286,1,21,4,3,69,23,46,67
N'castle Jet,6286,2,15,5,8,61,43,18,50
Melbourne C,6286,3,15,4,10,49,37,12,49
Melbourne V,6286,4,13,5,11,46,43,3,44
Adelaide Utd,6286,5,11,6,11,37,40,-3,39
Brisbane,6286,6,10,5,13,33,42,-9,35
Western Sydn,6286,7,8,9,10,38,47,-9,33
Perth Glory,6286,8,10,2,15,37,50,-13,32
Wellington P,6286,9,5,6,16,31,55,-24,21
CC Mariners,6286,10,4,8,15,28,49,-21,20
Sydney FC,6287,1,21,4,3,66,22,44,67
N'castle Jet,6287,2,15,6,7,58,38,20,51
Melbourne C,6287,3,14,5,10,44,34,10,47
Melbourne V,6287,4,13,5,11,45,40,5,44
Adelaide Utd,6287,5,11,6,11,37,40,-3,39
Brisbane,6287,6,10,5,13,33,42,-9,35
Western Sydn,6287,7,8,9,10,38,47,-9,33
Perth Glory,6287,8,10,2,15,37,50,-13,32
Wellington P,6287,9,5,6,16,31,55,-24,21
CC Mariners,6287,10,4,8,15,28,49,-21,20
Sydney FC,6288,1,21,4,3,66,22,44,67
N'castle Jet,6288,2,16,5,7,59,38,21,53
Melbourne C,6288,3,14,4,11,44,35,9,46
Melbourne V,6288,4,13,5,11,45,40,5,44
Adelaide Utd,6288,5,11,6,11,37,40,-3,39
Brisbane,6288,6,10,5,13,33,42,-9,35
Western Sydn,6288,7,8,9,10,38,47,-9,33
Perth Glory,6288,8,10,2,15,37,50,-13,32
Wellington P,6288,9,5,6,16,31,55,-24,21
CC Mariners,6288,10,4,8,15,28,49,-21,20
Sydney FC,6289,1,21,4,3,69,22,47,67
N'castle Jet,6289,2,15,6,7,58,38,20,51
Melbourne C,6289,3,14,5,10,44,34,10,47
Melbourne V,6289,4,13,5,11,45,43,2,44
Adelaide Utd,6289,5,11,6,11,37,40,-3,39
Brisbane,6289,6,10,5,13,33,42,-9,35
Western Sydn,6289,7,8,9,10,38,47,-9,33
Perth Glory,6289,8,10,2,15,37,50,-13,32
Wellington P,6289,9,5,6,16,31,55,-24,21
CC Mariners,6289,10,4,8,15,28,49,-21,20
Sydney FC,6290,1,20,5,3,65,23,42,65
N'castle Jet,6290,2,16,5,7,63,37,26,53
Melbourne C,6290,3,14,4,11,43,39,4,46
Melbourne V,6290,4,13,6,10,46,39,7,45
Adelaide Utd,6290,5,11,6,11,37,40,-3,39
Brisbane,6290,6,10,5,13,33,42,-9,35
Western Sydn,6290,7,8,9,10,38,47,-9,33
Perth Glory,6290,8,10,2,15,37,50,-13,32
Wellington P,6290,9,5,6,16,31,55,-24,21
CC Mariners,6290,10,4,8,15,28,49,-21,20
Sydney FC,6291,1,20,4,4,65,25,40,64
N'castle Jet,6291,2,16,5,7,61,37,24,53
Melbourne V,6291,3,14,5,10,48,39,9,47
Melbourne C,6291,4,14,4,11,43,37,6,46
Adelaide Utd,6291,5,11,6,11,37,40,-3,39
Brisbane,6291,6,10,5,13,33,42,-9,35
Western Sydn,6291,7,8,9,10,38,47,-9,33
Perth Glory,6291,8,10,2,15,37,50,-13,32
Wellington P,6291,9,5,6,16,31,55,-24,21
CC Mariners,6291,10,4,8,15,28,49,-21,20
Sydney FC,6292,1,21,4,3,67,24,43,67
N'castle Jet,6292,2,15,5,8,58,39,19,50
Melbourne C,6292,3,15,4,10,45,34,11,49
Melbourne V,6292,4,13,5,11,47,41,6,44
Adelaide Utd,6292,5,11,6,11,37,40,-3,39
Brisbane,6292,6,10,5,13,33,42,-9,35
Western Sydn,6292,7,8,9,10,38,47,-9,33
Perth Glory,6292,8,10,2,15,37,50,-13,32
Wellington P,6292,9,5,6,16,31,55,-24,21
CC Mariners,6292,10,4,8,15,28,49,-21,20
Sydney FC,6293,1,20,4,4,64,23,41,64
N'castle Jet,6293,2,15,5,8,58,39,19,50
Melbourne C,6293,3,15,4,10,45,34,11,49
Melbourne V,6293,4,14,5,10,46,38,8,47
Adelaide Utd,6293,5,11,6,11,37,40,-3,39
Brisbane,6293,6,10,5,13,33,42,-9,35
Western Sydn,6293,7,8,9,10,38,47,-9,33
Perth Glory,6293,8,10,2,15,37,50,-13,32
Wellington P,6293,9,5,6,16,31,55,-24,21
CC Mariners,6293,10,4,8,15,28,49,-21,20
Sydney FC,6294,1,21,4,3,68,22,46,67
N'castle Jet,6294,2,15,6,7,59,39,20,51
Melbourne C,6294,3,14,5,10,45,35,10,47
Melbourne V,6294,4,13,5,11,45,42,3,44
Adelaide Utd,6294,5,11,6,11,37,40,-3,39
Brisbane,6294,6,10,5,13,33,42,-9,35
Western Sydn,6294,7,8,9,10,38,47,-9,33
Perth Glory,6294,8,10,2,15,37,50,-13,32
Wellington P,6294,9,5,6,16,31,55,-24,21
CC Mariners,6294,10,4,8,15,28,49,-21,20
Sydney FC,6295,1,20,5,3,65,23,42,65
N'castle Jet,6295,2,16,5,7,60,39,21,53
Melbourne C,6295,3,14,4,11,45,36,9,46
Melbourne V,6295,4,13,6,10,46,39,7,45
Adelaide Utd,6295,5,11,6,11,37,40,-3,39
Brisbane,6295,6,10,5,13,33,42,-9,35
Western Sydn,6295,7,8,9,10,38,47,-9,33
Perth Glory,6295,8,10,2,15,37,50,-13,32
Wellington P,6295,9,5,6,16,31,55,-24,21
CC Mariners,6295,10,4,8,15,28,49,-21,20
Sydney FC,6296,1,21,4,3,69,22,47,67
N'castle Jet,6296,2,15,5,8,57,38,19,50
Melbourne C,6296,3,15,4,10,44,33,11,49
Melbourne V,6296,4,13,5,11,45,43,2,44
Adelaide Utd,6296,5,11,6,11,37,40,-3,39
Brisbane,6296,6,10,5,13,33,42,-9,35
Western Sydn,6296,7,8,9,10,38,47,-9,33
Perth Glory,6296,8,10,2,15,37,50,-13,32
Wellington P,6296,9,5,6,16,31,55,-24,21
CC Mariners,6296,10,4,8,15,28,49,-21,20
Sydney FC,6297,1,20,4,4,64,24,40,64
N'castle Jet,6297,2,16,5,7,60,38,22,53
Melbourne V,6297,3,14,5,10,47,38,9,47
Melbourne C,6297,4,14,4,11,44,36,8,46
Adelaide Utd,6297,5,11,6,11,37,40,-3,39
Brisbane,6297,6,10,5,13,33,42,-9,35
Western Sydn,6297,7,8,9,10,38,47,-9,33
Perth Glory,6297,8,10,2,15,37,50,-13,32
Wellington P,6297,9,5,6,16,31,55,-24,21
CC Mariners,6297,10,4,8,15,28,49,-21,20
Sydney FC,6298,1,20,4,4,66,25,41,64
N'castle Jet,6298,2,15,6,7,58,38,20,51
Melbourne C,6298,3,14,5,10,44,34,10,47
Melbourne V,6298,4,14,5,10,48,40,8,47
Adelaide Utd,6298,5,11,6,11,37,40,-3,39
Brisbane,6298,6,10,5,13,33,42,-9,35
Western Sydn,6298,7,8,9,10,38,47,-9,33
Perth Glory,6298,8,10,2,15,37,50,-13,32
Wellington P,6298,9,5,6,16,31,55,-24,21
CC Mariners,6298,10,4,8,15,28,49,-21,20
Sydney FC,6299,1,21,4,3,67,23,44,67
N'castle Jet,6299,2,15,6,7,58,38,20,51
Melbourne C,6299,3,14,5,10,44,34,10,47
Melbourne V,6299,4,13,5,11,46,41,5,44
Adelaide Utd,6299,5,11,6,11,37,40,-3,39
Brisbane,6299,6,10,5,13,33,42,-9,35
Western Sydn,6299,7,8,9,10,38,47,-9,33
Perth Glory,6299,8,10,2,15,37,50,-13,32
Wellington P,6299,9,5,6,16,31,55,-24,21
CC Mariners,6299,10,4,8,15,28,49,-21,20
Sydney FC,6300,1,21,4,3,69,23,46,67
N'castle Jet,6300,2,15,5,8,57,38,19,50
Melbourne C,6300,3,15,4,10,44,33,11,49
Melbourne V,6300,4,13,5,11,46,43,3,44
Adelaide Utd,6300,5,11,6,11,37,40,-3,39
Brisbane,6300,6,10,5,13,33,42,-9,35
Western Sydn,6300,7,8,9,10,38,47,-9,33
Perth Glory,6300,8,10,2,15,37,50,-13,32
Wellington P,6300,9,5,6,16,31,55,-24,21
CC Mariners,6300,10,4,8,15,28,49,-21,20
Sydney FC,6301,1,21,4,3,66,23,43,67
N'castle Jet,6301,2,15,5,8,57,40,17,50
Melbourne C,6301,3,15,4,10,46,33,13,49
Melbourne V,6301,4,13,5,11,46,40,6,44
Adelaide Utd,6301,5,11,6,11,37,40,-3,39
Brisbane,6301,6,10,5,13,33,42,-9,35
Western Sydn,6301,7,8,9,10,38,47,-9,33
Perth Glory,6301,8,10,2,15,37,50,-13,32
Wellington P,6301,9,5,6,16,31,55,-24,21
CC Mariners,6301,10,4,8,15,28,49,-21,20
Sydney FC,6302,1,21,4,3,67,22,45,67
N'castle Jet,6302,2,16,5,7,60,39,21,53
Melbourne C,6302,3,14,4,11,45,36,9,46
Melbourne V,6302,4,13,5,11,45,41,4,44
Adelaide Utd,6302,5,11,6,11,37,40,-3,39
Brisbane,6302,6,10,5,13,33,42,-9,35
Western Sydn,6302,7,8,9,10,38,47,-9,33
Perth Glory,6302,8,10,2,15,37,50,-13,32
Wellington P,6302,9,5,6,16,31,55,-24,21
CC Mariners,6302,10,4,8,15,28,49,-21,20
Sydney FC,6303,1,21,4,3,68,24,44,67
N'castle Jet,6303,2,16,5,7,59,37,22,53
Melbourne C,6303,3,14,4,11,43,35,8,46
Melbourne V,6303,4,13,5,11,47,42,5,44
Adelaide Utd,6303,5,11,6,11,37,40,-3,39
Brisbane,6303,6,10,5,13,33,42,-9,35
Western Sydn,6303,7,8,9,10,38,47,-9,33
Perth Glory,6303,8,10,2,15,37,50,-13,32
Wellington P,6303,9,5,6,16,31,55,-24,21
CC Mariners,6303,10,4,8,15,28,49,-21,20
Sydney FC,6304,1,21,4,3,67,22,45,67
N'castle Jet,6304,2,15,6,7,58,38,20,51
Melbourne C,6304,3,14,5,10,44,34,10,47
Melbourne V,6304,4,13,5,11,45,41,4,44
Adelaide Utd,6304,5,11,6,11,37,40,-3,39
Brisbane,6304,6,10,5,13,33,42,-9,35
Western Sydn,6304,7,8,9,10,38,47,-9,33
Perth Glory,6304,8,10,2,15,37,50,-13,32
Wellington P,6304,9,5,6,16,31,55,-24,21
CC Mariners,6304,10,4,8,15,28,49,-21,20
Sydney FC,6305,1,21,4,3,66,23,43,67
N'castle Jet,6305,2,16,5,7,58,37,21,53
Melbourne C,6305,3,14,4,11,43,34,9,46
Melbourne V,6305,4,13,5,11,46,40,6,44
Adelaide Utd,6305,5,11,6,11,37,40,-3,39
Brisbane,6305,6,10,5,13,33,42,-9,35
Western Sydn,6305,7,8,9,10,38,47,-9,33
Perth Glory,6305,8,10,2,15,37,50,-13,32
Wellington P,6305,9,5,6,16,31,55,-24,21
CC Mariners,6305,10,4,8,15,28,49,-21,20
Sydney FC,6306,1,21,4,3,65,22,43,67
N'castle Jet,6306,2,16,5,7,60,39,21,53
Melbourne C,6306,3,14,4,11,45,36,9,46
Melbourne V,6306,4,13,5,11,45,39,6,44
Adelaide Utd,6306,5,11,6,11,37,40,-3,39
Brisbane,6306,6,10,5,13,33,42,-9,35
Western Sydn,6306,7,8,9,10,38,47,-9,33
Perth Glory,6306,8,10,2,15,37,50,-13,32
Wellington P,6306,9,5,6,16,31,55,-24,21
CC Mariners,6306,10,4,8,15,28,49,-21,20
Sydney FC,6307,1,21,4,3,69,23,46,67
N'castle Jet,6307,2,16,5,7,59,38,21,53
Melbourne C,6307,3,14,4,11,44,35,9,46
Melbourne V,6307,4,13,5,11,46,43,3,44
Adelaide Utd,6307,5,11,6,11,37,40,-3,39
Brisbane,6307,6,10,5,13,33,42,-9,35
Western Sydn,6307,7,8,9,10,38,47,-9,33
Perth Glory,6307,8,10,2,15,37,50,-13,32
Wellington P,6307,9,5,6,16,31,55,-24,21
CC Mariners,6307,10,4,8,15,28,49,-21,20
Sydney FC,6308,1,20,5,3,64,22,42,65
N'castle Jet,6308,2,16,5,7,58,37,21,53
Melbourne C,6308,3,14,4,11,43,34,9,46
Melbourne V,6308,4,13,6,10,45,38,7,45
Adelaide Utd,6308,5,11,6,11,37,40,-3,39
Brisbane,6308,6,10,5,13,33,42,-9,35
Western Sydn,6308,7,8,9,10,38,47,-9,33
Perth Glory,6308,8,10,2,15,37,50,-13,32
Wellington P,6308,9,5,6,16,31,55,-24,21
CC Mariners,6308,10,4,8,15,28,49,-21,20
Sydney FC,6309,1,21,4,3,67,22,45,67
N'castle Jet,6309,2,15,5,8,58,40,18,50
Melbourne C,6309,3,15,4,10,46,34,12,49
Melbourne V,6309,4,13,5,11,45,41,4,44
Adelaide Utd,6309,5,11,6,11,37,40,-3,39
Brisbane,6309,6,10,5,13,33,42,-9,35
Western Sydn,6309,7,8,9,10,38,47,-9,33
Perth Glory,6309,8,10,2,15,37,50,-13,32
Wellington P,6309,9,5,6,16,31,55,-24,21
CC Mariners,6309,10,4,8,15,28,49,-21,20
Sydney FC,6310,1,21,4,3,65,22,43,67
N'castle Jet,6310,2,15,6,7,57,37,20,51
Melbourne C,6310,3,14,5,10,43,33,10,47
Melbourne V,6310,4,13,5,11,45,39,6,44
Adelaide Utd,6310,5,11,6,11,37,40,-3,39
Brisbane,6310,6,10,5,13,33,42,-9,35
Western Sydn,6310,7,8,9,10,38,47,-9,33
Perth Glory,6310,8,10,2,15,37,50,-13,32
Wellington P,6310,9,5,6,16,31,55,-24,21
CC Mariners,6310,10,4,8,15,28,49,-21,20
Sydney FC,6311,1,21,4,3,67,23,44,67
N'castle Jet,6311,2,15,6,7,58,38,20,51
Melbourne C,6311,3,14,5,10,44,34,10,47
Melbourne V,6311,4,13,5,11,46,41,5,44
Adelaide Utd,6311,5,11,6,11,37,40,-3,39
Brisbane,6311,6,10,5,13,33,42,-9,35
Western Sydn,6311,7,8,9,10,38,47,-9,33
Perth Glory,6311,8,10,2,15,37,50,-13,32
Wellington P,6311,9,5,6,16,31,55,-24,21
CC Mariners,6311,10,4,8,15,28,49,-21,20
Sydney FC,6312,1,21,4,3,68,22,46,67
N'castle Jet,6312,2,15,5,8,59,41,18,50
Melbourne C,6312,3,15,4,10,47,35,12,49
Melbourne V,6312,4,13,5,11,45,42,3,44
Adelaide Utd,6312,5,11,6,11,37,40,-3,39
Brisbane,6312,6,10,5,13,33,42,-9,35
Western Sydn,6312,7,8,9,10,38,47,-9,33
Perth Glory,6312,8,10,2,15,37,50,-13,32
Wellington P,6312,9,5,6,16,31,55,-24,21
CC Mariners,6312,10,4,8,15,28,49,-21,20
Sydney FC,6313,1,20,4,4,65,24,41,64
N'castle Jet,6313,2,15,5,8,58,39,19,50
Melbourne C,6313,3,15,4,10,45,34,11,49
Melbourne V,6313,4,14,5,10,47,39,8,47
Adelaide Utd,6313,5,11,6,11,37,40,-3,39
Brisbane,6313,6,10,5,13,33,42,-9,35
Western Sydn,6313,7,8,9,10,38,47,-9,33
Perth Glory,6313,8,10,2,15,37,50,-13,32
Wellington P,6313,9,5,6,16,31,55,-24,21
CC Mariners,6313,10,4,8,15,28,49,-21,20
Sydney FC,6314,1,20,5,3,65,23,42,65
N'castle Jet,6314,2,15,6,7,59,39,20,51
Melbourne C,6314,3,14,5,10,45,35,10,47
Melbourne V,6314,4,13,6,10,46,39,7,45
Adelaide Utd,6314,5,11,6,11,37,40,-3,39
Brisbane,6314,6,10,5,13,33,42,-9,35
Western Sydn,6314,7,8,9,10,38,47,-9,33
Perth Glory,6314,8,10,2,15,37,50,-13,32
Wellington P,6314,9,5,6,16,31,55,-24,21
CC Mariners,6314,10,4,8,15,28,49,-21,20
Sydney FC,6315,1,20,5,3,64,22,42,65
N'castle Jet,6315,2,16,5,7,61,39,22,53
Melbourne C,6315,3,14,4,11,45,37,8,46
Melbourne V,6315,4,13,6,10,45,38,7,45
Adelaide Utd,6315,5,11,6,11,37,40,-3,39
Brisbane,6315,6,10,5,13,33,42,-9,35
Western Sydn,6315,7,8,9,10,38,47,-9,33
Perth Glory,6315,8,10,2,15,37,50,-13,32
Wellington P,6315,9,5,6,16,31,55,-24,21
CC Mariners,6315,10,4,8,15,28,49,-21,20
Sydney FC,6316,1,21,4,3,66,22,44,67
N'castle Jet,6316,2,15,5,8,57,38,19,50
Melbourne C,6316,3,15,4,10,44,33,11,49
Melbourne V,6316,4,13,5,11,45,40,5,44
Adelaide Utd,6316,5,11,6,11,37,40,-3,39
Brisbane,6316,6,10,5,13,33,42,-9,35
Western Sydn,6316,7,8,9,10,38,47,-9,33
Perth Glory,6316,8,10,2,15,37,50,-13,32
Wellington P,6316,9,5,6,16,31,55,-24,21
CC Mariners,6316,10,4,8,15,28,49,-21,20
Sydney FC,6317,1,20,5,3,65,23,42,65
N'castle Jet,6317,2,16,5,7,58,37,21,53
Melbourne C,6317,3,14,4,11,43,34,9,46
Melbourne V,6317,4,13,6,10,46,39,7,45
Adelaide Utd,6317,5,11,6,11,37,40,-3,39
Brisbane,6317,6,10,5,13,33,42,-9,35
Western Sydn,6317,7,8,9,10,38,47,-9,33
Perth Glory,6317,8,10,2,15,37,50,-13,32
Wellington P,6317,9,5,6,16,31,55,-24,21
CC Mariners,6317,10,4,8,15,28,49,-21,20
Sydney FC,6318,1,20,5,3,67,25,42,65
N'castle Jet,6318,2,16,5,7,60,38,22,53
Melbourne C,6318,3,14,4,11,44,36,8,46
Melbourne V,6318,4,13,6,10,48,41,7,45
Adelaide Utd,6318,5,11,6,11,37,40,-3,39
Brisbane,6318,6,10,5,13,33,42,-9,35
Western Sydn,6318,7,8,9,10,38,47,-9,33
Perth Glory,6318,8,10,2,15,37,50,-13,32
Wellington P,6318,9,5,6,16,31,55,-24,21
CC Mariners,6318,10,4,8,15,28,49,-21,20
Sydney FC,6319,1,20,4,4,65,24,41,64
N'castle Jet,6319,2,16,5,7,58,37,21,53
Melbourne V,6319,3,14,5,10,47,39,8,47
Melbourne C,6319,4,14,4,11,43,34,9,46
Adelaide Utd,6319,5,11,6,11,37,40,-3,39
Brisbane,6319,6,10,5,13,33,42,-9,35
Western Sydn,6319,7,8,9,10,38,47,-9,33
Perth Glory,6319,8,10,2,15,37,50,-13,32
Wellington P,6319,9,5,6,16,31,55,-24,21
CC Mariners,6319,10,4,8,15,28,49,-21,20
Sydney FC,6320,1,20,5,3,64,22,42,65
N'castle Jet,6320,2,16,5,7,61,37,24,53
Melbourne C,6320,3,14,4,11,43,37,6,46
Melbourne V,6320,4,13,6,10,45,38,7,45
Adelaide Utd,6320,5,11,6,11,37,40,-3,39
Brisbane,6320,6,10,5,13,33,42,-9,35
Western Sydn,6320,7,8,9,10,38,47,-9,33
Perth Glory,6320,8,10,2,15,37,50,-13,32
Wellington P,6320,9,5,6,16,31,55,-24,21
CC Mariners,6320,10,4,8,15,28,49,-21,20
Sydney FC,6321,1,21,4,3,67,23,44,67
N'castle Jet,6321,2,16,5,7,59,37,22,53
Melbourne C,6321,3,14,4,11,43,35,8,46
Melbourne V,6321,4,13,5,11,46,41,5,44
Adelaide Utd,6321,5,11,6,11,37,40,-3,39
Brisbane,6321,6,10,5,13,33,42,-9,35
Western Sydn,6321,7,8,9,10,38,47,-9,33
Perth Glory,6321,8,10,2,15,37,50,-13,32
Wellington P,6321,9,5,6,16,31,55,-24,21
CC Mariners,6321,10,4,8,15,28,49,-21,20
Sydney FC,6322,1,21,4,3,67,23,44,67
N'castle Jet,6322,2,16,5,7,60,38,22,53
Melbourne C,6322,3,14,4,11,44,36,8,46
Melbourne V,6322,4,13,5,11,46,41,5,44
Adelaide Utd,6322,5,11,6,11,37,40,-3,39
Brisbane,6322,6,10,5,13,33,42,-9,35
Western Sydn,6322,7,8,9,10,38,47,-9,33
Perth Glory,6322,8,10,2,15,37,50,-13,32
Wellington P,6322,9,5,6,16,31,55,-24,21
CC Mariners,6322,10,4,8,15,28,49,-21,20
Sydney FC,6323,1,21,4,3,66,23,43,67
N'castle Jet,6323,2,16,5,7,58,37,21,53
Melbourne C,6323,3,14,4,11,43,34,9,46
Melbourne V,6323,4,13,5,11,46,40,6,44
Adelaide Utd,6323,5,11,6,11,37,40,-3,39
Brisbane,6323,6,10,5,13,33,42,-9,35
Western Sydn,6323,7,8,9,10,38,47,-9,33
Perth Glory,6323,8,10,2,15,37,50,-13,32
Wellington P,6323,9,5,6,16,31,55,-24,21
CC Mariners,6323,10,4,8,15,28,49,-21,20
Sydney FC,6324,1,20,5,3,64,22,42,65
N'castle Jet,6324,2,16,5,7,65,39,26,53
Melbourne C,6324,3,14,4,11,45,41,4,46
Melbourne V,6324,4,13,6,10,45,38,7,45
Adelaide Utd,6324,5,11,6,11,37,40,-3,39
Brisbane,6324,6,10,5,13,33,42,-9,35
Western Sydn,6324,7,8,9,10,38,47,-9,33
Perth Glory,6324,8,10,2,15,37,50,-13,32
Wellington P,6324,9,5,6,16,31,55,-24,21
CC Mariners,6324,10,4,8,15,28,49,-21,20
Sydney FC,6325,1,21,4,3,68,22,46,67
N'castle Jet,6325,2,15,5,8,58,39,19,50
Melbourne C,6325,3,15,4,10,45,34,11,49
Melbourne V,6325,4,13,5,11,45,42,3,44
Adelaide Utd,6325,5,11,6,11,37,40,-3,39
Brisbane,6325,6,10,5,13,33,42,-9,35
Western Sydn,6325,7,8,9,10,38,47,-9,33
Perth Glory,6325,8,10,2,15,37,50,-13,32
Wellington P,6325,9,5,6,16,31,55,-24,21
CC Mariners,6325,10,4,8,15,28,49,-21,20
Sydney FC,6326,1,20,5,3,65,23,42,65
N'castle Jet,6326,2,15,6,7,58,38,20,51
Melbourne C,6326,3,14,5,10,44,34,10,47
Melbourne V,6326,4,13,6,10,46,39,7,45
Adelaide Utd,6326,5,11,6,11,37,40,-3,39
Brisbane,6326,6,10,5,13,33,42,-9,35
Western Sydn,6326,7,8,9,10,38,47,-9,33
Perth Glory,6326,8,10,2,15,37,50,-13,32
Wellington P,6326,9,5,6,16,31,55,-24,21
CC Mariners,6326,10,4,8,15,28,49,-21,20
Sydney FC,6327,1,21,4,3,68,23,45,67
N'castle Jet,6327,2,16,5,7,59,38,21,53
Melbourne C,6327,3,14,4,11,44,35,9,46
Melbourne V,6327,4,13,5,11,46,42,4,44
Adelaide Utd,6327,5,11,6,11,37,40,-3,39
Brisbane,6327,6,10,5,13,33,42,-9,35
Western Sydn,6327,7,8,9,10,38,47,-9,33
Perth Glory,6327,8,10,2,15,37,50,-13,32
Wellington P,6327,9,5,6,16,31,55,-24,21
CC Mariners,6327,10,4,8,15,28,49,-21,20
Sydney FC,6328,1,20,5,3,65,23,42,65
N'castle Jet,6328,2,15,5,8,58,43,15,50
Melbourne C,6328,3,15,4,10,49,34,15,49
Melbourne V,6328,4,13,6,10,46,39,7,45
Adelaide Utd,6328,5,11,6,11,37,40,-3,39
Brisbane,6328,6,10,5,13,33,42,-9,35
Western Sydn,6328,7,8,9,10,38,47,-9,33
Perth Glory,6328,8,10,2,15,37,50,-13,32
Wellington P,6328,9,5,6,16,31,55,-24,21
CC Mariners,6328,10,4,8,15,28,49,-21,20
Sydney FC,6329,1,21,4,3,66,22,44,67
N'castle Jet,6329,2,16,5,7,58,37,21,53
Melbourne C,6329,3,14,4,11,43,34,9,46
Melbourne V,6329,4,13,5,11,45,40,5,44
Adelaide Utd,6329,5,11,6,11,37,40,-3,39
Brisbane,6329,6,10,5,13,33,42,-9,35
Western Sydn,6329,7,8,9,10,38,47,-9,33
Perth Glory,6329,8,10,2,15,37,50,-13,32
Wellington P,6329,9,5,6,16,31,55,-24,21
CC Mariners,6329,10,4,8,15,28,49,-21,20
Sydney FC,6330,1,21,4,3,66,23,43,67
N'castle Jet,6330,2,16,5,7,60,37,23,53
Melbourne C,6330,3,14,4,11,43,36,7,46
Melbourne V,6330,4,13,5,11,46,40,6,44
Adelaide Utd,6330,5,11,6,11,37,40,-3,39
Brisbane,6330,6,10,5,13,33,42,-9,35
Western Sydn,6330,7,8,9,10,38,47,-9,33
Perth Glory,6330,8,10,2,15,37,50,-13,32
Wellington P,6330,9,5,6,16,31,55,-24,21
CC Mariners,6330,10,4,8,15,28,49,-21,20
Sydney FC,6331,1,21,4,3,72,22,50,67
N'castle Jet,6331,2,16,5,7,60,39,21,53
Melbourne C,6331,3,14,4,11,45,36,9,46
Melbourne V,6331,4,13,5,11,45,46,-1,44
Adelaide Utd,6331,5,11,6,11,37,40,-3,39
Brisbane,6331,6,10,5,13,33,42,-9,35
Western Sydn,6331,7,8,9,10,38,47,-9,33
Perth Glory,6331,8,10,2,15,37,50,-13,32
Wellington P,6331,9,5,6,16,31,55,-24,21
CC Mariners,6331,10,4,8,15,28,49,-21,20
Sydney FC,6332,1,21,4,3,66,22,44,67
N'castle Jet,6332,2,16,5,7,59,38,21,53
Melbourne C,6332,3,14,4,11,44,35,9,46
Melbourne V,6332,4,13,5,11,45,40,5,44
Adelaide Utd,6332,5,11,6,11,37,40,-3,39
Brisbane,6332,6,10,5,13,33,42,-9,35
Western Sydn,6332,7,8,9,10,38,47,-9,33
Perth Glory,6332,8,10,2,15,37,50,-13,32
Wellington P,6332,9,5,6,16,31,55,-24,21
CC Mariners,6332,10,4,8,15,28,49,-21,20
Sydney FC,6333,1,21,4,3,66,23,43,67
N'castle Jet,6333,2,16,5,7,59,38,21,53
Melbourne C,6333,3,14,4,11,44,35,9,46
Melbourne V,6333,4,13,5,11,46,40,6,44
Adelaide Utd,6333,5,11,6,11,37,40,-3,39
Brisbane,6333,6,10,5,13,33,42,-9,35
Western Sydn,6333,7,8,9,10,38,47,-9,33
Perth Glory,6333,8,10,2,15,37,50,-13,32
Wellington P,6333,9,5,6,16,31,55,-24,21
CC Mariners,6333,10,4,8,15,28,49,-21,20
Sydney FC,6334,1,20,4,4,64,23,41,64
N'castle Jet,6334,2,16,5,7,59,38,21,53
Melbourne V,6334,3,14,5,10,46,38,8,47
Melbourne C,6334,4,14,4,11,44,35,9,46
Adelaide Utd,6334,5,11,6,11,37,40,-3,39
Brisbane,6334,6,10,5,13,33,42,-9,35
Western Sydn,6334,7,8,9,10,38,47,-9,33
Perth Glory,6334,8,10,2,15,37,50,-13,32
Wellington P,6334,9,5,6,16,31,55,-24,21
CC Mariners,6334,10,4,8,15,28,49,-21,20
Sydney FC,6335,1,21,4,3,68,22,46,67
N'castle Jet,6335,2,15,6,7,58,38,20,51
Melbourne C,6335,3,14,5,10,44,34,10,47
Melbourne V,6335,4,13,5,11,45,42,3,44
Adelaide Utd,6335,5,11,6,11,37,40,-3,39
Brisbane,6335,6,10,5,13,33,42,-9,35
Western Sydn,6335,7,8,9,10,38,47,-9,33
Perth Glory,6335,8,10,2,15,37,50,-13,32
Wellington P,6335,9,5,6,16,31,55,-24,21
CC Mariners,6335,10,4,8,15,28,49,-21,20
Sydney FC,6336,1,21,4,3,72,23,49,67
N'castle Jet,6336,2,15,5,8,59,40,19,50
Melbourne C,6336,3,15,4,10,46,35,11,49
Melbourne V,6336,4,13,5,11,46,46,0,44
Adelaide Utd,6336,5,11,6,11,37,40,-3,39
Brisbane,6336,6,10,5,13,33,42,-9,35
Western Sydn,6336,7,8,9,10,38,47,-9,33
Perth Glory,6336,8,10,2,15,37,50,-13,32
Wellington P,6336,9,5,6,16,31,55,-24,21
CC Mariners,6336,10,4,8,15,28,49,-21,20
Sydney FC,6337,1,21,4,3,66,22,44,67
N'castle Jet,6337,2,16,5,7,58,37,21,53
Melbourne C,6337,3,14,4,11,43,34,9,46
Melbourne V,6337,4,13,5,11,45,40,5,44
Adelaide Utd,6337,5,11,6,11,37,40,-3,39
Brisbane,6337,6,10,5,13,33,42,-9,35
Western Sydn,6337,7,8,9,10,38,47,-9,33
Perth Glory,6337,8,10,2,15,37,50,-13,32
Wellington P,6337,9,5,6,16,31,55,-24,21
CC Mariners,6337,10,4,8,15,28,49,-21,20
Sydney FC,6338,1,21,4,3,67,22,45,67
N'castle Jet,6338,2,16,5,7,60,37,23,53
Melbourne C,6338,3,14,4,11,43,36,7,46
Melbourne V,6338,4,13,5,11,45,41,4,44
Adelaide Utd,6338,5,11,6,11,37,40,-3,39
Brisbane,6338,6,10,5,13,33,42,-9,35
Western Sydn,6338,7,8,9,10,38,47,-9,33
Perth Glory,6338,8,10,2,15,37,50,-13,32
Wellington P,6338,9,5,6,16,31,55,-24,21
CC Mariners,6338,10,4,8,15,28,49,-21,20
Sydney FC,6339,1,20,4,4,64,23,41,64
N'castle Jet,6339,2,16,5,7,61,38,23,53
Melbourne V,6339,3,14,5,10,46,38,8,47
Melbourne C,6339,4,14,4,11,44,37,7,46
Adelaide Utd,6339,5,11,6,11,37,40,-3,39
Brisbane,6339,6,10,5,13,33,42,-9,35
Western Sydn,6339,7,8,9,10,38,47,-9,33
Perth Glory,6339,8,10,2,15,37,50,-13,32
Wellington P,6339,9,5,6,16,31,55,-24,21
CC Mariners,6339,10,4,8,15,28,49,-21,20
Sydney FC,6340,1,21,4,3,67,22,45,67
N'castle Jet,6340,2,15,6,7,57,37,20,51
Melbourne C,6340,3,14,5,10,43,33,10,47
Melbourne V,6340,4,13,5,11,45,41,4,44
Adelaide Utd,6340,5,11,6,11,37,40,-3,39
Brisbane,6340,6,10,5,13,33,42,-9,35
Western Sydn,6340,7,8,9,10,38,47,-9,33
Perth Glory,6340,8,10,2,15,37,50,-13,32
Wellington P,6340,9,5,6,16,31,55,-24,21
CC Mariners,6340,10,4,8,15,28,49,-21,20
Sydney FC,6341,1,20,5,3,66,24,42,65
N'castle Jet,6341,2,16,5,7,60,37,23,53
Melbourne C,6341,3,14,4,11,43,36,7,46
Melbourne V,6341,4,13,6,10,47,40,7,45
Adelaide Utd,6341,5,11,6,11,37,40,-3,39
Brisbane,6341,6,10,5,13,33,42,-9,35
Western Sydn,6341,7,8,9,10,38,47,-9,33
Perth Glory,6341,8,10,2,15,37,50,-13,32
Wellington P,6341,9,5,6,16,31,55,-24,21
CC Mariners,6341,10,4,8,15,28,49,-21,20
Sydney FC,6342,1,20,5,3,66,24,42,65
N'castle Jet,6342,2,15,5,8,58,40,18,50
Melbourne C,6342,3,15,4,10,46,34,12,49
Melbourne V,6342,4,13,6,10,47,40,7,45
Adelaide Utd,6342,5,11,6,11,37,40,-3,39
Brisbane,6342,6,10,5,13,33,42,-9,35
Western Sydn,6342,7,8,9,10,38,47,-9,33
Perth Glory,6342,8,10,2,15,37,50,-13,32
Wellington P,6342,9,5,6,16,31,55,-24,21
CC Mariners,6342,10,4,8,15,28,49,-21,20
Sydney FC,6343,1,20,5,3,66,24,42,65
N'castle Jet,6343,2,16,5,7,59,38,21,53
Melbourne C,6343,3,14,4,11,44,35,9,46
Melbourne V,6343,4,13,6,10,47,40,7,45
Adelaide Utd,6343,5,11,6,11,37,40,-3,39
Brisbane,6343,6,10,5,13,33,42,-9,35
Western Sydn,6343,7,8,9,10,38,47,-9,33
Perth Glory,6343,8,10,2,15,37,50,-13,32
Wellington P,6343,9,5,6,16,31,55,-24,21
CC Mariners,6343,10,4,8,15,28,49,-21,20
Sydney FC,6344,1,21,4,3,68,23,45,67
N'castle Jet,6344,2,16,5,7,58,37,21,53
Melbourne C,6344,3,14,4,11,43,34,9,46
Melbourne V,6344,4,13,5,11,46,42,4,44
Adelaide Utd,6344,5,11,6,11,37,40,-3,39
Brisbane,6344,6,10,5,13,33,42,-9,35
Western Sydn,6344,7,8,9,10,38,47,-9,33
Perth Glory,6344,8,10,2,15,37,50,-13,32
Wellington P,6344,9,5,6,16,31,55,-24,21
CC Mariners,6344,10,4,8,15,28,49,-21,20
Sydney FC,6345,1,20,4,4,64,24,40,64
N'castle Jet,6345,2,15,5,8,57,39,18,50
Melbourne C,6345,3,15,4,10,45,33,12,49
Melbourne V,6345,4,14,5,10,47,38,9,47
Adelaide Utd,6345,5,11,6,11,37,40,-3,39
Brisbane,6345,6,10,5,13,33,42,-9,35
Western Sydn,6345,7,8,9,10,38,47,-9,33
Perth Glory,6345,8,10,2,15,37,50,-13,32
Wellington P,6345,9,5,6,16,31,55,-24,21
CC Mariners,6345,10,4,8,15,28,49,-21,20
Sydney FC,6346,1,20,5,3,65,23,42,65
N'castle Jet,6346,2,15,6,7,60,40,20,51
Melbourne C,6346,3,14,5,10,46,36,10,47
Melbourne V,6346,4,13,6,10,46,39,7,45
Adelaide Utd,6346,5,11,6,11,37,40,-3,39
Brisbane,6346,6,10,5,13,33,42,-9,35
Western Sydn,6346,7,8,9,10,38,47,-9,33
Perth Glory,6346,8,10,2,15,37,50,-13,32
Wellington P,6346,9,5,6,16,31,55,-24,21
CC Mariners,6346,10,4,8,15,28,49,-21,20
Sydney FC,6347,1,21,4,3,67,22,45,67
N'castle Jet,6347,2,16,5,7,58,37,21,53
Melbourne C,6347,3,14,4,11,43,34,9,46
Melbourne V,6347,4,13,5,11,45,41,4,44
Adelaide Utd,6347,5,11,6,11,37,40,-3,39
Brisbane,6347,6,10,5,13,33,42,-9,35
Western Sydn,6347,7,8,9,10,38,47,-9,33
Perth Glory,6347,8,10,2,15,37,50,-13,32
Wellington P,6347,9,5,6,16,31,55,-24,21
CC Mariners,6347,10,4,8,15,28,49,-21,20
Sydney FC,6348,1,20,4,4,64,24,40,64
N'castle Jet,6348,2,16,5,7,59,37,22,53
Melbourne V,6348,3,14,5,10,47,38,9,47
Melbourne C,6348,4,14,4,11,43,35,8,46
Adelaide Utd,6348,5,11,6,11,37,40,-3,39
Brisbane,6348,6,10,5,13,33,42,-9,35
Western Sydn,6348,7,8,9,10,38,47,-9,33
Perth Glory,6348,8,10,2,15,37,50,-13,32
Wellington P,6348,9,5,6,16,31,55,-24,21
CC Mariners,6348,10,4,8,15,28,49,-21,20
Sydney FC,6349,1,20,5,3,65,23,42,65
N'castle Jet,6349,2,15,6,7,58,38,20,51
Melbourne C,6349,3,14,5,10,44,34,10,47
Melbourne V,6349,4,13,6,10,46,39,7,45
Adelaide Utd,6349,5,11,6,11,37,40,-3,39
Brisbane,6349,6,10,5,13,33,42,-9,35
Western Sydn,6349,7,8,9,10,38,47,-9,33
Perth Glory,6349,8,10,2,15,37,50,-13,32
Wellington P,6349,9,5,6,16,31,55,-24,21
CC Mariners,6349,10,4,8,15,28,49,-21,20
Sydney FC,6350,1,20,4,4,65,24,41,64
N'castle Jet,6350,2,16,5,7,60,37,23,53
Melbourne V,6350,3,14,5,10,47,39,8,47
Melbourne C,6350,4,14,4,11,43,36,7,46
Adelaide Utd,6350,5,11,6,11,37,40,-3,39
Brisbane,6350,6,10,5,13,33,42,-9,35
Western Sydn,6350,7,8,9,10,38,47,-9,33
Perth Glory,6350,8,10,2,15,37,50,-13,32
Wellington P,6350,9,5,6,16,31,55,-24,21
CC Mariners,6350,10,4,8,15,28,49,-21,20
Sydney FC,6351,1,21,4,3,65,22,43,67
N'castle Jet,6351,2,15,5,8,57,40,17,50
Melbourne C,6351,3,15,4,10,46,33,13,49
Melbourne V,6351,4,13,5,11,45,39,6,44
Adelaide Utd,6351,5,11,6,11,37,40,-3,39
Brisbane,6351,6,10,5,13,33,42,-9,35
Western Sydn,6351,7,8,9,10,38,47,-9,33
Perth Glory,6351,8,10,2,15,37,50,-13,32
Wellington P,6351,9,5,6,16,31,55,-24,21
CC Mariners,6351,10,4,8,15,28,49,-21,20
Sydney FC,6352,1,21,4,3,65,22,43,67
N'castle Jet,6352,2,15,6,7,59,39,20,51
Melbourne C,6352,3,14,5,10,45,35,10,47
Melbourne V,6352,4,13,5,11,45,39,6,44
Adelaide Utd,6352,5,11,6,11,37,40,-3,39
Brisbane,6352,6,10,5,13,33,42,-9,35
Western Sydn,6352,7,8,9,10,38,47,-9,33
Perth Glory,6352,8,10,2,15,37,50,-13,32
Wellington P,6352,9,5,6,16,31,55,-24,21
CC Mariners,6352,10,4,8,15,28,49,-21,20
Sydney FC,6353,1,20,4,4,65,24,41,64
N'castle Jet,6353,2,16,5,7,59,37,22,53
Melbourne V,6353,3,14,5,10,47,39,8,47
Melbourne C,6353,4,14,4,11,43,35,8,46
Adelaide Utd,6353,5,11,6,11,37,40,-3,39
Brisbane,6353,6,10,5,13,33,42,-9,35
Western Sydn,6353,7,8,9,10,38,47,-9,33
Perth Glory,6353,8,10,2,15,37,50,-13,32
Wellington P,6353,9,5,6,16,31,55,-24,21
CC Mariners,6353,10,4,8,15,28,49,-21,20
Sydney FC,6354,1,20,4,4,65,24,41,64
N'castle Jet,6354,2,15,5,8,58,39,19,50
Melbourne C,6354,3,15,4,10,45,34,11,49
Melbourne V,6354,4,14,5,10,47,39,8,47
Adelaide Utd,6354,5,11,6,11,37,40,-3,39
Brisbane,6354,6,10,5,13,33,42,-9,35
Western Sydn,6354,7,8,9,10,38,47,-9,33
Perth Glory,6354,8,10,2,15,37,50,-13,32
Wellington P,6354,9,5,6,16,31,55,-24,21
CC Mariners,6354,10,4,8,15,28,49,-21,20
Sydney FC,6355,1,21,4,3,65,22,43,67
N'castle Jet,6355,2,16,5,7,60,38,22,53
Melbourne C,6355,3,14,4,11,44,36,8,46
Melbourne V,6355,4,13,5,11,45,39,6,44
Adelaide Utd,6355,5,11,6,11,37,40,-3,39
Brisbane,6355,6,10,5,13,33,42,-9,35
Western Sydn,6355,7,8,9,10,38,47,-9,33
Perth Glory,6355,8,10,2,15,37,50,-13,32
Wellington P,6355,9,5,6,16,31,55,-24,21
CC Mariners,6355,10,4,8,15,28,49,-21,20
Sydney FC,6356,1,21,4,3,66,23,43,67
N'castle Jet,6356,2,15,6,7,59,39,20,51
Melbourne C,6356,3,14,5,10,45,35,10,47
Melbourne V,6356,4,13,5,11,46,40,6,44
Adelaide Utd,6356,5,11,6,11,37,40,-3,39
Brisbane,6356,6,10,5,13,33,42,-9,35
Western Sydn,6356,7,8,9,10,38,47,-9,33
Perth Glory,6356,8,10,2,15,37,50,-13,32
Wellington P,6356,9,5,6,16,31,55,-24,21
CC Mariners,6356,10,4,8,15,28,49,-21,20
Sydney FC,6357,1,20,4,4,64,23,41,64
N'castle Jet,6357,2,16,5,7,59,37,22,53
Melbourne V,6357,3,14,5,10,46,38,8,47
Melbourne C,6357,4,14,4,11,43,35,8,46
Adelaide Utd,6357,5,11,6,11,37,40,-3,39
Brisbane,6357,6,10,5,13,33,42,-9,35
Western Sydn,6357,7,8,9,10,38,47,-9,33
Perth Glory,6357,8,10,2,15,37,50,-13,32
Wellington P,6357,9,5,6,16,31,55,-24,21
CC Mariners,6357,10,4,8,15,28,49,-21,20
Sydney FC,6358,1,21,4,3,69,23,46,67
N'castle Jet,6358,2,15,6,7,60,40,20,51
Melbourne C,6358,3,14,5,10,46,36,10,47
Melbourne V,6358,4,13,5,11,46,43,3,44
Adelaide Utd,6358,5,11,6,11,37,40,-3,39
Brisbane,6358,6,10,5,13,33,42,-9,35
Western Sydn,6358,7,8,9,10,38,47,-9,33
Perth Glory,6358,8,10,2,15,37,50,-13,32
Wellington P,6358,9,5,6,16,31,55,-24,21
CC Mariners,6358,10,4,8,15,28,49,-21,20
Sydney FC,6359,1,20,5,3,64,22,42,65
N'castle Jet,6359,2,16,5,7,62,37,25,53
Melbourne C,6359,3,14,4,11,43,38,5,46
Melbourne V,6359,4,13,6,10,45,38,7,45
Adelaide Utd,6359,5,11,6,11,37,40,-3,39
Brisbane,6359,6,10,5,13,33,42,-9,35
Western Sydn,6359,7,8,9,10,38,47,-9,33
Perth Glory,6359,8,10,2,15,37,50,-13,32
Wellington P,6359,9,5,6,16,31,55,-24,21
CC Mariners,6359,10,4,8,15,28,49,-21,20
Sydney FC,6360,1,21,4,3,69,25,44,67
N'castle Jet,6360,2,16,5,7,60,39,21,53
Melbourne C,6360,3,14,4,11,45,36,9,46
Melbourne V,6360,4,13,5,11,48,43,5,44
Adelaide Utd,6360,5,11,6,11,37,40,-3,39
Brisbane,6360,6,10,5,13,33,42,-9,35
Western Sydn,6360,7,8,9,10,38,47,-9,33
Perth Glory,6360,8,10,2,15,37,50,-13,32
Wellington P,6360,9,5,6,16,31,55,-24,21
CC Mariners,6360,10,4,8,15,28,49,-21,20
Sydney FC,6361,1,21,4,3,67,24,43,67
N'castle Jet,6361,2,15,5,8,57,38,19,50
Melbourne C,6361,3,15,4,10,44,33,11,49
Melbourne V,6361,4,13,5,11,47,41,6,44
Adelaide Utd,6361,5,11,6,11,37,40,-3,39
Brisbane,6361,6,10,5,13,33,42,-9,35
Western Sydn,6361,7,8,9,10,38,47,-9,33
Perth Glory,6361,8,10,2,15,37,50,-13,32
Wellington P,6361,9,5,6,16,31,55,-24,21
CC Mariners,6361,10,4,8,15,28,49,-21,20
Sydney FC,6362,1,21,4,3,68,22,46,67
N'castle Jet,6362,2,16,5,7,60,39,21,53
Melbourne C,6362,3,14,4,11,45,36,9,46
Melbourne V,6362,4,13,5,11,45,42,3,44
Adelaide Utd,6362,5,11,6,11,37,40,-3,39
Brisbane,6362,6,10,5,13,33,42,-9,35
Western Sydn,6362,7,8,9,10,38,47,-9,33
Perth Glory,6362,8,10,2,15,37,50,-13,32
Wellington P,6362,9,5,6,16,31,55,-24,21
CC Mariners,6362,10,4,8,15,28,49,-21,20
Sydney FC,6363,1,20,5,3,66,24,42,65
N'castle Jet,6363,2,15,5,8,57,38,19,50
Melbourne C,6363,3,15,4,10,44,33,11,49
Melbourne V,6363,4,13,6,10,47,40,7,45
Adelaide Utd,6363,5,11,6,11,37,40,-3,39
Brisbane,6363,6,10,5,13,33,42,-9,35
Western Sydn,6363,7,8,9,10,38,47,-9,33
Perth Glory,6363,8,10,2,15,37,50,-13,32
Wellington P,6363,9,5,6,16,31,55,-24,21
CC Mariners,6363,10,4,8,15,28,49,-21,20
Sydney FC,6364,1,21,4,3,65,22,43,67
N'castle Jet,6364,2,16,5,7,59,37,22,53
Melbourne C,6364,3,14,4,11,43,35,8,46
Melbourne V,6364,4,13,5,11,45,39,6,44
Adelaide Utd,6364,5,11,6,11,37,40,-3,39
Brisbane,6364,6,10,5,13,33,42,-9,35
Western Sydn,6364,7,8,9,10,38,47,-9,33
Perth Glory,6364,8,10,2,15,37,50,-13,32
Wellington P,6364,9,5,6,16,31,55,-24,21
CC Mariners,6364,10,4,8,15,28,49,-21,20
Sydney FC,6365,1,20,5,3,65,23,42,65
N'castle Jet,6365,2,15,5,8,59,40,19,50
Melbourne C,6365,3,15,4,10,46,35,11,49
Melbourne V,6365,4,13,6,10,46,39,7,45
Adelaide Utd,6365,5,11,6,11,37,40,-3,39
Brisbane,6365,6,10,5,13,33,42,-9,35
Western Sydn,6365,7,8,9,10,38,47,-9,33
Perth Glory,6365,8,10,2,15,37,50,-13,32
Wellington P,6365,9,5,6,16,31,55,-24,21
CC Mariners,6365,10,4,8,15,28,49,-21,20
Sydney FC,6366,1,21,4,3,66,22,44,67
N'castle Jet,6366,2,15,6,7,58,38,20,51
Melbourne C,6366,3,14,5,10,44,34,10,47
Melbourne V,6366,4,13,5,11,45,40,5,44
Adelaide Utd,6366,5,11,6,11,37,40,-3,39
Brisbane,6366,6,10,5,13,33,42,-9,35
Western Sydn,6366,7,8,9,10,38,47,-9,33
Perth Glory,6366,8,10,2,15,37,50,-13,32
Wellington P,6366,9,5,6,16,31,55,-24,21
CC Mariners,6366,10,4,8,15,28,49,-21,20
Sydney FC,6367,1,21,4,3,65,22,43,67
N'castle Jet,6367,2,15,5,8,57,39,18,50
Melbourne C,6367,3,15,4,10,45,33,12,49
Melbourne V,6367,4,13,5,11,45,39,6,44
Adelaide Utd,6367,5,11,6,11,37,40,-3,39
Brisbane,6367,6,10,5,13,33,42,-9,35
Western Sydn,6367,7,8,9,10,38,47,-9,33
Perth Glory,6367,8,10,2,15,37,50,-13,32
Wellington P,6367,9,5,6,16,31,55,-24,21
CC Mariners,6367,10,4,8,15,28,49,-21,20
Sydney FC,6368,1,20,4,4,65,24,41,64
N'castle Jet,6368,2,16,5,7,59,38,21,53
Melbourne V,6368,3,14,5,10,47,39,8,47
Melbourne C,6368,4,14,4,11,44,35,9,46
Adelaide Utd,6368,5,11,6,11,37,40,-3,39
Brisbane,6368,6,10,5,13,33,42,-9,35
Western Sydn,6368,7,8,9,10,38,47,-9,33
Perth Glory,6368,8,10,2,15,37,50,-13,32
Wellington P,6368,9,5,6,16,31,55,-24,21
CC Mariners,6368,10,4,8,15,28,49,-21,20
Sydney FC,6369,1,21,4,3,65,22,43,67
N'castle Jet,6369,2,15,5,8,59,43,16,50
Melbourne C,6369,3,15,4,10,49,35,14,49
Melbourne V,6369,4,13,5,11,45,39,6,44
Adelaide Utd,6369,5,11,6,11,37,40,-3,39
Brisbane,6369,6,10,5,13,33,42,-9,35
Western Sydn,6369,7,8,9,10,38,47,-9,33
Perth Glory,6369,8,10,2,15,37,50,-13,32
Wellington P,6369,9,5,6,16,31,55,-24,21
CC Mariners,6369,10,4,8,15,28,49,-21,20
Sydney FC,6370,1,21,4,3,67,24,43,67
N'castle Jet,6370,2,15,6,7,58,38,20,51
Melbourne C,6370,3,14,5,10,44,34,10,47
Melbourne V,6370,4,13,5,11,47,41,6,44
Adelaide Utd,6370,5,11,6,11,37,40,-3,39
Brisbane,6370,6,10,5,13,33,42,-9,35
Western Sydn,6370,7,8,9,10,38,47,-9,33
Perth Glory,6370,8,10,2,15,37,50,-13,32
Wellington P,6370,9,5,6,16,31,55,-24,21
CC Mariners,6370,10,4,8,15,28,49,-21,20
Sydney FC,6371,1,20,4,4,66,25,41,64
N'castle Jet,6371,2,15,6,7,58,38,20,51
Melbourne C,6371,3,14,5,10,44,34,10,47
Melbourne V,6371,4,14,5,10,48,40,8,47
Adelaide Utd,6371,5,11,6,11,37,40,-3,39
Brisbane,6371,6,10,5,13,33,42,-9,35
Western Sydn,6371,7,8,9,10,38,47,-9,33
Perth Glory,6371,8,10,2,15,37,50,-13,32
Wellington P,6371,9,5,6,16,31,55,-24,21
CC Mariners,6371,10,4,8,15,28,49,-21,20
Sydney FC,6372,1,20,4,4,64,23,41,64
N'castle Jet,6372,2,16,5,7,62,41,21,53
Melbourne V,6372,3,14,5,10,46,38,8,47
Melbourne C,6372,4,14,4,11,47,38,9,46
Adelaide Utd,6372,5,11,6,11,37,40,-3,39
Brisbane,6372,6,10,5,13,33,42,-9,35
Western Sydn,6372,7,8,9,10,38,47,-9,33
Perth Glory,6372,8,10,2,15,37,50,-13,32
Wellington P,6372,9,5,6,16,31,55,-24,21
CC Mariners,6372,10,4,8,15,28,49,-21,20
Sydney FC,6373,1,20,5,3,67,25,42,65
N'castle Jet,6373,2,16,5,7,59,38,21,53
Melbourne C,6373,3,14,4,11,44,35,9,46
Melbourne V,6373,4,13,6,10,48,41,7,45
Adelaide Utd,6373,5,11,6,11,37,40,-3,39
Brisbane,6373,6,10,5,13,33,42,-9,35
Western Sydn,6373,7,8,9,10,38,47,-9,33
Perth Glory,6373,8,10,2,15,37,50,-13,32
Wellington P,6373,9,5,6,16,31,55,-24,21
CC Mariners,6373,10,4,8,15,28,49,-21,20
Sydney FC,6374,1,21,4,3,67,23,44,67
N'castle Jet,6374,2,16,5,7,61,38,23,53
Melbourne C,6374,3,14,4,11,44,37,7,46
Melbourne V,6374,4,13,5,11,46,41,5,44
Adelaide Utd,6374,5,11,6,11,37,40,-3,39
Brisbane,6374,6,10,5,13,33,42,-9,35
Western Sydn,6374,7,8,9,10,38,47,-9,33
Perth Glory,6374,8,10,2,15,37,50,-13,32
Wellington P,6374,9,5,6,16,31,55,-24,21
CC Mariners,6374,10,4,8,15,28,49,-21,20
Sydney FC,6375,1,21,4,3,67,22,45,67
N'castle Jet,6375,2,16,5,7,61,39,22,53
Melbourne C,6375,3,14,4,11,45,37,8,46
Melbourne V,6375,4,13,5,11,45,41,4,44
Adelaide Utd,6375,5,11,6,11,37,40,-3,39
Brisbane,6375,6,10,5,13,33,42,-9,35
Western Sydn,6375,7,8,9,10,38,47,-9,33
Perth Glory,6375,8,10,2,15,37,50,-13,32
Wellington P,6375,9,5,6,16,31,55,-24,21
CC Mariners,6375,10,4,8,15,28,49,-21,20
Sydney FC,6376,1,21,4,3,65,22,43,67
N'castle Jet,6376,2,16,5,7,58,37,21,53
Melbourne C,6376,3,14,4,11,43,34,9,46
Melbourne V,6376,4,13,5,11,45,39,6,44
Adelaide Utd,6376,5,11,6,11,37,40,-3,39
Brisbane,6376,6,10,5,13,33,42,-9,35
Western Sydn,6376,7,8,9,10,38,47,-9,33
Perth Glory,6376,8,10,2,15,37,50,-13,32
Wellington P,6376,9,5,6,16,31,55,-24,21
CC Mariners,6376,10,4,8,15,28,49,-21,20
Sydney FC,6377,1,20,4,4,66,25,41,64
N'castle Jet,6377,2,16,5,7,62,38,24,53
Melbourne V,6377,3,14,5,10,48,40,8,47
Melbourne C,6377,4,14,4,11,44,38,6,46
Adelaide Utd,6377,5,11,6,11,37,40,-3,39
Brisbane,6377,6,10,5,13,33,42,-9,35
Western Sydn,6377,7,8,9,10,38,47,-9,33
Perth Glory,6377,8,10,2,15,37,50,-13,32
Wellington P,6377,9,5,6,16,31,55,-24,21
CC Mariners,6377,10,4,8,15,28,49,-21,20
Sydney FC,6378,1,21,4,3,66,22,44,67
N'castle Jet,6378,2,15,6,7,58,38,20,51
Melbourne C,6378,3,14,5,10,44,34,10,47
Melbourne V,6378,4,13,5,11,45,40,5,44
Adelaide Utd,6378,5,11,6,11,37,40,-3,39
Brisbane,6378,6,10,5,13,33,42,-9,35
Western Sydn,6378,7,8,9,10,38,47,-9,33
Perth Glory,6378,8,10,2,15,37,50,-13,32
Wellington P,6378,9,5,6,16,31,55,-24,21
CC Mariners,6378,10,4,8,15,28,49,-21,20
Sydney FC,6379,1,21,4,3,65,22,43,67
N'castle Jet,6379,2,16,5,7,62,39,23,53
Melbourne C,6379,3,14,4,11,45,38,7,46
Melbourne V,6379,4,13,5,11,45,39,6,44
Adelaide Utd,6379,5,11,6,11,37,40,-3,39
Brisbane,6379,6,10,5,13,33,42,-9,35
Western Sydn,6379,7,8,9,10,38,47,-9,33
Perth Glory,6379,8,10,2,15,37,50,-13,32
Wellington P,6379,9,5,6,16,31,55,-24,21
CC Mariners,6379,10,4,8,15,28,49,-21,20
Sydney FC,6380,1,20,4,4,65,25,40,64
N'castle Jet,6380,2,15,6,7,58,38,20,51
Melbourne C,6380,3,14,5,10,44,34,10,47
Melbourne V,6380,4,14,5,10,48,39,9,47
Adelaide Utd,6380,5,11,6,11,37,40,-3,39
Brisbane,6380,6,10,5,13,33,42,-9,35
Western Sydn,6380,7,8,9,10,38,47,-9,33
Perth Glory,6380,8,10,2,15,37,50,-13,32
Wellington P,6380,9,5,6,16,31,55,-24,21
CC Mariners,6380,10,4,8,15,28,49,-21,20
Sydney FC,6381,1,20,5,3,65,23,42,65
N'castle Jet,6381,2,16,5,7,60,37,23,53
Melbourne C,6381,3,14,4,11,43,36,7,46
Melbourne V,6381,4,13,6,10,46,39,7,45
Adelaide Utd,6381,5,11,6,11,37,40,-3,39
Brisbane,6381,6,10,5,13,33,42,-9,35
Western Sydn,6381,7,8,9,10,38,47,-9,33
Perth Glory,6381,8,10,2,15,37,50,-13,32
Wellington P,6381,9,5,6,16,31,55,-24,21
CC Mariners,6381,10,4,8,15,28,49,-21,20
Sydney FC,6382,1,21,4,3,65,22,43,67
N'castle Jet,6382,2,15,6,7,60,40,20,51
Melbourne C,6382,3,14,5,10,46,36,10,47
Melbourne V,6382,4,13,5,11,45,39,6,44
Adelaide Utd,6382,5,11,6,11,37,40,-3,39
Brisbane,6382,6,10,5,13,33,42,-9,35
Western Sydn,6382,7,8,9,10,38,47,-9,33
Perth Glory,6382,8,10,2,15,37,50,-13,32
Wellington P,6382,9,5,6,16,31,55,-24,21
CC Mariners,6382,10,4,8,15,28,49,-21,20
Sydney FC,6383,1,21,4,3,69,23,46,67
N'castle Jet,6383,2,16,5,7,59,38,21,53
Melbourne C,6383,3,14,4,11,44,35,9,46
Melbourne V,6383,4,13,5,11,46,43,3,44
Adelaide Utd,6383,5,11,6,11,37,40,-3,39
Brisbane,6383,6,10,5,13,33,42,-9,35
Western Sydn,6383,7,8,9,10,38,47,-9,33
Perth Glory,6383,8,10,2,15,37,50,-13,32
Wellington P,6383,9,5,6,16,31,55,-24,21
CC Mariners,6383,10,4,8,15,28,49,-21,20
Sydney FC,6384,1,21,4,3,67,23,44,67
N'castle Jet,6384,2,15,6,7,59,39,20,51
Melbourne C,6384,3,14,5,10,45,35,10,47
Melbourne V,6384,4,13,5,11,46,41,5,44
Adelaide Utd,6384,5,11,6,11,37,40,-3,39
Brisbane,6384,6,10,5,13,33,42,-9,35
Western Sydn,6384,7,8,9,10,38,47,-9,33
Perth Glory,6384,8,10,2,15,37,50,-13,32
Wellington P,6384,9,5,6,16,31,55,-24,21
CC Mariners,6384,10,4,8,15,28,49,-21,20
Sydney FC,6385,1,21,4,3,67,22,45,67
N'castle Jet,6385,2,16,5,7,58,37,21,53
Melbourne C,6385,3,14,4,11,43,34,9,46
Melbourne V,6385,4,13,5,11,45,41,4,44
Adelaide Utd,6385,5,11,6,11,37,40,-3,39
Brisbane,6385,6,10,5,13,33,42,-9,35
Western Sydn,6385,7,8,9,10,38,47,-9,33
Perth Glory,6385,8,10,2,15,37,50,-13,32
Wellington P,6385,9,5,6,16,31,55,-24,21
CC Mariners,6385,10,4,8,15,28,49,-21,20
Sydney FC,6386,1,20,5,3,64,22,42,65
N'castle Jet,6386,2,15,6,7,58,38,20,51
Melbourne C,6386,3,14,5,10,44,34,10,47
Melbourne V,6386,4,13,6,10,45,38,7,45
Adelaide Utd,6386,5,11,6,11,37,40,-3,39
Brisbane,6386,6,10,5,13,33,42,-9,35
Western Sydn,6386,7,8,9,10,38,47,-9,33
Perth Glory,6386,8,10,2,15,37,50,-13,32
Wellington P,6386,9,5,6,16,31,55,-24,21
CC Mariners,6386,10,4,8,15,28,49,-21,20
Sydney FC,6387,1,21,4,3,67,23,44,67
N'castle Jet,6387,2,15,6,7,58,38,20,51
Melbourne C,6387,3,14,5,10,44,34,10,47
Melbourne V,6387,4,13,5,11,46,41,5,44
Adelaide Utd,6387,5,11,6,11,37,40,-3,39
Brisbane,6387,6,10,5,13,33,42,-9,35
Western Sydn,6387,7,8,9,10,38,47,-9,33
Perth Glory,6387,8,10,2,15,37,50,-13,32
Wellington P,6387,9,5,6,16,31,55,-24,21
CC Mariners,6387,10,4,8,15,28,49,-21,20
Sydney FC,6388,1,21,4,3,68,22,46,67
N'castle Jet,6388,2,16,5,7,60,39,21,53
Melbourne C,6388,3,14,4,11,45,36,9,46
Melbourne V,6388,4,13,5,11,45,42,3,44
Adelaide Utd,6388,5,11,6,11,37,40,-3,39
Brisbane,6388,6,10,5,13,33,42,-9,35
Western Sydn,6388,7,8,9,10,38,47,-9,33
Perth Glory,6388,8,10,2,15,37,50,-13,32
Wellington P,6388,9,5,6,16,31,55,-24,21
CC Mariners,6388,10,4,8,15,28,49,-21,20
Sydney FC,6389,1,20,5,3,64,22,42,65
N'castle Jet,6389,2,15,5,8,57,38,19,50
Melbourne C,6389,3,15,4,10,44,33,11,49
Melbourne V,6389,4,13,6,10,45,38,7,45
Adelaide Utd,6389,5,11,6,11,37,40,-3,39
Brisbane,6389,6,10,5,13,33,42,-9,35
Western Sydn,6389,7,8,9,10,38,47,-9,33
Perth Glory,6389,8,10,2,15,37,50,-13,32
Wellington P,6389,9,5,6,16,31,55,-24,21
CC Mariners,6389,10,4,8,15,28,49,-21,20
Sydney FC,6390,1,21,4,3,67,23,44,67
N'castle Jet,6390,2,15,5,8,57,40,17,50
Melbourne C,6390,3,15,4,10,46,33,13,49
Melbourne V,6390,4,13,5,11,46,41,5,44
Adelaide Utd,6390,5,11,6,11,37,40,-3,39
Brisbane,6390,6,10,5,13,33,42,-9,35
Western Sydn,6390,7,8,9,10,38,47,-9,33
Perth Glory,6390,8,10,2,15,37,50,-13,32
Wellington P,6390,9,5,6,16,31,55,-24,21
CC Mariners,6390,10,4,8,15,28,49,-21,20
Sydney FC,6391,1,20,4,4,64,23,41,64
N'castle Jet,6391,2,15,5,8,57,38,19,50
Melbourne C,6391,3,15,4,10,44,33,11,49
Melbourne V,6391,4,14,5,10,46,38,8,47
Adelaide Utd,6391,5,11,6,11,37,40,-3,39
Brisbane,6391,6,10,5,13,33,42,-9,35
Western Sydn,6391,7,8,9,10,38,47,-9,33
Perth Glory,6391,8,10,2,15,37,50,-13,32
Wellington P,6391,9,5,6,16,31,55,-24,21
CC Mariners,6391,10,4,8,15,28,49,-21,20
Sydney FC,6392,1,20,5,3,65,23,42,65
N'castle Jet,6392,2,16,5,7,60,38,22,53
Melbourne C,6392,3,14,4,11,44,36,8,46
Melbourne V,6392,4,13,6,10,46,39,7,45
Adelaide Utd,6392,5,11,6,11,37,40,-3,39
Brisbane,6392,6,10,5,13,33,42,-9,35
Western Sydn,6392,7,8,9,10,38,47,-9,33
Perth Glory,6392,8,10,2,15,37,50,-13,32
Wellington P,6392,9,5,6,16,31,55,-24,21
CC Mariners,6392,10,4,8,15,28,49,-21,20
Sydney FC,6393,1,21,4,3,66,22,44,67
N'castle Jet,6393,2,16,5,7,61,40,21,53
Melbourne C,6393,3,14,4,11,46,37,9,46
Melbourne V,6393,4,13,5,11,45,40,5,44
Adelaide Utd,6393,5,11,6,11,37,40,-3,39
Brisbane,6393,6,10,5,13,33,42,-9,35
Western Sydn,6393,7,8,9,10,38,47,-9,33
Perth Glory,6393,8,10,2,15,37,50,-13,32
Wellington P,6393,9,5,6,16,31,55,-24,21
CC Mariners,6393,10,4,8,15,28,49,-21,20
Sydney FC,6394,1,20,5,3,66,24,42,65
N'castle Jet,6394,2,15,5,8,58,39,19,50
Melbourne C,6394,3,15,4,10,45,34,11,49
Melbourne V,6394,4,13,6,10,47,40,7,45
Adelaide Utd,6394,5,11,6,11,37,40,-3,39
Brisbane,6394,6,10,5,13,33,42,-9,35
Western Sydn,6394,7,8,9,10,38,47,-9,33
Perth Glory,6394,8,10,2,15,37,50,-13,32
Wellington P,6394,9,5,6,16,31,55,-24,21
CC Mariners,6394,10,4,8,15,28,49,-21,20
Sydney FC,6395,1,20,5,3,64,22,42,65
N'castle Jet,6395,2,15,5,8,58,40,18,50
Melbourne C,6395,3,15,4,10,46,34,12,49
Melbourne V,6395,4,13,6,10,45,38,7,45
Adelaide Utd,6395,5,11,6,11,37,40,-3,39
Brisbane,6395,6,10,5,13,33,42,-9,35
Western Sydn,6395,7,8,9,10,38,47,-9,33
Perth Glory,6395,8,10,2,15,37,50,-13,32
Wellington P,6395,9,5,6,16,31,55,-24,21
CC Mariners,6395,10,4,8,15,28,49,-21,20
Sydney FC,6396,1,20,5,3,66,24,42,65
N'castle Jet,6396,2,16,5,7,59,37,22,53
Melbourne C,6396,3,14,4,11,43,35,8,46
Melbourne V,6396,4,13,6,10,47,40,7,45
Adelaide Utd,6396,5,11,6,11,37,40,-3,39
Brisbane,6396,6,10,5,13,33,42,-9,35
Western Sydn,6396,7,8,9,10,38,47,-9,33
Perth Glory,6396,8,10,2,15,37,50,-13,32
Wellington P,6396,9,5,6,16,31,55,-24,21
CC Mariners,6396,10,4,8,15,28,49,-21,20
Sydney FC,6397,1,21,4,3,65,22,43,67
N'castle Jet,6397,2,16,5,7,58,37,21,53
Melbourne C,6397,3,14,4,11,43,34,9,46
Melbourne V,6397,4,13,5,11,45,39,6,44
Adelaide Utd,6397,5,11,6,11,37,40,-3,39
Brisbane,6397,6,10,5,13,33,42,-9,35
Western Sydn,6397,7,8,9,10,38,47,-9,33
Perth Glory,6397,8,10,2,15,37,50,-13,32
Wellington P,6397,9,5,6,16,31,55,-24,21
CC Mariners,6397,10,4,8,15,28,49,-21,20
Sydney FC,6398,1,20,4,4,65,26,39,64
N'castle Jet,6398,2,16,5,7,60,39,21,53
Melbourne V,6398,3,14,5,10,49,39,10,47
Melbourne C,6398,4,14,4,11,45,36,9,46
Adelaide Utd,6398,5,11,6,11,37,40,-3,39
Brisbane,6398,6,10,5,13,33,42,-9,35
Western Sydn,6398,7,8,9,10,38,47,-9,33
Perth Glory,6398,8,10,2,15,37,50,-13,32
Wellington P,6398,9,5,6,16,31,55,-24,21
CC Mariners,6398,10,4,8,15,28,49,-21,20
Sydney FC,6399,1,21,4,3,70,22,48,67
N'castle Jet,6399,2,16,5,7,58,37,21,53
Melbourne C,6399,3,14,4,11,43,34,9,46
Melbourne V,6399,4,13,5,11,45,44,1,44
Adelaide Utd,6399,5,11,6,11,37,40,-3,39
Brisbane,6399,6,10,5,13,33,42,-9,35
Western Sydn,6399,7,8,9,10,38,47,-9,33
Perth Glory,6399,8,10,2,15,37,50,-13,32
Wellington P,6399,9,5,6,16,31,55,-24,21
CC Mariners,6399,10,4,8,15,28,49,-21,20
Sydney FC,6400,1,21,4,3,68,23,45,67
N'castle Jet,6400,2,16,5,7,60,37,23,53
Melbourne C,6400,3,14,4,11,43,36,7,46
Melbourne V,6400,4,13,5,11,46,42,4,44
Adelaide Utd,6400,5,11,6,11,37,40,-3,39
Brisbane,6400,6,10,5,13,33,42,-9,35
Western Sydn,6400,7,8,9,10,38,47,-9,33
Perth Glory,6400,8,10,2,15,37,50,-13,32
Wellington P,6400,9,5,6,16,31,55,-24,21
CC Mariners,6400,10,4,8,15,28,49,-21,20
Sydney FC,6401,1,20,5,3,66,24,42,65
N'castle Jet,6401,2,15,5,8,57,38,19,50
Melbourne C,6401,3,15,4,10,44,33,11,49
Melbourne V,6401,4,13,6,10,47,40,7,45
Adelaide Utd,6401,5,11,6,11,37,40,-3,39
Brisbane,6401,6,10,5,13,33,42,-9,35
Western Sydn,6401,7,8,9,10,38,47,-9,33
Perth Glory,6401,8,10,2,15,37,50,-13,32
Wellington P,6401,9,5,6,16,31,55,-24,21
CC Mariners,6401,10,4,8,15,28,49,-21,20
Sydney FC,6402,1,21,4,3,65,22,43,67
N'castle Jet,6402,2,15,5,8,58,40,18,50
Melbourne C,6402,3,15,4,10,46,34,12,49
Melbourne V,6402,4,13,5,11,45,39,6,44
Adelaide Utd,6402,5,11,6,11,37,40,-3,39
Brisbane,6402,6,10,5,13,33,42,-9,35
Western Sydn,6402,7,8,9,10,38,47,-9,33
Perth Glory,6402,8,10,2,15,37,50,-13,32
Wellington P,6402,9,5,6,16,31,55,-24,21
CC Mariners,6402,10,4,8,15,28,49,-21,20
Sydney FC,6403,1,21,4,3,66,23,43,67
N'castle Jet,6403,2,15,6,7,59,39,20,51
Melbourne C,6403,3,14,5,10,45,35,10,47
Melbourne V,6403,4,13,5,11,46,40,6,44
Adelaide Utd,6403,5,11,6,11,37,40,-3,39
Brisbane,6403,6,10,5,13,33,42,-9,35
Western Sydn,6403,7,8,9,10,38,47,-9,33
Perth Glory,6403,8,10,2,15,37,50,-13,32
Wellington P,6403,9,5,6,16,31,55,-24,21
CC Mariners,6403,10,4,8,15,28,49,-21,20
Sydney FC,6404,1,21,4,3,67,24,43,67
N'castle Jet,6404,2,15,5,8,59,41,18,50
Melbourne C,6404,3,15,4,10,47,35,12,49
Melbourne V,6404,4,13,5,11,47,41,6,44
Adelaide Utd,6404,5,11,6,11,37,40,-3,39
Brisbane,6404,6,10,5,13,33,42,-9,35
Western Sydn,6404,7,8,9,10,38,47,-9,33
Perth Glory,6404,8,10,2,15,37,50,-13,32
Wellington P,6404,9,5,6,16,31,55,-24,21
CC Mariners,6404,10,4,8,15,28,49,-21,20
Sydney FC,6405,1,20,5,3,64,22,42,65
N'castle Jet,6405,2,16,5,7,59,38,21,53
Melbourne C,6405,3,14,4,11,44,35,9,46
Melbourne V,6405,4,13,6,10,45,38,7,45
Adelaide Utd,6405,5,11,6,11,37,40,-3,39
Brisbane,6405,6,10,5,13,33,42,-9,35
Western Sydn,6405,7,8,9,10,38,47,-9,33
Perth Glory,6405,8,10,2,15,37,50,-13,32
Wellington P,6405,9,5,6,16,31,55,-24,21
CC Mariners,6405,10,4,8,15,28,49,-21,20
Sydney FC,6406,1,21,4,3,65,22,43,67
N'castle Jet,6406,2,15,5,8,57,39,18,50
Melbourne C,6406,3,15,4,10,45,33,12,49
Melbourne V,6406,4,13,5,11,45,39,6,44
Adelaide Utd,6406,5,11,6,11,37,40,-3,39
Brisbane,6406,6,10,5,13,33,42,-9,35
Western Sydn,6406,7,8,9,10,38,47,-9,33
Perth Glory,6406,8,10,2,15,37,50,-13,32
Wellington P,6406,9,5,6,16,31,55,-24,21
CC Mariners,6406,10,4,8,15,28,49,-21,20
Sydney FC,6407,1,20,5,3,66,24,42,65
N'castle Jet,6407,2,15,6,7,59,39,20,51
Melbourne C,6407,3,14,5,10,45,35,10,47
Melbourne V,6407,4,13,6,10,47,40,7,45
Adelaide Utd,6407,5,11,6,11,37,40,-3,39
Brisbane,6407,6,10,5,13,33,42,-9,35
Western Sydn,6407,7,8,9,10,38,47,-9,33
Perth Glory,6407,8,10,2,15,37,50,-13,32
Wellington P,6407,9,5,6,16,31,55,-24,21
CC Mariners,6407,10,4,8,15,28,49,-21,20
Sydney FC,6408,1,21,4,3,67,22,45,67
N'castle Jet,6408,2,15,6,7,59,39,20,51
Melbourne C,6408,3,14,5,10,45,35,10,47
Melbourne V,6408,4,13,5,11,45,41,4,44
Adelaide Utd,6408,5,11,6,11,37,40,-3,39
Brisbane,6408,6,10,5,13,33,42,-9,35
Western Sydn,6408,7,8,9,10,38,47,-9,33
Perth Glory,6408,8,10,2,15,37,50,-13,32
Wellington P,6408,9,5,6,16,31,55,-24,21
CC Mariners,6408,10,4,8,15,28,49,-21,20
Sydney FC,6409,1,20,4,4,65,24,41,64
N'castle Jet,6409,2,16,5,7,60,37,23,53
Melbourne V,6409,3,14,5,10,47,39,8,47
Melbourne C,6409,4,14,4,11,43,36,7,46
Adelaide Utd,6409,5,11,6,11,37,40,-3,39
Brisbane,6409,6,10,5,13,33,42,-9,35
Western Sydn,6409,7,8,9,10,38,47,-9,33
Perth Glory,6409,8,10,2,15,37,50,-13,32
Wellington P,6409,9,5,6,16,31,55,-24,21
CC Mariners,6409,10,4,8,15,28,49,-21,20
Sydney FC,6410,1,21,4,3,67,24,43,67
N'castle Jet,6410,2,16,5,7,62,39,23,53
Melbourne C,6410,3,14,4,11,45,38,7,46
Melbourne V,6410,4,13,5,11,47,41,6,44
Adelaide Utd,6410,5,11,6,11,37,40,-3,39
Brisbane,6410,6,10,5,13,33,42,-9,35
Western Sydn,6410,7,8,9,10,38,47,-9,33
Perth Glory,6410,8,10,2,15,37,50,-13,32
Wellington P,6410,9,5,6,16,31,55,-24,21
CC Mariners,6410,10,4,8,15,28,49,-21,20
Sydney FC,6411,1,21,4,3,66,23,43,67
N'castle Jet,6411,2,16,5,7,62,37,25,53
Melbourne C,6411,3,14,4,11,43,38,5,46
Melbourne V,6411,4,13,5,11,46,40,6,44
Adelaide Utd,6411,5,11,6,11,37,40,-3,39
Brisbane,6411,6,10,5,13,33,42,-9,35
Western Sydn,6411,7,8,9,10,38,47,-9,33
Perth Glory,6411,8,10,2,15,37,50,-13,32
Wellington P,6411,9,5,6,16,31,55,-24,21
CC Mariners,6411,10,4,8,15,28,49,-21,20
Sydney FC,6412,1,21,4,3,66,23,43,67
N'castle Jet,6412,2,16,5,7,60,37,23,53
Melbourne C,6412,3,14,4,11,43,36,7,46
Melbourne V,6412,4,13,5,11,46,40,6,44
Adelaide Utd,6412,5,11,6,11,37,40,-3,39
Brisbane,6412,6,10,5,13,33,42,-9,35
Western Sydn,6412,7,8,9,10,38,47,-9,33
Perth Glory,6412,8,10,2,15,37,50,-13,32
Wellington P,6412,9,5,6,16,31,55,-24,21
CC Mariners,6412,10,4,8,15,28,49,-21,20
Sydney FC,6413,1,21,4,3,70,24,46,67
N'castle Jet,6413,2,15,6,7,58,38,20,51
Melbourne C,6413,3,14,5,10,44,34,10,47
Melbourne V,6413,4,13,5,11,47,44,3,44
Adelaide Utd,6413,5,11,6,11,37,40,-3,39
Brisbane,6413,6,10,5,13,33,42,-9,35
Western Sydn,6413,7,8,9,10,38,47,-9,33
Perth Glory,6413,8,10,2,15,37,50,-13,32
Wellington P,6413,9,5,6,16,31,55,-24,21
CC Mariners,6413,10,4,8,15,28,49,-21,20
Sydney FC,6414,1,20,5,3,65,23,42,65
N'castle Jet,6414,2,16,5,7,59,37,22,53
Melbourne C,6414,3,14,4,11,43,35,8,46
Melbourne V,6414,4,13,6,10,46,39,7,45
Adelaide Utd,6414,5,11,6,11,37,40,-3,39
Brisbane,6414,6,10,5,13,33,42,-9,35
Western Sydn,6414,7,8,9,10,38,47,-9,33
Perth Glory,6414,8,10,2,15,37,50,-13,32
Wellington P,6414,9,5,6,16,31,55,-24,21
CC Mariners,6414,10,4,8,15,28,49,-21,20
Sydney FC,6415,1,21,4,3,67,24,43,67
N'castle Jet,6415,2,15,6,7,57,37,20,51
Melbourne C,6415,3,14,5,10,43,33,10,47
Melbourne V,6415,4,13,5,11,47,41,6,44
Adelaide Utd,6415,5,11,6,11,37,40,-3,39
Brisbane,6415,6,10,5,13,33,42,-9,35
Western Sydn,6415,7,8,9,10,38,47,-9,33
Perth Glory,6415,8,10,2,15,37,50,-13,32
Wellington P,6415,9,5,6,16,31,55,-24,21
CC Mariners,6415,10,4,8,15,28,49,-21,20
Sydney FC,6416,1,20,5,3,64,22,42,65
N'castle Jet,6416,2,16,5,7,61,39,22,53
Melbourne C,6416,3,14,4,11,45,37,8,46
Melbourne V,6416,4,13,6,10,45,38,7,45
Adelaide Utd,6416,5,11,6,11,37,40,-3,39
Brisbane,6416,6,10,5,13,33,42,-9,35
Western Sydn,6416,7,8,9,10,38,47,-9,33
Perth Glory,6416,8,10,2,15,37,50,-13,32
Wellington P,6416,9,5,6,16,31,55,-24,21
CC Mariners,6416,10,4,8,15,28,49,-21,20
Sydney FC,6417,1,20,5,3,65,23,42,65
N'castle Jet,6417,2,16,5,7,60,39,21,53
Melbourne C,6417,3,14,4,11,45,36,9,46
Melbourne V,6417,4,13,6,10,46,39,7,45
Adelaide Utd,6417,5,11,6,11,37,40,-3,39
Brisbane,6417,6,10,5,13,33,42,-9,35
Western Sydn,6417,7,8,9,10,38,47,-9,33
Perth Glory,6417,8,10,2,15,37,50,-13,32
Wellington P,6417,9,5,6,16,31,55,-24,21
CC Mariners,6417,10,4,8,15,28,49,-21,20
Sydney FC,6418,1,21,4,3,66,22,44,67
N'castle Jet,6418,2,15,5,8,57,38,19,50
Melbourne C,6418,3,15,4,10,44,33,11,49
Melbourne V,6418,4,13,5,11,45,40,5,44
Adelaide Utd,6418,5,11,6,11,37,40,-3,39
Brisbane,6418,6,10,5,13,33,42,-9,35
Western Sydn,6418,7,8,9,10,38,47,-9,33
Perth Glory,6418,8,10,2,15,37,50,-13,32
Wellington P,6418,9,5,6,16,31,55,-24,21
CC Mariners,6418,10,4,8,15,28,49,-21,20
Sydney FC,6419,1,21,4,3,67,23,44,67
N'castle Jet,6419,2,15,5,8,59,40,19,50
Melbourne C,6419,3,15,4,10,46,35,11,49
Melbourne V,6419,4,13,5,11,46,41,5,44
Adelaide Utd,6419,5,11,6,11,37,40,-3,39
Brisbane,6419,6,10,5,13,33,42,-9,35
Western Sydn,6419,7,8,9,10,38,47,-9,33
Perth Glory,6419,8,10,2,15,37,50,-13,32
Wellington P,6419,9,5,6,16,31,55,-24,21
CC Mariners,6419,10,4,8,15,28,49,-21,20
Sydney FC,6420,1,21,4,3,66,22,44,67
N'castle Jet,6420,2,16,5,7,60,38,22,53
Melbourne C,6420,3,14,4,11,44,36,8,46
Melbourne V,6420,4,13,5,11,45,40,5,44
Adelaide Utd,6420,5,11,6,11,37,40,-3,39
Brisbane,6420,6,10,5,13,33,42,-9,35
Western Sydn,6420,7,8,9,10,38,47,-9,33
Perth Glory,6420,8,10,2,15,37,50,-13,32
Wellington P,6420,9,5,6,16,31,55,-24,21
CC Mariners,6420,10,4,8,15,28,49,-21,20
Sydney FC,6421,1,21,4,3,66,23,43,67
N'castle Jet,6421,2,16,5,7,58,37,21,53
Melbourne C,6421,3,14,4,11,43,34,9,46
Melbourne V,6421,4,13,5,11,46,40,6,44
Adelaide Utd,6421,5,11,6,11,37,40,-3,39
Brisbane,6421,6,10,5,13,33,42,-9,35
Western Sydn,6421,7,8,9,10,38,47,-9,33
Perth Glory,6421,8,10,2,15,37,50,-13,32
Wellington P,6421,9,5,6,16,31,55,-24,21
CC Mariners,6421,10,4,8,15,28,49,-21,20
Sydney FC,6422,1,21,4,3,67,23,44,67
N'castle Jet,6422,2,15,6,7,58,38,20,51
Melbourne C,6422,3,14,5,10,44,34,10,47
Melbourne V,6422,4,13,5,11,46,41,5,44
Adelaide Utd,6422,5,11,6,11,37,40,-3,39
Brisbane,6422,6,10,5,13,33,42,-9,35
Western Sydn,6422,7,8,9,10,38,47,-9,33
Perth Glory,6422,8,10,2,15,37,50,-13,32
Wellington P,6422,9,5,6,16,31,55,-24,21
CC Mariners,6422,10,4,8,15,28,49,-21,20
Sydney FC,6423,1,21,4,3,65,22,43,67
N'castle Jet,6423,2,15,6,7,58,38,20,51
Melbourne C,6423,3,14,5,10,44,34,10,47
Melbourne V,6423,4,13,5,11,45,39,6,44
Adelaide Utd,6423,5,11,6,11,37,40,-3,39
Brisbane,6423,6,10,5,13,33,42,-9,35
Western Sydn,6423,7,8,9,10,38,47,-9,33
Perth Glory,6423,8,10,2,15,37,50,-13,32
Wellington P,6423,9,5,6,16,31,55,-24,21
CC Mariners,6423,10,4,8,15,28,49,-21,20
Sydney FC,6424,1,21,4,3,68,24,44,67
N'castle Jet,6424,2,16,5,7,58,37,21,53
Melbourne C,6424,3,14,4,11,43,34,9,46
Melbourne V,6424,4,13,5,11,47,42,5,44
Adelaide Utd,6424,5,11,6,11,37,40,-3,39
Brisbane,6424,6,10,5,13,33,42,-9,35
Western Sydn,6424,7,8,9,10,38,47,-9,33
Perth Glory,6424,8,10,2,15,37,50,-13,32
Wellington P,6424,9,5,6,16,31,55,-24,21
CC Mariners,6424,10,4,8,15,28,49,-21,20
Sydney FC,6425,1,20,4,4,65,26,39,64
N'castle Jet,6425,2,15,5,8,58,39,19,50
Melbourne C,6425,3,15,4,10,45,34,11,49
Melbourne V,6425,4,14,5,10,49,39,10,47
Adelaide Utd,6425,5,11,6,11,37,40,-3,39
Brisbane,6425,6,10,5,13,33,42,-9,35
Western Sydn,6425,7,8,9,10,38,47,-9,33
Perth Glory,6425,8,10,2,15,37,50,-13,32
Wellington P,6425,9,5,6,16,31,55,-24,21
CC Mariners,6425,10,4,8,15,28,49,-21,20
Sydney FC,6426,1,21,4,3,68,22,46,67
N'castle Jet,6426,2,16,5,7,60,37,23,53
Melbourne C,6426,3,14,4,11,43,36,7,46
Melbourne V,6426,4,13,5,11,45,42,3,44
Adelaide Utd,6426,5,11,6,11,37,40,-3,39
Brisbane,6426,6,10,5,13,33,42,-9,35
Western Sydn,6426,7,8,9,10,38,47,-9,33
Perth Glory,6426,8,10,2,15,37,50,-13,32
Wellington P,6426,9,5,6,16,31,55,-24,21
CC Mariners,6426,10,4,8,15,28,49,-21,20
Sydney FC,6427,1,20,4,4,67,26,41,64
N'castle Jet,6427,2,16,5,7,60,38,22,53
Melbourne V,6427,3,14,5,10,49,41,8,47
Melbourne C,6427,4,14,4,11,44,36,8,46
Adelaide Utd,6427,5,11,6,11,37,40,-3,39
Brisbane,6427,6,10,5,13,33,42,-9,35
Western Sydn,6427,7,8,9,10,38,47,-9,33
Perth Glory,6427,8,10,2,15,37,50,-13,32
Wellington P,6427,9,5,6,16,31,55,-24,21
CC Mariners,6427,10,4,8,15,28,49,-21,20
Sydney FC,6428,1,21,4,3,66,22,44,67
N'castle Jet,6428,2,16,5,7,60,37,23,53
Melbourne C,6428,3,14,4,11,43,36,7,46
Melbourne V,6428,4,13,5,11,45,40,5,44
Adelaide Utd,6428,5,11,6,11,37,40,-3,39
Brisbane,6428,6,10,5,13,33,42,-9,35
Western Sydn,6428,7,8,9,10,38,47,-9,33
Perth Glory,6428,8,10,2,15,37,50,-13,32
Wellington P,6428,9,5,6,16,31,55,-24,21
CC Mariners,6428,10,4,8,15,28,49,-21,20
Sydney FC,6429,1,20,5,3,65,23,42,65
N'castle Jet,6429,2,16,5,7,64,38,26,53
Melbourne C,6429,3,14,4,11,44,40,4,46
Melbourne V,6429,4,13,6,10,46,39,7,45
Adelaide Utd,6429,5,11,6,11,37,40,-3,39
Brisbane,6429,6,10,5,13,33,42,-9,35
Western Sydn,6429,7,8,9,10,38,47,-9,33
Perth Glory,6429,8,10,2,15,37,50,-13,32
Wellington P,6429,9,5,6,16,31,55,-24,21
CC Mariners,6429,10,4,8,15,28,49,-21,20
Sydney FC,6430,1,21,4,3,67,24,43,67
N'castle Jet,6430,2,15,5,8,58,39,19,50
Melbourne C,6430,3,15,4,10,45,34,11,49
Melbourne V,6430,4,13,5,11,47,41,6,44
Adelaide Utd,6430,5,11,6,11,37,40,-3,39
Brisbane,6430,6,10,5,13,33,42,-9,35
Western Sydn,6430,7,8,9,10,38,47,-9,33
Perth Glory,6430,8,10,2,15,37,50,-13,32
Wellington P,6430,9,5,6,16,31,55,-24,21
CC Mariners,6430,10,4,8,15,28,49,-21,20
Sydney FC,6431,1,21,4,3,68,22,46,67
N'castle Jet,6431,2,15,6,7,59,39,20,51
Melbourne C,6431,3,14,5,10,45,35,10,47
Melbourne V,6431,4,13,5,11,45,42,3,44
Adelaide Utd,6431,5,11,6,11,37,40,-3,39
Brisbane,6431,6,10,5,13,33,42,-9,35
Western Sydn,6431,7,8,9,10,38,47,-9,33
Perth Glory,6431,8,10,2,15,37,50,-13,32
Wellington P,6431,9,5,6,16,31,55,-24,21
CC Mariners,6431,10,4,8,15,28,49,-21,20
Sydney FC,6432,1,21,4,3,66,23,43,67
N'castle Jet,6432,2,15,6,7,58,38,20,51
Melbourne C,6432,3,14,5,10,44,34,10,47
Melbourne V,6432,4,13,5,11,46,40,6,44
Adelaide Utd,6432,5,11,6,11,37,40,-3,39
Brisbane,6432,6,10,5,13,33,42,-9,35
Western Sydn,6432,7,8,9,10,38,47,-9,33
Perth Glory,6432,8,10,2,15,37,50,-13,32
Wellington P,6432,9,5,6,16,31,55,-24,21
CC Mariners,6432,10,4,8,15,28,49,-21,20
Sydney FC,6433,1,21,4,3,67,22,45,67
N'castle Jet,6433,2,16,5,7,59,37,22,53
Melbourne C,6433,3,14,4,11,43,35,8,46
Melbourne V,6433,4,13,5,11,45,41,4,44
Adelaide Utd,6433,5,11,6,11,37,40,-3,39
Brisbane,6433,6,10,5,13,33,42,-9,35
Western Sydn,6433,7,8,9,10,38,47,-9,33
Perth Glory,6433,8,10,2,15,37,50,-13,32
Wellington P,6433,9,5,6,16,31,55,-24,21
CC Mariners,6433,10,4,8,15,28,49,-21,20
Sydney FC,6434,1,21,4,3,66,23,43,67
N'castle Jet,6434,2,15,6,7,58,38,20,51
Melbourne C,6434,3,14,5,10,44,34,10,47
Melbourne V,6434,4,13,5,11,46,40,6,44
Adelaide Utd,6434,5,11,6,11,37,40,-3,39
Brisbane,6434,6,10,5,13,33,42,-9,35
Western Sydn,6434,7,8,9,10,38,47,-9,33
Perth Glory,6434,8,10,2,15,37,50,-13,32
Wellington P,6434,9,5,6,16,31,55,-24,21
CC Mariners,6434,10,4,8,15,28,49,-21,20
Sydney FC,6435,1,20,4,4,64,24,40,64
N'castle Jet,6435,2,15,6,7,58,38,20,51
Melbourne C,6435,3,14,5,10,44,34,10,47
Melbourne V,6435,4,14,5,10,47,38,9,47
Adelaide Utd,6435,5,11,6,11,37,40,-3,39
Brisbane,6435,6,10,5,13,33,42,-9,35
Western Sydn,6435,7,8,9,10,38,47,-9,33
Perth Glory,6435,8,10,2,15,37,50,-13,32
Wellington P,6435,9,5,6,16,31,55,-24,21
CC Mariners,6435,10,4,8,15,28,49,-21,20
Sydney FC,6436,1,20,5,3,65,23,42,65
N'castle Jet,6436,2,15,5,8,58,40,18,50
Melbourne C,6436,3,15,4,10,46,34,12,49
Melbourne V,6436,4,13,6,10,46,39,7,45
Adelaide Utd,6436,5,11,6,11,37,40,-3,39
Brisbane,6436,6,10,5,13,33,42,-9,35
Western Sydn,6436,7,8,9,10,38,47,-9,33
Perth Glory,6436,8,10,2,15,37,50,-13,32
Wellington P,6436,9,5,6,16,31,55,-24,21
CC Mariners,6436,10,4,8,15,28,49,-21,20
Sydney FC,6437,1,20,4,4,64,24,40,64
N'castle Jet,6437,2,15,5,8,58,39,19,50
Melbourne C,6437,3,15,4,10,45,34,11,49
Melbourne V,6437,4,14,5,10,47,38,9,47
Adelaide Utd,6437,5,11,6,11,37,40,-3,39
Brisbane,6437,6,10,5,13,33,42,-9,35
Western Sydn,6437,7,8,9,10,38,47,-9,33
Perth Glory,6437,8,10,2,15,37,50,-13,32
Wellington P,6437,9,5,6,16,31,55,-24,21
CC Mariners,6437,10,4,8,15,28,49,-21,20
Sydney FC,6438,1,21,4,3,67,22,45,67
N'castle Jet,6438,2,16,5,7,62,37,25,53
Melbourne C,6438,3,14,4,11,43,38,5,46
Melbourne V,6438,4,13,5,11,45,41,4,44
Adelaide Utd,6438,5,11,6,11,37,40,-3,39
Brisbane,6438,6,10,5,13,33,42,-9,35
Western Sydn,6438,7,8,9,10,38,47,-9,33
Perth Glory,6438,8,10,2,15,37,50,-13,32
Wellington P,6438,9,5,6,16,31,55,-24,21
CC Mariners,6438,10,4,8,15,28,49,-21,20
Sydney FC,6439,1,21,4,3,66,23,43,67
N'castle Jet,6439,2,16,5,7,59,37,22,53
Melbourne C,6439,3,14,4,11,43,35,8,46
Melbourne V,6439,4,13,5,11,46,40,6,44
Adelaide Utd,6439,5,11,6,11,37,40,-3,39
Brisbane,6439,6,10,5,13,33,42,-9,35
Western Sydn,6439,7,8,9,10,38,47,-9,33
Perth Glory,6439,8,10,2,15,37,50,-13,32
Wellington P,6439,9,5,6,16,31,55,-24,21
CC Mariners,6439,10,4,8,15,28,49,-21,20
Sydney FC,6440,1,21,4,3,67,22,45,67
N'castle Jet,6440,2,16,5,7,60,37,23,53
Melbourne C,6440,3,14,4,11,43,36,7,46
Melbourne V,6440,4,13,5,11,45,41,4,44
Adelaide Utd,6440,5,11,6,11,37,40,-3,39
Brisbane,6440,6,10,5,13,33,42,-9,35
Western Sydn,6440,7,8,9,10,38,47,-9,33
Perth Glory,6440,8,10,2,15,37,50,-13,32
Wellington P,6440,9,5,6,16,31,55,-24,21
CC Mariners,6440,10,4,8,15,28,49,-21,20
Sydney FC,6441,1,21,4,3,68,23,45,67
N'castle Jet,6441,2,16,5,7,61,39,22,53
Melbourne C,6441,3,14,4,11,45,37,8,46
Melbourne V,6441,4,13,5,11,46,42,4,44
Adelaide Utd,6441,5,11,6,11,37,40,-3,39
Brisbane,6441,6,10,5,13,33,42,-9,35
Western Sydn,6441,7,8,9,10,38,47,-9,33
Perth Glory,6441,8,10,2,15,37,50,-13,32
Wellington P,6441,9,5,6,16,31,55,-24,21
CC Mariners,6441,10,4,8,15,28,49,-21,20
Sydney FC,6442,1,21,4,3,67,22,45,67
N'castle Jet,6442,2,15,5,8,57,40,17,50
Melbourne C,6442,3,15,4,10,46,33,13,49
Melbourne V,6442,4,13,5,11,45,41,4,44
Adelaide Utd,6442,5,11,6,11,37,40,-3,39
Brisbane,6442,6,10,5,13,33,42,-9,35
Western Sydn,6442,7,8,9,10,38,47,-9,33
Perth Glory,6442,8,10,2,15,37,50,-13,32
Wellington P,6442,9,5,6,16,31,55,-24,21
CC Mariners,6442,10,4,8,15,28,49,-21,20
Sydney FC,6443,1,20,4,4,65,25,40,64
N'castle Jet,6443,2,15,5,8,58,39,19,50
Melbourne C,6443,3,15,4,10,45,34,11,49
Melbourne V,6443,4,14,5,10,48,39,9,47
Adelaide Utd,6443,5,11,6,11,37,40,-3,39
Brisbane,6443,6,10,5,13,33,42,-9,35
Western Sydn,6443,7,8,9,10,38,47,-9,33
Perth Glory,6443,8,10,2,15,37,50,-13,32
Wellington P,6443,9,5,6,16,31,55,-24,21
CC Mariners,6443,10,4,8,15,28,49,-21,20
Sydney FC,6444,1,21,4,3,66,23,43,67
N'castle Jet,6444,2,16,5,7,59,37,22,53
Melbourne C,6444,3,14,4,11,43,35,8,46
Melbourne V,6444,4,13,5,11,46,40,6,44
Adelaide Utd,6444,5,11,6,11,37,40,-3,39
Brisbane,6444,6,10,5,13,33,42,-9,35
Western Sydn,6444,7,8,9,10,38,47,-9,33
Perth Glory,6444,8,10,2,15,37,50,-13,32
Wellington P,6444,9,5,6,16,31,55,-24,21
CC Mariners,6444,10,4,8,15,28,49,-21,20
Sydney FC,6445,1,20,4,4,66,25,41,64
N'castle Jet,6445,2,15,5,8,59,40,19,50
Melbourne C,6445,3,15,4,10,46,35,11,49
Melbourne V,6445,4,14,5,10,48,40,8,47
Adelaide Utd,6445,5,11,6,11,37,40,-3,39
Brisbane,6445,6,10,5,13,33,42,-9,35
Western Sydn,6445,7,8,9,10,38,47,-9,33
Perth Glory,6445,8,10,2,15,37,50,-13,32
Wellington P,6445,9,5,6,16,31,55,-24,21
CC Mariners,6445,10,4,8,15,28,49,-21,20
Sydney FC,6446,1,21,4,3,67,22,45,67
N'castle Jet,6446,2,16,5,7,60,39,21,53
Melbourne C,6446,3,14,4,11,45,36,9,46
Melbourne V,6446,4,13,5,11,45,41,4,44
Adelaide Utd,6446,5,11,6,11,37,40,-3,39
Brisbane,6446,6,10,5,13,33,42,-9,35
Western Sydn,6446,7,8,9,10,38,47,-9,33
Perth Glory,6446,8,10,2,15,37,50,-13,32
Wellington P,6446,9,5,6,16,31,55,-24,21
CC Mariners,6446,10,4,8,15,28,49,-21,20
Sydney FC,6447,1,20,4,4,64,24,40,64
N'castle Jet,6447,2,16,5,7,60,39,21,53
Melbourne V,6447,3,14,5,10,47,38,9,47
Melbourne C,6447,4,14,4,11,45,36,9,46
Adelaide Utd,6447,5,11,6,11,37,40,-3,39
Brisbane,6447,6,10,5,13,33,42,-9,35
Western Sydn,6447,7,8,9,10,38,47,-9,33
Perth Glory,6447,8,10,2,15,37,50,-13,32
Wellington P,6447,9,5,6,16,31,55,-24,21
CC Mariners,6447,10,4,8,15,28,49,-21,20
Sydney FC,6448,1,21,4,3,66,22,44,67
N'castle Jet,6448,2,16,5,7,61,38,23,53
Melbourne C,6448,3,14,4,11,44,37,7,46
Melbourne V,6448,4,13,5,11,45,40,5,44
Adelaide Utd,6448,5,11,6,11,37,40,-3,39
Brisbane,6448,6,10,5,13,33,42,-9,35
Western Sydn,6448,7,8,9,10,38,47,-9,33
Perth Glory,6448,8,10,2,15,37,50,-13,32
Wellington P,6448,9,5,6,16,31,55,-24,21
CC Mariners,6448,10,4,8,15,28,49,-21,20
Sydney FC,6449,1,21,4,3,66,22,44,67
N'castle Jet,6449,2,15,5,8,58,39,19,50
Melbourne C,6449,3,15,4,10,45,34,11,49
Melbourne V,6449,4,13,5,11,45,40,5,44
Adelaide Utd,6449,5,11,6,11,37,40,-3,39
Brisbane,6449,6,10,5,13,33,42,-9,35
Western Sydn,6449,7,8,9,10,38,47,-9,33
Perth Glory,6449,8,10,2,15,37,50,-13,32
Wellington P,6449,9,5,6,16,31,55,-24,21
CC Mariners,6449,10,4,8,15,28,49,-21,20
Sydney FC,6450,1,20,5,3,66,24,42,65
N'castle Jet,6450,2,15,6,7,58,38,20,51
Melbourne C,6450,3,14,5,10,44,34,10,47
Melbourne V,6450,4,13,6,10,47,40,7,45
Adelaide Utd,6450,5,11,6,11,37,40,-3,39
Brisbane,6450,6,10,5,13,33,42,-9,35
Western Sydn,6450,7,8,9,10,38,47,-9,33
Perth Glory,6450,8,10,2,15,37,50,-13,32
Wellington P,6450,9,5,6,16,31,55,-24,21
CC Mariners,6450,10,4,8,15,28,49,-21,20
Sydney FC,6451,1,20,5,3,65,23,42,65
N'castle Jet,6451,2,16,5,7,58,37,21,53
Melbourne C,6451,3,14,4,11,43,34,9,46
Melbourne V,6451,4,13,6,10,46,39,7,45
Adelaide Utd,6451,5,11,6,11,37,40,-3,39
Brisbane,6451,6,10,5,13,33,42,-9,35
Western Sydn,6451,7,8,9,10,38,47,-9,33
Perth Glory,6451,8,10,2,15,37,50,-13,32
Wellington P,6451,9,5,6,16,31,55,-24,21
CC Mariners,6451,10,4,8,15,28,49,-21,20
Sydney FC,6452,1,20,5,3,65,23,42,65
N'castle Jet,6452,2,15,6,7,57,37,20,51
Melbourne C,6452,3,14,5,10,43,33,10,47
Melbourne V,6452,4,13,6,10,46,39,7,45
Adelaide Utd,6452,5,11,6,11,37,40,-3,39
Brisbane,6452,6,10,5,13,33,42,-9,35
Western Sydn,6452,7,8,9,10,38,47,-9,33
Perth Glory,6452,8,10,2,15,37,50,-13,32
Wellington P,6452,9,5,6,16,31,55,-24,21
CC Mariners,6452,10,4,8,15,28,49,-21,20
Sydney FC,6453,1,20,5,3,65,23,42,65
N'castle Jet,6453,2,16,5,7,59,38,21,53
Melbourne C,6453,3,14,4,11,44,35,9,46
Melbourne V,6453,4,13,6,10,46,39,7,45
Adelaide Utd,6453,5,11,6,11,37,40,-3,39
Brisbane,6453,6,10,5,13,33,42,-9,35
Western Sydn,6453,7,8,9,10,38,47,-9,33
Perth Glory,6453,8,10,2,15,37,50,-13,32
Wellington P,6453,9,5,6,16,31,55,-24,21
CC Mariners,6453,10,4,8,15,28,49,-21,20
Sydney FC,6454,1,20,5,3,64,22,42,65
N'castle Jet,6454,2,15,6,7,58,38,20,51
Melbourne C,6454,3,14,5,10,44,34,10,47
Melbourne V,6454,4,13,6,10,45,38,7,45
Adelaide Utd,6454,5,11,6,11,37,40,-3,39
Brisbane,6454,6,10,5,13,33,42,-9,35
Western Sydn,6454,7,8,9,10,38,47,-9,33
Perth Glory,6454,8,10,2,15,37,50,-13,32
Wellington P,6454,9,5,6,16,31,55,-24,21
CC Mariners,6454,10,4,8,15,28,49,-21,20
Sydney FC,6455,1,21,4,3,65,22,43,67
N'castle Jet,6455,2,16,5,7,60,39,21,53
Melbourne C,6455,3,14,4,11,45,36,9,46
Melbourne V,6455,4,13,5,11,45,39,6,44
Adelaide Utd,6455,5,11,6,11,37,40,-3,39
Brisbane,6455,6,10,5,13,33,42,-9,35
Western Sydn,6455,7,8,9,10,38,47,-9,33
Perth Glory,6455,8,10,2,15,37,50,-13,32
Wellington P,6455,9,5,6,16,31,55,-24,21
CC Mariners,6455,10,4,8,15,28,49,-21,20
Sydney FC,6456,1,21,4,3,66,22,44,67
N'castle Jet,6456,2,15,6,7,58,38,20,51
Melbourne C,6456,3,14,5,10,44,34,10,47
Melbourne V,6456,4,13,5,11,45,40,5,44
Adelaide Utd,6456,5,11,6,11,37,40,-3,39
Brisbane,6456,6,10,5,13,33,42,-9,35
Western Sydn,6456,7,8,9,10,38,47,-9,33
Perth Glory,6456,8,10,2,15,37,50,-13,32
Wellington P,6456,9,5,6,16,31,55,-24,21
CC Mariners,6456,10,4,8,15,28,49,-21,20
Sydney FC,6457,1,21,4,3,67,23,44,67
N'castle Jet,6457,2,16,5,7,60,39,21,53
Melbourne C,6457,3,14,4,11,45,36,9,46
Melbourne V,6457,4,13,5,11,46,41,5,44
Adelaide Utd,6457,5,11,6,11,37,40,-3,39
Brisbane,6457,6,10,5,13,33,42,-9,35
Western Sydn,6457,7,8,9,10,38,47,-9,33
Perth Glory,6457,8,10,2,15,37,50,-13,32
Wellington P,6457,9,5,6,16,31,55,-24,21
CC Mariners,6457,10,4,8,15,28,49,-21,20
Sydney FC,6458,1,20,5,3,65,23,42,65
N'castle Jet,6458,2,16,5,7,61,38,23,53
Melbourne C,6458,3,14,4,11,44,37,7,46
Melbourne V,6458,4,13,6,10,46,39,7,45
Adelaide Utd,6458,5,11,6,11,37,40,-3,39
Brisbane,6458,6,10,5,13,33,42,-9,35
Western Sydn,6458,7,8,9,10,38,47,-9,33
Perth Glory,6458,8,10,2,15,37,50,-13,32
Wellington P,6458,9,5,6,16,31,55,-24,21
CC Mariners,6458,10,4,8,15,28,49,-21,20
Sydney FC,6459,1,20,4,4,67,26,41,64
N'castle Jet,6459,2,15,6,7,60,40,20,51
Melbourne C,6459,3,14,5,10,46,36,10,47
Melbourne V,6459,4,14,5,10,49,41,8,47
Adelaide Utd,6459,5,11,6,11,37,40,-3,39
Brisbane,6459,6,10,5,13,33,42,-9,35
Western Sydn,6459,7,8,9,10,38,47,-9,33
Perth Glory,6459,8,10,2,15,37,50,-13,32
Wellington P,6459,9,5,6,16,31,55,-24,21
CC Mariners,6459,10,4,8,15,28,49,-21,20
Sydney FC,6460,1,21,4,3,66,23,43,67
N'castle Jet,6460,2,16,5,7,60,38,22,53
Melbourne C,6460,3,14,4,11,44,36,8,46
Melbourne V,6460,4,13,5,11,46,40,6,44
Adelaide Utd,6460,5,11,6,11,37,40,-3,39
Brisbane,6460,6,10,5,13,33,42,-9,35
Western Sydn,6460,7,8,9,10,38,47,-9,33
Perth Glory,6460,8,10,2,15,37,50,-13,32
Wellington P,6460,9,5,6,16,31,55,-24,21
CC Mariners,6460,10,4,8,15,28,49,-21,20
Sydney FC,6461,1,20,4,4,66,26,40,64
N'castle Jet,6461,2,15,5,8,57,38,19,50
Melbourne C,6461,3,15,4,10,44,33,11,49
Melbourne V,6461,4,14,5,10,49,40,9,47
Adelaide Utd,6461,5,11,6,11,37,40,-3,39
Brisbane,6461,6,10,5,13,33,42,-9,35
Western Sydn,6461,7,8,9,10,38,47,-9,33
Perth Glory,6461,8,10,2,15,37,50,-13,32
Wellington P,6461,9,5,6,16,31,55,-24,21
CC Mariners,6461,10,4,8,15,28,49,-21,20
Sydney FC,6462,1,21,4,3,67,22,45,67
N'castle Jet,6462,2,16,5,7,64,37,27,53
Melbourne C,6462,3,14,4,11,43,40,3,46
Melbourne V,6462,4,13,5,11,45,41,4,44
Adelaide Utd,6462,5,11,6,11,37,40,-3,39
Brisbane,6462,6,10,5,13,33,42,-9,35
Western Sydn,6462,7,8,9,10,38,47,-9,33
Perth Glory,6462,8,10,2,15,37,50,-13,32
Wellington P,6462,9,5,6,16,31,55,-24,21
CC Mariners,6462,10,4,8,15,28,49,-21,20
Sydney FC,6463,1,21,4,3,67,22,45,67
N'castle Jet,6463,2,16,5,7,61,38,23,53
Melbourne C,6463,3,14,4,11,44,37,7,46
Melbourne V,6463,4,13,5,11,45,41,4,44
Adelaide Utd,6463,5,11,6,11,37,40,-3,39
Brisbane,6463,6,10,5,13,33,42,-9,35
Western Sydn,6463,7,8,9,10,38,47,-9,33
Perth Glory,6463,8,10,2,15,37,50,-13,32
Wellington P,6463,9,5,6,16,31,55,-24,21
CC Mariners,6463,10,4,8,15,28,49,-21,20
Sydney FC,6464,1,21,4,3,68,24,44,67
N'castle Jet,6464,2,15,6,7,58,38,20,51
Melbourne C,6464,3,14,5,10,44,34,10,47
Melbourne V,6464,4,13,5,11,47,42,5,44
Adelaide Utd,6464,5,11,6,11,37,40,-3,39
Brisbane,6464,6,10,5,13,33,42,-9,35
Western Sydn,6464,7,8,9,10,38,47,-9,33
Perth Glory,6464,8,10,2,15,37,50,-13,32
Wellington P,6464,9,5,6,16,31,55,-24,21
CC Mariners,6464,10,4,8,15,28,49,-21,20
Sydney FC,6465,1,20,5,3,65,23,42,65
N'castle Jet,6465,2,16,5,7,61,37,24,53
Melbourne C,6465,3,14,4,11,43,37,6,46
Melbourne V,6465,4,13,6,10,46,39,7,45
Adelaide Utd,6465,5,11,6,11,37,40,-3,39
Brisbane,6465,6,10,5,13,33,42,-9,35
Western Sydn,6465,7,8,9,10,38,47,-9,33
Perth Glory,6465,8,10,2,15,37,50,-13,32
Wellington P,6465,9,5,6,16,31,55,-24,21
CC Mariners,6465,10,4,8,15,28,49,-21,20
Sydney FC,6466,1,21,4,3,67,23,44,67
N'castle Jet,6466,2,15,6,7,59,39,20,51
Melbourne C,6466,3,14,5,10,45,35,10,47
Melbourne V,6466,4,13,5,11,46,41,5,44
Adelaide Utd,6466,5,11,6,11,37,40,-3,39
Brisbane,6466,6,10,5,13,33,42,-9,35
Western Sydn,6466,7,8,9,10,38,47,-9,33
Perth Glory,6466,8,10,2,15,37,50,-13,32
Wellington P,6466,9,5,6,16,31,55,-24,21
CC Mariners,6466,10,4,8,15,28,49,-21,20
Sydney FC,6467,1,21,4,3,66,23,43,67
N'castle Jet,6467,2,16,5,7,59,38,21,53
Melbourne C,6467,3,14,4,11,44,35,9,46
Melbourne V,6467,4,13,5,11,46,40,6,44
Adelaide Utd,6467,5,11,6,11,37,40,-3,39
Brisbane,6467,6,10,5,13,33,42,-9,35
Western Sydn,6467,7,8,9,10,38,47,-9,33
Perth Glory,6467,8,10,2,15,37,50,-13,32
Wellington P,6467,9,5,6,16,31,55,-24,21
CC Mariners,6467,10,4,8,15,28,49,-21,20
Sydney FC,6468,1,21,4,3,65,22,43,67
N'castle Jet,6468,2,15,6,7,59,39,20,51
Melbourne C,6468,3,14,5,10,45,35,10,47
Melbourne V,6468,4,13,5,11,45,39,6,44
Adelaide Utd,6468,5,11,6,11,37,40,-3,39
Brisbane,6468,6,10,5,13,33,42,-9,35
Western Sydn,6468,7,8,9,10,38,47,-9,33
Perth Glory,6468,8,10,2,15,37,50,-13,32
Wellington P,6468,9,5,6,16,31,55,-24,21
CC Mariners,6468,10,4,8,15,28,49,-21,20
Sydney FC,6469,1,21,4,3,69,22,47,67
N'castle Jet,6469,2,15,5,8,59,40,19,50
Melbourne C,6469,3,15,4,10,46,35,11,49
Melbourne V,6469,4,13,5,11,45,43,2,44
Adelaide Utd,6469,5,11,6,11,37,40,-3,39
Brisbane,6469,6,10,5,13,33,42,-9,35
Western Sydn,6469,7,8,9,10,38,47,-9,33
Perth Glory,6469,8,10,2,15,37,50,-13,32
Wellington P,6469,9,5,6,16,31,55,-24,21
CC Mariners,6469,10,4,8,15,28,49,-21,20
Sydney FC,6470,1,21,4,3,66,23,43,67
N'castle Jet,6470,2,16,5,7,59,38,21,53
Melbourne C,6470,3,14,4,11,44,35,9,46
Melbourne V,6470,4,13,5,11,46,40,6,44
Adelaide Utd,6470,5,11,6,11,37,40,-3,39
Brisbane,6470,6,10,5,13,33,42,-9,35
Western Sydn,6470,7,8,9,10,38,47,-9,33
Perth Glory,6470,8,10,2,15,37,50,-13,32
Wellington P,6470,9,5,6,16,31,55,-24,21
CC Mariners,6470,10,4,8,15,28,49,-21,20
Sydney FC,6471,1,21,4,3,66,22,44,67
N'castle Jet,6471,2,15,5,8,58,39,19,50
Melbourne C,6471,3,15,4,10,45,34,11,49
Melbourne V,6471,4,13,5,11,45,40,5,44
Adelaide Utd,6471,5,11,6,11,37,40,-3,39
Brisbane,6471,6,10,5,13,33,42,-9,35
Western Sydn,6471,7,8,9,10,38,47,-9,33
Perth Glory,6471,8,10,2,15,37,50,-13,32
Wellington P,6471,9,5,6,16,31,55,-24,21
CC Mariners,6471,10,4,8,15,28,49,-21,20
Sydney FC,6472,1,21,4,3,66,23,43,67
N'castle Jet,6472,2,16,5,7,59,37,22,53
Melbourne C,6472,3,14,4,11,43,35,8,46
Melbourne V,6472,4,13,5,11,46,40,6,44
Adelaide Utd,6472,5,11,6,11,37,40,-3,39
Brisbane,6472,6,10,5,13,33,42,-9,35
Western Sydn,6472,7,8,9,10,38,47,-9,33
Perth Glory,6472,8,10,2,15,37,50,-13,32
Wellington P,6472,9,5,6,16,31,55,-24,21
CC Mariners,6472,10,4,8,15,28,49,-21,20
Sydney FC,6473,1,21,4,3,69,23,46,67
N'castle Jet,6473,2,16,5,7,59,38,21,53
Melbourne C,6473,3,14,4,11,44,35,9,46
Melbourne V,6473,4,13,5,11,46,43,3,44
Adelaide Utd,6473,5,11,6,11,37,40,-3,39
Brisbane,6473,6,10,5,13,33,42,-9,35
Western Sydn,6473,7,8,9,10,38,47,-9,33
Perth Glory,6473,8,10,2,15,37,50,-13,32
Wellington P,6473,9,5,6,16,31,55,-24,21
CC Mariners,6473,10,4,8,15,28,49,-21,20
Sydney FC,6474,1,21,4,3,66,22,44,67
N'castle Jet,6474,2,15,6,7,59,39,20,51
Melbourne C,6474,3,14,5,10,45,35,10,47
Melbourne V,6474,4,13,5,11,45,40,5,44
Adelaide Utd,6474,5,11,6,11,37,40,-3,39
Brisbane,6474,6,10,5,13,33,42,-9,35
Western Sydn,6474,7,8,9,10,38,47,-9,33
Perth Glory,6474,8,10,2,15,37,50,-13,32
Wellington P,6474,9,5,6,16,31,55,-24,21
CC Mariners,6474,10,4,8,15,28,49,-21,20
Sydney FC,6475,1,20,5,3,65,23,42,65
N'castle Jet,6475,2,15,5,8,60,41,19,50
Melbourne C,6475,3,15,4,10,47,36,11,49
Melbourne V,6475,4,13,6,10,46,39,7,45
Adelaide Utd,6475,5,11,6,11,37,40,-3,39
Brisbane,6475,6,10,5,13,33,42,-9,35
Western Sydn,6475,7,8,9,10,38,47,-9,33
Perth Glory,6475,8,10,2,15,37,50,-13,32
Wellington P,6475,9,5,6,16,31,55,-24,21
CC Mariners,6475,10,4,8,15,28,49,-21,20
Sydney FC,6476,1,21,4,3,67,24,43,67
N'castle Jet,6476,2,15,6,7,57,37,20,51
Melbourne C,6476,3,14,5,10,43,33,10,47
Melbourne V,6476,4,13,5,11,47,41,6,44
Adelaide Utd,6476,5,11,6,11,37,40,-3,39
Brisbane,6476,6,10,5,13,33,42,-9,35
Western Sydn,6476,7,8,9,10,38,47,-9,33
Perth Glory,6476,8,10,2,15,37,50,-13,32
Wellington P,6476,9,5,6,16,31,55,-24,21
CC Mariners,6476,10,4,8,15,28,49,-21,20
Sydney FC,6477,1,20,4,4,64,24,40,64
N'castle Jet,6477,2,16,5,7,61,38,23,53
Melbourne V,6477,3,14,5,10,47,38,9,47
Melbourne C,6477,4,14,4,11,44,37,7,46
Adelaide Utd,6477,5,11,6,11,37,40,-3,39
Brisbane,6477,6,10,5,13,33,42,-9,35
Western Sydn,6477,7,8,9,10,38,47,-9,33
Perth Glory,6477,8,10,2,15,37,50,-13,32
Wellington P,6477,9,5,6,16,31,55,-24,21
CC Mariners,6477,10,4,8,15,28,49,-21,20
Sydney FC,6478,1,21,4,3,65,22,43,67
N'castle Jet,6478,2,15,5,8,57,40,17,50
Melbourne C,6478,3,15,4,10,46,33,13,49
Melbourne V,6478,4,13,5,11,45,39,6,44
Adelaide Utd,6478,5,11,6,11,37,40,-3,39
Brisbane,6478,6,10,5,13,33,42,-9,35
Western Sydn,6478,7,8,9,10,38,47,-9,33
Perth Glory,6478,8,10,2,15,37,50,-13,32
Wellington P,6478,9,5,6,16,31,55,-24,21
CC Mariners,6478,10,4,8,15,28,49,-21,20
Sydney FC,6479,1,21,4,3,68,22,46,67
N'castle Jet,6479,2,15,5,8,59,40,19,50
Melbourne C,6479,3,15,4,10,46,35,11,49
Melbourne V,6479,4,13,5,11,45,42,3,44
Adelaide Utd,6479,5,11,6,11,37,40,-3,39
Brisbane,6479,6,10,5,13,33,42,-9,35
Western Sydn,6479,7,8,9,10,38,47,-9,33
Perth Glory,6479,8,10,2,15,37,50,-13,32
Wellington P,6479,9,5,6,16,31,55,-24,21
CC Mariners,6479,10,4,8,15,28,49,-21,20
Sydney FC,6480,1,21,4,3,67,23,44,67
N'castle Jet,6480,2,16,5,7,59,37,22,53
Melbourne C,6480,3,14,4,11,43,35,8,46
Melbourne V,6480,4,13,5,11,46,41,5,44
Adelaide Utd,6480,5,11,6,11,37,40,-3,39
Brisbane,6480,6,10,5,13,33,42,-9,35
Western Sydn,6480,7,8,9,10,38,47,-9,33
Perth Glory,6480,8,10,2,15,37,50,-13,32
Wellington P,6480,9,5,6,16,31,55,-24,21
CC Mariners,6480,10,4,8,15,28,49,-21,20
Sydney FC,6481,1,20,5,3,64,22,42,65
N'castle Jet,6481,2,15,5,8,58,40,18,50
Melbourne C,6481,3,15,4,10,46,34,12,49
Melbourne V,6481,4,13,6,10,45,38,7,45
Adelaide Utd,6481,5,11,6,11,37,40,-3,39
Brisbane,6481,6,10,5,13,33,42,-9,35
Western Sydn,6481,7,8,9,10,38,47,-9,33
Perth Glory,6481,8,10,2,15,37,50,-13,32
Wellington P,6481,9,5,6,16,31,55,-24,21
CC Mariners,6481,10,4,8,15,28,49,-21,20
Sydney FC,6482,1,21,4,3,68,24,44,67
N'castle Jet,6482,2,15,5,8,58,41,17,50
Melbourne C,6482,3,15,4,10,47,34,13,49
Melbourne V,6482,4,13,5,11,47,42,5,44
Adelaide Utd,6482,5,11,6,11,37,40,-3,39
Brisbane,6482,6,10,5,13,33,42,-9,35
Western Sydn,6482,7,8,9,10,38,47,-9,33
Perth Glory,6482,8,10,2,15,37,50,-13,32
Wellington P,6482,9,5,6,16,31,55,-24,21
CC Mariners,6482,10,4,8,15,28,49,-21,20
Sydney FC,6483,1,21,4,3,66,23,43,67
N'castle Jet,6483,2,15,5,8,59,40,19,50
Melbourne C,6483,3,15,4,10,46,35,11,49
Melbourne V,6483,4,13,5,11,46,40,6,44
Adelaide Utd,6483,5,11,6,11,37,40,-3,39
Brisbane,6483,6,10,5,13,33,42,-9,35
Western Sydn,6483,7,8,9,10,38,47,-9,33
Perth Glory,6483,8,10,2,15,37,50,-13,32
Wellington P,6483,9,5,6,16,31,55,-24,21
CC Mariners,6483,10,4,8,15,28,49,-21,20
Sydney FC,6484,1,20,5,3,64,22,42,65
N'castle Jet,6484,2,15,5,8,57,40,17,50
Melbourne C,6484,3,15,4,10,46,33,13,49
Melbourne V,6484,4,13,6,10,45,38,7,45
Adelaide Utd,6484,5,11,6,11,37,40,-3,39
Brisbane,6484,6,10,5,13,33,42,-9,35
Western Sydn,6484,7,8,9,10,38,47,-9,33
Perth Glory,6484,8,10,2,15,37,50,-13,32
Wellington P,6484,9,5,6,16,31,55,-24,21
CC Mariners,6484,10,4,8,15,28,49,-21,20
Sydney FC,6485,1,20,4,4,65,24,41,64
N'castle Jet,6485,2,15,5,8,57,39,18,50
Melbourne C,6485,3,15,4,10,45,33,12,49
Melbourne V,6485,4,14,5,10,47,39,8,47
Adelaide Utd,6485,5,11,6,11,37,40,-3,39
Brisbane,6485,6,10,5,13,33,42,-9,35
Western Sydn,6485,7,8,9,10,38,47,-9,33
Perth Glory,6485,8,10,2,15,37,50,-13,32
Wellington P,6485,9,5,6,16,31,55,-24,21
CC Mariners,6485,10,4,8,15,28,49,-21,20
Sydney FC,6486,1,21,4,3,67,23,44,67
N'castle Jet,6486,2,15,5,8,58,39,19,50
Melbourne C,6486,3,15,4,10,45,34,11,49
Melbourne V,6486,4,13,5,11,46,41,5,44
Adelaide Utd,6486,5,11,6,11,37,40,-3,39
Brisbane,6486,6,10,5,13,33,42,-9,35
Western Sydn,6486,7,8,9,10,38,47,-9,33
Perth Glory,6486,8,10,2,15,37,50,-13,32
Wellington P,6486,9,5,6,16,31,55,-24,21
CC Mariners,6486,10,4,8,15,28,49,-21,20
Sydney FC,6487,1,21,4,3,67,23,44,67
N'castle Jet,6487,2,15,5,8,58,39,19,50
Melbourne C,6487,3,15,4,10,45,34,11,49
Melbourne V,6487,4,13,5,11,46,41,5,44
Adelaide Utd,6487,5,11,6,11,37,40,-3,39
Brisbane,6487,6,10,5,13,33,42,-9,35
Western Sydn,6487,7,8,9,10,38,47,-9,33
Perth Glory,6487,8,10,2,15,37,50,-13,32
Wellington P,6487,9,5,6,16,31,55,-24,21
CC Mariners,6487,10,4,8,15,28,49,-21,20
Sydney FC,6488,1,21,4,3,66,23,43,67
N'castle Jet,6488,2,15,5,8,57,39,18,50
Melbourne C,6488,3,15,4,10,45,33,12,49
Melbourne V,6488,4,13,5,11,46,40,6,44
Adelaide Utd,6488,5,11,6,11,37,40,-3,39
Brisbane,6488,6,10,5,13,33,42,-9,35
Western Sydn,6488,7,8,9,10,38,47,-9,33
Perth Glory,6488,8,10,2,15,37,50,-13,32
Wellington P,6488,9,5,6,16,31,55,-24,21
CC Mariners,6488,10,4,8,15,28,49,-21,20
Sydney FC,6489,1,21,4,3,67,24,43,67
N'castle Jet,6489,2,15,5,8,58,40,18,50
Melbourne C,6489,3,15,4,10,46,34,12,49
Melbourne V,6489,4,13,5,11,47,41,6,44
Adelaide Utd,6489,5,11,6,11,37,40,-3,39
Brisbane,6489,6,10,5,13,33,42,-9,35
Western Sydn,6489,7,8,9,10,38,47,-9,33
Perth Glory,6489,8,10,2,15,37,50,-13,32
Wellington P,6489,9,5,6,16,31,55,-24,21
CC Mariners,6489,10,4,8,15,28,49,-21,20
Sydney FC,6490,1,20,4,4,65,24,41,64
N'castle Jet,6490,2,16,5,7,59,37,22,53
Melbourne V,6490,3,14,5,10,47,39,8,47
Melbourne C,6490,4,14,4,11,43,35,8,46
Adelaide Utd,6490,5,11,6,11,37,40,-3,39
Brisbane,6490,6,10,5,13,33,42,-9,35
Western Sydn,6490,7,8,9,10,38,47,-9,33
Perth Glory,6490,8,10,2,15,37,50,-13,32
Wellington P,6490,9,5,6,16,31,55,-24,21
CC Mariners,6490,10,4,8,15,28,49,-21,20
Sydney FC,6491,1,21,4,3,66,22,44,67
N'castle Jet,6491,2,16,5,7,60,38,22,53
Melbourne C,6491,3,14,4,11,44,36,8,46
Melbourne V,6491,4,13,5,11,45,40,5,44
Adelaide Utd,6491,5,11,6,11,37,40,-3,39
Brisbane,6491,6,10,5,13,33,42,-9,35
Western Sydn,6491,7,8,9,10,38,47,-9,33
Perth Glory,6491,8,10,2,15,37,50,-13,32
Wellington P,6491,9,5,6,16,31,55,-24,21
CC Mariners,6491,10,4,8,15,28,49,-21,20
Sydney FC,6492,1,21,4,3,67,24,43,67
N'castle Jet,6492,2,16,5,7,59,38,21,53
Melbourne C,6492,3,14,4,11,44,35,9,46
Melbourne V,6492,4,13,5,11,47,41,6,44
Adelaide Utd,6492,5,11,6,11,37,40,-3,39
Brisbane,6492,6,10,5,13,33,42,-9,35
Western Sydn,6492,7,8,9,10,38,47,-9,33
Perth Glory,6492,8,10,2,15,37,50,-13,32
Wellington P,6492,9,5,6,16,31,55,-24,21
CC Mariners,6492,10,4,8,15,28,49,-21,20
Sydney FC,6493,1,21,4,3,66,23,43,67
N'castle Jet,6493,2,16,5,7,61,38,23,53
Melbourne C,6493,3,14,4,11,44,37,7,46
Melbourne V,6493,4,13,5,11,46,40,6,44
Adelaide Utd,6493,5,11,6,11,37,40,-3,39
Brisbane,6493,6,10,5,13,33,42,-9,35
Western Sydn,6493,7,8,9,10,38,47,-9,33
Perth Glory,6493,8,10,2,15,37,50,-13,32
Wellington P,6493,9,5,6,16,31,55,-24,21
CC Mariners,6493,10,4,8,15,28,49,-21,20
Sydney FC,6494,1,20,5,3,64,22,42,65
N'castle Jet,6494,2,15,6,7,57,37,20,51
Melbourne C,6494,3,14,5,10,43,33,10,47
Melbourne V,6494,4,13,6,10,45,38,7,45
Adelaide Utd,6494,5,11,6,11,37,40,-3,39
Brisbane,6494,6,10,5,13,33,42,-9,35
Western Sydn,6494,7,8,9,10,38,47,-9,33
Perth Glory,6494,8,10,2,15,37,50,-13,32
Wellington P,6494,9,5,6,16,31,55,-24,21
CC Mariners,6494,10,4,8,15,28,49,-21,20
Sydney FC,6495,1,21,4,3,67,23,44,67
N'castle Jet,6495,2,16,5,7,59,37,22,53
Melbourne C,6495,3,14,4,11,43,35,8,46
Melbourne V,6495,4,13,5,11,46,41,5,44
Adelaide Utd,6495,5,11,6,11,37,40,-3,39
Brisbane,6495,6,10,5,13,33,42,-9,35
Western Sydn,6495,7,8,9,10,38,47,-9,33
Perth Glory,6495,8,10,2,15,37,50,-13,32
Wellington P,6495,9,5,6,16,31,55,-24,21
CC Mariners,6495,10,4,8,15,28,49,-21,20
Sydney FC,6496,1,21,4,3,69,24,45,67
N'castle Jet,6496,2,15,5,8,58,40,18,50
Melbourne C,6496,3,15,4,10,46,34,12,49
Melbourne V,6496,4,13,5,11,47,43,4,44
Adelaide Utd,6496,5,11,6,11,37,40,-3,39
Brisbane,6496,6,10,5,13,33,42,-9,35
Western Sydn,6496,7,8,9,10,38,47,-9,33
Perth Glory,6496,8,10,2,15,37,50,-13,32
Wellington P,6496,9,5,6,16,31,55,-24,21
CC Mariners,6496,10,4,8,15,28,49,-21,20
Sydney FC,6497,1,21,4,3,66,23,43,67
N'castle Jet,6497,2,16,5,7,60,38,22,53
Melbourne C,6497,3,14,4,11,44,36,8,46
Melbourne V,6497,4,13,5,11,46,40,6,44
Adelaide Utd,6497,5,11,6,11,37,40,-3,39
Brisbane,6497,6,10,5,13,33,42,-9,35
Western Sydn,6497,7,8,9,10,38,47,-9,33
Perth Glory,6497,8,10,2,15,37,50,-13,32
Wellington P,6497,9,5,6,16,31,55,-24,21
CC Mariners,6497,10,4,8,15,28,49,-21,20
Sydney FC,6498,1,21,4,3,69,22,47,67
N'castle Jet,6498,2,15,6,7,58,38,20,51
Melbourne C,6498,3,14,5,10,44,34,10,47
Melbourne V,6498,4,13,5,11,45,43,2,44
Adelaide Utd,6498,5,11,6,11,37,40,-3,39
Brisbane,6498,6,10,5,13,33,42,-9,35
Western Sydn,6498,7,8,9,10,38,47,-9,33
Perth Glory,6498,8,10,2,15,37,50,-13,32
Wellington P,6498,9,5,6,16,31,55,-24,21
CC Mariners,6498,10,4,8,15,28,49,-21,20
Sydney FC,6499,1,20,5,3,65,23,42,65
N'castle Jet,6499,2,15,6,7,57,37,20,51
Melbourne C,6499,3,14,5,10,43,33,10,47
Melbourne V,6499,4,13,6,10,46,39,7,45
Adelaide Utd,6499,5,11,6,11,37,40,-3,39
Brisbane,6499,6,10,5,13,33,42,-9,35
Western Sydn,6499,7,8,9,10,38,47,-9,33
Perth Glory,6499,8,10,2,15,37,50,-13,32
Wellington P,6499,9,5,6,16,31,55,-24,21
CC Mariners,6499,10,4,8,15,28,49,-21,20
Sydney FC,6500,1,21,4,3,69,22,47,67
N'castle Jet,6500,2,16,5,7,60,38,22,53
Melbourne C,6500,3,14,4,11,44,36,8,46
Melbourne V,6500,4,13,5,11,45,43,2,44
Adelaide Utd,6500,5,11,6,11,37,40,-3,39
Brisbane,6500,6,10,5,13,33,42,-9,35
Western Sydn,6500,7,8,9,10,38,47,-9,33
Perth Glory,6500,8,10,2,15,37,50,-13,32
Wellington P,6500,9,5,6,16,31,55,-24,21
CC Mariners,6500,10,4,8,15,28,49,-21,20
Sydney FC,6501,1,21,4,3,67,22,45,67
N'castle Jet,6501,2,15,5,8,57,42,15,50
Melbourne C,6501,3,15,4,10,48,33,15,49
Melbourne V,6501,4,13,5,11,45,41,4,44
Adelaide Utd,6501,5,11,6,11,37,40,-3,39
Brisbane,6501,6,10,5,13,33,42,-9,35
Western Sydn,6501,7,8,9,10,38,47,-9,33
Perth Glory,6501,8,10,2,15,37,50,-13,32
Wellington P,6501,9,5,6,16,31,55,-24,21
CC Mariners,6501,10,4,8,15,28,49,-21,20
Sydney FC,6502,1,20,4,4,65,24,41,64
N'castle Jet,6502,2,15,6,7,58,38,20,51
Melbourne C,6502,3,14,5,10,44,34,10,47
Melbourne V,6502,4,14,5,10,47,39,8,47
Adelaide Utd,6502,5,11,6,11,37,40,-3,39
Brisbane,6502,6,10,5,13,33,42,-9,35
Western Sydn,6502,7,8,9,10,38,47,-9,33
Perth Glory,6502,8,10,2,15,37,50,-13,32
Wellington P,6502,9,5,6,16,31,55,-24,21
CC Mariners,6502,10,4,8,15,28,49,-21,20
Sydney FC,6503,1,20,5,3,64,22,42,65
N'castle Jet,6503,2,16,5,7,59,37,22,53
Melbourne C,6503,3,14,4,11,43,35,8,46
Melbourne V,6503,4,13,6,10,45,38,7,45
Adelaide Utd,6503,5,11,6,11,37,40,-3,39
Brisbane,6503,6,10,5,13,33,42,-9,35
Western Sydn,6503,7,8,9,10,38,47,-9,33
Perth Glory,6503,8,10,2,15,37,50,-13,32
Wellington P,6503,9,5,6,16,31,55,-24,21
CC Mariners,6503,10,4,8,15,28,49,-21,20
Sydney FC,6504,1,21,4,3,66,23,43,67
N'castle Jet,6504,2,16,5,7,60,37,23,53
Melbourne C,6504,3,14,4,11,43,36,7,46
Melbourne V,6504,4,13,5,11,46,40,6,44
Adelaide Utd,6504,5,11,6,11,37,40,-3,39
Brisbane,6504,6,10,5,13,33,42,-9,35
Western Sydn,6504,7,8,9,10,38,47,-9,33
Perth Glory,6504,8,10,2,15,37,50,-13,32
Wellington P,6504,9,5,6,16,31,55,-24,21
CC Mariners,6504,10,4,8,15,28,49,-21,20
Sydney FC,6505,1,20,5,3,64,22,42,65
N'castle Jet,6505,2,15,5,8,57,40,17,50
Melbourne C,6505,3,15,4,10,46,33,13,49
Melbourne V,6505,4,13,6,10,45,38,7,45
Adelaide Utd,6505,5,11,6,11,37,40,-3,39
Brisbane,6505,6,10,5,13,33,42,-9,35
Western Sydn,6505,7,8,9,10,38,47,-9,33
Perth Glory,6505,8,10,2,15,37,50,-13,32
Wellington P,6505,9,5,6,16,31,55,-24,21
CC Mariners,6505,10,4,8,15,28,49,-21,20
Sydney FC,6506,1,20,4,4,66,25,41,64
N'castle Jet,6506,2,15,6,7,59,39,20,51
Melbourne C,6506,3,14,5,10,45,35,10,47
Melbourne V,6506,4,14,5,10,48,40,8,47
Adelaide Utd,6506,5,11,6,11,37,40,-3,39
Brisbane,6506,6,10,5,13,33,42,-9,35
Western Sydn,6506,7,8,9,10,38,47,-9,33
Perth Glory,6506,8,10,2,15,37,50,-13,32
Wellington P,6506,9,5,6,16,31,55,-24,21
CC Mariners,6506,10,4,8,15,28,49,-21,20
Sydney FC,6507,1,21,4,3,66,22,44,67
N'castle Jet,6507,2,15,6,7,61,41,20,51
Melbourne C,6507,3,14,5,10,47,37,10,47
Melbourne V,6507,4,13,5,11,45,40,5,44
Adelaide Utd,6507,5,11,6,11,37,40,-3,39
Brisbane,6507,6,10,5,13,33,42,-9,35
Western Sydn,6507,7,8,9,10,38,47,-9,33
Perth Glory,6507,8,10,2,15,37,50,-13,32
Wellington P,6507,9,5,6,16,31,55,-24,21
CC Mariners,6507,10,4,8,15,28,49,-21,20
Sydney FC,6508,1,21,4,3,66,22,44,67
N'castle Jet,6508,2,15,5,8,58,39,19,50
Melbourne C,6508,3,15,4,10,45,34,11,49
Melbourne V,6508,4,13,5,11,45,40,5,44
Adelaide Utd,6508,5,11,6,11,37,40,-3,39
Brisbane,6508,6,10,5,13,33,42,-9,35
Western Sydn,6508,7,8,9,10,38,47,-9,33
Perth Glory,6508,8,10,2,15,37,50,-13,32
Wellington P,6508,9,5,6,16,31,55,-24,21
CC Mariners,6508,10,4,8,15,28,49,-21,20
Sydney FC,6509,1,21,4,3,66,22,44,67
N'castle Jet,6509,2,15,5,8,58,39,19,50
Melbourne C,6509,3,15,4,10,45,34,11,49
Melbourne V,6509,4,13,5,11,45,40,5,44
Adelaide Utd,6509,5,11,6,11,37,40,-3,39
Brisbane,6509,6,10,5,13,33,42,-9,35
Western Sydn,6509,7,8,9,10,38,47,-9,33
Perth Glory,6509,8,10,2,15,37,50,-13,32
Wellington P,6509,9,5,6,16,31,55,-24,21
CC Mariners,6509,10,4,8,15,28,49,-21,20
Sydney FC,6510,1,20,4,4,64,23,41,64
N'castle Jet,6510,2,16,5,7,60,39,21,53
Melbourne V,6510,3,14,5,10,46,38,8,47
Melbourne C,6510,4,14,4,11,45,36,9,46
Adelaide Utd,6510,5,11,6,11,37,40,-3,39
Brisbane,6510,6,10,5,13,33,42,-9,35
Western Sydn,6510,7,8,9,10,38,47,-9,33
Perth Glory,6510,8,10,2,15,37,50,-13,32
Wellington P,6510,9,5,6,16,31,55,-24,21
CC Mariners,6510,10,4,8,15,28,49,-21,20
Sydney FC,6511,1,20,4,4,65,24,41,64
N'castle Jet,6511,2,15,6,7,59,39,20,51
Melbourne C,6511,3,14,5,10,45,35,10,47
Melbourne V,6511,4,14,5,10,47,39,8,47
Adelaide Utd,6511,5,11,6,11,37,40,-3,39
Brisbane,6511,6,10,5,13,33,42,-9,35
Western Sydn,6511,7,8,9,10,38,47,-9,33
Perth Glory,6511,8,10,2,15,37,50,-13,32
Wellington P,6511,9,5,6,16,31,55,-24,21
CC Mariners,6511,10,4,8,15,28,49,-21,20
Sydney FC,6512,1,21,4,3,68,24,44,67
N'castle Jet,6512,2,16,5,7,59,37,22,53
Melbourne C,6512,3,14,4,11,43,35,8,46
Melbourne V,6512,4,13,5,11,47,42,5,44
Adelaide Utd,6512,5,11,6,11,37,40,-3,39
Brisbane,6512,6,10,5,13,33,42,-9,35
Western Sydn,6512,7,8,9,10,38,47,-9,33
Perth Glory,6512,8,10,2,15,37,50,-13,32
Wellington P,6512,9,5,6,16,31,55,-24,21
CC Mariners,6512,10,4,8,15,28,49,-21,20
Sydney FC,6513,1,20,4,4,64,23,41,64
N'castle Jet,6513,2,16,5,7,59,37,22,53
Melbourne V,6513,3,14,5,10,46,38,8,47
Melbourne C,6513,4,14,4,11,43,35,8,46
Adelaide Utd,6513,5,11,6,11,37,40,-3,39
Brisbane,6513,6,10,5,13,33,42,-9,35
Western Sydn,6513,7,8,9,10,38,47,-9,33
Perth Glory,6513,8,10,2,15,37,50,-13,32
Wellington P,6513,9,5,6,16,31,55,-24,21
CC Mariners,6513,10,4,8,15,28,49,-21,20
Sydney FC,6514,1,20,5,3,65,23,42,65
N'castle Jet,6514,2,16,5,7,59,38,21,53
Melbourne C,6514,3,14,4,11,44,35,9,46
Melbourne V,6514,4,13,6,10,46,39,7,45
Adelaide Utd,6514,5,11,6,11,37,40,-3,39
Brisbane,6514,6,10,5,13,33,42,-9,35
Western Sydn,6514,7,8,9,10,38,47,-9,33
Perth Glory,6514,8,10,2,15,37,50,-13,32
Wellington P,6514,9,5,6,16,31,55,-24,21
CC Mariners,6514,10,4,8,15,28,49,-21,20
Sydney FC,6515,1,21,4,3,65,22,43,67
N'castle Jet,6515,2,15,6,7,59,39,20,51
Melbourne C,6515,3,14,5,10,45,35,10,47
Melbourne V,6515,4,13,5,11,45,39,6,44
Adelaide Utd,6515,5,11,6,11,37,40,-3,39
Brisbane,6515,6,10,5,13,33,42,-9,35
Western Sydn,6515,7,8,9,10,38,47,-9,33
Perth Glory,6515,8,10,2,15,37,50,-13,32
Wellington P,6515,9,5,6,16,31,55,-24,21
CC Mariners,6515,10,4,8,15,28,49,-21,20
Sydney FC,6516,1,21,4,3,68,24,44,67
N'castle Jet,6516,2,15,5,8,58,39,19,50
Melbourne C,6516,3,15,4,10,45,34,11,49
Melbourne V,6516,4,13,5,11,47,42,5,44
Adelaide Utd,6516,5,11,6,11,37,40,-3,39
Brisbane,6516,6,10,5,13,33,42,-9,35
Western Sydn,6516,7,8,9,10,38,47,-9,33
Perth Glory,6516,8,10,2,15,37,50,-13,32
Wellington P,6516,9,5,6,16,31,55,-24,21
CC Mariners,6516,10,4,8,15,28,49,-21,20
Sydney FC,6517,1,21,4,3,67,23,44,67
N'castle Jet,6517,2,16,5,7,59,38,21,53
Melbourne C,6517,3,14,4,11,44,35,9,46
Melbourne V,6517,4,13,5,11,46,41,5,44
Adelaide Utd,6517,5,11,6,11,37,40,-3,39
Brisbane,6517,6,10,5,13,33,42,-9,35
Western Sydn,6517,7,8,9,10,38,47,-9,33
Perth Glory,6517,8,10,2,15,37,50,-13,32
Wellington P,6517,9,5,6,16,31,55,-24,21
CC Mariners,6517,10,4,8,15,28,49,-21,20
Sydney FC,6518,1,21,4,3,70,22,48,67
N'castle Jet,6518,2,15,6,7,58,38,20,51
Melbourne C,6518,3,14,5,10,44,34,10,47
Melbourne V,6518,4,13,5,11,45,44,1,44
Adelaide Utd,6518,5,11,6,11,37,40,-3,39
Brisbane,6518,6,10,5,13,33,42,-9,35
Western Sydn,6518,7,8,9,10,38,47,-9,33
Perth Glory,6518,8,10,2,15,37,50,-13,32
Wellington P,6518,9,5,6,16,31,55,-24,21
CC Mariners,6518,10,4,8,15,28,49,-21,20
Sydney FC,6519,1,21,4,3,67,23,44,67
N'castle Jet,6519,2,15,6,7,58,38,20,51
Melbourne C,6519,3,14,5,10,44,34,10,47
Melbourne V,6519,4,13,5,11,46,41,5,44
Adelaide Utd,6519,5,11,6,11,37,40,-3,39
Brisbane,6519,6,10,5,13,33,42,-9,35
Western Sydn,6519,7,8,9,10,38,47,-9,33
Perth Glory,6519,8,10,2,15,37,50,-13,32
Wellington P,6519,9,5,6,16,31,55,-24,21
CC Mariners,6519,10,4,8,15,28,49,-21,20
Sydney FC,6520,1,20,5,3,65,23,42,65
N'castle Jet,6520,2,15,6,7,59,39,20,51
Melbourne C,6520,3,14,5,10,45,35,10,47
Melbourne V,6520,4,13,6,10,46,39,7,45
Adelaide Utd,6520,5,11,6,11,37,40,-3,39
Brisbane,6520,6,10,5,13,33,42,-9,35
Western Sydn,6520,7,8,9,10,38,47,-9,33
Perth Glory,6520,8,10,2,15,37,50,-13,32
Wellington P,6520,9,5,6,16,31,55,-24,21
CC Mariners,6520,10,4,8,15,28,49,-21,20
Sydney FC,6521,1,21,4,3,66,23,43,67
N'castle Jet,6521,2,15,6,7,58,38,20,51
Melbourne C,6521,3,14,5,10,44,34,10,47
Melbourne V,6521,4,13,5,11,46,40,6,44
Adelaide Utd,6521,5,11,6,11,37,40,-3,39
Brisbane,6521,6,10,5,13,33,42,-9,35
Western Sydn,6521,7,8,9,10,38,47,-9,33
Perth Glory,6521,8,10,2,15,37,50,-13,32
Wellington P,6521,9,5,6,16,31,55,-24,21
CC Mariners,6521,10,4,8,15,28,49,-21,20
Sydney FC,6522,1,20,4,4,65,24,41,64
N'castle Jet,6522,2,16,5,7,58,37,21,53
Melbourne V,6522,3,14,5,10,47,39,8,47
Melbourne C,6522,4,14,4,11,43,34,9,46
Adelaide Utd,6522,5,11,6,11,37,40,-3,39
Brisbane,6522,6,10,5,13,33,42,-9,35
Western Sydn,6522,7,8,9,10,38,47,-9,33
Perth Glory,6522,8,10,2,15,37,50,-13,32
Wellington P,6522,9,5,6,16,31,55,-24,21
CC Mariners,6522,10,4,8,15,28,49,-21,20
Sydney FC,6523,1,21,4,3,68,24,44,67
N'castle Jet,6523,2,15,5,8,57,38,19,50
Melbourne C,6523,3,15,4,10,44,33,11,49
Melbourne V,6523,4,13,5,11,47,42,5,44
Adelaide Utd,6523,5,11,6,11,37,40,-3,39
Brisbane,6523,6,10,5,13,33,42,-9,35
Western Sydn,6523,7,8,9,10,38,47,-9,33
Perth Glory,6523,8,10,2,15,37,50,-13,32
Wellington P,6523,9,5,6,16,31,55,-24,21
CC Mariners,6523,10,4,8,15,28,49,-21,20
Sydney FC,6524,1,21,4,3,67,24,43,67
N'castle Jet,6524,2,15,5,8,58,39,19,50
Melbourne C,6524,3,15,4,10,45,34,11,49
Melbourne V,6524,4,13,5,11,47,41,6,44
Adelaide Utd,6524,5,11,6,11,37,40,-3,39
Brisbane,6524,6,10,5,13,33,42,-9,35
Western Sydn,6524,7,8,9,10,38,47,-9,33
Perth Glory,6524,8,10,2,15,37,50,-13,32
Wellington P,6524,9,5,6,16,31,55,-24,21
CC Mariners,6524,10,4,8,15,28,49,-21,20
Sydney FC,6525,1,20,4,4,64,24,40,64
N'castle Jet,6525,2,16,5,7,60,39,21,53
Melbourne V,6525,3,14,5,10,47,38,9,47
Melbourne C,6525,4,14,4,11,45,36,9,46
Adelaide Utd,6525,5,11,6,11,37,40,-3,39
Brisbane,6525,6,10,5,13,33,42,-9,35
Western Sydn,6525,7,8,9,10,38,47,-9,33
Perth Glory,6525,8,10,2,15,37,50,-13,32
Wellington P,6525,9,5,6,16,31,55,-24,21
CC Mariners,6525,10,4,8,15,28,49,-21,20
Sydney FC,6526,1,20,5,3,65,23,42,65
N'castle Jet,6526,2,16,5,7,60,39,21,53
Melbourne C,6526,3,14,4,11,45,36,9,46
Melbourne V,6526,4,13,6,10,46,39,7,45
Adelaide Utd,6526,5,11,6,11,37,40,-3,39
Brisbane,6526,6,10,5,13,33,42,-9,35
Western Sydn,6526,7,8,9,10,38,47,-9,33
Perth Glory,6526,8,10,2,15,37,50,-13,32
Wellington P,6526,9,5,6,16,31,55,-24,21
CC Mariners,6526,10,4,8,15,28,49,-21,20
Sydney FC,6527,1,20,4,4,64,23,41,64
N'castle Jet,6527,2,15,6,7,59,39,20,51
Melbourne C,6527,3,14,5,10,45,35,10,47
Melbourne V,6527,4,14,5,10,46,38,8,47
Adelaide Utd,6527,5,11,6,11,37,40,-3,39
Brisbane,6527,6,10,5,13,33,42,-9,35
Western Sydn,6527,7,8,9,10,38,47,-9,33
Perth Glory,6527,8,10,2,15,37,50,-13,32
Wellington P,6527,9,5,6,16,31,55,-24,21
CC Mariners,6527,10,4,8,15,28,49,-21,20
Sydney FC,6528,1,20,5,3,65,23,42,65
N'castle Jet,6528,2,16,5,7,59,38,21,53
Melbourne C,6528,3,14,4,11,44,35,9,46
Melbourne V,6528,4,13,6,10,46,39,7,45
Adelaide Utd,6528,5,11,6,11,37,40,-3,39
Brisbane,6528,6,10,5,13,33,42,-9,35
Western Sydn,6528,7,8,9,10,38,47,-9,33
Perth Glory,6528,8,10,2,15,37,50,-13,32
Wellington P,6528,9,5,6,16,31,55,-24,21
CC Mariners,6528,10,4,8,15,28,49,-21,20
Sydney FC,6529,1,20,4,4,65,24,41,64
N'castle Jet,6529,2,16,5,7,62,38,24,53
Melbourne V,6529,3,14,5,10,47,39,8,47
Melbourne C,6529,4,14,4,11,44,38,6,46
Adelaide Utd,6529,5,11,6,11,37,40,-3,39
Brisbane,6529,6,10,5,13,33,42,-9,35
Western Sydn,6529,7,8,9,10,38,47,-9,33
Perth Glory,6529,8,10,2,15,37,50,-13,32
Wellington P,6529,9,5,6,16,31,55,-24,21
CC Mariners,6529,10,4,8,15,28,49,-21,20
Sydney FC,6530,1,20,5,3,66,24,42,65
N'castle Jet,6530,2,15,5,8,57,40,17,50
Melbourne C,6530,3,15,4,10,46,33,13,49
Melbourne V,6530,4,13,6,10,47,40,7,45
Adelaide Utd,6530,5,11,6,11,37,40,-3,39
Brisbane,6530,6,10,5,13,33,42,-9,35
Western Sydn,6530,7,8,9,10,38,47,-9,33
Perth Glory,6530,8,10,2,15,37,50,-13,32
Wellington P,6530,9,5,6,16,31,55,-24,21
CC Mariners,6530,10,4,8,15,28,49,-21,20
Sydney FC,6531,1,21,4,3,68,23,45,67
N'castle Jet,6531,2,16,5,7,59,37,22,53
Melbourne C,6531,3,14,4,11,43,35,8,46
Melbourne V,6531,4,13,5,11,46,42,4,44
Adelaide Utd,6531,5,11,6,11,37,40,-3,39
Brisbane,6531,6,10,5,13,33,42,-9,35
Western Sydn,6531,7,8,9,10,38,47,-9,33
Perth Glory,6531,8,10,2,15,37,50,-13,32
Wellington P,6531,9,5,6,16,31,55,-24,21
CC Mariners,6531,10,4,8,15,28,49,-21,20
Sydney FC,6532,1,21,4,3,70,23,47,67
N'castle Jet,6532,2,15,5,8,59,40,19,50
Melbourne C,6532,3,15,4,10,46,35,11,49
Melbourne V,6532,4,13,5,11,46,44,2,44
Adelaide Utd,6532,5,11,6,11,37,40,-3,39
Brisbane,6532,6,10,5,13,33,42,-9,35
Western Sydn,6532,7,8,9,10,38,47,-9,33
Perth Glory,6532,8,10,2,15,37,50,-13,32
Wellington P,6532,9,5,6,16,31,55,-24,21
CC Mariners,6532,10,4,8,15,28,49,-21,20
Sydney FC,6533,1,20,5,3,65,23,42,65
N'castle Jet,6533,2,15,6,7,58,38,20,51
Melbourne C,6533,3,14,5,10,44,34,10,47
Melbourne V,6533,4,13,6,10,46,39,7,45
Adelaide Utd,6533,5,11,6,11,37,40,-3,39
Brisbane,6533,6,10,5,13,33,42,-9,35
Western Sydn,6533,7,8,9,10,38,47,-9,33
Perth Glory,6533,8,10,2,15,37,50,-13,32
Wellington P,6533,9,5,6,16,31,55,-24,21
CC Mariners,6533,10,4,8,15,28,49,-21,20
Sydney FC,6534,1,21,4,3,67,23,44,67
N'castle Jet,6534,2,15,6,7,59,39,20,51
Melbourne C,6534,3,14,5,10,45,35,10,47
Melbourne V,6534,4,13,5,11,46,41,5,44
Adelaide Utd,6534,5,11,6,11,37,40,-3,39
Brisbane,6534,6,10,5,13,33,42,-9,35
Western Sydn,6534,7,8,9,10,38,47,-9,33
Perth Glory,6534,8,10,2,15,37,50,-13,32
Wellington P,6534,9,5,6,16,31,55,-24,21
CC Mariners,6534,10,4,8,15,28,49,-21,20
Sydney FC,6535,1,20,5,3,67,25,42,65
N'castle Jet,6535,2,16,5,7,60,37,23,53
Melbourne C,6535,3,14,4,11,43,36,7,46
Melbourne V,6535,4,13,6,10,48,41,7,45
Adelaide Utd,6535,5,11,6,11,37,40,-3,39
Brisbane,6535,6,10,5,13,33,42,-9,35
Western Sydn,6535,7,8,9,10,38,47,-9,33
Perth Glory,6535,8,10,2,15,37,50,-13,32
Wellington P,6535,9,5,6,16,31,55,-24,21
CC Mariners,6535,10,4,8,15,28,49,-21,20
Sydney FC,6536,1,21,4,3,66,22,44,67
N'castle Jet,6536,2,16,5,7,59,37,22,53
Melbourne C,6536,3,14,4,11,43,35,8,46
Melbourne V,6536,4,13,5,11,45,40,5,44
Adelaide Utd,6536,5,11,6,11,37,40,-3,39
Brisbane,6536,6,10,5,13,33,42,-9,35
Western Sydn,6536,7,8,9,10,38,47,-9,33
Perth Glory,6536,8,10,2,15,37,50,-13,32
Wellington P,6536,9,5,6,16,31,55,-24,21
CC Mariners,6536,10,4,8,15,28,49,-21,20
Sydney FC,6537,1,20,4,4,64,24,40,64
N'castle Jet,6537,2,16,5,7,59,38,21,53
Melbourne V,6537,3,14,5,10,47,38,9,47
Melbourne C,6537,4,14,4,11,44,35,9,46
Adelaide Utd,6537,5,11,6,11,37,40,-3,39
Brisbane,6537,6,10,5,13,33,42,-9,35
Western Sydn,6537,7,8,9,10,38,47,-9,33
Perth Glory,6537,8,10,2,15,37,50,-13,32
Wellington P,6537,9,5,6,16,31,55,-24,21
CC Mariners,6537,10,4,8,15,28,49,-21,20
Sydney FC,6538,1,21,4,3,67,24,43,67
N'castle Jet,6538,2,16,5,7,60,38,22,53
Melbourne C,6538,3,14,4,11,44,36,8,46
Melbourne V,6538,4,13,5,11,47,41,6,44
Adelaide Utd,6538,5,11,6,11,37,40,-3,39
Brisbane,6538,6,10,5,13,33,42,-9,35
Western Sydn,6538,7,8,9,10,38,47,-9,33
Perth Glory,6538,8,10,2,15,37,50,-13,32
Wellington P,6538,9,5,6,16,31,55,-24,21
CC Mariners,6538,10,4,8,15,28,49,-21,20
Sydney FC,6539,1,21,4,3,67,22,45,67
N'castle Jet,6539,2,15,6,7,58,38,20,51
Melbourne C,6539,3,14,5,10,44,34,10,47
Melbourne V,6539,4,13,5,11,45,41,4,44
Adelaide Utd,6539,5,11,6,11,37,40,-3,39
Brisbane,6539,6,10,5,13,33,42,-9,35
Western Sydn,6539,7,8,9,10,38,47,-9,33
Perth Glory,6539,8,10,2,15,37,50,-13,32
Wellington P,6539,9,5,6,16,31,55,-24,21
CC Mariners,6539,10,4,8,15,28,49,-21,20
Sydney FC,6540,1,21,4,3,66,23,43,67
N'castle Jet,6540,2,16,5,7,59,37,22,53
Melbourne C,6540,3,14,4,11,43,35,8,46
Melbourne V,6540,4,13,5,11,46,40,6,44
Adelaide Utd,6540,5,11,6,11,37,40,-3,39
Brisbane,6540,6,10,5,13,33,42,-9,35
Western Sydn,6540,7,8,9,10,38,47,-9,33
Perth Glory,6540,8,10,2,15,37,50,-13,32
Wellington P,6540,9,5,6,16,31,55,-24,21
CC Mariners,6540,10,4,8,15,28,49,-21,20
Sydney FC,6541,1,21,4,3,65,22,43,67
N'castle Jet,6541,2,16,5,7,60,39,21,53
Melbourne C,6541,3,14,4,11,45,36,9,46
Melbourne V,6541,4,13,5,11,45,39,6,44
Adelaide Utd,6541,5,11,6,11,37,40,-3,39
Brisbane,6541,6,10,5,13,33,42,-9,35
Western Sydn,6541,7,8,9,10,38,47,-9,33
Perth Glory,6541,8,10,2,15,37,50,-13,32
Wellington P,6541,9,5,6,16,31,55,-24,21
CC Mariners,6541,10,4,8,15,28,49,-21,20
Sydney FC,6542,1,21,4,3,67,22,45,67
N'castle Jet,6542,2,16,5,7,58,37,21,53
Melbourne C,6542,3,14,4,11,43,34,9,46
Melbourne V,6542,4,13,5,11,45,41,4,44
Adelaide Utd,6542,5,11,6,11,37,40,-3,39
Brisbane,6542,6,10,5,13,33,42,-9,35
Western Sydn,6542,7,8,9,10,38,47,-9,33
Perth Glory,6542,8,10,2,15,37,50,-13,32
Wellington P,6542,9,5,6,16,31,55,-24,21
CC Mariners,6542,10,4,8,15,28,49,-21,20
Sydney FC,6543,1,21,4,3,68,22,46,67
N'castle Jet,6543,2,16,5,7,60,38,22,53
Melbourne C,6543,3,14,4,11,44,36,8,46
Melbourne V,6543,4,13,5,11,45,42,3,44
Adelaide Utd,6543,5,11,6,11,37,40,-3,39
Brisbane,6543,6,10,5,13,33,42,-9,35
Western Sydn,6543,7,8,9,10,38,47,-9,33
Perth Glory,6543,8,10,2,15,37,50,-13,32
Wellington P,6543,9,5,6,16,31,55,-24,21
CC Mariners,6543,10,4,8,15,28,49,-21,20
Sydney FC,6544,1,20,5,3,66,24,42,65
N'castle Jet,6544,2,15,6,7,58,38,20,51
Melbourne C,6544,3,14,5,10,44,34,10,47
Melbourne V,6544,4,13,6,10,47,40,7,45
Adelaide Utd,6544,5,11,6,11,37,40,-3,39
Brisbane,6544,6,10,5,13,33,42,-9,35
Western Sydn,6544,7,8,9,10,38,47,-9,33
Perth Glory,6544,8,10,2,15,37,50,-13,32
Wellington P,6544,9,5,6,16,31,55,-24,21
CC Mariners,6544,10,4,8,15,28,49,-21,20
Sydney FC,6545,1,20,4,4,64,23,41,64
N'castle Jet,6545,2,16,5,7,59,38,21,53
Melbourne V,6545,3,14,5,10,46,38,8,47
Melbourne C,6545,4,14,4,11,44,35,9,46
Adelaide Utd,6545,5,11,6,11,37,40,-3,39
Brisbane,6545,6,10,5,13,33,42,-9,35
Western Sydn,6545,7,8,9,10,38,47,-9,33
Perth Glory,6545,8,10,2,15,37,50,-13,32
Wellington P,6545,9,5,6,16,31,55,-24,21
CC Mariners,6545,10,4,8,15,28,49,-21,20
Sydney FC,6546,1,20,5,3,65,23,42,65
N'castle Jet,6546,2,15,5,8,58,39,19,50
Melbourne C,6546,3,15,4,10,45,34,11,49
Melbourne V,6546,4,13,6,10,46,39,7,45
Adelaide Utd,6546,5,11,6,11,37,40,-3,39
Brisbane,6546,6,10,5,13,33,42,-9,35
Western Sydn,6546,7,8,9,10,38,47,-9,33
Perth Glory,6546,8,10,2,15,37,50,-13,32
Wellington P,6546,9,5,6,16,31,55,-24,21
CC Mariners,6546,10,4,8,15,28,49,-21,20
Sydney FC,6547,1,21,4,3,68,22,46,67
N'castle Jet,6547,2,15,5,8,58,40,18,50
Melbourne C,6547,3,15,4,10,46,34,12,49
Melbourne V,6547,4,13,5,11,45,42,3,44
Adelaide Utd,6547,5,11,6,11,37,40,-3,39
Brisbane,6547,6,10,5,13,33,42,-9,35
Western Sydn,6547,7,8,9,10,38,47,-9,33
Perth Glory,6547,8,10,2,15,37,50,-13,32
Wellington P,6547,9,5,6,16,31,55,-24,21
CC Mariners,6547,10,4,8,15,28,49,-21,20
Sydney FC,6548,1,21,4,3,67,23,44,67
N'castle Jet,6548,2,15,6,7,57,37,20,51
Melbourne C,6548,3,14,5,10,43,33,10,47
Melbourne V,6548,4,13,5,11,46,41,5,44
Adelaide Utd,6548,5,11,6,11,37,40,-3,39
Brisbane,6548,6,10,5,13,33,42,-9,35
Western Sydn,6548,7,8,9,10,38,47,-9,33
Perth Glory,6548,8,10,2,15,37,50,-13,32
Wellington P,6548,9,5,6,16,31,55,-24,21
CC Mariners,6548,10,4,8,15,28,49,-21,20
Sydney FC,6549,1,20,4,4,65,24,41,64
N'castle Jet,6549,2,16,5,7,60,39,21,53
Melbourne V,6549,3,14,5,10,47,39,8,47
Melbourne C,6549,4,14,4,11,45,36,9,46
Adelaide Utd,6549,5,11,6,11,37,40,-3,39
Brisbane,6549,6,10,5,13,33,42,-9,35
Western Sydn,6549,7,8,9,10,38,47,-9,33
Perth Glory,6549,8,10,2,15,37,50,-13,32
Wellington P,6549,9,5,6,16,31,55,-24,21
CC Mariners,6549,10,4,8,15,28,49,-21,20
Sydney FC,6550,1,21,4,3,67,22,45,67
N'castle Jet,6550,2,15,5,8,57,38,19,50
Melbourne C,6550,3,15,4,10,44,33,11,49
Melbourne V,6550,4,13,5,11,45,41,4,44
Adelaide Utd,6550,5,11,6,11,37,40,-3,39
Brisbane,6550,6,10,5,13,33,42,-9,35
Western Sydn,6550,7,8,9,10,38,47,-9,33
Perth Glory,6550,8,10,2,15,37,50,-13,32
Wellington P,6550,9,5,6,16,31,55,-24,21
CC Mariners,6550,10,4,8,15,28,49,-21,20
Sydney FC,6551,1,21,4,3,66,22,44,67
N'castle Jet,6551,2,16,5,7,59,37,22,53
Melbourne C,6551,3,14,4,11,43,35,8,46
Melbourne V,6551,4,13,5,11,45,40,5,44
Adelaide Utd,6551,5,11,6,11,37,40,-3,39
Brisbane,6551,6,10,5,13,33,42,-9,35
Western Sydn,6551,7,8,9,10,38,47,-9,33
Perth Glory,6551,8,10,2,15,37,50,-13,32
Wellington P,6551,9,5,6,16,31,55,-24,21
CC Mariners,6551,10,4,8,15,28,49,-21,20
Sydney FC,6552,1,20,4,4,64,26,38,64
N'castle Jet,6552,2,15,5,8,58,39,19,50
Melbourne C,6552,3,15,4,10,45,34,11,49
Melbourne V,6552,4,14,5,10,49,38,11,47
Adelaide Utd,6552,5,11,6,11,37,40,-3,39
Brisbane,6552,6,10,5,13,33,42,-9,35
Western Sydn,6552,7,8,9,10,38,47,-9,33
Perth Glory,6552,8,10,2,15,37,50,-13,32
Wellington P,6552,9,5,6,16,31,55,-24,21
CC Mariners,6552,10,4,8,15,28,49,-21,20
Sydney FC,6553,1,21,4,3,73,22,51,67
N'castle Jet,6553,2,15,5,8,58,39,19,50
Melbourne C,6553,3,15,4,10,45,34,11,49
Melbourne V,6553,4,13,5,11,45,47,-2,44
Adelaide Utd,6553,5,11,6,11,37,40,-3,39
Brisbane,6553,6,10,5,13,33,42,-9,35
Western Sydn,6553,7,8,9,10,38,47,-9,33
Perth Glory,6553,8,10,2,15,37,50,-13,32
Wellington P,6553,9,5,6,16,31,55,-24,21
CC Mariners,6553,10,4,8,15,28,49,-21,20
Sydney FC,6554,1,21,4,3,67,22,45,67
N'castle Jet,6554,2,15,6,7,58,38,20,51
Melbourne C,6554,3,14,5,10,44,34,10,47
Melbourne V,6554,4,13,5,11,45,41,4,44
Adelaide Utd,6554,5,11,6,11,37,40,-3,39
Brisbane,6554,6,10,5,13,33,42,-9,35
Western Sydn,6554,7,8,9,10,38,47,-9,33
Perth Glory,6554,8,10,2,15,37,50,-13,32
Wellington P,6554,9,5,6,16,31,55,-24,21
CC Mariners,6554,10,4,8,15,28,49,-21,20
Sydney FC,6555,1,21,4,3,65,22,43,67
N'castle Jet,6555,2,16,5,7,61,39,22,53
Melbourne C,6555,3,14,4,11,45,37,8,46
Melbourne V,6555,4,13,5,11,45,39,6,44
Adelaide Utd,6555,5,11,6,11,37,40,-3,39
Brisbane,6555,6,10,5,13,33,42,-9,35
Western Sydn,6555,7,8,9,10,38,47,-9,33
Perth Glory,6555,8,10,2,15,37,50,-13,32
Wellington P,6555,9,5,6,16,31,55,-24,21
CC Mariners,6555,10,4,8,15,28,49,-21,20
Sydney FC,6556,1,20,4,4,64,23,41,64
N'castle Jet,6556,2,15,6,7,59,39,20,51
Melbourne C,6556,3,14,5,10,45,35,10,47
Melbourne V,6556,4,14,5,10,46,38,8,47
Adelaide Utd,6556,5,11,6,11,37,40,-3,39
Brisbane,6556,6,10,5,13,33,42,-9,35
Western Sydn,6556,7,8,9,10,38,47,-9,33
Perth Glory,6556,8,10,2,15,37,50,-13,32
Wellington P,6556,9,5,6,16,31,55,-24,21
CC Mariners,6556,10,4,8,15,28,49,-21,20
Sydney FC,6557,1,20,4,4,66,25,41,64
N'castle Jet,6557,2,15,6,7,57,37,20,51
Melbourne C,6557,3,14,5,10,43,33,10,47
Melbourne V,6557,4,14,5,10,48,40,8,47
Adelaide Utd,6557,5,11,6,11,37,40,-3,39
Brisbane,6557,6,10,5,13,33,42,-9,35
Western Sydn,6557,7,8,9,10,38,47,-9,33
Perth Glory,6557,8,10,2,15,37,50,-13,32
Wellington P,6557,9,5,6,16,31,55,-24,21
CC Mariners,6557,10,4,8,15,28,49,-21,20
Sydney FC,6558,1,20,5,3,64,22,42,65
N'castle Jet,6558,2,15,5,8,57,39,18,50
Melbourne C,6558,3,15,4,10,45,33,12,49
Melbourne V,6558,4,13,6,10,45,38,7,45
Adelaide Utd,6558,5,11,6,11,37,40,-3,39
Brisbane,6558,6,10,5,13,33,42,-9,35
Western Sydn,6558,7,8,9,10,38,47,-9,33
Perth Glory,6558,8,10,2,15,37,50,-13,32
Wellington P,6558,9,5,6,16,31,55,-24,21
CC Mariners,6558,10,4,8,15,28,49,-21,20
Sydney FC,6559,1,21,4,3,66,23,43,67
N'castle Jet,6559,2,15,5,8,58,39,19,50
Melbourne C,6559,3,15,4,10,45,34,11,49
Melbourne V,6559,4,13,5,11,46,40,6,44
Adelaide Utd,6559,5,11,6,11,37,40,-3,39
Brisbane,6559,6,10,5,13,33,42,-9,35
Western Sydn,6559,7,8,9,10,38,47,-9,33
Perth Glory,6559,8,10,2,15,37,50,-13,32
Wellington P,6559,9,5,6,16,31,55,-24,21
CC Mariners,6559,10,4,8,15,28,49,-21,20
Sydney FC,6560,1,20,5,3,65,23,42,65
N'castle Jet,6560,2,16,5,7,63,37,26,53
Melbourne C,6560,3,14,4,11,43,39,4,46
Melbourne V,6560,4,13,6,10,46,39,7,45
Adelaide Utd,6560,5,11,6,11,37,40,-3,39
Brisbane,6560,6,10,5,13,33,42,-9,35
Western Sydn,6560,7,8,9,10,38,47,-9,33
Perth Glory,6560,8,10,2,15,37,50,-13,32
Wellington P,6560,9,5,6,16,31,55,-24,21
CC Mariners,6560,10,4,8,15,28,49,-21,20
Sydney FC,6561,1,21,4,3,68,22,46,67
N'castle Jet,6561,2,16,5,7,59,37,22,53
Melbourne C,6561,3,14,4,11,43,35,8,46
Melbourne V,6561,4,13,5,11,45,42,3,44
Adelaide Utd,6561,5,11,6,11,37,40,-3,39
Brisbane,6561,6,10,5,13,33,42,-9,35
Western Sydn,6561,7,8,9,10,38,47,-9,33
Perth Glory,6561,8,10,2,15,37,50,-13,32
Wellington P,6561,9,5,6,16,31,55,-24,21
CC Mariners,6561,10,4,8,15,28,49,-21,20
Sydney FC,6562,1,21,4,3,65,22,43,67
N'castle Jet,6562,2,16,5,7,58,37,21,53
Melbourne C,6562,3,14,4,11,43,34,9,46
Melbourne V,6562,4,13,5,11,45,39,6,44
Adelaide Utd,6562,5,11,6,11,37,40,-3,39
Brisbane,6562,6,10,5,13,33,42,-9,35
Western Sydn,6562,7,8,9,10,38,47,-9,33
Perth Glory,6562,8,10,2,15,37,50,-13,32
Wellington P,6562,9,5,6,16,31,55,-24,21
CC Mariners,6562,10,4,8,15,28,49,-21,20
Sydney FC,6563,1,21,4,3,67,22,45,67
N'castle Jet,6563,2,16,5,7,58,37,21,53
Melbourne C,6563,3,14,4,11,43,34,9,46
Melbourne V,6563,4,13,5,11,45,41,4,44
Adelaide Utd,6563,5,11,6,11,37,40,-3,39
Brisbane,6563,6,10,5,13,33,42,-9,35
Western Sydn,6563,7,8,9,10,38,47,-9,33
Perth Glory,6563,8,10,2,15,37,50,-13,32
Wellington P,6563,9,5,6,16,31,55,-24,21
CC Mariners,6563,10,4,8,15,28,49,-21,20
Sydney FC,6564,1,21,4,3,69,24,45,67
N'castle Jet,6564,2,15,5,8,57,41,16,50
Melbourne C,6564,3,15,4,10,47,33,14,49
Melbourne V,6564,4,13,5,11,47,43,4,44
Adelaide Utd,6564,5,11,6,11,37,40,-3,39
Brisbane,6564,6,10,5,13,33,42,-9,35
Western Sydn,6564,7,8,9,10,38,47,-9,33
Perth Glory,6564,8,10,2,15,37,50,-13,32
Wellington P,6564,9,5,6,16,31,55,-24,21
CC Mariners,6564,10,4,8,15,28,49,-21,20
Sydney FC,6565,1,21,4,3,68,23,45,67
N'castle Jet,6565,2,15,6,7,58,38,20,51
Melbourne C,6565,3,14,5,10,44,34,10,47
Melbourne V,6565,4,13,5,11,46,42,4,44
Adelaide Utd,6565,5,11,6,11,37,40,-3,39
Brisbane,6565,6,10,5,13,33,42,-9,35
Western Sydn,6565,7,8,9,10,38,47,-9,33
Perth Glory,6565,8,10,2,15,37,50,-13,32
Wellington P,6565,9,5,6,16,31,55,-24,21
CC Mariners,6565,10,4,8,15,28,49,-21,20
Sydney FC,6566,1,21,4,3,67,23,44,67
N'castle Jet,6566,2,15,6,7,58,38,20,51
Melbourne C,6566,3,14,5,10,44,34,10,47
Melbourne V,6566,4,13,5,11,46,41,5,44
Adelaide Utd,6566,5,11,6,11,37,40,-3,39
Brisbane,6566,6,10,5,13,33,42,-9,35
Western Sydn,6566,7,8,9,10,38,47,-9,33
Perth Glory,6566,8,10,2,15,37,50,-13,32
Wellington P,6566,9,5,6,16,31,55,-24,21
CC Mariners,6566,10,4,8,15,28,49,-21,20
Sydney FC,6567,1,21,4,3,68,24,44,67
N'castle Jet,6567,2,16,5,7,60,38,22,53
Melbourne C,6567,3,14,4,11,44,36,8,46
Melbourne V,6567,4,13,5,11,47,42,5,44
Adelaide Utd,6567,5,11,6,11,37,40,-3,39
Brisbane,6567,6,10,5,13,33,42,-9,35
Western Sydn,6567,7,8,9,10,38,47,-9,33
Perth Glory,6567,8,10,2,15,37,50,-13,32
Wellington P,6567,9,5,6,16,31,55,-24,21
CC Mariners,6567,10,4,8,15,28,49,-21,20
Sydney FC,6568,1,20,5,3,65,23,42,65
N'castle Jet,6568,2,15,6,7,57,37,20,51
Melbourne C,6568,3,14,5,10,43,33,10,47
Melbourne V,6568,4,13,6,10,46,39,7,45
Adelaide Utd,6568,5,11,6,11,37,40,-3,39
Brisbane,6568,6,10,5,13,33,42,-9,35
Western Sydn,6568,7,8,9,10,38,47,-9,33
Perth Glory,6568,8,10,2,15,37,50,-13,32
Wellington P,6568,9,5,6,16,31,55,-24,21
CC Mariners,6568,10,4,8,15,28,49,-21,20
Sydney FC,6569,1,21,4,3,65,22,43,67
N'castle Jet,6569,2,16,5,7,59,38,21,53
Melbourne C,6569,3,14,4,11,44,35,9,46
Melbourne V,6569,4,13,5,11,45,39,6,44
Adelaide Utd,6569,5,11,6,11,37,40,-3,39
Brisbane,6569,6,10,5,13,33,42,-9,35
Western Sydn,6569,7,8,9,10,38,47,-9,33
Perth Glory,6569,8,10,2,15,37,50,-13,32
Wellington P,6569,9,5,6,16,31,55,-24,21
CC Mariners,6569,10,4,8,15,28,49,-21,20
Sydney FC,6570,1,20,4,4,65,24,41,64
N'castle Jet,6570,2,16,5,7,62,38,24,53
Melbourne V,6570,3,14,5,10,47,39,8,47
Melbourne C,6570,4,14,4,11,44,38,6,46
Adelaide Utd,6570,5,11,6,11,37,40,-3,39
Brisbane,6570,6,10,5,13,33,42,-9,35
Western Sydn,6570,7,8,9,10,38,47,-9,33
Perth Glory,6570,8,10,2,15,37,50,-13,32
Wellington P,6570,9,5,6,16,31,55,-24,21
CC Mariners,6570,10,4,8,15,28,49,-21,20
Sydney FC,6571,1,20,4,4,65,24,41,64
N'castle Jet,6571,2,15,6,7,58,38,20,51
Melbourne C,6571,3,14,5,10,44,34,10,47
Melbourne V,6571,4,14,5,10,47,39,8,47
Adelaide Utd,6571,5,11,6,11,37,40,-3,39
Brisbane,6571,6,10,5,13,33,42,-9,35
Western Sydn,6571,7,8,9,10,38,47,-9,33
Perth Glory,6571,8,10,2,15,37,50,-13,32
Wellington P,6571,9,5,6,16,31,55,-24,21
CC Mariners,6571,10,4,8,15,28,49,-21,20
Sydney FC,6572,1,20,5,3,64,22,42,65
N'castle Jet,6572,2,16,5,7,60,38,22,53
Melbourne C,6572,3,14,4,11,44,36,8,46
Melbourne V,6572,4,13,6,10,45,38,7,45
Adelaide Utd,6572,5,11,6,11,37,40,-3,39
Brisbane,6572,6,10,5,13,33,42,-9,35
Western Sydn,6572,7,8,9,10,38,47,-9,33
Perth Glory,6572,8,10,2,15,37,50,-13,32
Wellington P,6572,9,5,6,16,31,55,-24,21
CC Mariners,6572,10,4,8,15,28,49,-21,20
Sydney FC,6573,1,21,4,3,67,22,45,67
N'castle Jet,6573,2,16,5,7,60,37,23,53
Melbourne C,6573,3,14,4,11,43,36,7,46
Melbourne V,6573,4,13,5,11,45,41,4,44
Adelaide Utd,6573,5,11,6,11,37,40,-3,39
Brisbane,6573,6,10,5,13,33,42,-9,35
Western Sydn,6573,7,8,9,10,38,47,-9,33
Perth Glory,6573,8,10,2,15,37,50,-13,32
Wellington P,6573,9,5,6,16,31,55,-24,21
CC Mariners,6573,10,4,8,15,28,49,-21,20
Sydney FC,6574,1,21,4,3,66,23,43,67
N'castle Jet,6574,2,16,5,7,60,37,23,53
Melbourne C,6574,3,14,4,11,43,36,7,46
Melbourne V,6574,4,13,5,11,46,40,6,44
Adelaide Utd,6574,5,11,6,11,37,40,-3,39
Brisbane,6574,6,10,5,13,33,42,-9,35
Western Sydn,6574,7,8,9,10,38,47,-9,33
Perth Glory,6574,8,10,2,15,37,50,-13,32
Wellington P,6574,9,5,6,16,31,55,-24,21
CC Mariners,6574,10,4,8,15,28,49,-21,20
Sydney FC,6575,1,21,4,3,69,23,46,67
N'castle Jet,6575,2,15,6,7,58,38,20,51
Melbourne C,6575,3,14,5,10,44,34,10,47
Melbourne V,6575,4,13,5,11,46,43,3,44
Adelaide Utd,6575,5,11,6,11,37,40,-3,39
Brisbane,6575,6,10,5,13,33,42,-9,35
Western Sydn,6575,7,8,9,10,38,47,-9,33
Perth Glory,6575,8,10,2,15,37,50,-13,32
Wellington P,6575,9,5,6,16,31,55,-24,21
CC Mariners,6575,10,4,8,15,28,49,-21,20
Sydney FC,6576,1,21,4,3,68,23,45,67
N'castle Jet,6576,2,16,5,7,59,37,22,53
Melbourne C,6576,3,14,4,11,43,35,8,46
Melbourne V,6576,4,13,5,11,46,42,4,44
Adelaide Utd,6576,5,11,6,11,37,40,-3,39
Brisbane,6576,6,10,5,13,33,42,-9,35
Western Sydn,6576,7,8,9,10,38,47,-9,33
Perth Glory,6576,8,10,2,15,37,50,-13,32
Wellington P,6576,9,5,6,16,31,55,-24,21
CC Mariners,6576,10,4,8,15,28,49,-21,20
Sydney FC,6577,1,20,5,3,66,24,42,65
N'castle Jet,6577,2,15,6,7,60,40,20,51
Melbourne C,6577,3,14,5,10,46,36,10,47
Melbourne V,6577,4,13,6,10,47,40,7,45
Adelaide Utd,6577,5,11,6,11,37,40,-3,39
Brisbane,6577,6,10,5,13,33,42,-9,35
Western Sydn,6577,7,8,9,10,38,47,-9,33
Perth Glory,6577,8,10,2,15,37,50,-13,32
Wellington P,6577,9,5,6,16,31,55,-24,21
CC Mariners,6577,10,4,8,15,28,49,-21,20
Sydney FC,6578,1,21,4,3,67,24,43,67
N'castle Jet,6578,2,16,5,7,59,37,22,53
Melbourne C,6578,3,14,4,11,43,35,8,46
Melbourne V,6578,4,13,5,11,47,41,6,44
Adelaide Utd,6578,5,11,6,11,37,40,-3,39
Brisbane,6578,6,10,5,13,33,42,-9,35
Western Sydn,6578,7,8,9,10,38,47,-9,33
Perth Glory,6578,8,10,2,15,37,50,-13,32
Wellington P,6578,9,5,6,16,31,55,-24,21
CC Mariners,6578,10,4,8,15,28,49,-21,20
Sydney FC,6579,1,20,5,3,65,23,42,65
N'castle Jet,6579,2,16,5,7,58,37,21,53
Melbourne C,6579,3,14,4,11,43,34,9,46
Melbourne V,6579,4,13,6,10,46,39,7,45
Adelaide Utd,6579,5,11,6,11,37,40,-3,39
Brisbane,6579,6,10,5,13,33,42,-9,35
Western Sydn,6579,7,8,9,10,38,47,-9,33
Perth Glory,6579,8,10,2,15,37,50,-13,32
Wellington P,6579,9,5,6,16,31,55,-24,21
CC Mariners,6579,10,4,8,15,28,49,-21,20
Sydney FC,6580,1,21,4,3,67,23,44,67
N'castle Jet,6580,2,16,5,7,59,38,21,53
Melbourne C,6580,3,14,4,11,44,35,9,46
Melbourne V,6580,4,13,5,11,46,41,5,44
Adelaide Utd,6580,5,11,6,11,37,40,-3,39
Brisbane,6580,6,10,5,13,33,42,-9,35
Western Sydn,6580,7,8,9,10,38,47,-9,33
Perth Glory,6580,8,10,2,15,37,50,-13,32
Wellington P,6580,9,5,6,16,31,55,-24,21
CC Mariners,6580,10,4,8,15,28,49,-21,20
Sydney FC,6581,1,21,4,3,66,22,44,67
N'castle Jet,6581,2,15,5,8,57,40,17,50
Melbourne C,6581,3,15,4,10,46,33,13,49
Melbourne V,6581,4,13,5,11,45,40,5,44
Adelaide Utd,6581,5,11,6,11,37,40,-3,39
Brisbane,6581,6,10,5,13,33,42,-9,35
Western Sydn,6581,7,8,9,10,38,47,-9,33
Perth Glory,6581,8,10,2,15,37,50,-13,32
Wellington P,6581,9,5,6,16,31,55,-24,21
CC Mariners,6581,10,4,8,15,28,49,-21,20
Sydney FC,6582,1,21,4,3,66,23,43,67
N'castle Jet,6582,2,16,5,7,60,37,23,53
Melbourne C,6582,3,14,4,11,43,36,7,46
Melbourne V,6582,4,13,5,11,46,40,6,44
Adelaide Utd,6582,5,11,6,11,37,40,-3,39
Brisbane,6582,6,10,5,13,33,42,-9,35
Western Sydn,6582,7,8,9,10,38,47,-9,33
Perth Glory,6582,8,10,2,15,37,50,-13,32
Wellington P,6582,9,5,6,16,31,55,-24,21
CC Mariners,6582,10,4,8,15,28,49,-21,20
Sydney FC,6583,1,21,4,3,67,24,43,67
N'castle Jet,6583,2,16,5,7,62,37,25,53
Melbourne C,6583,3,14,4,11,43,38,5,46
Melbourne V,6583,4,13,5,11,47,41,6,44
Adelaide Utd,6583,5,11,6,11,37,40,-3,39
Brisbane,6583,6,10,5,13,33,42,-9,35
Western Sydn,6583,7,8,9,10,38,47,-9,33
Perth Glory,6583,8,10,2,15,37,50,-13,32
Wellington P,6583,9,5,6,16,31,55,-24,21
CC Mariners,6583,10,4,8,15,28,49,-21,20
Sydney FC,6584,1,20,4,4,64,23,41,64
N'castle Jet,6584,2,16,5,7,59,37,22,53
Melbourne V,6584,3,14,5,10,46,38,8,47
Melbourne C,6584,4,14,4,11,43,35,8,46
Adelaide Utd,6584,5,11,6,11,37,40,-3,39
Brisbane,6584,6,10,5,13,33,42,-9,35
Western Sydn,6584,7,8,9,10,38,47,-9,33
Perth Glory,6584,8,10,2,15,37,50,-13,32
Wellington P,6584,9,5,6,16,31,55,-24,21
CC Mariners,6584,10,4,8,15,28,49,-21,20
Sydney FC,6585,1,21,4,3,68,22,46,67
N'castle Jet,6585,2,16,5,7,59,38,21,53
Melbourne C,6585,3,14,4,11,44,35,9,46
Melbourne V,6585,4,13,5,11,45,42,3,44
Adelaide Utd,6585,5,11,6,11,37,40,-3,39
Brisbane,6585,6,10,5,13,33,42,-9,35
Western Sydn,6585,7,8,9,10,38,47,-9,33
Perth Glory,6585,8,10,2,15,37,50,-13,32
Wellington P,6585,9,5,6,16,31,55,-24,21
CC Mariners,6585,10,4,8,15,28,49,-21,20
Sydney FC,6586,1,21,4,3,66,23,43,67
N'castle Jet,6586,2,15,6,7,57,37,20,51
Melbourne C,6586,3,14,5,10,43,33,10,47
Melbourne V,6586,4,13,5,11,46,40,6,44
Adelaide Utd,6586,5,11,6,11,37,40,-3,39
Brisbane,6586,6,10,5,13,33,42,-9,35
Western Sydn,6586,7,8,9,10,38,47,-9,33
Perth Glory,6586,8,10,2,15,37,50,-13,32
Wellington P,6586,9,5,6,16,31,55,-24,21
CC Mariners,6586,10,4,8,15,28,49,-21,20
Sydney FC,6587,1,21,4,3,65,22,43,67
N'castle Jet,6587,2,16,5,7,60,39,21,53
Melbourne C,6587,3,14,4,11,45,36,9,46
Melbourne V,6587,4,13,5,11,45,39,6,44
Adelaide Utd,6587,5,11,6,11,37,40,-3,39
Brisbane,6587,6,10,5,13,33,42,-9,35
Western Sydn,6587,7,8,9,10,38,47,-9,33
Perth Glory,6587,8,10,2,15,37,50,-13,32
Wellington P,6587,9,5,6,16,31,55,-24,21
CC Mariners,6587,10,4,8,15,28,49,-21,20
Sydney FC,6588,1,21,4,3,65,22,43,67
N'castle Jet,6588,2,15,6,7,59,39,20,51
Melbourne C,6588,3,14,5,10,45,35,10,47
Melbourne V,6588,4,13,5,11,45,39,6,44
Adelaide Utd,6588,5,11,6,11,37,40,-3,39
Brisbane,6588,6,10,5,13,33,42,-9,35
Western Sydn,6588,7,8,9,10,38,47,-9,33
Perth Glory,6588,8,10,2,15,37,50,-13,32
Wellington P,6588,9,5,6,16,31,55,-24,21
CC Mariners,6588,10,4,8,15,28,49,-21,20
Sydney FC,6589,1,20,4,4,65,25,40,64
N'castle Jet,6589,2,16,5,7,60,38,22,53
Melbourne V,6589,3,14,5,10,48,39,9,47
Melbourne C,6589,4,14,4,11,44,36,8,46
Adelaide Utd,6589,5,11,6,11,37,40,-3,39
Brisbane,6589,6,10,5,13,33,42,-9,35
Western Sydn,6589,7,8,9,10,38,47,-9,33
Perth Glory,6589,8,10,2,15,37,50,-13,32
Wellington P,6589,9,5,6,16,31,55,-24,21
CC Mariners,6589,10,4,8,15,28,49,-21,20
Sydney FC,6590,1,21,4,3,66,22,44,67
N'castle Jet,6590,2,15,5,8,57,39,18,50
Melbourne C,6590,3,15,4,10,45,33,12,49
Melbourne V,6590,4,13,5,11,45,40,5,44
Adelaide Utd,6590,5,11,6,11,37,40,-3,39
Brisbane,6590,6,10,5,13,33,42,-9,35
Western Sydn,6590,7,8,9,10,38,47,-9,33
Perth Glory,6590,8,10,2,15,37,50,-13,32
Wellington P,6590,9,5,6,16,31,55,-24,21
CC Mariners,6590,10,4,8,15,28,49,-21,20
Sydney FC,6591,1,20,5,3,65,23,42,65
N'castle Jet,6591,2,15,5,8,57,39,18,50
Melbourne C,6591,3,15,4,10,45,33,12,49
Melbourne V,6591,4,13,6,10,46,39,7,45
Adelaide Utd,6591,5,11,6,11,37,40,-3,39
Brisbane,6591,6,10,5,13,33,42,-9,35
Western Sydn,6591,7,8,9,10,38,47,-9,33
Perth Glory,6591,8,10,2,15,37,50,-13,32
Wellington P,6591,9,5,6,16,31,55,-24,21
CC Mariners,6591,10,4,8,15,28,49,-21,20
Sydney FC,6592,1,20,4,4,64,23,41,64
N'castle Jet,6592,2,16,5,7,58,37,21,53
Melbourne V,6592,3,14,5,10,46,38,8,47
Melbourne C,6592,4,14,4,11,43,34,9,46
Adelaide Utd,6592,5,11,6,11,37,40,-3,39
Brisbane,6592,6,10,5,13,33,42,-9,35
Western Sydn,6592,7,8,9,10,38,47,-9,33
Perth Glory,6592,8,10,2,15,37,50,-13,32
Wellington P,6592,9,5,6,16,31,55,-24,21
CC Mariners,6592,10,4,8,15,28,49,-21,20
Sydney FC,6593,1,21,4,3,67,23,44,67
N'castle Jet,6593,2,15,6,7,59,39,20,51
Melbourne C,6593,3,14,5,10,45,35,10,47
Melbourne V,6593,4,13,5,11,46,41,5,44
Adelaide Utd,6593,5,11,6,11,37,40,-3,39
Brisbane,6593,6,10,5,13,33,42,-9,35
Western Sydn,6593,7,8,9,10,38,47,-9,33
Perth Glory,6593,8,10,2,15,37,50,-13,32
Wellington P,6593,9,5,6,16,31,55,-24,21
CC Mariners,6593,10,4,8,15,28,49,-21,20
Sydney FC,6594,1,20,4,4,66,27,39,64
N'castle Jet,6594,2,16,5,7,58,37,21,53
Melbourne V,6594,3,14,5,10,50,40,10,47
Melbourne C,6594,4,14,4,11,43,34,9,46
Adelaide Utd,6594,5,11,6,11,37,40,-3,39
Brisbane,6594,6,10,5,13,33,42,-9,35
Western Sydn,6594,7,8,9,10,38,47,-9,33
Perth Glory,6594,8,10,2,15,37,50,-13,32
Wellington P,6594,9,5,6,16,31,55,-24,21
CC Mariners,6594,10,4,8,15,28,49,-21,20
Sydney FC,6595,1,21,4,3,66,22,44,67
N'castle Jet,6595,2,16,5,7,61,38,23,53
Melbourne C,6595,3,14,4,11,44,37,7,46
Melbourne V,6595,4,13,5,11,45,40,5,44
Adelaide Utd,6595,5,11,6,11,37,40,-3,39
Brisbane,6595,6,10,5,13,33,42,-9,35
Western Sydn,6595,7,8,9,10,38,47,-9,33
Perth Glory,6595,8,10,2,15,37,50,-13,32
Wellington P,6595,9,5,6,16,31,55,-24,21
CC Mariners,6595,10,4,8,15,28,49,-21,20
Sydney FC,6596,1,20,4,4,66,25,41,64
N'castle Jet,6596,2,16,5,7,58,37,21,53
Melbourne V,6596,3,14,5,10,48,40,8,47
Melbourne C,6596,4,14,4,11,43,34,9,46
Adelaide Utd,6596,5,11,6,11,37,40,-3,39
Brisbane,6596,6,10,5,13,33,42,-9,35
Western Sydn,6596,7,8,9,10,38,47,-9,33
Perth Glory,6596,8,10,2,15,37,50,-13,32
Wellington P,6596,9,5,6,16,31,55,-24,21
CC Mariners,6596,10,4,8,15,28,49,-21,20
Sydney FC,6597,1,21,4,3,67,23,44,67
N'castle Jet,6597,2,16,5,7,59,37,22,53
Melbourne C,6597,3,14,4,11,43,35,8,46
Melbourne V,6597,4,13,5,11,46,41,5,44
Adelaide Utd,6597,5,11,6,11,37,40,-3,39
Brisbane,6597,6,10,5,13,33,42,-9,35
Western Sydn,6597,7,8,9,10,38,47,-9,33
Perth Glory,6597,8,10,2,15,37,50,-13,32
Wellington P,6597,9,5,6,16,31,55,-24,21
CC Mariners,6597,10,4,8,15,28,49,-21,20
Sydney FC,6598,1,21,4,3,66,23,43,67
N'castle Jet,6598,2,15,6,7,57,37,20,51
Melbourne C,6598,3,14,5,10,43,33,10,47
Melbourne V,6598,4,13,5,11,46,40,6,44
Adelaide Utd,6598,5,11,6,11,37,40,-3,39
Brisbane,6598,6,10,5,13,33,42,-9,35
Western Sydn,6598,7,8,9,10,38,47,-9,33
Perth Glory,6598,8,10,2,15,37,50,-13,32
Wellington P,6598,9,5,6,16,31,55,-24,21
CC Mariners,6598,10,4,8,15,28,49,-21,20
Sydney FC,6599,1,21,4,3,65,22,43,67
N'castle Jet,6599,2,16,5,7,59,38,21,53
Melbourne C,6599,3,14,4,11,44,35,9,46
Melbourne V,6599,4,13,5,11,45,39,6,44
Adelaide Utd,6599,5,11,6,11,37,40,-3,39
Brisbane,6599,6,10,5,13,33,42,-9,35
Western Sydn,6599,7,8,9,10,38,47,-9,33
Perth Glory,6599,8,10,2,15,37,50,-13,32
Wellington P,6599,9,5,6,16,31,55,-24,21
CC Mariners,6599,10,4,8,15,28,49,-21,20
Sydney FC,6600,1,20,5,3,65,23,42,65
N'castle Jet,6600,2,15,6,7,58,38,20,51
Melbourne C,6600,3,14,5,10,44,34,10,47
Melbourne V,6600,4,13,6,10,46,39,7,45
Adelaide Utd,6600,5,11,6,11,37,40,-3,39
Brisbane,6600,6,10,5,13,33,42,-9,35
Western Sydn,6600,7,8,9,10,38,47,-9,33
Perth Glory,6600,8,10,2,15,37,50,-13,32
Wellington P,6600,9,5,6,16,31,55,-24,21
CC Mariners,6600,10,4,8,15,28,49,-21,20
Sydney FC,6601,1,21,4,3,66,22,44,67
N'castle Jet,6601,2,15,5,8,57,38,19,50
Melbourne C,6601,3,15,4,10,44,33,11,49
Melbourne V,6601,4,13,5,11,45,40,5,44
Adelaide Utd,6601,5,11,6,11,37,40,-3,39
Brisbane,6601,6,10,5,13,33,42,-9,35
Western Sydn,6601,7,8,9,10,38,47,-9,33
Perth Glory,6601,8,10,2,15,37,50,-13,32
Wellington P,6601,9,5,6,16,31,55,-24,21
CC Mariners,6601,10,4,8,15,28,49,-21,20
Sydney FC,6602,1,20,5,3,64,22,42,65
N'castle Jet,6602,2,16,5,7,60,39,21,53
Melbourne C,6602,3,14,4,11,45,36,9,46
Melbourne V,6602,4,13,6,10,45,38,7,45
Adelaide Utd,6602,5,11,6,11,37,40,-3,39
Brisbane,6602,6,10,5,13,33,42,-9,35
Western Sydn,6602,7,8,9,10,38,47,-9,33
Perth Glory,6602,8,10,2,15,37,50,-13,32
Wellington P,6602,9,5,6,16,31,55,-24,21
CC Mariners,6602,10,4,8,15,28,49,-21,20
Sydney FC,6603,1,20,4,4,65,24,41,64
N'castle Jet,6603,2,16,5,7,58,37,21,53
Melbourne V,6603,3,14,5,10,47,39,8,47
Melbourne C,6603,4,14,4,11,43,34,9,46
Adelaide Utd,6603,5,11,6,11,37,40,-3,39
Brisbane,6603,6,10,5,13,33,42,-9,35
Western Sydn,6603,7,8,9,10,38,47,-9,33
Perth Glory,6603,8,10,2,15,37,50,-13,32
Wellington P,6603,9,5,6,16,31,55,-24,21
CC Mariners,6603,10,4,8,15,28,49,-21,20
Sydney FC,6604,1,20,4,4,64,23,41,64
N'castle Jet,6604,2,15,5,8,57,40,17,50
Melbourne C,6604,3,15,4,10,46,33,13,49
Melbourne V,6604,4,14,5,10,46,38,8,47
Adelaide Utd,6604,5,11,6,11,37,40,-3,39
Brisbane,6604,6,10,5,13,33,42,-9,35
Western Sydn,6604,7,8,9,10,38,47,-9,33
Perth Glory,6604,8,10,2,15,37,50,-13,32
Wellington P,6604,9,5,6,16,31,55,-24,21
CC Mariners,6604,10,4,8,15,28,49,-21,20
Sydney FC,6605,1,21,4,3,65,22,43,67
N'castle Jet,6605,2,16,5,7,58,37,21,53
Melbourne C,6605,3,14,4,11,43,34,9,46
Melbourne V,6605,4,13,5,11,45,39,6,44
Adelaide Utd,6605,5,11,6,11,37,40,-3,39
Brisbane,6605,6,10,5,13,33,42,-9,35
Western Sydn,6605,7,8,9,10,38,47,-9,33
Perth Glory,6605,8,10,2,15,37,50,-13,32
Wellington P,6605,9,5,6,16,31,55,-24,21
CC Mariners,6605,10,4,8,15,28,49,-21,20
Sydney FC,6606,1,21,4,3,66,22,44,67
N'castle Jet,6606,2,15,6,7,57,37,20,51
Melbourne C,6606,3,14,5,10,43,33,10,47
Melbourne V,6606,4,13,5,11,45,40,5,44
Adelaide Utd,6606,5,11,6,11,37,40,-3,39
Brisbane,6606,6,10,5,13,33,42,-9,35
Western Sydn,6606,7,8,9,10,38,47,-9,33
Perth Glory,6606,8,10,2,15,37,50,-13,32
Wellington P,6606,9,5,6,16,31,55,-24,21
CC Mariners,6606,10,4,8,15,28,49,-21,20
Sydney FC,6607,1,21,4,3,66,23,43,67
N'castle Jet,6607,2,15,6,7,59,39,20,51
Melbourne C,6607,3,14,5,10,45,35,10,47
Melbourne V,6607,4,13,5,11,46,40,6,44
Adelaide Utd,6607,5,11,6,11,37,40,-3,39
Brisbane,6607,6,10,5,13,33,42,-9,35
Western Sydn,6607,7,8,9,10,38,47,-9,33
Perth Glory,6607,8,10,2,15,37,50,-13,32
Wellington P,6607,9,5,6,16,31,55,-24,21
CC Mariners,6607,10,4,8,15,28,49,-21,20
Sydney FC,6608,1,21,4,3,66,22,44,67
N'castle Jet,6608,2,16,5,7,59,37,22,53
Melbourne C,6608,3,14,4,11,43,35,8,46
Melbourne V,6608,4,13,5,11,45,40,5,44
Adelaide Utd,6608,5,11,6,11,37,40,-3,39
Brisbane,6608,6,10,5,13,33,42,-9,35
Western Sydn,6608,7,8,9,10,38,47,-9,33
Perth Glory,6608,8,10,2,15,37,50,-13,32
Wellington P,6608,9,5,6,16,31,55,-24,21
CC Mariners,6608,10,4,8,15,28,49,-21,20
Sydney FC,6609,1,21,4,3,66,23,43,67
N'castle Jet,6609,2,15,6,7,59,39,20,51
Melbourne C,6609,3,14,5,10,45,35,10,47
Melbourne V,6609,4,13,5,11,46,40,6,44
Adelaide Utd,6609,5,11,6,11,37,40,-3,39
Brisbane,6609,6,10,5,13,33,42,-9,35
Western Sydn,6609,7,8,9,10,38,47,-9,33
Perth Glory,6609,8,10,2,15,37,50,-13,32
Wellington P,6609,9,5,6,16,31,55,-24,21
CC Mariners,6609,10,4,8,15,28,49,-21,20
Sydney FC,6610,1,20,4,4,64,24,40,64
N'castle Jet,6610,2,16,5,7,62,37,25,53
Melbourne V,6610,3,14,5,10,47,38,9,47
Melbourne C,6610,4,14,4,11,43,38,5,46
Adelaide Utd,6610,5,11,6,11,37,40,-3,39
Brisbane,6610,6,10,5,13,33,42,-9,35
Western Sydn,6610,7,8,9,10,38,47,-9,33
Perth Glory,6610,8,10,2,15,37,50,-13,32
Wellington P,6610,9,5,6,16,31,55,-24,21
CC Mariners,6610,10,4,8,15,28,49,-21,20
Sydney FC,6611,1,21,4,3,65,22,43,67
N'castle Jet,6611,2,16,5,7,60,38,22,53
Melbourne C,6611,3,14,4,11,44,36,8,46
Melbourne V,6611,4,13,5,11,45,39,6,44
Adelaide Utd,6611,5,11,6,11,37,40,-3,39
Brisbane,6611,6,10,5,13,33,42,-9,35
Western Sydn,6611,7,8,9,10,38,47,-9,33
Perth Glory,6611,8,10,2,15,37,50,-13,32
Wellington P,6611,9,5,6,16,31,55,-24,21
CC Mariners,6611,10,4,8,15,28,49,-21,20
Sydney FC,6612,1,20,5,3,66,24,42,65
N'castle Jet,6612,2,16,5,7,62,38,24,53
Melbourne C,6612,3,14,4,11,44,38,6,46
Melbourne V,6612,4,13,6,10,47,40,7,45
Adelaide Utd,6612,5,11,6,11,37,40,-3,39
Brisbane,6612,6,10,5,13,33,42,-9,35
Western Sydn,6612,7,8,9,10,38,47,-9,33
Perth Glory,6612,8,10,2,15,37,50,-13,32
Wellington P,6612,9,5,6,16,31,55,-24,21
CC Mariners,6612,10,4,8,15,28,49,-21,20
Sydney FC,6613,1,21,4,3,68,22,46,67
N'castle Jet,6613,2,16,5,7,59,38,21,53
Melbourne C,6613,3,14,4,11,44,35,9,46
Melbourne V,6613,4,13,5,11,45,42,3,44
Adelaide Utd,6613,5,11,6,11,37,40,-3,39
Brisbane,6613,6,10,5,13,33,42,-9,35
Western Sydn,6613,7,8,9,10,38,47,-9,33
Perth Glory,6613,8,10,2,15,37,50,-13,32
Wellington P,6613,9,5,6,16,31,55,-24,21
CC Mariners,6613,10,4,8,15,28,49,-21,20
Sydney FC,6614,1,21,4,3,66,22,44,67
N'castle Jet,6614,2,15,5,8,58,39,19,50
Melbourne C,6614,3,15,4,10,45,34,11,49
Melbourne V,6614,4,13,5,11,45,40,5,44
Adelaide Utd,6614,5,11,6,11,37,40,-3,39
Brisbane,6614,6,10,5,13,33,42,-9,35
Western Sydn,6614,7,8,9,10,38,47,-9,33
Perth Glory,6614,8,10,2,15,37,50,-13,32
Wellington P,6614,9,5,6,16,31,55,-24,21
CC Mariners,6614,10,4,8,15,28,49,-21,20
Sydney FC,6615,1,20,4,4,64,23,41,64
N'castle Jet,6615,2,16,5,7,58,37,21,53
Melbourne V,6615,3,14,5,10,46,38,8,47
Melbourne C,6615,4,14,4,11,43,34,9,46
Adelaide Utd,6615,5,11,6,11,37,40,-3,39
Brisbane,6615,6,10,5,13,33,42,-9,35
Western Sydn,6615,7,8,9,10,38,47,-9,33
Perth Glory,6615,8,10,2,15,37,50,-13,32
Wellington P,6615,9,5,6,16,31,55,-24,21
CC Mariners,6615,10,4,8,15,28,49,-21,20
Sydney FC,6616,1,20,5,3,65,23,42,65
N'castle Jet,6616,2,16,5,7,59,37,22,53
Melbourne C,6616,3,14,4,11,43,35,8,46
Melbourne V,6616,4,13,6,10,46,39,7,45
Adelaide Utd,6616,5,11,6,11,37,40,-3,39
Brisbane,6616,6,10,5,13,33,42,-9,35
Western Sydn,6616,7,8,9,10,38,47,-9,33
Perth Glory,6616,8,10,2,15,37,50,-13,32
Wellington P,6616,9,5,6,16,31,55,-24,21
CC Mariners,6616,10,4,8,15,28,49,-21,20
Sydney FC,6617,1,20,4,4,64,23,41,64
N'castle Jet,6617,2,15,5,8,57,38,19,50
Melbourne C,6617,3,15,4,10,44,33,11,49
Melbourne V,6617,4,14,5,10,46,38,8,47
Adelaide Utd,6617,5,11,6,11,37,40,-3,39
Brisbane,6617,6,10,5,13,33,42,-9,35
Western Sydn,6617,7,8,9,10,38,47,-9,33
Perth Glory,6617,8,10,2,15,37,50,-13,32
Wellington P,6617,9,5,6,16,31,55,-24,21
CC Mariners,6617,10,4,8,15,28,49,-21,20
Sydney FC,6618,1,21,4,3,67,24,43,67
N'castle Jet,6618,2,16,5,7,60,37,23,53
Melbourne C,6618,3,14,4,11,43,36,7,46
Melbourne V,6618,4,13,5,11,47,41,6,44
Adelaide Utd,6618,5,11,6,11,37,40,-3,39
Brisbane,6618,6,10,5,13,33,42,-9,35
Western Sydn,6618,7,8,9,10,38,47,-9,33
Perth Glory,6618,8,10,2,15,37,50,-13,32
Wellington P,6618,9,5,6,16,31,55,-24,21
CC Mariners,6618,10,4,8,15,28,49,-21,20
Sydney FC,6619,1,21,4,3,66,22,44,67
N'castle Jet,6619,2,16,5,7,60,38,22,53
Melbourne C,6619,3,14,4,11,44,36,8,46
Melbourne V,6619,4,13,5,11,45,40,5,44
Adelaide Utd,6619,5,11,6,11,37,40,-3,39
Brisbane,6619,6,10,5,13,33,42,-9,35
Western Sydn,6619,7,8,9,10,38,47,-9,33
Perth Glory,6619,8,10,2,15,37,50,-13,32
Wellington P,6619,9,5,6,16,31,55,-24,21
CC Mariners,6619,10,4,8,15,28,49,-21,20
Sydney FC,6620,1,21,4,3,66,22,44,67
N'castle Jet,6620,2,15,5,8,58,39,19,50
Melbourne C,6620,3,15,4,10,45,34,11,49
Melbourne V,6620,4,13,5,11,45,40,5,44
Adelaide Utd,6620,5,11,6,11,37,40,-3,39
Brisbane,6620,6,10,5,13,33,42,-9,35
Western Sydn,6620,7,8,9,10,38,47,-9,33
Perth Glory,6620,8,10,2,15,37,50,-13,32
Wellington P,6620,9,5,6,16,31,55,-24,21
CC Mariners,6620,10,4,8,15,28,49,-21,20
Sydney FC,6621,1,21,4,3,66,22,44,67
N'castle Jet,6621,2,16,5,7,58,37,21,53
Melbourne C,6621,3,14,4,11,43,34,9,46
Melbourne V,6621,4,13,5,11,45,40,5,44
Adelaide Utd,6621,5,11,6,11,37,40,-3,39
Brisbane,6621,6,10,5,13,33,42,-9,35
Western Sydn,6621,7,8,9,10,38,47,-9,33
Perth Glory,6621,8,10,2,15,37,50,-13,32
Wellington P,6621,9,5,6,16,31,55,-24,21
CC Mariners,6621,10,4,8,15,28,49,-21,20
Sydney FC,6622,1,20,5,3,64,22,42,65
N'castle Jet,6622,2,16,5,7,61,39,22,53
Melbourne C,6622,3,14,4,11,45,37,8,46
Melbourne V,6622,4,13,6,10,45,38,7,45
Adelaide Utd,6622,5,11,6,11,37,40,-3,39
Brisbane,6622,6,10,5,13,33,42,-9,35
Western Sydn,6622,7,8,9,10,38,47,-9,33
Perth Glory,6622,8,10,2,15,37,50,-13,32
Wellington P,6622,9,5,6,16,31,55,-24,21
CC Mariners,6622,10,4,8,15,28,49,-21,20
Sydney FC,6623,1,20,4,4,66,25,41,64
N'castle Jet,6623,2,15,6,7,58,38,20,51
Melbourne C,6623,3,14,5,10,44,34,10,47
Melbourne V,6623,4,14,5,10,48,40,8,47
Adelaide Utd,6623,5,11,6,11,37,40,-3,39
Brisbane,6623,6,10,5,13,33,42,-9,35
Western Sydn,6623,7,8,9,10,38,47,-9,33
Perth Glory,6623,8,10,2,15,37,50,-13,32
Wellington P,6623,9,5,6,16,31,55,-24,21
CC Mariners,6623,10,4,8,15,28,49,-21,20
Sydney FC,6624,1,21,4,3,65,22,43,67
N'castle Jet,6624,2,16,5,7,59,38,21,53
Melbourne C,6624,3,14,4,11,44,35,9,46
Melbourne V,6624,4,13,5,11,45,39,6,44
Adelaide Utd,6624,5,11,6,11,37,40,-3,39
Brisbane,6624,6,10,5,13,33,42,-9,35
Western Sydn,6624,7,8,9,10,38,47,-9,33
Perth Glory,6624,8,10,2,15,37,50,-13,32
Wellington P,6624,9,5,6,16,31,55,-24,21
CC Mariners,6624,10,4,8,15,28,49,-21,20
Sydney FC,6625,1,21,4,3,66,23,43,67
N'castle Jet,6625,2,16,5,7,60,38,22,53
Melbourne C,6625,3,14,4,11,44,36,8,46
Melbourne V,6625,4,13,5,11,46,40,6,44
Adelaide Utd,6625,5,11,6,11,37,40,-3,39
Brisbane,6625,6,10,5,13,33,42,-9,35
Western Sydn,6625,7,8,9,10,38,47,-9,33
Perth Glory,6625,8,10,2,15,37,50,-13,32
Wellington P,6625,9,5,6,16,31,55,-24,21
CC Mariners,6625,10,4,8,15,28,49,-21,20
Sydney FC,6626,1,21,4,3,67,23,44,67
N'castle Jet,6626,2,15,6,7,58,38,20,51
Melbourne C,6626,3,14,5,10,44,34,10,47
Melbourne V,6626,4,13,5,11,46,41,5,44
Adelaide Utd,6626,5,11,6,11,37,40,-3,39
Brisbane,6626,6,10,5,13,33,42,-9,35
Western Sydn,6626,7,8,9,10,38,47,-9,33
Perth Glory,6626,8,10,2,15,37,50,-13,32
Wellington P,6626,9,5,6,16,31,55,-24,21
CC Mariners,6626,10,4,8,15,28,49,-21,20
Sydney FC,6627,1,21,4,3,67,23,44,67
N'castle Jet,6627,2,16,5,7,59,37,22,53
Melbourne C,6627,3,14,4,11,43,35,8,46
Melbourne V,6627,4,13,5,11,46,41,5,44
Adelaide Utd,6627,5,11,6,11,37,40,-3,39
Brisbane,6627,6,10,5,13,33,42,-9,35
Western Sydn,6627,7,8,9,10,38,47,-9,33
Perth Glory,6627,8,10,2,15,37,50,-13,32
Wellington P,6627,9,5,6,16,31,55,-24,21
CC Mariners,6627,10,4,8,15,28,49,-21,20
Sydney FC,6628,1,20,5,3,65,23,42,65
N'castle Jet,6628,2,16,5,7,61,37,24,53
Melbourne C,6628,3,14,4,11,43,37,6,46
Melbourne V,6628,4,13,6,10,46,39,7,45
Adelaide Utd,6628,5,11,6,11,37,40,-3,39
Brisbane,6628,6,10,5,13,33,42,-9,35
Western Sydn,6628,7,8,9,10,38,47,-9,33
Perth Glory,6628,8,10,2,15,37,50,-13,32
Wellington P,6628,9,5,6,16,31,55,-24,21
CC Mariners,6628,10,4,8,15,28,49,-21,20
Sydney FC,6629,1,21,4,3,66,22,44,67
N'castle Jet,6629,2,15,6,7,60,40,20,51
Melbourne C,6629,3,14,5,10,46,36,10,47
Melbourne V,6629,4,13,5,11,45,40,5,44
Adelaide Utd,6629,5,11,6,11,37,40,-3,39
Brisbane,6629,6,10,5,13,33,42,-9,35
Western Sydn,6629,7,8,9,10,38,47,-9,33
Perth Glory,6629,8,10,2,15,37,50,-13,32
Wellington P,6629,9,5,6,16,31,55,-24,21
CC Mariners,6629,10,4,8,15,28,49,-21,20
Sydney FC,6630,1,20,5,3,64,22,42,65
N'castle Jet,6630,2,15,5,8,57,39,18,50
Melbourne C,6630,3,15,4,10,45,33,12,49
Melbourne V,6630,4,13,6,10,45,38,7,45
Adelaide Utd,6630,5,11,6,11,37,40,-3,39
Brisbane,6630,6,10,5,13,33,42,-9,35
Western Sydn,6630,7,8,9,10,38,47,-9,33
Perth Glory,6630,8,10,2,15,37,50,-13,32
Wellington P,6630,9,5,6,16,31,55,-24,21
CC Mariners,6630,10,4,8,15,28,49,-21,20
Sydney FC,6631,1,21,4,3,67,22,45,67
N'castle Jet,6631,2,16,5,7,60,37,23,53
Melbourne C,6631,3,14,4,11,43,36,7,46
Melbourne V,6631,4,13,5,11,45,41,4,44
Adelaide Utd,6631,5,11,6,11,37,40,-3,39
Brisbane,6631,6,10,5,13,33,42,-9,35
Western Sydn,6631,7,8,9,10,38,47,-9,33
Perth Glory,6631,8,10,2,15,37,50,-13,32
Wellington P,6631,9,5,6,16,31,55,-24,21
CC Mariners,6631,10,4,8,15,28,49,-21,20
Sydney FC,6632,1,20,4,4,64,23,41,64
N'castle Jet,6632,2,15,6,7,59,39,20,51
Melbourne C,6632,3,14,5,10,45,35,10,47
Melbourne V,6632,4,14,5,10,46,38,8,47
Adelaide Utd,6632,5,11,6,11,37,40,-3,39
Brisbane,6632,6,10,5,13,33,42,-9,35
Western Sydn,6632,7,8,9,10,38,47,-9,33
Perth Glory,6632,8,10,2,15,37,50,-13,32
Wellington P,6632,9,5,6,16,31,55,-24,21
CC Mariners,6632,10,4,8,15,28,49,-21,20
Sydney FC,6633,1,20,4,4,65,25,40,64
N'castle Jet,6633,2,16,5,7,59,38,21,53
Melbourne V,6633,3,14,5,10,48,39,9,47
Melbourne C,6633,4,14,4,11,44,35,9,46
Adelaide Utd,6633,5,11,6,11,37,40,-3,39
Brisbane,6633,6,10,5,13,33,42,-9,35
Western Sydn,6633,7,8,9,10,38,47,-9,33
Perth Glory,6633,8,10,2,15,37,50,-13,32
Wellington P,6633,9,5,6,16,31,55,-24,21
CC Mariners,6633,10,4,8,15,28,49,-21,20
Sydney FC,6634,1,20,4,4,65,25,40,64
N'castle Jet,6634,2,15,6,7,59,39,20,51
Melbourne C,6634,3,14,5,10,45,35,10,47
Melbourne V,6634,4,14,5,10,48,39,9,47
Adelaide Utd,6634,5,11,6,11,37,40,-3,39
Brisbane,6634,6,10,5,13,33,42,-9,35
Western Sydn,6634,7,8,9,10,38,47,-9,33
Perth Glory,6634,8,10,2,15,37,50,-13,32
Wellington P,6634,9,5,6,16,31,55,-24,21
CC Mariners,6634,10,4,8,15,28,49,-21,20
Sydney FC,6635,1,20,5,3,65,23,42,65
N'castle Jet,6635,2,15,6,7,59,39,20,51
Melbourne C,6635,3,14,5,10,45,35,10,47
Melbourne V,6635,4,13,6,10,46,39,7,45
Adelaide Utd,6635,5,11,6,11,37,40,-3,39
Brisbane,6635,6,10,5,13,33,42,-9,35
Western Sydn,6635,7,8,9,10,38,47,-9,33
Perth Glory,6635,8,10,2,15,37,50,-13,32
Wellington P,6635,9,5,6,16,31,55,-24,21
CC Mariners,6635,10,4,8,15,28,49,-21,20
Sydney FC,6636,1,20,5,3,67,25,42,65
N'castle Jet,6636,2,15,6,7,58,38,20,51
Melbourne C,6636,3,14,5,10,44,34,10,47
Melbourne V,6636,4,13,6,10,48,41,7,45
Adelaide Utd,6636,5,11,6,11,37,40,-3,39
Brisbane,6636,6,10,5,13,33,42,-9,35
Western Sydn,6636,7,8,9,10,38,47,-9,33
Perth Glory,6636,8,10,2,15,37,50,-13,32
Wellington P,6636,9,5,6,16,31,55,-24,21
CC Mariners,6636,10,4,8,15,28,49,-21,20
Sydney FC,6637,1,20,5,3,67,25,42,65
N'castle Jet,6637,2,16,5,7,58,37,21,53
Melbourne C,6637,3,14,4,11,43,34,9,46
Melbourne V,6637,4,13,6,10,48,41,7,45
Adelaide Utd,6637,5,11,6,11,37,40,-3,39
Brisbane,6637,6,10,5,13,33,42,-9,35
Western Sydn,6637,7,8,9,10,38,47,-9,33
Perth Glory,6637,8,10,2,15,37,50,-13,32
Wellington P,6637,9,5,6,16,31,55,-24,21
CC Mariners,6637,10,4,8,15,28,49,-21,20
Sydney FC,6638,1,21,4,3,67,23,44,67
N'castle Jet,6638,2,16,5,7,59,38,21,53
Melbourne C,6638,3,14,4,11,44,35,9,46
Melbourne V,6638,4,13,5,11,46,41,5,44
Adelaide Utd,6638,5,11,6,11,37,40,-3,39
Brisbane,6638,6,10,5,13,33,42,-9,35
Western Sydn,6638,7,8,9,10,38,47,-9,33
Perth Glory,6638,8,10,2,15,37,50,-13,32
Wellington P,6638,9,5,6,16,31,55,-24,21
CC Mariners,6638,10,4,8,15,28,49,-21,20
Sydney FC,6639,1,21,4,3,67,22,45,67
N'castle Jet,6639,2,15,5,8,57,39,18,50
Melbourne C,6639,3,15,4,10,45,33,12,49
Melbourne V,6639,4,13,5,11,45,41,4,44
Adelaide Utd,6639,5,11,6,11,37,40,-3,39
Brisbane,6639,6,10,5,13,33,42,-9,35
Western Sydn,6639,7,8,9,10,38,47,-9,33
Perth Glory,6639,8,10,2,15,37,50,-13,32
Wellington P,6639,9,5,6,16,31,55,-24,21
CC Mariners,6639,10,4,8,15,28,49,-21,20
Sydney FC,6640,1,20,5,3,65,23,42,65
N'castle Jet,6640,2,15,5,8,59,40,19,50
Melbourne C,6640,3,15,4,10,46,35,11,49
Melbourne V,6640,4,13,6,10,46,39,7,45
Adelaide Utd,6640,5,11,6,11,37,40,-3,39
Brisbane,6640,6,10,5,13,33,42,-9,35
Western Sydn,6640,7,8,9,10,38,47,-9,33
Perth Glory,6640,8,10,2,15,37,50,-13,32
Wellington P,6640,9,5,6,16,31,55,-24,21
CC Mariners,6640,10,4,8,15,28,49,-21,20
Sydney FC,6641,1,21,4,3,66,23,43,67
N'castle Jet,6641,2,15,5,8,58,39,19,50
Melbourne C,6641,3,15,4,10,45,34,11,49
Melbourne V,6641,4,13,5,11,46,40,6,44
Adelaide Utd,6641,5,11,6,11,37,40,-3,39
Brisbane,6641,6,10,5,13,33,42,-9,35
Western Sydn,6641,7,8,9,10,38,47,-9,33
Perth Glory,6641,8,10,2,15,37,50,-13,32
Wellington P,6641,9,5,6,16,31,55,-24,21
CC Mariners,6641,10,4,8,15,28,49,-21,20
Sydney FC,6642,1,21,4,3,68,23,45,67
N'castle Jet,6642,2,16,5,7,60,39,21,53
Melbourne C,6642,3,14,4,11,45,36,9,46
Melbourne V,6642,4,13,5,11,46,42,4,44
Adelaide Utd,6642,5,11,6,11,37,40,-3,39
Brisbane,6642,6,10,5,13,33,42,-9,35
Western Sydn,6642,7,8,9,10,38,47,-9,33
Perth Glory,6642,8,10,2,15,37,50,-13,32
Wellington P,6642,9,5,6,16,31,55,-24,21
CC Mariners,6642,10,4,8,15,28,49,-21,20
Sydney FC,6643,1,20,4,4,64,25,39,64
N'castle Jet,6643,2,16,5,7,61,38,23,53
Melbourne V,6643,3,14,5,10,48,38,10,47
Melbourne C,6643,4,14,4,11,44,37,7,46
Adelaide Utd,6643,5,11,6,11,37,40,-3,39
Brisbane,6643,6,10,5,13,33,42,-9,35
Western Sydn,6643,7,8,9,10,38,47,-9,33
Perth Glory,6643,8,10,2,15,37,50,-13,32
Wellington P,6643,9,5,6,16,31,55,-24,21
CC Mariners,6643,10,4,8,15,28,49,-21,20
Sydney FC,6644,1,21,4,3,68,22,46,67
N'castle Jet,6644,2,15,6,7,58,38,20,51
Melbourne C,6644,3,14,5,10,44,34,10,47
Melbourne V,6644,4,13,5,11,45,42,3,44
Adelaide Utd,6644,5,11,6,11,37,40,-3,39
Brisbane,6644,6,10,5,13,33,42,-9,35
Western Sydn,6644,7,8,9,10,38,47,-9,33
Perth Glory,6644,8,10,2,15,37,50,-13,32
Wellington P,6644,9,5,6,16,31,55,-24,21
CC Mariners,6644,10,4,8,15,28,49,-21,20
Sydney FC,6645,1,20,4,4,65,24,41,64
N'castle Jet,6645,2,16,5,7,65,38,27,53
Melbourne V,6645,3,14,5,10,47,39,8,47
Melbourne C,6645,4,14,4,11,44,41,3,46
Adelaide Utd,6645,5,11,6,11,37,40,-3,39
Brisbane,6645,6,10,5,13,33,42,-9,35
Western Sydn,6645,7,8,9,10,38,47,-9,33
Perth Glory,6645,8,10,2,15,37,50,-13,32
Wellington P,6645,9,5,6,16,31,55,-24,21
CC Mariners,6645,10,4,8,15,28,49,-21,20
Sydney FC,6646,1,20,5,3,65,23,42,65
N'castle Jet,6646,2,15,6,7,59,39,20,51
Melbourne C,6646,3,14,5,10,45,35,10,47
Melbourne V,6646,4,13,6,10,46,39,7,45
Adelaide Utd,6646,5,11,6,11,37,40,-3,39
Brisbane,6646,6,10,5,13,33,42,-9,35
Western Sydn,6646,7,8,9,10,38,47,-9,33
Perth Glory,6646,8,10,2,15,37,50,-13,32
Wellington P,6646,9,5,6,16,31,55,-24,21
CC Mariners,6646,10,4,8,15,28,49,-21,20
Sydney FC,6647,1,21,4,3,67,24,43,67
N'castle Jet,6647,2,15,6,7,58,38,20,51
Melbourne C,6647,3,14,5,10,44,34,10,47
Melbourne V,6647,4,13,5,11,47,41,6,44
Adelaide Utd,6647,5,11,6,11,37,40,-3,39
Brisbane,6647,6,10,5,13,33,42,-9,35
Western Sydn,6647,7,8,9,10,38,47,-9,33
Perth Glory,6647,8,10,2,15,37,50,-13,32
Wellington P,6647,9,5,6,16,31,55,-24,21
CC Mariners,6647,10,4,8,15,28,49,-21,20
Sydney FC,6648,1,21,4,3,68,22,46,67
N'castle Jet,6648,2,16,5,7,60,37,23,53
Melbourne C,6648,3,14,4,11,43,36,7,46
Melbourne V,6648,4,13,5,11,45,42,3,44
Adelaide Utd,6648,5,11,6,11,37,40,-3,39
Brisbane,6648,6,10,5,13,33,42,-9,35
Western Sydn,6648,7,8,9,10,38,47,-9,33
Perth Glory,6648,8,10,2,15,37,50,-13,32
Wellington P,6648,9,5,6,16,31,55,-24,21
CC Mariners,6648,10,4,8,15,28,49,-21,20
Sydney FC,6649,1,21,4,3,68,23,45,67
N'castle Jet,6649,2,16,5,7,60,38,22,53
Melbourne C,6649,3,14,4,11,44,36,8,46
Melbourne V,6649,4,13,5,11,46,42,4,44
Adelaide Utd,6649,5,11,6,11,37,40,-3,39
Brisbane,6649,6,10,5,13,33,42,-9,35
Western Sydn,6649,7,8,9,10,38,47,-9,33
Perth Glory,6649,8,10,2,15,37,50,-13,32
Wellington P,6649,9,5,6,16,31,55,-24,21
CC Mariners,6649,10,4,8,15,28,49,-21,20
Sydney FC,6650,1,21,4,3,65,22,43,67
N'castle Jet,6650,2,15,6,7,57,37,20,51
Melbourne C,6650,3,14,5,10,43,33,10,47
Melbourne V,6650,4,13,5,11,45,39,6,44
Adelaide Utd,6650,5,11,6,11,37,40,-3,39
Brisbane,6650,6,10,5,13,33,42,-9,35
Western Sydn,6650,7,8,9,10,38,47,-9,33
Perth Glory,6650,8,10,2,15,37,50,-13,32
Wellington P,6650,9,5,6,16,31,55,-24,21
CC Mariners,6650,10,4,8,15,28,49,-21,20
Sydney FC,6651,1,21,4,3,66,22,44,67
N'castle Jet,6651,2,15,6,7,60,40,20,51
Melbourne C,6651,3,14,5,10,46,36,10,47
Melbourne V,6651,4,13,5,11,45,40,5,44
Adelaide Utd,6651,5,11,6,11,37,40,-3,39
Brisbane,6651,6,10,5,13,33,42,-9,35
Western Sydn,6651,7,8,9,10,38,47,-9,33
Perth Glory,6651,8,10,2,15,37,50,-13,32
Wellington P,6651,9,5,6,16,31,55,-24,21
CC Mariners,6651,10,4,8,15,28,49,-21,20
Sydney FC,6652,1,20,5,3,64,22,42,65
N'castle Jet,6652,2,16,5,7,60,39,21,53
Melbourne C,6652,3,14,4,11,45,36,9,46
Melbourne V,6652,4,13,6,10,45,38,7,45
Adelaide Utd,6652,5,11,6,11,37,40,-3,39
Brisbane,6652,6,10,5,13,33,42,-9,35
Western Sydn,6652,7,8,9,10,38,47,-9,33
Perth Glory,6652,8,10,2,15,37,50,-13,32
Wellington P,6652,9,5,6,16,31,55,-24,21
CC Mariners,6652,10,4,8,15,28,49,-21,20
Sydney FC,6653,1,21,4,3,66,22,44,67
N'castle Jet,6653,2,16,5,7,58,37,21,53
Melbourne C,6653,3,14,4,11,43,34,9,46
Melbourne V,6653,4,13,5,11,45,40,5,44
Adelaide Utd,6653,5,11,6,11,37,40,-3,39
Brisbane,6653,6,10,5,13,33,42,-9,35
Western Sydn,6653,7,8,9,10,38,47,-9,33
Perth Glory,6653,8,10,2,15,37,50,-13,32
Wellington P,6653,9,5,6,16,31,55,-24,21
CC Mariners,6653,10,4,8,15,28,49,-21,20
Sydney FC,6654,1,21,4,3,69,23,46,67
N'castle Jet,6654,2,16,5,7,60,37,23,53
Melbourne C,6654,3,14,4,11,43,36,7,46
Melbourne V,6654,4,13,5,11,46,43,3,44
Adelaide Utd,6654,5,11,6,11,37,40,-3,39
Brisbane,6654,6,10,5,13,33,42,-9,35
Western Sydn,6654,7,8,9,10,38,47,-9,33
Perth Glory,6654,8,10,2,15,37,50,-13,32
Wellington P,6654,9,5,6,16,31,55,-24,21
CC Mariners,6654,10,4,8,15,28,49,-21,20
Sydney FC,6655,1,21,4,3,66,23,43,67
N'castle Jet,6655,2,16,5,7,60,38,22,53
Melbourne C,6655,3,14,4,11,44,36,8,46
Melbourne V,6655,4,13,5,11,46,40,6,44
Adelaide Utd,6655,5,11,6,11,37,40,-3,39
Brisbane,6655,6,10,5,13,33,42,-9,35
Western Sydn,6655,7,8,9,10,38,47,-9,33
Perth Glory,6655,8,10,2,15,37,50,-13,32
Wellington P,6655,9,5,6,16,31,55,-24,21
CC Mariners,6655,10,4,8,15,28,49,-21,20
Sydney FC,6656,1,21,4,3,66,22,44,67
N'castle Jet,6656,2,15,5,8,57,38,19,50
Melbourne C,6656,3,15,4,10,44,33,11,49
Melbourne V,6656,4,13,5,11,45,40,5,44
Adelaide Utd,6656,5,11,6,11,37,40,-3,39
Brisbane,6656,6,10,5,13,33,42,-9,35
Western Sydn,6656,7,8,9,10,38,47,-9,33
Perth Glory,6656,8,10,2,15,37,50,-13,32
Wellington P,6656,9,5,6,16,31,55,-24,21
CC Mariners,6656,10,4,8,15,28,49,-21,20
Sydney FC,6657,1,21,4,3,66,23,43,67
N'castle Jet,6657,2,15,6,7,57,37,20,51
Melbourne C,6657,3,14,5,10,43,33,10,47
Melbourne V,6657,4,13,5,11,46,40,6,44
Adelaide Utd,6657,5,11,6,11,37,40,-3,39
Brisbane,6657,6,10,5,13,33,42,-9,35
Western Sydn,6657,7,8,9,10,38,47,-9,33
Perth Glory,6657,8,10,2,15,37,50,-13,32
Wellington P,6657,9,5,6,16,31,55,-24,21
CC Mariners,6657,10,4,8,15,28,49,-21,20
Sydney FC,6658,1,20,5,3,68,26,42,65
N'castle Jet,6658,2,16,5,7,60,37,23,53
Melbourne C,6658,3,14,4,11,43,36,7,46
Melbourne V,6658,4,13,6,10,49,42,7,45
Adelaide Utd,6658,5,11,6,11,37,40,-3,39
Brisbane,6658,6,10,5,13,33,42,-9,35
Western Sydn,6658,7,8,9,10,38,47,-9,33
Perth Glory,6658,8,10,2,15,37,50,-13,32
Wellington P,6658,9,5,6,16,31,55,-24,21
CC Mariners,6658,10,4,8,15,28,49,-21,20
Sydney FC,6659,1,20,4,4,65,24,41,64
N'castle Jet,6659,2,16,5,7,59,37,22,53
Melbourne V,6659,3,14,5,10,47,39,8,47
Melbourne C,6659,4,14,4,11,43,35,8,46
Adelaide Utd,6659,5,11,6,11,37,40,-3,39
Brisbane,6659,6,10,5,13,33,42,-9,35
Western Sydn,6659,7,8,9,10,38,47,-9,33
Perth Glory,6659,8,10,2,15,37,50,-13,32
Wellington P,6659,9,5,6,16,31,55,-24,21
CC Mariners,6659,10,4,8,15,28,49,-21,20
Sydney FC,6660,1,21,4,3,68,24,44,67
N'castle Jet,6660,2,15,6,7,60,40,20,51
Melbourne C,6660,3,14,5,10,46,36,10,47
Melbourne V,6660,4,13,5,11,47,42,5,44
Adelaide Utd,6660,5,11,6,11,37,40,-3,39
Brisbane,6660,6,10,5,13,33,42,-9,35
Western Sydn,6660,7,8,9,10,38,47,-9,33
Perth Glory,6660,8,10,2,15,37,50,-13,32
Wellington P,6660,9,5,6,16,31,55,-24,21
CC Mariners,6660,10,4,8,15,28,49,-21,20
Sydney FC,6661,1,21,4,3,65,22,43,67
N'castle Jet,6661,2,16,5,7,59,37,22,53
Melbourne C,6661,3,14,4,11,43,35,8,46
Melbourne V,6661,4,13,5,11,45,39,6,44
Adelaide Utd,6661,5,11,6,11,37,40,-3,39
Brisbane,6661,6,10,5,13,33,42,-9,35
Western Sydn,6661,7,8,9,10,38,47,-9,33
Perth Glory,6661,8,10,2,15,37,50,-13,32
Wellington P,6661,9,5,6,16,31,55,-24,21
CC Mariners,6661,10,4,8,15,28,49,-21,20
Sydney FC,6662,1,21,4,3,66,23,43,67
N'castle Jet,6662,2,15,5,8,58,41,17,50
Melbourne C,6662,3,15,4,10,47,34,13,49
Melbourne V,6662,4,13,5,11,46,40,6,44
Adelaide Utd,6662,5,11,6,11,37,40,-3,39
Brisbane,6662,6,10,5,13,33,42,-9,35
Western Sydn,6662,7,8,9,10,38,47,-9,33
Perth Glory,6662,8,10,2,15,37,50,-13,32
Wellington P,6662,9,5,6,16,31,55,-24,21
CC Mariners,6662,10,4,8,15,28,49,-21,20
Sydney FC,6663,1,20,5,3,64,22,42,65
N'castle Jet,6663,2,16,5,7,61,38,23,53
Melbourne C,6663,3,14,4,11,44,37,7,46
Melbourne V,6663,4,13,6,10,45,38,7,45
Adelaide Utd,6663,5,11,6,11,37,40,-3,39
Brisbane,6663,6,10,5,13,33,42,-9,35
Western Sydn,6663,7,8,9,10,38,47,-9,33
Perth Glory,6663,8,10,2,15,37,50,-13,32
Wellington P,6663,9,5,6,16,31,55,-24,21
CC Mariners,6663,10,4,8,15,28,49,-21,20
Sydney FC,6664,1,21,4,3,67,22,45,67
N'castle Jet,6664,2,16,5,7,58,37,21,53
Melbourne C,6664,3,14,4,11,43,34,9,46
Melbourne V,6664,4,13,5,11,45,41,4,44
Adelaide Utd,6664,5,11,6,11,37,40,-3,39
Brisbane,6664,6,10,5,13,33,42,-9,35
Western Sydn,6664,7,8,9,10,38,47,-9,33
Perth Glory,6664,8,10,2,15,37,50,-13,32
Wellington P,6664,9,5,6,16,31,55,-24,21
CC Mariners,6664,10,4,8,15,28,49,-21,20
Sydney FC,6665,1,20,4,4,64,23,41,64
N'castle Jet,6665,2,16,5,7,60,39,21,53
Melbourne V,6665,3,14,5,10,46,38,8,47
Melbourne C,6665,4,14,4,11,45,36,9,46
Adelaide Utd,6665,5,11,6,11,37,40,-3,39
Brisbane,6665,6,10,5,13,33,42,-9,35
Western Sydn,6665,7,8,9,10,38,47,-9,33
Perth Glory,6665,8,10,2,15,37,50,-13,32
Wellington P,6665,9,5,6,16,31,55,-24,21
CC Mariners,6665,10,4,8,15,28,49,-21,20
Sydney FC,6666,1,21,4,3,66,22,44,67
N'castle Jet,6666,2,15,5,8,58,39,19,50
Melbourne C,6666,3,15,4,10,45,34,11,49
Melbourne V,6666,4,13,5,11,45,40,5,44
Adelaide Utd,6666,5,11,6,11,37,40,-3,39
Brisbane,6666,6,10,5,13,33,42,-9,35
Western Sydn,6666,7,8,9,10,38,47,-9,33
Perth Glory,6666,8,10,2,15,37,50,-13,32
Wellington P,6666,9,5,6,16,31,55,-24,21
CC Mariners,6666,10,4,8,15,28,49,-21,20
Sydney FC,6667,1,20,4,4,67,26,41,64
N'castle Jet,6667,2,15,5,8,58,39,19,50
Melbourne C,6667,3,15,4,10,45,34,11,49
Melbourne V,6667,4,14,5,10,49,41,8,47
Adelaide Utd,6667,5,11,6,11,37,40,-3,39
Brisbane,6667,6,10,5,13,33,42,-9,35
Western Sydn,6667,7,8,9,10,38,47,-9,33
Perth Glory,6667,8,10,2,15,37,50,-13,32
Wellington P,6667,9,5,6,16,31,55,-24,21
CC Mariners,6667,10,4,8,15,28,49,-21,20
Sydney FC,6668,1,20,4,4,65,24,41,64
N'castle Jet,6668,2,15,5,8,59,40,19,50
Melbourne C,6668,3,15,4,10,46,35,11,49
Melbourne V,6668,4,14,5,10,47,39,8,47
Adelaide Utd,6668,5,11,6,11,37,40,-3,39
Brisbane,6668,6,10,5,13,33,42,-9,35
Western Sydn,6668,7,8,9,10,38,47,-9,33
Perth Glory,6668,8,10,2,15,37,50,-13,32
Wellington P,6668,9,5,6,16,31,55,-24,21
CC Mariners,6668,10,4,8,15,28,49,-21,20
Sydney FC,6669,1,21,4,3,66,22,44,67
N'castle Jet,6669,2,16,5,7,60,37,23,53
Melbourne C,6669,3,14,4,11,43,36,7,46
Melbourne V,6669,4,13,5,11,45,40,5,44
Adelaide Utd,6669,5,11,6,11,37,40,-3,39
Brisbane,6669,6,10,5,13,33,42,-9,35
Western Sydn,6669,7,8,9,10,38,47,-9,33
Perth Glory,6669,8,10,2,15,37,50,-13,32
Wellington P,6669,9,5,6,16,31,55,-24,21
CC Mariners,6669,10,4,8,15,28,49,-21,20
Sydney FC,6670,1,21,4,3,67,22,45,67
N'castle Jet,6670,2,16,5,7,59,37,22,53
Melbourne C,6670,3,14,4,11,43,35,8,46
Melbourne V,6670,4,13,5,11,45,41,4,44
Adelaide Utd,6670,5,11,6,11,37,40,-3,39
Brisbane,6670,6,10,5,13,33,42,-9,35
Western Sydn,6670,7,8,9,10,38,47,-9,33
Perth Glory,6670,8,10,2,15,37,50,-13,32
Wellington P,6670,9,5,6,16,31,55,-24,21
CC Mariners,6670,10,4,8,15,28,49,-21,20
Sydney FC,6671,1,20,4,4,65,25,40,64
N'castle Jet,6671,2,15,6,7,58,38,20,51
Melbourne C,6671,3,14,5,10,44,34,10,47
Melbourne V,6671,4,14,5,10,48,39,9,47
Adelaide Utd,6671,5,11,6,11,37,40,-3,39
Brisbane,6671,6,10,5,13,33,42,-9,35
Western Sydn,6671,7,8,9,10,38,47,-9,33
Perth Glory,6671,8,10,2,15,37,50,-13,32
Wellington P,6671,9,5,6,16,31,55,-24,21
CC Mariners,6671,10,4,8,15,28,49,-21,20
Sydney FC,6672,1,20,5,3,65,23,42,65
N'castle Jet,6672,2,16,5,7,59,38,21,53
Melbourne C,6672,3,14,4,11,44,35,9,46
Melbourne V,6672,4,13,6,10,46,39,7,45
Adelaide Utd,6672,5,11,6,11,37,40,-3,39
Brisbane,6672,6,10,5,13,33,42,-9,35
Western Sydn,6672,7,8,9,10,38,47,-9,33
Perth Glory,6672,8,10,2,15,37,50,-13,32
Wellington P,6672,9,5,6,16,31,55,-24,21
CC Mariners,6672,10,4,8,15,28,49,-21,20
Sydney FC,6673,1,21,4,3,66,23,43,67
N'castle Jet,6673,2,16,5,7,58,37,21,53
Melbourne C,6673,3,14,4,11,43,34,9,46
Melbourne V,6673,4,13,5,11,46,40,6,44
Adelaide Utd,6673,5,11,6,11,37,40,-3,39
Brisbane,6673,6,10,5,13,33,42,-9,35
Western Sydn,6673,7,8,9,10,38,47,-9,33
Perth Glory,6673,8,10,2,15,37,50,-13,32
Wellington P,6673,9,5,6,16,31,55,-24,21
CC Mariners,6673,10,4,8,15,28,49,-21,20
Sydney FC,6674,1,21,4,3,67,24,43,67
N'castle Jet,6674,2,16,5,7,59,38,21,53
Melbourne C,6674,3,14,4,11,44,35,9,46
Melbourne V,6674,4,13,5,11,47,41,6,44
Adelaide Utd,6674,5,11,6,11,37,40,-3,39
Brisbane,6674,6,10,5,13,33,42,-9,35
Western Sydn,6674,7,8,9,10,38,47,-9,33
Perth Glory,6674,8,10,2,15,37,50,-13,32
Wellington P,6674,9,5,6,16,31,55,-24,21
CC Mariners,6674,10,4,8,15,28,49,-21,20
Sydney FC,6675,1,21,4,3,66,22,44,67
N'castle Jet,6675,2,16,5,7,60,37,23,53
Melbourne C,6675,3,14,4,11,43,36,7,46
Melbourne V,6675,4,13,5,11,45,40,5,44
Adelaide Utd,6675,5,11,6,11,37,40,-3,39
Brisbane,6675,6,10,5,13,33,42,-9,35
Western Sydn,6675,7,8,9,10,38,47,-9,33
Perth Glory,6675,8,10,2,15,37,50,-13,32
Wellington P,6675,9,5,6,16,31,55,-24,21
CC Mariners,6675,10,4,8,15,28,49,-21,20
Sydney FC,6676,1,20,5,3,66,24,42,65
N'castle Jet,6676,2,15,5,8,57,39,18,50
Melbourne C,6676,3,15,4,10,45,33,12,49
Melbourne V,6676,4,13,6,10,47,40,7,45
Adelaide Utd,6676,5,11,6,11,37,40,-3,39
Brisbane,6676,6,10,5,13,33,42,-9,35
Western Sydn,6676,7,8,9,10,38,47,-9,33
Perth Glory,6676,8,10,2,15,37,50,-13,32
Wellington P,6676,9,5,6,16,31,55,-24,21
CC Mariners,6676,10,4,8,15,28,49,-21,20
Sydney FC,6677,1,20,5,3,66,24,42,65
N'castle Jet,6677,2,16,5,7,62,38,24,53
Melbourne C,6677,3,14,4,11,44,38,6,46
Melbourne V,6677,4,13,6,10,47,40,7,45
Adelaide Utd,6677,5,11,6,11,37,40,-3,39
Brisbane,6677,6,10,5,13,33,42,-9,35
Western Sydn,6677,7,8,9,10,38,47,-9,33
Perth Glory,6677,8,10,2,15,37,50,-13,32
Wellington P,6677,9,5,6,16,31,55,-24,21
CC Mariners,6677,10,4,8,15,28,49,-21,20
Sydney FC,6678,1,21,4,3,66,23,43,67
N'castle Jet,6678,2,16,5,7,61,39,22,53
Melbourne C,6678,3,14,4,11,45,37,8,46
Melbourne V,6678,4,13,5,11,46,40,6,44
Adelaide Utd,6678,5,11,6,11,37,40,-3,39
Brisbane,6678,6,10,5,13,33,42,-9,35
Western Sydn,6678,7,8,9,10,38,47,-9,33
Perth Glory,6678,8,10,2,15,37,50,-13,32
Wellington P,6678,9,5,6,16,31,55,-24,21
CC Mariners,6678,10,4,8,15,28,49,-21,20
Sydney FC,6679,1,21,4,3,68,23,45,67
N'castle Jet,6679,2,15,5,8,57,38,19,50
Melbourne C,6679,3,15,4,10,44,33,11,49
Melbourne V,6679,4,13,5,11,46,42,4,44
Adelaide Utd,6679,5,11,6,11,37,40,-3,39
Brisbane,6679,6,10,5,13,33,42,-9,35
Western Sydn,6679,7,8,9,10,38,47,-9,33
Perth Glory,6679,8,10,2,15,37,50,-13,32
Wellington P,6679,9,5,6,16,31,55,-24,21
CC Mariners,6679,10,4,8,15,28,49,-21,20
Sydney FC,6680,1,20,5,3,64,22,42,65
N'castle Jet,6680,2,16,5,7,60,39,21,53
Melbourne C,6680,3,14,4,11,45,36,9,46
Melbourne V,6680,4,13,6,10,45,38,7,45
Adelaide Utd,6680,5,11,6,11,37,40,-3,39
Brisbane,6680,6,10,5,13,33,42,-9,35
Western Sydn,6680,7,8,9,10,38,47,-9,33
Perth Glory,6680,8,10,2,15,37,50,-13,32
Wellington P,6680,9,5,6,16,31,55,-24,21
CC Mariners,6680,10,4,8,15,28,49,-21,20
Sydney FC,6681,1,21,4,3,68,23,45,67
N'castle Jet,6681,2,16,5,7,60,38,22,53
Melbourne C,6681,3,14,4,11,44,36,8,46
Melbourne V,6681,4,13,5,11,46,42,4,44
Adelaide Utd,6681,5,11,6,11,37,40,-3,39
Brisbane,6681,6,10,5,13,33,42,-9,35
Western Sydn,6681,7,8,9,10,38,47,-9,33
Perth Glory,6681,8,10,2,15,37,50,-13,32
Wellington P,6681,9,5,6,16,31,55,-24,21
CC Mariners,6681,10,4,8,15,28,49,-21,20
Sydney FC,6682,1,21,4,3,66,22,44,67
N'castle Jet,6682,2,16,5,7,58,37,21,53
Melbourne C,6682,3,14,4,11,43,34,9,46
Melbourne V,6682,4,13,5,11,45,40,5,44
Adelaide Utd,6682,5,11,6,11,37,40,-3,39
Brisbane,6682,6,10,5,13,33,42,-9,35
Western Sydn,6682,7,8,9,10,38,47,-9,33
Perth Glory,6682,8,10,2,15,37,50,-13,32
Wellington P,6682,9,5,6,16,31,55,-24,21
CC Mariners,6682,10,4,8,15,28,49,-21,20
Sydney FC,6683,1,21,4,3,66,22,44,67
N'castle Jet,6683,2,16,5,7,60,38,22,53
Melbourne C,6683,3,14,4,11,44,36,8,46
Melbourne V,6683,4,13,5,11,45,40,5,44
Adelaide Utd,6683,5,11,6,11,37,40,-3,39
Brisbane,6683,6,10,5,13,33,42,-9,35
Western Sydn,6683,7,8,9,10,38,47,-9,33
Perth Glory,6683,8,10,2,15,37,50,-13,32
Wellington P,6683,9,5,6,16,31,55,-24,21
CC Mariners,6683,10,4,8,15,28,49,-21,20
Sydney FC,6684,1,21,4,3,67,23,44,67
N'castle Jet,6684,2,15,6,7,58,38,20,51
Melbourne C,6684,3,14,5,10,44,34,10,47
Melbourne V,6684,4,13,5,11,46,41,5,44
Adelaide Utd,6684,5,11,6,11,37,40,-3,39
Brisbane,6684,6,10,5,13,33,42,-9,35
Western Sydn,6684,7,8,9,10,38,47,-9,33
Perth Glory,6684,8,10,2,15,37,50,-13,32
Wellington P,6684,9,5,6,16,31,55,-24,21
CC Mariners,6684,10,4,8,15,28,49,-21,20
Sydney FC,6685,1,21,4,3,65,22,43,67
N'castle Jet,6685,2,15,6,7,58,38,20,51
Melbourne C,6685,3,14,5,10,44,34,10,47
Melbourne V,6685,4,13,5,11,45,39,6,44
Adelaide Utd,6685,5,11,6,11,37,40,-3,39
Brisbane,6685,6,10,5,13,33,42,-9,35
Western Sydn,6685,7,8,9,10,38,47,-9,33
Perth Glory,6685,8,10,2,15,37,50,-13,32
Wellington P,6685,9,5,6,16,31,55,-24,21
CC Mariners,6685,10,4,8,15,28,49,-21,20
Sydney FC,6686,1,21,4,3,65,22,43,67
N'castle Jet,6686,2,15,5,8,57,40,17,50
Melbourne C,6686,3,15,4,10,46,33,13,49
Melbourne V,6686,4,13,5,11,45,39,6,44
Adelaide Utd,6686,5,11,6,11,37,40,-3,39
Brisbane,6686,6,10,5,13,33,42,-9,35
Western Sydn,6686,7,8,9,10,38,47,-9,33
Perth Glory,6686,8,10,2,15,37,50,-13,32
Wellington P,6686,9,5,6,16,31,55,-24,21
CC Mariners,6686,10,4,8,15,28,49,-21,20
Sydney FC,6687,1,21,4,3,65,22,43,67
N'castle Jet,6687,2,15,6,7,59,39,20,51
Melbourne C,6687,3,14,5,10,45,35,10,47
Melbourne V,6687,4,13,5,11,45,39,6,44
Adelaide Utd,6687,5,11,6,11,37,40,-3,39
Brisbane,6687,6,10,5,13,33,42,-9,35
Western Sydn,6687,7,8,9,10,38,47,-9,33
Perth Glory,6687,8,10,2,15,37,50,-13,32
Wellington P,6687,9,5,6,16,31,55,-24,21
CC Mariners,6687,10,4,8,15,28,49,-21,20
Sydney FC,6688,1,20,5,3,66,24,42,65
N'castle Jet,6688,2,16,5,7,58,37,21,53
Melbourne C,6688,3,14,4,11,43,34,9,46
Melbourne V,6688,4,13,6,10,47,40,7,45
Adelaide Utd,6688,5,11,6,11,37,40,-3,39
Brisbane,6688,6,10,5,13,33,42,-9,35
Western Sydn,6688,7,8,9,10,38,47,-9,33
Perth Glory,6688,8,10,2,15,37,50,-13,32
Wellington P,6688,9,5,6,16,31,55,-24,21
CC Mariners,6688,10,4,8,15,28,49,-21,20
Sydney FC,6689,1,21,4,3,66,22,44,67
N'castle Jet,6689,2,15,5,8,59,40,19,50
Melbourne C,6689,3,15,4,10,46,35,11,49
Melbourne V,6689,4,13,5,11,45,40,5,44
Adelaide Utd,6689,5,11,6,11,37,40,-3,39
Brisbane,6689,6,10,5,13,33,42,-9,35
Western Sydn,6689,7,8,9,10,38,47,-9,33
Perth Glory,6689,8,10,2,15,37,50,-13,32
Wellington P,6689,9,5,6,16,31,55,-24,21
CC Mariners,6689,10,4,8,15,28,49,-21,20
Sydney FC,6690,1,21,4,3,65,22,43,67
N'castle Jet,6690,2,15,6,7,57,37,20,51
Melbourne C,6690,3,14,5,10,43,33,10,47
Melbourne V,6690,4,13,5,11,45,39,6,44
Adelaide Utd,6690,5,11,6,11,37,40,-3,39
Brisbane,6690,6,10,5,13,33,42,-9,35
Western Sydn,6690,7,8,9,10,38,47,-9,33
Perth Glory,6690,8,10,2,15,37,50,-13,32
Wellington P,6690,9,5,6,16,31,55,-24,21
CC Mariners,6690,10,4,8,15,28,49,-21,20
Sydney FC,6691,1,21,4,3,67,24,43,67
N'castle Jet,6691,2,15,6,7,59,39,20,51
Melbourne C,6691,3,14,5,10,45,35,10,47
Melbourne V,6691,4,13,5,11,47,41,6,44
Adelaide Utd,6691,5,11,6,11,37,40,-3,39
Brisbane,6691,6,10,5,13,33,42,-9,35
Western Sydn,6691,7,8,9,10,38,47,-9,33
Perth Glory,6691,8,10,2,15,37,50,-13,32
Wellington P,6691,9,5,6,16,31,55,-24,21
CC Mariners,6691,10,4,8,15,28,49,-21,20
Sydney FC,6692,1,20,5,3,65,23,42,65
N'castle Jet,6692,2,16,5,7,58,37,21,53
Melbourne C,6692,3,14,4,11,43,34,9,46
Melbourne V,6692,4,13,6,10,46,39,7,45
Adelaide Utd,6692,5,11,6,11,37,40,-3,39
Brisbane,6692,6,10,5,13,33,42,-9,35
Western Sydn,6692,7,8,9,10,38,47,-9,33
Perth Glory,6692,8,10,2,15,37,50,-13,32
Wellington P,6692,9,5,6,16,31,55,-24,21
CC Mariners,6692,10,4,8,15,28,49,-21,20
Sydney FC,6693,1,20,5,3,65,23,42,65
N'castle Jet,6693,2,15,6,7,58,38,20,51
Melbourne C,6693,3,14,5,10,44,34,10,47
Melbourne V,6693,4,13,6,10,46,39,7,45
Adelaide Utd,6693,5,11,6,11,37,40,-3,39
Brisbane,6693,6,10,5,13,33,42,-9,35
Western Sydn,6693,7,8,9,10,38,47,-9,33
Perth Glory,6693,8,10,2,15,37,50,-13,32
Wellington P,6693,9,5,6,16,31,55,-24,21
CC Mariners,6693,10,4,8,15,28,49,-21,20
Sydney FC,6694,1,20,5,3,65,23,42,65
N'castle Jet,6694,2,15,6,7,58,38,20,51
Melbourne C,6694,3,14,5,10,44,34,10,47
Melbourne V,6694,4,13,6,10,46,39,7,45
Adelaide Utd,6694,5,11,6,11,37,40,-3,39
Brisbane,6694,6,10,5,13,33,42,-9,35
Western Sydn,6694,7,8,9,10,38,47,-9,33
Perth Glory,6694,8,10,2,15,37,50,-13,32
Wellington P,6694,9,5,6,16,31,55,-24,21
CC Mariners,6694,10,4,8,15,28,49,-21,20
Sydney FC,6695,1,21,4,3,67,22,45,67
N'castle Jet,6695,2,15,6,7,58,38,20,51
Melbourne C,6695,3,14,5,10,44,34,10,47
Melbourne V,6695,4,13,5,11,45,41,4,44
Adelaide Utd,6695,5,11,6,11,37,40,-3,39
Brisbane,6695,6,10,5,13,33,42,-9,35
Western Sydn,6695,7,8,9,10,38,47,-9,33
Perth Glory,6695,8,10,2,15,37,50,-13,32
Wellington P,6695,9,5,6,16,31,55,-24,21
CC Mariners,6695,10,4,8,15,28,49,-21,20
Sydney FC,6696,1,21,4,3,65,22,43,67
N'castle Jet,6696,2,15,5,8,60,41,19,50
Melbourne C,6696,3,15,4,10,47,36,11,49
Melbourne V,6696,4,13,5,11,45,39,6,44
Adelaide Utd,6696,5,11,6,11,37,40,-3,39
Brisbane,6696,6,10,5,13,33,42,-9,35
Western Sydn,6696,7,8,9,10,38,47,-9,33
Perth Glory,6696,8,10,2,15,37,50,-13,32
Wellington P,6696,9,5,6,16,31,55,-24,21
CC Mariners,6696,10,4,8,15,28,49,-21,20
Sydney FC,6697,1,20,5,3,65,23,42,65
N'castle Jet,6697,2,15,5,8,57,38,19,50
Melbourne C,6697,3,15,4,10,44,33,11,49
Melbourne V,6697,4,13,6,10,46,39,7,45
Adelaide Utd,6697,5,11,6,11,37,40,-3,39
Brisbane,6697,6,10,5,13,33,42,-9,35
Western Sydn,6697,7,8,9,10,38,47,-9,33
Perth Glory,6697,8,10,2,15,37,50,-13,32
Wellington P,6697,9,5,6,16,31,55,-24,21
CC Mariners,6697,10,4,8,15,28,49,-21,20
Sydney FC,6698,1,21,4,3,65,22,43,67
N'castle Jet,6698,2,16,5,7,59,38,21,53
Melbourne C,6698,3,14,4,11,44,35,9,46
Melbourne V,6698,4,13,5,11,45,39,6,44
Adelaide Utd,6698,5,11,6,11,37,40,-3,39
Brisbane,6698,6,10,5,13,33,42,-9,35
Western Sydn,6698,7,8,9,10,38,47,-9,33
Perth Glory,6698,8,10,2,15,37,50,-13,32
Wellington P,6698,9,5,6,16,31,55,-24,21
CC Mariners,6698,10,4,8,15,28,49,-21,20
Sydney FC,6699,1,20,4,4,64,27,37,64
N'castle Jet,6699,2,16,5,7,59,38,21,53
Melbourne V,6699,3,14,5,10,50,38,12,47
Melbourne C,6699,4,14,4,11,44,35,9,46
Adelaide Utd,6699,5,11,6,11,37,40,-3,39
Brisbane,6699,6,10,5,13,33,42,-9,35
Western Sydn,6699,7,8,9,10,38,47,-9,33
Perth Glory,6699,8,10,2,15,37,50,-13,32
Wellington P,6699,9,5,6,16,31,55,-24,21
CC Mariners,6699,10,4,8,15,28,49,-21,20
Sydney FC,6700,1,21,4,3,67,22,45,67
N'castle Jet,6700,2,16,5,7,60,37,23,53
Melbourne C,6700,3,14,4,11,43,36,7,46
Melbourne V,6700,4,13,5,11,45,41,4,44
Adelaide Utd,6700,5,11,6,11,37,40,-3,39
Brisbane,6700,6,10,5,13,33,42,-9,35
Western Sydn,6700,7,8,9,10,38,47,-9,33
Perth Glory,6700,8,10,2,15,37,50,-13,32
Wellington P,6700,9,5,6,16,31,55,-24,21
CC Mariners,6700,10,4,8,15,28,49,-21,20
Sydney FC,6701,1,21,4,3,66,23,43,67
N'castle Jet,6701,2,15,6,7,59,39,20,51
Melbourne C,6701,3,14,5,10,45,35,10,47
Melbourne V,6701,4,13,5,11,46,40,6,44
Adelaide Utd,6701,5,11,6,11,37,40,-3,39
Brisbane,6701,6,10,5,13,33,42,-9,35
Western Sydn,6701,7,8,9,10,38,47,-9,33
Perth Glory,6701,8,10,2,15,37,50,-13,32
Wellington P,6701,9,5,6,16,31,55,-24,21
CC Mariners,6701,10,4,8,15,28,49,-21,20
Sydney FC,6702,1,21,4,3,66,23,43,67
N'castle Jet,6702,2,15,6,7,59,39,20,51
Melbourne C,6702,3,14,5,10,45,35,10,47
Melbourne V,6702,4,13,5,11,46,40,6,44
Adelaide Utd,6702,5,11,6,11,37,40,-3,39
Brisbane,6702,6,10,5,13,33,42,-9,35
Western Sydn,6702,7,8,9,10,38,47,-9,33
Perth Glory,6702,8,10,2,15,37,50,-13,32
Wellington P,6702,9,5,6,16,31,55,-24,21
CC Mariners,6702,10,4,8,15,28,49,-21,20
Sydney FC,6703,1,21,4,3,68,23,45,67
N'castle Jet,6703,2,15,5,8,57,38,19,50
Melbourne C,6703,3,15,4,10,44,33,11,49
Melbourne V,6703,4,13,5,11,46,42,4,44
Adelaide Utd,6703,5,11,6,11,37,40,-3,39
Brisbane,6703,6,10,5,13,33,42,-9,35
Western Sydn,6703,7,8,9,10,38,47,-9,33
Perth Glory,6703,8,10,2,15,37,50,-13,32
Wellington P,6703,9,5,6,16,31,55,-24,21
CC Mariners,6703,10,4,8,15,28,49,-21,20
Sydney FC,6704,1,21,4,3,66,22,44,67
N'castle Jet,6704,2,15,5,8,58,39,19,50
Melbourne C,6704,3,15,4,10,45,34,11,49
Melbourne V,6704,4,13,5,11,45,40,5,44
Adelaide Utd,6704,5,11,6,11,37,40,-3,39
Brisbane,6704,6,10,5,13,33,42,-9,35
Western Sydn,6704,7,8,9,10,38,47,-9,33
Perth Glory,6704,8,10,2,15,37,50,-13,32
Wellington P,6704,9,5,6,16,31,55,-24,21
CC Mariners,6704,10,4,8,15,28,49,-21,20
Sydney FC,6705,1,20,4,4,64,23,41,64
N'castle Jet,6705,2,15,6,7,57,37,20,51
Melbourne C,6705,3,14,5,10,43,33,10,47
Melbourne V,6705,4,14,5,10,46,38,8,47
Adelaide Utd,6705,5,11,6,11,37,40,-3,39
Brisbane,6705,6,10,5,13,33,42,-9,35
Western Sydn,6705,7,8,9,10,38,47,-9,33
Perth Glory,6705,8,10,2,15,37,50,-13,32
Wellington P,6705,9,5,6,16,31,55,-24,21
CC Mariners,6705,10,4,8,15,28,49,-21,20
Sydney FC,6706,1,21,4,3,66,22,44,67
N'castle Jet,6706,2,15,5,8,57,38,19,50
Melbourne C,6706,3,15,4,10,44,33,11,49
Melbourne V,6706,4,13,5,11,45,40,5,44
Adelaide Utd,6706,5,11,6,11,37,40,-3,39
Brisbane,6706,6,10,5,13,33,42,-9,35
Western Sydn,6706,7,8,9,10,38,47,-9,33
Perth Glory,6706,8,10,2,15,37,50,-13,32
Wellington P,6706,9,5,6,16,31,55,-24,21
CC Mariners,6706,10,4,8,15,28,49,-21,20
Sydney FC,6707,1,21,4,3,66,22,44,67
N'castle Jet,6707,2,16,5,7,60,38,22,53
Melbourne C,6707,3,14,4,11,44,36,8,46
Melbourne V,6707,4,13,5,11,45,40,5,44
Adelaide Utd,6707,5,11,6,11,37,40,-3,39
Brisbane,6707,6,10,5,13,33,42,-9,35
Western Sydn,6707,7,8,9,10,38,47,-9,33
Perth Glory,6707,8,10,2,15,37,50,-13,32
Wellington P,6707,9,5,6,16,31,55,-24,21
CC Mariners,6707,10,4,8,15,28,49,-21,20
Sydney FC,6708,1,21,4,3,65,22,43,67
N'castle Jet,6708,2,16,5,7,60,38,22,53
Melbourne C,6708,3,14,4,11,44,36,8,46
Melbourne V,6708,4,13,5,11,45,39,6,44
Adelaide Utd,6708,5,11,6,11,37,40,-3,39
Brisbane,6708,6,10,5,13,33,42,-9,35
Western Sydn,6708,7,8,9,10,38,47,-9,33
Perth Glory,6708,8,10,2,15,37,50,-13,32
Wellington P,6708,9,5,6,16,31,55,-24,21
CC Mariners,6708,10,4,8,15,28,49,-21,20
Sydney FC,6709,1,21,4,3,65,22,43,67
N'castle Jet,6709,2,15,6,7,58,38,20,51
Melbourne C,6709,3,14,5,10,44,34,10,47
Melbourne V,6709,4,13,5,11,45,39,6,44
Adelaide Utd,6709,5,11,6,11,37,40,-3,39
Brisbane,6709,6,10,5,13,33,42,-9,35
Western Sydn,6709,7,8,9,10,38,47,-9,33
Perth Glory,6709,8,10,2,15,37,50,-13,32
Wellington P,6709,9,5,6,16,31,55,-24,21
CC Mariners,6709,10,4,8,15,28,49,-21,20
Sydney FC,6710,1,21,4,3,69,22,47,67
N'castle Jet,6710,2,16,5,7,58,37,21,53
Melbourne C,6710,3,14,4,11,43,34,9,46
Melbourne V,6710,4,13,5,11,45,43,2,44
Adelaide Utd,6710,5,11,6,11,37,40,-3,39
Brisbane,6710,6,10,5,13,33,42,-9,35
Western Sydn,6710,7,8,9,10,38,47,-9,33
Perth Glory,6710,8,10,2,15,37,50,-13,32
Wellington P,6710,9,5,6,16,31,55,-24,21
CC Mariners,6710,10,4,8,15,28,49,-21,20
Sydney FC,6711,1,20,5,3,67,25,42,65
N'castle Jet,6711,2,15,6,7,58,38,20,51
Melbourne C,6711,3,14,5,10,44,34,10,47
Melbourne V,6711,4,13,6,10,48,41,7,45
Adelaide Utd,6711,5,11,6,11,37,40,-3,39
Brisbane,6711,6,10,5,13,33,42,-9,35
Western Sydn,6711,7,8,9,10,38,47,-9,33
Perth Glory,6711,8,10,2,15,37,50,-13,32
Wellington P,6711,9,5,6,16,31,55,-24,21
CC Mariners,6711,10,4,8,15,28,49,-21,20
Sydney FC,6712,1,21,4,3,68,25,43,67
N'castle Jet,6712,2,16,5,7,60,37,23,53
Melbourne C,6712,3,14,4,11,43,36,7,46
Melbourne V,6712,4,13,5,11,48,42,6,44
Adelaide Utd,6712,5,11,6,11,37,40,-3,39
Brisbane,6712,6,10,5,13,33,42,-9,35
Western Sydn,6712,7,8,9,10,38,47,-9,33
Perth Glory,6712,8,10,2,15,37,50,-13,32
Wellington P,6712,9,5,6,16,31,55,-24,21
CC Mariners,6712,10,4,8,15,28,49,-21,20
Sydney FC,6713,1,20,5,3,64,22,42,65
N'castle Jet,6713,2,16,5,7,59,37,22,53
Melbourne C,6713,3,14,4,11,43,35,8,46
Melbourne V,6713,4,13,6,10,45,38,7,45
Adelaide Utd,6713,5,11,6,11,37,40,-3,39
Brisbane,6713,6,10,5,13,33,42,-9,35
Western Sydn,6713,7,8,9,10,38,47,-9,33
Perth Glory,6713,8,10,2,15,37,50,-13,32
Wellington P,6713,9,5,6,16,31,55,-24,21
CC Mariners,6713,10,4,8,15,28,49,-21,20
Sydney FC,6714,1,21,4,3,67,22,45,67
N'castle Jet,6714,2,16,5,7,60,37,23,53
Melbourne C,6714,3,14,4,11,43,36,7,46
Melbourne V,6714,4,13,5,11,45,41,4,44
Adelaide Utd,6714,5,11,6,11,37,40,-3,39
Brisbane,6714,6,10,5,13,33,42,-9,35
Western Sydn,6714,7,8,9,10,38,47,-9,33
Perth Glory,6714,8,10,2,15,37,50,-13,32
Wellington P,6714,9,5,6,16,31,55,-24,21
CC Mariners,6714,10,4,8,15,28,49,-21,20
Sydney FC,6715,1,21,4,3,66,22,44,67
N'castle Jet,6715,2,16,5,7,59,37,22,53
Melbourne C,6715,3,14,4,11,43,35,8,46
Melbourne V,6715,4,13,5,11,45,40,5,44
Adelaide Utd,6715,5,11,6,11,37,40,-3,39
Brisbane,6715,6,10,5,13,33,42,-9,35
Western Sydn,6715,7,8,9,10,38,47,-9,33
Perth Glory,6715,8,10,2,15,37,50,-13,32
Wellington P,6715,9,5,6,16,31,55,-24,21
CC Mariners,6715,10,4,8,15,28,49,-21,20
Sydney FC,6716,1,21,4,3,66,23,43,67
N'castle Jet,6716,2,16,5,7,60,37,23,53
Melbourne C,6716,3,14,4,11,43,36,7,46
Melbourne V,6716,4,13,5,11,46,40,6,44
Adelaide Utd,6716,5,11,6,11,37,40,-3,39
Brisbane,6716,6,10,5,13,33,42,-9,35
Western Sydn,6716,7,8,9,10,38,47,-9,33
Perth Glory,6716,8,10,2,15,37,50,-13,32
Wellington P,6716,9,5,6,16,31,55,-24,21
CC Mariners,6716,10,4,8,15,28,49,-21,20
Sydney FC,6717,1,20,4,4,64,23,41,64
N'castle Jet,6717,2,16,5,7,60,39,21,53
Melbourne V,6717,3,14,5,10,46,38,8,47
Melbourne C,6717,4,14,4,11,45,36,9,46
Adelaide Utd,6717,5,11,6,11,37,40,-3,39
Brisbane,6717,6,10,5,13,33,42,-9,35
Western Sydn,6717,7,8,9,10,38,47,-9,33
Perth Glory,6717,8,10,2,15,37,50,-13,32
Wellington P,6717,9,5,6,16,31,55,-24,21
CC Mariners,6717,10,4,8,15,28,49,-21,20
Sydney FC,6718,1,21,4,3,66,22,44,67
N'castle Jet,6718,2,16,5,7,60,39,21,53
Melbourne C,6718,3,14,4,11,45,36,9,46
Melbourne V,6718,4,13,5,11,45,40,5,44
Adelaide Utd,6718,5,11,6,11,37,40,-3,39
Brisbane,6718,6,10,5,13,33,42,-9,35
Western Sydn,6718,7,8,9,10,38,47,-9,33
Perth Glory,6718,8,10,2,15,37,50,-13,32
Wellington P,6718,9,5,6,16,31,55,-24,21
CC Mariners,6718,10,4,8,15,28,49,-21,20
Sydney FC,6719,1,21,4,3,66,22,44,67
N'castle Jet,6719,2,16,5,7,59,38,21,53
Melbourne C,6719,3,14,4,11,44,35,9,46
Melbourne V,6719,4,13,5,11,45,40,5,44
Adelaide Utd,6719,5,11,6,11,37,40,-3,39
Brisbane,6719,6,10,5,13,33,42,-9,35
Western Sydn,6719,7,8,9,10,38,47,-9,33
Perth Glory,6719,8,10,2,15,37,50,-13,32
Wellington P,6719,9,5,6,16,31,55,-24,21
CC Mariners,6719,10,4,8,15,28,49,-21,20
Sydney FC,6720,1,21,4,3,68,22,46,67
N'castle Jet,6720,2,15,5,8,57,39,18,50
Melbourne C,6720,3,15,4,10,45,33,12,49
Melbourne V,6720,4,13,5,11,45,42,3,44
Adelaide Utd,6720,5,11,6,11,37,40,-3,39
Brisbane,6720,6,10,5,13,33,42,-9,35
Western Sydn,6720,7,8,9,10,38,47,-9,33
Perth Glory,6720,8,10,2,15,37,50,-13,32
Wellington P,6720,9,5,6,16,31,55,-24,21
CC Mariners,6720,10,4,8,15,28,49,-21,20
Sydney FC,6721,1,21,4,3,70,25,45,67
N'castle Jet,6721,2,16,5,7,60,37,23,53
Melbourne C,6721,3,14,4,11,43,36,7,46
Melbourne V,6721,4,13,5,11,48,44,4,44
Adelaide Utd,6721,5,11,6,11,37,40,-3,39
Brisbane,6721,6,10,5,13,33,42,-9,35
Western Sydn,6721,7,8,9,10,38,47,-9,33
Perth Glory,6721,8,10,2,15,37,50,-13,32
Wellington P,6721,9,5,6,16,31,55,-24,21
CC Mariners,6721,10,4,8,15,28,49,-21,20
Sydney FC,6722,1,21,4,3,65,22,43,67
N'castle Jet,6722,2,15,6,7,59,39,20,51
Melbourne C,6722,3,14,5,10,45,35,10,47
Melbourne V,6722,4,13,5,11,45,39,6,44
Adelaide Utd,6722,5,11,6,11,37,40,-3,39
Brisbane,6722,6,10,5,13,33,42,-9,35
Western Sydn,6722,7,8,9,10,38,47,-9,33
Perth Glory,6722,8,10,2,15,37,50,-13,32
Wellington P,6722,9,5,6,16,31,55,-24,21
CC Mariners,6722,10,4,8,15,28,49,-21,20
Sydney FC,6723,1,20,5,3,66,24,42,65
N'castle Jet,6723,2,15,5,8,57,40,17,50
Melbourne C,6723,3,15,4,10,46,33,13,49
Melbourne V,6723,4,13,6,10,47,40,7,45
Adelaide Utd,6723,5,11,6,11,37,40,-3,39
Brisbane,6723,6,10,5,13,33,42,-9,35
Western Sydn,6723,7,8,9,10,38,47,-9,33
Perth Glory,6723,8,10,2,15,37,50,-13,32
Wellington P,6723,9,5,6,16,31,55,-24,21
CC Mariners,6723,10,4,8,15,28,49,-21,20
Sydney FC,6724,1,20,4,4,64,23,41,64
N'castle Jet,6724,2,15,6,7,59,39,20,51
Melbourne C,6724,3,14,5,10,45,35,10,47
Melbourne V,6724,4,14,5,10,46,38,8,47
Adelaide Utd,6724,5,11,6,11,37,40,-3,39
Brisbane,6724,6,10,5,13,33,42,-9,35
Western Sydn,6724,7,8,9,10,38,47,-9,33
Perth Glory,6724,8,10,2,15,37,50,-13,32
Wellington P,6724,9,5,6,16,31,55,-24,21
CC Mariners,6724,10,4,8,15,28,49,-21,20
Sydney FC,6725,1,21,4,3,66,23,43,67
N'castle Jet,6725,2,15,6,7,58,38,20,51
Melbourne C,6725,3,14,5,10,44,34,10,47
Melbourne V,6725,4,13,5,11,46,40,6,44
Adelaide Utd,6725,5,11,6,11,37,40,-3,39
Brisbane,6725,6,10,5,13,33,42,-9,35
Western Sydn,6725,7,8,9,10,38,47,-9,33
Perth Glory,6725,8,10,2,15,37,50,-13,32
Wellington P,6725,9,5,6,16,31,55,-24,21
CC Mariners,6725,10,4,8,15,28,49,-21,20
Sydney FC,6726,1,20,4,4,65,25,40,64
N'castle Jet,6726,2,16,5,7,58,37,21,53
Melbourne V,6726,3,14,5,10,48,39,9,47
Melbourne C,6726,4,14,4,11,43,34,9,46
Adelaide Utd,6726,5,11,6,11,37,40,-3,39
Brisbane,6726,6,10,5,13,33,42,-9,35
Western Sydn,6726,7,8,9,10,38,47,-9,33
Perth Glory,6726,8,10,2,15,37,50,-13,32
Wellington P,6726,9,5,6,16,31,55,-24,21
CC Mariners,6726,10,4,8,15,28,49,-21,20
Sydney FC,6727,1,21,4,3,66,23,43,67
N'castle Jet,6727,2,16,5,7,59,38,21,53
Melbourne C,6727,3,14,4,11,44,35,9,46
Melbourne V,6727,4,13,5,11,46,40,6,44
Adelaide Utd,6727,5,11,6,11,37,40,-3,39
Brisbane,6727,6,10,5,13,33,42,-9,35
Western Sydn,6727,7,8,9,10,38,47,-9,33
Perth Glory,6727,8,10,2,15,37,50,-13,32
Wellington P,6727,9,5,6,16,31,55,-24,21
CC Mariners,6727,10,4,8,15,28,49,-21,20
Sydney FC,6728,1,20,5,3,65,23,42,65
N'castle Jet,6728,2,16,5,7,60,38,22,53
Melbourne C,6728,3,14,4,11,44,36,8,46
Melbourne V,6728,4,13,6,10,46,39,7,45
Adelaide Utd,6728,5,11,6,11,37,40,-3,39
Brisbane,6728,6,10,5,13,33,42,-9,35
Western Sydn,6728,7,8,9,10,38,47,-9,33
Perth Glory,6728,8,10,2,15,37,50,-13,32
Wellington P,6728,9,5,6,16,31,55,-24,21
CC Mariners,6728,10,4,8,15,28,49,-21,20
Sydney FC,6729,1,20,4,4,66,25,41,64
N'castle Jet,6729,2,15,5,8,59,40,19,50
Melbourne C,6729,3,15,4,10,46,35,11,49
Melbourne V,6729,4,14,5,10,48,40,8,47
Adelaide Utd,6729,5,11,6,11,37,40,-3,39
Brisbane,6729,6,10,5,13,33,42,-9,35
Western Sydn,6729,7,8,9,10,38,47,-9,33
Perth Glory,6729,8,10,2,15,37,50,-13,32
Wellington P,6729,9,5,6,16,31,55,-24,21
CC Mariners,6729,10,4,8,15,28,49,-21,20
Sydney FC,6730,1,21,4,3,66,22,44,67
N'castle Jet,6730,2,16,5,7,61,39,22,53
Melbourne C,6730,3,14,4,11,45,37,8,46
Melbourne V,6730,4,13,5,11,45,40,5,44
Adelaide Utd,6730,5,11,6,11,37,40,-3,39
Brisbane,6730,6,10,5,13,33,42,-9,35
Western Sydn,6730,7,8,9,10,38,47,-9,33
Perth Glory,6730,8,10,2,15,37,50,-13,32
Wellington P,6730,9,5,6,16,31,55,-24,21
CC Mariners,6730,10,4,8,15,28,49,-21,20
Sydney FC,6731,1,21,4,3,69,23,46,67
N'castle Jet,6731,2,15,5,8,57,40,17,50
Melbourne C,6731,3,15,4,10,46,33,13,49
Melbourne V,6731,4,13,5,11,46,43,3,44
Adelaide Utd,6731,5,11,6,11,37,40,-3,39
Brisbane,6731,6,10,5,13,33,42,-9,35
Western Sydn,6731,7,8,9,10,38,47,-9,33
Perth Glory,6731,8,10,2,15,37,50,-13,32
Wellington P,6731,9,5,6,16,31,55,-24,21
CC Mariners,6731,10,4,8,15,28,49,-21,20
Sydney FC,6732,1,20,5,3,65,23,42,65
N'castle Jet,6732,2,15,6,7,59,39,20,51
Melbourne C,6732,3,14,5,10,45,35,10,47
Melbourne V,6732,4,13,6,10,46,39,7,45
Adelaide Utd,6732,5,11,6,11,37,40,-3,39
Brisbane,6732,6,10,5,13,33,42,-9,35
Western Sydn,6732,7,8,9,10,38,47,-9,33
Perth Glory,6732,8,10,2,15,37,50,-13,32
Wellington P,6732,9,5,6,16,31,55,-24,21
CC Mariners,6732,10,4,8,15,28,49,-21,20
Sydney FC,6733,1,21,4,3,67,23,44,67
N'castle Jet,6733,2,16,5,7,60,39,21,53
Melbourne C,6733,3,14,4,11,45,36,9,46
Melbourne V,6733,4,13,5,11,46,41,5,44
Adelaide Utd,6733,5,11,6,11,37,40,-3,39
Brisbane,6733,6,10,5,13,33,42,-9,35
Western Sydn,6733,7,8,9,10,38,47,-9,33
Perth Glory,6733,8,10,2,15,37,50,-13,32
Wellington P,6733,9,5,6,16,31,55,-24,21
CC Mariners,6733,10,4,8,15,28,49,-21,20
Sydney FC,6734,1,21,4,3,65,22,43,67
N'castle Jet,6734,2,16,5,7,60,37,23,53
Melbourne C,6734,3,14,4,11,43,36,7,46
Melbourne V,6734,4,13,5,11,45,39,6,44
Adelaide Utd,6734,5,11,6,11,37,40,-3,39
Brisbane,6734,6,10,5,13,33,42,-9,35
Western Sydn,6734,7,8,9,10,38,47,-9,33
Perth Glory,6734,8,10,2,15,37,50,-13,32
Wellington P,6734,9,5,6,16,31,55,-24,21
CC Mariners,6734,10,4,8,15,28,49,-21,20
Sydney FC,6735,1,21,4,3,71,23,48,67
N'castle Jet,6735,2,15,6,7,58,38,20,51
Melbourne C,6735,3,14,5,10,44,34,10,47
Melbourne V,6735,4,13,5,11,46,45,1,44
Adelaide Utd,6735,5,11,6,11,37,40,-3,39
Brisbane,6735,6,10,5,13,33,42,-9,35
Western Sydn,6735,7,8,9,10,38,47,-9,33
Perth Glory,6735,8,10,2,15,37,50,-13,32
Wellington P,6735,9,5,6,16,31,55,-24,21
CC Mariners,6735,10,4,8,15,28,49,-21,20
Sydney FC,6736,1,20,5,3,65,23,42,65
N'castle Jet,6736,2,15,6,7,59,39,20,51
Melbourne C,6736,3,14,5,10,45,35,10,47
Melbourne V,6736,4,13,6,10,46,39,7,45
Adelaide Utd,6736,5,11,6,11,37,40,-3,39
Brisbane,6736,6,10,5,13,33,42,-9,35
Western Sydn,6736,7,8,9,10,38,47,-9,33
Perth Glory,6736,8,10,2,15,37,50,-13,32
Wellington P,6736,9,5,6,16,31,55,-24,21
CC Mariners,6736,10,4,8,15,28,49,-21,20
Sydney FC,6737,1,20,4,4,64,25,39,64
N'castle Jet,6737,2,16,5,7,61,38,23,53
Melbourne V,6737,3,14,5,10,48,38,10,47
Melbourne C,6737,4,14,4,11,44,37,7,46
Adelaide Utd,6737,5,11,6,11,37,40,-3,39
Brisbane,6737,6,10,5,13,33,42,-9,35
Western Sydn,6737,7,8,9,10,38,47,-9,33
Perth Glory,6737,8,10,2,15,37,50,-13,32
Wellington P,6737,9,5,6,16,31,55,-24,21
CC Mariners,6737,10,4,8,15,28,49,-21,20
Sydney FC,6738,1,21,4,3,65,22,43,67
N'castle Jet,6738,2,15,5,8,57,38,19,50
Melbourne C,6738,3,15,4,10,44,33,11,49
Melbourne V,6738,4,13,5,11,45,39,6,44
Adelaide Utd,6738,5,11,6,11,37,40,-3,39
Brisbane,6738,6,10,5,13,33,42,-9,35
Western Sydn,6738,7,8,9,10,38,47,-9,33
Perth Glory,6738,8,10,2,15,37,50,-13,32
Wellington P,6738,9,5,6,16,31,55,-24,21
CC Mariners,6738,10,4,8,15,28,49,-21,20
Sydney FC,6739,1,21,4,3,66,23,43,67
N'castle Jet,6739,2,15,5,8,59,40,19,50
Melbourne C,6739,3,15,4,10,46,35,11,49
Melbourne V,6739,4,13,5,11,46,40,6,44
Adelaide Utd,6739,5,11,6,11,37,40,-3,39
Brisbane,6739,6,10,5,13,33,42,-9,35
Western Sydn,6739,7,8,9,10,38,47,-9,33
Perth Glory,6739,8,10,2,15,37,50,-13,32
Wellington P,6739,9,5,6,16,31,55,-24,21
CC Mariners,6739,10,4,8,15,28,49,-21,20
Sydney FC,6740,1,20,4,4,65,24,41,64
N'castle Jet,6740,2,16,5,7,61,39,22,53
Melbourne V,6740,3,14,5,10,47,39,8,47
Melbourne C,6740,4,14,4,11,45,37,8,46
Adelaide Utd,6740,5,11,6,11,37,40,-3,39
Brisbane,6740,6,10,5,13,33,42,-9,35
Western Sydn,6740,7,8,9,10,38,47,-9,33
Perth Glory,6740,8,10,2,15,37,50,-13,32
Wellington P,6740,9,5,6,16,31,55,-24,21
CC Mariners,6740,10,4,8,15,28,49,-21,20
Sydney FC,6741,1,21,4,3,67,23,44,67
N'castle Jet,6741,2,15,5,8,58,40,18,50
Melbourne C,6741,3,15,4,10,46,34,12,49
Melbourne V,6741,4,13,5,11,46,41,5,44
Adelaide Utd,6741,5,11,6,11,37,40,-3,39
Brisbane,6741,6,10,5,13,33,42,-9,35
Western Sydn,6741,7,8,9,10,38,47,-9,33
Perth Glory,6741,8,10,2,15,37,50,-13,32
Wellington P,6741,9,5,6,16,31,55,-24,21
CC Mariners,6741,10,4,8,15,28,49,-21,20
Sydney FC,6742,1,21,4,3,66,22,44,67
N'castle Jet,6742,2,15,6,7,58,38,20,51
Melbourne C,6742,3,14,5,10,44,34,10,47
Melbourne V,6742,4,13,5,11,45,40,5,44
Adelaide Utd,6742,5,11,6,11,37,40,-3,39
Brisbane,6742,6,10,5,13,33,42,-9,35
Western Sydn,6742,7,8,9,10,38,47,-9,33
Perth Glory,6742,8,10,2,15,37,50,-13,32
Wellington P,6742,9,5,6,16,31,55,-24,21
CC Mariners,6742,10,4,8,15,28,49,-21,20
Sydney FC,6743,1,21,4,3,66,22,44,67
N'castle Jet,6743,2,15,5,8,57,38,19,50
Melbourne C,6743,3,15,4,10,44,33,11,49
Melbourne V,6743,4,13,5,11,45,40,5,44
Adelaide Utd,6743,5,11,6,11,37,40,-3,39
Brisbane,6743,6,10,5,13,33,42,-9,35
Western Sydn,6743,7,8,9,10,38,47,-9,33
Perth Glory,6743,8,10,2,15,37,50,-13,32
Wellington P,6743,9,5,6,16,31,55,-24,21
CC Mariners,6743,10,4,8,15,28,49,-21,20
Sydney FC,6744,1,21,4,3,69,23,46,67
N'castle Jet,6744,2,15,6,7,59,39,20,51
Melbourne C,6744,3,14,5,10,45,35,10,47
Melbourne V,6744,4,13,5,11,46,43,3,44
Adelaide Utd,6744,5,11,6,11,37,40,-3,39
Brisbane,6744,6,10,5,13,33,42,-9,35
Western Sydn,6744,7,8,9,10,38,47,-9,33
Perth Glory,6744,8,10,2,15,37,50,-13,32
Wellington P,6744,9,5,6,16,31,55,-24,21
CC Mariners,6744,10,4,8,15,28,49,-21,20
Sydney FC,6745,1,21,4,3,67,23,44,67
N'castle Jet,6745,2,15,6,7,58,38,20,51
Melbourne C,6745,3,14,5,10,44,34,10,47
Melbourne V,6745,4,13,5,11,46,41,5,44
Adelaide Utd,6745,5,11,6,11,37,40,-3,39
Brisbane,6745,6,10,5,13,33,42,-9,35
Western Sydn,6745,7,8,9,10,38,47,-9,33
Perth Glory,6745,8,10,2,15,37,50,-13,32
Wellington P,6745,9,5,6,16,31,55,-24,21
CC Mariners,6745,10,4,8,15,28,49,-21,20
Sydney FC,6746,1,21,4,3,67,22,45,67
N'castle Jet,6746,2,16,5,7,61,38,23,53
Melbourne C,6746,3,14,4,11,44,37,7,46
Melbourne V,6746,4,13,5,11,45,41,4,44
Adelaide Utd,6746,5,11,6,11,37,40,-3,39
Brisbane,6746,6,10,5,13,33,42,-9,35
Western Sydn,6746,7,8,9,10,38,47,-9,33
Perth Glory,6746,8,10,2,15,37,50,-13,32
Wellington P,6746,9,5,6,16,31,55,-24,21
CC Mariners,6746,10,4,8,15,28,49,-21,20
Sydney FC,6747,1,21,4,3,67,24,43,67
N'castle Jet,6747,2,15,5,8,57,39,18,50
Melbourne C,6747,3,15,4,10,45,33,12,49
Melbourne V,6747,4,13,5,11,47,41,6,44
Adelaide Utd,6747,5,11,6,11,37,40,-3,39
Brisbane,6747,6,10,5,13,33,42,-9,35
Western Sydn,6747,7,8,9,10,38,47,-9,33
Perth Glory,6747,8,10,2,15,37,50,-13,32
Wellington P,6747,9,5,6,16,31,55,-24,21
CC Mariners,6747,10,4,8,15,28,49,-21,20
Sydney FC,6748,1,21,4,3,65,22,43,67
N'castle Jet,6748,2,15,5,8,57,38,19,50
Melbourne C,6748,3,15,4,10,44,33,11,49
Melbourne V,6748,4,13,5,11,45,39,6,44
Adelaide Utd,6748,5,11,6,11,37,40,-3,39
Brisbane,6748,6,10,5,13,33,42,-9,35
Western Sydn,6748,7,8,9,10,38,47,-9,33
Perth Glory,6748,8,10,2,15,37,50,-13,32
Wellington P,6748,9,5,6,16,31,55,-24,21
CC Mariners,6748,10,4,8,15,28,49,-21,20
Sydney FC,6749,1,21,4,3,67,24,43,67
N'castle Jet,6749,2,16,5,7,59,37,22,53
Melbourne C,6749,3,14,4,11,43,35,8,46
Melbourne V,6749,4,13,5,11,47,41,6,44
Adelaide Utd,6749,5,11,6,11,37,40,-3,39
Brisbane,6749,6,10,5,13,33,42,-9,35
Western Sydn,6749,7,8,9,10,38,47,-9,33
Perth Glory,6749,8,10,2,15,37,50,-13,32
Wellington P,6749,9,5,6,16,31,55,-24,21
CC Mariners,6749,10,4,8,15,28,49,-21,20
Sydney FC,6750,1,21,4,3,66,23,43,67
N'castle Jet,6750,2,15,6,7,59,39,20,51
Melbourne C,6750,3,14,5,10,45,35,10,47
Melbourne V,6750,4,13,5,11,46,40,6,44
Adelaide Utd,6750,5,11,6,11,37,40,-3,39
Brisbane,6750,6,10,5,13,33,42,-9,35
Western Sydn,6750,7,8,9,10,38,47,-9,33
Perth Glory,6750,8,10,2,15,37,50,-13,32
Wellington P,6750,9,5,6,16,31,55,-24,21
CC Mariners,6750,10,4,8,15,28,49,-21,20
Sydney FC,6751,1,20,5,3,64,22,42,65
N'castle Jet,6751,2,15,6,7,58,38,20,51
Melbourne C,6751,3,14,5,10,44,34,10,47
Melbourne V,6751,4,13,6,10,45,38,7,45
Adelaide Utd,6751,5,11,6,11,37,40,-3,39
Brisbane,6751,6,10,5,13,33,42,-9,35
Western Sydn,6751,7,8,9,10,38,47,-9,33
Perth Glory,6751,8,10,2,15,37,50,-13,32
Wellington P,6751,9,5,6,16,31,55,-24,21
CC Mariners,6751,10,4,8,15,28,49,-21,20
Sydney FC,6752,1,21,4,3,67,24,43,67
N'castle Jet,6752,2,16,5,7,60,38,22,53
Melbourne C,6752,3,14,4,11,44,36,8,46
Melbourne V,6752,4,13,5,11,47,41,6,44
Adelaide Utd,6752,5,11,6,11,37,40,-3,39
Brisbane,6752,6,10,5,13,33,42,-9,35
Western Sydn,6752,7,8,9,10,38,47,-9,33
Perth Glory,6752,8,10,2,15,37,50,-13,32
Wellington P,6752,9,5,6,16,31,55,-24,21
CC Mariners,6752,10,4,8,15,28,49,-21,20
Sydney FC,6753,1,20,4,4,64,23,41,64
N'castle Jet,6753,2,15,5,8,57,39,18,50
Melbourne C,6753,3,15,4,10,45,33,12,49
Melbourne V,6753,4,14,5,10,46,38,8,47
Adelaide Utd,6753,5,11,6,11,37,40,-3,39
Brisbane,6753,6,10,5,13,33,42,-9,35
Western Sydn,6753,7,8,9,10,38,47,-9,33
Perth Glory,6753,8,10,2,15,37,50,-13,32
Wellington P,6753,9,5,6,16,31,55,-24,21
CC Mariners,6753,10,4,8,15,28,49,-21,20
Sydney FC,6754,1,21,4,3,65,22,43,67
N'castle Jet,6754,2,15,6,7,59,39,20,51
Melbourne C,6754,3,14,5,10,45,35,10,47
Melbourne V,6754,4,13,5,11,45,39,6,44
Adelaide Utd,6754,5,11,6,11,37,40,-3,39
Brisbane,6754,6,10,5,13,33,42,-9,35
Western Sydn,6754,7,8,9,10,38,47,-9,33
Perth Glory,6754,8,10,2,15,37,50,-13,32
Wellington P,6754,9,5,6,16,31,55,-24,21
CC Mariners,6754,10,4,8,15,28,49,-21,20
Sydney FC,6755,1,21,4,3,68,22,46,67
N'castle Jet,6755,2,15,5,8,57,38,19,50
Melbourne C,6755,3,15,4,10,44,33,11,49
Melbourne V,6755,4,13,5,11,45,42,3,44
Adelaide Utd,6755,5,11,6,11,37,40,-3,39
Brisbane,6755,6,10,5,13,33,42,-9,35
Western Sydn,6755,7,8,9,10,38,47,-9,33
Perth Glory,6755,8,10,2,15,37,50,-13,32
Wellington P,6755,9,5,6,16,31,55,-24,21
CC Mariners,6755,10,4,8,15,28,49,-21,20
Sydney FC,6756,1,20,4,4,65,25,40,64
N'castle Jet,6756,2,15,6,7,58,38,20,51
Melbourne C,6756,3,14,5,10,44,34,10,47
Melbourne V,6756,4,14,5,10,48,39,9,47
Adelaide Utd,6756,5,11,6,11,37,40,-3,39
Brisbane,6756,6,10,5,13,33,42,-9,35
Western Sydn,6756,7,8,9,10,38,47,-9,33
Perth Glory,6756,8,10,2,15,37,50,-13,32
Wellington P,6756,9,5,6,16,31,55,-24,21
CC Mariners,6756,10,4,8,15,28,49,-21,20
Sydney FC,6757,1,20,5,3,65,23,42,65
N'castle Jet,6757,2,15,5,8,59,40,19,50
Melbourne C,6757,3,15,4,10,46,35,11,49
Melbourne V,6757,4,13,6,10,46,39,7,45
Adelaide Utd,6757,5,11,6,11,37,40,-3,39
Brisbane,6757,6,10,5,13,33,42,-9,35
Western Sydn,6757,7,8,9,10,38,47,-9,33
Perth Glory,6757,8,10,2,15,37,50,-13,32
Wellington P,6757,9,5,6,16,31,55,-24,21
CC Mariners,6757,10,4,8,15,28,49,-21,20
Sydney FC,6758,1,20,4,4,64,23,41,64
N'castle Jet,6758,2,16,5,7,58,37,21,53
Melbourne V,6758,3,14,5,10,46,38,8,47
Melbourne C,6758,4,14,4,11,43,34,9,46
Adelaide Utd,6758,5,11,6,11,37,40,-3,39
Brisbane,6758,6,10,5,13,33,42,-9,35
Western Sydn,6758,7,8,9,10,38,47,-9,33
Perth Glory,6758,8,10,2,15,37,50,-13,32
Wellington P,6758,9,5,6,16,31,55,-24,21
CC Mariners,6758,10,4,8,15,28,49,-21,20
Sydney FC,6759,1,20,4,4,65,25,40,64
N'castle Jet,6759,2,16,5,7,59,38,21,53
Melbourne V,6759,3,14,5,10,48,39,9,47
Melbourne C,6759,4,14,4,11,44,35,9,46
Adelaide Utd,6759,5,11,6,11,37,40,-3,39
Brisbane,6759,6,10,5,13,33,42,-9,35
Western Sydn,6759,7,8,9,10,38,47,-9,33
Perth Glory,6759,8,10,2,15,37,50,-13,32
Wellington P,6759,9,5,6,16,31,55,-24,21
CC Mariners,6759,10,4,8,15,28,49,-21,20
Sydney FC,6760,1,21,4,3,67,24,43,67
N'castle Jet,6760,2,15,6,7,58,38,20,51
Melbourne C,6760,3,14,5,10,44,34,10,47
Melbourne V,6760,4,13,5,11,47,41,6,44
Adelaide Utd,6760,5,11,6,11,37,40,-3,39
Brisbane,6760,6,10,5,13,33,42,-9,35
Western Sydn,6760,7,8,9,10,38,47,-9,33
Perth Glory,6760,8,10,2,15,37,50,-13,32
Wellington P,6760,9,5,6,16,31,55,-24,21
CC Mariners,6760,10,4,8,15,28,49,-21,20
Sydney FC,6761,1,21,4,3,69,23,46,67
N'castle Jet,6761,2,15,6,7,58,38,20,51
Melbourne C,6761,3,14,5,10,44,34,10,47
Melbourne V,6761,4,13,5,11,46,43,3,44
Adelaide Utd,6761,5,11,6,11,37,40,-3,39
Brisbane,6761,6,10,5,13,33,42,-9,35
Western Sydn,6761,7,8,9,10,38,47,-9,33
Perth Glory,6761,8,10,2,15,37,50,-13,32
Wellington P,6761,9,5,6,16,31,55,-24,21
CC Mariners,6761,10,4,8,15,28,49,-21,20
Sydney FC,6762,1,20,5,3,64,22,42,65
N'castle Jet,6762,2,15,5,8,57,38,19,50
Melbourne C,6762,3,15,4,10,44,33,11,49
Melbourne V,6762,4,13,6,10,45,38,7,45
Adelaide Utd,6762,5,11,6,11,37,40,-3,39
Brisbane,6762,6,10,5,13,33,42,-9,35
Western Sydn,6762,7,8,9,10,38,47,-9,33
Perth Glory,6762,8,10,2,15,37,50,-13,32
Wellington P,6762,9,5,6,16,31,55,-24,21
CC Mariners,6762,10,4,8,15,28,49,-21,20
Sydney FC,6763,1,21,4,3,67,22,45,67
N'castle Jet,6763,2,16,5,7,60,38,22,53
Melbourne C,6763,3,14,4,11,44,36,8,46
Melbourne V,6763,4,13,5,11,45,41,4,44
Adelaide Utd,6763,5,11,6,11,37,40,-3,39
Brisbane,6763,6,10,5,13,33,42,-9,35
Western Sydn,6763,7,8,9,10,38,47,-9,33
Perth Glory,6763,8,10,2,15,37,50,-13,32
Wellington P,6763,9,5,6,16,31,55,-24,21
CC Mariners,6763,10,4,8,15,28,49,-21,20
Sydney FC,6764,1,21,4,3,66,23,43,67
N'castle Jet,6764,2,15,6,7,60,40,20,51
Melbourne C,6764,3,14,5,10,46,36,10,47
Melbourne V,6764,4,13,5,11,46,40,6,44
Adelaide Utd,6764,5,11,6,11,37,40,-3,39
Brisbane,6764,6,10,5,13,33,42,-9,35
Western Sydn,6764,7,8,9,10,38,47,-9,33
Perth Glory,6764,8,10,2,15,37,50,-13,32
Wellington P,6764,9,5,6,16,31,55,-24,21
CC Mariners,6764,10,4,8,15,28,49,-21,20
Sydney FC,6765,1,21,4,3,66,22,44,67
N'castle Jet,6765,2,16,5,7,61,39,22,53
Melbourne C,6765,3,14,4,11,45,37,8,46
Melbourne V,6765,4,13,5,11,45,40,5,44
Adelaide Utd,6765,5,11,6,11,37,40,-3,39
Brisbane,6765,6,10,5,13,33,42,-9,35
Western Sydn,6765,7,8,9,10,38,47,-9,33
Perth Glory,6765,8,10,2,15,37,50,-13,32
Wellington P,6765,9,5,6,16,31,55,-24,21
CC Mariners,6765,10,4,8,15,28,49,-21,20
Sydney FC,6766,1,21,4,3,66,22,44,67
N'castle Jet,6766,2,15,5,8,57,38,19,50
Melbourne C,6766,3,15,4,10,44,33,11,49
Melbourne V,6766,4,13,5,11,45,40,5,44
Adelaide Utd,6766,5,11,6,11,37,40,-3,39
Brisbane,6766,6,10,5,13,33,42,-9,35
Western Sydn,6766,7,8,9,10,38,47,-9,33
Perth Glory,6766,8,10,2,15,37,50,-13,32
Wellington P,6766,9,5,6,16,31,55,-24,21
CC Mariners,6766,10,4,8,15,28,49,-21,20
Sydney FC,6767,1,21,4,3,68,23,45,67
N'castle Jet,6767,2,16,5,7,58,37,21,53
Melbourne C,6767,3,14,4,11,43,34,9,46
Melbourne V,6767,4,13,5,11,46,42,4,44
Adelaide Utd,6767,5,11,6,11,37,40,-3,39
Brisbane,6767,6,10,5,13,33,42,-9,35
Western Sydn,6767,7,8,9,10,38,47,-9,33
Perth Glory,6767,8,10,2,15,37,50,-13,32
Wellington P,6767,9,5,6,16,31,55,-24,21
CC Mariners,6767,10,4,8,15,28,49,-21,20
Sydney FC,6768,1,21,4,3,65,22,43,67
N'castle Jet,6768,2,16,5,7,60,38,22,53
Melbourne C,6768,3,14,4,11,44,36,8,46
Melbourne V,6768,4,13,5,11,45,39,6,44
Adelaide Utd,6768,5,11,6,11,37,40,-3,39
Brisbane,6768,6,10,5,13,33,42,-9,35
Western Sydn,6768,7,8,9,10,38,47,-9,33
Perth Glory,6768,8,10,2,15,37,50,-13,32
Wellington P,6768,9,5,6,16,31,55,-24,21
CC Mariners,6768,10,4,8,15,28,49,-21,20
Sydney FC,6769,1,20,5,3,65,23,42,65
N'castle Jet,6769,2,16,5,7,60,39,21,53
Melbourne C,6769,3,14,4,11,45,36,9,46
Melbourne V,6769,4,13,6,10,46,39,7,45
Adelaide Utd,6769,5,11,6,11,37,40,-3,39
Brisbane,6769,6,10,5,13,33,42,-9,35
Western Sydn,6769,7,8,9,10,38,47,-9,33
Perth Glory,6769,8,10,2,15,37,50,-13,32
Wellington P,6769,9,5,6,16,31,55,-24,21
CC Mariners,6769,10,4,8,15,28,49,-21,20
Sydney FC,6770,1,20,5,3,66,24,42,65
N'castle Jet,6770,2,15,5,8,60,41,19,50
Melbourne C,6770,3,15,4,10,47,36,11,49
Melbourne V,6770,4,13,6,10,47,40,7,45
Adelaide Utd,6770,5,11,6,11,37,40,-3,39
Brisbane,6770,6,10,5,13,33,42,-9,35
Western Sydn,6770,7,8,9,10,38,47,-9,33
Perth Glory,6770,8,10,2,15,37,50,-13,32
Wellington P,6770,9,5,6,16,31,55,-24,21
CC Mariners,6770,10,4,8,15,28,49,-21,20
Sydney FC,6771,1,21,4,3,66,23,43,67
N'castle Jet,6771,2,15,6,7,59,39,20,51
Melbourne C,6771,3,14,5,10,45,35,10,47
Melbourne V,6771,4,13,5,11,46,40,6,44
Adelaide Utd,6771,5,11,6,11,37,40,-3,39
Brisbane,6771,6,10,5,13,33,42,-9,35
Western Sydn,6771,7,8,9,10,38,47,-9,33
Perth Glory,6771,8,10,2,15,37,50,-13,32
Wellington P,6771,9,5,6,16,31,55,-24,21
CC Mariners,6771,10,4,8,15,28,49,-21,20
Sydney FC,6772,1,21,4,3,66,22,44,67
N'castle Jet,6772,2,15,6,7,57,37,20,51
Melbourne C,6772,3,14,5,10,43,33,10,47
Melbourne V,6772,4,13,5,11,45,40,5,44
Adelaide Utd,6772,5,11,6,11,37,40,-3,39
Brisbane,6772,6,10,5,13,33,42,-9,35
Western Sydn,6772,7,8,9,10,38,47,-9,33
Perth Glory,6772,8,10,2,15,37,50,-13,32
Wellington P,6772,9,5,6,16,31,55,-24,21
CC Mariners,6772,10,4,8,15,28,49,-21,20
Sydney FC,6773,1,20,4,4,65,25,40,64
N'castle Jet,6773,2,16,5,7,60,38,22,53
Melbourne V,6773,3,14,5,10,48,39,9,47
Melbourne C,6773,4,14,4,11,44,36,8,46
Adelaide Utd,6773,5,11,6,11,37,40,-3,39
Brisbane,6773,6,10,5,13,33,42,-9,35
Western Sydn,6773,7,8,9,10,38,47,-9,33
Perth Glory,6773,8,10,2,15,37,50,-13,32
Wellington P,6773,9,5,6,16,31,55,-24,21
CC Mariners,6773,10,4,8,15,28,49,-21,20
Sydney FC,6774,1,21,4,3,72,22,50,67
N'castle Jet,6774,2,16,5,7,59,38,21,53
Melbourne C,6774,3,14,4,11,44,35,9,46
Melbourne V,6774,4,13,5,11,45,46,-1,44
Adelaide Utd,6774,5,11,6,11,37,40,-3,39
Brisbane,6774,6,10,5,13,33,42,-9,35
Western Sydn,6774,7,8,9,10,38,47,-9,33
Perth Glory,6774,8,10,2,15,37,50,-13,32
Wellington P,6774,9,5,6,16,31,55,-24,21
CC Mariners,6774,10,4,8,15,28,49,-21,20
Sydney FC,6775,1,20,4,4,64,24,40,64
N'castle Jet,6775,2,15,6,7,59,39,20,51
Melbourne C,6775,3,14,5,10,45,35,10,47
Melbourne V,6775,4,14,5,10,47,38,9,47
Adelaide Utd,6775,5,11,6,11,37,40,-3,39
Brisbane,6775,6,10,5,13,33,42,-9,35
Western Sydn,6775,7,8,9,10,38,47,-9,33
Perth Glory,6775,8,10,2,15,37,50,-13,32
Wellington P,6775,9,5,6,16,31,55,-24,21
CC Mariners,6775,10,4,8,15,28,49,-21,20
Sydney FC,6776,1,21,4,3,67,23,44,67
N'castle Jet,6776,2,16,5,7,58,37,21,53
Melbourne C,6776,3,14,4,11,43,34,9,46
Melbourne V,6776,4,13,5,11,46,41,5,44
Adelaide Utd,6776,5,11,6,11,37,40,-3,39
Brisbane,6776,6,10,5,13,33,42,-9,35
Western Sydn,6776,7,8,9,10,38,47,-9,33
Perth Glory,6776,8,10,2,15,37,50,-13,32
Wellington P,6776,9,5,6,16,31,55,-24,21
CC Mariners,6776,10,4,8,15,28,49,-21,20
Sydney FC,6777,1,21,4,3,68,22,46,67
N'castle Jet,6777,2,15,6,7,58,38,20,51
Melbourne C,6777,3,14,5,10,44,34,10,47
Melbourne V,6777,4,13,5,11,45,42,3,44
Adelaide Utd,6777,5,11,6,11,37,40,-3,39
Brisbane,6777,6,10,5,13,33,42,-9,35
Western Sydn,6777,7,8,9,10,38,47,-9,33
Perth Glory,6777,8,10,2,15,37,50,-13,32
Wellington P,6777,9,5,6,16,31,55,-24,21
CC Mariners,6777,10,4,8,15,28,49,-21,20
Sydney FC,6778,1,21,4,3,67,22,45,67
N'castle Jet,6778,2,16,5,7,61,39,22,53
Melbourne C,6778,3,14,4,11,45,37,8,46
Melbourne V,6778,4,13,5,11,45,41,4,44
Adelaide Utd,6778,5,11,6,11,37,40,-3,39
Brisbane,6778,6,10,5,13,33,42,-9,35
Western Sydn,6778,7,8,9,10,38,47,-9,33
Perth Glory,6778,8,10,2,15,37,50,-13,32
Wellington P,6778,9,5,6,16,31,55,-24,21
CC Mariners,6778,10,4,8,15,28,49,-21,20
Sydney FC,6779,1,21,4,3,68,22,46,67
N'castle Jet,6779,2,15,5,8,58,39,19,50
Melbourne C,6779,3,15,4,10,45,34,11,49
Melbourne V,6779,4,13,5,11,45,42,3,44
Adelaide Utd,6779,5,11,6,11,37,40,-3,39
Brisbane,6779,6,10,5,13,33,42,-9,35
Western Sydn,6779,7,8,9,10,38,47,-9,33
Perth Glory,6779,8,10,2,15,37,50,-13,32
Wellington P,6779,9,5,6,16,31,55,-24,21
CC Mariners,6779,10,4,8,15,28,49,-21,20
Sydney FC,6780,1,21,4,3,66,22,44,67
N'castle Jet,6780,2,15,6,7,58,38,20,51
Melbourne C,6780,3,14,5,10,44,34,10,47
Melbourne V,6780,4,13,5,11,45,40,5,44
Adelaide Utd,6780,5,11,6,11,37,40,-3,39
Brisbane,6780,6,10,5,13,33,42,-9,35
Western Sydn,6780,7,8,9,10,38,47,-9,33
Perth Glory,6780,8,10,2,15,37,50,-13,32
Wellington P,6780,9,5,6,16,31,55,-24,21
CC Mariners,6780,10,4,8,15,28,49,-21,20
Sydney FC,6781,1,21,4,3,67,23,44,67
N'castle Jet,6781,2,15,6,7,57,37,20,51
Melbourne C,6781,3,14,5,10,43,33,10,47
Melbourne V,6781,4,13,5,11,46,41,5,44
Adelaide Utd,6781,5,11,6,11,37,40,-3,39
Brisbane,6781,6,10,5,13,33,42,-9,35
Western Sydn,6781,7,8,9,10,38,47,-9,33
Perth Glory,6781,8,10,2,15,37,50,-13,32
Wellington P,6781,9,5,6,16,31,55,-24,21
CC Mariners,6781,10,4,8,15,28,49,-21,20
Sydney FC,6782,1,21,4,3,66,23,43,67
N'castle Jet,6782,2,16,5,7,58,37,21,53
Melbourne C,6782,3,14,4,11,43,34,9,46
Melbourne V,6782,4,13,5,11,46,40,6,44
Adelaide Utd,6782,5,11,6,11,37,40,-3,39
Brisbane,6782,6,10,5,13,33,42,-9,35
Western Sydn,6782,7,8,9,10,38,47,-9,33
Perth Glory,6782,8,10,2,15,37,50,-13,32
Wellington P,6782,9,5,6,16,31,55,-24,21
CC Mariners,6782,10,4,8,15,28,49,-21,20
Sydney FC,6783,1,20,5,3,65,23,42,65
N'castle Jet,6783,2,16,5,7,60,37,23,53
Melbourne C,6783,3,14,4,11,43,36,7,46
Melbourne V,6783,4,13,6,10,46,39,7,45
Adelaide Utd,6783,5,11,6,11,37,40,-3,39
Brisbane,6783,6,10,5,13,33,42,-9,35
Western Sydn,6783,7,8,9,10,38,47,-9,33
Perth Glory,6783,8,10,2,15,37,50,-13,32
Wellington P,6783,9,5,6,16,31,55,-24,21
CC Mariners,6783,10,4,8,15,28,49,-21,20
Sydney FC,6784,1,21,4,3,70,22,48,67
N'castle Jet,6784,2,16,5,7,59,37,22,53
Melbourne C,6784,3,14,4,11,43,35,8,46
Melbourne V,6784,4,13,5,11,45,44,1,44
Adelaide Utd,6784,5,11,6,11,37,40,-3,39
Brisbane,6784,6,10,5,13,33,42,-9,35
Western Sydn,6784,7,8,9,10,38,47,-9,33
Perth Glory,6784,8,10,2,15,37,50,-13,32
Wellington P,6784,9,5,6,16,31,55,-24,21
CC Mariners,6784,10,4,8,15,28,49,-21,20
Sydney FC,6785,1,21,4,3,68,23,45,67
N'castle Jet,6785,2,15,6,7,58,38,20,51
Melbourne C,6785,3,14,5,10,44,34,10,47
Melbourne V,6785,4,13,5,11,46,42,4,44
Adelaide Utd,6785,5,11,6,11,37,40,-3,39
Brisbane,6785,6,10,5,13,33,42,-9,35
Western Sydn,6785,7,8,9,10,38,47,-9,33
Perth Glory,6785,8,10,2,15,37,50,-13,32
Wellington P,6785,9,5,6,16,31,55,-24,21
CC Mariners,6785,10,4,8,15,28,49,-21,20
Sydney FC,6786,1,20,4,4,64,24,40,64
N'castle Jet,6786,2,15,5,8,58,39,19,50
Melbourne C,6786,3,15,4,10,45,34,11,49
Melbourne V,6786,4,14,5,10,47,38,9,47
Adelaide Utd,6786,5,11,6,11,37,40,-3,39
Brisbane,6786,6,10,5,13,33,42,-9,35
Western Sydn,6786,7,8,9,10,38,47,-9,33
Perth Glory,6786,8,10,2,15,37,50,-13,32
Wellington P,6786,9,5,6,16,31,55,-24,21
CC Mariners,6786,10,4,8,15,28,49,-21,20
Sydney FC,6787,1,21,4,3,69,22,47,67
N'castle Jet,6787,2,16,5,7,60,39,21,53
Melbourne C,6787,3,14,4,11,45,36,9,46
Melbourne V,6787,4,13,5,11,45,43,2,44
Adelaide Utd,6787,5,11,6,11,37,40,-3,39
Brisbane,6787,6,10,5,13,33,42,-9,35
Western Sydn,6787,7,8,9,10,38,47,-9,33
Perth Glory,6787,8,10,2,15,37,50,-13,32
Wellington P,6787,9,5,6,16,31,55,-24,21
CC Mariners,6787,10,4,8,15,28,49,-21,20
Sydney FC,6788,1,21,4,3,69,22,47,67
N'castle Jet,6788,2,15,5,8,59,40,19,50
Melbourne C,6788,3,15,4,10,46,35,11,49
Melbourne V,6788,4,13,5,11,45,43,2,44
Adelaide Utd,6788,5,11,6,11,37,40,-3,39
Brisbane,6788,6,10,5,13,33,42,-9,35
Western Sydn,6788,7,8,9,10,38,47,-9,33
Perth Glory,6788,8,10,2,15,37,50,-13,32
Wellington P,6788,9,5,6,16,31,55,-24,21
CC Mariners,6788,10,4,8,15,28,49,-21,20
Sydney FC,6789,1,20,5,3,65,23,42,65
N'castle Jet,6789,2,16,5,7,59,37,22,53
Melbourne C,6789,3,14,4,11,43,35,8,46
Melbourne V,6789,4,13,6,10,46,39,7,45
Adelaide Utd,6789,5,11,6,11,37,40,-3,39
Brisbane,6789,6,10,5,13,33,42,-9,35
Western Sydn,6789,7,8,9,10,38,47,-9,33
Perth Glory,6789,8,10,2,15,37,50,-13,32
Wellington P,6789,9,5,6,16,31,55,-24,21
CC Mariners,6789,10,4,8,15,28,49,-21,20
Sydney FC,6790,1,21,4,3,68,23,45,67
N'castle Jet,6790,2,16,5,7,59,37,22,53
Melbourne C,6790,3,14,4,11,43,35,8,46
Melbourne V,6790,4,13,5,11,46,42,4,44
Adelaide Utd,6790,5,11,6,11,37,40,-3,39
Brisbane,6790,6,10,5,13,33,42,-9,35
Western Sydn,6790,7,8,9,10,38,47,-9,33
Perth Glory,6790,8,10,2,15,37,50,-13,32
Wellington P,6790,9,5,6,16,31,55,-24,21
CC Mariners,6790,10,4,8,15,28,49,-21,20
Sydney FC,6791,1,20,5,3,64,22,42,65
N'castle Jet,6791,2,16,5,7,58,37,21,53
Melbourne C,6791,3,14,4,11,43,34,9,46
Melbourne V,6791,4,13,6,10,45,38,7,45
Adelaide Utd,6791,5,11,6,11,37,40,-3,39
Brisbane,6791,6,10,5,13,33,42,-9,35
Western Sydn,6791,7,8,9,10,38,47,-9,33
Perth Glory,6791,8,10,2,15,37,50,-13,32
Wellington P,6791,9,5,6,16,31,55,-24,21
CC Mariners,6791,10,4,8,15,28,49,-21,20
Sydney FC,6792,1,21,4,3,66,23,43,67
N'castle Jet,6792,2,15,6,7,58,38,20,51
Melbourne C,6792,3,14,5,10,44,34,10,47
Melbourne V,6792,4,13,5,11,46,40,6,44
Adelaide Utd,6792,5,11,6,11,37,40,-3,39
Brisbane,6792,6,10,5,13,33,42,-9,35
Western Sydn,6792,7,8,9,10,38,47,-9,33
Perth Glory,6792,8,10,2,15,37,50,-13,32
Wellington P,6792,9,5,6,16,31,55,-24,21
CC Mariners,6792,10,4,8,15,28,49,-21,20
Sydney FC,6793,1,21,4,3,67,23,44,67
N'castle Jet,6793,2,16,5,7,62,37,25,53
Melbourne C,6793,3,14,4,11,43,38,5,46
Melbourne V,6793,4,13,5,11,46,41,5,44
Adelaide Utd,6793,5,11,6,11,37,40,-3,39
Brisbane,6793,6,10,5,13,33,42,-9,35
Western Sydn,6793,7,8,9,10,38,47,-9,33
Perth Glory,6793,8,10,2,15,37,50,-13,32
Wellington P,6793,9,5,6,16,31,55,-24,21
CC Mariners,6793,10,4,8,15,28,49,-21,20
Sydney FC,6794,1,21,4,3,67,23,44,67
N'castle Jet,6794,2,15,5,8,58,40,18,50
Melbourne C,6794,3,15,4,10,46,34,12,49
Melbourne V,6794,4,13,5,11,46,41,5,44
Adelaide Utd,6794,5,11,6,11,37,40,-3,39
Brisbane,6794,6,10,5,13,33,42,-9,35
Western Sydn,6794,7,8,9,10,38,47,-9,33
Perth Glory,6794,8,10,2,15,37,50,-13,32
Wellington P,6794,9,5,6,16,31,55,-24,21
CC Mariners,6794,10,4,8,15,28,49,-21,20
Sydney FC,6795,1,20,4,4,64,23,41,64
N'castle Jet,6795,2,16,5,7,59,37,22,53
Melbourne V,6795,3,14,5,10,46,38,8,47
Melbourne C,6795,4,14,4,11,43,35,8,46
Adelaide Utd,6795,5,11,6,11,37,40,-3,39
Brisbane,6795,6,10,5,13,33,42,-9,35
Western Sydn,6795,7,8,9,10,38,47,-9,33
Perth Glory,6795,8,10,2,15,37,50,-13,32
Wellington P,6795,9,5,6,16,31,55,-24,21
CC Mariners,6795,10,4,8,15,28,49,-21,20
Sydney FC,6796,1,20,5,3,65,23,42,65
N'castle Jet,6796,2,16,5,7,59,38,21,53
Melbourne C,6796,3,14,4,11,44,35,9,46
Melbourne V,6796,4,13,6,10,46,39,7,45
Adelaide Utd,6796,5,11,6,11,37,40,-3,39
Brisbane,6796,6,10,5,13,33,42,-9,35
Western Sydn,6796,7,8,9,10,38,47,-9,33
Perth Glory,6796,8,10,2,15,37,50,-13,32
Wellington P,6796,9,5,6,16,31,55,-24,21
CC Mariners,6796,10,4,8,15,28,49,-21,20
Sydney FC,6797,1,21,4,3,65,22,43,67
N'castle Jet,6797,2,15,6,7,59,39,20,51
Melbourne C,6797,3,14,5,10,45,35,10,47
Melbourne V,6797,4,13,5,11,45,39,6,44
Adelaide Utd,6797,5,11,6,11,37,40,-3,39
Brisbane,6797,6,10,5,13,33,42,-9,35
Western Sydn,6797,7,8,9,10,38,47,-9,33
Perth Glory,6797,8,10,2,15,37,50,-13,32
Wellington P,6797,9,5,6,16,31,55,-24,21
CC Mariners,6797,10,4,8,15,28,49,-21,20
Sydney FC,6798,1,20,4,4,64,23,41,64
N'castle Jet,6798,2,15,5,8,57,39,18,50
Melbourne C,6798,3,15,4,10,45,33,12,49
Melbourne V,6798,4,14,5,10,46,38,8,47
Adelaide Utd,6798,5,11,6,11,37,40,-3,39
Brisbane,6798,6,10,5,13,33,42,-9,35
Western Sydn,6798,7,8,9,10,38,47,-9,33
Perth Glory,6798,8,10,2,15,37,50,-13,32
Wellington P,6798,9,5,6,16,31,55,-24,21
CC Mariners,6798,10,4,8,15,28,49,-21,20
Sydney FC,6799,1,21,4,3,65,22,43,67
N'castle Jet,6799,2,16,5,7,59,38,21,53
Melbourne C,6799,3,14,4,11,44,35,9,46
Melbourne V,6799,4,13,5,11,45,39,6,44
Adelaide Utd,6799,5,11,6,11,37,40,-3,39
Brisbane,6799,6,10,5,13,33,42,-9,35
Western Sydn,6799,7,8,9,10,38,47,-9,33
Perth Glory,6799,8,10,2,15,37,50,-13,32
Wellington P,6799,9,5,6,16,31,55,-24,21
CC Mariners,6799,10,4,8,15,28,49,-21,20
Sydney FC,6800,1,21,4,3,70,22,48,67
N'castle Jet,6800,2,16,5,7,60,38,22,53
Melbourne C,6800,3,14,4,11,44,36,8,46
Melbourne V,6800,4,13,5,11,45,44,1,44
Adelaide Utd,6800,5,11,6,11,37,40,-3,39
Brisbane,6800,6,10,5,13,33,42,-9,35
Western Sydn,6800,7,8,9,10,38,47,-9,33
Perth Glory,6800,8,10,2,15,37,50,-13,32
Wellington P,6800,9,5,6,16,31,55,-24,21
CC Mariners,6800,10,4,8,15,28,49,-21,20
Sydney FC,6801,1,21,4,3,66,22,44,67
N'castle Jet,6801,2,16,5,7,59,38,21,53
Melbourne C,6801,3,14,4,11,44,35,9,46
Melbourne V,6801,4,13,5,11,45,40,5,44
Adelaide Utd,6801,5,11,6,11,37,40,-3,39
Brisbane,6801,6,10,5,13,33,42,-9,35
Western Sydn,6801,7,8,9,10,38,47,-9,33
Perth Glory,6801,8,10,2,15,37,50,-13,32
Wellington P,6801,9,5,6,16,31,55,-24,21
CC Mariners,6801,10,4,8,15,28,49,-21,20
Sydney FC,6802,1,21,4,3,66,22,44,67
N'castle Jet,6802,2,15,5,8,58,40,18,50
Melbourne C,6802,3,15,4,10,46,34,12,49
Melbourne V,6802,4,13,5,11,45,40,5,44
Adelaide Utd,6802,5,11,6,11,37,40,-3,39
Brisbane,6802,6,10,5,13,33,42,-9,35
Western Sydn,6802,7,8,9,10,38,47,-9,33
Perth Glory,6802,8,10,2,15,37,50,-13,32
Wellington P,6802,9,5,6,16,31,55,-24,21
CC Mariners,6802,10,4,8,15,28,49,-21,20
Sydney FC,6803,1,21,4,3,67,22,45,67
N'castle Jet,6803,2,16,5,7,59,38,21,53
Melbourne C,6803,3,14,4,11,44,35,9,46
Melbourne V,6803,4,13,5,11,45,41,4,44
Adelaide Utd,6803,5,11,6,11,37,40,-3,39
Brisbane,6803,6,10,5,13,33,42,-9,35
Western Sydn,6803,7,8,9,10,38,47,-9,33
Perth Glory,6803,8,10,2,15,37,50,-13,32
Wellington P,6803,9,5,6,16,31,55,-24,21
CC Mariners,6803,10,4,8,15,28,49,-21,20
Sydney FC,6804,1,21,4,3,67,22,45,67
N'castle Jet,6804,2,15,5,8,57,38,19,50
Melbourne C,6804,3,15,4,10,44,33,11,49
Melbourne V,6804,4,13,5,11,45,41,4,44
Adelaide Utd,6804,5,11,6,11,37,40,-3,39
Brisbane,6804,6,10,5,13,33,42,-9,35
Western Sydn,6804,7,8,9,10,38,47,-9,33
Perth Glory,6804,8,10,2,15,37,50,-13,32
Wellington P,6804,9,5,6,16,31,55,-24,21
CC Mariners,6804,10,4,8,15,28,49,-21,20
Sydney FC,6805,1,21,4,3,67,22,45,67
N'castle Jet,6805,2,15,6,7,59,39,20,51
Melbourne C,6805,3,14,5,10,45,35,10,47
Melbourne V,6805,4,13,5,11,45,41,4,44
Adelaide Utd,6805,5,11,6,11,37,40,-3,39
Brisbane,6805,6,10,5,13,33,42,-9,35
Western Sydn,6805,7,8,9,10,38,47,-9,33
Perth Glory,6805,8,10,2,15,37,50,-13,32
Wellington P,6805,9,5,6,16,31,55,-24,21
CC Mariners,6805,10,4,8,15,28,49,-21,20
Sydney FC,6806,1,20,4,4,64,24,40,64
N'castle Jet,6806,2,16,5,7,58,37,21,53
Melbourne V,6806,3,14,5,10,47,38,9,47
Melbourne C,6806,4,14,4,11,43,34,9,46
Adelaide Utd,6806,5,11,6,11,37,40,-3,39
Brisbane,6806,6,10,5,13,33,42,-9,35
Western Sydn,6806,7,8,9,10,38,47,-9,33
Perth Glory,6806,8,10,2,15,37,50,-13,32
Wellington P,6806,9,5,6,16,31,55,-24,21
CC Mariners,6806,10,4,8,15,28,49,-21,20
Sydney FC,6807,1,20,4,4,65,24,41,64
N'castle Jet,6807,2,16,5,7,59,37,22,53
Melbourne V,6807,3,14,5,10,47,39,8,47
Melbourne C,6807,4,14,4,11,43,35,8,46
Adelaide Utd,6807,5,11,6,11,37,40,-3,39
Brisbane,6807,6,10,5,13,33,42,-9,35
Western Sydn,6807,7,8,9,10,38,47,-9,33
Perth Glory,6807,8,10,2,15,37,50,-13,32
Wellington P,6807,9,5,6,16,31,55,-24,21
CC Mariners,6807,10,4,8,15,28,49,-21,20
Sydney FC,6808,1,20,5,3,66,24,42,65
N'castle Jet,6808,2,15,5,8,58,39,19,50
Melbourne C,6808,3,15,4,10,45,34,11,49
Melbourne V,6808,4,13,6,10,47,40,7,45
Adelaide Utd,6808,5,11,6,11,37,40,-3,39
Brisbane,6808,6,10,5,13,33,42,-9,35
Western Sydn,6808,7,8,9,10,38,47,-9,33
Perth Glory,6808,8,10,2,15,37,50,-13,32
Wellington P,6808,9,5,6,16,31,55,-24,21
CC Mariners,6808,10,4,8,15,28,49,-21,20
Sydney FC,6809,1,21,4,3,66,22,44,67
N'castle Jet,6809,2,15,5,8,57,40,17,50
Melbourne C,6809,3,15,4,10,46,33,13,49
Melbourne V,6809,4,13,5,11,45,40,5,44
Adelaide Utd,6809,5,11,6,11,37,40,-3,39
Brisbane,6809,6,10,5,13,33,42,-9,35
Western Sydn,6809,7,8,9,10,38,47,-9,33
Perth Glory,6809,8,10,2,15,37,50,-13,32
Wellington P,6809,9,5,6,16,31,55,-24,21
CC Mariners,6809,10,4,8,15,28,49,-21,20
Sydney FC,6810,1,21,4,3,66,23,43,67
N'castle Jet,6810,2,15,6,7,58,38,20,51
Melbourne C,6810,3,14,5,10,44,34,10,47
Melbourne V,6810,4,13,5,11,46,40,6,44
Adelaide Utd,6810,5,11,6,11,37,40,-3,39
Brisbane,6810,6,10,5,13,33,42,-9,35
Western Sydn,6810,7,8,9,10,38,47,-9,33
Perth Glory,6810,8,10,2,15,37,50,-13,32
Wellington P,6810,9,5,6,16,31,55,-24,21
CC Mariners,6810,10,4,8,15,28,49,-21,20
Sydney FC,6811,1,21,4,3,66,22,44,67
N'castle Jet,6811,2,16,5,7,59,37,22,53
Melbourne C,6811,3,14,4,11,43,35,8,46
Melbourne V,6811,4,13,5,11,45,40,5,44
Adelaide Utd,6811,5,11,6,11,37,40,-3,39
Brisbane,6811,6,10,5,13,33,42,-9,35
Western Sydn,6811,7,8,9,10,38,47,-9,33
Perth Glory,6811,8,10,2,15,37,50,-13,32
Wellington P,6811,9,5,6,16,31,55,-24,21
CC Mariners,6811,10,4,8,15,28,49,-21,20
Sydney FC,6812,1,21,4,3,66,22,44,67
N'castle Jet,6812,2,15,5,8,57,39,18,50
Melbourne C,6812,3,15,4,10,45,33,12,49
Melbourne V,6812,4,13,5,11,45,40,5,44
Adelaide Utd,6812,5,11,6,11,37,40,-3,39
Brisbane,6812,6,10,5,13,33,42,-9,35
Western Sydn,6812,7,8,9,10,38,47,-9,33
Perth Glory,6812,8,10,2,15,37,50,-13,32
Wellington P,6812,9,5,6,16,31,55,-24,21
CC Mariners,6812,10,4,8,15,28,49,-21,20
Sydney FC,6813,1,21,4,3,67,22,45,67
N'castle Jet,6813,2,16,5,7,60,37,23,53
Melbourne C,6813,3,14,4,11,43,36,7,46
Melbourne V,6813,4,13,5,11,45,41,4,44
Adelaide Utd,6813,5,11,6,11,37,40,-3,39
Brisbane,6813,6,10,5,13,33,42,-9,35
Western Sydn,6813,7,8,9,10,38,47,-9,33
Perth Glory,6813,8,10,2,15,37,50,-13,32
Wellington P,6813,9,5,6,16,31,55,-24,21
CC Mariners,6813,10,4,8,15,28,49,-21,20
Sydney FC,6814,1,21,4,3,65,22,43,67
N'castle Jet,6814,2,16,5,7,60,39,21,53
Melbourne C,6814,3,14,4,11,45,36,9,46
Melbourne V,6814,4,13,5,11,45,39,6,44
Adelaide Utd,6814,5,11,6,11,37,40,-3,39
Brisbane,6814,6,10,5,13,33,42,-9,35
Western Sydn,6814,7,8,9,10,38,47,-9,33
Perth Glory,6814,8,10,2,15,37,50,-13,32
Wellington P,6814,9,5,6,16,31,55,-24,21
CC Mariners,6814,10,4,8,15,28,49,-21,20
Sydney FC,6815,1,21,4,3,65,22,43,67
N'castle Jet,6815,2,16,5,7,58,37,21,53
Melbourne C,6815,3,14,4,11,43,34,9,46
Melbourne V,6815,4,13,5,11,45,39,6,44
Adelaide Utd,6815,5,11,6,11,37,40,-3,39
Brisbane,6815,6,10,5,13,33,42,-9,35
Western Sydn,6815,7,8,9,10,38,47,-9,33
Perth Glory,6815,8,10,2,15,37,50,-13,32
Wellington P,6815,9,5,6,16,31,55,-24,21
CC Mariners,6815,10,4,8,15,28,49,-21,20
Sydney FC,6816,1,21,4,3,66,22,44,67
N'castle Jet,6816,2,15,5,8,57,38,19,50
Melbourne C,6816,3,15,4,10,44,33,11,49
Melbourne V,6816,4,13,5,11,45,40,5,44
Adelaide Utd,6816,5,11,6,11,37,40,-3,39
Brisbane,6816,6,10,5,13,33,42,-9,35
Western Sydn,6816,7,8,9,10,38,47,-9,33
Perth Glory,6816,8,10,2,15,37,50,-13,32
Wellington P,6816,9,5,6,16,31,55,-24,21
CC Mariners,6816,10,4,8,15,28,49,-21,20
Sydney FC,6817,1,20,5,3,65,23,42,65
N'castle Jet,6817,2,16,5,7,59,37,22,53
Melbourne C,6817,3,14,4,11,43,35,8,46
Melbourne V,6817,4,13,6,10,46,39,7,45
Adelaide Utd,6817,5,11,6,11,37,40,-3,39
Brisbane,6817,6,10,5,13,33,42,-9,35
Western Sydn,6817,7,8,9,10,38,47,-9,33
Perth Glory,6817,8,10,2,15,37,50,-13,32
Wellington P,6817,9,5,6,16,31,55,-24,21
CC Mariners,6817,10,4,8,15,28,49,-21,20
Sydney FC,6818,1,21,4,3,68,23,45,67
N'castle Jet,6818,2,16,5,7,60,37,23,53
Melbourne C,6818,3,14,4,11,43,36,7,46
Melbourne V,6818,4,13,5,11,46,42,4,44
Adelaide Utd,6818,5,11,6,11,37,40,-3,39
Brisbane,6818,6,10,5,13,33,42,-9,35
Western Sydn,6818,7,8,9,10,38,47,-9,33
Perth Glory,6818,8,10,2,15,37,50,-13,32
Wellington P,6818,9,5,6,16,31,55,-24,21
CC Mariners,6818,10,4,8,15,28,49,-21,20
Sydney FC,6819,1,20,5,3,64,22,42,65
N'castle Jet,6819,2,16,5,7,60,37,23,53
Melbourne C,6819,3,14,4,11,43,36,7,46
Melbourne V,6819,4,13,6,10,45,38,7,45
Adelaide Utd,6819,5,11,6,11,37,40,-3,39
Brisbane,6819,6,10,5,13,33,42,-9,35
Western Sydn,6819,7,8,9,10,38,47,-9,33
Perth Glory,6819,8,10,2,15,37,50,-13,32
Wellington P,6819,9,5,6,16,31,55,-24,21
CC Mariners,6819,10,4,8,15,28,49,-21,20
Sydney FC,6820,1,21,4,3,69,22,47,67
N'castle Jet,6820,2,15,6,7,58,38,20,51
Melbourne C,6820,3,14,5,10,44,34,10,47
Melbourne V,6820,4,13,5,11,45,43,2,44
Adelaide Utd,6820,5,11,6,11,37,40,-3,39
Brisbane,6820,6,10,5,13,33,42,-9,35
Western Sydn,6820,7,8,9,10,38,47,-9,33
Perth Glory,6820,8,10,2,15,37,50,-13,32
Wellington P,6820,9,5,6,16,31,55,-24,21
CC Mariners,6820,10,4,8,15,28,49,-21,20
Sydney FC,6821,1,21,4,3,66,23,43,67
N'castle Jet,6821,2,15,5,8,58,40,18,50
Melbourne C,6821,3,15,4,10,46,34,12,49
Melbourne V,6821,4,13,5,11,46,40,6,44
Adelaide Utd,6821,5,11,6,11,37,40,-3,39
Brisbane,6821,6,10,5,13,33,42,-9,35
Western Sydn,6821,7,8,9,10,38,47,-9,33
Perth Glory,6821,8,10,2,15,37,50,-13,32
Wellington P,6821,9,5,6,16,31,55,-24,21
CC Mariners,6821,10,4,8,15,28,49,-21,20
Sydney FC,6822,1,21,4,3,69,22,47,67
N'castle Jet,6822,2,16,5,7,60,37,23,53
Melbourne C,6822,3,14,4,11,43,36,7,46
Melbourne V,6822,4,13,5,11,45,43,2,44
Adelaide Utd,6822,5,11,6,11,37,40,-3,39
Brisbane,6822,6,10,5,13,33,42,-9,35
Western Sydn,6822,7,8,9,10,38,47,-9,33
Perth Glory,6822,8,10,2,15,37,50,-13,32
Wellington P,6822,9,5,6,16,31,55,-24,21
CC Mariners,6822,10,4,8,15,28,49,-21,20
Sydney FC,6823,1,21,4,3,66,23,43,67
N'castle Jet,6823,2,16,5,7,58,37,21,53
Melbourne C,6823,3,14,4,11,43,34,9,46
Melbourne V,6823,4,13,5,11,46,40,6,44
Adelaide Utd,6823,5,11,6,11,37,40,-3,39
Brisbane,6823,6,10,5,13,33,42,-9,35
Western Sydn,6823,7,8,9,10,38,47,-9,33
Perth Glory,6823,8,10,2,15,37,50,-13,32
Wellington P,6823,9,5,6,16,31,55,-24,21
CC Mariners,6823,10,4,8,15,28,49,-21,20
Sydney FC,6824,1,21,4,3,65,22,43,67
N'castle Jet,6824,2,15,5,8,58,39,19,50
Melbourne C,6824,3,15,4,10,45,34,11,49
Melbourne V,6824,4,13,5,11,45,39,6,44
Adelaide Utd,6824,5,11,6,11,37,40,-3,39
Brisbane,6824,6,10,5,13,33,42,-9,35
Western Sydn,6824,7,8,9,10,38,47,-9,33
Perth Glory,6824,8,10,2,15,37,50,-13,32
Wellington P,6824,9,5,6,16,31,55,-24,21
CC Mariners,6824,10,4,8,15,28,49,-21,20
Sydney FC,6825,1,21,4,3,69,24,45,67
N'castle Jet,6825,2,15,5,8,58,39,19,50
Melbourne C,6825,3,15,4,10,45,34,11,49
Melbourne V,6825,4,13,5,11,47,43,4,44
Adelaide Utd,6825,5,11,6,11,37,40,-3,39
Brisbane,6825,6,10,5,13,33,42,-9,35
Western Sydn,6825,7,8,9,10,38,47,-9,33
Perth Glory,6825,8,10,2,15,37,50,-13,32
Wellington P,6825,9,5,6,16,31,55,-24,21
CC Mariners,6825,10,4,8,15,28,49,-21,20
Sydney FC,6826,1,21,4,3,65,22,43,67
N'castle Jet,6826,2,15,6,7,58,38,20,51
Melbourne C,6826,3,14,5,10,44,34,10,47
Melbourne V,6826,4,13,5,11,45,39,6,44
Adelaide Utd,6826,5,11,6,11,37,40,-3,39
Brisbane,6826,6,10,5,13,33,42,-9,35
Western Sydn,6826,7,8,9,10,38,47,-9,33
Perth Glory,6826,8,10,2,15,37,50,-13,32
Wellington P,6826,9,5,6,16,31,55,-24,21
CC Mariners,6826,10,4,8,15,28,49,-21,20
Sydney FC,6827,1,20,5,3,65,23,42,65
N'castle Jet,6827,2,15,5,8,57,41,16,50
Melbourne C,6827,3,15,4,10,47,33,14,49
Melbourne V,6827,4,13,6,10,46,39,7,45
Adelaide Utd,6827,5,11,6,11,37,40,-3,39
Brisbane,6827,6,10,5,13,33,42,-9,35
Western Sydn,6827,7,8,9,10,38,47,-9,33
Perth Glory,6827,8,10,2,15,37,50,-13,32
Wellington P,6827,9,5,6,16,31,55,-24,21
CC Mariners,6827,10,4,8,15,28,49,-21,20
Sydney FC,6828,1,20,4,4,65,24,41,64
N'castle Jet,6828,2,15,6,7,57,37,20,51
Melbourne C,6828,3,14,5,10,43,33,10,47
Melbourne V,6828,4,14,5,10,47,39,8,47
Adelaide Utd,6828,5,11,6,11,37,40,-3,39
Brisbane,6828,6,10,5,13,33,42,-9,35
Western Sydn,6828,7,8,9,10,38,47,-9,33
Perth Glory,6828,8,10,2,15,37,50,-13,32
Wellington P,6828,9,5,6,16,31,55,-24,21
CC Mariners,6828,10,4,8,15,28,49,-21,20
Sydney FC,6829,1,21,4,3,70,23,47,67
N'castle Jet,6829,2,16,5,7,58,37,21,53
Melbourne C,6829,3,14,4,11,43,34,9,46
Melbourne V,6829,4,13,5,11,46,44,2,44
Adelaide Utd,6829,5,11,6,11,37,40,-3,39
Brisbane,6829,6,10,5,13,33,42,-9,35
Western Sydn,6829,7,8,9,10,38,47,-9,33
Perth Glory,6829,8,10,2,15,37,50,-13,32
Wellington P,6829,9,5,6,16,31,55,-24,21
CC Mariners,6829,10,4,8,15,28,49,-21,20
Sydney FC,6830,1,21,4,3,68,24,44,67
N'castle Jet,6830,2,16,5,7,59,38,21,53
Melbourne C,6830,3,14,4,11,44,35,9,46
Melbourne V,6830,4,13,5,11,47,42,5,44
Adelaide Utd,6830,5,11,6,11,37,40,-3,39
Brisbane,6830,6,10,5,13,33,42,-9,35
Western Sydn,6830,7,8,9,10,38,47,-9,33
Perth Glory,6830,8,10,2,15,37,50,-13,32
Wellington P,6830,9,5,6,16,31,55,-24,21
CC Mariners,6830,10,4,8,15,28,49,-21,20
Sydney FC,6831,1,20,4,4,64,23,41,64
N'castle Jet,6831,2,15,6,7,60,40,20,51
Melbourne C,6831,3,14,5,10,46,36,10,47
Melbourne V,6831,4,14,5,10,46,38,8,47
Adelaide Utd,6831,5,11,6,11,37,40,-3,39
Brisbane,6831,6,10,5,13,33,42,-9,35
Western Sydn,6831,7,8,9,10,38,47,-9,33
Perth Glory,6831,8,10,2,15,37,50,-13,32
Wellington P,6831,9,5,6,16,31,55,-24,21
CC Mariners,6831,10,4,8,15,28,49,-21,20
Sydney FC,6832,1,21,4,3,71,22,49,67
N'castle Jet,6832,2,16,5,7,58,37,21,53
Melbourne C,6832,3,14,4,11,43,34,9,46
Melbourne V,6832,4,13,5,11,45,45,0,44
Adelaide Utd,6832,5,11,6,11,37,40,-3,39
Brisbane,6832,6,10,5,13,33,42,-9,35
Western Sydn,6832,7,8,9,10,38,47,-9,33
Perth Glory,6832,8,10,2,15,37,50,-13,32
Wellington P,6832,9,5,6,16,31,55,-24,21
CC Mariners,6832,10,4,8,15,28,49,-21,20
Sydney FC,6833,1,20,4,4,65,24,41,64
N'castle Jet,6833,2,15,6,7,60,40,20,51
Melbourne C,6833,3,14,5,10,46,36,10,47
Melbourne V,6833,4,14,5,10,47,39,8,47
Adelaide Utd,6833,5,11,6,11,37,40,-3,39
Brisbane,6833,6,10,5,13,33,42,-9,35
Western Sydn,6833,7,8,9,10,38,47,-9,33
Perth Glory,6833,8,10,2,15,37,50,-13,32
Wellington P,6833,9,5,6,16,31,55,-24,21
CC Mariners,6833,10,4,8,15,28,49,-21,20
Sydney FC,6834,1,21,4,3,66,23,43,67
N'castle Jet,6834,2,16,5,7,59,37,22,53
Melbourne C,6834,3,14,4,11,43,35,8,46
Melbourne V,6834,4,13,5,11,46,40,6,44
Adelaide Utd,6834,5,11,6,11,37,40,-3,39
Brisbane,6834,6,10,5,13,33,42,-9,35
Western Sydn,6834,7,8,9,10,38,47,-9,33
Perth Glory,6834,8,10,2,15,37,50,-13,32
Wellington P,6834,9,5,6,16,31,55,-24,21
CC Mariners,6834,10,4,8,15,28,49,-21,20
Sydney FC,6835,1,21,4,3,68,23,45,67
N'castle Jet,6835,2,16,5,7,59,38,21,53
Melbourne C,6835,3,14,4,11,44,35,9,46
Melbourne V,6835,4,13,5,11,46,42,4,44
Adelaide Utd,6835,5,11,6,11,37,40,-3,39
Brisbane,6835,6,10,5,13,33,42,-9,35
Western Sydn,6835,7,8,9,10,38,47,-9,33
Perth Glory,6835,8,10,2,15,37,50,-13,32
Wellington P,6835,9,5,6,16,31,55,-24,21
CC Mariners,6835,10,4,8,15,28,49,-21,20
Sydney FC,6836,1,21,4,3,66,23,43,67
N'castle Jet,6836,2,16,5,7,60,38,22,53
Melbourne C,6836,3,14,4,11,44,36,8,46
Melbourne V,6836,4,13,5,11,46,40,6,44
Adelaide Utd,6836,5,11,6,11,37,40,-3,39
Brisbane,6836,6,10,5,13,33,42,-9,35
Western Sydn,6836,7,8,9,10,38,47,-9,33
Perth Glory,6836,8,10,2,15,37,50,-13,32
Wellington P,6836,9,5,6,16,31,55,-24,21
CC Mariners,6836,10,4,8,15,28,49,-21,20
Sydney FC,6837,1,20,5,3,67,25,42,65
N'castle Jet,6837,2,16,5,7,59,38,21,53
Melbourne C,6837,3,14,4,11,44,35,9,46
Melbourne V,6837,4,13,6,10,48,41,7,45
Adelaide Utd,6837,5,11,6,11,37,40,-3,39
Brisbane,6837,6,10,5,13,33,42,-9,35
Western Sydn,6837,7,8,9,10,38,47,-9,33
Perth Glory,6837,8,10,2,15,37,50,-13,32
Wellington P,6837,9,5,6,16,31,55,-24,21
CC Mariners,6837,10,4,8,15,28,49,-21,20
Sydney FC,6838,1,21,4,3,68,22,46,67
N'castle Jet,6838,2,16,5,7,59,38,21,53
Melbourne C,6838,3,14,4,11,44,35,9,46
Melbourne V,6838,4,13,5,11,45,42,3,44
Adelaide Utd,6838,5,11,6,11,37,40,-3,39
Brisbane,6838,6,10,5,13,33,42,-9,35
Western Sydn,6838,7,8,9,10,38,47,-9,33
Perth Glory,6838,8,10,2,15,37,50,-13,32
Wellington P,6838,9,5,6,16,31,55,-24,21
CC Mariners,6838,10,4,8,15,28,49,-21,20
Sydney FC,6839,1,21,4,3,66,23,43,67
N'castle Jet,6839,2,16,5,7,59,37,22,53
Melbourne C,6839,3,14,4,11,43,35,8,46
Melbourne V,6839,4,13,5,11,46,40,6,44
Adelaide Utd,6839,5,11,6,11,37,40,-3,39
Brisbane,6839,6,10,5,13,33,42,-9,35
Western Sydn,6839,7,8,9,10,38,47,-9,33
Perth Glory,6839,8,10,2,15,37,50,-13,32
Wellington P,6839,9,5,6,16,31,55,-24,21
CC Mariners,6839,10,4,8,15,28,49,-21,20
Sydney FC,6840,1,21,4,3,65,22,43,67
N'castle Jet,6840,2,16,5,7,59,38,21,53
Melbourne C,6840,3,14,4,11,44,35,9,46
Melbourne V,6840,4,13,5,11,45,39,6,44
Adelaide Utd,6840,5,11,6,11,37,40,-3,39
Brisbane,6840,6,10,5,13,33,42,-9,35
Western Sydn,6840,7,8,9,10,38,47,-9,33
Perth Glory,6840,8,10,2,15,37,50,-13,32
Wellington P,6840,9,5,6,16,31,55,-24,21
CC Mariners,6840,10,4,8,15,28,49,-21,20
Sydney FC,6841,1,20,5,3,65,23,42,65
N'castle Jet,6841,2,16,5,7,60,39,21,53
Melbourne C,6841,3,14,4,11,45,36,9,46
Melbourne V,6841,4,13,6,10,46,39,7,45
Adelaide Utd,6841,5,11,6,11,37,40,-3,39
Brisbane,6841,6,10,5,13,33,42,-9,35
Western Sydn,6841,7,8,9,10,38,47,-9,33
Perth Glory,6841,8,10,2,15,37,50,-13,32
Wellington P,6841,9,5,6,16,31,55,-24,21
CC Mariners,6841,10,4,8,15,28,49,-21,20
Sydney FC,6842,1,20,5,3,66,24,42,65
N'castle Jet,6842,2,16,5,7,58,37,21,53
Melbourne C,6842,3,14,4,11,43,34,9,46
Melbourne V,6842,4,13,6,10,47,40,7,45
Adelaide Utd,6842,5,11,6,11,37,40,-3,39
Brisbane,6842,6,10,5,13,33,42,-9,35
Western Sydn,6842,7,8,9,10,38,47,-9,33
Perth Glory,6842,8,10,2,15,37,50,-13,32
Wellington P,6842,9,5,6,16,31,55,-24,21
CC Mariners,6842,10,4,8,15,28,49,-21,20
Sydney FC,6843,1,21,4,3,67,22,45,67
N'castle Jet,6843,2,15,6,7,58,38,20,51
Melbourne C,6843,3,14,5,10,44,34,10,47
Melbourne V,6843,4,13,5,11,45,41,4,44
Adelaide Utd,6843,5,11,6,11,37,40,-3,39
Brisbane,6843,6,10,5,13,33,42,-9,35
Western Sydn,6843,7,8,9,10,38,47,-9,33
Perth Glory,6843,8,10,2,15,37,50,-13,32
Wellington P,6843,9,5,6,16,31,55,-24,21
CC Mariners,6843,10,4,8,15,28,49,-21,20
Sydney FC,6844,1,20,5,3,66,24,42,65
N'castle Jet,6844,2,16,5,7,61,40,21,53
Melbourne C,6844,3,14,4,11,46,37,9,46
Melbourne V,6844,4,13,6,10,47,40,7,45
Adelaide Utd,6844,5,11,6,11,37,40,-3,39
Brisbane,6844,6,10,5,13,33,42,-9,35
Western Sydn,6844,7,8,9,10,38,47,-9,33
Perth Glory,6844,8,10,2,15,37,50,-13,32
Wellington P,6844,9,5,6,16,31,55,-24,21
CC Mariners,6844,10,4,8,15,28,49,-21,20
Sydney FC,6845,1,21,4,3,67,23,44,67
N'castle Jet,6845,2,15,6,7,59,39,20,51
Melbourne C,6845,3,14,5,10,45,35,10,47
Melbourne V,6845,4,13,5,11,46,41,5,44
Adelaide Utd,6845,5,11,6,11,37,40,-3,39
Brisbane,6845,6,10,5,13,33,42,-9,35
Western Sydn,6845,7,8,9,10,38,47,-9,33
Perth Glory,6845,8,10,2,15,37,50,-13,32
Wellington P,6845,9,5,6,16,31,55,-24,21
CC Mariners,6845,10,4,8,15,28,49,-21,20
Sydney FC,6846,1,21,4,3,68,22,46,67
N'castle Jet,6846,2,16,5,7,61,39,22,53
Melbourne C,6846,3,14,4,11,45,37,8,46
Melbourne V,6846,4,13,5,11,45,42,3,44
Adelaide Utd,6846,5,11,6,11,37,40,-3,39
Brisbane,6846,6,10,5,13,33,42,-9,35
Western Sydn,6846,7,8,9,10,38,47,-9,33
Perth Glory,6846,8,10,2,15,37,50,-13,32
Wellington P,6846,9,5,6,16,31,55,-24,21
CC Mariners,6846,10,4,8,15,28,49,-21,20
Sydney FC,6847,1,21,4,3,66,22,44,67
N'castle Jet,6847,2,16,5,7,59,38,21,53
Melbourne C,6847,3,14,4,11,44,35,9,46
Melbourne V,6847,4,13,5,11,45,40,5,44
Adelaide Utd,6847,5,11,6,11,37,40,-3,39
Brisbane,6847,6,10,5,13,33,42,-9,35
Western Sydn,6847,7,8,9,10,38,47,-9,33
Perth Glory,6847,8,10,2,15,37,50,-13,32
Wellington P,6847,9,5,6,16,31,55,-24,21
CC Mariners,6847,10,4,8,15,28,49,-21,20
Sydney FC,6848,1,21,4,3,65,22,43,67
N'castle Jet,6848,2,15,5,8,57,40,17,50
Melbourne C,6848,3,15,4,10,46,33,13,49
Melbourne V,6848,4,13,5,11,45,39,6,44
Adelaide Utd,6848,5,11,6,11,37,40,-3,39
Brisbane,6848,6,10,5,13,33,42,-9,35
Western Sydn,6848,7,8,9,10,38,47,-9,33
Perth Glory,6848,8,10,2,15,37,50,-13,32
Wellington P,6848,9,5,6,16,31,55,-24,21
CC Mariners,6848,10,4,8,15,28,49,-21,20
Sydney FC,6849,1,20,4,4,67,26,41,64
N'castle Jet,6849,2,16,5,7,58,37,21,53
Melbourne V,6849,3,14,5,10,49,41,8,47
Melbourne C,6849,4,14,4,11,43,34,9,46
Adelaide Utd,6849,5,11,6,11,37,40,-3,39
Brisbane,6849,6,10,5,13,33,42,-9,35
Western Sydn,6849,7,8,9,10,38,47,-9,33
Perth Glory,6849,8,10,2,15,37,50,-13,32
Wellington P,6849,9,5,6,16,31,55,-24,21
CC Mariners,6849,10,4,8,15,28,49,-21,20
Sydney FC,6850,1,21,4,3,67,22,45,67
N'castle Jet,6850,2,16,5,7,58,37,21,53
Melbourne C,6850,3,14,4,11,43,34,9,46
Melbourne V,6850,4,13,5,11,45,41,4,44
Adelaide Utd,6850,5,11,6,11,37,40,-3,39
Brisbane,6850,6,10,5,13,33,42,-9,35
Western Sydn,6850,7,8,9,10,38,47,-9,33
Perth Glory,6850,8,10,2,15,37,50,-13,32
Wellington P,6850,9,5,6,16,31,55,-24,21
CC Mariners,6850,10,4,8,15,28,49,-21,20
Sydney FC,6851,1,21,4,3,66,23,43,67
N'castle Jet,6851,2,15,6,7,58,38,20,51
Melbourne C,6851,3,14,5,10,44,34,10,47
Melbourne V,6851,4,13,5,11,46,40,6,44
Adelaide Utd,6851,5,11,6,11,37,40,-3,39
Brisbane,6851,6,10,5,13,33,42,-9,35
Western Sydn,6851,7,8,9,10,38,47,-9,33
Perth Glory,6851,8,10,2,15,37,50,-13,32
Wellington P,6851,9,5,6,16,31,55,-24,21
CC Mariners,6851,10,4,8,15,28,49,-21,20
Sydney FC,6852,1,20,4,4,65,24,41,64
N'castle Jet,6852,2,16,5,7,59,37,22,53
Melbourne V,6852,3,14,5,10,47,39,8,47
Melbourne C,6852,4,14,4,11,43,35,8,46
Adelaide Utd,6852,5,11,6,11,37,40,-3,39
Brisbane,6852,6,10,5,13,33,42,-9,35
Western Sydn,6852,7,8,9,10,38,47,-9,33
Perth Glory,6852,8,10,2,15,37,50,-13,32
Wellington P,6852,9,5,6,16,31,55,-24,21
CC Mariners,6852,10,4,8,15,28,49,-21,20
Sydney FC,6853,1,20,5,3,65,23,42,65
N'castle Jet,6853,2,16,5,7,61,38,23,53
Melbourne C,6853,3,14,4,11,44,37,7,46
Melbourne V,6853,4,13,6,10,46,39,7,45
Adelaide Utd,6853,5,11,6,11,37,40,-3,39
Brisbane,6853,6,10,5,13,33,42,-9,35
Western Sydn,6853,7,8,9,10,38,47,-9,33
Perth Glory,6853,8,10,2,15,37,50,-13,32
Wellington P,6853,9,5,6,16,31,55,-24,21
CC Mariners,6853,10,4,8,15,28,49,-21,20
Sydney FC,6854,1,21,4,3,66,23,43,67
N'castle Jet,6854,2,16,5,7,60,38,22,53
Melbourne C,6854,3,14,4,11,44,36,8,46
Melbourne V,6854,4,13,5,11,46,40,6,44
Adelaide Utd,6854,5,11,6,11,37,40,-3,39
Brisbane,6854,6,10,5,13,33,42,-9,35
Western Sydn,6854,7,8,9,10,38,47,-9,33
Perth Glory,6854,8,10,2,15,37,50,-13,32
Wellington P,6854,9,5,6,16,31,55,-24,21
CC Mariners,6854,10,4,8,15,28,49,-21,20
Sydney FC,6855,1,21,4,3,68,22,46,67
N'castle Jet,6855,2,15,5,8,57,39,18,50
Melbourne C,6855,3,15,4,10,45,33,12,49
Melbourne V,6855,4,13,5,11,45,42,3,44
Adelaide Utd,6855,5,11,6,11,37,40,-3,39
Brisbane,6855,6,10,5,13,33,42,-9,35
Western Sydn,6855,7,8,9,10,38,47,-9,33
Perth Glory,6855,8,10,2,15,37,50,-13,32
Wellington P,6855,9,5,6,16,31,55,-24,21
CC Mariners,6855,10,4,8,15,28,49,-21,20
Sydney FC,6856,1,21,4,3,66,23,43,67
N'castle Jet,6856,2,16,5,7,58,37,21,53
Melbourne C,6856,3,14,4,11,43,34,9,46
Melbourne V,6856,4,13,5,11,46,40,6,44
Adelaide Utd,6856,5,11,6,11,37,40,-3,39
Brisbane,6856,6,10,5,13,33,42,-9,35
Western Sydn,6856,7,8,9,10,38,47,-9,33
Perth Glory,6856,8,10,2,15,37,50,-13,32
Wellington P,6856,9,5,6,16,31,55,-24,21
CC Mariners,6856,10,4,8,15,28,49,-21,20
Sydney FC,6857,1,20,5,3,65,23,42,65
N'castle Jet,6857,2,15,5,8,58,40,18,50
Melbourne C,6857,3,15,4,10,46,34,12,49
Melbourne V,6857,4,13,6,10,46,39,7,45
Adelaide Utd,6857,5,11,6,11,37,40,-3,39
Brisbane,6857,6,10,5,13,33,42,-9,35
Western Sydn,6857,7,8,9,10,38,47,-9,33
Perth Glory,6857,8,10,2,15,37,50,-13,32
Wellington P,6857,9,5,6,16,31,55,-24,21
CC Mariners,6857,10,4,8,15,28,49,-21,20
Sydney FC,6858,1,20,4,4,64,24,40,64
N'castle Jet,6858,2,16,5,7,58,37,21,53
Melbourne V,6858,3,14,5,10,47,38,9,47
Melbourne C,6858,4,14,4,11,43,34,9,46
Adelaide Utd,6858,5,11,6,11,37,40,-3,39
Brisbane,6858,6,10,5,13,33,42,-9,35
Western Sydn,6858,7,8,9,10,38,47,-9,33
Perth Glory,6858,8,10,2,15,37,50,-13,32
Wellington P,6858,9,5,6,16,31,55,-24,21
CC Mariners,6858,10,4,8,15,28,49,-21,20
Sydney FC,6859,1,21,4,3,66,22,44,67
N'castle Jet,6859,2,15,6,7,57,37,20,51
Melbourne C,6859,3,14,5,10,43,33,10,47
Melbourne V,6859,4,13,5,11,45,40,5,44
Adelaide Utd,6859,5,11,6,11,37,40,-3,39
Brisbane,6859,6,10,5,13,33,42,-9,35
Western Sydn,6859,7,8,9,10,38,47,-9,33
Perth Glory,6859,8,10,2,15,37,50,-13,32
Wellington P,6859,9,5,6,16,31,55,-24,21
CC Mariners,6859,10,4,8,15,28,49,-21,20
Sydney FC,6860,1,21,4,3,66,22,44,67
N'castle Jet,6860,2,15,6,7,58,38,20,51
Melbourne C,6860,3,14,5,10,44,34,10,47
Melbourne V,6860,4,13,5,11,45,40,5,44
Adelaide Utd,6860,5,11,6,11,37,40,-3,39
Brisbane,6860,6,10,5,13,33,42,-9,35
Western Sydn,6860,7,8,9,10,38,47,-9,33
Perth Glory,6860,8,10,2,15,37,50,-13,32
Wellington P,6860,9,5,6,16,31,55,-24,21
CC Mariners,6860,10,4,8,15,28,49,-21,20
Sydney FC,6861,1,20,4,4,65,25,40,64
N'castle Jet,6861,2,16,5,7,58,37,21,53
Melbourne V,6861,3,14,5,10,48,39,9,47
Melbourne C,6861,4,14,4,11,43,34,9,46
Adelaide Utd,6861,5,11,6,11,37,40,-3,39
Brisbane,6861,6,10,5,13,33,42,-9,35
Western Sydn,6861,7,8,9,10,38,47,-9,33
Perth Glory,6861,8,10,2,15,37,50,-13,32
Wellington P,6861,9,5,6,16,31,55,-24,21
CC Mariners,6861,10,4,8,15,28,49,-21,20
Sydney FC,6862,1,20,5,3,66,24,42,65
N'castle Jet,6862,2,16,5,7,59,37,22,53
Melbourne C,6862,3,14,4,11,43,35,8,46
Melbourne V,6862,4,13,6,10,47,40,7,45
Adelaide Utd,6862,5,11,6,11,37,40,-3,39
Brisbane,6862,6,10,5,13,33,42,-9,35
Western Sydn,6862,7,8,9,10,38,47,-9,33
Perth Glory,6862,8,10,2,15,37,50,-13,32
Wellington P,6862,9,5,6,16,31,55,-24,21
CC Mariners,6862,10,4,8,15,28,49,-21,20
Sydney FC,6863,1,21,4,3,67,24,43,67
N'castle Jet,6863,2,16,5,7,60,38,22,53
Melbourne C,6863,3,14,4,11,44,36,8,46
Melbourne V,6863,4,13,5,11,47,41,6,44
Adelaide Utd,6863,5,11,6,11,37,40,-3,39
Brisbane,6863,6,10,5,13,33,42,-9,35
Western Sydn,6863,7,8,9,10,38,47,-9,33
Perth Glory,6863,8,10,2,15,37,50,-13,32
Wellington P,6863,9,5,6,16,31,55,-24,21
CC Mariners,6863,10,4,8,15,28,49,-21,20
Sydney FC,6864,1,20,4,4,64,23,41,64
N'castle Jet,6864,2,15,5,8,58,39,19,50
Melbourne C,6864,3,15,4,10,45,34,11,49
Melbourne V,6864,4,14,5,10,46,38,8,47
Adelaide Utd,6864,5,11,6,11,37,40,-3,39
Brisbane,6864,6,10,5,13,33,42,-9,35
Western Sydn,6864,7,8,9,10,38,47,-9,33
Perth Glory,6864,8,10,2,15,37,50,-13,32
Wellington P,6864,9,5,6,16,31,55,-24,21
CC Mariners,6864,10,4,8,15,28,49,-21,20
Sydney FC,6865,1,21,4,3,67,22,45,67
N'castle Jet,6865,2,16,5,7,60,37,23,53
Melbourne C,6865,3,14,4,11,43,36,7,46
Melbourne V,6865,4,13,5,11,45,41,4,44
Adelaide Utd,6865,5,11,6,11,37,40,-3,39
Brisbane,6865,6,10,5,13,33,42,-9,35
Western Sydn,6865,7,8,9,10,38,47,-9,33
Perth Glory,6865,8,10,2,15,37,50,-13,32
Wellington P,6865,9,5,6,16,31,55,-24,21
CC Mariners,6865,10,4,8,15,28,49,-21,20
Sydney FC,6866,1,20,5,3,66,24,42,65
N'castle Jet,6866,2,16,5,7,60,38,22,53
Melbourne C,6866,3,14,4,11,44,36,8,46
Melbourne V,6866,4,13,6,10,47,40,7,45
Adelaide Utd,6866,5,11,6,11,37,40,-3,39
Brisbane,6866,6,10,5,13,33,42,-9,35
Western Sydn,6866,7,8,9,10,38,47,-9,33
Perth Glory,6866,8,10,2,15,37,50,-13,32
Wellington P,6866,9,5,6,16,31,55,-24,21
CC Mariners,6866,10,4,8,15,28,49,-21,20
Sydney FC,6867,1,21,4,3,65,22,43,67
N'castle Jet,6867,2,15,6,7,57,37,20,51
Melbourne C,6867,3,14,5,10,43,33,10,47
Melbourne V,6867,4,13,5,11,45,39,6,44
Adelaide Utd,6867,5,11,6,11,37,40,-3,39
Brisbane,6867,6,10,5,13,33,42,-9,35
Western Sydn,6867,7,8,9,10,38,47,-9,33
Perth Glory,6867,8,10,2,15,37,50,-13,32
Wellington P,6867,9,5,6,16,31,55,-24,21
CC Mariners,6867,10,4,8,15,28,49,-21,20
Sydney FC,6868,1,21,4,3,67,24,43,67
N'castle Jet,6868,2,15,5,8,57,38,19,50
Melbourne C,6868,3,15,4,10,44,33,11,49
Melbourne V,6868,4,13,5,11,47,41,6,44
Adelaide Utd,6868,5,11,6,11,37,40,-3,39
Brisbane,6868,6,10,5,13,33,42,-9,35
Western Sydn,6868,7,8,9,10,38,47,-9,33
Perth Glory,6868,8,10,2,15,37,50,-13,32
Wellington P,6868,9,5,6,16,31,55,-24,21
CC Mariners,6868,10,4,8,15,28,49,-21,20
Sydney FC,6869,1,21,4,3,67,23,44,67
N'castle Jet,6869,2,16,5,7,60,37,23,53
Melbourne C,6869,3,14,4,11,43,36,7,46
Melbourne V,6869,4,13,5,11,46,41,5,44
Adelaide Utd,6869,5,11,6,11,37,40,-3,39
Brisbane,6869,6,10,5,13,33,42,-9,35
Western Sydn,6869,7,8,9,10,38,47,-9,33
Perth Glory,6869,8,10,2,15,37,50,-13,32
Wellington P,6869,9,5,6,16,31,55,-24,21
CC Mariners,6869,10,4,8,15,28,49,-21,20
Sydney FC,6870,1,20,5,3,64,22,42,65
N'castle Jet,6870,2,16,5,7,58,37,21,53
Melbourne C,6870,3,14,4,11,43,34,9,46
Melbourne V,6870,4,13,6,10,45,38,7,45
Adelaide Utd,6870,5,11,6,11,37,40,-3,39
Brisbane,6870,6,10,5,13,33,42,-9,35
Western Sydn,6870,7,8,9,10,38,47,-9,33
Perth Glory,6870,8,10,2,15,37,50,-13,32
Wellington P,6870,9,5,6,16,31,55,-24,21
CC Mariners,6870,10,4,8,15,28,49,-21,20
Sydney FC,6871,1,21,4,3,69,23,46,67
N'castle Jet,6871,2,16,5,7,58,37,21,53
Melbourne C,6871,3,14,4,11,43,34,9,46
Melbourne V,6871,4,13,5,11,46,43,3,44
Adelaide Utd,6871,5,11,6,11,37,40,-3,39
Brisbane,6871,6,10,5,13,33,42,-9,35
Western Sydn,6871,7,8,9,10,38,47,-9,33
Perth Glory,6871,8,10,2,15,37,50,-13,32
Wellington P,6871,9,5,6,16,31,55,-24,21
CC Mariners,6871,10,4,8,15,28,49,-21,20
Sydney FC,6872,1,20,4,4,64,24,40,64
N'castle Jet,6872,2,16,5,7,58,37,21,53
Melbourne V,6872,3,14,5,10,47,38,9,47
Melbourne C,6872,4,14,4,11,43,34,9,46
Adelaide Utd,6872,5,11,6,11,37,40,-3,39
Brisbane,6872,6,10,5,13,33,42,-9,35
Western Sydn,6872,7,8,9,10,38,47,-9,33
Perth Glory,6872,8,10,2,15,37,50,-13,32
Wellington P,6872,9,5,6,16,31,55,-24,21
CC Mariners,6872,10,4,8,15,28,49,-21,20
Sydney FC,6873,1,21,4,3,68,23,45,67
N'castle Jet,6873,2,15,6,7,58,38,20,51
Melbourne C,6873,3,14,5,10,44,34,10,47
Melbourne V,6873,4,13,5,11,46,42,4,44
Adelaide Utd,6873,5,11,6,11,37,40,-3,39
Brisbane,6873,6,10,5,13,33,42,-9,35
Western Sydn,6873,7,8,9,10,38,47,-9,33
Perth Glory,6873,8,10,2,15,37,50,-13,32
Wellington P,6873,9,5,6,16,31,55,-24,21
CC Mariners,6873,10,4,8,15,28,49,-21,20
Sydney FC,6874,1,21,4,3,67,22,45,67
N'castle Jet,6874,2,15,5,8,59,40,19,50
Melbourne C,6874,3,15,4,10,46,35,11,49
Melbourne V,6874,4,13,5,11,45,41,4,44
Adelaide Utd,6874,5,11,6,11,37,40,-3,39
Brisbane,6874,6,10,5,13,33,42,-9,35
Western Sydn,6874,7,8,9,10,38,47,-9,33
Perth Glory,6874,8,10,2,15,37,50,-13,32
Wellington P,6874,9,5,6,16,31,55,-24,21
CC Mariners,6874,10,4,8,15,28,49,-21,20
Sydney FC,6875,1,20,4,4,64,24,40,64
N'castle Jet,6875,2,16,5,7,61,40,21,53
Melbourne V,6875,3,14,5,10,47,38,9,47
Melbourne C,6875,4,14,4,11,46,37,9,46
Adelaide Utd,6875,5,11,6,11,37,40,-3,39
Brisbane,6875,6,10,5,13,33,42,-9,35
Western Sydn,6875,7,8,9,10,38,47,-9,33
Perth Glory,6875,8,10,2,15,37,50,-13,32
Wellington P,6875,9,5,6,16,31,55,-24,21
CC Mariners,6875,10,4,8,15,28,49,-21,20
Sydney FC,6876,1,20,4,4,64,23,41,64
N'castle Jet,6876,2,15,5,8,57,41,16,50
Melbourne C,6876,3,15,4,10,47,33,14,49
Melbourne V,6876,4,14,5,10,46,38,8,47
Adelaide Utd,6876,5,11,6,11,37,40,-3,39
Brisbane,6876,6,10,5,13,33,42,-9,35
Western Sydn,6876,7,8,9,10,38,47,-9,33
Perth Glory,6876,8,10,2,15,37,50,-13,32
Wellington P,6876,9,5,6,16,31,55,-24,21
CC Mariners,6876,10,4,8,15,28,49,-21,20
Sydney FC,6877,1,21,4,3,69,22,47,67
N'castle Jet,6877,2,16,5,7,62,38,24,53
Melbourne C,6877,3,14,4,11,44,38,6,46
Melbourne V,6877,4,13,5,11,45,43,2,44
Adelaide Utd,6877,5,11,6,11,37,40,-3,39
Brisbane,6877,6,10,5,13,33,42,-9,35
Western Sydn,6877,7,8,9,10,38,47,-9,33
Perth Glory,6877,8,10,2,15,37,50,-13,32
Wellington P,6877,9,5,6,16,31,55,-24,21
CC Mariners,6877,10,4,8,15,28,49,-21,20
Sydney FC,6878,1,21,4,3,66,22,44,67
N'castle Jet,6878,2,15,5,8,58,41,17,50
Melbourne C,6878,3,15,4,10,47,34,13,49
Melbourne V,6878,4,13,5,11,45,40,5,44
Adelaide Utd,6878,5,11,6,11,37,40,-3,39
Brisbane,6878,6,10,5,13,33,42,-9,35
Western Sydn,6878,7,8,9,10,38,47,-9,33
Perth Glory,6878,8,10,2,15,37,50,-13,32
Wellington P,6878,9,5,6,16,31,55,-24,21
CC Mariners,6878,10,4,8,15,28,49,-21,20
Sydney FC,6879,1,21,4,3,69,25,44,67
N'castle Jet,6879,2,16,5,7,60,37,23,53
Melbourne C,6879,3,14,4,11,43,36,7,46
Melbourne V,6879,4,13,5,11,48,43,5,44
Adelaide Utd,6879,5,11,6,11,37,40,-3,39
Brisbane,6879,6,10,5,13,33,42,-9,35
Western Sydn,6879,7,8,9,10,38,47,-9,33
Perth Glory,6879,8,10,2,15,37,50,-13,32
Wellington P,6879,9,5,6,16,31,55,-24,21
CC Mariners,6879,10,4,8,15,28,49,-21,20
Sydney FC,6880,1,20,4,4,65,25,40,64
N'castle Jet,6880,2,15,6,7,58,38,20,51
Melbourne C,6880,3,14,5,10,44,34,10,47
Melbourne V,6880,4,14,5,10,48,39,9,47
Adelaide Utd,6880,5,11,6,11,37,40,-3,39
Brisbane,6880,6,10,5,13,33,42,-9,35
Western Sydn,6880,7,8,9,10,38,47,-9,33
Perth Glory,6880,8,10,2,15,37,50,-13,32
Wellington P,6880,9,5,6,16,31,55,-24,21
CC Mariners,6880,10,4,8,15,28,49,-21,20
Sydney FC,6881,1,21,4,3,65,22,43,67
N'castle Jet,6881,2,16,5,7,58,37,21,53
Melbourne C,6881,3,14,4,11,43,34,9,46
Melbourne V,6881,4,13,5,11,45,39,6,44
Adelaide Utd,6881,5,11,6,11,37,40,-3,39
Brisbane,6881,6,10,5,13,33,42,-9,35
Western Sydn,6881,7,8,9,10,38,47,-9,33
Perth Glory,6881,8,10,2,15,37,50,-13,32
Wellington P,6881,9,5,6,16,31,55,-24,21
CC Mariners,6881,10,4,8,15,28,49,-21,20
Sydney FC,6882,1,20,5,3,64,22,42,65
N'castle Jet,6882,2,15,5,8,59,40,19,50
Melbourne C,6882,3,15,4,10,46,35,11,49
Melbourne V,6882,4,13,6,10,45,38,7,45
Adelaide Utd,6882,5,11,6,11,37,40,-3,39
Brisbane,6882,6,10,5,13,33,42,-9,35
Western Sydn,6882,7,8,9,10,38,47,-9,33
Perth Glory,6882,8,10,2,15,37,50,-13,32
Wellington P,6882,9,5,6,16,31,55,-24,21
CC Mariners,6882,10,4,8,15,28,49,-21,20
Sydney FC,6883,1,21,4,3,69,23,46,67
N'castle Jet,6883,2,15,6,7,58,38,20,51
Melbourne C,6883,3,14,5,10,44,34,10,47
Melbourne V,6883,4,13,5,11,46,43,3,44
Adelaide Utd,6883,5,11,6,11,37,40,-3,39
Brisbane,6883,6,10,5,13,33,42,-9,35
Western Sydn,6883,7,8,9,10,38,47,-9,33
Perth Glory,6883,8,10,2,15,37,50,-13,32
Wellington P,6883,9,5,6,16,31,55,-24,21
CC Mariners,6883,10,4,8,15,28,49,-21,20
Sydney FC,6884,1,21,4,3,70,24,46,67
N'castle Jet,6884,2,15,6,7,57,37,20,51
Melbourne C,6884,3,14,5,10,43,33,10,47
Melbourne V,6884,4,13,5,11,47,44,3,44
Adelaide Utd,6884,5,11,6,11,37,40,-3,39
Brisbane,6884,6,10,5,13,33,42,-9,35
Western Sydn,6884,7,8,9,10,38,47,-9,33
Perth Glory,6884,8,10,2,15,37,50,-13,32
Wellington P,6884,9,5,6,16,31,55,-24,21
CC Mariners,6884,10,4,8,15,28,49,-21,20
Sydney FC,6885,1,21,4,3,67,22,45,67
N'castle Jet,6885,2,16,5,7,60,39,21,53
Melbourne C,6885,3,14,4,11,45,36,9,46
Melbourne V,6885,4,13,5,11,45,41,4,44
Adelaide Utd,6885,5,11,6,11,37,40,-3,39
Brisbane,6885,6,10,5,13,33,42,-9,35
Western Sydn,6885,7,8,9,10,38,47,-9,33
Perth Glory,6885,8,10,2,15,37,50,-13,32
Wellington P,6885,9,5,6,16,31,55,-24,21
CC Mariners,6885,10,4,8,15,28,49,-21,20
Sydney FC,6886,1,20,5,3,65,23,42,65
N'castle Jet,6886,2,16,5,7,58,37,21,53
Melbourne C,6886,3,14,4,11,43,34,9,46
Melbourne V,6886,4,13,6,10,46,39,7,45
Adelaide Utd,6886,5,11,6,11,37,40,-3,39
Brisbane,6886,6,10,5,13,33,42,-9,35
Western Sydn,6886,7,8,9,10,38,47,-9,33
Perth Glory,6886,8,10,2,15,37,50,-13,32
Wellington P,6886,9,5,6,16,31,55,-24,21
CC Mariners,6886,10,4,8,15,28,49,-21,20
Sydney FC,6887,1,21,4,3,67,22,45,67
N'castle Jet,6887,2,16,5,7,61,38,23,53
Melbourne C,6887,3,14,4,11,44,37,7,46
Melbourne V,6887,4,13,5,11,45,41,4,44
Adelaide Utd,6887,5,11,6,11,37,40,-3,39
Brisbane,6887,6,10,5,13,33,42,-9,35
Western Sydn,6887,7,8,9,10,38,47,-9,33
Perth Glory,6887,8,10,2,15,37,50,-13,32
Wellington P,6887,9,5,6,16,31,55,-24,21
CC Mariners,6887,10,4,8,15,28,49,-21,20
Sydney FC,6888,1,21,4,3,67,22,45,67
N'castle Jet,6888,2,16,5,7,59,38,21,53
Melbourne C,6888,3,14,4,11,44,35,9,46
Melbourne V,6888,4,13,5,11,45,41,4,44
Adelaide Utd,6888,5,11,6,11,37,40,-3,39
Brisbane,6888,6,10,5,13,33,42,-9,35
Western Sydn,6888,7,8,9,10,38,47,-9,33
Perth Glory,6888,8,10,2,15,37,50,-13,32
Wellington P,6888,9,5,6,16,31,55,-24,21
CC Mariners,6888,10,4,8,15,28,49,-21,20
Sydney FC,6889,1,21,4,3,66,23,43,67
N'castle Jet,6889,2,16,5,7,61,38,23,53
Melbourne C,6889,3,14,4,11,44,37,7,46
Melbourne V,6889,4,13,5,11,46,40,6,44
Adelaide Utd,6889,5,11,6,11,37,40,-3,39
Brisbane,6889,6,10,5,13,33,42,-9,35
Western Sydn,6889,7,8,9,10,38,47,-9,33
Perth Glory,6889,8,10,2,15,37,50,-13,32
Wellington P,6889,9,5,6,16,31,55,-24,21
CC Mariners,6889,10,4,8,15,28,49,-21,20
Sydney FC,6890,1,21,4,3,65,22,43,67
N'castle Jet,6890,2,15,5,8,59,40,19,50
Melbourne C,6890,3,15,4,10,46,35,11,49
Melbourne V,6890,4,13,5,11,45,39,6,44
Adelaide Utd,6890,5,11,6,11,37,40,-3,39
Brisbane,6890,6,10,5,13,33,42,-9,35
Western Sydn,6890,7,8,9,10,38,47,-9,33
Perth Glory,6890,8,10,2,15,37,50,-13,32
Wellington P,6890,9,5,6,16,31,55,-24,21
CC Mariners,6890,10,4,8,15,28,49,-21,20
Sydney FC,6891,1,21,4,3,68,22,46,67
N'castle Jet,6891,2,16,5,7,58,37,21,53
Melbourne C,6891,3,14,4,11,43,34,9,46
Melbourne V,6891,4,13,5,11,45,42,3,44
Adelaide Utd,6891,5,11,6,11,37,40,-3,39
Brisbane,6891,6,10,5,13,33,42,-9,35
Western Sydn,6891,7,8,9,10,38,47,-9,33
Perth Glory,6891,8,10,2,15,37,50,-13,32
Wellington P,6891,9,5,6,16,31,55,-24,21
CC Mariners,6891,10,4,8,15,28,49,-21,20
Sydney FC,6892,1,21,4,3,67,23,44,67
N'castle Jet,6892,2,16,5,7,62,41,21,53
Melbourne C,6892,3,14,4,11,47,38,9,46
Melbourne V,6892,4,13,5,11,46,41,5,44
Adelaide Utd,6892,5,11,6,11,37,40,-3,39
Brisbane,6892,6,10,5,13,33,42,-9,35
Western Sydn,6892,7,8,9,10,38,47,-9,33
Perth Glory,6892,8,10,2,15,37,50,-13,32
Wellington P,6892,9,5,6,16,31,55,-24,21
CC Mariners,6892,10,4,8,15,28,49,-21,20
Sydney FC,6893,1,21,4,3,68,22,46,67
N'castle Jet,6893,2,15,6,7,58,38,20,51
Melbourne C,6893,3,14,5,10,44,34,10,47
Melbourne V,6893,4,13,5,11,45,42,3,44
Adelaide Utd,6893,5,11,6,11,37,40,-3,39
Brisbane,6893,6,10,5,13,33,42,-9,35
Western Sydn,6893,7,8,9,10,38,47,-9,33
Perth Glory,6893,8,10,2,15,37,50,-13,32
Wellington P,6893,9,5,6,16,31,55,-24,21
CC Mariners,6893,10,4,8,15,28,49,-21,20
Sydney FC,6894,1,20,4,4,64,23,41,64
N'castle Jet,6894,2,16,5,7,58,37,21,53
Melbourne V,6894,3,14,5,10,46,38,8,47
Melbourne C,6894,4,14,4,11,43,34,9,46
Adelaide Utd,6894,5,11,6,11,37,40,-3,39
Brisbane,6894,6,10,5,13,33,42,-9,35
Western Sydn,6894,7,8,9,10,38,47,-9,33
Perth Glory,6894,8,10,2,15,37,50,-13,32
Wellington P,6894,9,5,6,16,31,55,-24,21
CC Mariners,6894,10,4,8,15,28,49,-21,20
Sydney FC,6895,1,21,4,3,68,23,45,67
N'castle Jet,6895,2,15,5,8,58,40,18,50
Melbourne C,6895,3,15,4,10,46,34,12,49
Melbourne V,6895,4,13,5,11,46,42,4,44
Adelaide Utd,6895,5,11,6,11,37,40,-3,39
Brisbane,6895,6,10,5,13,33,42,-9,35
Western Sydn,6895,7,8,9,10,38,47,-9,33
Perth Glory,6895,8,10,2,15,37,50,-13,32
Wellington P,6895,9,5,6,16,31,55,-24,21
CC Mariners,6895,10,4,8,15,28,49,-21,20
Sydney FC,6896,1,20,4,4,64,23,41,64
N'castle Jet,6896,2,16,5,7,60,37,23,53
Melbourne V,6896,3,14,5,10,46,38,8,47
Melbourne C,6896,4,14,4,11,43,36,7,46
Adelaide Utd,6896,5,11,6,11,37,40,-3,39
Brisbane,6896,6,10,5,13,33,42,-9,35
Western Sydn,6896,7,8,9,10,38,47,-9,33
Perth Glory,6896,8,10,2,15,37,50,-13,32
Wellington P,6896,9,5,6,16,31,55,-24,21
CC Mariners,6896,10,4,8,15,28,49,-21,20
Sydney FC,6897,1,21,4,3,67,24,43,67
N'castle Jet,6897,2,15,6,7,57,37,20,51
Melbourne C,6897,3,14,5,10,43,33,10,47
Melbourne V,6897,4,13,5,11,47,41,6,44
Adelaide Utd,6897,5,11,6,11,37,40,-3,39
Brisbane,6897,6,10,5,13,33,42,-9,35
Western Sydn,6897,7,8,9,10,38,47,-9,33
Perth Glory,6897,8,10,2,15,37,50,-13,32
Wellington P,6897,9,5,6,16,31,55,-24,21
CC Mariners,6897,10,4,8,15,28,49,-21,20
Sydney FC,6898,1,21,4,3,69,23,46,67
N'castle Jet,6898,2,15,6,7,58,38,20,51
Melbourne C,6898,3,14,5,10,44,34,10,47
Melbourne V,6898,4,13,5,11,46,43,3,44
Adelaide Utd,6898,5,11,6,11,37,40,-3,39
Brisbane,6898,6,10,5,13,33,42,-9,35
Western Sydn,6898,7,8,9,10,38,47,-9,33
Perth Glory,6898,8,10,2,15,37,50,-13,32
Wellington P,6898,9,5,6,16,31,55,-24,21
CC Mariners,6898,10,4,8,15,28,49,-21,20
Sydney FC,6899,1,21,4,3,70,23,47,67
N'castle Jet,6899,2,16,5,7,61,37,24,53
Melbourne C,6899,3,14,4,11,43,37,6,46
Melbourne V,6899,4,13,5,11,46,44,2,44
Adelaide Utd,6899,5,11,6,11,37,40,-3,39
Brisbane,6899,6,10,5,13,33,42,-9,35
Western Sydn,6899,7,8,9,10,38,47,-9,33
Perth Glory,6899,8,10,2,15,37,50,-13,32
Wellington P,6899,9,5,6,16,31,55,-24,21
CC Mariners,6899,10,4,8,15,28,49,-21,20
Sydney FC,6900,1,20,4,4,64,24,40,64
N'castle Jet,6900,2,16,5,7,59,37,22,53
Melbourne V,6900,3,14,5,10,47,38,9,47
Melbourne C,6900,4,14,4,11,43,35,8,46
Adelaide Utd,6900,5,11,6,11,37,40,-3,39
Brisbane,6900,6,10,5,13,33,42,-9,35
Western Sydn,6900,7,8,9,10,38,47,-9,33
Perth Glory,6900,8,10,2,15,37,50,-13,32
Wellington P,6900,9,5,6,16,31,55,-24,21
CC Mariners,6900,10,4,8,15,28,49,-21,20
Sydney FC,6901,1,21,4,3,66,22,44,67
N'castle Jet,6901,2,15,6,7,57,37,20,51
Melbourne C,6901,3,14,5,10,43,33,10,47
Melbourne V,6901,4,13,5,11,45,40,5,44
Adelaide Utd,6901,5,11,6,11,37,40,-3,39
Brisbane,6901,6,10,5,13,33,42,-9,35
Western Sydn,6901,7,8,9,10,38,47,-9,33
Perth Glory,6901,8,10,2,15,37,50,-13,32
Wellington P,6901,9,5,6,16,31,55,-24,21
CC Mariners,6901,10,4,8,15,28,49,-21,20
Sydney FC,6902,1,21,4,3,66,23,43,67
N'castle Jet,6902,2,16,5,7,61,37,24,53
Melbourne C,6902,3,14,4,11,43,37,6,46
Melbourne V,6902,4,13,5,11,46,40,6,44
Adelaide Utd,6902,5,11,6,11,37,40,-3,39
Brisbane,6902,6,10,5,13,33,42,-9,35
Western Sydn,6902,7,8,9,10,38,47,-9,33
Perth Glory,6902,8,10,2,15,37,50,-13,32
Wellington P,6902,9,5,6,16,31,55,-24,21
CC Mariners,6902,10,4,8,15,28,49,-21,20
Sydney FC,6903,1,21,4,3,66,23,43,67
N'castle Jet,6903,2,16,5,7,60,38,22,53
Melbourne C,6903,3,14,4,11,44,36,8,46
Melbourne V,6903,4,13,5,11,46,40,6,44
Adelaide Utd,6903,5,11,6,11,37,40,-3,39
Brisbane,6903,6,10,5,13,33,42,-9,35
Western Sydn,6903,7,8,9,10,38,47,-9,33
Perth Glory,6903,8,10,2,15,37,50,-13,32
Wellington P,6903,9,5,6,16,31,55,-24,21
CC Mariners,6903,10,4,8,15,28,49,-21,20
Sydney FC,6904,1,21,4,3,68,24,44,67
N'castle Jet,6904,2,15,5,8,58,40,18,50
Melbourne C,6904,3,15,4,10,46,34,12,49
Melbourne V,6904,4,13,5,11,47,42,5,44
Adelaide Utd,6904,5,11,6,11,37,40,-3,39
Brisbane,6904,6,10,5,13,33,42,-9,35
Western Sydn,6904,7,8,9,10,38,47,-9,33
Perth Glory,6904,8,10,2,15,37,50,-13,32
Wellington P,6904,9,5,6,16,31,55,-24,21
CC Mariners,6904,10,4,8,15,28,49,-21,20
Sydney FC,6905,1,21,4,3,66,23,43,67
N'castle Jet,6905,2,16,5,7,60,38,22,53
Melbourne C,6905,3,14,4,11,44,36,8,46
Melbourne V,6905,4,13,5,11,46,40,6,44
Adelaide Utd,6905,5,11,6,11,37,40,-3,39
Brisbane,6905,6,10,5,13,33,42,-9,35
Western Sydn,6905,7,8,9,10,38,47,-9,33
Perth Glory,6905,8,10,2,15,37,50,-13,32
Wellington P,6905,9,5,6,16,31,55,-24,21
CC Mariners,6905,10,4,8,15,28,49,-21,20
Sydney FC,6906,1,21,4,3,67,23,44,67
N'castle Jet,6906,2,16,5,7,60,39,21,53
Melbourne C,6906,3,14,4,11,45,36,9,46
Melbourne V,6906,4,13,5,11,46,41,5,44
Adelaide Utd,6906,5,11,6,11,37,40,-3,39
Brisbane,6906,6,10,5,13,33,42,-9,35
Western Sydn,6906,7,8,9,10,38,47,-9,33
Perth Glory,6906,8,10,2,15,37,50,-13,32
Wellington P,6906,9,5,6,16,31,55,-24,21
CC Mariners,6906,10,4,8,15,28,49,-21,20
Sydney FC,6907,1,21,4,3,67,23,44,67
N'castle Jet,6907,2,15,5,8,57,39,18,50
Melbourne C,6907,3,15,4,10,45,33,12,49
Melbourne V,6907,4,13,5,11,46,41,5,44
Adelaide Utd,6907,5,11,6,11,37,40,-3,39
Brisbane,6907,6,10,5,13,33,42,-9,35
Western Sydn,6907,7,8,9,10,38,47,-9,33
Perth Glory,6907,8,10,2,15,37,50,-13,32
Wellington P,6907,9,5,6,16,31,55,-24,21
CC Mariners,6907,10,4,8,15,28,49,-21,20
Sydney FC,6908,1,21,4,3,69,24,45,67
N'castle Jet,6908,2,15,5,8,57,39,18,50
Melbourne C,6908,3,15,4,10,45,33,12,49
Melbourne V,6908,4,13,5,11,47,43,4,44
Adelaide Utd,6908,5,11,6,11,37,40,-3,39
Brisbane,6908,6,10,5,13,33,42,-9,35
Western Sydn,6908,7,8,9,10,38,47,-9,33
Perth Glory,6908,8,10,2,15,37,50,-13,32
Wellington P,6908,9,5,6,16,31,55,-24,21
CC Mariners,6908,10,4,8,15,28,49,-21,20
Sydney FC,6909,1,21,4,3,69,23,46,67
N'castle Jet,6909,2,15,6,7,59,39,20,51
Melbourne C,6909,3,14,5,10,45,35,10,47
Melbourne V,6909,4,13,5,11,46,43,3,44
Adelaide Utd,6909,5,11,6,11,37,40,-3,39
Brisbane,6909,6,10,5,13,33,42,-9,35
Western Sydn,6909,7,8,9,10,38,47,-9,33
Perth Glory,6909,8,10,2,15,37,50,-13,32
Wellington P,6909,9,5,6,16,31,55,-24,21
CC Mariners,6909,10,4,8,15,28,49,-21,20
Sydney FC,6910,1,21,4,3,68,25,43,67
N'castle Jet,6910,2,15,5,8,57,38,19,50
Melbourne C,6910,3,15,4,10,44,33,11,49
Melbourne V,6910,4,13,5,11,48,42,6,44
Adelaide Utd,6910,5,11,6,11,37,40,-3,39
Brisbane,6910,6,10,5,13,33,42,-9,35
Western Sydn,6910,7,8,9,10,38,47,-9,33
Perth Glory,6910,8,10,2,15,37,50,-13,32
Wellington P,6910,9,5,6,16,31,55,-24,21
CC Mariners,6910,10,4,8,15,28,49,-21,20
Sydney FC,6911,1,21,4,3,66,22,44,67
N'castle Jet,6911,2,15,5,8,58,41,17,50
Melbourne C,6911,3,15,4,10,47,34,13,49
Melbourne V,6911,4,13,5,11,45,40,5,44
Adelaide Utd,6911,5,11,6,11,37,40,-3,39
Brisbane,6911,6,10,5,13,33,42,-9,35
Western Sydn,6911,7,8,9,10,38,47,-9,33
Perth Glory,6911,8,10,2,15,37,50,-13,32
Wellington P,6911,9,5,6,16,31,55,-24,21
CC Mariners,6911,10,4,8,15,28,49,-21,20
Sydney FC,6912,1,21,4,3,68,24,44,67
N'castle Jet,6912,2,16,5,7,60,37,23,53
Melbourne C,6912,3,14,4,11,43,36,7,46
Melbourne V,6912,4,13,5,11,47,42,5,44
Adelaide Utd,6912,5,11,6,11,37,40,-3,39
Brisbane,6912,6,10,5,13,33,42,-9,35
Western Sydn,6912,7,8,9,10,38,47,-9,33
Perth Glory,6912,8,10,2,15,37,50,-13,32
Wellington P,6912,9,5,6,16,31,55,-24,21
CC Mariners,6912,10,4,8,15,28,49,-21,20
Sydney FC,6913,1,21,4,3,67,23,44,67
N'castle Jet,6913,2,15,6,7,59,39,20,51
Melbourne C,6913,3,14,5,10,45,35,10,47
Melbourne V,6913,4,13,5,11,46,41,5,44
Adelaide Utd,6913,5,11,6,11,37,40,-3,39
Brisbane,6913,6,10,5,13,33,42,-9,35
Western Sydn,6913,7,8,9,10,38,47,-9,33
Perth Glory,6913,8,10,2,15,37,50,-13,32
Wellington P,6913,9,5,6,16,31,55,-24,21
CC Mariners,6913,10,4,8,15,28,49,-21,20
Sydney FC,6914,1,21,4,3,68,23,45,67
N'castle Jet,6914,2,15,6,7,58,38,20,51
Melbourne C,6914,3,14,5,10,44,34,10,47
Melbourne V,6914,4,13,5,11,46,42,4,44
Adelaide Utd,6914,5,11,6,11,37,40,-3,39
Brisbane,6914,6,10,5,13,33,42,-9,35
Western Sydn,6914,7,8,9,10,38,47,-9,33
Perth Glory,6914,8,10,2,15,37,50,-13,32
Wellington P,6914,9,5,6,16,31,55,-24,21
CC Mariners,6914,10,4,8,15,28,49,-21,20
Sydney FC,6915,1,20,4,4,64,24,40,64
N'castle Jet,6915,2,16,5,7,62,37,25,53
Melbourne V,6915,3,14,5,10,47,38,9,47
Melbourne C,6915,4,14,4,11,43,38,5,46
Adelaide Utd,6915,5,11,6,11,37,40,-3,39
Brisbane,6915,6,10,5,13,33,42,-9,35
Western Sydn,6915,7,8,9,10,38,47,-9,33
Perth Glory,6915,8,10,2,15,37,50,-13,32
Wellington P,6915,9,5,6,16,31,55,-24,21
CC Mariners,6915,10,4,8,15,28,49,-21,20
Sydney FC,6916,1,21,4,3,66,22,44,67
N'castle Jet,6916,2,16,5,7,61,39,22,53
Melbourne C,6916,3,14,4,11,45,37,8,46
Melbourne V,6916,4,13,5,11,45,40,5,44
Adelaide Utd,6916,5,11,6,11,37,40,-3,39
Brisbane,6916,6,10,5,13,33,42,-9,35
Western Sydn,6916,7,8,9,10,38,47,-9,33
Perth Glory,6916,8,10,2,15,37,50,-13,32
Wellington P,6916,9,5,6,16,31,55,-24,21
CC Mariners,6916,10,4,8,15,28,49,-21,20
Sydney FC,6917,1,20,5,3,66,24,42,65
N'castle Jet,6917,2,15,6,7,58,38,20,51
Melbourne C,6917,3,14,5,10,44,34,10,47
Melbourne V,6917,4,13,6,10,47,40,7,45
Adelaide Utd,6917,5,11,6,11,37,40,-3,39
Brisbane,6917,6,10,5,13,33,42,-9,35
Western Sydn,6917,7,8,9,10,38,47,-9,33
Perth Glory,6917,8,10,2,15,37,50,-13,32
Wellington P,6917,9,5,6,16,31,55,-24,21
CC Mariners,6917,10,4,8,15,28,49,-21,20
Sydney FC,6918,1,20,5,3,66,24,42,65
N'castle Jet,6918,2,15,6,7,57,37,20,51
Melbourne C,6918,3,14,5,10,43,33,10,47
Melbourne V,6918,4,13,6,10,47,40,7,45
Adelaide Utd,6918,5,11,6,11,37,40,-3,39
Brisbane,6918,6,10,5,13,33,42,-9,35
Western Sydn,6918,7,8,9,10,38,47,-9,33
Perth Glory,6918,8,10,2,15,37,50,-13,32
Wellington P,6918,9,5,6,16,31,55,-24,21
CC Mariners,6918,10,4,8,15,28,49,-21,20
Sydney FC,6919,1,21,4,3,66,22,44,67
N'castle Jet,6919,2,16,5,7,59,37,22,53
Melbourne C,6919,3,14,4,11,43,35,8,46
Melbourne V,6919,4,13,5,11,45,40,5,44
Adelaide Utd,6919,5,11,6,11,37,40,-3,39
Brisbane,6919,6,10,5,13,33,42,-9,35
Western Sydn,6919,7,8,9,10,38,47,-9,33
Perth Glory,6919,8,10,2,15,37,50,-13,32
Wellington P,6919,9,5,6,16,31,55,-24,21
CC Mariners,6919,10,4,8,15,28,49,-21,20
Sydney FC,6920,1,21,4,3,70,22,48,67
N'castle Jet,6920,2,16,5,7,60,37,23,53
Melbourne C,6920,3,14,4,11,43,36,7,46
Melbourne V,6920,4,13,5,11,45,44,1,44
Adelaide Utd,6920,5,11,6,11,37,40,-3,39
Brisbane,6920,6,10,5,13,33,42,-9,35
Western Sydn,6920,7,8,9,10,38,47,-9,33
Perth Glory,6920,8,10,2,15,37,50,-13,32
Wellington P,6920,9,5,6,16,31,55,-24,21
CC Mariners,6920,10,4,8,15,28,49,-21,20
Sydney FC,6921,1,21,4,3,67,23,44,67
N'castle Jet,6921,2,16,5,7,62,39,23,53
Melbourne C,6921,3,14,4,11,45,38,7,46
Melbourne V,6921,4,13,5,11,46,41,5,44
Adelaide Utd,6921,5,11,6,11,37,40,-3,39
Brisbane,6921,6,10,5,13,33,42,-9,35
Western Sydn,6921,7,8,9,10,38,47,-9,33
Perth Glory,6921,8,10,2,15,37,50,-13,32
Wellington P,6921,9,5,6,16,31,55,-24,21
CC Mariners,6921,10,4,8,15,28,49,-21,20
Sydney FC,6922,1,21,4,3,67,23,44,67
N'castle Jet,6922,2,15,6,7,57,37,20,51
Melbourne C,6922,3,14,5,10,43,33,10,47
Melbourne V,6922,4,13,5,11,46,41,5,44
Adelaide Utd,6922,5,11,6,11,37,40,-3,39
Brisbane,6922,6,10,5,13,33,42,-9,35
Western Sydn,6922,7,8,9,10,38,47,-9,33
Perth Glory,6922,8,10,2,15,37,50,-13,32
Wellington P,6922,9,5,6,16,31,55,-24,21
CC Mariners,6922,10,4,8,15,28,49,-21,20
Sydney FC,6923,1,21,4,3,67,23,44,67
N'castle Jet,6923,2,15,5,8,57,38,19,50
Melbourne C,6923,3,15,4,10,44,33,11,49
Melbourne V,6923,4,13,5,11,46,41,5,44
Adelaide Utd,6923,5,11,6,11,37,40,-3,39
Brisbane,6923,6,10,5,13,33,42,-9,35
Western Sydn,6923,7,8,9,10,38,47,-9,33
Perth Glory,6923,8,10,2,15,37,50,-13,32
Wellington P,6923,9,5,6,16,31,55,-24,21
CC Mariners,6923,10,4,8,15,28,49,-21,20
Sydney FC,6924,1,21,4,3,65,22,43,67
N'castle Jet,6924,2,16,5,7,59,38,21,53
Melbourne C,6924,3,14,4,11,44,35,9,46
Melbourne V,6924,4,13,5,11,45,39,6,44
Adelaide Utd,6924,5,11,6,11,37,40,-3,39
Brisbane,6924,6,10,5,13,33,42,-9,35
Western Sydn,6924,7,8,9,10,38,47,-9,33
Perth Glory,6924,8,10,2,15,37,50,-13,32
Wellington P,6924,9,5,6,16,31,55,-24,21
CC Mariners,6924,10,4,8,15,28,49,-21,20
Sydney FC,6925,1,21,4,3,68,23,45,67
N'castle Jet,6925,2,16,5,7,58,37,21,53
Melbourne C,6925,3,14,4,11,43,34,9,46
Melbourne V,6925,4,13,5,11,46,42,4,44
Adelaide Utd,6925,5,11,6,11,37,40,-3,39
Brisbane,6925,6,10,5,13,33,42,-9,35
Western Sydn,6925,7,8,9,10,38,47,-9,33
Perth Glory,6925,8,10,2,15,37,50,-13,32
Wellington P,6925,9,5,6,16,31,55,-24,21
CC Mariners,6925,10,4,8,15,28,49,-21,20
Sydney FC,6926,1,21,4,3,66,23,43,67
N'castle Jet,6926,2,16,5,7,58,37,21,53
Melbourne C,6926,3,14,4,11,43,34,9,46
Melbourne V,6926,4,13,5,11,46,40,6,44
Adelaide Utd,6926,5,11,6,11,37,40,-3,39
Brisbane,6926,6,10,5,13,33,42,-9,35
Western Sydn,6926,7,8,9,10,38,47,-9,33
Perth Glory,6926,8,10,2,15,37,50,-13,32
Wellington P,6926,9,5,6,16,31,55,-24,21
CC Mariners,6926,10,4,8,15,28,49,-21,20
Sydney FC,6927,1,21,4,3,68,23,45,67
N'castle Jet,6927,2,16,5,7,61,37,24,53
Melbourne C,6927,3,14,4,11,43,37,6,46
Melbourne V,6927,4,13,5,11,46,42,4,44
Adelaide Utd,6927,5,11,6,11,37,40,-3,39
Brisbane,6927,6,10,5,13,33,42,-9,35
Western Sydn,6927,7,8,9,10,38,47,-9,33
Perth Glory,6927,8,10,2,15,37,50,-13,32
Wellington P,6927,9,5,6,16,31,55,-24,21
CC Mariners,6927,10,4,8,15,28,49,-21,20
Sydney FC,6928,1,21,4,3,68,24,44,67
N'castle Jet,6928,2,16,5,7,58,37,21,53
Melbourne C,6928,3,14,4,11,43,34,9,46
Melbourne V,6928,4,13,5,11,47,42,5,44
Adelaide Utd,6928,5,11,6,11,37,40,-3,39
Brisbane,6928,6,10,5,13,33,42,-9,35
Western Sydn,6928,7,8,9,10,38,47,-9,33
Perth Glory,6928,8,10,2,15,37,50,-13,32
Wellington P,6928,9,5,6,16,31,55,-24,21
CC Mariners,6928,10,4,8,15,28,49,-21,20
Sydney FC,6929,1,20,4,4,65,25,40,64
N'castle Jet,6929,2,16,5,7,59,38,21,53
Melbourne V,6929,3,14,5,10,48,39,9,47
Melbourne C,6929,4,14,4,11,44,35,9,46
Adelaide Utd,6929,5,11,6,11,37,40,-3,39
Brisbane,6929,6,10,5,13,33,42,-9,35
Western Sydn,6929,7,8,9,10,38,47,-9,33
Perth Glory,6929,8,10,2,15,37,50,-13,32
Wellington P,6929,9,5,6,16,31,55,-24,21
CC Mariners,6929,10,4,8,15,28,49,-21,20
Sydney FC,6930,1,21,4,3,67,22,45,67
N'castle Jet,6930,2,15,5,8,57,39,18,50
Melbourne C,6930,3,15,4,10,45,33,12,49
Melbourne V,6930,4,13,5,11,45,41,4,44
Adelaide Utd,6930,5,11,6,11,37,40,-3,39
Brisbane,6930,6,10,5,13,33,42,-9,35
Western Sydn,6930,7,8,9,10,38,47,-9,33
Perth Glory,6930,8,10,2,15,37,50,-13,32
Wellington P,6930,9,5,6,16,31,55,-24,21
CC Mariners,6930,10,4,8,15,28,49,-21,20
Sydney FC,6931,1,21,4,3,67,22,45,67
N'castle Jet,6931,2,15,6,7,59,39,20,51
Melbourne C,6931,3,14,5,10,45,35,10,47
Melbourne V,6931,4,13,5,11,45,41,4,44
Adelaide Utd,6931,5,11,6,11,37,40,-3,39
Brisbane,6931,6,10,5,13,33,42,-9,35
Western Sydn,6931,7,8,9,10,38,47,-9,33
Perth Glory,6931,8,10,2,15,37,50,-13,32
Wellington P,6931,9,5,6,16,31,55,-24,21
CC Mariners,6931,10,4,8,15,28,49,-21,20
Sydney FC,6932,1,21,4,3,67,23,44,67
N'castle Jet,6932,2,16,5,7,59,37,22,53
Melbourne C,6932,3,14,4,11,43,35,8,46
Melbourne V,6932,4,13,5,11,46,41,5,44
Adelaide Utd,6932,5,11,6,11,37,40,-3,39
Brisbane,6932,6,10,5,13,33,42,-9,35
Western Sydn,6932,7,8,9,10,38,47,-9,33
Perth Glory,6932,8,10,2,15,37,50,-13,32
Wellington P,6932,9,5,6,16,31,55,-24,21
CC Mariners,6932,10,4,8,15,28,49,-21,20
Sydney FC,6933,1,21,4,3,67,23,44,67
N'castle Jet,6933,2,15,5,8,57,38,19,50
Melbourne C,6933,3,15,4,10,44,33,11,49
Melbourne V,6933,4,13,5,11,46,41,5,44
Adelaide Utd,6933,5,11,6,11,37,40,-3,39
Brisbane,6933,6,10,5,13,33,42,-9,35
Western Sydn,6933,7,8,9,10,38,47,-9,33
Perth Glory,6933,8,10,2,15,37,50,-13,32
Wellington P,6933,9,5,6,16,31,55,-24,21
CC Mariners,6933,10,4,8,15,28,49,-21,20
Sydney FC,6934,1,21,4,3,66,22,44,67
N'castle Jet,6934,2,16,5,7,59,37,22,53
Melbourne C,6934,3,14,4,11,43,35,8,46
Melbourne V,6934,4,13,5,11,45,40,5,44
Adelaide Utd,6934,5,11,6,11,37,40,-3,39
Brisbane,6934,6,10,5,13,33,42,-9,35
Western Sydn,6934,7,8,9,10,38,47,-9,33
Perth Glory,6934,8,10,2,15,37,50,-13,32
Wellington P,6934,9,5,6,16,31,55,-24,21
CC Mariners,6934,10,4,8,15,28,49,-21,20
Sydney FC,6935,1,20,4,4,65,25,40,64
N'castle Jet,6935,2,15,5,8,57,38,19,50
Melbourne C,6935,3,15,4,10,44,33,11,49
Melbourne V,6935,4,14,5,10,48,39,9,47
Adelaide Utd,6935,5,11,6,11,37,40,-3,39
Brisbane,6935,6,10,5,13,33,42,-9,35
Western Sydn,6935,7,8,9,10,38,47,-9,33
Perth Glory,6935,8,10,2,15,37,50,-13,32
Wellington P,6935,9,5,6,16,31,55,-24,21
CC Mariners,6935,10,4,8,15,28,49,-21,20
Sydney FC,6936,1,21,4,3,66,23,43,67
N'castle Jet,6936,2,15,6,7,58,38,20,51
Melbourne C,6936,3,14,5,10,44,34,10,47
Melbourne V,6936,4,13,5,11,46,40,6,44
Adelaide Utd,6936,5,11,6,11,37,40,-3,39
Brisbane,6936,6,10,5,13,33,42,-9,35
Western Sydn,6936,7,8,9,10,38,47,-9,33
Perth Glory,6936,8,10,2,15,37,50,-13,32
Wellington P,6936,9,5,6,16,31,55,-24,21
CC Mariners,6936,10,4,8,15,28,49,-21,20
Sydney FC,6937,1,20,4,4,66,26,40,64
N'castle Jet,6937,2,16,5,7,62,39,23,53
Melbourne V,6937,3,14,5,10,49,40,9,47
Melbourne C,6937,4,14,4,11,45,38,7,46
Adelaide Utd,6937,5,11,6,11,37,40,-3,39
Brisbane,6937,6,10,5,13,33,42,-9,35
Western Sydn,6937,7,8,9,10,38,47,-9,33
Perth Glory,6937,8,10,2,15,37,50,-13,32
Wellington P,6937,9,5,6,16,31,55,-24,21
CC Mariners,6937,10,4,8,15,28,49,-21,20
Sydney FC,6938,1,21,4,3,66,22,44,67
N'castle Jet,6938,2,16,5,7,60,39,21,53
Melbourne C,6938,3,14,4,11,45,36,9,46
Melbourne V,6938,4,13,5,11,45,40,5,44
Adelaide Utd,6938,5,11,6,11,37,40,-3,39
Brisbane,6938,6,10,5,13,33,42,-9,35
Western Sydn,6938,7,8,9,10,38,47,-9,33
Perth Glory,6938,8,10,2,15,37,50,-13,32
Wellington P,6938,9,5,6,16,31,55,-24,21
CC Mariners,6938,10,4,8,15,28,49,-21,20
Sydney FC,6939,1,21,4,3,68,24,44,67
N'castle Jet,6939,2,15,5,8,58,39,19,50
Melbourne C,6939,3,15,4,10,45,34,11,49
Melbourne V,6939,4,13,5,11,47,42,5,44
Adelaide Utd,6939,5,11,6,11,37,40,-3,39
Brisbane,6939,6,10,5,13,33,42,-9,35
Western Sydn,6939,7,8,9,10,38,47,-9,33
Perth Glory,6939,8,10,2,15,37,50,-13,32
Wellington P,6939,9,5,6,16,31,55,-24,21
CC Mariners,6939,10,4,8,15,28,49,-21,20
Sydney FC,6940,1,20,4,4,64,24,40,64
N'castle Jet,6940,2,16,5,7,61,40,21,53
Melbourne V,6940,3,14,5,10,47,38,9,47
Melbourne C,6940,4,14,4,11,46,37,9,46
Adelaide Utd,6940,5,11,6,11,37,40,-3,39
Brisbane,6940,6,10,5,13,33,42,-9,35
Western Sydn,6940,7,8,9,10,38,47,-9,33
Perth Glory,6940,8,10,2,15,37,50,-13,32
Wellington P,6940,9,5,6,16,31,55,-24,21
CC Mariners,6940,10,4,8,15,28,49,-21,20
Sydney FC,6941,1,21,4,3,68,24,44,67
N'castle Jet,6941,2,16,5,7,62,38,24,53
Melbourne C,6941,3,14,4,11,44,38,6,46
Melbourne V,6941,4,13,5,11,47,42,5,44
Adelaide Utd,6941,5,11,6,11,37,40,-3,39
Brisbane,6941,6,10,5,13,33,42,-9,35
Western Sydn,6941,7,8,9,10,38,47,-9,33
Perth Glory,6941,8,10,2,15,37,50,-13,32
Wellington P,6941,9,5,6,16,31,55,-24,21
CC Mariners,6941,10,4,8,15,28,49,-21,20
Sydney FC,6942,1,21,4,3,66,22,44,67
N'castle Jet,6942,2,16,5,7,59,37,22,53
Melbourne C,6942,3,14,4,11,43,35,8,46
Melbourne V,6942,4,13,5,11,45,40,5,44
Adelaide Utd,6942,5,11,6,11,37,40,-3,39
Brisbane,6942,6,10,5,13,33,42,-9,35
Western Sydn,6942,7,8,9,10,38,47,-9,33
Perth Glory,6942,8,10,2,15,37,50,-13,32
Wellington P,6942,9,5,6,16,31,55,-24,21
CC Mariners,6942,10,4,8,15,28,49,-21,20
Sydney FC,6943,1,20,5,3,64,22,42,65
N'castle Jet,6943,2,16,5,7,58,37,21,53
Melbourne C,6943,3,14,4,11,43,34,9,46
Melbourne V,6943,4,13,6,10,45,38,7,45
Adelaide Utd,6943,5,11,6,11,37,40,-3,39
Brisbane,6943,6,10,5,13,33,42,-9,35
Western Sydn,6943,7,8,9,10,38,47,-9,33
Perth Glory,6943,8,10,2,15,37,50,-13,32
Wellington P,6943,9,5,6,16,31,55,-24,21
CC Mariners,6943,10,4,8,15,28,49,-21,20
Sydney FC,6944,1,21,4,3,68,23,45,67
N'castle Jet,6944,2,16,5,7,63,37,26,53
Melbourne C,6944,3,14,4,11,43,39,4,46
Melbourne V,6944,4,13,5,11,46,42,4,44
Adelaide Utd,6944,5,11,6,11,37,40,-3,39
Brisbane,6944,6,10,5,13,33,42,-9,35
Western Sydn,6944,7,8,9,10,38,47,-9,33
Perth Glory,6944,8,10,2,15,37,50,-13,32
Wellington P,6944,9,5,6,16,31,55,-24,21
CC Mariners,6944,10,4,8,15,28,49,-21,20
Sydney FC,6945,1,21,4,3,69,22,47,67
N'castle Jet,6945,2,15,5,8,57,38,19,50
Melbourne C,6945,3,15,4,10,44,33,11,49
Melbourne V,6945,4,13,5,11,45,43,2,44
Adelaide Utd,6945,5,11,6,11,37,40,-3,39
Brisbane,6945,6,10,5,13,33,42,-9,35
Western Sydn,6945,7,8,9,10,38,47,-9,33
Perth Glory,6945,8,10,2,15,37,50,-13,32
Wellington P,6945,9,5,6,16,31,55,-24,21
CC Mariners,6945,10,4,8,15,28,49,-21,20
Sydney FC,6946,1,21,4,3,68,22,46,67
N'castle Jet,6946,2,15,5,8,58,39,19,50
Melbourne C,6946,3,15,4,10,45,34,11,49
Melbourne V,6946,4,13,5,11,45,42,3,44
Adelaide Utd,6946,5,11,6,11,37,40,-3,39
Brisbane,6946,6,10,5,13,33,42,-9,35
Western Sydn,6946,7,8,9,10,38,47,-9,33
Perth Glory,6946,8,10,2,15,37,50,-13,32
Wellington P,6946,9,5,6,16,31,55,-24,21
CC Mariners,6946,10,4,8,15,28,49,-21,20
Sydney FC,6947,1,21,4,3,65,22,43,67
N'castle Jet,6947,2,15,6,7,58,38,20,51
Melbourne C,6947,3,14,5,10,44,34,10,47
Melbourne V,6947,4,13,5,11,45,39,6,44
Adelaide Utd,6947,5,11,6,11,37,40,-3,39
Brisbane,6947,6,10,5,13,33,42,-9,35
Western Sydn,6947,7,8,9,10,38,47,-9,33
Perth Glory,6947,8,10,2,15,37,50,-13,32
Wellington P,6947,9,5,6,16,31,55,-24,21
CC Mariners,6947,10,4,8,15,28,49,-21,20
Sydney FC,6948,1,20,4,4,65,24,41,64
N'castle Jet,6948,2,15,6,7,58,38,20,51
Melbourne C,6948,3,14,5,10,44,34,10,47
Melbourne V,6948,4,14,5,10,47,39,8,47
Adelaide Utd,6948,5,11,6,11,37,40,-3,39
Brisbane,6948,6,10,5,13,33,42,-9,35
Western Sydn,6948,7,8,9,10,38,47,-9,33
Perth Glory,6948,8,10,2,15,37,50,-13,32
Wellington P,6948,9,5,6,16,31,55,-24,21
CC Mariners,6948,10,4,8,15,28,49,-21,20
Sydney FC,6949,1,21,4,3,68,23,45,67
N'castle Jet,6949,2,15,6,7,59,39,20,51
Melbourne C,6949,3,14,5,10,45,35,10,47
Melbourne V,6949,4,13,5,11,46,42,4,44
Adelaide Utd,6949,5,11,6,11,37,40,-3,39
Brisbane,6949,6,10,5,13,33,42,-9,35
Western Sydn,6949,7,8,9,10,38,47,-9,33
Perth Glory,6949,8,10,2,15,37,50,-13,32
Wellington P,6949,9,5,6,16,31,55,-24,21
CC Mariners,6949,10,4,8,15,28,49,-21,20
Sydney FC,6950,1,21,4,3,67,24,43,67
N'castle Jet,6950,2,16,5,7,61,39,22,53
Melbourne C,6950,3,14,4,11,45,37,8,46
Melbourne V,6950,4,13,5,11,47,41,6,44
Adelaide Utd,6950,5,11,6,11,37,40,-3,39
Brisbane,6950,6,10,5,13,33,42,-9,35
Western Sydn,6950,7,8,9,10,38,47,-9,33
Perth Glory,6950,8,10,2,15,37,50,-13,32
Wellington P,6950,9,5,6,16,31,55,-24,21
CC Mariners,6950,10,4,8,15,28,49,-21,20
Sydney FC,6951,1,21,4,3,68,23,45,67
N'castle Jet,6951,2,16,5,7,59,37,22,53
Melbourne C,6951,3,14,4,11,43,35,8,46
Melbourne V,6951,4,13,5,11,46,42,4,44
Adelaide Utd,6951,5,11,6,11,37,40,-3,39
Brisbane,6951,6,10,5,13,33,42,-9,35
Western Sydn,6951,7,8,9,10,38,47,-9,33
Perth Glory,6951,8,10,2,15,37,50,-13,32
Wellington P,6951,9,5,6,16,31,55,-24,21
CC Mariners,6951,10,4,8,15,28,49,-21,20
Sydney FC,6952,1,21,4,3,66,22,44,67
N'castle Jet,6952,2,16,5,7,60,39,21,53
Melbourne C,6952,3,14,4,11,45,36,9,46
Melbourne V,6952,4,13,5,11,45,40,5,44
Adelaide Utd,6952,5,11,6,11,37,40,-3,39
Brisbane,6952,6,10,5,13,33,42,-9,35
Western Sydn,6952,7,8,9,10,38,47,-9,33
Perth Glory,6952,8,10,2,15,37,50,-13,32
Wellington P,6952,9,5,6,16,31,55,-24,21
CC Mariners,6952,10,4,8,15,28,49,-21,20
Sydney FC,6953,1,20,5,3,65,23,42,65
N'castle Jet,6953,2,15,5,8,59,40,19,50
Melbourne C,6953,3,15,4,10,46,35,11,49
Melbourne V,6953,4,13,6,10,46,39,7,45
Adelaide Utd,6953,5,11,6,11,37,40,-3,39
Brisbane,6953,6,10,5,13,33,42,-9,35
Western Sydn,6953,7,8,9,10,38,47,-9,33
Perth Glory,6953,8,10,2,15,37,50,-13,32
Wellington P,6953,9,5,6,16,31,55,-24,21
CC Mariners,6953,10,4,8,15,28,49,-21,20
Sydney FC,6954,1,20,5,3,64,22,42,65
N'castle Jet,6954,2,15,5,8,57,38,19,50
Melbourne C,6954,3,15,4,10,44,33,11,49
Melbourne V,6954,4,13,6,10,45,38,7,45
Adelaide Utd,6954,5,11,6,11,37,40,-3,39
Brisbane,6954,6,10,5,13,33,42,-9,35
Western Sydn,6954,7,8,9,10,38,47,-9,33
Perth Glory,6954,8,10,2,15,37,50,-13,32
Wellington P,6954,9,5,6,16,31,55,-24,21
CC Mariners,6954,10,4,8,15,28,49,-21,20
Sydney FC,6955,1,20,5,3,65,23,42,65
N'castle Jet,6955,2,15,5,8,57,38,19,50
Melbourne C,6955,3,15,4,10,44,33,11,49
Melbourne V,6955,4,13,6,10,46,39,7,45
Adelaide Utd,6955,5,11,6,11,37,40,-3,39
Brisbane,6955,6,10,5,13,33,42,-9,35
Western Sydn,6955,7,8,9,10,38,47,-9,33
Perth Glory,6955,8,10,2,15,37,50,-13,32
Wellington P,6955,9,5,6,16,31,55,-24,21
CC Mariners,6955,10,4,8,15,28,49,-21,20
Sydney FC,6956,1,21,4,3,67,22,45,67
N'castle Jet,6956,2,15,6,7,58,38,20,51
Melbourne C,6956,3,14,5,10,44,34,10,47
Melbourne V,6956,4,13,5,11,45,41,4,44
Adelaide Utd,6956,5,11,6,11,37,40,-3,39
Brisbane,6956,6,10,5,13,33,42,-9,35
Western Sydn,6956,7,8,9,10,38,47,-9,33
Perth Glory,6956,8,10,2,15,37,50,-13,32
Wellington P,6956,9,5,6,16,31,55,-24,21
CC Mariners,6956,10,4,8,15,28,49,-21,20
Sydney FC,6957,1,21,4,3,68,23,45,67
N'castle Jet,6957,2,16,5,7,59,38,21,53
Melbourne C,6957,3,14,4,11,44,35,9,46
Melbourne V,6957,4,13,5,11,46,42,4,44
Adelaide Utd,6957,5,11,6,11,37,40,-3,39
Brisbane,6957,6,10,5,13,33,42,-9,35
Western Sydn,6957,7,8,9,10,38,47,-9,33
Perth Glory,6957,8,10,2,15,37,50,-13,32
Wellington P,6957,9,5,6,16,31,55,-24,21
CC Mariners,6957,10,4,8,15,28,49,-21,20
Sydney FC,6958,1,21,4,3,65,22,43,67
N'castle Jet,6958,2,15,5,8,60,42,18,50
Melbourne C,6958,3,15,4,10,48,36,12,49
Melbourne V,6958,4,13,5,11,45,39,6,44
Adelaide Utd,6958,5,11,6,11,37,40,-3,39
Brisbane,6958,6,10,5,13,33,42,-9,35
Western Sydn,6958,7,8,9,10,38,47,-9,33
Perth Glory,6958,8,10,2,15,37,50,-13,32
Wellington P,6958,9,5,6,16,31,55,-24,21
CC Mariners,6958,10,4,8,15,28,49,-21,20
Sydney FC,6959,1,21,4,3,69,24,45,67
N'castle Jet,6959,2,15,6,7,59,39,20,51
Melbourne C,6959,3,14,5,10,45,35,10,47
Melbourne V,6959,4,13,5,11,47,43,4,44
Adelaide Utd,6959,5,11,6,11,37,40,-3,39
Brisbane,6959,6,10,5,13,33,42,-9,35
Western Sydn,6959,7,8,9,10,38,47,-9,33
Perth Glory,6959,8,10,2,15,37,50,-13,32
Wellington P,6959,9,5,6,16,31,55,-24,21
CC Mariners,6959,10,4,8,15,28,49,-21,20
Sydney FC,6960,1,21,4,3,67,22,45,67
N'castle Jet,6960,2,16,5,7,59,38,21,53
Melbourne C,6960,3,14,4,11,44,35,9,46
Melbourne V,6960,4,13,5,11,45,41,4,44
Adelaide Utd,6960,5,11,6,11,37,40,-3,39
Brisbane,6960,6,10,5,13,33,42,-9,35
Western Sydn,6960,7,8,9,10,38,47,-9,33
Perth Glory,6960,8,10,2,15,37,50,-13,32
Wellington P,6960,9,5,6,16,31,55,-24,21
CC Mariners,6960,10,4,8,15,28,49,-21,20
Sydney FC,6961,1,20,4,4,65,24,41,64
N'castle Jet,6961,2,15,5,8,59,40,19,50
Melbourne C,6961,3,15,4,10,46,35,11,49
Melbourne V,6961,4,14,5,10,47,39,8,47
Adelaide Utd,6961,5,11,6,11,37,40,-3,39
Brisbane,6961,6,10,5,13,33,42,-9,35
Western Sydn,6961,7,8,9,10,38,47,-9,33
Perth Glory,6961,8,10,2,15,37,50,-13,32
Wellington P,6961,9,5,6,16,31,55,-24,21
CC Mariners,6961,10,4,8,15,28,49,-21,20
Sydney FC,6962,1,20,4,4,65,24,41,64
N'castle Jet,6962,2,15,6,7,57,37,20,51
Melbourne C,6962,3,14,5,10,43,33,10,47
Melbourne V,6962,4,14,5,10,47,39,8,47
Adelaide Utd,6962,5,11,6,11,37,40,-3,39
Brisbane,6962,6,10,5,13,33,42,-9,35
Western Sydn,6962,7,8,9,10,38,47,-9,33
Perth Glory,6962,8,10,2,15,37,50,-13,32
Wellington P,6962,9,5,6,16,31,55,-24,21
CC Mariners,6962,10,4,8,15,28,49,-21,20
Sydney FC,6963,1,20,4,4,65,26,39,64
N'castle Jet,6963,2,15,6,7,57,37,20,51
Melbourne V,6963,3,14,5,10,49,39,10,47
Melbourne C,6963,4,14,5,10,43,33,10,47
Adelaide Utd,6963,5,11,6,11,37,40,-3,39
Brisbane,6963,6,10,5,13,33,42,-9,35
Western Sydn,6963,7,8,9,10,38,47,-9,33
Perth Glory,6963,8,10,2,15,37,50,-13,32
Wellington P,6963,9,5,6,16,31,55,-24,21
CC Mariners,6963,10,4,8,15,28,49,-21,20
Sydney FC,6964,1,21,4,3,67,23,44,67
N'castle Jet,6964,2,16,5,7,58,37,21,53
Melbourne C,6964,3,14,4,11,43,34,9,46
Melbourne V,6964,4,13,5,11,46,41,5,44
Adelaide Utd,6964,5,11,6,11,37,40,-3,39
Brisbane,6964,6,10,5,13,33,42,-9,35
Western Sydn,6964,7,8,9,10,38,47,-9,33
Perth Glory,6964,8,10,2,15,37,50,-13,32
Wellington P,6964,9,5,6,16,31,55,-24,21
CC Mariners,6964,10,4,8,15,28,49,-21,20
Sydney FC,6965,1,20,4,4,64,24,40,64
N'castle Jet,6965,2,15,6,7,59,39,20,51
Melbourne C,6965,3,14,5,10,45,35,10,47
Melbourne V,6965,4,14,5,10,47,38,9,47
Adelaide Utd,6965,5,11,6,11,37,40,-3,39
Brisbane,6965,6,10,5,13,33,42,-9,35
Western Sydn,6965,7,8,9,10,38,47,-9,33
Perth Glory,6965,8,10,2,15,37,50,-13,32
Wellington P,6965,9,5,6,16,31,55,-24,21
CC Mariners,6965,10,4,8,15,28,49,-21,20
Sydney FC,6966,1,20,4,4,64,24,40,64
N'castle Jet,6966,2,15,5,8,58,39,19,50
Melbourne C,6966,3,15,4,10,45,34,11,49
Melbourne V,6966,4,14,5,10,47,38,9,47
Adelaide Utd,6966,5,11,6,11,37,40,-3,39
Brisbane,6966,6,10,5,13,33,42,-9,35
Western Sydn,6966,7,8,9,10,38,47,-9,33
Perth Glory,6966,8,10,2,15,37,50,-13,32
Wellington P,6966,9,5,6,16,31,55,-24,21
CC Mariners,6966,10,4,8,15,28,49,-21,20
Sydney FC,6967,1,21,4,3,67,24,43,67
N'castle Jet,6967,2,15,5,8,57,40,17,50
Melbourne C,6967,3,15,4,10,46,33,13,49
Melbourne V,6967,4,13,5,11,47,41,6,44
Adelaide Utd,6967,5,11,6,11,37,40,-3,39
Brisbane,6967,6,10,5,13,33,42,-9,35
Western Sydn,6967,7,8,9,10,38,47,-9,33
Perth Glory,6967,8,10,2,15,37,50,-13,32
Wellington P,6967,9,5,6,16,31,55,-24,21
CC Mariners,6967,10,4,8,15,28,49,-21,20
Sydney FC,6968,1,20,5,3,65,23,42,65
N'castle Jet,6968,2,15,6,7,58,38,20,51
Melbourne C,6968,3,14,5,10,44,34,10,47
Melbourne V,6968,4,13,6,10,46,39,7,45
Adelaide Utd,6968,5,11,6,11,37,40,-3,39
Brisbane,6968,6,10,5,13,33,42,-9,35
Western Sydn,6968,7,8,9,10,38,47,-9,33
Perth Glory,6968,8,10,2,15,37,50,-13,32
Wellington P,6968,9,5,6,16,31,55,-24,21
CC Mariners,6968,10,4,8,15,28,49,-21,20
Sydney FC,6969,1,21,4,3,67,22,45,67
N'castle Jet,6969,2,15,5,8,58,39,19,50
Melbourne C,6969,3,15,4,10,45,34,11,49
Melbourne V,6969,4,13,5,11,45,41,4,44
Adelaide Utd,6969,5,11,6,11,37,40,-3,39
Brisbane,6969,6,10,5,13,33,42,-9,35
Western Sydn,6969,7,8,9,10,38,47,-9,33
Perth Glory,6969,8,10,2,15,37,50,-13,32
Wellington P,6969,9,5,6,16,31,55,-24,21
CC Mariners,6969,10,4,8,15,28,49,-21,20
Sydney FC,6970,1,21,4,3,69,23,46,67
N'castle Jet,6970,2,16,5,7,59,37,22,53
Melbourne C,6970,3,14,4,11,43,35,8,46
Melbourne V,6970,4,13,5,11,46,43,3,44
Adelaide Utd,6970,5,11,6,11,37,40,-3,39
Brisbane,6970,6,10,5,13,33,42,-9,35
Western Sydn,6970,7,8,9,10,38,47,-9,33
Perth Glory,6970,8,10,2,15,37,50,-13,32
Wellington P,6970,9,5,6,16,31,55,-24,21
CC Mariners,6970,10,4,8,15,28,49,-21,20
Sydney FC,6971,1,20,4,4,64,23,41,64
N'castle Jet,6971,2,16,5,7,60,38,22,53
Melbourne V,6971,3,14,5,10,46,38,8,47
Melbourne C,6971,4,14,4,11,44,36,8,46
Adelaide Utd,6971,5,11,6,11,37,40,-3,39
Brisbane,6971,6,10,5,13,33,42,-9,35
Western Sydn,6971,7,8,9,10,38,47,-9,33
Perth Glory,6971,8,10,2,15,37,50,-13,32
Wellington P,6971,9,5,6,16,31,55,-24,21
CC Mariners,6971,10,4,8,15,28,49,-21,20
Sydney FC,6972,1,21,4,3,67,23,44,67
N'castle Jet,6972,2,15,5,8,57,38,19,50
Melbourne C,6972,3,15,4,10,44,33,11,49
Melbourne V,6972,4,13,5,11,46,41,5,44
Adelaide Utd,6972,5,11,6,11,37,40,-3,39
Brisbane,6972,6,10,5,13,33,42,-9,35
Western Sydn,6972,7,8,9,10,38,47,-9,33
Perth Glory,6972,8,10,2,15,37,50,-13,32
Wellington P,6972,9,5,6,16,31,55,-24,21
CC Mariners,6972,10,4,8,15,28,49,-21,20
Sydney FC,6973,1,21,4,3,66,23,43,67
N'castle Jet,6973,2,16,5,7,60,37,23,53
Melbourne C,6973,3,14,4,11,43,36,7,46
Melbourne V,6973,4,13,5,11,46,40,6,44
Adelaide Utd,6973,5,11,6,11,37,40,-3,39
Brisbane,6973,6,10,5,13,33,42,-9,35
Western Sydn,6973,7,8,9,10,38,47,-9,33
Perth Glory,6973,8,10,2,15,37,50,-13,32
Wellington P,6973,9,5,6,16,31,55,-24,21
CC Mariners,6973,10,4,8,15,28,49,-21,20
Sydney FC,6974,1,21,4,3,67,23,44,67
N'castle Jet,6974,2,15,6,7,58,38,20,51
Melbourne C,6974,3,14,5,10,44,34,10,47
Melbourne V,6974,4,13,5,11,46,41,5,44
Adelaide Utd,6974,5,11,6,11,37,40,-3,39
Brisbane,6974,6,10,5,13,33,42,-9,35
Western Sydn,6974,7,8,9,10,38,47,-9,33
Perth Glory,6974,8,10,2,15,37,50,-13,32
Wellington P,6974,9,5,6,16,31,55,-24,21
CC Mariners,6974,10,4,8,15,28,49,-21,20
Sydney FC,6975,1,21,4,3,66,23,43,67
N'castle Jet,6975,2,15,5,8,58,39,19,50
Melbourne C,6975,3,15,4,10,45,34,11,49
Melbourne V,6975,4,13,5,11,46,40,6,44
Adelaide Utd,6975,5,11,6,11,37,40,-3,39
Brisbane,6975,6,10,5,13,33,42,-9,35
Western Sydn,6975,7,8,9,10,38,47,-9,33
Perth Glory,6975,8,10,2,15,37,50,-13,32
Wellington P,6975,9,5,6,16,31,55,-24,21
CC Mariners,6975,10,4,8,15,28,49,-21,20
Sydney FC,6976,1,21,4,3,68,22,46,67
N'castle Jet,6976,2,16,5,7,59,38,21,53
Melbourne C,6976,3,14,4,11,44,35,9,46
Melbourne V,6976,4,13,5,11,45,42,3,44
Adelaide Utd,6976,5,11,6,11,37,40,-3,39
Brisbane,6976,6,10,5,13,33,42,-9,35
Western Sydn,6976,7,8,9,10,38,47,-9,33
Perth Glory,6976,8,10,2,15,37,50,-13,32
Wellington P,6976,9,5,6,16,31,55,-24,21
CC Mariners,6976,10,4,8,15,28,49,-21,20
Sydney FC,6977,1,21,4,3,65,22,43,67
N'castle Jet,6977,2,15,6,7,58,38,20,51
Melbourne C,6977,3,14,5,10,44,34,10,47
Melbourne V,6977,4,13,5,11,45,39,6,44
Adelaide Utd,6977,5,11,6,11,37,40,-3,39
Brisbane,6977,6,10,5,13,33,42,-9,35
Western Sydn,6977,7,8,9,10,38,47,-9,33
Perth Glory,6977,8,10,2,15,37,50,-13,32
Wellington P,6977,9,5,6,16,31,55,-24,21
CC Mariners,6977,10,4,8,15,28,49,-21,20
Sydney FC,6978,1,21,4,3,68,23,45,67
N'castle Jet,6978,2,15,6,7,58,38,20,51
Melbourne C,6978,3,14,5,10,44,34,10,47
Melbourne V,6978,4,13,5,11,46,42,4,44
Adelaide Utd,6978,5,11,6,11,37,40,-3,39
Brisbane,6978,6,10,5,13,33,42,-9,35
Western Sydn,6978,7,8,9,10,38,47,-9,33
Perth Glory,6978,8,10,2,15,37,50,-13,32
Wellington P,6978,9,5,6,16,31,55,-24,21
CC Mariners,6978,10,4,8,15,28,49,-21,20
Sydney FC,6979,1,20,4,4,65,24,41,64
N'castle Jet,6979,2,16,5,7,59,38,21,53
Melbourne V,6979,3,14,5,10,47,39,8,47
Melbourne C,6979,4,14,4,11,44,35,9,46
Adelaide Utd,6979,5,11,6,11,37,40,-3,39
Brisbane,6979,6,10,5,13,33,42,-9,35
Western Sydn,6979,7,8,9,10,38,47,-9,33
Perth Glory,6979,8,10,2,15,37,50,-13,32
Wellington P,6979,9,5,6,16,31,55,-24,21
CC Mariners,6979,10,4,8,15,28,49,-21,20
Sydney FC,6980,1,20,5,3,65,23,42,65
N'castle Jet,6980,2,15,6,7,60,40,20,51
Melbourne C,6980,3,14,5,10,46,36,10,47
Melbourne V,6980,4,13,6,10,46,39,7,45
Adelaide Utd,6980,5,11,6,11,37,40,-3,39
Brisbane,6980,6,10,5,13,33,42,-9,35
Western Sydn,6980,7,8,9,10,38,47,-9,33
Perth Glory,6980,8,10,2,15,37,50,-13,32
Wellington P,6980,9,5,6,16,31,55,-24,21
CC Mariners,6980,10,4,8,15,28,49,-21,20
Sydney FC,6981,1,21,4,3,68,22,46,67
N'castle Jet,6981,2,16,5,7,59,38,21,53
Melbourne C,6981,3,14,4,11,44,35,9,46
Melbourne V,6981,4,13,5,11,45,42,3,44
Adelaide Utd,6981,5,11,6,11,37,40,-3,39
Brisbane,6981,6,10,5,13,33,42,-9,35
Western Sydn,6981,7,8,9,10,38,47,-9,33
Perth Glory,6981,8,10,2,15,37,50,-13,32
Wellington P,6981,9,5,6,16,31,55,-24,21
CC Mariners,6981,10,4,8,15,28,49,-21,20
Sydney FC,6982,1,21,4,3,68,22,46,67
N'castle Jet,6982,2,15,6,7,59,39,20,51
Melbourne C,6982,3,14,5,10,45,35,10,47
Melbourne V,6982,4,13,5,11,45,42,3,44
Adelaide Utd,6982,5,11,6,11,37,40,-3,39
Brisbane,6982,6,10,5,13,33,42,-9,35
Western Sydn,6982,7,8,9,10,38,47,-9,33
Perth Glory,6982,8,10,2,15,37,50,-13,32
Wellington P,6982,9,5,6,16,31,55,-24,21
CC Mariners,6982,10,4,8,15,28,49,-21,20
Sydney FC,6983,1,20,4,4,64,24,40,64
N'castle Jet,6983,2,16,5,7,58,37,21,53
Melbourne V,6983,3,14,5,10,47,38,9,47
Melbourne C,6983,4,14,4,11,43,34,9,46
Adelaide Utd,6983,5,11,6,11,37,40,-3,39
Brisbane,6983,6,10,5,13,33,42,-9,35
Western Sydn,6983,7,8,9,10,38,47,-9,33
Perth Glory,6983,8,10,2,15,37,50,-13,32
Wellington P,6983,9,5,6,16,31,55,-24,21
CC Mariners,6983,10,4,8,15,28,49,-21,20
Sydney FC,6984,1,21,4,3,65,22,43,67
N'castle Jet,6984,2,16,5,7,58,37,21,53
Melbourne C,6984,3,14,4,11,43,34,9,46
Melbourne V,6984,4,13,5,11,45,39,6,44
Adelaide Utd,6984,5,11,6,11,37,40,-3,39
Brisbane,6984,6,10,5,13,33,42,-9,35
Western Sydn,6984,7,8,9,10,38,47,-9,33
Perth Glory,6984,8,10,2,15,37,50,-13,32
Wellington P,6984,9,5,6,16,31,55,-24,21
CC Mariners,6984,10,4,8,15,28,49,-21,20
Sydney FC,6985,1,20,5,3,65,23,42,65
N'castle Jet,6985,2,16,5,7,59,37,22,53
Melbourne C,6985,3,14,4,11,43,35,8,46
Melbourne V,6985,4,13,6,10,46,39,7,45
Adelaide Utd,6985,5,11,6,11,37,40,-3,39
Brisbane,6985,6,10,5,13,33,42,-9,35
Western Sydn,6985,7,8,9,10,38,47,-9,33
Perth Glory,6985,8,10,2,15,37,50,-13,32
Wellington P,6985,9,5,6,16,31,55,-24,21
CC Mariners,6985,10,4,8,15,28,49,-21,20
Sydney FC,6986,1,21,4,3,69,23,46,67
N'castle Jet,6986,2,15,6,7,58,38,20,51
Melbourne C,6986,3,14,5,10,44,34,10,47
Melbourne V,6986,4,13,5,11,46,43,3,44
Adelaide Utd,6986,5,11,6,11,37,40,-3,39
Brisbane,6986,6,10,5,13,33,42,-9,35
Western Sydn,6986,7,8,9,10,38,47,-9,33
Perth Glory,6986,8,10,2,15,37,50,-13,32
Wellington P,6986,9,5,6,16,31,55,-24,21
CC Mariners,6986,10,4,8,15,28,49,-21,20
Sydney FC,6987,1,20,5,3,66,24,42,65
N'castle Jet,6987,2,15,5,8,58,39,19,50
Melbourne C,6987,3,15,4,10,45,34,11,49
Melbourne V,6987,4,13,6,10,47,40,7,45
Adelaide Utd,6987,5,11,6,11,37,40,-3,39
Brisbane,6987,6,10,5,13,33,42,-9,35
Western Sydn,6987,7,8,9,10,38,47,-9,33
Perth Glory,6987,8,10,2,15,37,50,-13,32
Wellington P,6987,9,5,6,16,31,55,-24,21
CC Mariners,6987,10,4,8,15,28,49,-21,20
Sydney FC,6988,1,20,5,3,65,23,42,65
N'castle Jet,6988,2,16,5,7,61,38,23,53
Melbourne C,6988,3,14,4,11,44,37,7,46
Melbourne V,6988,4,13,6,10,46,39,7,45
Adelaide Utd,6988,5,11,6,11,37,40,-3,39
Brisbane,6988,6,10,5,13,33,42,-9,35
Western Sydn,6988,7,8,9,10,38,47,-9,33
Perth Glory,6988,8,10,2,15,37,50,-13,32
Wellington P,6988,9,5,6,16,31,55,-24,21
CC Mariners,6988,10,4,8,15,28,49,-21,20
Sydney FC,6989,1,20,4,4,64,28,36,64
N'castle Jet,6989,2,16,5,7,59,37,22,53
Melbourne V,6989,3,14,5,10,51,38,13,47
Melbourne C,6989,4,14,4,11,43,35,8,46
Adelaide Utd,6989,5,11,6,11,37,40,-3,39
Brisbane,6989,6,10,5,13,33,42,-9,35
Western Sydn,6989,7,8,9,10,38,47,-9,33
Perth Glory,6989,8,10,2,15,37,50,-13,32
Wellington P,6989,9,5,6,16,31,55,-24,21
CC Mariners,6989,10,4,8,15,28,49,-21,20
Sydney FC,6990,1,21,4,3,66,23,43,67
N'castle Jet,6990,2,15,5,8,57,39,18,50
Melbourne C,6990,3,15,4,10,45,33,12,49
Melbourne V,6990,4,13,5,11,46,40,6,44
Adelaide Utd,6990,5,11,6,11,37,40,-3,39
Brisbane,6990,6,10,5,13,33,42,-9,35
Western Sydn,6990,7,8,9,10,38,47,-9,33
Perth Glory,6990,8,10,2,15,37,50,-13,32
Wellington P,6990,9,5,6,16,31,55,-24,21
CC Mariners,6990,10,4,8,15,28,49,-21,20
Sydney FC,6991,1,21,4,3,66,22,44,67
N'castle Jet,6991,2,16,5,7,61,38,23,53
Melbourne C,6991,3,14,4,11,44,37,7,46
Melbourne V,6991,4,13,5,11,45,40,5,44
Adelaide Utd,6991,5,11,6,11,37,40,-3,39
Brisbane,6991,6,10,5,13,33,42,-9,35
Western Sydn,6991,7,8,9,10,38,47,-9,33
Perth Glory,6991,8,10,2,15,37,50,-13,32
Wellington P,6991,9,5,6,16,31,55,-24,21
CC Mariners,6991,10,4,8,15,28,49,-21,20
Sydney FC,6992,1,21,4,3,68,22,46,67
N'castle Jet,6992,2,16,5,7,59,38,21,53
Melbourne C,6992,3,14,4,11,44,35,9,46
Melbourne V,6992,4,13,5,11,45,42,3,44
Adelaide Utd,6992,5,11,6,11,37,40,-3,39
Brisbane,6992,6,10,5,13,33,42,-9,35
Western Sydn,6992,7,8,9,10,38,47,-9,33
Perth Glory,6992,8,10,2,15,37,50,-13,32
Wellington P,6992,9,5,6,16,31,55,-24,21
CC Mariners,6992,10,4,8,15,28,49,-21,20
Sydney FC,6993,1,20,4,4,64,24,40,64
N'castle Jet,6993,2,16,5,7,60,38,22,53
Melbourne V,6993,3,14,5,10,47,38,9,47
Melbourne C,6993,4,14,4,11,44,36,8,46
Adelaide Utd,6993,5,11,6,11,37,40,-3,39
Brisbane,6993,6,10,5,13,33,42,-9,35
Western Sydn,6993,7,8,9,10,38,47,-9,33
Perth Glory,6993,8,10,2,15,37,50,-13,32
Wellington P,6993,9,5,6,16,31,55,-24,21
CC Mariners,6993,10,4,8,15,28,49,-21,20
Sydney FC,6994,1,20,4,4,67,26,41,64
N'castle Jet,6994,2,16,5,7,62,39,23,53
Melbourne V,6994,3,14,5,10,49,41,8,47
Melbourne C,6994,4,14,4,11,45,38,7,46
Adelaide Utd,6994,5,11,6,11,37,40,-3,39
Brisbane,6994,6,10,5,13,33,42,-9,35
Western Sydn,6994,7,8,9,10,38,47,-9,33
Perth Glory,6994,8,10,2,15,37,50,-13,32
Wellington P,6994,9,5,6,16,31,55,-24,21
CC Mariners,6994,10,4,8,15,28,49,-21,20
Sydney FC,6995,1,21,4,3,67,22,45,67
N'castle Jet,6995,2,15,5,8,57,41,16,50
Melbourne C,6995,3,15,4,10,47,33,14,49
Melbourne V,6995,4,13,5,11,45,41,4,44
Adelaide Utd,6995,5,11,6,11,37,40,-3,39
Brisbane,6995,6,10,5,13,33,42,-9,35
Western Sydn,6995,7,8,9,10,38,47,-9,33
Perth Glory,6995,8,10,2,15,37,50,-13,32
Wellington P,6995,9,5,6,16,31,55,-24,21
CC Mariners,6995,10,4,8,15,28,49,-21,20
Sydney FC,6996,1,21,4,3,67,24,43,67
N'castle Jet,6996,2,16,5,7,60,39,21,53
Melbourne C,6996,3,14,4,11,45,36,9,46
Melbourne V,6996,4,13,5,11,47,41,6,44
Adelaide Utd,6996,5,11,6,11,37,40,-3,39
Brisbane,6996,6,10,5,13,33,42,-9,35
Western Sydn,6996,7,8,9,10,38,47,-9,33
Perth Glory,6996,8,10,2,15,37,50,-13,32
Wellington P,6996,9,5,6,16,31,55,-24,21
CC Mariners,6996,10,4,8,15,28,49,-21,20
Sydney FC,6997,1,21,4,3,67,24,43,67
N'castle Jet,6997,2,15,5,8,57,41,16,50
Melbourne C,6997,3,15,4,10,47,33,14,49
Melbourne V,6997,4,13,5,11,47,41,6,44
Adelaide Utd,6997,5,11,6,11,37,40,-3,39
Brisbane,6997,6,10,5,13,33,42,-9,35
Western Sydn,6997,7,8,9,10,38,47,-9,33
Perth Glory,6997,8,10,2,15,37,50,-13,32
Wellington P,6997,9,5,6,16,31,55,-24,21
CC Mariners,6997,10,4,8,15,28,49,-21,20
Sydney FC,6998,1,21,4,3,66,23,43,67
N'castle Jet,6998,2,16,5,7,59,37,22,53
Melbourne C,6998,3,14,4,11,43,35,8,46
Melbourne V,6998,4,13,5,11,46,40,6,44
Adelaide Utd,6998,5,11,6,11,37,40,-3,39
Brisbane,6998,6,10,5,13,33,42,-9,35
Western Sydn,6998,7,8,9,10,38,47,-9,33
Perth Glory,6998,8,10,2,15,37,50,-13,32
Wellington P,6998,9,5,6,16,31,55,-24,21
CC Mariners,6998,10,4,8,15,28,49,-21,20
Sydney FC,6999,1,20,4,4,66,25,41,64
N'castle Jet,6999,2,15,6,7,57,37,20,51
Melbourne C,6999,3,14,5,10,43,33,10,47
Melbourne V,6999,4,14,5,10,48,40,8,47
Adelaide Utd,6999,5,11,6,11,37,40,-3,39
Brisbane,6999,6,10,5,13,33,42,-9,35
Western Sydn,6999,7,8,9,10,38,47,-9,33
Perth Glory,6999,8,10,2,15,37,50,-13,32
Wellington P,6999,9,5,6,16,31,55,-24,21
CC Mariners,6999,10,4,8,15,28,49,-21,20
Sydney FC,7000,1,20,5,3,64,22,42,65
N'castle Jet,7000,2,16,5,7,59,38,21,53
Melbourne C,7000,3,14,4,11,44,35,9,46
Melbourne V,7000,4,13,6,10,45,38,7,45
Adelaide Utd,7000,5,11,6,11,37,40,-3,39
Brisbane,7000,6,10,5,13,33,42,-9,35
Western Sydn,7000,7,8,9,10,38,47,-9,33
Perth Glory,7000,8,10,2,15,37,50,-13,32
Wellington P,7000,9,5,6,16,31,55,-24,21
CC Mariners,7000,10,4,8,15,28,49,-21,20
Sydney FC,7001,1,21,4,3,66,22,44,67
N'castle Jet,7001,2,16,5,7,60,37,23,53
Melbourne C,7001,3,14,4,11,43,36,7,46
Melbourne V,7001,4,13,5,11,45,40,5,44
Adelaide Utd,7001,5,11,6,11,37,40,-3,39
Brisbane,7001,6,10,5,13,33,42,-9,35
Western Sydn,7001,7,8,9,10,38,47,-9,33
Perth Glory,7001,8,10,2,15,37,50,-13,32
Wellington P,7001,9,5,6,16,31,55,-24,21
CC Mariners,7001,10,4,8,15,28,49,-21,20
Sydney FC,7002,1,20,4,4,67,26,41,64
N'castle Jet,7002,2,15,5,8,59,40,19,50
Melbourne C,7002,3,15,4,10,46,35,11,49
Melbourne V,7002,4,14,5,10,49,41,8,47
Adelaide Utd,7002,5,11,6,11,37,40,-3,39
Brisbane,7002,6,10,5,13,33,42,-9,35
Western Sydn,7002,7,8,9,10,38,47,-9,33
Perth Glory,7002,8,10,2,15,37,50,-13,32
Wellington P,7002,9,5,6,16,31,55,-24,21
CC Mariners,7002,10,4,8,15,28,49,-21,20
Sydney FC,7003,1,20,5,3,65,23,42,65
N'castle Jet,7003,2,15,6,7,59,39,20,51
Melbourne C,7003,3,14,5,10,45,35,10,47
Melbourne V,7003,4,13,6,10,46,39,7,45
Adelaide Utd,7003,5,11,6,11,37,40,-3,39
Brisbane,7003,6,10,5,13,33,42,-9,35
Western Sydn,7003,7,8,9,10,38,47,-9,33
Perth Glory,7003,8,10,2,15,37,50,-13,32
Wellington P,7003,9,5,6,16,31,55,-24,21
CC Mariners,7003,10,4,8,15,28,49,-21,20
Sydney FC,7004,1,21,4,3,66,22,44,67
N'castle Jet,7004,2,16,5,7,59,38,21,53
Melbourne C,7004,3,14,4,11,44,35,9,46
Melbourne V,7004,4,13,5,11,45,40,5,44
Adelaide Utd,7004,5,11,6,11,37,40,-3,39
Brisbane,7004,6,10,5,13,33,42,-9,35
Western Sydn,7004,7,8,9,10,38,47,-9,33
Perth Glory,7004,8,10,2,15,37,50,-13,32
Wellington P,7004,9,5,6,16,31,55,-24,21
CC Mariners,7004,10,4,8,15,28,49,-21,20
Sydney FC,7005,1,21,4,3,67,24,43,67
N'castle Jet,7005,2,15,6,7,59,39,20,51
Melbourne C,7005,3,14,5,10,45,35,10,47
Melbourne V,7005,4,13,5,11,47,41,6,44
Adelaide Utd,7005,5,11,6,11,37,40,-3,39
Brisbane,7005,6,10,5,13,33,42,-9,35
Western Sydn,7005,7,8,9,10,38,47,-9,33
Perth Glory,7005,8,10,2,15,37,50,-13,32
Wellington P,7005,9,5,6,16,31,55,-24,21
CC Mariners,7005,10,4,8,15,28,49,-21,20
Sydney FC,7006,1,21,4,3,65,22,43,67
N'castle Jet,7006,2,15,6,7,59,39,20,51
Melbourne C,7006,3,14,5,10,45,35,10,47
Melbourne V,7006,4,13,5,11,45,39,6,44
Adelaide Utd,7006,5,11,6,11,37,40,-3,39
Brisbane,7006,6,10,5,13,33,42,-9,35
Western Sydn,7006,7,8,9,10,38,47,-9,33
Perth Glory,7006,8,10,2,15,37,50,-13,32
Wellington P,7006,9,5,6,16,31,55,-24,21
CC Mariners,7006,10,4,8,15,28,49,-21,20
Sydney FC,7007,1,20,4,4,64,25,39,64
N'castle Jet,7007,2,15,6,7,58,38,20,51
Melbourne V,7007,3,14,5,10,48,38,10,47
Melbourne C,7007,4,14,5,10,44,34,10,47
Adelaide Utd,7007,5,11,6,11,37,40,-3,39
Brisbane,7007,6,10,5,13,33,42,-9,35
Western Sydn,7007,7,8,9,10,38,47,-9,33
Perth Glory,7007,8,10,2,15,37,50,-13,32
Wellington P,7007,9,5,6,16,31,55,-24,21
CC Mariners,7007,10,4,8,15,28,49,-21,20
Sydney FC,7008,1,21,4,3,66,23,43,67
N'castle Jet,7008,2,15,6,7,58,38,20,51
Melbourne C,7008,3,14,5,10,44,34,10,47
Melbourne V,7008,4,13,5,11,46,40,6,44
Adelaide Utd,7008,5,11,6,11,37,40,-3,39
Brisbane,7008,6,10,5,13,33,42,-9,35
Western Sydn,7008,7,8,9,10,38,47,-9,33
Perth Glory,7008,8,10,2,15,37,50,-13,32
Wellington P,7008,9,5,6,16,31,55,-24,21
CC Mariners,7008,10,4,8,15,28,49,-21,20
Sydney FC,7009,1,21,4,3,66,23,43,67
N'castle Jet,7009,2,16,5,7,60,38,22,53
Melbourne C,7009,3,14,4,11,44,36,8,46
Melbourne V,7009,4,13,5,11,46,40,6,44
Adelaide Utd,7009,5,11,6,11,37,40,-3,39
Brisbane,7009,6,10,5,13,33,42,-9,35
Western Sydn,7009,7,8,9,10,38,47,-9,33
Perth Glory,7009,8,10,2,15,37,50,-13,32
Wellington P,7009,9,5,6,16,31,55,-24,21
CC Mariners,7009,10,4,8,15,28,49,-21,20
Sydney FC,7010,1,20,5,3,64,22,42,65
N'castle Jet,7010,2,15,5,8,58,39,19,50
Melbourne C,7010,3,15,4,10,45,34,11,49
Melbourne V,7010,4,13,6,10,45,38,7,45
Adelaide Utd,7010,5,11,6,11,37,40,-3,39
Brisbane,7010,6,10,5,13,33,42,-9,35
Western Sydn,7010,7,8,9,10,38,47,-9,33
Perth Glory,7010,8,10,2,15,37,50,-13,32
Wellington P,7010,9,5,6,16,31,55,-24,21
CC Mariners,7010,10,4,8,15,28,49,-21,20
Sydney FC,7011,1,20,4,4,64,23,41,64
N'castle Jet,7011,2,15,6,7,59,39,20,51
Melbourne C,7011,3,14,5,10,45,35,10,47
Melbourne V,7011,4,14,5,10,46,38,8,47
Adelaide Utd,7011,5,11,6,11,37,40,-3,39
Brisbane,7011,6,10,5,13,33,42,-9,35
Western Sydn,7011,7,8,9,10,38,47,-9,33
Perth Glory,7011,8,10,2,15,37,50,-13,32
Wellington P,7011,9,5,6,16,31,55,-24,21
CC Mariners,7011,10,4,8,15,28,49,-21,20
Sydney FC,7012,1,20,4,4,64,24,40,64
N'castle Jet,7012,2,16,5,7,64,41,23,53
Melbourne V,7012,3,14,5,10,47,38,9,47
Melbourne C,7012,4,14,4,11,47,40,7,46
Adelaide Utd,7012,5,11,6,11,37,40,-3,39
Brisbane,7012,6,10,5,13,33,42,-9,35
Western Sydn,7012,7,8,9,10,38,47,-9,33
Perth Glory,7012,8,10,2,15,37,50,-13,32
Wellington P,7012,9,5,6,16,31,55,-24,21
CC Mariners,7012,10,4,8,15,28,49,-21,20
Sydney FC,7013,1,21,4,3,67,24,43,67
N'castle Jet,7013,2,15,6,7,58,38,20,51
Melbourne C,7013,3,14,5,10,44,34,10,47
Melbourne V,7013,4,13,5,11,47,41,6,44
Adelaide Utd,7013,5,11,6,11,37,40,-3,39
Brisbane,7013,6,10,5,13,33,42,-9,35
Western Sydn,7013,7,8,9,10,38,47,-9,33
Perth Glory,7013,8,10,2,15,37,50,-13,32
Wellington P,7013,9,5,6,16,31,55,-24,21
CC Mariners,7013,10,4,8,15,28,49,-21,20
Sydney FC,7014,1,20,5,3,66,24,42,65
N'castle Jet,7014,2,16,5,7,59,37,22,53
Melbourne C,7014,3,14,4,11,43,35,8,46
Melbourne V,7014,4,13,6,10,47,40,7,45
Adelaide Utd,7014,5,11,6,11,37,40,-3,39
Brisbane,7014,6,10,5,13,33,42,-9,35
Western Sydn,7014,7,8,9,10,38,47,-9,33
Perth Glory,7014,8,10,2,15,37,50,-13,32
Wellington P,7014,9,5,6,16,31,55,-24,21
CC Mariners,7014,10,4,8,15,28,49,-21,20
Sydney FC,7015,1,21,4,3,66,23,43,67
N'castle Jet,7015,2,16,5,7,58,37,21,53
Melbourne C,7015,3,14,4,11,43,34,9,46
Melbourne V,7015,4,13,5,11,46,40,6,44
Adelaide Utd,7015,5,11,6,11,37,40,-3,39
Brisbane,7015,6,10,5,13,33,42,-9,35
Western Sydn,7015,7,8,9,10,38,47,-9,33
Perth Glory,7015,8,10,2,15,37,50,-13,32
Wellington P,7015,9,5,6,16,31,55,-24,21
CC Mariners,7015,10,4,8,15,28,49,-21,20
Sydney FC,7016,1,20,4,4,65,24,41,64
N'castle Jet,7016,2,16,5,7,61,37,24,53
Melbourne V,7016,3,14,5,10,47,39,8,47
Melbourne C,7016,4,14,4,11,43,37,6,46
Adelaide Utd,7016,5,11,6,11,37,40,-3,39
Brisbane,7016,6,10,5,13,33,42,-9,35
Western Sydn,7016,7,8,9,10,38,47,-9,33
Perth Glory,7016,8,10,2,15,37,50,-13,32
Wellington P,7016,9,5,6,16,31,55,-24,21
CC Mariners,7016,10,4,8,15,28,49,-21,20
Sydney FC,7017,1,21,4,3,66,22,44,67
N'castle Jet,7017,2,15,6,7,59,39,20,51
Melbourne C,7017,3,14,5,10,45,35,10,47
Melbourne V,7017,4,13,5,11,45,40,5,44
Adelaide Utd,7017,5,11,6,11,37,40,-3,39
Brisbane,7017,6,10,5,13,33,42,-9,35
Western Sydn,7017,7,8,9,10,38,47,-9,33
Perth Glory,7017,8,10,2,15,37,50,-13,32
Wellington P,7017,9,5,6,16,31,55,-24,21
CC Mariners,7017,10,4,8,15,28,49,-21,20
Sydney FC,7018,1,21,4,3,67,22,45,67
N'castle Jet,7018,2,16,5,7,58,37,21,53
Melbourne C,7018,3,14,4,11,43,34,9,46
Melbourne V,7018,4,13,5,11,45,41,4,44
Adelaide Utd,7018,5,11,6,11,37,40,-3,39
Brisbane,7018,6,10,5,13,33,42,-9,35
Western Sydn,7018,7,8,9,10,38,47,-9,33
Perth Glory,7018,8,10,2,15,37,50,-13,32
Wellington P,7018,9,5,6,16,31,55,-24,21
CC Mariners,7018,10,4,8,15,28,49,-21,20
Sydney FC,7019,1,21,4,3,69,22,47,67
N'castle Jet,7019,2,16,5,7,59,38,21,53
Melbourne C,7019,3,14,4,11,44,35,9,46
Melbourne V,7019,4,13,5,11,45,43,2,44
Adelaide Utd,7019,5,11,6,11,37,40,-3,39
Brisbane,7019,6,10,5,13,33,42,-9,35
Western Sydn,7019,7,8,9,10,38,47,-9,33
Perth Glory,7019,8,10,2,15,37,50,-13,32
Wellington P,7019,9,5,6,16,31,55,-24,21
CC Mariners,7019,10,4,8,15,28,49,-21,20
Sydney FC,7020,1,20,5,3,65,23,42,65
N'castle Jet,7020,2,15,6,7,58,38,20,51
Melbourne C,7020,3,14,5,10,44,34,10,47
Melbourne V,7020,4,13,6,10,46,39,7,45
Adelaide Utd,7020,5,11,6,11,37,40,-3,39
Brisbane,7020,6,10,5,13,33,42,-9,35
Western Sydn,7020,7,8,9,10,38,47,-9,33
Perth Glory,7020,8,10,2,15,37,50,-13,32
Wellington P,7020,9,5,6,16,31,55,-24,21
CC Mariners,7020,10,4,8,15,28,49,-21,20
Sydney FC,7021,1,21,4,3,67,22,45,67
N'castle Jet,7021,2,16,5,7,58,37,21,53
Melbourne C,7021,3,14,4,11,43,34,9,46
Melbourne V,7021,4,13,5,11,45,41,4,44
Adelaide Utd,7021,5,11,6,11,37,40,-3,39
Brisbane,7021,6,10,5,13,33,42,-9,35
Western Sydn,7021,7,8,9,10,38,47,-9,33
Perth Glory,7021,8,10,2,15,37,50,-13,32
Wellington P,7021,9,5,6,16,31,55,-24,21
CC Mariners,7021,10,4,8,15,28,49,-21,20
Sydney FC,7022,1,21,4,3,66,23,43,67
N'castle Jet,7022,2,16,5,7,58,37,21,53
Melbourne C,7022,3,14,4,11,43,34,9,46
Melbourne V,7022,4,13,5,11,46,40,6,44
Adelaide Utd,7022,5,11,6,11,37,40,-3,39
Brisbane,7022,6,10,5,13,33,42,-9,35
Western Sydn,7022,7,8,9,10,38,47,-9,33
Perth Glory,7022,8,10,2,15,37,50,-13,32
Wellington P,7022,9,5,6,16,31,55,-24,21
CC Mariners,7022,10,4,8,15,28,49,-21,20
Sydney FC,7023,1,21,4,3,69,22,47,67
N'castle Jet,7023,2,16,5,7,60,38,22,53
Melbourne C,7023,3,14,4,11,44,36,8,46
Melbourne V,7023,4,13,5,11,45,43,2,44
Adelaide Utd,7023,5,11,6,11,37,40,-3,39
Brisbane,7023,6,10,5,13,33,42,-9,35
Western Sydn,7023,7,8,9,10,38,47,-9,33
Perth Glory,7023,8,10,2,15,37,50,-13,32
Wellington P,7023,9,5,6,16,31,55,-24,21
CC Mariners,7023,10,4,8,15,28,49,-21,20
Sydney FC,7024,1,21,4,3,67,24,43,67
N'castle Jet,7024,2,16,5,7,59,37,22,53
Melbourne C,7024,3,14,4,11,43,35,8,46
Melbourne V,7024,4,13,5,11,47,41,6,44
Adelaide Utd,7024,5,11,6,11,37,40,-3,39
Brisbane,7024,6,10,5,13,33,42,-9,35
Western Sydn,7024,7,8,9,10,38,47,-9,33
Perth Glory,7024,8,10,2,15,37,50,-13,32
Wellington P,7024,9,5,6,16,31,55,-24,21
CC Mariners,7024,10,4,8,15,28,49,-21,20
Sydney FC,7025,1,21,4,3,66,22,44,67
N'castle Jet,7025,2,15,5,8,58,39,19,50
Melbourne C,7025,3,15,4,10,45,34,11,49
Melbourne V,7025,4,13,5,11,45,40,5,44
Adelaide Utd,7025,5,11,6,11,37,40,-3,39
Brisbane,7025,6,10,5,13,33,42,-9,35
Western Sydn,7025,7,8,9,10,38,47,-9,33
Perth Glory,7025,8,10,2,15,37,50,-13,32
Wellington P,7025,9,5,6,16,31,55,-24,21
CC Mariners,7025,10,4,8,15,28,49,-21,20
Sydney FC,7026,1,21,4,3,65,22,43,67
N'castle Jet,7026,2,16,5,7,61,38,23,53
Melbourne C,7026,3,14,4,11,44,37,7,46
Melbourne V,7026,4,13,5,11,45,39,6,44
Adelaide Utd,7026,5,11,6,11,37,40,-3,39
Brisbane,7026,6,10,5,13,33,42,-9,35
Western Sydn,7026,7,8,9,10,38,47,-9,33
Perth Glory,7026,8,10,2,15,37,50,-13,32
Wellington P,7026,9,5,6,16,31,55,-24,21
CC Mariners,7026,10,4,8,15,28,49,-21,20
Sydney FC,7027,1,21,4,3,69,22,47,67
N'castle Jet,7027,2,15,5,8,59,40,19,50
Melbourne C,7027,3,15,4,10,46,35,11,49
Melbourne V,7027,4,13,5,11,45,43,2,44
Adelaide Utd,7027,5,11,6,11,37,40,-3,39
Brisbane,7027,6,10,5,13,33,42,-9,35
Western Sydn,7027,7,8,9,10,38,47,-9,33
Perth Glory,7027,8,10,2,15,37,50,-13,32
Wellington P,7027,9,5,6,16,31,55,-24,21
CC Mariners,7027,10,4,8,15,28,49,-21,20
Sydney FC,7028,1,20,4,4,65,24,41,64
N'castle Jet,7028,2,15,6,7,59,39,20,51
Melbourne C,7028,3,14,5,10,45,35,10,47
Melbourne V,7028,4,14,5,10,47,39,8,47
Adelaide Utd,7028,5,11,6,11,37,40,-3,39
Brisbane,7028,6,10,5,13,33,42,-9,35
Western Sydn,7028,7,8,9,10,38,47,-9,33
Perth Glory,7028,8,10,2,15,37,50,-13,32
Wellington P,7028,9,5,6,16,31,55,-24,21
CC Mariners,7028,10,4,8,15,28,49,-21,20
Sydney FC,7029,1,20,4,4,64,23,41,64
N'castle Jet,7029,2,16,5,7,62,38,24,53
Melbourne V,7029,3,14,5,10,46,38,8,47
Melbourne C,7029,4,14,4,11,44,38,6,46
Adelaide Utd,7029,5,11,6,11,37,40,-3,39
Brisbane,7029,6,10,5,13,33,42,-9,35
Western Sydn,7029,7,8,9,10,38,47,-9,33
Perth Glory,7029,8,10,2,15,37,50,-13,32
Wellington P,7029,9,5,6,16,31,55,-24,21
CC Mariners,7029,10,4,8,15,28,49,-21,20
Sydney FC,7030,1,20,5,3,66,24,42,65
N'castle Jet,7030,2,15,5,8,58,39,19,50
Melbourne C,7030,3,15,4,10,45,34,11,49
Melbourne V,7030,4,13,6,10,47,40,7,45
Adelaide Utd,7030,5,11,6,11,37,40,-3,39
Brisbane,7030,6,10,5,13,33,42,-9,35
Western Sydn,7030,7,8,9,10,38,47,-9,33
Perth Glory,7030,8,10,2,15,37,50,-13,32
Wellington P,7030,9,5,6,16,31,55,-24,21
CC Mariners,7030,10,4,8,15,28,49,-21,20
Sydney FC,7031,1,20,5,3,65,23,42,65
N'castle Jet,7031,2,16,5,7,58,37,21,53
Melbourne C,7031,3,14,4,11,43,34,9,46
Melbourne V,7031,4,13,6,10,46,39,7,45
Adelaide Utd,7031,5,11,6,11,37,40,-3,39
Brisbane,7031,6,10,5,13,33,42,-9,35
Western Sydn,7031,7,8,9,10,38,47,-9,33
Perth Glory,7031,8,10,2,15,37,50,-13,32
Wellington P,7031,9,5,6,16,31,55,-24,21
CC Mariners,7031,10,4,8,15,28,49,-21,20
Sydney FC,7032,1,21,4,3,68,23,45,67
N'castle Jet,7032,2,15,6,7,59,39,20,51
Melbourne C,7032,3,14,5,10,45,35,10,47
Melbourne V,7032,4,13,5,11,46,42,4,44
Adelaide Utd,7032,5,11,6,11,37,40,-3,39
Brisbane,7032,6,10,5,13,33,42,-9,35
Western Sydn,7032,7,8,9,10,38,47,-9,33
Perth Glory,7032,8,10,2,15,37,50,-13,32
Wellington P,7032,9,5,6,16,31,55,-24,21
CC Mariners,7032,10,4,8,15,28,49,-21,20
Sydney FC,7033,1,20,5,3,65,23,42,65
N'castle Jet,7033,2,16,5,7,59,37,22,53
Melbourne C,7033,3,14,4,11,43,35,8,46
Melbourne V,7033,4,13,6,10,46,39,7,45
Adelaide Utd,7033,5,11,6,11,37,40,-3,39
Brisbane,7033,6,10,5,13,33,42,-9,35
Western Sydn,7033,7,8,9,10,38,47,-9,33
Perth Glory,7033,8,10,2,15,37,50,-13,32
Wellington P,7033,9,5,6,16,31,55,-24,21
CC Mariners,7033,10,4,8,15,28,49,-21,20
Sydney FC,7034,1,20,4,4,64,23,41,64
N'castle Jet,7034,2,15,6,7,58,38,20,51
Melbourne C,7034,3,14,5,10,44,34,10,47
Melbourne V,7034,4,14,5,10,46,38,8,47
Adelaide Utd,7034,5,11,6,11,37,40,-3,39
Brisbane,7034,6,10,5,13,33,42,-9,35
Western Sydn,7034,7,8,9,10,38,47,-9,33
Perth Glory,7034,8,10,2,15,37,50,-13,32
Wellington P,7034,9,5,6,16,31,55,-24,21
CC Mariners,7034,10,4,8,15,28,49,-21,20
Sydney FC,7035,1,21,4,3,66,22,44,67
N'castle Jet,7035,2,16,5,7,60,38,22,53
Melbourne C,7035,3,14,4,11,44,36,8,46
Melbourne V,7035,4,13,5,11,45,40,5,44
Adelaide Utd,7035,5,11,6,11,37,40,-3,39
Brisbane,7035,6,10,5,13,33,42,-9,35
Western Sydn,7035,7,8,9,10,38,47,-9,33
Perth Glory,7035,8,10,2,15,37,50,-13,32
Wellington P,7035,9,5,6,16,31,55,-24,21
CC Mariners,7035,10,4,8,15,28,49,-21,20
Sydney FC,7036,1,20,5,3,67,25,42,65
N'castle Jet,7036,2,16,5,7,59,38,21,53
Melbourne C,7036,3,14,4,11,44,35,9,46
Melbourne V,7036,4,13,6,10,48,41,7,45
Adelaide Utd,7036,5,11,6,11,37,40,-3,39
Brisbane,7036,6,10,5,13,33,42,-9,35
Western Sydn,7036,7,8,9,10,38,47,-9,33
Perth Glory,7036,8,10,2,15,37,50,-13,32
Wellington P,7036,9,5,6,16,31,55,-24,21
CC Mariners,7036,10,4,8,15,28,49,-21,20
Sydney FC,7037,1,21,4,3,66,22,44,67
N'castle Jet,7037,2,16,5,7,60,37,23,53
Melbourne C,7037,3,14,4,11,43,36,7,46
Melbourne V,7037,4,13,5,11,45,40,5,44
Adelaide Utd,7037,5,11,6,11,37,40,-3,39
Brisbane,7037,6,10,5,13,33,42,-9,35
Western Sydn,7037,7,8,9,10,38,47,-9,33
Perth Glory,7037,8,10,2,15,37,50,-13,32
Wellington P,7037,9,5,6,16,31,55,-24,21
CC Mariners,7037,10,4,8,15,28,49,-21,20
Sydney FC,7038,1,21,4,3,68,22,46,67
N'castle Jet,7038,2,16,5,7,59,38,21,53
Melbourne C,7038,3,14,4,11,44,35,9,46
Melbourne V,7038,4,13,5,11,45,42,3,44
Adelaide Utd,7038,5,11,6,11,37,40,-3,39
Brisbane,7038,6,10,5,13,33,42,-9,35
Western Sydn,7038,7,8,9,10,38,47,-9,33
Perth Glory,7038,8,10,2,15,37,50,-13,32
Wellington P,7038,9,5,6,16,31,55,-24,21
CC Mariners,7038,10,4,8,15,28,49,-21,20
Sydney FC,7039,1,20,4,4,66,26,40,64
N'castle Jet,7039,2,15,6,7,59,39,20,51
Melbourne C,7039,3,14,5,10,45,35,10,47
Melbourne V,7039,4,14,5,10,49,40,9,47
Adelaide Utd,7039,5,11,6,11,37,40,-3,39
Brisbane,7039,6,10,5,13,33,42,-9,35
Western Sydn,7039,7,8,9,10,38,47,-9,33
Perth Glory,7039,8,10,2,15,37,50,-13,32
Wellington P,7039,9,5,6,16,31,55,-24,21
CC Mariners,7039,10,4,8,15,28,49,-21,20
Sydney FC,7040,1,20,4,4,65,24,41,64
N'castle Jet,7040,2,16,5,7,59,37,22,53
Melbourne V,7040,3,14,5,10,47,39,8,47
Melbourne C,7040,4,14,4,11,43,35,8,46
Adelaide Utd,7040,5,11,6,11,37,40,-3,39
Brisbane,7040,6,10,5,13,33,42,-9,35
Western Sydn,7040,7,8,9,10,38,47,-9,33
Perth Glory,7040,8,10,2,15,37,50,-13,32
Wellington P,7040,9,5,6,16,31,55,-24,21
CC Mariners,7040,10,4,8,15,28,49,-21,20
Sydney FC,7041,1,20,5,3,65,23,42,65
N'castle Jet,7041,2,16,5,7,59,38,21,53
Melbourne C,7041,3,14,4,11,44,35,9,46
Melbourne V,7041,4,13,6,10,46,39,7,45
Adelaide Utd,7041,5,11,6,11,37,40,-3,39
Brisbane,7041,6,10,5,13,33,42,-9,35
Western Sydn,7041,7,8,9,10,38,47,-9,33
Perth Glory,7041,8,10,2,15,37,50,-13,32
Wellington P,7041,9,5,6,16,31,55,-24,21
CC Mariners,7041,10,4,8,15,28,49,-21,20
Sydney FC,7042,1,21,4,3,65,22,43,67
N'castle Jet,7042,2,16,5,7,59,38,21,53
Melbourne C,7042,3,14,4,11,44,35,9,46
Melbourne V,7042,4,13,5,11,45,39,6,44
Adelaide Utd,7042,5,11,6,11,37,40,-3,39
Brisbane,7042,6,10,5,13,33,42,-9,35
Western Sydn,7042,7,8,9,10,38,47,-9,33
Perth Glory,7042,8,10,2,15,37,50,-13,32
Wellington P,7042,9,5,6,16,31,55,-24,21
CC Mariners,7042,10,4,8,15,28,49,-21,20
Sydney FC,7043,1,21,4,3,67,23,44,67
N'castle Jet,7043,2,16,5,7,59,37,22,53
Melbourne C,7043,3,14,4,11,43,35,8,46
Melbourne V,7043,4,13,5,11,46,41,5,44
Adelaide Utd,7043,5,11,6,11,37,40,-3,39
Brisbane,7043,6,10,5,13,33,42,-9,35
Western Sydn,7043,7,8,9,10,38,47,-9,33
Perth Glory,7043,8,10,2,15,37,50,-13,32
Wellington P,7043,9,5,6,16,31,55,-24,21
CC Mariners,7043,10,4,8,15,28,49,-21,20
Sydney FC,7044,1,21,4,3,67,23,44,67
N'castle Jet,7044,2,15,6,7,58,38,20,51
Melbourne C,7044,3,14,5,10,44,34,10,47
Melbourne V,7044,4,13,5,11,46,41,5,44
Adelaide Utd,7044,5,11,6,11,37,40,-3,39
Brisbane,7044,6,10,5,13,33,42,-9,35
Western Sydn,7044,7,8,9,10,38,47,-9,33
Perth Glory,7044,8,10,2,15,37,50,-13,32
Wellington P,7044,9,5,6,16,31,55,-24,21
CC Mariners,7044,10,4,8,15,28,49,-21,20
Sydney FC,7045,1,21,4,3,67,23,44,67
N'castle Jet,7045,2,16,5,7,60,37,23,53
Melbourne C,7045,3,14,4,11,43,36,7,46
Melbourne V,7045,4,13,5,11,46,41,5,44
Adelaide Utd,7045,5,11,6,11,37,40,-3,39
Brisbane,7045,6,10,5,13,33,42,-9,35
Western Sydn,7045,7,8,9,10,38,47,-9,33
Perth Glory,7045,8,10,2,15,37,50,-13,32
Wellington P,7045,9,5,6,16,31,55,-24,21
CC Mariners,7045,10,4,8,15,28,49,-21,20
Sydney FC,7046,1,20,5,3,65,23,42,65
N'castle Jet,7046,2,16,5,7,59,37,22,53
Melbourne C,7046,3,14,4,11,43,35,8,46
Melbourne V,7046,4,13,6,10,46,39,7,45
Adelaide Utd,7046,5,11,6,11,37,40,-3,39
Brisbane,7046,6,10,5,13,33,42,-9,35
Western Sydn,7046,7,8,9,10,38,47,-9,33
Perth Glory,7046,8,10,2,15,37,50,-13,32
Wellington P,7046,9,5,6,16,31,55,-24,21
CC Mariners,7046,10,4,8,15,28,49,-21,20
Sydney FC,7047,1,20,4,4,65,25,40,64
N'castle Jet,7047,2,15,5,8,58,39,19,50
Melbourne C,7047,3,15,4,10,45,34,11,49
Melbourne V,7047,4,14,5,10,48,39,9,47
Adelaide Utd,7047,5,11,6,11,37,40,-3,39
Brisbane,7047,6,10,5,13,33,42,-9,35
Western Sydn,7047,7,8,9,10,38,47,-9,33
Perth Glory,7047,8,10,2,15,37,50,-13,32
Wellington P,7047,9,5,6,16,31,55,-24,21
CC Mariners,7047,10,4,8,15,28,49,-21,20
Sydney FC,7048,1,21,4,3,66,22,44,67
N'castle Jet,7048,2,15,5,8,58,39,19,50
Melbourne C,7048,3,15,4,10,45,34,11,49
Melbourne V,7048,4,13,5,11,45,40,5,44
Adelaide Utd,7048,5,11,6,11,37,40,-3,39
Brisbane,7048,6,10,5,13,33,42,-9,35
Western Sydn,7048,7,8,9,10,38,47,-9,33
Perth Glory,7048,8,10,2,15,37,50,-13,32
Wellington P,7048,9,5,6,16,31,55,-24,21
CC Mariners,7048,10,4,8,15,28,49,-21,20
Sydney FC,7049,1,21,4,3,67,23,44,67
N'castle Jet,7049,2,16,5,7,58,37,21,53
Melbourne C,7049,3,14,4,11,43,34,9,46
Melbourne V,7049,4,13,5,11,46,41,5,44
Adelaide Utd,7049,5,11,6,11,37,40,-3,39
Brisbane,7049,6,10,5,13,33,42,-9,35
Western Sydn,7049,7,8,9,10,38,47,-9,33
Perth Glory,7049,8,10,2,15,37,50,-13,32
Wellington P,7049,9,5,6,16,31,55,-24,21
CC Mariners,7049,10,4,8,15,28,49,-21,20
Sydney FC,7050,1,20,4,4,64,23,41,64
N'castle Jet,7050,2,16,5,7,58,37,21,53
Melbourne V,7050,3,14,5,10,46,38,8,47
Melbourne C,7050,4,14,4,11,43,34,9,46
Adelaide Utd,7050,5,11,6,11,37,40,-3,39
Brisbane,7050,6,10,5,13,33,42,-9,35
Western Sydn,7050,7,8,9,10,38,47,-9,33
Perth Glory,7050,8,10,2,15,37,50,-13,32
Wellington P,7050,9,5,6,16,31,55,-24,21
CC Mariners,7050,10,4,8,15,28,49,-21,20
Sydney FC,7051,1,21,4,3,66,23,43,67
N'castle Jet,7051,2,15,6,7,58,38,20,51
Melbourne C,7051,3,14,5,10,44,34,10,47
Melbourne V,7051,4,13,5,11,46,40,6,44
Adelaide Utd,7051,5,11,6,11,37,40,-3,39
Brisbane,7051,6,10,5,13,33,42,-9,35
Western Sydn,7051,7,8,9,10,38,47,-9,33
Perth Glory,7051,8,10,2,15,37,50,-13,32
Wellington P,7051,9,5,6,16,31,55,-24,21
CC Mariners,7051,10,4,8,15,28,49,-21,20
Sydney FC,7052,1,21,4,3,67,23,44,67
N'castle Jet,7052,2,16,5,7,59,38,21,53
Melbourne C,7052,3,14,4,11,44,35,9,46
Melbourne V,7052,4,13,5,11,46,41,5,44
Adelaide Utd,7052,5,11,6,11,37,40,-3,39
Brisbane,7052,6,10,5,13,33,42,-9,35
Western Sydn,7052,7,8,9,10,38,47,-9,33
Perth Glory,7052,8,10,2,15,37,50,-13,32
Wellington P,7052,9,5,6,16,31,55,-24,21
CC Mariners,7052,10,4,8,15,28,49,-21,20
Sydney FC,7053,1,21,4,3,68,23,45,67
N'castle Jet,7053,2,16,5,7,61,37,24,53
Melbourne C,7053,3,14,4,11,43,37,6,46
Melbourne V,7053,4,13,5,11,46,42,4,44
Adelaide Utd,7053,5,11,6,11,37,40,-3,39
Brisbane,7053,6,10,5,13,33,42,-9,35
Western Sydn,7053,7,8,9,10,38,47,-9,33
Perth Glory,7053,8,10,2,15,37,50,-13,32
Wellington P,7053,9,5,6,16,31,55,-24,21
CC Mariners,7053,10,4,8,15,28,49,-21,20
Sydney FC,7054,1,21,4,3,66,23,43,67
N'castle Jet,7054,2,15,5,8,57,38,19,50
Melbourne C,7054,3,15,4,10,44,33,11,49
Melbourne V,7054,4,13,5,11,46,40,6,44
Adelaide Utd,7054,5,11,6,11,37,40,-3,39
Brisbane,7054,6,10,5,13,33,42,-9,35
Western Sydn,7054,7,8,9,10,38,47,-9,33
Perth Glory,7054,8,10,2,15,37,50,-13,32
Wellington P,7054,9,5,6,16,31,55,-24,21
CC Mariners,7054,10,4,8,15,28,49,-21,20
Sydney FC,7055,1,21,4,3,65,22,43,67
N'castle Jet,7055,2,16,5,7,62,38,24,53
Melbourne C,7055,3,14,4,11,44,38,6,46
Melbourne V,7055,4,13,5,11,45,39,6,44
Adelaide Utd,7055,5,11,6,11,37,40,-3,39
Brisbane,7055,6,10,5,13,33,42,-9,35
Western Sydn,7055,7,8,9,10,38,47,-9,33
Perth Glory,7055,8,10,2,15,37,50,-13,32
Wellington P,7055,9,5,6,16,31,55,-24,21
CC Mariners,7055,10,4,8,15,28,49,-21,20
Sydney FC,7056,1,21,4,3,65,22,43,67
N'castle Jet,7056,2,16,5,7,60,39,21,53
Melbourne C,7056,3,14,4,11,45,36,9,46
Melbourne V,7056,4,13,5,11,45,39,6,44
Adelaide Utd,7056,5,11,6,11,37,40,-3,39
Brisbane,7056,6,10,5,13,33,42,-9,35
Western Sydn,7056,7,8,9,10,38,47,-9,33
Perth Glory,7056,8,10,2,15,37,50,-13,32
Wellington P,7056,9,5,6,16,31,55,-24,21
CC Mariners,7056,10,4,8,15,28,49,-21,20
Sydney FC,7057,1,20,4,4,66,26,40,64
N'castle Jet,7057,2,15,6,7,57,37,20,51
Melbourne C,7057,3,14,5,10,43,33,10,47
Melbourne V,7057,4,14,5,10,49,40,9,47
Adelaide Utd,7057,5,11,6,11,37,40,-3,39
Brisbane,7057,6,10,5,13,33,42,-9,35
Western Sydn,7057,7,8,9,10,38,47,-9,33
Perth Glory,7057,8,10,2,15,37,50,-13,32
Wellington P,7057,9,5,6,16,31,55,-24,21
CC Mariners,7057,10,4,8,15,28,49,-21,20
Sydney FC,7058,1,20,4,4,64,23,41,64
N'castle Jet,7058,2,15,5,8,57,41,16,50
Melbourne C,7058,3,15,4,10,47,33,14,49
Melbourne V,7058,4,14,5,10,46,38,8,47
Adelaide Utd,7058,5,11,6,11,37,40,-3,39
Brisbane,7058,6,10,5,13,33,42,-9,35
Western Sydn,7058,7,8,9,10,38,47,-9,33
Perth Glory,7058,8,10,2,15,37,50,-13,32
Wellington P,7058,9,5,6,16,31,55,-24,21
CC Mariners,7058,10,4,8,15,28,49,-21,20
Sydney FC,7059,1,21,4,3,66,22,44,67
N'castle Jet,7059,2,16,5,7,60,38,22,53
Melbourne C,7059,3,14,4,11,44,36,8,46
Melbourne V,7059,4,13,5,11,45,40,5,44
Adelaide Utd,7059,5,11,6,11,37,40,-3,39
Brisbane,7059,6,10,5,13,33,42,-9,35
Western Sydn,7059,7,8,9,10,38,47,-9,33
Perth Glory,7059,8,10,2,15,37,50,-13,32
Wellington P,7059,9,5,6,16,31,55,-24,21
CC Mariners,7059,10,4,8,15,28,49,-21,20
Sydney FC,7060,1,21,4,3,66,22,44,67
N'castle Jet,7060,2,15,5,8,57,40,17,50
Melbourne C,7060,3,15,4,10,46,33,13,49
Melbourne V,7060,4,13,5,11,45,40,5,44
Adelaide Utd,7060,5,11,6,11,37,40,-3,39
Brisbane,7060,6,10,5,13,33,42,-9,35
Western Sydn,7060,7,8,9,10,38,47,-9,33
Perth Glory,7060,8,10,2,15,37,50,-13,32
Wellington P,7060,9,5,6,16,31,55,-24,21
CC Mariners,7060,10,4,8,15,28,49,-21,20
Sydney FC,7061,1,20,5,3,65,23,42,65
N'castle Jet,7061,2,15,6,7,58,38,20,51
Melbourne C,7061,3,14,5,10,44,34,10,47
Melbourne V,7061,4,13,6,10,46,39,7,45
Adelaide Utd,7061,5,11,6,11,37,40,-3,39
Brisbane,7061,6,10,5,13,33,42,-9,35
Western Sydn,7061,7,8,9,10,38,47,-9,33
Perth Glory,7061,8,10,2,15,37,50,-13,32
Wellington P,7061,9,5,6,16,31,55,-24,21
CC Mariners,7061,10,4,8,15,28,49,-21,20
Sydney FC,7062,1,21,4,3,66,23,43,67
N'castle Jet,7062,2,15,6,7,60,40,20,51
Melbourne C,7062,3,14,5,10,46,36,10,47
Melbourne V,7062,4,13,5,11,46,40,6,44
Adelaide Utd,7062,5,11,6,11,37,40,-3,39
Brisbane,7062,6,10,5,13,33,42,-9,35
Western Sydn,7062,7,8,9,10,38,47,-9,33
Perth Glory,7062,8,10,2,15,37,50,-13,32
Wellington P,7062,9,5,6,16,31,55,-24,21
CC Mariners,7062,10,4,8,15,28,49,-21,20
Sydney FC,7063,1,21,4,3,66,22,44,67
N'castle Jet,7063,2,16,5,7,60,39,21,53
Melbourne C,7063,3,14,4,11,45,36,9,46
Melbourne V,7063,4,13,5,11,45,40,5,44
Adelaide Utd,7063,5,11,6,11,37,40,-3,39
Brisbane,7063,6,10,5,13,33,42,-9,35
Western Sydn,7063,7,8,9,10,38,47,-9,33
Perth Glory,7063,8,10,2,15,37,50,-13,32
Wellington P,7063,9,5,6,16,31,55,-24,21
CC Mariners,7063,10,4,8,15,28,49,-21,20
Sydney FC,7064,1,20,5,3,69,27,42,65
N'castle Jet,7064,2,16,5,7,61,40,21,53
Melbourne C,7064,3,14,4,11,46,37,9,46
Melbourne V,7064,4,13,6,10,50,43,7,45
Adelaide Utd,7064,5,11,6,11,37,40,-3,39
Brisbane,7064,6,10,5,13,33,42,-9,35
Western Sydn,7064,7,8,9,10,38,47,-9,33
Perth Glory,7064,8,10,2,15,37,50,-13,32
Wellington P,7064,9,5,6,16,31,55,-24,21
CC Mariners,7064,10,4,8,15,28,49,-21,20
Sydney FC,7065,1,20,4,4,64,23,41,64
N'castle Jet,7065,2,15,5,8,58,39,19,50
Melbourne C,7065,3,15,4,10,45,34,11,49
Melbourne V,7065,4,14,5,10,46,38,8,47
Adelaide Utd,7065,5,11,6,11,37,40,-3,39
Brisbane,7065,6,10,5,13,33,42,-9,35
Western Sydn,7065,7,8,9,10,38,47,-9,33
Perth Glory,7065,8,10,2,15,37,50,-13,32
Wellington P,7065,9,5,6,16,31,55,-24,21
CC Mariners,7065,10,4,8,15,28,49,-21,20
Sydney FC,7066,1,20,5,3,66,24,42,65
N'castle Jet,7066,2,15,5,8,59,40,19,50
Melbourne C,7066,3,15,4,10,46,35,11,49
Melbourne V,7066,4,13,6,10,47,40,7,45
Adelaide Utd,7066,5,11,6,11,37,40,-3,39
Brisbane,7066,6,10,5,13,33,42,-9,35
Western Sydn,7066,7,8,9,10,38,47,-9,33
Perth Glory,7066,8,10,2,15,37,50,-13,32
Wellington P,7066,9,5,6,16,31,55,-24,21
CC Mariners,7066,10,4,8,15,28,49,-21,20
Sydney FC,7067,1,20,5,3,66,24,42,65
N'castle Jet,7067,2,16,5,7,58,37,21,53
Melbourne C,7067,3,14,4,11,43,34,9,46
Melbourne V,7067,4,13,6,10,47,40,7,45
Adelaide Utd,7067,5,11,6,11,37,40,-3,39
Brisbane,7067,6,10,5,13,33,42,-9,35
Western Sydn,7067,7,8,9,10,38,47,-9,33
Perth Glory,7067,8,10,2,15,37,50,-13,32
Wellington P,7067,9,5,6,16,31,55,-24,21
CC Mariners,7067,10,4,8,15,28,49,-21,20
Sydney FC,7068,1,21,4,3,65,22,43,67
N'castle Jet,7068,2,16,5,7,61,38,23,53
Melbourne C,7068,3,14,4,11,44,37,7,46
Melbourne V,7068,4,13,5,11,45,39,6,44
Adelaide Utd,7068,5,11,6,11,37,40,-3,39
Brisbane,7068,6,10,5,13,33,42,-9,35
Western Sydn,7068,7,8,9,10,38,47,-9,33
Perth Glory,7068,8,10,2,15,37,50,-13,32
Wellington P,7068,9,5,6,16,31,55,-24,21
CC Mariners,7068,10,4,8,15,28,49,-21,20
Sydney FC,7069,1,20,4,4,64,23,41,64
N'castle Jet,7069,2,15,6,7,59,39,20,51
Melbourne C,7069,3,14,5,10,45,35,10,47
Melbourne V,7069,4,14,5,10,46,38,8,47
Adelaide Utd,7069,5,11,6,11,37,40,-3,39
Brisbane,7069,6,10,5,13,33,42,-9,35
Western Sydn,7069,7,8,9,10,38,47,-9,33
Perth Glory,7069,8,10,2,15,37,50,-13,32
Wellington P,7069,9,5,6,16,31,55,-24,21
CC Mariners,7069,10,4,8,15,28,49,-21,20
Sydney FC,7070,1,20,4,4,66,25,41,64
N'castle Jet,7070,2,15,6,7,57,37,20,51
Melbourne C,7070,3,14,5,10,43,33,10,47
Melbourne V,7070,4,14,5,10,48,40,8,47
Adelaide Utd,7070,5,11,6,11,37,40,-3,39
Brisbane,7070,6,10,5,13,33,42,-9,35
Western Sydn,7070,7,8,9,10,38,47,-9,33
Perth Glory,7070,8,10,2,15,37,50,-13,32
Wellington P,7070,9,5,6,16,31,55,-24,21
CC Mariners,7070,10,4,8,15,28,49,-21,20
Sydney FC,7071,1,21,4,3,67,22,45,67
N'castle Jet,7071,2,16,5,7,61,37,24,53
Melbourne C,7071,3,14,4,11,43,37,6,46
Melbourne V,7071,4,13,5,11,45,41,4,44
Adelaide Utd,7071,5,11,6,11,37,40,-3,39
Brisbane,7071,6,10,5,13,33,42,-9,35
Western Sydn,7071,7,8,9,10,38,47,-9,33
Perth Glory,7071,8,10,2,15,37,50,-13,32
Wellington P,7071,9,5,6,16,31,55,-24,21
CC Mariners,7071,10,4,8,15,28,49,-21,20
Sydney FC,7072,1,21,4,3,65,22,43,67
N'castle Jet,7072,2,15,6,7,58,38,20,51
Melbourne C,7072,3,14,5,10,44,34,10,47
Melbourne V,7072,4,13,5,11,45,39,6,44
Adelaide Utd,7072,5,11,6,11,37,40,-3,39
Brisbane,7072,6,10,5,13,33,42,-9,35
Western Sydn,7072,7,8,9,10,38,47,-9,33
Perth Glory,7072,8,10,2,15,37,50,-13,32
Wellington P,7072,9,5,6,16,31,55,-24,21
CC Mariners,7072,10,4,8,15,28,49,-21,20
Sydney FC,7073,1,21,4,3,65,22,43,67
N'castle Jet,7073,2,16,5,7,59,38,21,53
Melbourne C,7073,3,14,4,11,44,35,9,46
Melbourne V,7073,4,13,5,11,45,39,6,44
Adelaide Utd,7073,5,11,6,11,37,40,-3,39
Brisbane,7073,6,10,5,13,33,42,-9,35
Western Sydn,7073,7,8,9,10,38,47,-9,33
Perth Glory,7073,8,10,2,15,37,50,-13,32
Wellington P,7073,9,5,6,16,31,55,-24,21
CC Mariners,7073,10,4,8,15,28,49,-21,20
Sydney FC,7074,1,20,5,3,65,23,42,65
N'castle Jet,7074,2,16,5,7,58,37,21,53
Melbourne C,7074,3,14,4,11,43,34,9,46
Melbourne V,7074,4,13,6,10,46,39,7,45
Adelaide Utd,7074,5,11,6,11,37,40,-3,39
Brisbane,7074,6,10,5,13,33,42,-9,35
Western Sydn,7074,7,8,9,10,38,47,-9,33
Perth Glory,7074,8,10,2,15,37,50,-13,32
Wellington P,7074,9,5,6,16,31,55,-24,21
CC Mariners,7074,10,4,8,15,28,49,-21,20
Sydney FC,7075,1,20,4,4,64,24,40,64
N'castle Jet,7075,2,15,6,7,57,37,20,51
Melbourne C,7075,3,14,5,10,43,33,10,47
Melbourne V,7075,4,14,5,10,47,38,9,47
Adelaide Utd,7075,5,11,6,11,37,40,-3,39
Brisbane,7075,6,10,5,13,33,42,-9,35
Western Sydn,7075,7,8,9,10,38,47,-9,33
Perth Glory,7075,8,10,2,15,37,50,-13,32
Wellington P,7075,9,5,6,16,31,55,-24,21
CC Mariners,7075,10,4,8,15,28,49,-21,20
Sydney FC,7076,1,20,5,3,65,23,42,65
N'castle Jet,7076,2,15,5,8,58,39,19,50
Melbourne C,7076,3,15,4,10,45,34,11,49
Melbourne V,7076,4,13,6,10,46,39,7,45
Adelaide Utd,7076,5,11,6,11,37,40,-3,39
Brisbane,7076,6,10,5,13,33,42,-9,35
Western Sydn,7076,7,8,9,10,38,47,-9,33
Perth Glory,7076,8,10,2,15,37,50,-13,32
Wellington P,7076,9,5,6,16,31,55,-24,21
CC Mariners,7076,10,4,8,15,28,49,-21,20
Sydney FC,7077,1,21,4,3,66,23,43,67
N'castle Jet,7077,2,16,5,7,60,39,21,53
Melbourne C,7077,3,14,4,11,45,36,9,46
Melbourne V,7077,4,13,5,11,46,40,6,44
Adelaide Utd,7077,5,11,6,11,37,40,-3,39
Brisbane,7077,6,10,5,13,33,42,-9,35
Western Sydn,7077,7,8,9,10,38,47,-9,33
Perth Glory,7077,8,10,2,15,37,50,-13,32
Wellington P,7077,9,5,6,16,31,55,-24,21
CC Mariners,7077,10,4,8,15,28,49,-21,20
Sydney FC,7078,1,21,4,3,67,23,44,67
N'castle Jet,7078,2,16,5,7,60,38,22,53
Melbourne C,7078,3,14,4,11,44,36,8,46
Melbourne V,7078,4,13,5,11,46,41,5,44
Adelaide Utd,7078,5,11,6,11,37,40,-3,39
Brisbane,7078,6,10,5,13,33,42,-9,35
Western Sydn,7078,7,8,9,10,38,47,-9,33
Perth Glory,7078,8,10,2,15,37,50,-13,32
Wellington P,7078,9,5,6,16,31,55,-24,21
CC Mariners,7078,10,4,8,15,28,49,-21,20
Sydney FC,7079,1,20,4,4,66,25,41,64
N'castle Jet,7079,2,16,5,7,61,37,24,53
Melbourne V,7079,3,14,5,10,48,40,8,47
Melbourne C,7079,4,14,4,11,43,37,6,46
Adelaide Utd,7079,5,11,6,11,37,40,-3,39
Brisbane,7079,6,10,5,13,33,42,-9,35
Western Sydn,7079,7,8,9,10,38,47,-9,33
Perth Glory,7079,8,10,2,15,37,50,-13,32
Wellington P,7079,9,5,6,16,31,55,-24,21
CC Mariners,7079,10,4,8,15,28,49,-21,20
Sydney FC,7080,1,20,5,3,65,23,42,65
N'castle Jet,7080,2,15,6,7,58,38,20,51
Melbourne C,7080,3,14,5,10,44,34,10,47
Melbourne V,7080,4,13,6,10,46,39,7,45
Adelaide Utd,7080,5,11,6,11,37,40,-3,39
Brisbane,7080,6,10,5,13,33,42,-9,35
Western Sydn,7080,7,8,9,10,38,47,-9,33
Perth Glory,7080,8,10,2,15,37,50,-13,32
Wellington P,7080,9,5,6,16,31,55,-24,21
CC Mariners,7080,10,4,8,15,28,49,-21,20
Sydney FC,7081,1,21,4,3,68,22,46,67
N'castle Jet,7081,2,15,6,7,57,37,20,51
Melbourne C,7081,3,14,5,10,43,33,10,47
Melbourne V,7081,4,13,5,11,45,42,3,44
Adelaide Utd,7081,5,11,6,11,37,40,-3,39
Brisbane,7081,6,10,5,13,33,42,-9,35
Western Sydn,7081,7,8,9,10,38,47,-9,33
Perth Glory,7081,8,10,2,15,37,50,-13,32
Wellington P,7081,9,5,6,16,31,55,-24,21
CC Mariners,7081,10,4,8,15,28,49,-21,20
Sydney FC,7082,1,21,4,3,66,23,43,67
N'castle Jet,7082,2,15,5,8,59,40,19,50
Melbourne C,7082,3,15,4,10,46,35,11,49
Melbourne V,7082,4,13,5,11,46,40,6,44
Adelaide Utd,7082,5,11,6,11,37,40,-3,39
Brisbane,7082,6,10,5,13,33,42,-9,35
Western Sydn,7082,7,8,9,10,38,47,-9,33
Perth Glory,7082,8,10,2,15,37,50,-13,32
Wellington P,7082,9,5,6,16,31,55,-24,21
CC Mariners,7082,10,4,8,15,28,49,-21,20
Sydney FC,7083,1,21,4,3,65,22,43,67
N'castle Jet,7083,2,15,6,7,59,39,20,51
Melbourne C,7083,3,14,5,10,45,35,10,47
Melbourne V,7083,4,13,5,11,45,39,6,44
Adelaide Utd,7083,5,11,6,11,37,40,-3,39
Brisbane,7083,6,10,5,13,33,42,-9,35
Western Sydn,7083,7,8,9,10,38,47,-9,33
Perth Glory,7083,8,10,2,15,37,50,-13,32
Wellington P,7083,9,5,6,16,31,55,-24,21
CC Mariners,7083,10,4,8,15,28,49,-21,20
Sydney FC,7084,1,21,4,3,66,22,44,67
N'castle Jet,7084,2,15,5,8,57,39,18,50
Melbourne C,7084,3,15,4,10,45,33,12,49
Melbourne V,7084,4,13,5,11,45,40,5,44
Adelaide Utd,7084,5,11,6,11,37,40,-3,39
Brisbane,7084,6,10,5,13,33,42,-9,35
Western Sydn,7084,7,8,9,10,38,47,-9,33
Perth Glory,7084,8,10,2,15,37,50,-13,32
Wellington P,7084,9,5,6,16,31,55,-24,21
CC Mariners,7084,10,4,8,15,28,49,-21,20
Sydney FC,7085,1,21,4,3,67,23,44,67
N'castle Jet,7085,2,15,6,7,58,38,20,51
Melbourne C,7085,3,14,5,10,44,34,10,47
Melbourne V,7085,4,13,5,11,46,41,5,44
Adelaide Utd,7085,5,11,6,11,37,40,-3,39
Brisbane,7085,6,10,5,13,33,42,-9,35
Western Sydn,7085,7,8,9,10,38,47,-9,33
Perth Glory,7085,8,10,2,15,37,50,-13,32
Wellington P,7085,9,5,6,16,31,55,-24,21
CC Mariners,7085,10,4,8,15,28,49,-21,20
Sydney FC,7086,1,21,4,3,65,22,43,67
N'castle Jet,7086,2,16,5,7,60,38,22,53
Melbourne C,7086,3,14,4,11,44,36,8,46
Melbourne V,7086,4,13,5,11,45,39,6,44
Adelaide Utd,7086,5,11,6,11,37,40,-3,39
Brisbane,7086,6,10,5,13,33,42,-9,35
Western Sydn,7086,7,8,9,10,38,47,-9,33
Perth Glory,7086,8,10,2,15,37,50,-13,32
Wellington P,7086,9,5,6,16,31,55,-24,21
CC Mariners,7086,10,4,8,15,28,49,-21,20
Sydney FC,7087,1,21,4,3,66,22,44,67
N'castle Jet,7087,2,15,6,7,60,40,20,51
Melbourne C,7087,3,14,5,10,46,36,10,47
Melbourne V,7087,4,13,5,11,45,40,5,44
Adelaide Utd,7087,5,11,6,11,37,40,-3,39
Brisbane,7087,6,10,5,13,33,42,-9,35
Western Sydn,7087,7,8,9,10,38,47,-9,33
Perth Glory,7087,8,10,2,15,37,50,-13,32
Wellington P,7087,9,5,6,16,31,55,-24,21
CC Mariners,7087,10,4,8,15,28,49,-21,20
Sydney FC,7088,1,21,4,3,67,22,45,67
N'castle Jet,7088,2,16,5,7,59,38,21,53
Melbourne C,7088,3,14,4,11,44,35,9,46
Melbourne V,7088,4,13,5,11,45,41,4,44
Adelaide Utd,7088,5,11,6,11,37,40,-3,39
Brisbane,7088,6,10,5,13,33,42,-9,35
Western Sydn,7088,7,8,9,10,38,47,-9,33
Perth Glory,7088,8,10,2,15,37,50,-13,32
Wellington P,7088,9,5,6,16,31,55,-24,21
CC Mariners,7088,10,4,8,15,28,49,-21,20
Sydney FC,7089,1,21,4,3,67,23,44,67
N'castle Jet,7089,2,15,5,8,57,38,19,50
Melbourne C,7089,3,15,4,10,44,33,11,49
Melbourne V,7089,4,13,5,11,46,41,5,44
Adelaide Utd,7089,5,11,6,11,37,40,-3,39
Brisbane,7089,6,10,5,13,33,42,-9,35
Western Sydn,7089,7,8,9,10,38,47,-9,33
Perth Glory,7089,8,10,2,15,37,50,-13,32
Wellington P,7089,9,5,6,16,31,55,-24,21
CC Mariners,7089,10,4,8,15,28,49,-21,20
Sydney FC,7090,1,20,4,4,66,25,41,64
N'castle Jet,7090,2,16,5,7,59,37,22,53
Melbourne V,7090,3,14,5,10,48,40,8,47
Melbourne C,7090,4,14,4,11,43,35,8,46
Adelaide Utd,7090,5,11,6,11,37,40,-3,39
Brisbane,7090,6,10,5,13,33,42,-9,35
Western Sydn,7090,7,8,9,10,38,47,-9,33
Perth Glory,7090,8,10,2,15,37,50,-13,32
Wellington P,7090,9,5,6,16,31,55,-24,21
CC Mariners,7090,10,4,8,15,28,49,-21,20
Sydney FC,7091,1,21,4,3,68,22,46,67
N'castle Jet,7091,2,16,5,7,59,37,22,53
Melbourne C,7091,3,14,4,11,43,35,8,46
Melbourne V,7091,4,13,5,11,45,42,3,44
Adelaide Utd,7091,5,11,6,11,37,40,-3,39
Brisbane,7091,6,10,5,13,33,42,-9,35
Western Sydn,7091,7,8,9,10,38,47,-9,33
Perth Glory,7091,8,10,2,15,37,50,-13,32
Wellington P,7091,9,5,6,16,31,55,-24,21
CC Mariners,7091,10,4,8,15,28,49,-21,20
Sydney FC,7092,1,20,4,4,64,24,40,64
N'castle Jet,7092,2,16,5,7,58,37,21,53
Melbourne V,7092,3,14,5,10,47,38,9,47
Melbourne C,7092,4,14,4,11,43,34,9,46
Adelaide Utd,7092,5,11,6,11,37,40,-3,39
Brisbane,7092,6,10,5,13,33,42,-9,35
Western Sydn,7092,7,8,9,10,38,47,-9,33
Perth Glory,7092,8,10,2,15,37,50,-13,32
Wellington P,7092,9,5,6,16,31,55,-24,21
CC Mariners,7092,10,4,8,15,28,49,-21,20
Sydney FC,7093,1,20,4,4,64,23,41,64
N'castle Jet,7093,2,16,5,7,59,37,22,53
Melbourne V,7093,3,14,5,10,46,38,8,47
Melbourne C,7093,4,14,4,11,43,35,8,46
Adelaide Utd,7093,5,11,6,11,37,40,-3,39
Brisbane,7093,6,10,5,13,33,42,-9,35
Western Sydn,7093,7,8,9,10,38,47,-9,33
Perth Glory,7093,8,10,2,15,37,50,-13,32
Wellington P,7093,9,5,6,16,31,55,-24,21
CC Mariners,7093,10,4,8,15,28,49,-21,20
Sydney FC,7094,1,20,4,4,66,26,40,64
N'castle Jet,7094,2,15,5,8,57,38,19,50
Melbourne C,7094,3,15,4,10,44,33,11,49
Melbourne V,7094,4,14,5,10,49,40,9,47
Adelaide Utd,7094,5,11,6,11,37,40,-3,39
Brisbane,7094,6,10,5,13,33,42,-9,35
Western Sydn,7094,7,8,9,10,38,47,-9,33
Perth Glory,7094,8,10,2,15,37,50,-13,32
Wellington P,7094,9,5,6,16,31,55,-24,21
CC Mariners,7094,10,4,8,15,28,49,-21,20
Sydney FC,7095,1,20,5,3,65,23,42,65
N'castle Jet,7095,2,16,5,7,58,37,21,53
Melbourne C,7095,3,14,4,11,43,34,9,46
Melbourne V,7095,4,13,6,10,46,39,7,45
Adelaide Utd,7095,5,11,6,11,37,40,-3,39
Brisbane,7095,6,10,5,13,33,42,-9,35
Western Sydn,7095,7,8,9,10,38,47,-9,33
Perth Glory,7095,8,10,2,15,37,50,-13,32
Wellington P,7095,9,5,6,16,31,55,-24,21
CC Mariners,7095,10,4,8,15,28,49,-21,20
Sydney FC,7096,1,20,5,3,65,23,42,65
N'castle Jet,7096,2,15,6,7,57,37,20,51
Melbourne C,7096,3,14,5,10,43,33,10,47
Melbourne V,7096,4,13,6,10,46,39,7,45
Adelaide Utd,7096,5,11,6,11,37,40,-3,39
Brisbane,7096,6,10,5,13,33,42,-9,35
Western Sydn,7096,7,8,9,10,38,47,-9,33
Perth Glory,7096,8,10,2,15,37,50,-13,32
Wellington P,7096,9,5,6,16,31,55,-24,21
CC Mariners,7096,10,4,8,15,28,49,-21,20
Sydney FC,7097,1,21,4,3,69,22,47,67
N'castle Jet,7097,2,16,5,7,60,38,22,53
Melbourne C,7097,3,14,4,11,44,36,8,46
Melbourne V,7097,4,13,5,11,45,43,2,44
Adelaide Utd,7097,5,11,6,11,37,40,-3,39
Brisbane,7097,6,10,5,13,33,42,-9,35
Western Sydn,7097,7,8,9,10,38,47,-9,33
Perth Glory,7097,8,10,2,15,37,50,-13,32
Wellington P,7097,9,5,6,16,31,55,-24,21
CC Mariners,7097,10,4,8,15,28,49,-21,20
Sydney FC,7098,1,20,4,4,65,24,41,64
N'castle Jet,7098,2,16,5,7,59,38,21,53
Melbourne V,7098,3,14,5,10,47,39,8,47
Melbourne C,7098,4,14,4,11,44,35,9,46
Adelaide Utd,7098,5,11,6,11,37,40,-3,39
Brisbane,7098,6,10,5,13,33,42,-9,35
Western Sydn,7098,7,8,9,10,38,47,-9,33
Perth Glory,7098,8,10,2,15,37,50,-13,32
Wellington P,7098,9,5,6,16,31,55,-24,21
CC Mariners,7098,10,4,8,15,28,49,-21,20
Sydney FC,7099,1,21,4,3,65,22,43,67
N'castle Jet,7099,2,15,6,7,58,38,20,51
Melbourne C,7099,3,14,5,10,44,34,10,47
Melbourne V,7099,4,13,5,11,45,39,6,44
Adelaide Utd,7099,5,11,6,11,37,40,-3,39
Brisbane,7099,6,10,5,13,33,42,-9,35
Western Sydn,7099,7,8,9,10,38,47,-9,33
Perth Glory,7099,8,10,2,15,37,50,-13,32
Wellington P,7099,9,5,6,16,31,55,-24,21
CC Mariners,7099,10,4,8,15,28,49,-21,20
Sydney FC,7100,1,21,4,3,66,23,43,67
N'castle Jet,7100,2,15,6,7,60,40,20,51
Melbourne C,7100,3,14,5,10,46,36,10,47
Melbourne V,7100,4,13,5,11,46,40,6,44
Adelaide Utd,7100,5,11,6,11,37,40,-3,39
Brisbane,7100,6,10,5,13,33,42,-9,35
Western Sydn,7100,7,8,9,10,38,47,-9,33
Perth Glory,7100,8,10,2,15,37,50,-13,32
Wellington P,7100,9,5,6,16,31,55,-24,21
CC Mariners,7100,10,4,8,15,28,49,-21,20
Sydney FC,7101,1,20,4,4,64,23,41,64
N'castle Jet,7101,2,16,5,7,59,38,21,53
Melbourne V,7101,3,14,5,10,46,38,8,47
Melbourne C,7101,4,14,4,11,44,35,9,46
Adelaide Utd,7101,5,11,6,11,37,40,-3,39
Brisbane,7101,6,10,5,13,33,42,-9,35
Western Sydn,7101,7,8,9,10,38,47,-9,33
Perth Glory,7101,8,10,2,15,37,50,-13,32
Wellington P,7101,9,5,6,16,31,55,-24,21
CC Mariners,7101,10,4,8,15,28,49,-21,20
Sydney FC,7102,1,21,4,3,66,22,44,67
N'castle Jet,7102,2,15,5,8,57,39,18,50
Melbourne C,7102,3,15,4,10,45,33,12,49
Melbourne V,7102,4,13,5,11,45,40,5,44
Adelaide Utd,7102,5,11,6,11,37,40,-3,39
Brisbane,7102,6,10,5,13,33,42,-9,35
Western Sydn,7102,7,8,9,10,38,47,-9,33
Perth Glory,7102,8,10,2,15,37,50,-13,32
Wellington P,7102,9,5,6,16,31,55,-24,21
CC Mariners,7102,10,4,8,15,28,49,-21,20
Sydney FC,7103,1,20,5,3,64,22,42,65
N'castle Jet,7103,2,16,5,7,59,38,21,53
Melbourne C,7103,3,14,4,11,44,35,9,46
Melbourne V,7103,4,13,6,10,45,38,7,45
Adelaide Utd,7103,5,11,6,11,37,40,-3,39
Brisbane,7103,6,10,5,13,33,42,-9,35
Western Sydn,7103,7,8,9,10,38,47,-9,33
Perth Glory,7103,8,10,2,15,37,50,-13,32
Wellington P,7103,9,5,6,16,31,55,-24,21
CC Mariners,7103,10,4,8,15,28,49,-21,20
Sydney FC,7104,1,21,4,3,65,22,43,67
N'castle Jet,7104,2,15,5,8,57,40,17,50
Melbourne C,7104,3,15,4,10,46,33,13,49
Melbourne V,7104,4,13,5,11,45,39,6,44
Adelaide Utd,7104,5,11,6,11,37,40,-3,39
Brisbane,7104,6,10,5,13,33,42,-9,35
Western Sydn,7104,7,8,9,10,38,47,-9,33
Perth Glory,7104,8,10,2,15,37,50,-13,32
Wellington P,7104,9,5,6,16,31,55,-24,21
CC Mariners,7104,10,4,8,15,28,49,-21,20
Sydney FC,7105,1,20,5,3,66,24,42,65
N'castle Jet,7105,2,16,5,7,60,38,22,53
Melbourne C,7105,3,14,4,11,44,36,8,46
Melbourne V,7105,4,13,6,10,47,40,7,45
Adelaide Utd,7105,5,11,6,11,37,40,-3,39
Brisbane,7105,6,10,5,13,33,42,-9,35
Western Sydn,7105,7,8,9,10,38,47,-9,33
Perth Glory,7105,8,10,2,15,37,50,-13,32
Wellington P,7105,9,5,6,16,31,55,-24,21
CC Mariners,7105,10,4,8,15,28,49,-21,20
Sydney FC,7106,1,21,4,3,69,23,46,67
N'castle Jet,7106,2,15,6,7,57,37,20,51
Melbourne C,7106,3,14,5,10,43,33,10,47
Melbourne V,7106,4,13,5,11,46,43,3,44
Adelaide Utd,7106,5,11,6,11,37,40,-3,39
Brisbane,7106,6,10,5,13,33,42,-9,35
Western Sydn,7106,7,8,9,10,38,47,-9,33
Perth Glory,7106,8,10,2,15,37,50,-13,32
Wellington P,7106,9,5,6,16,31,55,-24,21
CC Mariners,7106,10,4,8,15,28,49,-21,20
Sydney FC,7107,1,21,4,3,67,22,45,67
N'castle Jet,7107,2,16,5,7,61,39,22,53
Melbourne C,7107,3,14,4,11,45,37,8,46
Melbourne V,7107,4,13,5,11,45,41,4,44
Adelaide Utd,7107,5,11,6,11,37,40,-3,39
Brisbane,7107,6,10,5,13,33,42,-9,35
Western Sydn,7107,7,8,9,10,38,47,-9,33
Perth Glory,7107,8,10,2,15,37,50,-13,32
Wellington P,7107,9,5,6,16,31,55,-24,21
CC Mariners,7107,10,4,8,15,28,49,-21,20
Sydney FC,7108,1,20,4,4,65,24,41,64
N'castle Jet,7108,2,16,5,7,60,37,23,53
Melbourne V,7108,3,14,5,10,47,39,8,47
Melbourne C,7108,4,14,4,11,43,36,7,46
Adelaide Utd,7108,5,11,6,11,37,40,-3,39
Brisbane,7108,6,10,5,13,33,42,-9,35
Western Sydn,7108,7,8,9,10,38,47,-9,33
Perth Glory,7108,8,10,2,15,37,50,-13,32
Wellington P,7108,9,5,6,16,31,55,-24,21
CC Mariners,7108,10,4,8,15,28,49,-21,20
Sydney FC,7109,1,20,4,4,64,23,41,64
N'castle Jet,7109,2,15,6,7,58,38,20,51
Melbourne C,7109,3,14,5,10,44,34,10,47
Melbourne V,7109,4,14,5,10,46,38,8,47
Adelaide Utd,7109,5,11,6,11,37,40,-3,39
Brisbane,7109,6,10,5,13,33,42,-9,35
Western Sydn,7109,7,8,9,10,38,47,-9,33
Perth Glory,7109,8,10,2,15,37,50,-13,32
Wellington P,7109,9,5,6,16,31,55,-24,21
CC Mariners,7109,10,4,8,15,28,49,-21,20
Sydney FC,7110,1,21,4,3,68,22,46,67
N'castle Jet,7110,2,16,5,7,59,38,21,53
Melbourne C,7110,3,14,4,11,44,35,9,46
Melbourne V,7110,4,13,5,11,45,42,3,44
Adelaide Utd,7110,5,11,6,11,37,40,-3,39
Brisbane,7110,6,10,5,13,33,42,-9,35
Western Sydn,7110,7,8,9,10,38,47,-9,33
Perth Glory,7110,8,10,2,15,37,50,-13,32
Wellington P,7110,9,5,6,16,31,55,-24,21
CC Mariners,7110,10,4,8,15,28,49,-21,20
Sydney FC,7111,1,21,4,3,66,23,43,67
N'castle Jet,7111,2,16,5,7,59,38,21,53
Melbourne C,7111,3,14,4,11,44,35,9,46
Melbourne V,7111,4,13,5,11,46,40,6,44
Adelaide Utd,7111,5,11,6,11,37,40,-3,39
Brisbane,7111,6,10,5,13,33,42,-9,35
Western Sydn,7111,7,8,9,10,38,47,-9,33
Perth Glory,7111,8,10,2,15,37,50,-13,32
Wellington P,7111,9,5,6,16,31,55,-24,21
CC Mariners,7111,10,4,8,15,28,49,-21,20
Sydney FC,7112,1,20,5,3,64,22,42,65
N'castle Jet,7112,2,15,5,8,59,40,19,50
Melbourne C,7112,3,15,4,10,46,35,11,49
Melbourne V,7112,4,13,6,10,45,38,7,45
Adelaide Utd,7112,5,11,6,11,37,40,-3,39
Brisbane,7112,6,10,5,13,33,42,-9,35
Western Sydn,7112,7,8,9,10,38,47,-9,33
Perth Glory,7112,8,10,2,15,37,50,-13,32
Wellington P,7112,9,5,6,16,31,55,-24,21
CC Mariners,7112,10,4,8,15,28,49,-21,20
Sydney FC,7113,1,21,4,3,67,23,44,67
N'castle Jet,7113,2,15,5,8,59,40,19,50
Melbourne C,7113,3,15,4,10,46,35,11,49
Melbourne V,7113,4,13,5,11,46,41,5,44
Adelaide Utd,7113,5,11,6,11,37,40,-3,39
Brisbane,7113,6,10,5,13,33,42,-9,35
Western Sydn,7113,7,8,9,10,38,47,-9,33
Perth Glory,7113,8,10,2,15,37,50,-13,32
Wellington P,7113,9,5,6,16,31,55,-24,21
CC Mariners,7113,10,4,8,15,28,49,-21,20
Sydney FC,7114,1,21,4,3,67,22,45,67
N'castle Jet,7114,2,15,6,7,57,37,20,51
Melbourne C,7114,3,14,5,10,43,33,10,47
Melbourne V,7114,4,13,5,11,45,41,4,44
Adelaide Utd,7114,5,11,6,11,37,40,-3,39
Brisbane,7114,6,10,5,13,33,42,-9,35
Western Sydn,7114,7,8,9,10,38,47,-9,33
Perth Glory,7114,8,10,2,15,37,50,-13,32
Wellington P,7114,9,5,6,16,31,55,-24,21
CC Mariners,7114,10,4,8,15,28,49,-21,20
Sydney FC,7115,1,21,4,3,69,22,47,67
N'castle Jet,7115,2,15,5,8,59,40,19,50
Melbourne C,7115,3,15,4,10,46,35,11,49
Melbourne V,7115,4,13,5,11,45,43,2,44
Adelaide Utd,7115,5,11,6,11,37,40,-3,39
Brisbane,7115,6,10,5,13,33,42,-9,35
Western Sydn,7115,7,8,9,10,38,47,-9,33
Perth Glory,7115,8,10,2,15,37,50,-13,32
Wellington P,7115,9,5,6,16,31,55,-24,21
CC Mariners,7115,10,4,8,15,28,49,-21,20
Sydney FC,7116,1,21,4,3,65,22,43,67
N'castle Jet,7116,2,16,5,7,59,38,21,53
Melbourne C,7116,3,14,4,11,44,35,9,46
Melbourne V,7116,4,13,5,11,45,39,6,44
Adelaide Utd,7116,5,11,6,11,37,40,-3,39
Brisbane,7116,6,10,5,13,33,42,-9,35
Western Sydn,7116,7,8,9,10,38,47,-9,33
Perth Glory,7116,8,10,2,15,37,50,-13,32
Wellington P,7116,9,5,6,16,31,55,-24,21
CC Mariners,7116,10,4,8,15,28,49,-21,20
Sydney FC,7117,1,21,4,3,66,23,43,67
N'castle Jet,7117,2,15,5,8,57,39,18,50
Melbourne C,7117,3,15,4,10,45,33,12,49
Melbourne V,7117,4,13,5,11,46,40,6,44
Adelaide Utd,7117,5,11,6,11,37,40,-3,39
Brisbane,7117,6,10,5,13,33,42,-9,35
Western Sydn,7117,7,8,9,10,38,47,-9,33
Perth Glory,7117,8,10,2,15,37,50,-13,32
Wellington P,7117,9,5,6,16,31,55,-24,21
CC Mariners,7117,10,4,8,15,28,49,-21,20
Sydney FC,7118,1,21,4,3,68,22,46,67
N'castle Jet,7118,2,15,5,8,57,38,19,50
Melbourne C,7118,3,15,4,10,44,33,11,49
Melbourne V,7118,4,13,5,11,45,42,3,44
Adelaide Utd,7118,5,11,6,11,37,40,-3,39
Brisbane,7118,6,10,5,13,33,42,-9,35
Western Sydn,7118,7,8,9,10,38,47,-9,33
Perth Glory,7118,8,10,2,15,37,50,-13,32
Wellington P,7118,9,5,6,16,31,55,-24,21
CC Mariners,7118,10,4,8,15,28,49,-21,20
Sydney FC,7119,1,21,4,3,68,22,46,67
N'castle Jet,7119,2,16,5,7,60,38,22,53
Melbourne C,7119,3,14,4,11,44,36,8,46
Melbourne V,7119,4,13,5,11,45,42,3,44
Adelaide Utd,7119,5,11,6,11,37,40,-3,39
Brisbane,7119,6,10,5,13,33,42,-9,35
Western Sydn,7119,7,8,9,10,38,47,-9,33
Perth Glory,7119,8,10,2,15,37,50,-13,32
Wellington P,7119,9,5,6,16,31,55,-24,21
CC Mariners,7119,10,4,8,15,28,49,-21,20
Sydney FC,7120,1,20,4,4,64,23,41,64
N'castle Jet,7120,2,16,5,7,60,37,23,53
Melbourne V,7120,3,14,5,10,46,38,8,47
Melbourne C,7120,4,14,4,11,43,36,7,46
Adelaide Utd,7120,5,11,6,11,37,40,-3,39
Brisbane,7120,6,10,5,13,33,42,-9,35
Western Sydn,7120,7,8,9,10,38,47,-9,33
Perth Glory,7120,8,10,2,15,37,50,-13,32
Wellington P,7120,9,5,6,16,31,55,-24,21
CC Mariners,7120,10,4,8,15,28,49,-21,20
Sydney FC,7121,1,20,5,3,66,24,42,65
N'castle Jet,7121,2,15,6,7,58,38,20,51
Melbourne C,7121,3,14,5,10,44,34,10,47
Melbourne V,7121,4,13,6,10,47,40,7,45
Adelaide Utd,7121,5,11,6,11,37,40,-3,39
Brisbane,7121,6,10,5,13,33,42,-9,35
Western Sydn,7121,7,8,9,10,38,47,-9,33
Perth Glory,7121,8,10,2,15,37,50,-13,32
Wellington P,7121,9,5,6,16,31,55,-24,21
CC Mariners,7121,10,4,8,15,28,49,-21,20
Sydney FC,7122,1,21,4,3,67,23,44,67
N'castle Jet,7122,2,15,6,7,59,39,20,51
Melbourne C,7122,3,14,5,10,45,35,10,47
Melbourne V,7122,4,13,5,11,46,41,5,44
Adelaide Utd,7122,5,11,6,11,37,40,-3,39
Brisbane,7122,6,10,5,13,33,42,-9,35
Western Sydn,7122,7,8,9,10,38,47,-9,33
Perth Glory,7122,8,10,2,15,37,50,-13,32
Wellington P,7122,9,5,6,16,31,55,-24,21
CC Mariners,7122,10,4,8,15,28,49,-21,20
Sydney FC,7123,1,21,4,3,65,22,43,67
N'castle Jet,7123,2,15,6,7,58,38,20,51
Melbourne C,7123,3,14,5,10,44,34,10,47
Melbourne V,7123,4,13,5,11,45,39,6,44
Adelaide Utd,7123,5,11,6,11,37,40,-3,39
Brisbane,7123,6,10,5,13,33,42,-9,35
Western Sydn,7123,7,8,9,10,38,47,-9,33
Perth Glory,7123,8,10,2,15,37,50,-13,32
Wellington P,7123,9,5,6,16,31,55,-24,21
CC Mariners,7123,10,4,8,15,28,49,-21,20
Sydney FC,7124,1,21,4,3,68,22,46,67
N'castle Jet,7124,2,16,5,7,59,37,22,53
Melbourne C,7124,3,14,4,11,43,35,8,46
Melbourne V,7124,4,13,5,11,45,42,3,44
Adelaide Utd,7124,5,11,6,11,37,40,-3,39
Brisbane,7124,6,10,5,13,33,42,-9,35
Western Sydn,7124,7,8,9,10,38,47,-9,33
Perth Glory,7124,8,10,2,15,37,50,-13,32
Wellington P,7124,9,5,6,16,31,55,-24,21
CC Mariners,7124,10,4,8,15,28,49,-21,20
Sydney FC,7125,1,21,4,3,68,22,46,67
N'castle Jet,7125,2,15,6,7,57,37,20,51
Melbourne C,7125,3,14,5,10,43,33,10,47
Melbourne V,7125,4,13,5,11,45,42,3,44
Adelaide Utd,7125,5,11,6,11,37,40,-3,39
Brisbane,7125,6,10,5,13,33,42,-9,35
Western Sydn,7125,7,8,9,10,38,47,-9,33
Perth Glory,7125,8,10,2,15,37,50,-13,32
Wellington P,7125,9,5,6,16,31,55,-24,21
CC Mariners,7125,10,4,8,15,28,49,-21,20
Sydney FC,7126,1,20,4,4,64,23,41,64
N'castle Jet,7126,2,16,5,7,59,38,21,53
Melbourne V,7126,3,14,5,10,46,38,8,47
Melbourne C,7126,4,14,4,11,44,35,9,46
Adelaide Utd,7126,5,11,6,11,37,40,-3,39
Brisbane,7126,6,10,5,13,33,42,-9,35
Western Sydn,7126,7,8,9,10,38,47,-9,33
Perth Glory,7126,8,10,2,15,37,50,-13,32
Wellington P,7126,9,5,6,16,31,55,-24,21
CC Mariners,7126,10,4,8,15,28,49,-21,20
Sydney FC,7127,1,21,4,3,69,22,47,67
N'castle Jet,7127,2,16,5,7,60,38,22,53
Melbourne C,7127,3,14,4,11,44,36,8,46
Melbourne V,7127,4,13,5,11,45,43,2,44
Adelaide Utd,7127,5,11,6,11,37,40,-3,39
Brisbane,7127,6,10,5,13,33,42,-9,35
Western Sydn,7127,7,8,9,10,38,47,-9,33
Perth Glory,7127,8,10,2,15,37,50,-13,32
Wellington P,7127,9,5,6,16,31,55,-24,21
CC Mariners,7127,10,4,8,15,28,49,-21,20
Sydney FC,7128,1,20,5,3,65,23,42,65
N'castle Jet,7128,2,16,5,7,62,38,24,53
Melbourne C,7128,3,14,4,11,44,38,6,46
Melbourne V,7128,4,13,6,10,46,39,7,45
Adelaide Utd,7128,5,11,6,11,37,40,-3,39
Brisbane,7128,6,10,5,13,33,42,-9,35
Western Sydn,7128,7,8,9,10,38,47,-9,33
Perth Glory,7128,8,10,2,15,37,50,-13,32
Wellington P,7128,9,5,6,16,31,55,-24,21
CC Mariners,7128,10,4,8,15,28,49,-21,20
Sydney FC,7129,1,21,4,3,66,23,43,67
N'castle Jet,7129,2,15,5,8,59,40,19,50
Melbourne C,7129,3,15,4,10,46,35,11,49
Melbourne V,7129,4,13,5,11,46,40,6,44
Adelaide Utd,7129,5,11,6,11,37,40,-3,39
Brisbane,7129,6,10,5,13,33,42,-9,35
Western Sydn,7129,7,8,9,10,38,47,-9,33
Perth Glory,7129,8,10,2,15,37,50,-13,32
Wellington P,7129,9,5,6,16,31,55,-24,21
CC Mariners,7129,10,4,8,15,28,49,-21,20
Sydney FC,7130,1,20,4,4,65,24,41,64
N'castle Jet,7130,2,16,5,7,59,38,21,53
Melbourne V,7130,3,14,5,10,47,39,8,47
Melbourne C,7130,4,14,4,11,44,35,9,46
Adelaide Utd,7130,5,11,6,11,37,40,-3,39
Brisbane,7130,6,10,5,13,33,42,-9,35
Western Sydn,7130,7,8,9,10,38,47,-9,33
Perth Glory,7130,8,10,2,15,37,50,-13,32
Wellington P,7130,9,5,6,16,31,55,-24,21
CC Mariners,7130,10,4,8,15,28,49,-21,20
Sydney FC,7131,1,20,5,3,65,23,42,65
N'castle Jet,7131,2,16,5,7,63,37,26,53
Melbourne C,7131,3,14,4,11,43,39,4,46
Melbourne V,7131,4,13,6,10,46,39,7,45
Adelaide Utd,7131,5,11,6,11,37,40,-3,39
Brisbane,7131,6,10,5,13,33,42,-9,35
Western Sydn,7131,7,8,9,10,38,47,-9,33
Perth Glory,7131,8,10,2,15,37,50,-13,32
Wellington P,7131,9,5,6,16,31,55,-24,21
CC Mariners,7131,10,4,8,15,28,49,-21,20
Sydney FC,7132,1,20,4,4,65,24,41,64
N'castle Jet,7132,2,16,5,7,59,38,21,53
Melbourne V,7132,3,14,5,10,47,39,8,47
Melbourne C,7132,4,14,4,11,44,35,9,46
Adelaide Utd,7132,5,11,6,11,37,40,-3,39
Brisbane,7132,6,10,5,13,33,42,-9,35
Western Sydn,7132,7,8,9,10,38,47,-9,33
Perth Glory,7132,8,10,2,15,37,50,-13,32
Wellington P,7132,9,5,6,16,31,55,-24,21
CC Mariners,7132,10,4,8,15,28,49,-21,20
Sydney FC,7133,1,20,5,3,66,24,42,65
N'castle Jet,7133,2,16,5,7,60,38,22,53
Melbourne C,7133,3,14,4,11,44,36,8,46
Melbourne V,7133,4,13,6,10,47,40,7,45
Adelaide Utd,7133,5,11,6,11,37,40,-3,39
Brisbane,7133,6,10,5,13,33,42,-9,35
Western Sydn,7133,7,8,9,10,38,47,-9,33
Perth Glory,7133,8,10,2,15,37,50,-13,32
Wellington P,7133,9,5,6,16,31,55,-24,21
CC Mariners,7133,10,4,8,15,28,49,-21,20
Sydney FC,7134,1,21,4,3,67,23,44,67
N'castle Jet,7134,2,16,5,7,58,37,21,53
Melbourne C,7134,3,14,4,11,43,34,9,46
Melbourne V,7134,4,13,5,11,46,41,5,44
Adelaide Utd,7134,5,11,6,11,37,40,-3,39
Brisbane,7134,6,10,5,13,33,42,-9,35
Western Sydn,7134,7,8,9,10,38,47,-9,33
Perth Glory,7134,8,10,2,15,37,50,-13,32
Wellington P,7134,9,5,6,16,31,55,-24,21
CC Mariners,7134,10,4,8,15,28,49,-21,20
Sydney FC,7135,1,21,4,3,68,23,45,67
N'castle Jet,7135,2,16,5,7,59,38,21,53
Melbourne C,7135,3,14,4,11,44,35,9,46
Melbourne V,7135,4,13,5,11,46,42,4,44
Adelaide Utd,7135,5,11,6,11,37,40,-3,39
Brisbane,7135,6,10,5,13,33,42,-9,35
Western Sydn,7135,7,8,9,10,38,47,-9,33
Perth Glory,7135,8,10,2,15,37,50,-13,32
Wellington P,7135,9,5,6,16,31,55,-24,21
CC Mariners,7135,10,4,8,15,28,49,-21,20
Sydney FC,7136,1,21,4,3,65,22,43,67
N'castle Jet,7136,2,16,5,7,61,38,23,53
Melbourne C,7136,3,14,4,11,44,37,7,46
Melbourne V,7136,4,13,5,11,45,39,6,44
Adelaide Utd,7136,5,11,6,11,37,40,-3,39
Brisbane,7136,6,10,5,13,33,42,-9,35
Western Sydn,7136,7,8,9,10,38,47,-9,33
Perth Glory,7136,8,10,2,15,37,50,-13,32
Wellington P,7136,9,5,6,16,31,55,-24,21
CC Mariners,7136,10,4,8,15,28,49,-21,20
Sydney FC,7137,1,21,4,3,66,23,43,67
N'castle Jet,7137,2,15,5,8,58,39,19,50
Melbourne C,7137,3,15,4,10,45,34,11,49
Melbourne V,7137,4,13,5,11,46,40,6,44
Adelaide Utd,7137,5,11,6,11,37,40,-3,39
Brisbane,7137,6,10,5,13,33,42,-9,35
Western Sydn,7137,7,8,9,10,38,47,-9,33
Perth Glory,7137,8,10,2,15,37,50,-13,32
Wellington P,7137,9,5,6,16,31,55,-24,21
CC Mariners,7137,10,4,8,15,28,49,-21,20
Sydney FC,7138,1,21,4,3,66,22,44,67
N'castle Jet,7138,2,16,5,7,59,38,21,53
Melbourne C,7138,3,14,4,11,44,35,9,46
Melbourne V,7138,4,13,5,11,45,40,5,44
Adelaide Utd,7138,5,11,6,11,37,40,-3,39
Brisbane,7138,6,10,5,13,33,42,-9,35
Western Sydn,7138,7,8,9,10,38,47,-9,33
Perth Glory,7138,8,10,2,15,37,50,-13,32
Wellington P,7138,9,5,6,16,31,55,-24,21
CC Mariners,7138,10,4,8,15,28,49,-21,20
Sydney FC,7139,1,20,4,4,65,26,39,64
N'castle Jet,7139,2,16,5,7,61,37,24,53
Melbourne V,7139,3,14,5,10,49,39,10,47
Melbourne C,7139,4,14,4,11,43,37,6,46
Adelaide Utd,7139,5,11,6,11,37,40,-3,39
Brisbane,7139,6,10,5,13,33,42,-9,35
Western Sydn,7139,7,8,9,10,38,47,-9,33
Perth Glory,7139,8,10,2,15,37,50,-13,32
Wellington P,7139,9,5,6,16,31,55,-24,21
CC Mariners,7139,10,4,8,15,28,49,-21,20
Sydney FC,7140,1,21,4,3,65,22,43,67
N'castle Jet,7140,2,16,5,7,62,39,23,53
Melbourne C,7140,3,14,4,11,45,38,7,46
Melbourne V,7140,4,13,5,11,45,39,6,44
Adelaide Utd,7140,5,11,6,11,37,40,-3,39
Brisbane,7140,6,10,5,13,33,42,-9,35
Western Sydn,7140,7,8,9,10,38,47,-9,33
Perth Glory,7140,8,10,2,15,37,50,-13,32
Wellington P,7140,9,5,6,16,31,55,-24,21
CC Mariners,7140,10,4,8,15,28,49,-21,20
Sydney FC,7141,1,21,4,3,68,22,46,67
N'castle Jet,7141,2,15,6,7,58,38,20,51
Melbourne C,7141,3,14,5,10,44,34,10,47
Melbourne V,7141,4,13,5,11,45,42,3,44
Adelaide Utd,7141,5,11,6,11,37,40,-3,39
Brisbane,7141,6,10,5,13,33,42,-9,35
Western Sydn,7141,7,8,9,10,38,47,-9,33
Perth Glory,7141,8,10,2,15,37,50,-13,32
Wellington P,7141,9,5,6,16,31,55,-24,21
CC Mariners,7141,10,4,8,15,28,49,-21,20
Sydney FC,7142,1,20,4,4,64,23,41,64
N'castle Jet,7142,2,16,5,7,60,39,21,53
Melbourne V,7142,3,14,5,10,46,38,8,47
Melbourne C,7142,4,14,4,11,45,36,9,46
Adelaide Utd,7142,5,11,6,11,37,40,-3,39
Brisbane,7142,6,10,5,13,33,42,-9,35
Western Sydn,7142,7,8,9,10,38,47,-9,33
Perth Glory,7142,8,10,2,15,37,50,-13,32
Wellington P,7142,9,5,6,16,31,55,-24,21
CC Mariners,7142,10,4,8,15,28,49,-21,20
Sydney FC,7143,1,20,5,3,66,24,42,65
N'castle Jet,7143,2,16,5,7,58,37,21,53
Melbourne C,7143,3,14,4,11,43,34,9,46
Melbourne V,7143,4,13,6,10,47,40,7,45
Adelaide Utd,7143,5,11,6,11,37,40,-3,39
Brisbane,7143,6,10,5,13,33,42,-9,35
Western Sydn,7143,7,8,9,10,38,47,-9,33
Perth Glory,7143,8,10,2,15,37,50,-13,32
Wellington P,7143,9,5,6,16,31,55,-24,21
CC Mariners,7143,10,4,8,15,28,49,-21,20
Sydney FC,7144,1,20,4,4,64,23,41,64
N'castle Jet,7144,2,16,5,7,58,37,21,53
Melbourne V,7144,3,14,5,10,46,38,8,47
Melbourne C,7144,4,14,4,11,43,34,9,46
Adelaide Utd,7144,5,11,6,11,37,40,-3,39
Brisbane,7144,6,10,5,13,33,42,-9,35
Western Sydn,7144,7,8,9,10,38,47,-9,33
Perth Glory,7144,8,10,2,15,37,50,-13,32
Wellington P,7144,9,5,6,16,31,55,-24,21
CC Mariners,7144,10,4,8,15,28,49,-21,20
Sydney FC,7145,1,21,4,3,66,22,44,67
N'castle Jet,7145,2,16,5,7,59,38,21,53
Melbourne C,7145,3,14,4,11,44,35,9,46
Melbourne V,7145,4,13,5,11,45,40,5,44
Adelaide Utd,7145,5,11,6,11,37,40,-3,39
Brisbane,7145,6,10,5,13,33,42,-9,35
Western Sydn,7145,7,8,9,10,38,47,-9,33
Perth Glory,7145,8,10,2,15,37,50,-13,32
Wellington P,7145,9,5,6,16,31,55,-24,21
CC Mariners,7145,10,4,8,15,28,49,-21,20
Sydney FC,7146,1,21,4,3,66,23,43,67
N'castle Jet,7146,2,15,6,7,59,39,20,51
Melbourne C,7146,3,14,5,10,45,35,10,47
Melbourne V,7146,4,13,5,11,46,40,6,44
Adelaide Utd,7146,5,11,6,11,37,40,-3,39
Brisbane,7146,6,10,5,13,33,42,-9,35
Western Sydn,7146,7,8,9,10,38,47,-9,33
Perth Glory,7146,8,10,2,15,37,50,-13,32
Wellington P,7146,9,5,6,16,31,55,-24,21
CC Mariners,7146,10,4,8,15,28,49,-21,20
Sydney FC,7147,1,21,4,3,66,23,43,67
N'castle Jet,7147,2,15,6,7,58,38,20,51
Melbourne C,7147,3,14,5,10,44,34,10,47
Melbourne V,7147,4,13,5,11,46,40,6,44
Adelaide Utd,7147,5,11,6,11,37,40,-3,39
Brisbane,7147,6,10,5,13,33,42,-9,35
Western Sydn,7147,7,8,9,10,38,47,-9,33
Perth Glory,7147,8,10,2,15,37,50,-13,32
Wellington P,7147,9,5,6,16,31,55,-24,21
CC Mariners,7147,10,4,8,15,28,49,-21,20
Sydney FC,7148,1,20,4,4,64,23,41,64
N'castle Jet,7148,2,16,5,7,59,37,22,53
Melbourne V,7148,3,14,5,10,46,38,8,47
Melbourne C,7148,4,14,4,11,43,35,8,46
Adelaide Utd,7148,5,11,6,11,37,40,-3,39
Brisbane,7148,6,10,5,13,33,42,-9,35
Western Sydn,7148,7,8,9,10,38,47,-9,33
Perth Glory,7148,8,10,2,15,37,50,-13,32
Wellington P,7148,9,5,6,16,31,55,-24,21
CC Mariners,7148,10,4,8,15,28,49,-21,20
Sydney FC,7149,1,21,4,3,65,22,43,67
N'castle Jet,7149,2,16,5,7,59,38,21,53
Melbourne C,7149,3,14,4,11,44,35,9,46
Melbourne V,7149,4,13,5,11,45,39,6,44
Adelaide Utd,7149,5,11,6,11,37,40,-3,39
Brisbane,7149,6,10,5,13,33,42,-9,35
Western Sydn,7149,7,8,9,10,38,47,-9,33
Perth Glory,7149,8,10,2,15,37,50,-13,32
Wellington P,7149,9,5,6,16,31,55,-24,21
CC Mariners,7149,10,4,8,15,28,49,-21,20
Sydney FC,7150,1,20,5,3,64,22,42,65
N'castle Jet,7150,2,16,5,7,59,37,22,53
Melbourne C,7150,3,14,4,11,43,35,8,46
Melbourne V,7150,4,13,6,10,45,38,7,45
Adelaide Utd,7150,5,11,6,11,37,40,-3,39
Brisbane,7150,6,10,5,13,33,42,-9,35
Western Sydn,7150,7,8,9,10,38,47,-9,33
Perth Glory,7150,8,10,2,15,37,50,-13,32
Wellington P,7150,9,5,6,16,31,55,-24,21
CC Mariners,7150,10,4,8,15,28,49,-21,20
Sydney FC,7151,1,21,4,3,65,22,43,67
N'castle Jet,7151,2,15,5,8,58,39,19,50
Melbourne C,7151,3,15,4,10,45,34,11,49
Melbourne V,7151,4,13,5,11,45,39,6,44
Adelaide Utd,7151,5,11,6,11,37,40,-3,39
Brisbane,7151,6,10,5,13,33,42,-9,35
Western Sydn,7151,7,8,9,10,38,47,-9,33
Perth Glory,7151,8,10,2,15,37,50,-13,32
Wellington P,7151,9,5,6,16,31,55,-24,21
CC Mariners,7151,10,4,8,15,28,49,-21,20
Sydney FC,7152,1,21,4,3,66,22,44,67
N'castle Jet,7152,2,15,6,7,57,37,20,51
Melbourne C,7152,3,14,5,10,43,33,10,47
Melbourne V,7152,4,13,5,11,45,40,5,44
Adelaide Utd,7152,5,11,6,11,37,40,-3,39
Brisbane,7152,6,10,5,13,33,42,-9,35
Western Sydn,7152,7,8,9,10,38,47,-9,33
Perth Glory,7152,8,10,2,15,37,50,-13,32
Wellington P,7152,9,5,6,16,31,55,-24,21
CC Mariners,7152,10,4,8,15,28,49,-21,20
Sydney FC,7153,1,21,4,3,66,23,43,67
N'castle Jet,7153,2,15,6,7,57,37,20,51
Melbourne C,7153,3,14,5,10,43,33,10,47
Melbourne V,7153,4,13,5,11,46,40,6,44
Adelaide Utd,7153,5,11,6,11,37,40,-3,39
Brisbane,7153,6,10,5,13,33,42,-9,35
Western Sydn,7153,7,8,9,10,38,47,-9,33
Perth Glory,7153,8,10,2,15,37,50,-13,32
Wellington P,7153,9,5,6,16,31,55,-24,21
CC Mariners,7153,10,4,8,15,28,49,-21,20
Sydney FC,7154,1,21,4,3,66,23,43,67
N'castle Jet,7154,2,16,5,7,62,39,23,53
Melbourne C,7154,3,14,4,11,45,38,7,46
Melbourne V,7154,4,13,5,11,46,40,6,44
Adelaide Utd,7154,5,11,6,11,37,40,-3,39
Brisbane,7154,6,10,5,13,33,42,-9,35
Western Sydn,7154,7,8,9,10,38,47,-9,33
Perth Glory,7154,8,10,2,15,37,50,-13,32
Wellington P,7154,9,5,6,16,31,55,-24,21
CC Mariners,7154,10,4,8,15,28,49,-21,20
Sydney FC,7155,1,21,4,3,66,23,43,67
N'castle Jet,7155,2,15,6,7,59,39,20,51
Melbourne C,7155,3,14,5,10,45,35,10,47
Melbourne V,7155,4,13,5,11,46,40,6,44
Adelaide Utd,7155,5,11,6,11,37,40,-3,39
Brisbane,7155,6,10,5,13,33,42,-9,35
Western Sydn,7155,7,8,9,10,38,47,-9,33
Perth Glory,7155,8,10,2,15,37,50,-13,32
Wellington P,7155,9,5,6,16,31,55,-24,21
CC Mariners,7155,10,4,8,15,28,49,-21,20
Sydney FC,7156,1,20,5,3,64,22,42,65
N'castle Jet,7156,2,15,6,7,57,37,20,51
Melbourne C,7156,3,14,5,10,43,33,10,47
Melbourne V,7156,4,13,6,10,45,38,7,45
Adelaide Utd,7156,5,11,6,11,37,40,-3,39
Brisbane,7156,6,10,5,13,33,42,-9,35
Western Sydn,7156,7,8,9,10,38,47,-9,33
Perth Glory,7156,8,10,2,15,37,50,-13,32
Wellington P,7156,9,5,6,16,31,55,-24,21
CC Mariners,7156,10,4,8,15,28,49,-21,20
Sydney FC,7157,1,21,4,3,66,23,43,67
N'castle Jet,7157,2,15,6,7,58,38,20,51
Melbourne C,7157,3,14,5,10,44,34,10,47
Melbourne V,7157,4,13,5,11,46,40,6,44
Adelaide Utd,7157,5,11,6,11,37,40,-3,39
Brisbane,7157,6,10,5,13,33,42,-9,35
Western Sydn,7157,7,8,9,10,38,47,-9,33
Perth Glory,7157,8,10,2,15,37,50,-13,32
Wellington P,7157,9,5,6,16,31,55,-24,21
CC Mariners,7157,10,4,8,15,28,49,-21,20
Sydney FC,7158,1,21,4,3,65,22,43,67
N'castle Jet,7158,2,16,5,7,60,38,22,53
Melbourne C,7158,3,14,4,11,44,36,8,46
Melbourne V,7158,4,13,5,11,45,39,6,44
Adelaide Utd,7158,5,11,6,11,37,40,-3,39
Brisbane,7158,6,10,5,13,33,42,-9,35
Western Sydn,7158,7,8,9,10,38,47,-9,33
Perth Glory,7158,8,10,2,15,37,50,-13,32
Wellington P,7158,9,5,6,16,31,55,-24,21
CC Mariners,7158,10,4,8,15,28,49,-21,20
Sydney FC,7159,1,20,5,3,64,22,42,65
N'castle Jet,7159,2,15,5,8,58,39,19,50
Melbourne C,7159,3,15,4,10,45,34,11,49
Melbourne V,7159,4,13,6,10,45,38,7,45
Adelaide Utd,7159,5,11,6,11,37,40,-3,39
Brisbane,7159,6,10,5,13,33,42,-9,35
Western Sydn,7159,7,8,9,10,38,47,-9,33
Perth Glory,7159,8,10,2,15,37,50,-13,32
Wellington P,7159,9,5,6,16,31,55,-24,21
CC Mariners,7159,10,4,8,15,28,49,-21,20
Sydney FC,7160,1,21,4,3,67,23,44,67
N'castle Jet,7160,2,15,6,7,60,40,20,51
Melbourne C,7160,3,14,5,10,46,36,10,47
Melbourne V,7160,4,13,5,11,46,41,5,44
Adelaide Utd,7160,5,11,6,11,37,40,-3,39
Brisbane,7160,6,10,5,13,33,42,-9,35
Western Sydn,7160,7,8,9,10,38,47,-9,33
Perth Glory,7160,8,10,2,15,37,50,-13,32
Wellington P,7160,9,5,6,16,31,55,-24,21
CC Mariners,7160,10,4,8,15,28,49,-21,20
Sydney FC,7161,1,21,4,3,66,22,44,67
N'castle Jet,7161,2,16,5,7,60,37,23,53
Melbourne C,7161,3,14,4,11,43,36,7,46
Melbourne V,7161,4,13,5,11,45,40,5,44
Adelaide Utd,7161,5,11,6,11,37,40,-3,39
Brisbane,7161,6,10,5,13,33,42,-9,35
Western Sydn,7161,7,8,9,10,38,47,-9,33
Perth Glory,7161,8,10,2,15,37,50,-13,32
Wellington P,7161,9,5,6,16,31,55,-24,21
CC Mariners,7161,10,4,8,15,28,49,-21,20
Sydney FC,7162,1,21,4,3,66,22,44,67
N'castle Jet,7162,2,15,5,8,59,41,18,50
Melbourne C,7162,3,15,4,10,47,35,12,49
Melbourne V,7162,4,13,5,11,45,40,5,44
Adelaide Utd,7162,5,11,6,11,37,40,-3,39
Brisbane,7162,6,10,5,13,33,42,-9,35
Western Sydn,7162,7,8,9,10,38,47,-9,33
Perth Glory,7162,8,10,2,15,37,50,-13,32
Wellington P,7162,9,5,6,16,31,55,-24,21
CC Mariners,7162,10,4,8,15,28,49,-21,20
Sydney FC,7163,1,21,4,3,66,23,43,67
N'castle Jet,7163,2,15,6,7,58,38,20,51
Melbourne C,7163,3,14,5,10,44,34,10,47
Melbourne V,7163,4,13,5,11,46,40,6,44
Adelaide Utd,7163,5,11,6,11,37,40,-3,39
Brisbane,7163,6,10,5,13,33,42,-9,35
Western Sydn,7163,7,8,9,10,38,47,-9,33
Perth Glory,7163,8,10,2,15,37,50,-13,32
Wellington P,7163,9,5,6,16,31,55,-24,21
CC Mariners,7163,10,4,8,15,28,49,-21,20
Sydney FC,7164,1,20,5,3,65,23,42,65
N'castle Jet,7164,2,15,5,8,58,40,18,50
Melbourne C,7164,3,15,4,10,46,34,12,49
Melbourne V,7164,4,13,6,10,46,39,7,45
Adelaide Utd,7164,5,11,6,11,37,40,-3,39
Brisbane,7164,6,10,5,13,33,42,-9,35
Western Sydn,7164,7,8,9,10,38,47,-9,33
Perth Glory,7164,8,10,2,15,37,50,-13,32
Wellington P,7164,9,5,6,16,31,55,-24,21
CC Mariners,7164,10,4,8,15,28,49,-21,20
Sydney FC,7165,1,21,4,3,68,22,46,67
N'castle Jet,7165,2,15,5,8,57,40,17,50
Melbourne C,7165,3,15,4,10,46,33,13,49
Melbourne V,7165,4,13,5,11,45,42,3,44
Adelaide Utd,7165,5,11,6,11,37,40,-3,39
Brisbane,7165,6,10,5,13,33,42,-9,35
Western Sydn,7165,7,8,9,10,38,47,-9,33
Perth Glory,7165,8,10,2,15,37,50,-13,32
Wellington P,7165,9,5,6,16,31,55,-24,21
CC Mariners,7165,10,4,8,15,28,49,-21,20
Sydney FC,7166,1,20,4,4,65,25,40,64
N'castle Jet,7166,2,15,5,8,57,38,19,50
Melbourne C,7166,3,15,4,10,44,33,11,49
Melbourne V,7166,4,14,5,10,48,39,9,47
Adelaide Utd,7166,5,11,6,11,37,40,-3,39
Brisbane,7166,6,10,5,13,33,42,-9,35
Western Sydn,7166,7,8,9,10,38,47,-9,33
Perth Glory,7166,8,10,2,15,37,50,-13,32
Wellington P,7166,9,5,6,16,31,55,-24,21
CC Mariners,7166,10,4,8,15,28,49,-21,20
Sydney FC,7167,1,20,4,4,65,24,41,64
N'castle Jet,7167,2,16,5,7,61,37,24,53
Melbourne V,7167,3,14,5,10,47,39,8,47
Melbourne C,7167,4,14,4,11,43,37,6,46
Adelaide Utd,7167,5,11,6,11,37,40,-3,39
Brisbane,7167,6,10,5,13,33,42,-9,35
Western Sydn,7167,7,8,9,10,38,47,-9,33
Perth Glory,7167,8,10,2,15,37,50,-13,32
Wellington P,7167,9,5,6,16,31,55,-24,21
CC Mariners,7167,10,4,8,15,28,49,-21,20
Sydney FC,7168,1,21,4,3,68,24,44,67
N'castle Jet,7168,2,16,5,7,58,37,21,53
Melbourne C,7168,3,14,4,11,43,34,9,46
Melbourne V,7168,4,13,5,11,47,42,5,44
Adelaide Utd,7168,5,11,6,11,37,40,-3,39
Brisbane,7168,6,10,5,13,33,42,-9,35
Western Sydn,7168,7,8,9,10,38,47,-9,33
Perth Glory,7168,8,10,2,15,37,50,-13,32
Wellington P,7168,9,5,6,16,31,55,-24,21
CC Mariners,7168,10,4,8,15,28,49,-21,20
Sydney FC,7169,1,21,4,3,66,23,43,67
N'castle Jet,7169,2,15,6,7,59,39,20,51
Melbourne C,7169,3,14,5,10,45,35,10,47
Melbourne V,7169,4,13,5,11,46,40,6,44
Adelaide Utd,7169,5,11,6,11,37,40,-3,39
Brisbane,7169,6,10,5,13,33,42,-9,35
Western Sydn,7169,7,8,9,10,38,47,-9,33
Perth Glory,7169,8,10,2,15,37,50,-13,32
Wellington P,7169,9,5,6,16,31,55,-24,21
CC Mariners,7169,10,4,8,15,28,49,-21,20
Sydney FC,7170,1,21,4,3,66,22,44,67
N'castle Jet,7170,2,16,5,7,62,37,25,53
Melbourne C,7170,3,14,4,11,43,38,5,46
Melbourne V,7170,4,13,5,11,45,40,5,44
Adelaide Utd,7170,5,11,6,11,37,40,-3,39
Brisbane,7170,6,10,5,13,33,42,-9,35
Western Sydn,7170,7,8,9,10,38,47,-9,33
Perth Glory,7170,8,10,2,15,37,50,-13,32
Wellington P,7170,9,5,6,16,31,55,-24,21
CC Mariners,7170,10,4,8,15,28,49,-21,20
Sydney FC,7171,1,21,4,3,67,24,43,67
N'castle Jet,7171,2,16,5,7,59,37,22,53
Melbourne C,7171,3,14,4,11,43,35,8,46
Melbourne V,7171,4,13,5,11,47,41,6,44
Adelaide Utd,7171,5,11,6,11,37,40,-3,39
Brisbane,7171,6,10,5,13,33,42,-9,35
Western Sydn,7171,7,8,9,10,38,47,-9,33
Perth Glory,7171,8,10,2,15,37,50,-13,32
Wellington P,7171,9,5,6,16,31,55,-24,21
CC Mariners,7171,10,4,8,15,28,49,-21,20
Sydney FC,7172,1,21,4,3,66,23,43,67
N'castle Jet,7172,2,16,5,7,59,37,22,53
Melbourne C,7172,3,14,4,11,43,35,8,46
Melbourne V,7172,4,13,5,11,46,40,6,44
Adelaide Utd,7172,5,11,6,11,37,40,-3,39
Brisbane,7172,6,10,5,13,33,42,-9,35
Western Sydn,7172,7,8,9,10,38,47,-9,33
Perth Glory,7172,8,10,2,15,37,50,-13,32
Wellington P,7172,9,5,6,16,31,55,-24,21
CC Mariners,7172,10,4,8,15,28,49,-21,20
Sydney FC,7173,1,21,4,3,66,22,44,67
N'castle Jet,7173,2,15,5,8,57,40,17,50
Melbourne C,7173,3,15,4,10,46,33,13,49
Melbourne V,7173,4,13,5,11,45,40,5,44
Adelaide Utd,7173,5,11,6,11,37,40,-3,39
Brisbane,7173,6,10,5,13,33,42,-9,35
Western Sydn,7173,7,8,9,10,38,47,-9,33
Perth Glory,7173,8,10,2,15,37,50,-13,32
Wellington P,7173,9,5,6,16,31,55,-24,21
CC Mariners,7173,10,4,8,15,28,49,-21,20
Sydney FC,7174,1,21,4,3,67,24,43,67
N'castle Jet,7174,2,16,5,7,59,38,21,53
Melbourne C,7174,3,14,4,11,44,35,9,46
Melbourne V,7174,4,13,5,11,47,41,6,44
Adelaide Utd,7174,5,11,6,11,37,40,-3,39
Brisbane,7174,6,10,5,13,33,42,-9,35
Western Sydn,7174,7,8,9,10,38,47,-9,33
Perth Glory,7174,8,10,2,15,37,50,-13,32
Wellington P,7174,9,5,6,16,31,55,-24,21
CC Mariners,7174,10,4,8,15,28,49,-21,20
Sydney FC,7175,1,20,4,4,65,25,40,64
N'castle Jet,7175,2,16,5,7,59,37,22,53
Melbourne V,7175,3,14,5,10,48,39,9,47
Melbourne C,7175,4,14,4,11,43,35,8,46
Adelaide Utd,7175,5,11,6,11,37,40,-3,39
Brisbane,7175,6,10,5,13,33,42,-9,35
Western Sydn,7175,7,8,9,10,38,47,-9,33
Perth Glory,7175,8,10,2,15,37,50,-13,32
Wellington P,7175,9,5,6,16,31,55,-24,21
CC Mariners,7175,10,4,8,15,28,49,-21,20
Sydney FC,7176,1,20,4,4,66,25,41,64
N'castle Jet,7176,2,16,5,7,59,37,22,53
Melbourne V,7176,3,14,5,10,48,40,8,47
Melbourne C,7176,4,14,4,11,43,35,8,46
Adelaide Utd,7176,5,11,6,11,37,40,-3,39
Brisbane,7176,6,10,5,13,33,42,-9,35
Western Sydn,7176,7,8,9,10,38,47,-9,33
Perth Glory,7176,8,10,2,15,37,50,-13,32
Wellington P,7176,9,5,6,16,31,55,-24,21
CC Mariners,7176,10,4,8,15,28,49,-21,20
Sydney FC,7177,1,20,5,3,64,22,42,65
N'castle Jet,7177,2,16,5,7,59,38,21,53
Melbourne C,7177,3,14,4,11,44,35,9,46
Melbourne V,7177,4,13,6,10,45,38,7,45
Adelaide Utd,7177,5,11,6,11,37,40,-3,39
Brisbane,7177,6,10,5,13,33,42,-9,35
Western Sydn,7177,7,8,9,10,38,47,-9,33
Perth Glory,7177,8,10,2,15,37,50,-13,32
Wellington P,7177,9,5,6,16,31,55,-24,21
CC Mariners,7177,10,4,8,15,28,49,-21,20
Sydney FC,7178,1,21,4,3,67,23,44,67
N'castle Jet,7178,2,16,5,7,58,37,21,53
Melbourne C,7178,3,14,4,11,43,34,9,46
Melbourne V,7178,4,13,5,11,46,41,5,44
Adelaide Utd,7178,5,11,6,11,37,40,-3,39
Brisbane,7178,6,10,5,13,33,42,-9,35
Western Sydn,7178,7,8,9,10,38,47,-9,33
Perth Glory,7178,8,10,2,15,37,50,-13,32
Wellington P,7178,9,5,6,16,31,55,-24,21
CC Mariners,7178,10,4,8,15,28,49,-21,20
Sydney FC,7179,1,21,4,3,68,23,45,67
N'castle Jet,7179,2,16,5,7,61,40,21,53
Melbourne C,7179,3,14,4,11,46,37,9,46
Melbourne V,7179,4,13,5,11,46,42,4,44
Adelaide Utd,7179,5,11,6,11,37,40,-3,39
Brisbane,7179,6,10,5,13,33,42,-9,35
Western Sydn,7179,7,8,9,10,38,47,-9,33
Perth Glory,7179,8,10,2,15,37,50,-13,32
Wellington P,7179,9,5,6,16,31,55,-24,21
CC Mariners,7179,10,4,8,15,28,49,-21,20
Sydney FC,7180,1,20,5,3,66,24,42,65
N'castle Jet,7180,2,15,5,8,57,38,19,50
Melbourne C,7180,3,15,4,10,44,33,11,49
Melbourne V,7180,4,13,6,10,47,40,7,45
Adelaide Utd,7180,5,11,6,11,37,40,-3,39
Brisbane,7180,6,10,5,13,33,42,-9,35
Western Sydn,7180,7,8,9,10,38,47,-9,33
Perth Glory,7180,8,10,2,15,37,50,-13,32
Wellington P,7180,9,5,6,16,31,55,-24,21
CC Mariners,7180,10,4,8,15,28,49,-21,20
Sydney FC,7181,1,21,4,3,66,23,43,67
N'castle Jet,7181,2,16,5,7,62,37,25,53
Melbourne C,7181,3,14,4,11,43,38,5,46
Melbourne V,7181,4,13,5,11,46,40,6,44
Adelaide Utd,7181,5,11,6,11,37,40,-3,39
Brisbane,7181,6,10,5,13,33,42,-9,35
Western Sydn,7181,7,8,9,10,38,47,-9,33
Perth Glory,7181,8,10,2,15,37,50,-13,32
Wellington P,7181,9,5,6,16,31,55,-24,21
CC Mariners,7181,10,4,8,15,28,49,-21,20
Sydney FC,7182,1,20,5,3,65,23,42,65
N'castle Jet,7182,2,15,6,7,59,39,20,51
Melbourne C,7182,3,14,5,10,45,35,10,47
Melbourne V,7182,4,13,6,10,46,39,7,45
Adelaide Utd,7182,5,11,6,11,37,40,-3,39
Brisbane,7182,6,10,5,13,33,42,-9,35
Western Sydn,7182,7,8,9,10,38,47,-9,33
Perth Glory,7182,8,10,2,15,37,50,-13,32
Wellington P,7182,9,5,6,16,31,55,-24,21
CC Mariners,7182,10,4,8,15,28,49,-21,20
Sydney FC,7183,1,21,4,3,70,23,47,67
N'castle Jet,7183,2,15,5,8,57,38,19,50
Melbourne C,7183,3,15,4,10,44,33,11,49
Melbourne V,7183,4,13,5,11,46,44,2,44
Adelaide Utd,7183,5,11,6,11,37,40,-3,39
Brisbane,7183,6,10,5,13,33,42,-9,35
Western Sydn,7183,7,8,9,10,38,47,-9,33
Perth Glory,7183,8,10,2,15,37,50,-13,32
Wellington P,7183,9,5,6,16,31,55,-24,21
CC Mariners,7183,10,4,8,15,28,49,-21,20
Sydney FC,7184,1,21,4,3,66,22,44,67
N'castle Jet,7184,2,16,5,7,59,37,22,53
Melbourne C,7184,3,14,4,11,43,35,8,46
Melbourne V,7184,4,13,5,11,45,40,5,44
Adelaide Utd,7184,5,11,6,11,37,40,-3,39
Brisbane,7184,6,10,5,13,33,42,-9,35
Western Sydn,7184,7,8,9,10,38,47,-9,33
Perth Glory,7184,8,10,2,15,37,50,-13,32
Wellington P,7184,9,5,6,16,31,55,-24,21
CC Mariners,7184,10,4,8,15,28,49,-21,20
Sydney FC,7185,1,20,4,4,64,23,41,64
N'castle Jet,7185,2,16,5,7,61,37,24,53
Melbourne V,7185,3,14,5,10,46,38,8,47
Melbourne C,7185,4,14,4,11,43,37,6,46
Adelaide Utd,7185,5,11,6,11,37,40,-3,39
Brisbane,7185,6,10,5,13,33,42,-9,35
Western Sydn,7185,7,8,9,10,38,47,-9,33
Perth Glory,7185,8,10,2,15,37,50,-13,32
Wellington P,7185,9,5,6,16,31,55,-24,21
CC Mariners,7185,10,4,8,15,28,49,-21,20
Sydney FC,7186,1,20,5,3,66,24,42,65
N'castle Jet,7186,2,16,5,7,60,38,22,53
Melbourne C,7186,3,14,4,11,44,36,8,46
Melbourne V,7186,4,13,6,10,47,40,7,45
Adelaide Utd,7186,5,11,6,11,37,40,-3,39
Brisbane,7186,6,10,5,13,33,42,-9,35
Western Sydn,7186,7,8,9,10,38,47,-9,33
Perth Glory,7186,8,10,2,15,37,50,-13,32
Wellington P,7186,9,5,6,16,31,55,-24,21
CC Mariners,7186,10,4,8,15,28,49,-21,20
Sydney FC,7187,1,21,4,3,65,22,43,67
N'castle Jet,7187,2,16,5,7,59,38,21,53
Melbourne C,7187,3,14,4,11,44,35,9,46
Melbourne V,7187,4,13,5,11,45,39,6,44
Adelaide Utd,7187,5,11,6,11,37,40,-3,39
Brisbane,7187,6,10,5,13,33,42,-9,35
Western Sydn,7187,7,8,9,10,38,47,-9,33
Perth Glory,7187,8,10,2,15,37,50,-13,32
Wellington P,7187,9,5,6,16,31,55,-24,21
CC Mariners,7187,10,4,8,15,28,49,-21,20
Sydney FC,7188,1,21,4,3,66,22,44,67
N'castle Jet,7188,2,16,5,7,60,38,22,53
Melbourne C,7188,3,14,4,11,44,36,8,46
Melbourne V,7188,4,13,5,11,45,40,5,44
Adelaide Utd,7188,5,11,6,11,37,40,-3,39
Brisbane,7188,6,10,5,13,33,42,-9,35
Western Sydn,7188,7,8,9,10,38,47,-9,33
Perth Glory,7188,8,10,2,15,37,50,-13,32
Wellington P,7188,9,5,6,16,31,55,-24,21
CC Mariners,7188,10,4,8,15,28,49,-21,20
Sydney FC,7189,1,20,5,3,64,22,42,65
N'castle Jet,7189,2,16,5,7,59,38,21,53
Melbourne C,7189,3,14,4,11,44,35,9,46
Melbourne V,7189,4,13,6,10,45,38,7,45
Adelaide Utd,7189,5,11,6,11,37,40,-3,39
Brisbane,7189,6,10,5,13,33,42,-9,35
Western Sydn,7189,7,8,9,10,38,47,-9,33
Perth Glory,7189,8,10,2,15,37,50,-13,32
Wellington P,7189,9,5,6,16,31,55,-24,21
CC Mariners,7189,10,4,8,15,28,49,-21,20
Sydney FC,7190,1,21,4,3,66,22,44,67
N'castle Jet,7190,2,15,5,8,59,40,19,50
Melbourne C,7190,3,15,4,10,46,35,11,49
Melbourne V,7190,4,13,5,11,45,40,5,44
Adelaide Utd,7190,5,11,6,11,37,40,-3,39
Brisbane,7190,6,10,5,13,33,42,-9,35
Western Sydn,7190,7,8,9,10,38,47,-9,33
Perth Glory,7190,8,10,2,15,37,50,-13,32
Wellington P,7190,9,5,6,16,31,55,-24,21
CC Mariners,7190,10,4,8,15,28,49,-21,20
Sydney FC,7191,1,21,4,3,66,23,43,67
N'castle Jet,7191,2,15,5,8,60,41,19,50
Melbourne C,7191,3,15,4,10,47,36,11,49
Melbourne V,7191,4,13,5,11,46,40,6,44
Adelaide Utd,7191,5,11,6,11,37,40,-3,39
Brisbane,7191,6,10,5,13,33,42,-9,35
Western Sydn,7191,7,8,9,10,38,47,-9,33
Perth Glory,7191,8,10,2,15,37,50,-13,32
Wellington P,7191,9,5,6,16,31,55,-24,21
CC Mariners,7191,10,4,8,15,28,49,-21,20
Sydney FC,7192,1,20,5,3,64,22,42,65
N'castle Jet,7192,2,15,5,8,58,39,19,50
Melbourne C,7192,3,15,4,10,45,34,11,49
Melbourne V,7192,4,13,6,10,45,38,7,45
Adelaide Utd,7192,5,11,6,11,37,40,-3,39
Brisbane,7192,6,10,5,13,33,42,-9,35
Western Sydn,7192,7,8,9,10,38,47,-9,33
Perth Glory,7192,8,10,2,15,37,50,-13,32
Wellington P,7192,9,5,6,16,31,55,-24,21
CC Mariners,7192,10,4,8,15,28,49,-21,20
Sydney FC,7193,1,21,4,3,69,23,46,67
N'castle Jet,7193,2,15,6,7,59,39,20,51
Melbourne C,7193,3,14,5,10,45,35,10,47
Melbourne V,7193,4,13,5,11,46,43,3,44
Adelaide Utd,7193,5,11,6,11,37,40,-3,39
Brisbane,7193,6,10,5,13,33,42,-9,35
Western Sydn,7193,7,8,9,10,38,47,-9,33
Perth Glory,7193,8,10,2,15,37,50,-13,32
Wellington P,7193,9,5,6,16,31,55,-24,21
CC Mariners,7193,10,4,8,15,28,49,-21,20
Sydney FC,7194,1,21,4,3,68,24,44,67
N'castle Jet,7194,2,15,5,8,57,38,19,50
Melbourne C,7194,3,15,4,10,44,33,11,49
Melbourne V,7194,4,13,5,11,47,42,5,44
Adelaide Utd,7194,5,11,6,11,37,40,-3,39
Brisbane,7194,6,10,5,13,33,42,-9,35
Western Sydn,7194,7,8,9,10,38,47,-9,33
Perth Glory,7194,8,10,2,15,37,50,-13,32
Wellington P,7194,9,5,6,16,31,55,-24,21
CC Mariners,7194,10,4,8,15,28,49,-21,20
Sydney FC,7195,1,21,4,3,69,23,46,67
N'castle Jet,7195,2,15,6,7,58,38,20,51
Melbourne C,7195,3,14,5,10,44,34,10,47
Melbourne V,7195,4,13,5,11,46,43,3,44
Adelaide Utd,7195,5,11,6,11,37,40,-3,39
Brisbane,7195,6,10,5,13,33,42,-9,35
Western Sydn,7195,7,8,9,10,38,47,-9,33
Perth Glory,7195,8,10,2,15,37,50,-13,32
Wellington P,7195,9,5,6,16,31,55,-24,21
CC Mariners,7195,10,4,8,15,28,49,-21,20
Sydney FC,7196,1,20,4,4,64,23,41,64
N'castle Jet,7196,2,15,5,8,57,39,18,50
Melbourne C,7196,3,15,4,10,45,33,12,49
Melbourne V,7196,4,14,5,10,46,38,8,47
Adelaide Utd,7196,5,11,6,11,37,40,-3,39
Brisbane,7196,6,10,5,13,33,42,-9,35
Western Sydn,7196,7,8,9,10,38,47,-9,33
Perth Glory,7196,8,10,2,15,37,50,-13,32
Wellington P,7196,9,5,6,16,31,55,-24,21
CC Mariners,7196,10,4,8,15,28,49,-21,20
Sydney FC,7197,1,20,4,4,65,24,41,64
N'castle Jet,7197,2,15,6,7,61,41,20,51
Melbourne C,7197,3,14,5,10,47,37,10,47
Melbourne V,7197,4,14,5,10,47,39,8,47
Adelaide Utd,7197,5,11,6,11,37,40,-3,39
Brisbane,7197,6,10,5,13,33,42,-9,35
Western Sydn,7197,7,8,9,10,38,47,-9,33
Perth Glory,7197,8,10,2,15,37,50,-13,32
Wellington P,7197,9,5,6,16,31,55,-24,21
CC Mariners,7197,10,4,8,15,28,49,-21,20
Sydney FC,7198,1,21,4,3,66,23,43,67
N'castle Jet,7198,2,16,5,7,59,38,21,53
Melbourne C,7198,3,14,4,11,44,35,9,46
Melbourne V,7198,4,13,5,11,46,40,6,44
Adelaide Utd,7198,5,11,6,11,37,40,-3,39
Brisbane,7198,6,10,5,13,33,42,-9,35
Western Sydn,7198,7,8,9,10,38,47,-9,33
Perth Glory,7198,8,10,2,15,37,50,-13,32
Wellington P,7198,9,5,6,16,31,55,-24,21
CC Mariners,7198,10,4,8,15,28,49,-21,20
Sydney FC,7199,1,21,4,3,67,24,43,67
N'castle Jet,7199,2,15,6,7,60,40,20,51
Melbourne C,7199,3,14,5,10,46,36,10,47
Melbourne V,7199,4,13,5,11,47,41,6,44
Adelaide Utd,7199,5,11,6,11,37,40,-3,39
Brisbane,7199,6,10,5,13,33,42,-9,35
Western Sydn,7199,7,8,9,10,38,47,-9,33
Perth Glory,7199,8,10,2,15,37,50,-13,32
Wellington P,7199,9,5,6,16,31,55,-24,21
CC Mariners,7199,10,4,8,15,28,49,-21,20
Sydney FC,7200,1,21,4,3,66,23,43,67
N'castle Jet,7200,2,16,5,7,62,38,24,53
Melbourne C,7200,3,14,4,11,44,38,6,46
Melbourne V,7200,4,13,5,11,46,40,6,44
Adelaide Utd,7200,5,11,6,11,37,40,-3,39
Brisbane,7200,6,10,5,13,33,42,-9,35
Western Sydn,7200,7,8,9,10,38,47,-9,33
Perth Glory,7200,8,10,2,15,37,50,-13,32
Wellington P,7200,9,5,6,16,31,55,-24,21
CC Mariners,7200,10,4,8,15,28,49,-21,20
Sydney FC,7201,1,20,5,3,65,23,42,65
N'castle Jet,7201,2,16,5,7,60,39,21,53
Melbourne C,7201,3,14,4,11,45,36,9,46
Melbourne V,7201,4,13,6,10,46,39,7,45
Adelaide Utd,7201,5,11,6,11,37,40,-3,39
Brisbane,7201,6,10,5,13,33,42,-9,35
Western Sydn,7201,7,8,9,10,38,47,-9,33
Perth Glory,7201,8,10,2,15,37,50,-13,32
Wellington P,7201,9,5,6,16,31,55,-24,21
CC Mariners,7201,10,4,8,15,28,49,-21,20
Sydney FC,7202,1,20,5,3,64,22,42,65
N'castle Jet,7202,2,16,5,7,59,37,22,53
Melbourne C,7202,3,14,4,11,43,35,8,46
Melbourne V,7202,4,13,6,10,45,38,7,45
Adelaide Utd,7202,5,11,6,11,37,40,-3,39
Brisbane,7202,6,10,5,13,33,42,-9,35
Western Sydn,7202,7,8,9,10,38,47,-9,33
Perth Glory,7202,8,10,2,15,37,50,-13,32
Wellington P,7202,9,5,6,16,31,55,-24,21
CC Mariners,7202,10,4,8,15,28,49,-21,20
Sydney FC,7203,1,20,5,3,64,22,42,65
N'castle Jet,7203,2,15,5,8,58,41,17,50
Melbourne C,7203,3,15,4,10,47,34,13,49
Melbourne V,7203,4,13,6,10,45,38,7,45
Adelaide Utd,7203,5,11,6,11,37,40,-3,39
Brisbane,7203,6,10,5,13,33,42,-9,35
Western Sydn,7203,7,8,9,10,38,47,-9,33
Perth Glory,7203,8,10,2,15,37,50,-13,32
Wellington P,7203,9,5,6,16,31,55,-24,21
CC Mariners,7203,10,4,8,15,28,49,-21,20
Sydney FC,7204,1,20,4,4,65,24,41,64
N'castle Jet,7204,2,15,6,7,59,39,20,51
Melbourne C,7204,3,14,5,10,45,35,10,47
Melbourne V,7204,4,14,5,10,47,39,8,47
Adelaide Utd,7204,5,11,6,11,37,40,-3,39
Brisbane,7204,6,10,5,13,33,42,-9,35
Western Sydn,7204,7,8,9,10,38,47,-9,33
Perth Glory,7204,8,10,2,15,37,50,-13,32
Wellington P,7204,9,5,6,16,31,55,-24,21
CC Mariners,7204,10,4,8,15,28,49,-21,20
Sydney FC,7205,1,21,4,3,68,23,45,67
N'castle Jet,7205,2,16,5,7,60,37,23,53
Melbourne C,7205,3,14,4,11,43,36,7,46
Melbourne V,7205,4,13,5,11,46,42,4,44
Adelaide Utd,7205,5,11,6,11,37,40,-3,39
Brisbane,7205,6,10,5,13,33,42,-9,35
Western Sydn,7205,7,8,9,10,38,47,-9,33
Perth Glory,7205,8,10,2,15,37,50,-13,32
Wellington P,7205,9,5,6,16,31,55,-24,21
CC Mariners,7205,10,4,8,15,28,49,-21,20
Sydney FC,7206,1,20,4,4,68,27,41,64
N'castle Jet,7206,2,16,5,7,58,37,21,53
Melbourne V,7206,3,14,5,10,50,42,8,47
Melbourne C,7206,4,14,4,11,43,34,9,46
Adelaide Utd,7206,5,11,6,11,37,40,-3,39
Brisbane,7206,6,10,5,13,33,42,-9,35
Western Sydn,7206,7,8,9,10,38,47,-9,33
Perth Glory,7206,8,10,2,15,37,50,-13,32
Wellington P,7206,9,5,6,16,31,55,-24,21
CC Mariners,7206,10,4,8,15,28,49,-21,20
Sydney FC,7207,1,21,4,3,68,23,45,67
N'castle Jet,7207,2,15,5,8,57,40,17,50
Melbourne C,7207,3,15,4,10,46,33,13,49
Melbourne V,7207,4,13,5,11,46,42,4,44
Adelaide Utd,7207,5,11,6,11,37,40,-3,39
Brisbane,7207,6,10,5,13,33,42,-9,35
Western Sydn,7207,7,8,9,10,38,47,-9,33
Perth Glory,7207,8,10,2,15,37,50,-13,32
Wellington P,7207,9,5,6,16,31,55,-24,21
CC Mariners,7207,10,4,8,15,28,49,-21,20
Sydney FC,7208,1,21,4,3,66,23,43,67
N'castle Jet,7208,2,15,5,8,58,39,19,50
Melbourne C,7208,3,15,4,10,45,34,11,49
Melbourne V,7208,4,13,5,11,46,40,6,44
Adelaide Utd,7208,5,11,6,11,37,40,-3,39
Brisbane,7208,6,10,5,13,33,42,-9,35
Western Sydn,7208,7,8,9,10,38,47,-9,33
Perth Glory,7208,8,10,2,15,37,50,-13,32
Wellington P,7208,9,5,6,16,31,55,-24,21
CC Mariners,7208,10,4,8,15,28,49,-21,20
Sydney FC,7209,1,20,4,4,65,24,41,64
N'castle Jet,7209,2,15,5,8,58,40,18,50
Melbourne C,7209,3,15,4,10,46,34,12,49
Melbourne V,7209,4,14,5,10,47,39,8,47
Adelaide Utd,7209,5,11,6,11,37,40,-3,39
Brisbane,7209,6,10,5,13,33,42,-9,35
Western Sydn,7209,7,8,9,10,38,47,-9,33
Perth Glory,7209,8,10,2,15,37,50,-13,32
Wellington P,7209,9,5,6,16,31,55,-24,21
CC Mariners,7209,10,4,8,15,28,49,-21,20
Sydney FC,7210,1,21,4,3,66,22,44,67
N'castle Jet,7210,2,15,5,8,59,40,19,50
Melbourne C,7210,3,15,4,10,46,35,11,49
Melbourne V,7210,4,13,5,11,45,40,5,44
Adelaide Utd,7210,5,11,6,11,37,40,-3,39
Brisbane,7210,6,10,5,13,33,42,-9,35
Western Sydn,7210,7,8,9,10,38,47,-9,33
Perth Glory,7210,8,10,2,15,37,50,-13,32
Wellington P,7210,9,5,6,16,31,55,-24,21
CC Mariners,7210,10,4,8,15,28,49,-21,20
Sydney FC,7211,1,21,4,3,67,22,45,67
N'castle Jet,7211,2,16,5,7,61,38,23,53
Melbourne C,7211,3,14,4,11,44,37,7,46
Melbourne V,7211,4,13,5,11,45,41,4,44
Adelaide Utd,7211,5,11,6,11,37,40,-3,39
Brisbane,7211,6,10,5,13,33,42,-9,35
Western Sydn,7211,7,8,9,10,38,47,-9,33
Perth Glory,7211,8,10,2,15,37,50,-13,32
Wellington P,7211,9,5,6,16,31,55,-24,21
CC Mariners,7211,10,4,8,15,28,49,-21,20
Sydney FC,7212,1,20,5,3,65,23,42,65
N'castle Jet,7212,2,16,5,7,58,37,21,53
Melbourne C,7212,3,14,4,11,43,34,9,46
Melbourne V,7212,4,13,6,10,46,39,7,45
Adelaide Utd,7212,5,11,6,11,37,40,-3,39
Brisbane,7212,6,10,5,13,33,42,-9,35
Western Sydn,7212,7,8,9,10,38,47,-9,33
Perth Glory,7212,8,10,2,15,37,50,-13,32
Wellington P,7212,9,5,6,16,31,55,-24,21
CC Mariners,7212,10,4,8,15,28,49,-21,20
Sydney FC,7213,1,21,4,3,67,24,43,67
N'castle Jet,7213,2,15,5,8,58,39,19,50
Melbourne C,7213,3,15,4,10,45,34,11,49
Melbourne V,7213,4,13,5,11,47,41,6,44
Adelaide Utd,7213,5,11,6,11,37,40,-3,39
Brisbane,7213,6,10,5,13,33,42,-9,35
Western Sydn,7213,7,8,9,10,38,47,-9,33
Perth Glory,7213,8,10,2,15,37,50,-13,32
Wellington P,7213,9,5,6,16,31,55,-24,21
CC Mariners,7213,10,4,8,15,28,49,-21,20
Sydney FC,7214,1,21,4,3,66,23,43,67
N'castle Jet,7214,2,16,5,7,59,38,21,53
Melbourne C,7214,3,14,4,11,44,35,9,46
Melbourne V,7214,4,13,5,11,46,40,6,44
Adelaide Utd,7214,5,11,6,11,37,40,-3,39
Brisbane,7214,6,10,5,13,33,42,-9,35
Western Sydn,7214,7,8,9,10,38,47,-9,33
Perth Glory,7214,8,10,2,15,37,50,-13,32
Wellington P,7214,9,5,6,16,31,55,-24,21
CC Mariners,7214,10,4,8,15,28,49,-21,20
Sydney FC,7215,1,21,4,3,66,23,43,67
N'castle Jet,7215,2,16,5,7,60,38,22,53
Melbourne C,7215,3,14,4,11,44,36,8,46
Melbourne V,7215,4,13,5,11,46,40,6,44
Adelaide Utd,7215,5,11,6,11,37,40,-3,39
Brisbane,7215,6,10,5,13,33,42,-9,35
Western Sydn,7215,7,8,9,10,38,47,-9,33
Perth Glory,7215,8,10,2,15,37,50,-13,32
Wellington P,7215,9,5,6,16,31,55,-24,21
CC Mariners,7215,10,4,8,15,28,49,-21,20
Sydney FC,7216,1,21,4,3,67,23,44,67
N'castle Jet,7216,2,16,5,7,61,39,22,53
Melbourne C,7216,3,14,4,11,45,37,8,46
Melbourne V,7216,4,13,5,11,46,41,5,44
Adelaide Utd,7216,5,11,6,11,37,40,-3,39
Brisbane,7216,6,10,5,13,33,42,-9,35
Western Sydn,7216,7,8,9,10,38,47,-9,33
Perth Glory,7216,8,10,2,15,37,50,-13,32
Wellington P,7216,9,5,6,16,31,55,-24,21
CC Mariners,7216,10,4,8,15,28,49,-21,20
Sydney FC,7217,1,20,4,4,65,24,41,64
N'castle Jet,7217,2,16,5,7,61,38,23,53
Melbourne V,7217,3,14,5,10,47,39,8,47
Melbourne C,7217,4,14,4,11,44,37,7,46
Adelaide Utd,7217,5,11,6,11,37,40,-3,39
Brisbane,7217,6,10,5,13,33,42,-9,35
Western Sydn,7217,7,8,9,10,38,47,-9,33
Perth Glory,7217,8,10,2,15,37,50,-13,32
Wellington P,7217,9,5,6,16,31,55,-24,21
CC Mariners,7217,10,4,8,15,28,49,-21,20
Sydney FC,7218,1,21,4,3,68,23,45,67
N'castle Jet,7218,2,16,5,7,62,39,23,53
Melbourne C,7218,3,14,4,11,45,38,7,46
Melbourne V,7218,4,13,5,11,46,42,4,44
Adelaide Utd,7218,5,11,6,11,37,40,-3,39
Brisbane,7218,6,10,5,13,33,42,-9,35
Western Sydn,7218,7,8,9,10,38,47,-9,33
Perth Glory,7218,8,10,2,15,37,50,-13,32
Wellington P,7218,9,5,6,16,31,55,-24,21
CC Mariners,7218,10,4,8,15,28,49,-21,20
Sydney FC,7219,1,21,4,3,65,22,43,67
N'castle Jet,7219,2,15,5,8,58,41,17,50
Melbourne C,7219,3,15,4,10,47,34,13,49
Melbourne V,7219,4,13,5,11,45,39,6,44
Adelaide Utd,7219,5,11,6,11,37,40,-3,39
Brisbane,7219,6,10,5,13,33,42,-9,35
Western Sydn,7219,7,8,9,10,38,47,-9,33
Perth Glory,7219,8,10,2,15,37,50,-13,32
Wellington P,7219,9,5,6,16,31,55,-24,21
CC Mariners,7219,10,4,8,15,28,49,-21,20
Sydney FC,7220,1,21,4,3,67,22,45,67
N'castle Jet,7220,2,16,5,7,60,39,21,53
Melbourne C,7220,3,14,4,11,45,36,9,46
Melbourne V,7220,4,13,5,11,45,41,4,44
Adelaide Utd,7220,5,11,6,11,37,40,-3,39
Brisbane,7220,6,10,5,13,33,42,-9,35
Western Sydn,7220,7,8,9,10,38,47,-9,33
Perth Glory,7220,8,10,2,15,37,50,-13,32
Wellington P,7220,9,5,6,16,31,55,-24,21
CC Mariners,7220,10,4,8,15,28,49,-21,20
Sydney FC,7221,1,21,4,3,66,22,44,67
N'castle Jet,7221,2,16,5,7,61,38,23,53
Melbourne C,7221,3,14,4,11,44,37,7,46
Melbourne V,7221,4,13,5,11,45,40,5,44
Adelaide Utd,7221,5,11,6,11,37,40,-3,39
Brisbane,7221,6,10,5,13,33,42,-9,35
Western Sydn,7221,7,8,9,10,38,47,-9,33
Perth Glory,7221,8,10,2,15,37,50,-13,32
Wellington P,7221,9,5,6,16,31,55,-24,21
CC Mariners,7221,10,4,8,15,28,49,-21,20
Sydney FC,7222,1,20,5,3,67,25,42,65
N'castle Jet,7222,2,15,5,8,57,40,17,50
Melbourne C,7222,3,15,4,10,46,33,13,49
Melbourne V,7222,4,13,6,10,48,41,7,45
Adelaide Utd,7222,5,11,6,11,37,40,-3,39
Brisbane,7222,6,10,5,13,33,42,-9,35
Western Sydn,7222,7,8,9,10,38,47,-9,33
Perth Glory,7222,8,10,2,15,37,50,-13,32
Wellington P,7222,9,5,6,16,31,55,-24,21
CC Mariners,7222,10,4,8,15,28,49,-21,20
Sydney FC,7223,1,20,4,4,65,25,40,64
N'castle Jet,7223,2,16,5,7,62,38,24,53
Melbourne V,7223,3,14,5,10,48,39,9,47
Melbourne C,7223,4,14,4,11,44,38,6,46
Adelaide Utd,7223,5,11,6,11,37,40,-3,39
Brisbane,7223,6,10,5,13,33,42,-9,35
Western Sydn,7223,7,8,9,10,38,47,-9,33
Perth Glory,7223,8,10,2,15,37,50,-13,32
Wellington P,7223,9,5,6,16,31,55,-24,21
CC Mariners,7223,10,4,8,15,28,49,-21,20
Sydney FC,7224,1,21,4,3,69,23,46,67
N'castle Jet,7224,2,16,5,7,58,37,21,53
Melbourne C,7224,3,14,4,11,43,34,9,46
Melbourne V,7224,4,13,5,11,46,43,3,44
Adelaide Utd,7224,5,11,6,11,37,40,-3,39
Brisbane,7224,6,10,5,13,33,42,-9,35
Western Sydn,7224,7,8,9,10,38,47,-9,33
Perth Glory,7224,8,10,2,15,37,50,-13,32
Wellington P,7224,9,5,6,16,31,55,-24,21
CC Mariners,7224,10,4,8,15,28,49,-21,20
Sydney FC,7225,1,20,4,4,65,24,41,64
N'castle Jet,7225,2,15,6,7,57,37,20,51
Melbourne C,7225,3,14,5,10,43,33,10,47
Melbourne V,7225,4,14,5,10,47,39,8,47
Adelaide Utd,7225,5,11,6,11,37,40,-3,39
Brisbane,7225,6,10,5,13,33,42,-9,35
Western Sydn,7225,7,8,9,10,38,47,-9,33
Perth Glory,7225,8,10,2,15,37,50,-13,32
Wellington P,7225,9,5,6,16,31,55,-24,21
CC Mariners,7225,10,4,8,15,28,49,-21,20
Sydney FC,7226,1,21,4,3,65,22,43,67
N'castle Jet,7226,2,16,5,7,60,38,22,53
Melbourne C,7226,3,14,4,11,44,36,8,46
Melbourne V,7226,4,13,5,11,45,39,6,44
Adelaide Utd,7226,5,11,6,11,37,40,-3,39
Brisbane,7226,6,10,5,13,33,42,-9,35
Western Sydn,7226,7,8,9,10,38,47,-9,33
Perth Glory,7226,8,10,2,15,37,50,-13,32
Wellington P,7226,9,5,6,16,31,55,-24,21
CC Mariners,7226,10,4,8,15,28,49,-21,20
Sydney FC,7227,1,20,5,3,64,22,42,65
N'castle Jet,7227,2,16,5,7,58,37,21,53
Melbourne C,7227,3,14,4,11,43,34,9,46
Melbourne V,7227,4,13,6,10,45,38,7,45
Adelaide Utd,7227,5,11,6,11,37,40,-3,39
Brisbane,7227,6,10,5,13,33,42,-9,35
Western Sydn,7227,7,8,9,10,38,47,-9,33
Perth Glory,7227,8,10,2,15,37,50,-13,32
Wellington P,7227,9,5,6,16,31,55,-24,21
CC Mariners,7227,10,4,8,15,28,49,-21,20
Sydney FC,7228,1,21,4,3,65,22,43,67
N'castle Jet,7228,2,16,5,7,59,37,22,53
Melbourne C,7228,3,14,4,11,43,35,8,46
Melbourne V,7228,4,13,5,11,45,39,6,44
Adelaide Utd,7228,5,11,6,11,37,40,-3,39
Brisbane,7228,6,10,5,13,33,42,-9,35
Western Sydn,7228,7,8,9,10,38,47,-9,33
Perth Glory,7228,8,10,2,15,37,50,-13,32
Wellington P,7228,9,5,6,16,31,55,-24,21
CC Mariners,7228,10,4,8,15,28,49,-21,20
Sydney FC,7229,1,20,4,4,65,25,40,64
N'castle Jet,7229,2,16,5,7,60,37,23,53
Melbourne V,7229,3,14,5,10,48,39,9,47
Melbourne C,7229,4,14,4,11,43,36,7,46
Adelaide Utd,7229,5,11,6,11,37,40,-3,39
Brisbane,7229,6,10,5,13,33,42,-9,35
Western Sydn,7229,7,8,9,10,38,47,-9,33
Perth Glory,7229,8,10,2,15,37,50,-13,32
Wellington P,7229,9,5,6,16,31,55,-24,21
CC Mariners,7229,10,4,8,15,28,49,-21,20
Sydney FC,7230,1,20,4,4,65,25,40,64
N'castle Jet,7230,2,16,5,7,59,37,22,53
Melbourne V,7230,3,14,5,10,48,39,9,47
Melbourne C,7230,4,14,4,11,43,35,8,46
Adelaide Utd,7230,5,11,6,11,37,40,-3,39
Brisbane,7230,6,10,5,13,33,42,-9,35
Western Sydn,7230,7,8,9,10,38,47,-9,33
Perth Glory,7230,8,10,2,15,37,50,-13,32
Wellington P,7230,9,5,6,16,31,55,-24,21
CC Mariners,7230,10,4,8,15,28,49,-21,20
Sydney FC,7231,1,21,4,3,65,22,43,67
N'castle Jet,7231,2,15,5,8,59,40,19,50
Melbourne C,7231,3,15,4,10,46,35,11,49
Melbourne V,7231,4,13,5,11,45,39,6,44
Adelaide Utd,7231,5,11,6,11,37,40,-3,39
Brisbane,7231,6,10,5,13,33,42,-9,35
Western Sydn,7231,7,8,9,10,38,47,-9,33
Perth Glory,7231,8,10,2,15,37,50,-13,32
Wellington P,7231,9,5,6,16,31,55,-24,21
CC Mariners,7231,10,4,8,15,28,49,-21,20
Sydney FC,7232,1,21,4,3,67,23,44,67
N'castle Jet,7232,2,15,6,7,58,38,20,51
Melbourne C,7232,3,14,5,10,44,34,10,47
Melbourne V,7232,4,13,5,11,46,41,5,44
Adelaide Utd,7232,5,11,6,11,37,40,-3,39
Brisbane,7232,6,10,5,13,33,42,-9,35
Western Sydn,7232,7,8,9,10,38,47,-9,33
Perth Glory,7232,8,10,2,15,37,50,-13,32
Wellington P,7232,9,5,6,16,31,55,-24,21
CC Mariners,7232,10,4,8,15,28,49,-21,20
Sydney FC,7233,1,21,4,3,66,22,44,67
N'castle Jet,7233,2,15,5,8,58,39,19,50
Melbourne C,7233,3,15,4,10,45,34,11,49
Melbourne V,7233,4,13,5,11,45,40,5,44
Adelaide Utd,7233,5,11,6,11,37,40,-3,39
Brisbane,7233,6,10,5,13,33,42,-9,35
Western Sydn,7233,7,8,9,10,38,47,-9,33
Perth Glory,7233,8,10,2,15,37,50,-13,32
Wellington P,7233,9,5,6,16,31,55,-24,21
CC Mariners,7233,10,4,8,15,28,49,-21,20
Sydney FC,7234,1,20,5,3,64,22,42,65
N'castle Jet,7234,2,15,5,8,60,42,18,50
Melbourne C,7234,3,15,4,10,48,36,12,49
Melbourne V,7234,4,13,6,10,45,38,7,45
Adelaide Utd,7234,5,11,6,11,37,40,-3,39
Brisbane,7234,6,10,5,13,33,42,-9,35
Western Sydn,7234,7,8,9,10,38,47,-9,33
Perth Glory,7234,8,10,2,15,37,50,-13,32
Wellington P,7234,9,5,6,16,31,55,-24,21
CC Mariners,7234,10,4,8,15,28,49,-21,20
Sydney FC,7235,1,20,4,4,66,25,41,64
N'castle Jet,7235,2,15,6,7,59,39,20,51
Melbourne C,7235,3,14,5,10,45,35,10,47
Melbourne V,7235,4,14,5,10,48,40,8,47
Adelaide Utd,7235,5,11,6,11,37,40,-3,39
Brisbane,7235,6,10,5,13,33,42,-9,35
Western Sydn,7235,7,8,9,10,38,47,-9,33
Perth Glory,7235,8,10,2,15,37,50,-13,32
Wellington P,7235,9,5,6,16,31,55,-24,21
CC Mariners,7235,10,4,8,15,28,49,-21,20
Sydney FC,7236,1,20,5,3,66,24,42,65
N'castle Jet,7236,2,16,5,7,58,37,21,53
Melbourne C,7236,3,14,4,11,43,34,9,46
Melbourne V,7236,4,13,6,10,47,40,7,45
Adelaide Utd,7236,5,11,6,11,37,40,-3,39
Brisbane,7236,6,10,5,13,33,42,-9,35
Western Sydn,7236,7,8,9,10,38,47,-9,33
Perth Glory,7236,8,10,2,15,37,50,-13,32
Wellington P,7236,9,5,6,16,31,55,-24,21
CC Mariners,7236,10,4,8,15,28,49,-21,20
Sydney FC,7237,1,21,4,3,67,22,45,67
N'castle Jet,7237,2,15,6,7,59,39,20,51
Melbourne C,7237,3,14,5,10,45,35,10,47
Melbourne V,7237,4,13,5,11,45,41,4,44
Adelaide Utd,7237,5,11,6,11,37,40,-3,39
Brisbane,7237,6,10,5,13,33,42,-9,35
Western Sydn,7237,7,8,9,10,38,47,-9,33
Perth Glory,7237,8,10,2,15,37,50,-13,32
Wellington P,7237,9,5,6,16,31,55,-24,21
CC Mariners,7237,10,4,8,15,28,49,-21,20
Sydney FC,7238,1,21,4,3,66,22,44,67
N'castle Jet,7238,2,16,5,7,61,37,24,53
Melbourne C,7238,3,14,4,11,43,37,6,46
Melbourne V,7238,4,13,5,11,45,40,5,44
Adelaide Utd,7238,5,11,6,11,37,40,-3,39
Brisbane,7238,6,10,5,13,33,42,-9,35
Western Sydn,7238,7,8,9,10,38,47,-9,33
Perth Glory,7238,8,10,2,15,37,50,-13,32
Wellington P,7238,9,5,6,16,31,55,-24,21
CC Mariners,7238,10,4,8,15,28,49,-21,20
Sydney FC,7239,1,21,4,3,68,23,45,67
N'castle Jet,7239,2,15,5,8,58,39,19,50
Melbourne C,7239,3,15,4,10,45,34,11,49
Melbourne V,7239,4,13,5,11,46,42,4,44
Adelaide Utd,7239,5,11,6,11,37,40,-3,39
Brisbane,7239,6,10,5,13,33,42,-9,35
Western Sydn,7239,7,8,9,10,38,47,-9,33
Perth Glory,7239,8,10,2,15,37,50,-13,32
Wellington P,7239,9,5,6,16,31,55,-24,21
CC Mariners,7239,10,4,8,15,28,49,-21,20
Sydney FC,7240,1,21,4,3,68,24,44,67
N'castle Jet,7240,2,15,5,8,57,38,19,50
Melbourne C,7240,3,15,4,10,44,33,11,49
Melbourne V,7240,4,13,5,11,47,42,5,44
Adelaide Utd,7240,5,11,6,11,37,40,-3,39
Brisbane,7240,6,10,5,13,33,42,-9,35
Western Sydn,7240,7,8,9,10,38,47,-9,33
Perth Glory,7240,8,10,2,15,37,50,-13,32
Wellington P,7240,9,5,6,16,31,55,-24,21
CC Mariners,7240,10,4,8,15,28,49,-21,20
Sydney FC,7241,1,21,4,3,66,22,44,67
N'castle Jet,7241,2,16,5,7,59,38,21,53
Melbourne C,7241,3,14,4,11,44,35,9,46
Melbourne V,7241,4,13,5,11,45,40,5,44
Adelaide Utd,7241,5,11,6,11,37,40,-3,39
Brisbane,7241,6,10,5,13,33,42,-9,35
Western Sydn,7241,7,8,9,10,38,47,-9,33
Perth Glory,7241,8,10,2,15,37,50,-13,32
Wellington P,7241,9,5,6,16,31,55,-24,21
CC Mariners,7241,10,4,8,15,28,49,-21,20
Sydney FC,7242,1,21,4,3,66,22,44,67
N'castle Jet,7242,2,15,6,7,58,38,20,51
Melbourne C,7242,3,14,5,10,44,34,10,47
Melbourne V,7242,4,13,5,11,45,40,5,44
Adelaide Utd,7242,5,11,6,11,37,40,-3,39
Brisbane,7242,6,10,5,13,33,42,-9,35
Western Sydn,7242,7,8,9,10,38,47,-9,33
Perth Glory,7242,8,10,2,15,37,50,-13,32
Wellington P,7242,9,5,6,16,31,55,-24,21
CC Mariners,7242,10,4,8,15,28,49,-21,20
Sydney FC,7243,1,20,4,4,64,25,39,64
N'castle Jet,7243,2,15,5,8,58,39,19,50
Melbourne C,7243,3,15,4,10,45,34,11,49
Melbourne V,7243,4,14,5,10,48,38,10,47
Adelaide Utd,7243,5,11,6,11,37,40,-3,39
Brisbane,7243,6,10,5,13,33,42,-9,35
Western Sydn,7243,7,8,9,10,38,47,-9,33
Perth Glory,7243,8,10,2,15,37,50,-13,32
Wellington P,7243,9,5,6,16,31,55,-24,21
CC Mariners,7243,10,4,8,15,28,49,-21,20
Sydney FC,7244,1,20,5,3,65,23,42,65
N'castle Jet,7244,2,15,5,8,58,40,18,50
Melbourne C,7244,3,15,4,10,46,34,12,49
Melbourne V,7244,4,13,6,10,46,39,7,45
Adelaide Utd,7244,5,11,6,11,37,40,-3,39
Brisbane,7244,6,10,5,13,33,42,-9,35
Western Sydn,7244,7,8,9,10,38,47,-9,33
Perth Glory,7244,8,10,2,15,37,50,-13,32
Wellington P,7244,9,5,6,16,31,55,-24,21
CC Mariners,7244,10,4,8,15,28,49,-21,20
Sydney FC,7245,1,21,4,3,70,23,47,67
N'castle Jet,7245,2,16,5,7,60,38,22,53
Melbourne C,7245,3,14,4,11,44,36,8,46
Melbourne V,7245,4,13,5,11,46,44,2,44
Adelaide Utd,7245,5,11,6,11,37,40,-3,39
Brisbane,7245,6,10,5,13,33,42,-9,35
Western Sydn,7245,7,8,9,10,38,47,-9,33
Perth Glory,7245,8,10,2,15,37,50,-13,32
Wellington P,7245,9,5,6,16,31,55,-24,21
CC Mariners,7245,10,4,8,15,28,49,-21,20
Sydney FC,7246,1,20,5,3,64,22,42,65
N'castle Jet,7246,2,16,5,7,59,38,21,53
Melbourne C,7246,3,14,4,11,44,35,9,46
Melbourne V,7246,4,13,6,10,45,38,7,45
Adelaide Utd,7246,5,11,6,11,37,40,-3,39
Brisbane,7246,6,10,5,13,33,42,-9,35
Western Sydn,7246,7,8,9,10,38,47,-9,33
Perth Glory,7246,8,10,2,15,37,50,-13,32
Wellington P,7246,9,5,6,16,31,55,-24,21
CC Mariners,7246,10,4,8,15,28,49,-21,20
Sydney FC,7247,1,20,5,3,66,24,42,65
N'castle Jet,7247,2,15,5,8,58,40,18,50
Melbourne C,7247,3,15,4,10,46,34,12,49
Melbourne V,7247,4,13,6,10,47,40,7,45
Adelaide Utd,7247,5,11,6,11,37,40,-3,39
Brisbane,7247,6,10,5,13,33,42,-9,35
Western Sydn,7247,7,8,9,10,38,47,-9,33
Perth Glory,7247,8,10,2,15,37,50,-13,32
Wellington P,7247,9,5,6,16,31,55,-24,21
CC Mariners,7247,10,4,8,15,28,49,-21,20
Sydney FC,7248,1,20,5,3,66,24,42,65
N'castle Jet,7248,2,16,5,7,60,38,22,53
Melbourne C,7248,3,14,4,11,44,36,8,46
Melbourne V,7248,4,13,6,10,47,40,7,45
Adelaide Utd,7248,5,11,6,11,37,40,-3,39
Brisbane,7248,6,10,5,13,33,42,-9,35
Western Sydn,7248,7,8,9,10,38,47,-9,33
Perth Glory,7248,8,10,2,15,37,50,-13,32
Wellington P,7248,9,5,6,16,31,55,-24,21
CC Mariners,7248,10,4,8,15,28,49,-21,20
Sydney FC,7249,1,21,4,3,66,23,43,67
N'castle Jet,7249,2,15,5,8,59,40,19,50
Melbourne C,7249,3,15,4,10,46,35,11,49
Melbourne V,7249,4,13,5,11,46,40,6,44
Adelaide Utd,7249,5,11,6,11,37,40,-3,39
Brisbane,7249,6,10,5,13,33,42,-9,35
Western Sydn,7249,7,8,9,10,38,47,-9,33
Perth Glory,7249,8,10,2,15,37,50,-13,32
Wellington P,7249,9,5,6,16,31,55,-24,21
CC Mariners,7249,10,4,8,15,28,49,-21,20
Sydney FC,7250,1,20,5,3,64,22,42,65
N'castle Jet,7250,2,15,6,7,58,38,20,51
Melbourne C,7250,3,14,5,10,44,34,10,47
Melbourne V,7250,4,13,6,10,45,38,7,45
Adelaide Utd,7250,5,11,6,11,37,40,-3,39
Brisbane,7250,6,10,5,13,33,42,-9,35
Western Sydn,7250,7,8,9,10,38,47,-9,33
Perth Glory,7250,8,10,2,15,37,50,-13,32
Wellington P,7250,9,5,6,16,31,55,-24,21
CC Mariners,7250,10,4,8,15,28,49,-21,20
Sydney FC,7251,1,21,4,3,67,22,45,67
N'castle Jet,7251,2,16,5,7,62,37,25,53
Melbourne C,7251,3,14,4,11,43,38,5,46
Melbourne V,7251,4,13,5,11,45,41,4,44
Adelaide Utd,7251,5,11,6,11,37,40,-3,39
Brisbane,7251,6,10,5,13,33,42,-9,35
Western Sydn,7251,7,8,9,10,38,47,-9,33
Perth Glory,7251,8,10,2,15,37,50,-13,32
Wellington P,7251,9,5,6,16,31,55,-24,21
CC Mariners,7251,10,4,8,15,28,49,-21,20
Sydney FC,7252,1,21,4,3,67,24,43,67
N'castle Jet,7252,2,16,5,7,59,38,21,53
Melbourne C,7252,3,14,4,11,44,35,9,46
Melbourne V,7252,4,13,5,11,47,41,6,44
Adelaide Utd,7252,5,11,6,11,37,40,-3,39
Brisbane,7252,6,10,5,13,33,42,-9,35
Western Sydn,7252,7,8,9,10,38,47,-9,33
Perth Glory,7252,8,10,2,15,37,50,-13,32
Wellington P,7252,9,5,6,16,31,55,-24,21
CC Mariners,7252,10,4,8,15,28,49,-21,20
Sydney FC,7253,1,20,5,3,65,23,42,65
N'castle Jet,7253,2,16,5,7,59,38,21,53
Melbourne C,7253,3,14,4,11,44,35,9,46
Melbourne V,7253,4,13,6,10,46,39,7,45
Adelaide Utd,7253,5,11,6,11,37,40,-3,39
Brisbane,7253,6,10,5,13,33,42,-9,35
Western Sydn,7253,7,8,9,10,38,47,-9,33
Perth Glory,7253,8,10,2,15,37,50,-13,32
Wellington P,7253,9,5,6,16,31,55,-24,21
CC Mariners,7253,10,4,8,15,28,49,-21,20
Sydney FC,7254,1,21,4,3,69,22,47,67
N'castle Jet,7254,2,15,6,7,58,38,20,51
Melbourne C,7254,3,14,5,10,44,34,10,47
Melbourne V,7254,4,13,5,11,45,43,2,44
Adelaide Utd,7254,5,11,6,11,37,40,-3,39
Brisbane,7254,6,10,5,13,33,42,-9,35
Western Sydn,7254,7,8,9,10,38,47,-9,33
Perth Glory,7254,8,10,2,15,37,50,-13,32
Wellington P,7254,9,5,6,16,31,55,-24,21
CC Mariners,7254,10,4,8,15,28,49,-21,20
Sydney FC,7255,1,21,4,3,66,23,43,67
N'castle Jet,7255,2,16,5,7,60,37,23,53
Melbourne C,7255,3,14,4,11,43,36,7,46
Melbourne V,7255,4,13,5,11,46,40,6,44
Adelaide Utd,7255,5,11,6,11,37,40,-3,39
Brisbane,7255,6,10,5,13,33,42,-9,35
Western Sydn,7255,7,8,9,10,38,47,-9,33
Perth Glory,7255,8,10,2,15,37,50,-13,32
Wellington P,7255,9,5,6,16,31,55,-24,21
CC Mariners,7255,10,4,8,15,28,49,-21,20
Sydney FC,7256,1,21,4,3,66,23,43,67
N'castle Jet,7256,2,15,5,8,58,40,18,50
Melbourne C,7256,3,15,4,10,46,34,12,49
Melbourne V,7256,4,13,5,11,46,40,6,44
Adelaide Utd,7256,5,11,6,11,37,40,-3,39
Brisbane,7256,6,10,5,13,33,42,-9,35
Western Sydn,7256,7,8,9,10,38,47,-9,33
Perth Glory,7256,8,10,2,15,37,50,-13,32
Wellington P,7256,9,5,6,16,31,55,-24,21
CC Mariners,7256,10,4,8,15,28,49,-21,20
Sydney FC,7257,1,21,4,3,66,23,43,67
N'castle Jet,7257,2,15,5,8,58,39,19,50
Melbourne C,7257,3,15,4,10,45,34,11,49
Melbourne V,7257,4,13,5,11,46,40,6,44
Adelaide Utd,7257,5,11,6,11,37,40,-3,39
Brisbane,7257,6,10,5,13,33,42,-9,35
Western Sydn,7257,7,8,9,10,38,47,-9,33
Perth Glory,7257,8,10,2,15,37,50,-13,32
Wellington P,7257,9,5,6,16,31,55,-24,21
CC Mariners,7257,10,4,8,15,28,49,-21,20
Sydney FC,7258,1,21,4,3,65,22,43,67
N'castle Jet,7258,2,15,5,8,58,39,19,50
Melbourne C,7258,3,15,4,10,45,34,11,49
Melbourne V,7258,4,13,5,11,45,39,6,44
Adelaide Utd,7258,5,11,6,11,37,40,-3,39
Brisbane,7258,6,10,5,13,33,42,-9,35
Western Sydn,7258,7,8,9,10,38,47,-9,33
Perth Glory,7258,8,10,2,15,37,50,-13,32
Wellington P,7258,9,5,6,16,31,55,-24,21
CC Mariners,7258,10,4,8,15,28,49,-21,20
Sydney FC,7259,1,21,4,3,67,23,44,67
N'castle Jet,7259,2,16,5,7,59,37,22,53
Melbourne C,7259,3,14,4,11,43,35,8,46
Melbourne V,7259,4,13,5,11,46,41,5,44
Adelaide Utd,7259,5,11,6,11,37,40,-3,39
Brisbane,7259,6,10,5,13,33,42,-9,35
Western Sydn,7259,7,8,9,10,38,47,-9,33
Perth Glory,7259,8,10,2,15,37,50,-13,32
Wellington P,7259,9,5,6,16,31,55,-24,21
CC Mariners,7259,10,4,8,15,28,49,-21,20
Sydney FC,7260,1,21,4,3,68,22,46,67
N'castle Jet,7260,2,15,5,8,58,39,19,50
Melbourne C,7260,3,15,4,10,45,34,11,49
Melbourne V,7260,4,13,5,11,45,42,3,44
Adelaide Utd,7260,5,11,6,11,37,40,-3,39
Brisbane,7260,6,10,5,13,33,42,-9,35
Western Sydn,7260,7,8,9,10,38,47,-9,33
Perth Glory,7260,8,10,2,15,37,50,-13,32
Wellington P,7260,9,5,6,16,31,55,-24,21
CC Mariners,7260,10,4,8,15,28,49,-21,20
Sydney FC,7261,1,20,5,3,65,23,42,65
N'castle Jet,7261,2,15,5,8,57,39,18,50
Melbourne C,7261,3,15,4,10,45,33,12,49
Melbourne V,7261,4,13,6,10,46,39,7,45
Adelaide Utd,7261,5,11,6,11,37,40,-3,39
Brisbane,7261,6,10,5,13,33,42,-9,35
Western Sydn,7261,7,8,9,10,38,47,-9,33
Perth Glory,7261,8,10,2,15,37,50,-13,32
Wellington P,7261,9,5,6,16,31,55,-24,21
CC Mariners,7261,10,4,8,15,28,49,-21,20
Sydney FC,7262,1,20,5,3,65,23,42,65
N'castle Jet,7262,2,15,6,7,58,38,20,51
Melbourne C,7262,3,14,5,10,44,34,10,47
Melbourne V,7262,4,13,6,10,46,39,7,45
Adelaide Utd,7262,5,11,6,11,37,40,-3,39
Brisbane,7262,6,10,5,13,33,42,-9,35
Western Sydn,7262,7,8,9,10,38,47,-9,33
Perth Glory,7262,8,10,2,15,37,50,-13,32
Wellington P,7262,9,5,6,16,31,55,-24,21
CC Mariners,7262,10,4,8,15,28,49,-21,20
Sydney FC,7263,1,21,4,3,67,24,43,67
N'castle Jet,7263,2,15,6,7,58,38,20,51
Melbourne C,7263,3,14,5,10,44,34,10,47
Melbourne V,7263,4,13,5,11,47,41,6,44
Adelaide Utd,7263,5,11,6,11,37,40,-3,39
Brisbane,7263,6,10,5,13,33,42,-9,35
Western Sydn,7263,7,8,9,10,38,47,-9,33
Perth Glory,7263,8,10,2,15,37,50,-13,32
Wellington P,7263,9,5,6,16,31,55,-24,21
CC Mariners,7263,10,4,8,15,28,49,-21,20
Sydney FC,7264,1,21,4,3,68,22,46,67
N'castle Jet,7264,2,16,5,7,60,38,22,53
Melbourne C,7264,3,14,4,11,44,36,8,46
Melbourne V,7264,4,13,5,11,45,42,3,44
Adelaide Utd,7264,5,11,6,11,37,40,-3,39
Brisbane,7264,6,10,5,13,33,42,-9,35
Western Sydn,7264,7,8,9,10,38,47,-9,33
Perth Glory,7264,8,10,2,15,37,50,-13,32
Wellington P,7264,9,5,6,16,31,55,-24,21
CC Mariners,7264,10,4,8,15,28,49,-21,20
Sydney FC,7265,1,21,4,3,67,24,43,67
N'castle Jet,7265,2,16,5,7,59,38,21,53
Melbourne C,7265,3,14,4,11,44,35,9,46
Melbourne V,7265,4,13,5,11,47,41,6,44
Adelaide Utd,7265,5,11,6,11,37,40,-3,39
Brisbane,7265,6,10,5,13,33,42,-9,35
Western Sydn,7265,7,8,9,10,38,47,-9,33
Perth Glory,7265,8,10,2,15,37,50,-13,32
Wellington P,7265,9,5,6,16,31,55,-24,21
CC Mariners,7265,10,4,8,15,28,49,-21,20
Sydney FC,7266,1,20,4,4,64,23,41,64
N'castle Jet,7266,2,15,6,7,58,38,20,51
Melbourne C,7266,3,14,5,10,44,34,10,47
Melbourne V,7266,4,14,5,10,46,38,8,47
Adelaide Utd,7266,5,11,6,11,37,40,-3,39
Brisbane,7266,6,10,5,13,33,42,-9,35
Western Sydn,7266,7,8,9,10,38,47,-9,33
Perth Glory,7266,8,10,2,15,37,50,-13,32
Wellington P,7266,9,5,6,16,31,55,-24,21
CC Mariners,7266,10,4,8,15,28,49,-21,20
Sydney FC,7267,1,21,4,3,67,23,44,67
N'castle Jet,7267,2,15,5,8,57,41,16,50
Melbourne C,7267,3,15,4,10,47,33,14,49
Melbourne V,7267,4,13,5,11,46,41,5,44
Adelaide Utd,7267,5,11,6,11,37,40,-3,39
Brisbane,7267,6,10,5,13,33,42,-9,35
Western Sydn,7267,7,8,9,10,38,47,-9,33
Perth Glory,7267,8,10,2,15,37,50,-13,32
Wellington P,7267,9,5,6,16,31,55,-24,21
CC Mariners,7267,10,4,8,15,28,49,-21,20
Sydney FC,7268,1,20,5,3,65,23,42,65
N'castle Jet,7268,2,16,5,7,59,37,22,53
Melbourne C,7268,3,14,4,11,43,35,8,46
Melbourne V,7268,4,13,6,10,46,39,7,45
Adelaide Utd,7268,5,11,6,11,37,40,-3,39
Brisbane,7268,6,10,5,13,33,42,-9,35
Western Sydn,7268,7,8,9,10,38,47,-9,33
Perth Glory,7268,8,10,2,15,37,50,-13,32
Wellington P,7268,9,5,6,16,31,55,-24,21
CC Mariners,7268,10,4,8,15,28,49,-21,20
Sydney FC,7269,1,21,4,3,66,23,43,67
N'castle Jet,7269,2,15,5,8,57,38,19,50
Melbourne C,7269,3,15,4,10,44,33,11,49
Melbourne V,7269,4,13,5,11,46,40,6,44
Adelaide Utd,7269,5,11,6,11,37,40,-3,39
Brisbane,7269,6,10,5,13,33,42,-9,35
Western Sydn,7269,7,8,9,10,38,47,-9,33
Perth Glory,7269,8,10,2,15,37,50,-13,32
Wellington P,7269,9,5,6,16,31,55,-24,21
CC Mariners,7269,10,4,8,15,28,49,-21,20
Sydney FC,7270,1,21,4,3,67,23,44,67
N'castle Jet,7270,2,15,6,7,57,37,20,51
Melbourne C,7270,3,14,5,10,43,33,10,47
Melbourne V,7270,4,13,5,11,46,41,5,44
Adelaide Utd,7270,5,11,6,11,37,40,-3,39
Brisbane,7270,6,10,5,13,33,42,-9,35
Western Sydn,7270,7,8,9,10,38,47,-9,33
Perth Glory,7270,8,10,2,15,37,50,-13,32
Wellington P,7270,9,5,6,16,31,55,-24,21
CC Mariners,7270,10,4,8,15,28,49,-21,20
Sydney FC,7271,1,21,4,3,65,22,43,67
N'castle Jet,7271,2,15,5,8,57,41,16,50
Melbourne C,7271,3,15,4,10,47,33,14,49
Melbourne V,7271,4,13,5,11,45,39,6,44
Adelaide Utd,7271,5,11,6,11,37,40,-3,39
Brisbane,7271,6,10,5,13,33,42,-9,35
Western Sydn,7271,7,8,9,10,38,47,-9,33
Perth Glory,7271,8,10,2,15,37,50,-13,32
Wellington P,7271,9,5,6,16,31,55,-24,21
CC Mariners,7271,10,4,8,15,28,49,-21,20
Sydney FC,7272,1,21,4,3,65,22,43,67
N'castle Jet,7272,2,15,6,7,58,38,20,51
Melbourne C,7272,3,14,5,10,44,34,10,47
Melbourne V,7272,4,13,5,11,45,39,6,44
Adelaide Utd,7272,5,11,6,11,37,40,-3,39
Brisbane,7272,6,10,5,13,33,42,-9,35
Western Sydn,7272,7,8,9,10,38,47,-9,33
Perth Glory,7272,8,10,2,15,37,50,-13,32
Wellington P,7272,9,5,6,16,31,55,-24,21
CC Mariners,7272,10,4,8,15,28,49,-21,20
Sydney FC,7273,1,20,4,4,66,25,41,64
N'castle Jet,7273,2,15,5,8,57,39,18,50
Melbourne C,7273,3,15,4,10,45,33,12,49
Melbourne V,7273,4,14,5,10,48,40,8,47
Adelaide Utd,7273,5,11,6,11,37,40,-3,39
Brisbane,7273,6,10,5,13,33,42,-9,35
Western Sydn,7273,7,8,9,10,38,47,-9,33
Perth Glory,7273,8,10,2,15,37,50,-13,32
Wellington P,7273,9,5,6,16,31,55,-24,21
CC Mariners,7273,10,4,8,15,28,49,-21,20
Sydney FC,7274,1,21,4,3,66,23,43,67
N'castle Jet,7274,2,15,5,8,57,39,18,50
Melbourne C,7274,3,15,4,10,45,33,12,49
Melbourne V,7274,4,13,5,11,46,40,6,44
Adelaide Utd,7274,5,11,6,11,37,40,-3,39
Brisbane,7274,6,10,5,13,33,42,-9,35
Western Sydn,7274,7,8,9,10,38,47,-9,33
Perth Glory,7274,8,10,2,15,37,50,-13,32
Wellington P,7274,9,5,6,16,31,55,-24,21
CC Mariners,7274,10,4,8,15,28,49,-21,20
Sydney FC,7275,1,20,5,3,64,22,42,65
N'castle Jet,7275,2,16,5,7,59,38,21,53
Melbourne C,7275,3,14,4,11,44,35,9,46
Melbourne V,7275,4,13,6,10,45,38,7,45
Adelaide Utd,7275,5,11,6,11,37,40,-3,39
Brisbane,7275,6,10,5,13,33,42,-9,35
Western Sydn,7275,7,8,9,10,38,47,-9,33
Perth Glory,7275,8,10,2,15,37,50,-13,32
Wellington P,7275,9,5,6,16,31,55,-24,21
CC Mariners,7275,10,4,8,15,28,49,-21,20
Sydney FC,7276,1,21,4,3,66,23,43,67
N'castle Jet,7276,2,15,5,8,58,39,19,50
Melbourne C,7276,3,15,4,10,45,34,11,49
Melbourne V,7276,4,13,5,11,46,40,6,44
Adelaide Utd,7276,5,11,6,11,37,40,-3,39
Brisbane,7276,6,10,5,13,33,42,-9,35
Western Sydn,7276,7,8,9,10,38,47,-9,33
Perth Glory,7276,8,10,2,15,37,50,-13,32
Wellington P,7276,9,5,6,16,31,55,-24,21
CC Mariners,7276,10,4,8,15,28,49,-21,20
Sydney FC,7277,1,21,4,3,67,24,43,67
N'castle Jet,7277,2,16,5,7,60,38,22,53
Melbourne C,7277,3,14,4,11,44,36,8,46
Melbourne V,7277,4,13,5,11,47,41,6,44
Adelaide Utd,7277,5,11,6,11,37,40,-3,39
Brisbane,7277,6,10,5,13,33,42,-9,35
Western Sydn,7277,7,8,9,10,38,47,-9,33
Perth Glory,7277,8,10,2,15,37,50,-13,32
Wellington P,7277,9,5,6,16,31,55,-24,21
CC Mariners,7277,10,4,8,15,28,49,-21,20
Sydney FC,7278,1,20,5,3,65,23,42,65
N'castle Jet,7278,2,15,5,8,57,39,18,50
Melbourne C,7278,3,15,4,10,45,33,12,49
Melbourne V,7278,4,13,6,10,46,39,7,45
Adelaide Utd,7278,5,11,6,11,37,40,-3,39
Brisbane,7278,6,10,5,13,33,42,-9,35
Western Sydn,7278,7,8,9,10,38,47,-9,33
Perth Glory,7278,8,10,2,15,37,50,-13,32
Wellington P,7278,9,5,6,16,31,55,-24,21
CC Mariners,7278,10,4,8,15,28,49,-21,20
Sydney FC,7279,1,21,4,3,70,24,46,67
N'castle Jet,7279,2,16,5,7,60,37,23,53
Melbourne C,7279,3,14,4,11,43,36,7,46
Melbourne V,7279,4,13,5,11,47,44,3,44
Adelaide Utd,7279,5,11,6,11,37,40,-3,39
Brisbane,7279,6,10,5,13,33,42,-9,35
Western Sydn,7279,7,8,9,10,38,47,-9,33
Perth Glory,7279,8,10,2,15,37,50,-13,32
Wellington P,7279,9,5,6,16,31,55,-24,21
CC Mariners,7279,10,4,8,15,28,49,-21,20
Sydney FC,7280,1,20,5,3,65,23,42,65
N'castle Jet,7280,2,16,5,7,58,37,21,53
Melbourne C,7280,3,14,4,11,43,34,9,46
Melbourne V,7280,4,13,6,10,46,39,7,45
Adelaide Utd,7280,5,11,6,11,37,40,-3,39
Brisbane,7280,6,10,5,13,33,42,-9,35
Western Sydn,7280,7,8,9,10,38,47,-9,33
Perth Glory,7280,8,10,2,15,37,50,-13,32
Wellington P,7280,9,5,6,16,31,55,-24,21
CC Mariners,7280,10,4,8,15,28,49,-21,20
Sydney FC,7281,1,21,4,3,65,22,43,67
N'castle Jet,7281,2,15,6,7,57,37,20,51
Melbourne C,7281,3,14,5,10,43,33,10,47
Melbourne V,7281,4,13,5,11,45,39,6,44
Adelaide Utd,7281,5,11,6,11,37,40,-3,39
Brisbane,7281,6,10,5,13,33,42,-9,35
Western Sydn,7281,7,8,9,10,38,47,-9,33
Perth Glory,7281,8,10,2,15,37,50,-13,32
Wellington P,7281,9,5,6,16,31,55,-24,21
CC Mariners,7281,10,4,8,15,28,49,-21,20
Sydney FC,7282,1,21,4,3,67,22,45,67
N'castle Jet,7282,2,15,6,7,60,40,20,51
Melbourne C,7282,3,14,5,10,46,36,10,47
Melbourne V,7282,4,13,5,11,45,41,4,44
Adelaide Utd,7282,5,11,6,11,37,40,-3,39
Brisbane,7282,6,10,5,13,33,42,-9,35
Western Sydn,7282,7,8,9,10,38,47,-9,33
Perth Glory,7282,8,10,2,15,37,50,-13,32
Wellington P,7282,9,5,6,16,31,55,-24,21
CC Mariners,7282,10,4,8,15,28,49,-21,20
Sydney FC,7283,1,20,5,3,65,23,42,65
N'castle Jet,7283,2,16,5,7,60,38,22,53
Melbourne C,7283,3,14,4,11,44,36,8,46
Melbourne V,7283,4,13,6,10,46,39,7,45
Adelaide Utd,7283,5,11,6,11,37,40,-3,39
Brisbane,7283,6,10,5,13,33,42,-9,35
Western Sydn,7283,7,8,9,10,38,47,-9,33
Perth Glory,7283,8,10,2,15,37,50,-13,32
Wellington P,7283,9,5,6,16,31,55,-24,21
CC Mariners,7283,10,4,8,15,28,49,-21,20
Sydney FC,7284,1,20,5,3,65,23,42,65
N'castle Jet,7284,2,15,5,8,58,41,17,50
Melbourne C,7284,3,15,4,10,47,34,13,49
Melbourne V,7284,4,13,6,10,46,39,7,45
Adelaide Utd,7284,5,11,6,11,37,40,-3,39
Brisbane,7284,6,10,5,13,33,42,-9,35
Western Sydn,7284,7,8,9,10,38,47,-9,33
Perth Glory,7284,8,10,2,15,37,50,-13,32
Wellington P,7284,9,5,6,16,31,55,-24,21
CC Mariners,7284,10,4,8,15,28,49,-21,20
Sydney FC,7285,1,20,5,3,65,23,42,65
N'castle Jet,7285,2,15,5,8,57,38,19,50
Melbourne C,7285,3,15,4,10,44,33,11,49
Melbourne V,7285,4,13,6,10,46,39,7,45
Adelaide Utd,7285,5,11,6,11,37,40,-3,39
Brisbane,7285,6,10,5,13,33,42,-9,35
Western Sydn,7285,7,8,9,10,38,47,-9,33
Perth Glory,7285,8,10,2,15,37,50,-13,32
Wellington P,7285,9,5,6,16,31,55,-24,21
CC Mariners,7285,10,4,8,15,28,49,-21,20
Sydney FC,7286,1,21,4,3,67,22,45,67
N'castle Jet,7286,2,15,5,8,58,39,19,50
Melbourne C,7286,3,15,4,10,45,34,11,49
Melbourne V,7286,4,13,5,11,45,41,4,44
Adelaide Utd,7286,5,11,6,11,37,40,-3,39
Brisbane,7286,6,10,5,13,33,42,-9,35
Western Sydn,7286,7,8,9,10,38,47,-9,33
Perth Glory,7286,8,10,2,15,37,50,-13,32
Wellington P,7286,9,5,6,16,31,55,-24,21
CC Mariners,7286,10,4,8,15,28,49,-21,20
Sydney FC,7287,1,21,4,3,66,22,44,67
N'castle Jet,7287,2,16,5,7,60,38,22,53
Melbourne C,7287,3,14,4,11,44,36,8,46
Melbourne V,7287,4,13,5,11,45,40,5,44
Adelaide Utd,7287,5,11,6,11,37,40,-3,39
Brisbane,7287,6,10,5,13,33,42,-9,35
Western Sydn,7287,7,8,9,10,38,47,-9,33
Perth Glory,7287,8,10,2,15,37,50,-13,32
Wellington P,7287,9,5,6,16,31,55,-24,21
CC Mariners,7287,10,4,8,15,28,49,-21,20
Sydney FC,7288,1,21,4,3,66,22,44,67
N'castle Jet,7288,2,16,5,7,59,38,21,53
Melbourne C,7288,3,14,4,11,44,35,9,46
Melbourne V,7288,4,13,5,11,45,40,5,44
Adelaide Utd,7288,5,11,6,11,37,40,-3,39
Brisbane,7288,6,10,5,13,33,42,-9,35
Western Sydn,7288,7,8,9,10,38,47,-9,33
Perth Glory,7288,8,10,2,15,37,50,-13,32
Wellington P,7288,9,5,6,16,31,55,-24,21
CC Mariners,7288,10,4,8,15,28,49,-21,20
Sydney FC,7289,1,20,4,4,64,23,41,64
N'castle Jet,7289,2,15,6,7,58,38,20,51
Melbourne C,7289,3,14,5,10,44,34,10,47
Melbourne V,7289,4,14,5,10,46,38,8,47
Adelaide Utd,7289,5,11,6,11,37,40,-3,39
Brisbane,7289,6,10,5,13,33,42,-9,35
Western Sydn,7289,7,8,9,10,38,47,-9,33
Perth Glory,7289,8,10,2,15,37,50,-13,32
Wellington P,7289,9,5,6,16,31,55,-24,21
CC Mariners,7289,10,4,8,15,28,49,-21,20
Sydney FC,7290,1,20,4,4,65,25,40,64
N'castle Jet,7290,2,16,5,7,61,39,22,53
Melbourne V,7290,3,14,5,10,48,39,9,47
Melbourne C,7290,4,14,4,11,45,37,8,46
Adelaide Utd,7290,5,11,6,11,37,40,-3,39
Brisbane,7290,6,10,5,13,33,42,-9,35
Western Sydn,7290,7,8,9,10,38,47,-9,33
Perth Glory,7290,8,10,2,15,37,50,-13,32
Wellington P,7290,9,5,6,16,31,55,-24,21
CC Mariners,7290,10,4,8,15,28,49,-21,20
Sydney FC,7291,1,21,4,3,66,23,43,67
N'castle Jet,7291,2,16,5,7,59,37,22,53
Melbourne C,7291,3,14,4,11,43,35,8,46
Melbourne V,7291,4,13,5,11,46,40,6,44
Adelaide Utd,7291,5,11,6,11,37,40,-3,39
Brisbane,7291,6,10,5,13,33,42,-9,35
Western Sydn,7291,7,8,9,10,38,47,-9,33
Perth Glory,7291,8,10,2,15,37,50,-13,32
Wellington P,7291,9,5,6,16,31,55,-24,21
CC Mariners,7291,10,4,8,15,28,49,-21,20
Sydney FC,7292,1,20,5,3,64,22,42,65
N'castle Jet,7292,2,16,5,7,59,37,22,53
Melbourne C,7292,3,14,4,11,43,35,8,46
Melbourne V,7292,4,13,6,10,45,38,7,45
Adelaide Utd,7292,5,11,6,11,37,40,-3,39
Brisbane,7292,6,10,5,13,33,42,-9,35
Western Sydn,7292,7,8,9,10,38,47,-9,33
Perth Glory,7292,8,10,2,15,37,50,-13,32
Wellington P,7292,9,5,6,16,31,55,-24,21
CC Mariners,7292,10,4,8,15,28,49,-21,20
Sydney FC,7293,1,20,4,4,64,23,41,64
N'castle Jet,7293,2,15,6,7,58,38,20,51
Melbourne C,7293,3,14,5,10,44,34,10,47
Melbourne V,7293,4,14,5,10,46,38,8,47
Adelaide Utd,7293,5,11,6,11,37,40,-3,39
Brisbane,7293,6,10,5,13,33,42,-9,35
Western Sydn,7293,7,8,9,10,38,47,-9,33
Perth Glory,7293,8,10,2,15,37,50,-13,32
Wellington P,7293,9,5,6,16,31,55,-24,21
CC Mariners,7293,10,4,8,15,28,49,-21,20
Sydney FC,7294,1,20,4,4,64,23,41,64
N'castle Jet,7294,2,16,5,7,61,38,23,53
Melbourne V,7294,3,14,5,10,46,38,8,47
Melbourne C,7294,4,14,4,11,44,37,7,46
Adelaide Utd,7294,5,11,6,11,37,40,-3,39
Brisbane,7294,6,10,5,13,33,42,-9,35
Western Sydn,7294,7,8,9,10,38,47,-9,33
Perth Glory,7294,8,10,2,15,37,50,-13,32
Wellington P,7294,9,5,6,16,31,55,-24,21
CC Mariners,7294,10,4,8,15,28,49,-21,20
Sydney FC,7295,1,21,4,3,67,23,44,67
N'castle Jet,7295,2,16,5,7,60,37,23,53
Melbourne C,7295,3,14,4,11,43,36,7,46
Melbourne V,7295,4,13,5,11,46,41,5,44
Adelaide Utd,7295,5,11,6,11,37,40,-3,39
Brisbane,7295,6,10,5,13,33,42,-9,35
Western Sydn,7295,7,8,9,10,38,47,-9,33
Perth Glory,7295,8,10,2,15,37,50,-13,32
Wellington P,7295,9,5,6,16,31,55,-24,21
CC Mariners,7295,10,4,8,15,28,49,-21,20
Sydney FC,7296,1,21,4,3,67,24,43,67
N'castle Jet,7296,2,16,5,7,58,37,21,53
Melbourne C,7296,3,14,4,11,43,34,9,46
Melbourne V,7296,4,13,5,11,47,41,6,44
Adelaide Utd,7296,5,11,6,11,37,40,-3,39
Brisbane,7296,6,10,5,13,33,42,-9,35
Western Sydn,7296,7,8,9,10,38,47,-9,33
Perth Glory,7296,8,10,2,15,37,50,-13,32
Wellington P,7296,9,5,6,16,31,55,-24,21
CC Mariners,7296,10,4,8,15,28,49,-21,20
Sydney FC,7297,1,20,5,3,64,22,42,65
N'castle Jet,7297,2,15,5,8,58,39,19,50
Melbourne C,7297,3,15,4,10,45,34,11,49
Melbourne V,7297,4,13,6,10,45,38,7,45
Adelaide Utd,7297,5,11,6,11,37,40,-3,39
Brisbane,7297,6,10,5,13,33,42,-9,35
Western Sydn,7297,7,8,9,10,38,47,-9,33
Perth Glory,7297,8,10,2,15,37,50,-13,32
Wellington P,7297,9,5,6,16,31,55,-24,21
CC Mariners,7297,10,4,8,15,28,49,-21,20
Sydney FC,7298,1,20,4,4,65,24,41,64
N'castle Jet,7298,2,16,5,7,60,38,22,53
Melbourne V,7298,3,14,5,10,47,39,8,47
Melbourne C,7298,4,14,4,11,44,36,8,46
Adelaide Utd,7298,5,11,6,11,37,40,-3,39
Brisbane,7298,6,10,5,13,33,42,-9,35
Western Sydn,7298,7,8,9,10,38,47,-9,33
Perth Glory,7298,8,10,2,15,37,50,-13,32
Wellington P,7298,9,5,6,16,31,55,-24,21
CC Mariners,7298,10,4,8,15,28,49,-21,20
Sydney FC,7299,1,20,5,3,65,23,42,65
N'castle Jet,7299,2,16,5,7,59,37,22,53
Melbourne C,7299,3,14,4,11,43,35,8,46
Melbourne V,7299,4,13,6,10,46,39,7,45
Adelaide Utd,7299,5,11,6,11,37,40,-3,39
Brisbane,7299,6,10,5,13,33,42,-9,35
Western Sydn,7299,7,8,9,10,38,47,-9,33
Perth Glory,7299,8,10,2,15,37,50,-13,32
Wellington P,7299,9,5,6,16,31,55,-24,21
CC Mariners,7299,10,4,8,15,28,49,-21,20
Sydney FC,7300,1,21,4,3,67,23,44,67
N'castle Jet,7300,2,16,5,7,60,38,22,53
Melbourne C,7300,3,14,4,11,44,36,8,46
Melbourne V,7300,4,13,5,11,46,41,5,44
Adelaide Utd,7300,5,11,6,11,37,40,-3,39
Brisbane,7300,6,10,5,13,33,42,-9,35
Western Sydn,7300,7,8,9,10,38,47,-9,33
Perth Glory,7300,8,10,2,15,37,50,-13,32
Wellington P,7300,9,5,6,16,31,55,-24,21
CC Mariners,7300,10,4,8,15,28,49,-21,20
Sydney FC,7301,1,21,4,3,65,22,43,67
N'castle Jet,7301,2,16,5,7,63,37,26,53
Melbourne C,7301,3,14,4,11,43,39,4,46
Melbourne V,7301,4,13,5,11,45,39,6,44
Adelaide Utd,7301,5,11,6,11,37,40,-3,39
Brisbane,7301,6,10,5,13,33,42,-9,35
Western Sydn,7301,7,8,9,10,38,47,-9,33
Perth Glory,7301,8,10,2,15,37,50,-13,32
Wellington P,7301,9,5,6,16,31,55,-24,21
CC Mariners,7301,10,4,8,15,28,49,-21,20
Sydney FC,7302,1,21,4,3,70,23,47,67
N'castle Jet,7302,2,16,5,7,58,37,21,53
Melbourne C,7302,3,14,4,11,43,34,9,46
Melbourne V,7302,4,13,5,11,46,44,2,44
Adelaide Utd,7302,5,11,6,11,37,40,-3,39
Brisbane,7302,6,10,5,13,33,42,-9,35
Western Sydn,7302,7,8,9,10,38,47,-9,33
Perth Glory,7302,8,10,2,15,37,50,-13,32
Wellington P,7302,9,5,6,16,31,55,-24,21
CC Mariners,7302,10,4,8,15,28,49,-21,20
Sydney FC,7303,1,21,4,3,68,22,46,67
N'castle Jet,7303,2,16,5,7,60,39,21,53
Melbourne C,7303,3,14,4,11,45,36,9,46
Melbourne V,7303,4,13,5,11,45,42,3,44
Adelaide Utd,7303,5,11,6,11,37,40,-3,39
Brisbane,7303,6,10,5,13,33,42,-9,35
Western Sydn,7303,7,8,9,10,38,47,-9,33
Perth Glory,7303,8,10,2,15,37,50,-13,32
Wellington P,7303,9,5,6,16,31,55,-24,21
CC Mariners,7303,10,4,8,15,28,49,-21,20
Sydney FC,7304,1,20,5,3,66,24,42,65
N'castle Jet,7304,2,15,6,7,58,38,20,51
Melbourne C,7304,3,14,5,10,44,34,10,47
Melbourne V,7304,4,13,6,10,47,40,7,45
Adelaide Utd,7304,5,11,6,11,37,40,-3,39
Brisbane,7304,6,10,5,13,33,42,-9,35
Western Sydn,7304,7,8,9,10,38,47,-9,33
Perth Glory,7304,8,10,2,15,37,50,-13,32
Wellington P,7304,9,5,6,16,31,55,-24,21
CC Mariners,7304,10,4,8,15,28,49,-21,20
Sydney FC,7305,1,21,4,3,67,23,44,67
N'castle Jet,7305,2,15,6,7,58,38,20,51
Melbourne C,7305,3,14,5,10,44,34,10,47
Melbourne V,7305,4,13,5,11,46,41,5,44
Adelaide Utd,7305,5,11,6,11,37,40,-3,39
Brisbane,7305,6,10,5,13,33,42,-9,35
Western Sydn,7305,7,8,9,10,38,47,-9,33
Perth Glory,7305,8,10,2,15,37,50,-13,32
Wellington P,7305,9,5,6,16,31,55,-24,21
CC Mariners,7305,10,4,8,15,28,49,-21,20
Sydney FC,7306,1,20,5,3,65,23,42,65
N'castle Jet,7306,2,15,5,8,57,38,19,50
Melbourne C,7306,3,15,4,10,44,33,11,49
Melbourne V,7306,4,13,6,10,46,39,7,45
Adelaide Utd,7306,5,11,6,11,37,40,-3,39
Brisbane,7306,6,10,5,13,33,42,-9,35
Western Sydn,7306,7,8,9,10,38,47,-9,33
Perth Glory,7306,8,10,2,15,37,50,-13,32
Wellington P,7306,9,5,6,16,31,55,-24,21
CC Mariners,7306,10,4,8,15,28,49,-21,20
Sydney FC,7307,1,21,4,3,69,23,46,67
N'castle Jet,7307,2,16,5,7,61,40,21,53
Melbourne C,7307,3,14,4,11,46,37,9,46
Melbourne V,7307,4,13,5,11,46,43,3,44
Adelaide Utd,7307,5,11,6,11,37,40,-3,39
Brisbane,7307,6,10,5,13,33,42,-9,35
Western Sydn,7307,7,8,9,10,38,47,-9,33
Perth Glory,7307,8,10,2,15,37,50,-13,32
Wellington P,7307,9,5,6,16,31,55,-24,21
CC Mariners,7307,10,4,8,15,28,49,-21,20
Sydney FC,7308,1,20,4,4,66,26,40,64
N'castle Jet,7308,2,16,5,7,61,38,23,53
Melbourne V,7308,3,14,5,10,49,40,9,47
Melbourne C,7308,4,14,4,11,44,37,7,46
Adelaide Utd,7308,5,11,6,11,37,40,-3,39
Brisbane,7308,6,10,5,13,33,42,-9,35
Western Sydn,7308,7,8,9,10,38,47,-9,33
Perth Glory,7308,8,10,2,15,37,50,-13,32
Wellington P,7308,9,5,6,16,31,55,-24,21
CC Mariners,7308,10,4,8,15,28,49,-21,20
Sydney FC,7309,1,21,4,3,66,23,43,67
N'castle Jet,7309,2,15,6,7,58,38,20,51
Melbourne C,7309,3,14,5,10,44,34,10,47
Melbourne V,7309,4,13,5,11,46,40,6,44
Adelaide Utd,7309,5,11,6,11,37,40,-3,39
Brisbane,7309,6,10,5,13,33,42,-9,35
Western Sydn,7309,7,8,9,10,38,47,-9,33
Perth Glory,7309,8,10,2,15,37,50,-13,32
Wellington P,7309,9,5,6,16,31,55,-24,21
CC Mariners,7309,10,4,8,15,28,49,-21,20
Sydney FC,7310,1,21,4,3,68,23,45,67
N'castle Jet,7310,2,16,5,7,60,38,22,53
Melbourne C,7310,3,14,4,11,44,36,8,46
Melbourne V,7310,4,13,5,11,46,42,4,44
Adelaide Utd,7310,5,11,6,11,37,40,-3,39
Brisbane,7310,6,10,5,13,33,42,-9,35
Western Sydn,7310,7,8,9,10,38,47,-9,33
Perth Glory,7310,8,10,2,15,37,50,-13,32
Wellington P,7310,9,5,6,16,31,55,-24,21
CC Mariners,7310,10,4,8,15,28,49,-21,20
Sydney FC,7311,1,20,4,4,66,25,41,64
N'castle Jet,7311,2,15,5,8,57,38,19,50
Melbourne C,7311,3,15,4,10,44,33,11,49
Melbourne V,7311,4,14,5,10,48,40,8,47
Adelaide Utd,7311,5,11,6,11,37,40,-3,39
Brisbane,7311,6,10,5,13,33,42,-9,35
Western Sydn,7311,7,8,9,10,38,47,-9,33
Perth Glory,7311,8,10,2,15,37,50,-13,32
Wellington P,7311,9,5,6,16,31,55,-24,21
CC Mariners,7311,10,4,8,15,28,49,-21,20
Sydney FC,7312,1,21,4,3,67,24,43,67
N'castle Jet,7312,2,16,5,7,59,37,22,53
Melbourne C,7312,3,14,4,11,43,35,8,46
Melbourne V,7312,4,13,5,11,47,41,6,44
Adelaide Utd,7312,5,11,6,11,37,40,-3,39
Brisbane,7312,6,10,5,13,33,42,-9,35
Western Sydn,7312,7,8,9,10,38,47,-9,33
Perth Glory,7312,8,10,2,15,37,50,-13,32
Wellington P,7312,9,5,6,16,31,55,-24,21
CC Mariners,7312,10,4,8,15,28,49,-21,20
Sydney FC,7313,1,21,4,3,67,22,45,67
N'castle Jet,7313,2,15,6,7,58,38,20,51
Melbourne C,7313,3,14,5,10,44,34,10,47
Melbourne V,7313,4,13,5,11,45,41,4,44
Adelaide Utd,7313,5,11,6,11,37,40,-3,39
Brisbane,7313,6,10,5,13,33,42,-9,35
Western Sydn,7313,7,8,9,10,38,47,-9,33
Perth Glory,7313,8,10,2,15,37,50,-13,32
Wellington P,7313,9,5,6,16,31,55,-24,21
CC Mariners,7313,10,4,8,15,28,49,-21,20
Sydney FC,7314,1,21,4,3,66,22,44,67
N'castle Jet,7314,2,15,5,8,60,41,19,50
Melbourne C,7314,3,15,4,10,47,36,11,49
Melbourne V,7314,4,13,5,11,45,40,5,44
Adelaide Utd,7314,5,11,6,11,37,40,-3,39
Brisbane,7314,6,10,5,13,33,42,-9,35
Western Sydn,7314,7,8,9,10,38,47,-9,33
Perth Glory,7314,8,10,2,15,37,50,-13,32
Wellington P,7314,9,5,6,16,31,55,-24,21
CC Mariners,7314,10,4,8,15,28,49,-21,20
Sydney FC,7315,1,20,4,4,64,23,41,64
N'castle Jet,7315,2,15,6,7,57,37,20,51
Melbourne C,7315,3,14,5,10,43,33,10,47
Melbourne V,7315,4,14,5,10,46,38,8,47
Adelaide Utd,7315,5,11,6,11,37,40,-3,39
Brisbane,7315,6,10,5,13,33,42,-9,35
Western Sydn,7315,7,8,9,10,38,47,-9,33
Perth Glory,7315,8,10,2,15,37,50,-13,32
Wellington P,7315,9,5,6,16,31,55,-24,21
CC Mariners,7315,10,4,8,15,28,49,-21,20
Sydney FC,7316,1,21,4,3,66,22,44,67
N'castle Jet,7316,2,15,5,8,58,39,19,50
Melbourne C,7316,3,15,4,10,45,34,11,49
Melbourne V,7316,4,13,5,11,45,40,5,44
Adelaide Utd,7316,5,11,6,11,37,40,-3,39
Brisbane,7316,6,10,5,13,33,42,-9,35
Western Sydn,7316,7,8,9,10,38,47,-9,33
Perth Glory,7316,8,10,2,15,37,50,-13,32
Wellington P,7316,9,5,6,16,31,55,-24,21
CC Mariners,7316,10,4,8,15,28,49,-21,20
Sydney FC,7317,1,21,4,3,66,22,44,67
N'castle Jet,7317,2,16,5,7,61,38,23,53
Melbourne C,7317,3,14,4,11,44,37,7,46
Melbourne V,7317,4,13,5,11,45,40,5,44
Adelaide Utd,7317,5,11,6,11,37,40,-3,39
Brisbane,7317,6,10,5,13,33,42,-9,35
Western Sydn,7317,7,8,9,10,38,47,-9,33
Perth Glory,7317,8,10,2,15,37,50,-13,32
Wellington P,7317,9,5,6,16,31,55,-24,21
CC Mariners,7317,10,4,8,15,28,49,-21,20
Sydney FC,7318,1,20,5,3,64,22,42,65
N'castle Jet,7318,2,16,5,7,60,39,21,53
Melbourne C,7318,3,14,4,11,45,36,9,46
Melbourne V,7318,4,13,6,10,45,38,7,45
Adelaide Utd,7318,5,11,6,11,37,40,-3,39
Brisbane,7318,6,10,5,13,33,42,-9,35
Western Sydn,7318,7,8,9,10,38,47,-9,33
Perth Glory,7318,8,10,2,15,37,50,-13,32
Wellington P,7318,9,5,6,16,31,55,-24,21
CC Mariners,7318,10,4,8,15,28,49,-21,20
Sydney FC,7319,1,20,4,4,64,23,41,64
N'castle Jet,7319,2,16,5,7,60,38,22,53
Melbourne V,7319,3,14,5,10,46,38,8,47
Melbourne C,7319,4,14,4,11,44,36,8,46
Adelaide Utd,7319,5,11,6,11,37,40,-3,39
Brisbane,7319,6,10,5,13,33,42,-9,35
Western Sydn,7319,7,8,9,10,38,47,-9,33
Perth Glory,7319,8,10,2,15,37,50,-13,32
Wellington P,7319,9,5,6,16,31,55,-24,21
CC Mariners,7319,10,4,8,15,28,49,-21,20
Sydney FC,7320,1,21,4,3,67,22,45,67
N'castle Jet,7320,2,16,5,7,59,38,21,53
Melbourne C,7320,3,14,4,11,44,35,9,46
Melbourne V,7320,4,13,5,11,45,41,4,44
Adelaide Utd,7320,5,11,6,11,37,40,-3,39
Brisbane,7320,6,10,5,13,33,42,-9,35
Western Sydn,7320,7,8,9,10,38,47,-9,33
Perth Glory,7320,8,10,2,15,37,50,-13,32
Wellington P,7320,9,5,6,16,31,55,-24,21
CC Mariners,7320,10,4,8,15,28,49,-21,20
Sydney FC,7321,1,21,4,3,66,22,44,67
N'castle Jet,7321,2,15,6,7,58,38,20,51
Melbourne C,7321,3,14,5,10,44,34,10,47
Melbourne V,7321,4,13,5,11,45,40,5,44
Adelaide Utd,7321,5,11,6,11,37,40,-3,39
Brisbane,7321,6,10,5,13,33,42,-9,35
Western Sydn,7321,7,8,9,10,38,47,-9,33
Perth Glory,7321,8,10,2,15,37,50,-13,32
Wellington P,7321,9,5,6,16,31,55,-24,21
CC Mariners,7321,10,4,8,15,28,49,-21,20
Sydney FC,7322,1,21,4,3,65,22,43,67
N'castle Jet,7322,2,16,5,7,60,38,22,53
Melbourne C,7322,3,14,4,11,44,36,8,46
Melbourne V,7322,4,13,5,11,45,39,6,44
Adelaide Utd,7322,5,11,6,11,37,40,-3,39
Brisbane,7322,6,10,5,13,33,42,-9,35
Western Sydn,7322,7,8,9,10,38,47,-9,33
Perth Glory,7322,8,10,2,15,37,50,-13,32
Wellington P,7322,9,5,6,16,31,55,-24,21
CC Mariners,7322,10,4,8,15,28,49,-21,20
Sydney FC,7323,1,20,5,3,66,24,42,65
N'castle Jet,7323,2,15,5,8,57,38,19,50
Melbourne C,7323,3,15,4,10,44,33,11,49
Melbourne V,7323,4,13,6,10,47,40,7,45
Adelaide Utd,7323,5,11,6,11,37,40,-3,39
Brisbane,7323,6,10,5,13,33,42,-9,35
Western Sydn,7323,7,8,9,10,38,47,-9,33
Perth Glory,7323,8,10,2,15,37,50,-13,32
Wellington P,7323,9,5,6,16,31,55,-24,21
CC Mariners,7323,10,4,8,15,28,49,-21,20
Sydney FC,7324,1,21,4,3,66,23,43,67
N'castle Jet,7324,2,16,5,7,60,38,22,53
Melbourne C,7324,3,14,4,11,44,36,8,46
Melbourne V,7324,4,13,5,11,46,40,6,44
Adelaide Utd,7324,5,11,6,11,37,40,-3,39
Brisbane,7324,6,10,5,13,33,42,-9,35
Western Sydn,7324,7,8,9,10,38,47,-9,33
Perth Glory,7324,8,10,2,15,37,50,-13,32
Wellington P,7324,9,5,6,16,31,55,-24,21
CC Mariners,7324,10,4,8,15,28,49,-21,20
Sydney FC,7325,1,20,4,4,65,25,40,64
N'castle Jet,7325,2,16,5,7,59,37,22,53
Melbourne V,7325,3,14,5,10,48,39,9,47
Melbourne C,7325,4,14,4,11,43,35,8,46
Adelaide Utd,7325,5,11,6,11,37,40,-3,39
Brisbane,7325,6,10,5,13,33,42,-9,35
Western Sydn,7325,7,8,9,10,38,47,-9,33
Perth Glory,7325,8,10,2,15,37,50,-13,32
Wellington P,7325,9,5,6,16,31,55,-24,21
CC Mariners,7325,10,4,8,15,28,49,-21,20
Sydney FC,7326,1,20,4,4,65,24,41,64
N'castle Jet,7326,2,16,5,7,59,37,22,53
Melbourne V,7326,3,14,5,10,47,39,8,47
Melbourne C,7326,4,14,4,11,43,35,8,46
Adelaide Utd,7326,5,11,6,11,37,40,-3,39
Brisbane,7326,6,10,5,13,33,42,-9,35
Western Sydn,7326,7,8,9,10,38,47,-9,33
Perth Glory,7326,8,10,2,15,37,50,-13,32
Wellington P,7326,9,5,6,16,31,55,-24,21
CC Mariners,7326,10,4,8,15,28,49,-21,20
Sydney FC,7327,1,20,5,3,65,23,42,65
N'castle Jet,7327,2,16,5,7,62,38,24,53
Melbourne C,7327,3,14,4,11,44,38,6,46
Melbourne V,7327,4,13,6,10,46,39,7,45
Adelaide Utd,7327,5,11,6,11,37,40,-3,39
Brisbane,7327,6,10,5,13,33,42,-9,35
Western Sydn,7327,7,8,9,10,38,47,-9,33
Perth Glory,7327,8,10,2,15,37,50,-13,32
Wellington P,7327,9,5,6,16,31,55,-24,21
CC Mariners,7327,10,4,8,15,28,49,-21,20
Sydney FC,7328,1,20,5,3,64,22,42,65
N'castle Jet,7328,2,15,6,7,61,41,20,51
Melbourne C,7328,3,14,5,10,47,37,10,47
Melbourne V,7328,4,13,6,10,45,38,7,45
Adelaide Utd,7328,5,11,6,11,37,40,-3,39
Brisbane,7328,6,10,5,13,33,42,-9,35
Western Sydn,7328,7,8,9,10,38,47,-9,33
Perth Glory,7328,8,10,2,15,37,50,-13,32
Wellington P,7328,9,5,6,16,31,55,-24,21
CC Mariners,7328,10,4,8,15,28,49,-21,20
Sydney FC,7329,1,21,4,3,68,23,45,67
N'castle Jet,7329,2,15,6,7,57,37,20,51
Melbourne C,7329,3,14,5,10,43,33,10,47
Melbourne V,7329,4,13,5,11,46,42,4,44
Adelaide Utd,7329,5,11,6,11,37,40,-3,39
Brisbane,7329,6,10,5,13,33,42,-9,35
Western Sydn,7329,7,8,9,10,38,47,-9,33
Perth Glory,7329,8,10,2,15,37,50,-13,32
Wellington P,7329,9,5,6,16,31,55,-24,21
CC Mariners,7329,10,4,8,15,28,49,-21,20
Sydney FC,7330,1,21,4,3,67,23,44,67
N'castle Jet,7330,2,15,5,8,57,38,19,50
Melbourne C,7330,3,15,4,10,44,33,11,49
Melbourne V,7330,4,13,5,11,46,41,5,44
Adelaide Utd,7330,5,11,6,11,37,40,-3,39
Brisbane,7330,6,10,5,13,33,42,-9,35
Western Sydn,7330,7,8,9,10,38,47,-9,33
Perth Glory,7330,8,10,2,15,37,50,-13,32
Wellington P,7330,9,5,6,16,31,55,-24,21
CC Mariners,7330,10,4,8,15,28,49,-21,20
Sydney FC,7331,1,21,4,3,66,22,44,67
N'castle Jet,7331,2,16,5,7,58,37,21,53
Melbourne C,7331,3,14,4,11,43,34,9,46
Melbourne V,7331,4,13,5,11,45,40,5,44
Adelaide Utd,7331,5,11,6,11,37,40,-3,39
Brisbane,7331,6,10,5,13,33,42,-9,35
Western Sydn,7331,7,8,9,10,38,47,-9,33
Perth Glory,7331,8,10,2,15,37,50,-13,32
Wellington P,7331,9,5,6,16,31,55,-24,21
CC Mariners,7331,10,4,8,15,28,49,-21,20
Sydney FC,7332,1,21,4,3,66,22,44,67
N'castle Jet,7332,2,16,5,7,61,38,23,53
Melbourne C,7332,3,14,4,11,44,37,7,46
Melbourne V,7332,4,13,5,11,45,40,5,44
Adelaide Utd,7332,5,11,6,11,37,40,-3,39
Brisbane,7332,6,10,5,13,33,42,-9,35
Western Sydn,7332,7,8,9,10,38,47,-9,33
Perth Glory,7332,8,10,2,15,37,50,-13,32
Wellington P,7332,9,5,6,16,31,55,-24,21
CC Mariners,7332,10,4,8,15,28,49,-21,20
Sydney FC,7333,1,20,4,4,65,24,41,64
N'castle Jet,7333,2,16,5,7,60,38,22,53
Melbourne V,7333,3,14,5,10,47,39,8,47
Melbourne C,7333,4,14,4,11,44,36,8,46
Adelaide Utd,7333,5,11,6,11,37,40,-3,39
Brisbane,7333,6,10,5,13,33,42,-9,35
Western Sydn,7333,7,8,9,10,38,47,-9,33
Perth Glory,7333,8,10,2,15,37,50,-13,32
Wellington P,7333,9,5,6,16,31,55,-24,21
CC Mariners,7333,10,4,8,15,28,49,-21,20
Sydney FC,7334,1,20,5,3,64,22,42,65
N'castle Jet,7334,2,16,5,7,59,37,22,53
Melbourne C,7334,3,14,4,11,43,35,8,46
Melbourne V,7334,4,13,6,10,45,38,7,45
Adelaide Utd,7334,5,11,6,11,37,40,-3,39
Brisbane,7334,6,10,5,13,33,42,-9,35
Western Sydn,7334,7,8,9,10,38,47,-9,33
Perth Glory,7334,8,10,2,15,37,50,-13,32
Wellington P,7334,9,5,6,16,31,55,-24,21
CC Mariners,7334,10,4,8,15,28,49,-21,20
Sydney FC,7335,1,21,4,3,66,23,43,67
N'castle Jet,7335,2,16,5,7,59,37,22,53
Melbourne C,7335,3,14,4,11,43,35,8,46
Melbourne V,7335,4,13,5,11,46,40,6,44
Adelaide Utd,7335,5,11,6,11,37,40,-3,39
Brisbane,7335,6,10,5,13,33,42,-9,35
Western Sydn,7335,7,8,9,10,38,47,-9,33
Perth Glory,7335,8,10,2,15,37,50,-13,32
Wellington P,7335,9,5,6,16,31,55,-24,21
CC Mariners,7335,10,4,8,15,28,49,-21,20
Sydney FC,7336,1,20,4,4,66,25,41,64
N'castle Jet,7336,2,15,5,8,57,38,19,50
Melbourne C,7336,3,15,4,10,44,33,11,49
Melbourne V,7336,4,14,5,10,48,40,8,47
Adelaide Utd,7336,5,11,6,11,37,40,-3,39
Brisbane,7336,6,10,5,13,33,42,-9,35
Western Sydn,7336,7,8,9,10,38,47,-9,33
Perth Glory,7336,8,10,2,15,37,50,-13,32
Wellington P,7336,9,5,6,16,31,55,-24,21
CC Mariners,7336,10,4,8,15,28,49,-21,20
Sydney FC,7337,1,20,4,4,64,24,40,64
N'castle Jet,7337,2,15,5,8,57,38,19,50
Melbourne C,7337,3,15,4,10,44,33,11,49
Melbourne V,7337,4,14,5,10,47,38,9,47
Adelaide Utd,7337,5,11,6,11,37,40,-3,39
Brisbane,7337,6,10,5,13,33,42,-9,35
Western Sydn,7337,7,8,9,10,38,47,-9,33
Perth Glory,7337,8,10,2,15,37,50,-13,32
Wellington P,7337,9,5,6,16,31,55,-24,21
CC Mariners,7337,10,4,8,15,28,49,-21,20
Sydney FC,7338,1,21,4,3,65,22,43,67
N'castle Jet,7338,2,16,5,7,59,37,22,53
Melbourne C,7338,3,14,4,11,43,35,8,46
Melbourne V,7338,4,13,5,11,45,39,6,44
Adelaide Utd,7338,5,11,6,11,37,40,-3,39
Brisbane,7338,6,10,5,13,33,42,-9,35
Western Sydn,7338,7,8,9,10,38,47,-9,33
Perth Glory,7338,8,10,2,15,37,50,-13,32
Wellington P,7338,9,5,6,16,31,55,-24,21
CC Mariners,7338,10,4,8,15,28,49,-21,20
Sydney FC,7339,1,21,4,3,69,25,44,67
N'castle Jet,7339,2,15,6,7,59,39,20,51
Melbourne C,7339,3,14,5,10,45,35,10,47
Melbourne V,7339,4,13,5,11,48,43,5,44
Adelaide Utd,7339,5,11,6,11,37,40,-3,39
Brisbane,7339,6,10,5,13,33,42,-9,35
Western Sydn,7339,7,8,9,10,38,47,-9,33
Perth Glory,7339,8,10,2,15,37,50,-13,32
Wellington P,7339,9,5,6,16,31,55,-24,21
CC Mariners,7339,10,4,8,15,28,49,-21,20
Sydney FC,7340,1,20,5,3,65,23,42,65
N'castle Jet,7340,2,15,5,8,57,38,19,50
Melbourne C,7340,3,15,4,10,44,33,11,49
Melbourne V,7340,4,13,6,10,46,39,7,45
Adelaide Utd,7340,5,11,6,11,37,40,-3,39
Brisbane,7340,6,10,5,13,33,42,-9,35
Western Sydn,7340,7,8,9,10,38,47,-9,33
Perth Glory,7340,8,10,2,15,37,50,-13,32
Wellington P,7340,9,5,6,16,31,55,-24,21
CC Mariners,7340,10,4,8,15,28,49,-21,20
Sydney FC,7341,1,21,4,3,66,22,44,67
N'castle Jet,7341,2,15,5,8,59,40,19,50
Melbourne C,7341,3,15,4,10,46,35,11,49
Melbourne V,7341,4,13,5,11,45,40,5,44
Adelaide Utd,7341,5,11,6,11,37,40,-3,39
Brisbane,7341,6,10,5,13,33,42,-9,35
Western Sydn,7341,7,8,9,10,38,47,-9,33
Perth Glory,7341,8,10,2,15,37,50,-13,32
Wellington P,7341,9,5,6,16,31,55,-24,21
CC Mariners,7341,10,4,8,15,28,49,-21,20
Sydney FC,7342,1,21,4,3,67,24,43,67
N'castle Jet,7342,2,15,6,7,57,37,20,51
Melbourne C,7342,3,14,5,10,43,33,10,47
Melbourne V,7342,4,13,5,11,47,41,6,44
Adelaide Utd,7342,5,11,6,11,37,40,-3,39
Brisbane,7342,6,10,5,13,33,42,-9,35
Western Sydn,7342,7,8,9,10,38,47,-9,33
Perth Glory,7342,8,10,2,15,37,50,-13,32
Wellington P,7342,9,5,6,16,31,55,-24,21
CC Mariners,7342,10,4,8,15,28,49,-21,20
Sydney FC,7343,1,21,4,3,67,23,44,67
N'castle Jet,7343,2,15,5,8,57,40,17,50
Melbourne C,7343,3,15,4,10,46,33,13,49
Melbourne V,7343,4,13,5,11,46,41,5,44
Adelaide Utd,7343,5,11,6,11,37,40,-3,39
Brisbane,7343,6,10,5,13,33,42,-9,35
Western Sydn,7343,7,8,9,10,38,47,-9,33
Perth Glory,7343,8,10,2,15,37,50,-13,32
Wellington P,7343,9,5,6,16,31,55,-24,21
CC Mariners,7343,10,4,8,15,28,49,-21,20
Sydney FC,7344,1,21,4,3,66,22,44,67
N'castle Jet,7344,2,16,5,7,62,39,23,53
Melbourne C,7344,3,14,4,11,45,38,7,46
Melbourne V,7344,4,13,5,11,45,40,5,44
Adelaide Utd,7344,5,11,6,11,37,40,-3,39
Brisbane,7344,6,10,5,13,33,42,-9,35
Western Sydn,7344,7,8,9,10,38,47,-9,33
Perth Glory,7344,8,10,2,15,37,50,-13,32
Wellington P,7344,9,5,6,16,31,55,-24,21
CC Mariners,7344,10,4,8,15,28,49,-21,20
Sydney FC,7345,1,21,4,3,66,23,43,67
N'castle Jet,7345,2,15,5,8,58,39,19,50
Melbourne C,7345,3,15,4,10,45,34,11,49
Melbourne V,7345,4,13,5,11,46,40,6,44
Adelaide Utd,7345,5,11,6,11,37,40,-3,39
Brisbane,7345,6,10,5,13,33,42,-9,35
Western Sydn,7345,7,8,9,10,38,47,-9,33
Perth Glory,7345,8,10,2,15,37,50,-13,32
Wellington P,7345,9,5,6,16,31,55,-24,21
CC Mariners,7345,10,4,8,15,28,49,-21,20
Sydney FC,7346,1,21,4,3,67,23,44,67
N'castle Jet,7346,2,16,5,7,60,37,23,53
Melbourne C,7346,3,14,4,11,43,36,7,46
Melbourne V,7346,4,13,5,11,46,41,5,44
Adelaide Utd,7346,5,11,6,11,37,40,-3,39
Brisbane,7346,6,10,5,13,33,42,-9,35
Western Sydn,7346,7,8,9,10,38,47,-9,33
Perth Glory,7346,8,10,2,15,37,50,-13,32
Wellington P,7346,9,5,6,16,31,55,-24,21
CC Mariners,7346,10,4,8,15,28,49,-21,20
Sydney FC,7347,1,21,4,3,67,23,44,67
N'castle Jet,7347,2,16,5,7,58,37,21,53
Melbourne C,7347,3,14,4,11,43,34,9,46
Melbourne V,7347,4,13,5,11,46,41,5,44
Adelaide Utd,7347,5,11,6,11,37,40,-3,39
Brisbane,7347,6,10,5,13,33,42,-9,35
Western Sydn,7347,7,8,9,10,38,47,-9,33
Perth Glory,7347,8,10,2,15,37,50,-13,32
Wellington P,7347,9,5,6,16,31,55,-24,21
CC Mariners,7347,10,4,8,15,28,49,-21,20
Sydney FC,7348,1,20,4,4,64,26,38,64
N'castle Jet,7348,2,16,5,7,59,37,22,53
Melbourne V,7348,3,14,5,10,49,38,11,47
Melbourne C,7348,4,14,4,11,43,35,8,46
Adelaide Utd,7348,5,11,6,11,37,40,-3,39
Brisbane,7348,6,10,5,13,33,42,-9,35
Western Sydn,7348,7,8,9,10,38,47,-9,33
Perth Glory,7348,8,10,2,15,37,50,-13,32
Wellington P,7348,9,5,6,16,31,55,-24,21
CC Mariners,7348,10,4,8,15,28,49,-21,20
Sydney FC,7349,1,21,4,3,66,22,44,67
N'castle Jet,7349,2,15,6,7,58,38,20,51
Melbourne C,7349,3,14,5,10,44,34,10,47
Melbourne V,7349,4,13,5,11,45,40,5,44
Adelaide Utd,7349,5,11,6,11,37,40,-3,39
Brisbane,7349,6,10,5,13,33,42,-9,35
Western Sydn,7349,7,8,9,10,38,47,-9,33
Perth Glory,7349,8,10,2,15,37,50,-13,32
Wellington P,7349,9,5,6,16,31,55,-24,21
CC Mariners,7349,10,4,8,15,28,49,-21,20
Sydney FC,7350,1,21,4,3,68,24,44,67
N'castle Jet,7350,2,15,6,7,59,39,20,51
Melbourne C,7350,3,14,5,10,45,35,10,47
Melbourne V,7350,4,13,5,11,47,42,5,44
Adelaide Utd,7350,5,11,6,11,37,40,-3,39
Brisbane,7350,6,10,5,13,33,42,-9,35
Western Sydn,7350,7,8,9,10,38,47,-9,33
Perth Glory,7350,8,10,2,15,37,50,-13,32
Wellington P,7350,9,5,6,16,31,55,-24,21
CC Mariners,7350,10,4,8,15,28,49,-21,20
Sydney FC,7351,1,21,4,3,65,22,43,67
N'castle Jet,7351,2,15,6,7,58,38,20,51
Melbourne C,7351,3,14,5,10,44,34,10,47
Melbourne V,7351,4,13,5,11,45,39,6,44
Adelaide Utd,7351,5,11,6,11,37,40,-3,39
Brisbane,7351,6,10,5,13,33,42,-9,35
Western Sydn,7351,7,8,9,10,38,47,-9,33
Perth Glory,7351,8,10,2,15,37,50,-13,32
Wellington P,7351,9,5,6,16,31,55,-24,21
CC Mariners,7351,10,4,8,15,28,49,-21,20
Sydney FC,7352,1,21,4,3,66,22,44,67
N'castle Jet,7352,2,16,5,7,60,38,22,53
Melbourne C,7352,3,14,4,11,44,36,8,46
Melbourne V,7352,4,13,5,11,45,40,5,44
Adelaide Utd,7352,5,11,6,11,37,40,-3,39
Brisbane,7352,6,10,5,13,33,42,-9,35
Western Sydn,7352,7,8,9,10,38,47,-9,33
Perth Glory,7352,8,10,2,15,37,50,-13,32
Wellington P,7352,9,5,6,16,31,55,-24,21
CC Mariners,7352,10,4,8,15,28,49,-21,20
Sydney FC,7353,1,21,4,3,67,22,45,67
N'castle Jet,7353,2,16,5,7,59,37,22,53
Melbourne C,7353,3,14,4,11,43,35,8,46
Melbourne V,7353,4,13,5,11,45,41,4,44
Adelaide Utd,7353,5,11,6,11,37,40,-3,39
Brisbane,7353,6,10,5,13,33,42,-9,35
Western Sydn,7353,7,8,9,10,38,47,-9,33
Perth Glory,7353,8,10,2,15,37,50,-13,32
Wellington P,7353,9,5,6,16,31,55,-24,21
CC Mariners,7353,10,4,8,15,28,49,-21,20
Sydney FC,7354,1,21,4,3,68,25,43,67
N'castle Jet,7354,2,15,6,7,59,39,20,51
Melbourne C,7354,3,14,5,10,45,35,10,47
Melbourne V,7354,4,13,5,11,48,42,6,44
Adelaide Utd,7354,5,11,6,11,37,40,-3,39
Brisbane,7354,6,10,5,13,33,42,-9,35
Western Sydn,7354,7,8,9,10,38,47,-9,33
Perth Glory,7354,8,10,2,15,37,50,-13,32
Wellington P,7354,9,5,6,16,31,55,-24,21
CC Mariners,7354,10,4,8,15,28,49,-21,20
Sydney FC,7355,1,21,4,3,67,22,45,67
N'castle Jet,7355,2,15,6,7,58,38,20,51
Melbourne C,7355,3,14,5,10,44,34,10,47
Melbourne V,7355,4,13,5,11,45,41,4,44
Adelaide Utd,7355,5,11,6,11,37,40,-3,39
Brisbane,7355,6,10,5,13,33,42,-9,35
Western Sydn,7355,7,8,9,10,38,47,-9,33
Perth Glory,7355,8,10,2,15,37,50,-13,32
Wellington P,7355,9,5,6,16,31,55,-24,21
CC Mariners,7355,10,4,8,15,28,49,-21,20
Sydney FC,7356,1,20,5,3,66,24,42,65
N'castle Jet,7356,2,16,5,7,58,37,21,53
Melbourne C,7356,3,14,4,11,43,34,9,46
Melbourne V,7356,4,13,6,10,47,40,7,45
Adelaide Utd,7356,5,11,6,11,37,40,-3,39
Brisbane,7356,6,10,5,13,33,42,-9,35
Western Sydn,7356,7,8,9,10,38,47,-9,33
Perth Glory,7356,8,10,2,15,37,50,-13,32
Wellington P,7356,9,5,6,16,31,55,-24,21
CC Mariners,7356,10,4,8,15,28,49,-21,20
Sydney FC,7357,1,21,4,3,66,22,44,67
N'castle Jet,7357,2,15,6,7,59,39,20,51
Melbourne C,7357,3,14,5,10,45,35,10,47
Melbourne V,7357,4,13,5,11,45,40,5,44
Adelaide Utd,7357,5,11,6,11,37,40,-3,39
Brisbane,7357,6,10,5,13,33,42,-9,35
Western Sydn,7357,7,8,9,10,38,47,-9,33
Perth Glory,7357,8,10,2,15,37,50,-13,32
Wellington P,7357,9,5,6,16,31,55,-24,21
CC Mariners,7357,10,4,8,15,28,49,-21,20
Sydney FC,7358,1,21,4,3,67,23,44,67
N'castle Jet,7358,2,16,5,7,59,38,21,53
Melbourne C,7358,3,14,4,11,44,35,9,46
Melbourne V,7358,4,13,5,11,46,41,5,44
Adelaide Utd,7358,5,11,6,11,37,40,-3,39
Brisbane,7358,6,10,5,13,33,42,-9,35
Western Sydn,7358,7,8,9,10,38,47,-9,33
Perth Glory,7358,8,10,2,15,37,50,-13,32
Wellington P,7358,9,5,6,16,31,55,-24,21
CC Mariners,7358,10,4,8,15,28,49,-21,20
Sydney FC,7359,1,21,4,3,69,23,46,67
N'castle Jet,7359,2,16,5,7,59,38,21,53
Melbourne C,7359,3,14,4,11,44,35,9,46
Melbourne V,7359,4,13,5,11,46,43,3,44
Adelaide Utd,7359,5,11,6,11,37,40,-3,39
Brisbane,7359,6,10,5,13,33,42,-9,35
Western Sydn,7359,7,8,9,10,38,47,-9,33
Perth Glory,7359,8,10,2,15,37,50,-13,32
Wellington P,7359,9,5,6,16,31,55,-24,21
CC Mariners,7359,10,4,8,15,28,49,-21,20
Sydney FC,7360,1,21,4,3,66,22,44,67
N'castle Jet,7360,2,16,5,7,59,38,21,53
Melbourne C,7360,3,14,4,11,44,35,9,46
Melbourne V,7360,4,13,5,11,45,40,5,44
Adelaide Utd,7360,5,11,6,11,37,40,-3,39
Brisbane,7360,6,10,5,13,33,42,-9,35
Western Sydn,7360,7,8,9,10,38,47,-9,33
Perth Glory,7360,8,10,2,15,37,50,-13,32
Wellington P,7360,9,5,6,16,31,55,-24,21
CC Mariners,7360,10,4,8,15,28,49,-21,20
Sydney FC,7361,1,21,4,3,67,22,45,67
N'castle Jet,7361,2,16,5,7,58,37,21,53
Melbourne C,7361,3,14,4,11,43,34,9,46
Melbourne V,7361,4,13,5,11,45,41,4,44
Adelaide Utd,7361,5,11,6,11,37,40,-3,39
Brisbane,7361,6,10,5,13,33,42,-9,35
Western Sydn,7361,7,8,9,10,38,47,-9,33
Perth Glory,7361,8,10,2,15,37,50,-13,32
Wellington P,7361,9,5,6,16,31,55,-24,21
CC Mariners,7361,10,4,8,15,28,49,-21,20
Sydney FC,7362,1,21,4,3,66,22,44,67
N'castle Jet,7362,2,15,5,8,57,40,17,50
Melbourne C,7362,3,15,4,10,46,33,13,49
Melbourne V,7362,4,13,5,11,45,40,5,44
Adelaide Utd,7362,5,11,6,11,37,40,-3,39
Brisbane,7362,6,10,5,13,33,42,-9,35
Western Sydn,7362,7,8,9,10,38,47,-9,33
Perth Glory,7362,8,10,2,15,37,50,-13,32
Wellington P,7362,9,5,6,16,31,55,-24,21
CC Mariners,7362,10,4,8,15,28,49,-21,20
Sydney FC,7363,1,21,4,3,68,24,44,67
N'castle Jet,7363,2,16,5,7,60,39,21,53
Melbourne C,7363,3,14,4,11,45,36,9,46
Melbourne V,7363,4,13,5,11,47,42,5,44
Adelaide Utd,7363,5,11,6,11,37,40,-3,39
Brisbane,7363,6,10,5,13,33,42,-9,35
Western Sydn,7363,7,8,9,10,38,47,-9,33
Perth Glory,7363,8,10,2,15,37,50,-13,32
Wellington P,7363,9,5,6,16,31,55,-24,21
CC Mariners,7363,10,4,8,15,28,49,-21,20
Sydney FC,7364,1,21,4,3,65,22,43,67
N'castle Jet,7364,2,15,6,7,58,38,20,51
Melbourne C,7364,3,14,5,10,44,34,10,47
Melbourne V,7364,4,13,5,11,45,39,6,44
Adelaide Utd,7364,5,11,6,11,37,40,-3,39
Brisbane,7364,6,10,5,13,33,42,-9,35
Western Sydn,7364,7,8,9,10,38,47,-9,33
Perth Glory,7364,8,10,2,15,37,50,-13,32
Wellington P,7364,9,5,6,16,31,55,-24,21
CC Mariners,7364,10,4,8,15,28,49,-21,20
Sydney FC,7365,1,21,4,3,66,22,44,67
N'castle Jet,7365,2,15,6,7,58,38,20,51
Melbourne C,7365,3,14,5,10,44,34,10,47
Melbourne V,7365,4,13,5,11,45,40,5,44
Adelaide Utd,7365,5,11,6,11,37,40,-3,39
Brisbane,7365,6,10,5,13,33,42,-9,35
Western Sydn,7365,7,8,9,10,38,47,-9,33
Perth Glory,7365,8,10,2,15,37,50,-13,32
Wellington P,7365,9,5,6,16,31,55,-24,21
CC Mariners,7365,10,4,8,15,28,49,-21,20
Sydney FC,7366,1,21,4,3,68,22,46,67
N'castle Jet,7366,2,15,5,8,58,39,19,50
Melbourne C,7366,3,15,4,10,45,34,11,49
Melbourne V,7366,4,13,5,11,45,42,3,44
Adelaide Utd,7366,5,11,6,11,37,40,-3,39
Brisbane,7366,6,10,5,13,33,42,-9,35
Western Sydn,7366,7,8,9,10,38,47,-9,33
Perth Glory,7366,8,10,2,15,37,50,-13,32
Wellington P,7366,9,5,6,16,31,55,-24,21
CC Mariners,7366,10,4,8,15,28,49,-21,20
Sydney FC,7367,1,21,4,3,67,22,45,67
N'castle Jet,7367,2,15,6,7,58,38,20,51
Melbourne C,7367,3,14,5,10,44,34,10,47
Melbourne V,7367,4,13,5,11,45,41,4,44
Adelaide Utd,7367,5,11,6,11,37,40,-3,39
Brisbane,7367,6,10,5,13,33,42,-9,35
Western Sydn,7367,7,8,9,10,38,47,-9,33
Perth Glory,7367,8,10,2,15,37,50,-13,32
Wellington P,7367,9,5,6,16,31,55,-24,21
CC Mariners,7367,10,4,8,15,28,49,-21,20
Sydney FC,7368,1,21,4,3,66,23,43,67
N'castle Jet,7368,2,16,5,7,59,37,22,53
Melbourne C,7368,3,14,4,11,43,35,8,46
Melbourne V,7368,4,13,5,11,46,40,6,44
Adelaide Utd,7368,5,11,6,11,37,40,-3,39
Brisbane,7368,6,10,5,13,33,42,-9,35
Western Sydn,7368,7,8,9,10,38,47,-9,33
Perth Glory,7368,8,10,2,15,37,50,-13,32
Wellington P,7368,9,5,6,16,31,55,-24,21
CC Mariners,7368,10,4,8,15,28,49,-21,20
Sydney FC,7369,1,20,5,3,66,24,42,65
N'castle Jet,7369,2,16,5,7,58,37,21,53
Melbourne C,7369,3,14,4,11,43,34,9,46
Melbourne V,7369,4,13,6,10,47,40,7,45
Adelaide Utd,7369,5,11,6,11,37,40,-3,39
Brisbane,7369,6,10,5,13,33,42,-9,35
Western Sydn,7369,7,8,9,10,38,47,-9,33
Perth Glory,7369,8,10,2,15,37,50,-13,32
Wellington P,7369,9,5,6,16,31,55,-24,21
CC Mariners,7369,10,4,8,15,28,49,-21,20
Sydney FC,7370,1,21,4,3,66,23,43,67
N'castle Jet,7370,2,15,6,7,59,39,20,51
Melbourne C,7370,3,14,5,10,45,35,10,47
Melbourne V,7370,4,13,5,11,46,40,6,44
Adelaide Utd,7370,5,11,6,11,37,40,-3,39
Brisbane,7370,6,10,5,13,33,42,-9,35
Western Sydn,7370,7,8,9,10,38,47,-9,33
Perth Glory,7370,8,10,2,15,37,50,-13,32
Wellington P,7370,9,5,6,16,31,55,-24,21
CC Mariners,7370,10,4,8,15,28,49,-21,20
Sydney FC,7371,1,20,5,3,65,23,42,65
N'castle Jet,7371,2,15,6,7,61,41,20,51
Melbourne C,7371,3,14,5,10,47,37,10,47
Melbourne V,7371,4,13,6,10,46,39,7,45
Adelaide Utd,7371,5,11,6,11,37,40,-3,39
Brisbane,7371,6,10,5,13,33,42,-9,35
Western Sydn,7371,7,8,9,10,38,47,-9,33
Perth Glory,7371,8,10,2,15,37,50,-13,32
Wellington P,7371,9,5,6,16,31,55,-24,21
CC Mariners,7371,10,4,8,15,28,49,-21,20
Sydney FC,7372,1,21,4,3,66,22,44,67
N'castle Jet,7372,2,16,5,7,61,40,21,53
Melbourne C,7372,3,14,4,11,46,37,9,46
Melbourne V,7372,4,13,5,11,45,40,5,44
Adelaide Utd,7372,5,11,6,11,37,40,-3,39
Brisbane,7372,6,10,5,13,33,42,-9,35
Western Sydn,7372,7,8,9,10,38,47,-9,33
Perth Glory,7372,8,10,2,15,37,50,-13,32
Wellington P,7372,9,5,6,16,31,55,-24,21
CC Mariners,7372,10,4,8,15,28,49,-21,20
Sydney FC,7373,1,21,4,3,67,24,43,67
N'castle Jet,7373,2,16,5,7,58,37,21,53
Melbourne C,7373,3,14,4,11,43,34,9,46
Melbourne V,7373,4,13,5,11,47,41,6,44
Adelaide Utd,7373,5,11,6,11,37,40,-3,39
Brisbane,7373,6,10,5,13,33,42,-9,35
Western Sydn,7373,7,8,9,10,38,47,-9,33
Perth Glory,7373,8,10,2,15,37,50,-13,32
Wellington P,7373,9,5,6,16,31,55,-24,21
CC Mariners,7373,10,4,8,15,28,49,-21,20
Sydney FC,7374,1,20,4,4,65,24,41,64
N'castle Jet,7374,2,15,6,7,59,39,20,51
Melbourne C,7374,3,14,5,10,45,35,10,47
Melbourne V,7374,4,14,5,10,47,39,8,47
Adelaide Utd,7374,5,11,6,11,37,40,-3,39
Brisbane,7374,6,10,5,13,33,42,-9,35
Western Sydn,7374,7,8,9,10,38,47,-9,33
Perth Glory,7374,8,10,2,15,37,50,-13,32
Wellington P,7374,9,5,6,16,31,55,-24,21
CC Mariners,7374,10,4,8,15,28,49,-21,20
Sydney FC,7375,1,21,4,3,67,22,45,67
N'castle Jet,7375,2,15,6,7,57,37,20,51
Melbourne C,7375,3,14,5,10,43,33,10,47
Melbourne V,7375,4,13,5,11,45,41,4,44
Adelaide Utd,7375,5,11,6,11,37,40,-3,39
Brisbane,7375,6,10,5,13,33,42,-9,35
Western Sydn,7375,7,8,9,10,38,47,-9,33
Perth Glory,7375,8,10,2,15,37,50,-13,32
Wellington P,7375,9,5,6,16,31,55,-24,21
CC Mariners,7375,10,4,8,15,28,49,-21,20
Sydney FC,7376,1,21,4,3,67,24,43,67
N'castle Jet,7376,2,16,5,7,59,38,21,53
Melbourne C,7376,3,14,4,11,44,35,9,46
Melbourne V,7376,4,13,5,11,47,41,6,44
Adelaide Utd,7376,5,11,6,11,37,40,-3,39
Brisbane,7376,6,10,5,13,33,42,-9,35
Western Sydn,7376,7,8,9,10,38,47,-9,33
Perth Glory,7376,8,10,2,15,37,50,-13,32
Wellington P,7376,9,5,6,16,31,55,-24,21
CC Mariners,7376,10,4,8,15,28,49,-21,20
Sydney FC,7377,1,20,4,4,64,25,39,64
N'castle Jet,7377,2,16,5,7,60,38,22,53
Melbourne V,7377,3,14,5,10,48,38,10,47
Melbourne C,7377,4,14,4,11,44,36,8,46
Adelaide Utd,7377,5,11,6,11,37,40,-3,39
Brisbane,7377,6,10,5,13,33,42,-9,35
Western Sydn,7377,7,8,9,10,38,47,-9,33
Perth Glory,7377,8,10,2,15,37,50,-13,32
Wellington P,7377,9,5,6,16,31,55,-24,21
CC Mariners,7377,10,4,8,15,28,49,-21,20
Sydney FC,7378,1,21,4,3,65,22,43,67
N'castle Jet,7378,2,15,6,7,58,38,20,51
Melbourne C,7378,3,14,5,10,44,34,10,47
Melbourne V,7378,4,13,5,11,45,39,6,44
Adelaide Utd,7378,5,11,6,11,37,40,-3,39
Brisbane,7378,6,10,5,13,33,42,-9,35
Western Sydn,7378,7,8,9,10,38,47,-9,33
Perth Glory,7378,8,10,2,15,37,50,-13,32
Wellington P,7378,9,5,6,16,31,55,-24,21
CC Mariners,7378,10,4,8,15,28,49,-21,20
Sydney FC,7379,1,21,4,3,67,22,45,67
N'castle Jet,7379,2,16,5,7,60,38,22,53
Melbourne C,7379,3,14,4,11,44,36,8,46
Melbourne V,7379,4,13,5,11,45,41,4,44
Adelaide Utd,7379,5,11,6,11,37,40,-3,39
Brisbane,7379,6,10,5,13,33,42,-9,35
Western Sydn,7379,7,8,9,10,38,47,-9,33
Perth Glory,7379,8,10,2,15,37,50,-13,32
Wellington P,7379,9,5,6,16,31,55,-24,21
CC Mariners,7379,10,4,8,15,28,49,-21,20
Sydney FC,7380,1,20,5,3,65,23,42,65
N'castle Jet,7380,2,15,6,7,57,37,20,51
Melbourne C,7380,3,14,5,10,43,33,10,47
Melbourne V,7380,4,13,6,10,46,39,7,45
Adelaide Utd,7380,5,11,6,11,37,40,-3,39
Brisbane,7380,6,10,5,13,33,42,-9,35
Western Sydn,7380,7,8,9,10,38,47,-9,33
Perth Glory,7380,8,10,2,15,37,50,-13,32
Wellington P,7380,9,5,6,16,31,55,-24,21
CC Mariners,7380,10,4,8,15,28,49,-21,20
Sydney FC,7381,1,21,4,3,67,23,44,67
N'castle Jet,7381,2,16,5,7,59,38,21,53
Melbourne C,7381,3,14,4,11,44,35,9,46
Melbourne V,7381,4,13,5,11,46,41,5,44
Adelaide Utd,7381,5,11,6,11,37,40,-3,39
Brisbane,7381,6,10,5,13,33,42,-9,35
Western Sydn,7381,7,8,9,10,38,47,-9,33
Perth Glory,7381,8,10,2,15,37,50,-13,32
Wellington P,7381,9,5,6,16,31,55,-24,21
CC Mariners,7381,10,4,8,15,28,49,-21,20
Sydney FC,7382,1,21,4,3,67,22,45,67
N'castle Jet,7382,2,15,5,8,57,38,19,50
Melbourne C,7382,3,15,4,10,44,33,11,49
Melbourne V,7382,4,13,5,11,45,41,4,44
Adelaide Utd,7382,5,11,6,11,37,40,-3,39
Brisbane,7382,6,10,5,13,33,42,-9,35
Western Sydn,7382,7,8,9,10,38,47,-9,33
Perth Glory,7382,8,10,2,15,37,50,-13,32
Wellington P,7382,9,5,6,16,31,55,-24,21
CC Mariners,7382,10,4,8,15,28,49,-21,20
Sydney FC,7383,1,20,4,4,66,25,41,64
N'castle Jet,7383,2,16,5,7,61,40,21,53
Melbourne V,7383,3,14,5,10,48,40,8,47
Melbourne C,7383,4,14,4,11,46,37,9,46
Adelaide Utd,7383,5,11,6,11,37,40,-3,39
Brisbane,7383,6,10,5,13,33,42,-9,35
Western Sydn,7383,7,8,9,10,38,47,-9,33
Perth Glory,7383,8,10,2,15,37,50,-13,32
Wellington P,7383,9,5,6,16,31,55,-24,21
CC Mariners,7383,10,4,8,15,28,49,-21,20
Sydney FC,7384,1,20,5,3,64,22,42,65
N'castle Jet,7384,2,15,5,8,59,41,18,50
Melbourne C,7384,3,15,4,10,47,35,12,49
Melbourne V,7384,4,13,6,10,45,38,7,45
Adelaide Utd,7384,5,11,6,11,37,40,-3,39
Brisbane,7384,6,10,5,13,33,42,-9,35
Western Sydn,7384,7,8,9,10,38,47,-9,33
Perth Glory,7384,8,10,2,15,37,50,-13,32
Wellington P,7384,9,5,6,16,31,55,-24,21
CC Mariners,7384,10,4,8,15,28,49,-21,20
Sydney FC,7385,1,20,5,3,64,22,42,65
N'castle Jet,7385,2,15,5,8,57,38,19,50
Melbourne C,7385,3,15,4,10,44,33,11,49
Melbourne V,7385,4,13,6,10,45,38,7,45
Adelaide Utd,7385,5,11,6,11,37,40,-3,39
Brisbane,7385,6,10,5,13,33,42,-9,35
Western Sydn,7385,7,8,9,10,38,47,-9,33
Perth Glory,7385,8,10,2,15,37,50,-13,32
Wellington P,7385,9,5,6,16,31,55,-24,21
CC Mariners,7385,10,4,8,15,28,49,-21,20
Sydney FC,7386,1,21,4,3,67,22,45,67
N'castle Jet,7386,2,16,5,7,60,38,22,53
Melbourne C,7386,3,14,4,11,44,36,8,46
Melbourne V,7386,4,13,5,11,45,41,4,44
Adelaide Utd,7386,5,11,6,11,37,40,-3,39
Brisbane,7386,6,10,5,13,33,42,-9,35
Western Sydn,7386,7,8,9,10,38,47,-9,33
Perth Glory,7386,8,10,2,15,37,50,-13,32
Wellington P,7386,9,5,6,16,31,55,-24,21
CC Mariners,7386,10,4,8,15,28,49,-21,20
Sydney FC,7387,1,20,4,4,67,26,41,64
N'castle Jet,7387,2,16,5,7,61,38,23,53
Melbourne V,7387,3,14,5,10,49,41,8,47
Melbourne C,7387,4,14,4,11,44,37,7,46
Adelaide Utd,7387,5,11,6,11,37,40,-3,39
Brisbane,7387,6,10,5,13,33,42,-9,35
Western Sydn,7387,7,8,9,10,38,47,-9,33
Perth Glory,7387,8,10,2,15,37,50,-13,32
Wellington P,7387,9,5,6,16,31,55,-24,21
CC Mariners,7387,10,4,8,15,28,49,-21,20
Sydney FC,7388,1,20,4,4,65,24,41,64
N'castle Jet,7388,2,15,5,8,58,40,18,50
Melbourne C,7388,3,15,4,10,46,34,12,49
Melbourne V,7388,4,14,5,10,47,39,8,47
Adelaide Utd,7388,5,11,6,11,37,40,-3,39
Brisbane,7388,6,10,5,13,33,42,-9,35
Western Sydn,7388,7,8,9,10,38,47,-9,33
Perth Glory,7388,8,10,2,15,37,50,-13,32
Wellington P,7388,9,5,6,16,31,55,-24,21
CC Mariners,7388,10,4,8,15,28,49,-21,20
Sydney FC,7389,1,21,4,3,67,22,45,67
N'castle Jet,7389,2,15,5,8,57,38,19,50
Melbourne C,7389,3,15,4,10,44,33,11,49
Melbourne V,7389,4,13,5,11,45,41,4,44
Adelaide Utd,7389,5,11,6,11,37,40,-3,39
Brisbane,7389,6,10,5,13,33,42,-9,35
Western Sydn,7389,7,8,9,10,38,47,-9,33
Perth Glory,7389,8,10,2,15,37,50,-13,32
Wellington P,7389,9,5,6,16,31,55,-24,21
CC Mariners,7389,10,4,8,15,28,49,-21,20
Sydney FC,7390,1,20,4,4,65,24,41,64
N'castle Jet,7390,2,15,5,8,57,40,17,50
Melbourne C,7390,3,15,4,10,46,33,13,49
Melbourne V,7390,4,14,5,10,47,39,8,47
Adelaide Utd,7390,5,11,6,11,37,40,-3,39
Brisbane,7390,6,10,5,13,33,42,-9,35
Western Sydn,7390,7,8,9,10,38,47,-9,33
Perth Glory,7390,8,10,2,15,37,50,-13,32
Wellington P,7390,9,5,6,16,31,55,-24,21
CC Mariners,7390,10,4,8,15,28,49,-21,20
Sydney FC,7391,1,21,4,3,66,22,44,67
N'castle Jet,7391,2,15,6,7,57,37,20,51
Melbourne C,7391,3,14,5,10,43,33,10,47
Melbourne V,7391,4,13,5,11,45,40,5,44
Adelaide Utd,7391,5,11,6,11,37,40,-3,39
Brisbane,7391,6,10,5,13,33,42,-9,35
Western Sydn,7391,7,8,9,10,38,47,-9,33
Perth Glory,7391,8,10,2,15,37,50,-13,32
Wellington P,7391,9,5,6,16,31,55,-24,21
CC Mariners,7391,10,4,8,15,28,49,-21,20
Sydney FC,7392,1,21,4,3,66,22,44,67
N'castle Jet,7392,2,16,5,7,59,37,22,53
Melbourne C,7392,3,14,4,11,43,35,8,46
Melbourne V,7392,4,13,5,11,45,40,5,44
Adelaide Utd,7392,5,11,6,11,37,40,-3,39
Brisbane,7392,6,10,5,13,33,42,-9,35
Western Sydn,7392,7,8,9,10,38,47,-9,33
Perth Glory,7392,8,10,2,15,37,50,-13,32
Wellington P,7392,9,5,6,16,31,55,-24,21
CC Mariners,7392,10,4,8,15,28,49,-21,20
Sydney FC,7393,1,21,4,3,68,22,46,67
N'castle Jet,7393,2,16,5,7,59,37,22,53
Melbourne C,7393,3,14,4,11,43,35,8,46
Melbourne V,7393,4,13,5,11,45,42,3,44
Adelaide Utd,7393,5,11,6,11,37,40,-3,39
Brisbane,7393,6,10,5,13,33,42,-9,35
Western Sydn,7393,7,8,9,10,38,47,-9,33
Perth Glory,7393,8,10,2,15,37,50,-13,32
Wellington P,7393,9,5,6,16,31,55,-24,21
CC Mariners,7393,10,4,8,15,28,49,-21,20
Sydney FC,7394,1,21,4,3,65,22,43,67
N'castle Jet,7394,2,16,5,7,60,38,22,53
Melbourne C,7394,3,14,4,11,44,36,8,46
Melbourne V,7394,4,13,5,11,45,39,6,44
Adelaide Utd,7394,5,11,6,11,37,40,-3,39
Brisbane,7394,6,10,5,13,33,42,-9,35
Western Sydn,7394,7,8,9,10,38,47,-9,33
Perth Glory,7394,8,10,2,15,37,50,-13,32
Wellington P,7394,9,5,6,16,31,55,-24,21
CC Mariners,7394,10,4,8,15,28,49,-21,20
Sydney FC,7395,1,21,4,3,67,24,43,67
N'castle Jet,7395,2,16,5,7,59,37,22,53
Melbourne C,7395,3,14,4,11,43,35,8,46
Melbourne V,7395,4,13,5,11,47,41,6,44
Adelaide Utd,7395,5,11,6,11,37,40,-3,39
Brisbane,7395,6,10,5,13,33,42,-9,35
Western Sydn,7395,7,8,9,10,38,47,-9,33
Perth Glory,7395,8,10,2,15,37,50,-13,32
Wellington P,7395,9,5,6,16,31,55,-24,21
CC Mariners,7395,10,4,8,15,28,49,-21,20
Sydney FC,7396,1,21,4,3,65,22,43,67
N'castle Jet,7396,2,16,5,7,58,37,21,53
Melbourne C,7396,3,14,4,11,43,34,9,46
Melbourne V,7396,4,13,5,11,45,39,6,44
Adelaide Utd,7396,5,11,6,11,37,40,-3,39
Brisbane,7396,6,10,5,13,33,42,-9,35
Western Sydn,7396,7,8,9,10,38,47,-9,33
Perth Glory,7396,8,10,2,15,37,50,-13,32
Wellington P,7396,9,5,6,16,31,55,-24,21
CC Mariners,7396,10,4,8,15,28,49,-21,20
Sydney FC,7397,1,20,5,3,66,24,42,65
N'castle Jet,7397,2,16,5,7,60,39,21,53
Melbourne C,7397,3,14,4,11,45,36,9,46
Melbourne V,7397,4,13,6,10,47,40,7,45
Adelaide Utd,7397,5,11,6,11,37,40,-3,39
Brisbane,7397,6,10,5,13,33,42,-9,35
Western Sydn,7397,7,8,9,10,38,47,-9,33
Perth Glory,7397,8,10,2,15,37,50,-13,32
Wellington P,7397,9,5,6,16,31,55,-24,21
CC Mariners,7397,10,4,8,15,28,49,-21,20
Sydney FC,7398,1,21,4,3,69,23,46,67
N'castle Jet,7398,2,15,5,8,58,40,18,50
Melbourne C,7398,3,15,4,10,46,34,12,49
Melbourne V,7398,4,13,5,11,46,43,3,44
Adelaide Utd,7398,5,11,6,11,37,40,-3,39
Brisbane,7398,6,10,5,13,33,42,-9,35
Western Sydn,7398,7,8,9,10,38,47,-9,33
Perth Glory,7398,8,10,2,15,37,50,-13,32
Wellington P,7398,9,5,6,16,31,55,-24,21
CC Mariners,7398,10,4,8,15,28,49,-21,20
Sydney FC,7399,1,21,4,3,67,23,44,67
N'castle Jet,7399,2,16,5,7,60,38,22,53
Melbourne C,7399,3,14,4,11,44,36,8,46
Melbourne V,7399,4,13,5,11,46,41,5,44
Adelaide Utd,7399,5,11,6,11,37,40,-3,39
Brisbane,7399,6,10,5,13,33,42,-9,35
Western Sydn,7399,7,8,9,10,38,47,-9,33
Perth Glory,7399,8,10,2,15,37,50,-13,32
Wellington P,7399,9,5,6,16,31,55,-24,21
CC Mariners,7399,10,4,8,15,28,49,-21,20
Sydney FC,7400,1,20,5,3,65,23,42,65
N'castle Jet,7400,2,15,6,7,58,38,20,51
Melbourne C,7400,3,14,5,10,44,34,10,47
Melbourne V,7400,4,13,6,10,46,39,7,45
Adelaide Utd,7400,5,11,6,11,37,40,-3,39
Brisbane,7400,6,10,5,13,33,42,-9,35
Western Sydn,7400,7,8,9,10,38,47,-9,33
Perth Glory,7400,8,10,2,15,37,50,-13,32
Wellington P,7400,9,5,6,16,31,55,-24,21
CC Mariners,7400,10,4,8,15,28,49,-21,20
Sydney FC,7401,1,20,4,4,65,24,41,64
N'castle Jet,7401,2,15,5,8,60,42,18,50
Melbourne C,7401,3,15,4,10,48,36,12,49
Melbourne V,7401,4,14,5,10,47,39,8,47
Adelaide Utd,7401,5,11,6,11,37,40,-3,39
Brisbane,7401,6,10,5,13,33,42,-9,35
Western Sydn,7401,7,8,9,10,38,47,-9,33
Perth Glory,7401,8,10,2,15,37,50,-13,32
Wellington P,7401,9,5,6,16,31,55,-24,21
CC Mariners,7401,10,4,8,15,28,49,-21,20
Sydney FC,7402,1,21,4,3,66,22,44,67
N'castle Jet,7402,2,15,6,7,59,39,20,51
Melbourne C,7402,3,14,5,10,45,35,10,47
Melbourne V,7402,4,13,5,11,45,40,5,44
Adelaide Utd,7402,5,11,6,11,37,40,-3,39
Brisbane,7402,6,10,5,13,33,42,-9,35
Western Sydn,7402,7,8,9,10,38,47,-9,33
Perth Glory,7402,8,10,2,15,37,50,-13,32
Wellington P,7402,9,5,6,16,31,55,-24,21
CC Mariners,7402,10,4,8,15,28,49,-21,20
Sydney FC,7403,1,20,5,3,65,23,42,65
N'castle Jet,7403,2,16,5,7,59,37,22,53
Melbourne C,7403,3,14,4,11,43,35,8,46
Melbourne V,7403,4,13,6,10,46,39,7,45
Adelaide Utd,7403,5,11,6,11,37,40,-3,39
Brisbane,7403,6,10,5,13,33,42,-9,35
Western Sydn,7403,7,8,9,10,38,47,-9,33
Perth Glory,7403,8,10,2,15,37,50,-13,32
Wellington P,7403,9,5,6,16,31,55,-24,21
CC Mariners,7403,10,4,8,15,28,49,-21,20
Sydney FC,7404,1,21,4,3,67,22,45,67
N'castle Jet,7404,2,15,5,8,57,40,17,50
Melbourne C,7404,3,15,4,10,46,33,13,49
Melbourne V,7404,4,13,5,11,45,41,4,44
Adelaide Utd,7404,5,11,6,11,37,40,-3,39
Brisbane,7404,6,10,5,13,33,42,-9,35
Western Sydn,7404,7,8,9,10,38,47,-9,33
Perth Glory,7404,8,10,2,15,37,50,-13,32
Wellington P,7404,9,5,6,16,31,55,-24,21
CC Mariners,7404,10,4,8,15,28,49,-21,20
Sydney FC,7405,1,21,4,3,68,22,46,67
N'castle Jet,7405,2,16,5,7,59,37,22,53
Melbourne C,7405,3,14,4,11,43,35,8,46
Melbourne V,7405,4,13,5,11,45,42,3,44
Adelaide Utd,7405,5,11,6,11,37,40,-3,39
Brisbane,7405,6,10,5,13,33,42,-9,35
Western Sydn,7405,7,8,9,10,38,47,-9,33
Perth Glory,7405,8,10,2,15,37,50,-13,32
Wellington P,7405,9,5,6,16,31,55,-24,21
CC Mariners,7405,10,4,8,15,28,49,-21,20
Sydney FC,7406,1,21,4,3,66,22,44,67
N'castle Jet,7406,2,16,5,7,60,38,22,53
Melbourne C,7406,3,14,4,11,44,36,8,46
Melbourne V,7406,4,13,5,11,45,40,5,44
Adelaide Utd,7406,5,11,6,11,37,40,-3,39
Brisbane,7406,6,10,5,13,33,42,-9,35
Western Sydn,7406,7,8,9,10,38,47,-9,33
Perth Glory,7406,8,10,2,15,37,50,-13,32
Wellington P,7406,9,5,6,16,31,55,-24,21
CC Mariners,7406,10,4,8,15,28,49,-21,20
Sydney FC,7407,1,21,4,3,68,22,46,67
N'castle Jet,7407,2,16,5,7,58,37,21,53
Melbourne C,7407,3,14,4,11,43,34,9,46
Melbourne V,7407,4,13,5,11,45,42,3,44
Adelaide Utd,7407,5,11,6,11,37,40,-3,39
Brisbane,7407,6,10,5,13,33,42,-9,35
Western Sydn,7407,7,8,9,10,38,47,-9,33
Perth Glory,7407,8,10,2,15,37,50,-13,32
Wellington P,7407,9,5,6,16,31,55,-24,21
CC Mariners,7407,10,4,8,15,28,49,-21,20
Sydney FC,7408,1,21,4,3,67,22,45,67
N'castle Jet,7408,2,16,5,7,59,38,21,53
Melbourne C,7408,3,14,4,11,44,35,9,46
Melbourne V,7408,4,13,5,11,45,41,4,44
Adelaide Utd,7408,5,11,6,11,37,40,-3,39
Brisbane,7408,6,10,5,13,33,42,-9,35
Western Sydn,7408,7,8,9,10,38,47,-9,33
Perth Glory,7408,8,10,2,15,37,50,-13,32
Wellington P,7408,9,5,6,16,31,55,-24,21
CC Mariners,7408,10,4,8,15,28,49,-21,20
Sydney FC,7409,1,21,4,3,66,22,44,67
N'castle Jet,7409,2,16,5,7,59,38,21,53
Melbourne C,7409,3,14,4,11,44,35,9,46
Melbourne V,7409,4,13,5,11,45,40,5,44
Adelaide Utd,7409,5,11,6,11,37,40,-3,39
Brisbane,7409,6,10,5,13,33,42,-9,35
Western Sydn,7409,7,8,9,10,38,47,-9,33
Perth Glory,7409,8,10,2,15,37,50,-13,32
Wellington P,7409,9,5,6,16,31,55,-24,21
CC Mariners,7409,10,4,8,15,28,49,-21,20
Sydney FC,7410,1,21,4,3,66,23,43,67
N'castle Jet,7410,2,16,5,7,59,37,22,53
Melbourne C,7410,3,14,4,11,43,35,8,46
Melbourne V,7410,4,13,5,11,46,40,6,44
Adelaide Utd,7410,5,11,6,11,37,40,-3,39
Brisbane,7410,6,10,5,13,33,42,-9,35
Western Sydn,7410,7,8,9,10,38,47,-9,33
Perth Glory,7410,8,10,2,15,37,50,-13,32
Wellington P,7410,9,5,6,16,31,55,-24,21
CC Mariners,7410,10,4,8,15,28,49,-21,20
Sydney FC,7411,1,21,4,3,68,22,46,67
N'castle Jet,7411,2,15,5,8,59,40,19,50
Melbourne C,7411,3,15,4,10,46,35,11,49
Melbourne V,7411,4,13,5,11,45,42,3,44
Adelaide Utd,7411,5,11,6,11,37,40,-3,39
Brisbane,7411,6,10,5,13,33,42,-9,35
Western Sydn,7411,7,8,9,10,38,47,-9,33
Perth Glory,7411,8,10,2,15,37,50,-13,32
Wellington P,7411,9,5,6,16,31,55,-24,21
CC Mariners,7411,10,4,8,15,28,49,-21,20
Sydney FC,7412,1,20,5,3,65,23,42,65
N'castle Jet,7412,2,16,5,7,59,37,22,53
Melbourne C,7412,3,14,4,11,43,35,8,46
Melbourne V,7412,4,13,6,10,46,39,7,45
Adelaide Utd,7412,5,11,6,11,37,40,-3,39
Brisbane,7412,6,10,5,13,33,42,-9,35
Western Sydn,7412,7,8,9,10,38,47,-9,33
Perth Glory,7412,8,10,2,15,37,50,-13,32
Wellington P,7412,9,5,6,16,31,55,-24,21
CC Mariners,7412,10,4,8,15,28,49,-21,20
Sydney FC,7413,1,21,4,3,67,22,45,67
N'castle Jet,7413,2,15,5,8,58,39,19,50
Melbourne C,7413,3,15,4,10,45,34,11,49
Melbourne V,7413,4,13,5,11,45,41,4,44
Adelaide Utd,7413,5,11,6,11,37,40,-3,39
Brisbane,7413,6,10,5,13,33,42,-9,35
Western Sydn,7413,7,8,9,10,38,47,-9,33
Perth Glory,7413,8,10,2,15,37,50,-13,32
Wellington P,7413,9,5,6,16,31,55,-24,21
CC Mariners,7413,10,4,8,15,28,49,-21,20
Sydney FC,7414,1,20,4,4,64,24,40,64
N'castle Jet,7414,2,16,5,7,60,38,22,53
Melbourne V,7414,3,14,5,10,47,38,9,47
Melbourne C,7414,4,14,4,11,44,36,8,46
Adelaide Utd,7414,5,11,6,11,37,40,-3,39
Brisbane,7414,6,10,5,13,33,42,-9,35
Western Sydn,7414,7,8,9,10,38,47,-9,33
Perth Glory,7414,8,10,2,15,37,50,-13,32
Wellington P,7414,9,5,6,16,31,55,-24,21
CC Mariners,7414,10,4,8,15,28,49,-21,20
Sydney FC,7415,1,21,4,3,68,23,45,67
N'castle Jet,7415,2,16,5,7,59,37,22,53
Melbourne C,7415,3,14,4,11,43,35,8,46
Melbourne V,7415,4,13,5,11,46,42,4,44
Adelaide Utd,7415,5,11,6,11,37,40,-3,39
Brisbane,7415,6,10,5,13,33,42,-9,35
Western Sydn,7415,7,8,9,10,38,47,-9,33
Perth Glory,7415,8,10,2,15,37,50,-13,32
Wellington P,7415,9,5,6,16,31,55,-24,21
CC Mariners,7415,10,4,8,15,28,49,-21,20
Sydney FC,7416,1,21,4,3,65,22,43,67
N'castle Jet,7416,2,15,5,8,57,39,18,50
Melbourne C,7416,3,15,4,10,45,33,12,49
Melbourne V,7416,4,13,5,11,45,39,6,44
Adelaide Utd,7416,5,11,6,11,37,40,-3,39
Brisbane,7416,6,10,5,13,33,42,-9,35
Western Sydn,7416,7,8,9,10,38,47,-9,33
Perth Glory,7416,8,10,2,15,37,50,-13,32
Wellington P,7416,9,5,6,16,31,55,-24,21
CC Mariners,7416,10,4,8,15,28,49,-21,20
Sydney FC,7417,1,21,4,3,66,23,43,67
N'castle Jet,7417,2,16,5,7,60,38,22,53
Melbourne C,7417,3,14,4,11,44,36,8,46
Melbourne V,7417,4,13,5,11,46,40,6,44
Adelaide Utd,7417,5,11,6,11,37,40,-3,39
Brisbane,7417,6,10,5,13,33,42,-9,35
Western Sydn,7417,7,8,9,10,38,47,-9,33
Perth Glory,7417,8,10,2,15,37,50,-13,32
Wellington P,7417,9,5,6,16,31,55,-24,21
CC Mariners,7417,10,4,8,15,28,49,-21,20
Sydney FC,7418,1,21,4,3,67,22,45,67
N'castle Jet,7418,2,16,5,7,59,37,22,53
Melbourne C,7418,3,14,4,11,43,35,8,46
Melbourne V,7418,4,13,5,11,45,41,4,44
Adelaide Utd,7418,5,11,6,11,37,40,-3,39
Brisbane,7418,6,10,5,13,33,42,-9,35
Western Sydn,7418,7,8,9,10,38,47,-9,33
Perth Glory,7418,8,10,2,15,37,50,-13,32
Wellington P,7418,9,5,6,16,31,55,-24,21
CC Mariners,7418,10,4,8,15,28,49,-21,20
Sydney FC,7419,1,21,4,3,67,22,45,67
N'castle Jet,7419,2,16,5,7,61,38,23,53
Melbourne C,7419,3,14,4,11,44,37,7,46
Melbourne V,7419,4,13,5,11,45,41,4,44
Adelaide Utd,7419,5,11,6,11,37,40,-3,39
Brisbane,7419,6,10,5,13,33,42,-9,35
Western Sydn,7419,7,8,9,10,38,47,-9,33
Perth Glory,7419,8,10,2,15,37,50,-13,32
Wellington P,7419,9,5,6,16,31,55,-24,21
CC Mariners,7419,10,4,8,15,28,49,-21,20
Sydney FC,7420,1,21,4,3,68,22,46,67
N'castle Jet,7420,2,16,5,7,60,37,23,53
Melbourne C,7420,3,14,4,11,43,36,7,46
Melbourne V,7420,4,13,5,11,45,42,3,44
Adelaide Utd,7420,5,11,6,11,37,40,-3,39
Brisbane,7420,6,10,5,13,33,42,-9,35
Western Sydn,7420,7,8,9,10,38,47,-9,33
Perth Glory,7420,8,10,2,15,37,50,-13,32
Wellington P,7420,9,5,6,16,31,55,-24,21
CC Mariners,7420,10,4,8,15,28,49,-21,20
Sydney FC,7421,1,20,5,3,65,23,42,65
N'castle Jet,7421,2,16,5,7,58,37,21,53
Melbourne C,7421,3,14,4,11,43,34,9,46
Melbourne V,7421,4,13,6,10,46,39,7,45
Adelaide Utd,7421,5,11,6,11,37,40,-3,39
Brisbane,7421,6,10,5,13,33,42,-9,35
Western Sydn,7421,7,8,9,10,38,47,-9,33
Perth Glory,7421,8,10,2,15,37,50,-13,32
Wellington P,7421,9,5,6,16,31,55,-24,21
CC Mariners,7421,10,4,8,15,28,49,-21,20
Sydney FC,7422,1,21,4,3,67,22,45,67
N'castle Jet,7422,2,15,6,7,57,37,20,51
Melbourne C,7422,3,14,5,10,43,33,10,47
Melbourne V,7422,4,13,5,11,45,41,4,44
Adelaide Utd,7422,5,11,6,11,37,40,-3,39
Brisbane,7422,6,10,5,13,33,42,-9,35
Western Sydn,7422,7,8,9,10,38,47,-9,33
Perth Glory,7422,8,10,2,15,37,50,-13,32
Wellington P,7422,9,5,6,16,31,55,-24,21
CC Mariners,7422,10,4,8,15,28,49,-21,20
Sydney FC,7423,1,20,5,3,66,24,42,65
N'castle Jet,7423,2,16,5,7,58,37,21,53
Melbourne C,7423,3,14,4,11,43,34,9,46
Melbourne V,7423,4,13,6,10,47,40,7,45
Adelaide Utd,7423,5,11,6,11,37,40,-3,39
Brisbane,7423,6,10,5,13,33,42,-9,35
Western Sydn,7423,7,8,9,10,38,47,-9,33
Perth Glory,7423,8,10,2,15,37,50,-13,32
Wellington P,7423,9,5,6,16,31,55,-24,21
CC Mariners,7423,10,4,8,15,28,49,-21,20
Sydney FC,7424,1,21,4,3,69,23,46,67
N'castle Jet,7424,2,16,5,7,59,38,21,53
Melbourne C,7424,3,14,4,11,44,35,9,46
Melbourne V,7424,4,13,5,11,46,43,3,44
Adelaide Utd,7424,5,11,6,11,37,40,-3,39
Brisbane,7424,6,10,5,13,33,42,-9,35
Western Sydn,7424,7,8,9,10,38,47,-9,33
Perth Glory,7424,8,10,2,15,37,50,-13,32
Wellington P,7424,9,5,6,16,31,55,-24,21
CC Mariners,7424,10,4,8,15,28,49,-21,20
Sydney FC,7425,1,21,4,3,66,22,44,67
N'castle Jet,7425,2,16,5,7,61,37,24,53
Melbourne C,7425,3,14,4,11,43,37,6,46
Melbourne V,7425,4,13,5,11,45,40,5,44
Adelaide Utd,7425,5,11,6,11,37,40,-3,39
Brisbane,7425,6,10,5,13,33,42,-9,35
Western Sydn,7425,7,8,9,10,38,47,-9,33
Perth Glory,7425,8,10,2,15,37,50,-13,32
Wellington P,7425,9,5,6,16,31,55,-24,21
CC Mariners,7425,10,4,8,15,28,49,-21,20
Sydney FC,7426,1,21,4,3,67,24,43,67
N'castle Jet,7426,2,15,5,8,58,40,18,50
Melbourne C,7426,3,15,4,10,46,34,12,49
Melbourne V,7426,4,13,5,11,47,41,6,44
Adelaide Utd,7426,5,11,6,11,37,40,-3,39
Brisbane,7426,6,10,5,13,33,42,-9,35
Western Sydn,7426,7,8,9,10,38,47,-9,33
Perth Glory,7426,8,10,2,15,37,50,-13,32
Wellington P,7426,9,5,6,16,31,55,-24,21
CC Mariners,7426,10,4,8,15,28,49,-21,20
Sydney FC,7427,1,21,4,3,68,22,46,67
N'castle Jet,7427,2,16,5,7,62,38,24,53
Melbourne C,7427,3,14,4,11,44,38,6,46
Melbourne V,7427,4,13,5,11,45,42,3,44
Adelaide Utd,7427,5,11,6,11,37,40,-3,39
Brisbane,7427,6,10,5,13,33,42,-9,35
Western Sydn,7427,7,8,9,10,38,47,-9,33
Perth Glory,7427,8,10,2,15,37,50,-13,32
Wellington P,7427,9,5,6,16,31,55,-24,21
CC Mariners,7427,10,4,8,15,28,49,-21,20
Sydney FC,7428,1,21,4,3,67,22,45,67
N'castle Jet,7428,2,16,5,7,59,37,22,53
Melbourne C,7428,3,14,4,11,43,35,8,46
Melbourne V,7428,4,13,5,11,45,41,4,44
Adelaide Utd,7428,5,11,6,11,37,40,-3,39
Brisbane,7428,6,10,5,13,33,42,-9,35
Western Sydn,7428,7,8,9,10,38,47,-9,33
Perth Glory,7428,8,10,2,15,37,50,-13,32
Wellington P,7428,9,5,6,16,31,55,-24,21
CC Mariners,7428,10,4,8,15,28,49,-21,20
Sydney FC,7429,1,21,4,3,67,22,45,67
N'castle Jet,7429,2,15,5,8,58,39,19,50
Melbourne C,7429,3,15,4,10,45,34,11,49
Melbourne V,7429,4,13,5,11,45,41,4,44
Adelaide Utd,7429,5,11,6,11,37,40,-3,39
Brisbane,7429,6,10,5,13,33,42,-9,35
Western Sydn,7429,7,8,9,10,38,47,-9,33
Perth Glory,7429,8,10,2,15,37,50,-13,32
Wellington P,7429,9,5,6,16,31,55,-24,21
CC Mariners,7429,10,4,8,15,28,49,-21,20
Sydney FC,7430,1,20,5,3,64,22,42,65
N'castle Jet,7430,2,16,5,7,59,37,22,53
Melbourne C,7430,3,14,4,11,43,35,8,46
Melbourne V,7430,4,13,6,10,45,38,7,45
Adelaide Utd,7430,5,11,6,11,37,40,-3,39
Brisbane,7430,6,10,5,13,33,42,-9,35
Western Sydn,7430,7,8,9,10,38,47,-9,33
Perth Glory,7430,8,10,2,15,37,50,-13,32
Wellington P,7430,9,5,6,16,31,55,-24,21
CC Mariners,7430,10,4,8,15,28,49,-21,20
Sydney FC,7431,1,21,4,3,66,22,44,67
N'castle Jet,7431,2,15,6,7,57,37,20,51
Melbourne C,7431,3,14,5,10,43,33,10,47
Melbourne V,7431,4,13,5,11,45,40,5,44
Adelaide Utd,7431,5,11,6,11,37,40,-3,39
Brisbane,7431,6,10,5,13,33,42,-9,35
Western Sydn,7431,7,8,9,10,38,47,-9,33
Perth Glory,7431,8,10,2,15,37,50,-13,32
Wellington P,7431,9,5,6,16,31,55,-24,21
CC Mariners,7431,10,4,8,15,28,49,-21,20
Sydney FC,7432,1,21,4,3,66,22,44,67
N'castle Jet,7432,2,15,5,8,58,40,18,50
Melbourne C,7432,3,15,4,10,46,34,12,49
Melbourne V,7432,4,13,5,11,45,40,5,44
Adelaide Utd,7432,5,11,6,11,37,40,-3,39
Brisbane,7432,6,10,5,13,33,42,-9,35
Western Sydn,7432,7,8,9,10,38,47,-9,33
Perth Glory,7432,8,10,2,15,37,50,-13,32
Wellington P,7432,9,5,6,16,31,55,-24,21
CC Mariners,7432,10,4,8,15,28,49,-21,20
Sydney FC,7433,1,20,4,4,66,25,41,64
N'castle Jet,7433,2,15,5,8,58,40,18,50
Melbourne C,7433,3,15,4,10,46,34,12,49
Melbourne V,7433,4,14,5,10,48,40,8,47
Adelaide Utd,7433,5,11,6,11,37,40,-3,39
Brisbane,7433,6,10,5,13,33,42,-9,35
Western Sydn,7433,7,8,9,10,38,47,-9,33
Perth Glory,7433,8,10,2,15,37,50,-13,32
Wellington P,7433,9,5,6,16,31,55,-24,21
CC Mariners,7433,10,4,8,15,28,49,-21,20
Sydney FC,7434,1,20,5,3,66,24,42,65
N'castle Jet,7434,2,15,6,7,57,37,20,51
Melbourne C,7434,3,14,5,10,43,33,10,47
Melbourne V,7434,4,13,6,10,47,40,7,45
Adelaide Utd,7434,5,11,6,11,37,40,-3,39
Brisbane,7434,6,10,5,13,33,42,-9,35
Western Sydn,7434,7,8,9,10,38,47,-9,33
Perth Glory,7434,8,10,2,15,37,50,-13,32
Wellington P,7434,9,5,6,16,31,55,-24,21
CC Mariners,7434,10,4,8,15,28,49,-21,20
Sydney FC,7435,1,21,4,3,65,22,43,67
N'castle Jet,7435,2,15,5,8,59,41,18,50
Melbourne C,7435,3,15,4,10,47,35,12,49
Melbourne V,7435,4,13,5,11,45,39,6,44
Adelaide Utd,7435,5,11,6,11,37,40,-3,39
Brisbane,7435,6,10,5,13,33,42,-9,35
Western Sydn,7435,7,8,9,10,38,47,-9,33
Perth Glory,7435,8,10,2,15,37,50,-13,32
Wellington P,7435,9,5,6,16,31,55,-24,21
CC Mariners,7435,10,4,8,15,28,49,-21,20
Sydney FC,7436,1,21,4,3,66,22,44,67
N'castle Jet,7436,2,15,6,7,58,38,20,51
Melbourne C,7436,3,14,5,10,44,34,10,47
Melbourne V,7436,4,13,5,11,45,40,5,44
Adelaide Utd,7436,5,11,6,11,37,40,-3,39
Brisbane,7436,6,10,5,13,33,42,-9,35
Western Sydn,7436,7,8,9,10,38,47,-9,33
Perth Glory,7436,8,10,2,15,37,50,-13,32
Wellington P,7436,9,5,6,16,31,55,-24,21
CC Mariners,7436,10,4,8,15,28,49,-21,20
Sydney FC,7437,1,21,4,3,68,22,46,67
N'castle Jet,7437,2,15,6,7,59,39,20,51
Melbourne C,7437,3,14,5,10,45,35,10,47
Melbourne V,7437,4,13,5,11,45,42,3,44
Adelaide Utd,7437,5,11,6,11,37,40,-3,39
Brisbane,7437,6,10,5,13,33,42,-9,35
Western Sydn,7437,7,8,9,10,38,47,-9,33
Perth Glory,7437,8,10,2,15,37,50,-13,32
Wellington P,7437,9,5,6,16,31,55,-24,21
CC Mariners,7437,10,4,8,15,28,49,-21,20
Sydney FC,7438,1,21,4,3,67,24,43,67
N'castle Jet,7438,2,15,5,8,59,40,19,50
Melbourne C,7438,3,15,4,10,46,35,11,49
Melbourne V,7438,4,13,5,11,47,41,6,44
Adelaide Utd,7438,5,11,6,11,37,40,-3,39
Brisbane,7438,6,10,5,13,33,42,-9,35
Western Sydn,7438,7,8,9,10,38,47,-9,33
Perth Glory,7438,8,10,2,15,37,50,-13,32
Wellington P,7438,9,5,6,16,31,55,-24,21
CC Mariners,7438,10,4,8,15,28,49,-21,20
Sydney FC,7439,1,20,5,3,66,24,42,65
N'castle Jet,7439,2,16,5,7,60,38,22,53
Melbourne C,7439,3,14,4,11,44,36,8,46
Melbourne V,7439,4,13,6,10,47,40,7,45
Adelaide Utd,7439,5,11,6,11,37,40,-3,39
Brisbane,7439,6,10,5,13,33,42,-9,35
Western Sydn,7439,7,8,9,10,38,47,-9,33
Perth Glory,7439,8,10,2,15,37,50,-13,32
Wellington P,7439,9,5,6,16,31,55,-24,21
CC Mariners,7439,10,4,8,15,28,49,-21,20
Sydney FC,7440,1,20,4,4,64,23,41,64
N'castle Jet,7440,2,15,5,8,58,39,19,50
Melbourne C,7440,3,15,4,10,45,34,11,49
Melbourne V,7440,4,14,5,10,46,38,8,47
Adelaide Utd,7440,5,11,6,11,37,40,-3,39
Brisbane,7440,6,10,5,13,33,42,-9,35
Western Sydn,7440,7,8,9,10,38,47,-9,33
Perth Glory,7440,8,10,2,15,37,50,-13,32
Wellington P,7440,9,5,6,16,31,55,-24,21
CC Mariners,7440,10,4,8,15,28,49,-21,20
Sydney FC,7441,1,20,5,3,65,23,42,65
N'castle Jet,7441,2,16,5,7,59,37,22,53
Melbourne C,7441,3,14,4,11,43,35,8,46
Melbourne V,7441,4,13,6,10,46,39,7,45
Adelaide Utd,7441,5,11,6,11,37,40,-3,39
Brisbane,7441,6,10,5,13,33,42,-9,35
Western Sydn,7441,7,8,9,10,38,47,-9,33
Perth Glory,7441,8,10,2,15,37,50,-13,32
Wellington P,7441,9,5,6,16,31,55,-24,21
CC Mariners,7441,10,4,8,15,28,49,-21,20
Sydney FC,7442,1,20,5,3,64,22,42,65
N'castle Jet,7442,2,15,6,7,57,37,20,51
Melbourne C,7442,3,14,5,10,43,33,10,47
Melbourne V,7442,4,13,6,10,45,38,7,45
Adelaide Utd,7442,5,11,6,11,37,40,-3,39
Brisbane,7442,6,10,5,13,33,42,-9,35
Western Sydn,7442,7,8,9,10,38,47,-9,33
Perth Glory,7442,8,10,2,15,37,50,-13,32
Wellington P,7442,9,5,6,16,31,55,-24,21
CC Mariners,7442,10,4,8,15,28,49,-21,20
Sydney FC,7443,1,21,4,3,68,22,46,67
N'castle Jet,7443,2,15,6,7,58,38,20,51
Melbourne C,7443,3,14,5,10,44,34,10,47
Melbourne V,7443,4,13,5,11,45,42,3,44
Adelaide Utd,7443,5,11,6,11,37,40,-3,39
Brisbane,7443,6,10,5,13,33,42,-9,35
Western Sydn,7443,7,8,9,10,38,47,-9,33
Perth Glory,7443,8,10,2,15,37,50,-13,32
Wellington P,7443,9,5,6,16,31,55,-24,21
CC Mariners,7443,10,4,8,15,28,49,-21,20
Sydney FC,7444,1,21,4,3,66,22,44,67
N'castle Jet,7444,2,15,6,7,58,38,20,51
Melbourne C,7444,3,14,5,10,44,34,10,47
Melbourne V,7444,4,13,5,11,45,40,5,44
Adelaide Utd,7444,5,11,6,11,37,40,-3,39
Brisbane,7444,6,10,5,13,33,42,-9,35
Western Sydn,7444,7,8,9,10,38,47,-9,33
Perth Glory,7444,8,10,2,15,37,50,-13,32
Wellington P,7444,9,5,6,16,31,55,-24,21
CC Mariners,7444,10,4,8,15,28,49,-21,20
Sydney FC,7445,1,20,4,4,65,24,41,64
N'castle Jet,7445,2,16,5,7,62,37,25,53
Melbourne V,7445,3,14,5,10,47,39,8,47
Melbourne C,7445,4,14,4,11,43,38,5,46
Adelaide Utd,7445,5,11,6,11,37,40,-3,39
Brisbane,7445,6,10,5,13,33,42,-9,35
Western Sydn,7445,7,8,9,10,38,47,-9,33
Perth Glory,7445,8,10,2,15,37,50,-13,32
Wellington P,7445,9,5,6,16,31,55,-24,21
CC Mariners,7445,10,4,8,15,28,49,-21,20
Sydney FC,7446,1,21,4,3,67,23,44,67
N'castle Jet,7446,2,16,5,7,58,37,21,53
Melbourne C,7446,3,14,4,11,43,34,9,46
Melbourne V,7446,4,13,5,11,46,41,5,44
Adelaide Utd,7446,5,11,6,11,37,40,-3,39
Brisbane,7446,6,10,5,13,33,42,-9,35
Western Sydn,7446,7,8,9,10,38,47,-9,33
Perth Glory,7446,8,10,2,15,37,50,-13,32
Wellington P,7446,9,5,6,16,31,55,-24,21
CC Mariners,7446,10,4,8,15,28,49,-21,20
Sydney FC,7447,1,21,4,3,67,23,44,67
N'castle Jet,7447,2,16,5,7,64,38,26,53
Melbourne C,7447,3,14,4,11,44,40,4,46
Melbourne V,7447,4,13,5,11,46,41,5,44
Adelaide Utd,7447,5,11,6,11,37,40,-3,39
Brisbane,7447,6,10,5,13,33,42,-9,35
Western Sydn,7447,7,8,9,10,38,47,-9,33
Perth Glory,7447,8,10,2,15,37,50,-13,32
Wellington P,7447,9,5,6,16,31,55,-24,21
CC Mariners,7447,10,4,8,15,28,49,-21,20
Sydney FC,7448,1,21,4,3,67,24,43,67
N'castle Jet,7448,2,16,5,7,60,38,22,53
Melbourne C,7448,3,14,4,11,44,36,8,46
Melbourne V,7448,4,13,5,11,47,41,6,44
Adelaide Utd,7448,5,11,6,11,37,40,-3,39
Brisbane,7448,6,10,5,13,33,42,-9,35
Western Sydn,7448,7,8,9,10,38,47,-9,33
Perth Glory,7448,8,10,2,15,37,50,-13,32
Wellington P,7448,9,5,6,16,31,55,-24,21
CC Mariners,7448,10,4,8,15,28,49,-21,20
Sydney FC,7449,1,20,4,4,65,26,39,64
N'castle Jet,7449,2,16,5,7,59,37,22,53
Melbourne V,7449,3,14,5,10,49,39,10,47
Melbourne C,7449,4,14,4,11,43,35,8,46
Adelaide Utd,7449,5,11,6,11,37,40,-3,39
Brisbane,7449,6,10,5,13,33,42,-9,35
Western Sydn,7449,7,8,9,10,38,47,-9,33
Perth Glory,7449,8,10,2,15,37,50,-13,32
Wellington P,7449,9,5,6,16,31,55,-24,21
CC Mariners,7449,10,4,8,15,28,49,-21,20
Sydney FC,7450,1,21,4,3,65,22,43,67
N'castle Jet,7450,2,15,6,7,60,40,20,51
Melbourne C,7450,3,14,5,10,46,36,10,47
Melbourne V,7450,4,13,5,11,45,39,6,44
Adelaide Utd,7450,5,11,6,11,37,40,-3,39
Brisbane,7450,6,10,5,13,33,42,-9,35
Western Sydn,7450,7,8,9,10,38,47,-9,33
Perth Glory,7450,8,10,2,15,37,50,-13,32
Wellington P,7450,9,5,6,16,31,55,-24,21
CC Mariners,7450,10,4,8,15,28,49,-21,20
Sydney FC,7451,1,21,4,3,68,22,46,67
N'castle Jet,7451,2,16,5,7,58,37,21,53
Melbourne C,7451,3,14,4,11,43,34,9,46
Melbourne V,7451,4,13,5,11,45,42,3,44
Adelaide Utd,7451,5,11,6,11,37,40,-3,39
Brisbane,7451,6,10,5,13,33,42,-9,35
Western Sydn,7451,7,8,9,10,38,47,-9,33
Perth Glory,7451,8,10,2,15,37,50,-13,32
Wellington P,7451,9,5,6,16,31,55,-24,21
CC Mariners,7451,10,4,8,15,28,49,-21,20
Sydney FC,7452,1,21,4,3,67,22,45,67
N'castle Jet,7452,2,15,5,8,58,39,19,50
Melbourne C,7452,3,15,4,10,45,34,11,49
Melbourne V,7452,4,13,5,11,45,41,4,44
Adelaide Utd,7452,5,11,6,11,37,40,-3,39
Brisbane,7452,6,10,5,13,33,42,-9,35
Western Sydn,7452,7,8,9,10,38,47,-9,33
Perth Glory,7452,8,10,2,15,37,50,-13,32
Wellington P,7452,9,5,6,16,31,55,-24,21
CC Mariners,7452,10,4,8,15,28,49,-21,20
Sydney FC,7453,1,21,4,3,68,25,43,67
N'castle Jet,7453,2,15,5,8,59,40,19,50
Melbourne C,7453,3,15,4,10,46,35,11,49
Melbourne V,7453,4,13,5,11,48,42,6,44
Adelaide Utd,7453,5,11,6,11,37,40,-3,39
Brisbane,7453,6,10,5,13,33,42,-9,35
Western Sydn,7453,7,8,9,10,38,47,-9,33
Perth Glory,7453,8,10,2,15,37,50,-13,32
Wellington P,7453,9,5,6,16,31,55,-24,21
CC Mariners,7453,10,4,8,15,28,49,-21,20
Sydney FC,7454,1,20,4,4,66,25,41,64
N'castle Jet,7454,2,16,5,7,60,37,23,53
Melbourne V,7454,3,14,5,10,48,40,8,47
Melbourne C,7454,4,14,4,11,43,36,7,46
Adelaide Utd,7454,5,11,6,11,37,40,-3,39
Brisbane,7454,6,10,5,13,33,42,-9,35
Western Sydn,7454,7,8,9,10,38,47,-9,33
Perth Glory,7454,8,10,2,15,37,50,-13,32
Wellington P,7454,9,5,6,16,31,55,-24,21
CC Mariners,7454,10,4,8,15,28,49,-21,20
Sydney FC,7455,1,21,4,3,66,22,44,67
N'castle Jet,7455,2,15,6,7,57,37,20,51
Melbourne C,7455,3,14,5,10,43,33,10,47
Melbourne V,7455,4,13,5,11,45,40,5,44
Adelaide Utd,7455,5,11,6,11,37,40,-3,39
Brisbane,7455,6,10,5,13,33,42,-9,35
Western Sydn,7455,7,8,9,10,38,47,-9,33
Perth Glory,7455,8,10,2,15,37,50,-13,32
Wellington P,7455,9,5,6,16,31,55,-24,21
CC Mariners,7455,10,4,8,15,28,49,-21,20
Sydney FC,7456,1,21,4,3,69,23,46,67
N'castle Jet,7456,2,16,5,7,60,37,23,53
Melbourne C,7456,3,14,4,11,43,36,7,46
Melbourne V,7456,4,13,5,11,46,43,3,44
Adelaide Utd,7456,5,11,6,11,37,40,-3,39
Brisbane,7456,6,10,5,13,33,42,-9,35
Western Sydn,7456,7,8,9,10,38,47,-9,33
Perth Glory,7456,8,10,2,15,37,50,-13,32
Wellington P,7456,9,5,6,16,31,55,-24,21
CC Mariners,7456,10,4,8,15,28,49,-21,20
Sydney FC,7457,1,21,4,3,67,22,45,67
N'castle Jet,7457,2,15,5,8,60,41,19,50
Melbourne C,7457,3,15,4,10,47,36,11,49
Melbourne V,7457,4,13,5,11,45,41,4,44
Adelaide Utd,7457,5,11,6,11,37,40,-3,39
Brisbane,7457,6,10,5,13,33,42,-9,35
Western Sydn,7457,7,8,9,10,38,47,-9,33
Perth Glory,7457,8,10,2,15,37,50,-13,32
Wellington P,7457,9,5,6,16,31,55,-24,21
CC Mariners,7457,10,4,8,15,28,49,-21,20
Sydney FC,7458,1,21,4,3,70,23,47,67
N'castle Jet,7458,2,16,5,7,60,38,22,53
Melbourne C,7458,3,14,4,11,44,36,8,46
Melbourne V,7458,4,13,5,11,46,44,2,44
Adelaide Utd,7458,5,11,6,11,37,40,-3,39
Brisbane,7458,6,10,5,13,33,42,-9,35
Western Sydn,7458,7,8,9,10,38,47,-9,33
Perth Glory,7458,8,10,2,15,37,50,-13,32
Wellington P,7458,9,5,6,16,31,55,-24,21
CC Mariners,7458,10,4,8,15,28,49,-21,20
Sydney FC,7459,1,20,5,3,65,23,42,65
N'castle Jet,7459,2,15,6,7,58,38,20,51
Melbourne C,7459,3,14,5,10,44,34,10,47
Melbourne V,7459,4,13,6,10,46,39,7,45
Adelaide Utd,7459,5,11,6,11,37,40,-3,39
Brisbane,7459,6,10,5,13,33,42,-9,35
Western Sydn,7459,7,8,9,10,38,47,-9,33
Perth Glory,7459,8,10,2,15,37,50,-13,32
Wellington P,7459,9,5,6,16,31,55,-24,21
CC Mariners,7459,10,4,8,15,28,49,-21,20
Sydney FC,7460,1,21,4,3,67,23,44,67
N'castle Jet,7460,2,15,5,8,58,41,17,50
Melbourne C,7460,3,15,4,10,47,34,13,49
Melbourne V,7460,4,13,5,11,46,41,5,44
Adelaide Utd,7460,5,11,6,11,37,40,-3,39
Brisbane,7460,6,10,5,13,33,42,-9,35
Western Sydn,7460,7,8,9,10,38,47,-9,33
Perth Glory,7460,8,10,2,15,37,50,-13,32
Wellington P,7460,9,5,6,16,31,55,-24,21
CC Mariners,7460,10,4,8,15,28,49,-21,20
Sydney FC,7461,1,21,4,3,66,23,43,67
N'castle Jet,7461,2,16,5,7,61,39,22,53
Melbourne C,7461,3,14,4,11,45,37,8,46
Melbourne V,7461,4,13,5,11,46,40,6,44
Adelaide Utd,7461,5,11,6,11,37,40,-3,39
Brisbane,7461,6,10,5,13,33,42,-9,35
Western Sydn,7461,7,8,9,10,38,47,-9,33
Perth Glory,7461,8,10,2,15,37,50,-13,32
Wellington P,7461,9,5,6,16,31,55,-24,21
CC Mariners,7461,10,4,8,15,28,49,-21,20
Sydney FC,7462,1,21,4,3,67,22,45,67
N'castle Jet,7462,2,16,5,7,60,39,21,53
Melbourne C,7462,3,14,4,11,45,36,9,46
Melbourne V,7462,4,13,5,11,45,41,4,44
Adelaide Utd,7462,5,11,6,11,37,40,-3,39
Brisbane,7462,6,10,5,13,33,42,-9,35
Western Sydn,7462,7,8,9,10,38,47,-9,33
Perth Glory,7462,8,10,2,15,37,50,-13,32
Wellington P,7462,9,5,6,16,31,55,-24,21
CC Mariners,7462,10,4,8,15,28,49,-21,20
Sydney FC,7463,1,21,4,3,65,22,43,67
N'castle Jet,7463,2,15,5,8,58,39,19,50
Melbourne C,7463,3,15,4,10,45,34,11,49
Melbourne V,7463,4,13,5,11,45,39,6,44
Adelaide Utd,7463,5,11,6,11,37,40,-3,39
Brisbane,7463,6,10,5,13,33,42,-9,35
Western Sydn,7463,7,8,9,10,38,47,-9,33
Perth Glory,7463,8,10,2,15,37,50,-13,32
Wellington P,7463,9,5,6,16,31,55,-24,21
CC Mariners,7463,10,4,8,15,28,49,-21,20
Sydney FC,7464,1,21,4,3,68,24,44,67
N'castle Jet,7464,2,16,5,7,61,38,23,53
Melbourne C,7464,3,14,4,11,44,37,7,46
Melbourne V,7464,4,13,5,11,47,42,5,44
Adelaide Utd,7464,5,11,6,11,37,40,-3,39
Brisbane,7464,6,10,5,13,33,42,-9,35
Western Sydn,7464,7,8,9,10,38,47,-9,33
Perth Glory,7464,8,10,2,15,37,50,-13,32
Wellington P,7464,9,5,6,16,31,55,-24,21
CC Mariners,7464,10,4,8,15,28,49,-21,20
Sydney FC,7465,1,21,4,3,65,22,43,67
N'castle Jet,7465,2,15,5,8,59,40,19,50
Melbourne C,7465,3,15,4,10,46,35,11,49
Melbourne V,7465,4,13,5,11,45,39,6,44
Adelaide Utd,7465,5,11,6,11,37,40,-3,39
Brisbane,7465,6,10,5,13,33,42,-9,35
Western Sydn,7465,7,8,9,10,38,47,-9,33
Perth Glory,7465,8,10,2,15,37,50,-13,32
Wellington P,7465,9,5,6,16,31,55,-24,21
CC Mariners,7465,10,4,8,15,28,49,-21,20
Sydney FC,7466,1,20,5,3,65,23,42,65
N'castle Jet,7466,2,16,5,7,58,37,21,53
Melbourne C,7466,3,14,4,11,43,34,9,46
Melbourne V,7466,4,13,6,10,46,39,7,45
Adelaide Utd,7466,5,11,6,11,37,40,-3,39
Brisbane,7466,6,10,5,13,33,42,-9,35
Western Sydn,7466,7,8,9,10,38,47,-9,33
Perth Glory,7466,8,10,2,15,37,50,-13,32
Wellington P,7466,9,5,6,16,31,55,-24,21
CC Mariners,7466,10,4,8,15,28,49,-21,20
Sydney FC,7467,1,20,4,4,65,26,39,64
N'castle Jet,7467,2,16,5,7,58,37,21,53
Melbourne V,7467,3,14,5,10,49,39,10,47
Melbourne C,7467,4,14,4,11,43,34,9,46
Adelaide Utd,7467,5,11,6,11,37,40,-3,39
Brisbane,7467,6,10,5,13,33,42,-9,35
Western Sydn,7467,7,8,9,10,38,47,-9,33
Perth Glory,7467,8,10,2,15,37,50,-13,32
Wellington P,7467,9,5,6,16,31,55,-24,21
CC Mariners,7467,10,4,8,15,28,49,-21,20
Sydney FC,7468,1,20,4,4,65,25,40,64
N'castle Jet,7468,2,15,5,8,58,39,19,50
Melbourne C,7468,3,15,4,10,45,34,11,49
Melbourne V,7468,4,14,5,10,48,39,9,47
Adelaide Utd,7468,5,11,6,11,37,40,-3,39
Brisbane,7468,6,10,5,13,33,42,-9,35
Western Sydn,7468,7,8,9,10,38,47,-9,33
Perth Glory,7468,8,10,2,15,37,50,-13,32
Wellington P,7468,9,5,6,16,31,55,-24,21
CC Mariners,7468,10,4,8,15,28,49,-21,20
Sydney FC,7469,1,20,4,4,65,24,41,64
N'castle Jet,7469,2,15,6,7,58,38,20,51
Melbourne C,7469,3,14,5,10,44,34,10,47
Melbourne V,7469,4,14,5,10,47,39,8,47
Adelaide Utd,7469,5,11,6,11,37,40,-3,39
Brisbane,7469,6,10,5,13,33,42,-9,35
Western Sydn,7469,7,8,9,10,38,47,-9,33
Perth Glory,7469,8,10,2,15,37,50,-13,32
Wellington P,7469,9,5,6,16,31,55,-24,21
CC Mariners,7469,10,4,8,15,28,49,-21,20
Sydney FC,7470,1,21,4,3,66,22,44,67
N'castle Jet,7470,2,15,5,8,58,39,19,50
Melbourne C,7470,3,15,4,10,45,34,11,49
Melbourne V,7470,4,13,5,11,45,40,5,44
Adelaide Utd,7470,5,11,6,11,37,40,-3,39
Brisbane,7470,6,10,5,13,33,42,-9,35
Western Sydn,7470,7,8,9,10,38,47,-9,33
Perth Glory,7470,8,10,2,15,37,50,-13,32
Wellington P,7470,9,5,6,16,31,55,-24,21
CC Mariners,7470,10,4,8,15,28,49,-21,20
Sydney FC,7471,1,21,4,3,66,23,43,67
N'castle Jet,7471,2,15,5,8,58,39,19,50
Melbourne C,7471,3,15,4,10,45,34,11,49
Melbourne V,7471,4,13,5,11,46,40,6,44
Adelaide Utd,7471,5,11,6,11,37,40,-3,39
Brisbane,7471,6,10,5,13,33,42,-9,35
Western Sydn,7471,7,8,9,10,38,47,-9,33
Perth Glory,7471,8,10,2,15,37,50,-13,32
Wellington P,7471,9,5,6,16,31,55,-24,21
CC Mariners,7471,10,4,8,15,28,49,-21,20
Sydney FC,7472,1,20,4,4,64,24,40,64
N'castle Jet,7472,2,16,5,7,60,38,22,53
Melbourne V,7472,3,14,5,10,47,38,9,47
Melbourne C,7472,4,14,4,11,44,36,8,46
Adelaide Utd,7472,5,11,6,11,37,40,-3,39
Brisbane,7472,6,10,5,13,33,42,-9,35
Western Sydn,7472,7,8,9,10,38,47,-9,33
Perth Glory,7472,8,10,2,15,37,50,-13,32
Wellington P,7472,9,5,6,16,31,55,-24,21
CC Mariners,7472,10,4,8,15,28,49,-21,20
Sydney FC,7473,1,21,4,3,65,22,43,67
N'castle Jet,7473,2,15,5,8,59,40,19,50
Melbourne C,7473,3,15,4,10,46,35,11,49
Melbourne V,7473,4,13,5,11,45,39,6,44
Adelaide Utd,7473,5,11,6,11,37,40,-3,39
Brisbane,7473,6,10,5,13,33,42,-9,35
Western Sydn,7473,7,8,9,10,38,47,-9,33
Perth Glory,7473,8,10,2,15,37,50,-13,32
Wellington P,7473,9,5,6,16,31,55,-24,21
CC Mariners,7473,10,4,8,15,28,49,-21,20
Sydney FC,7474,1,20,4,4,65,24,41,64
N'castle Jet,7474,2,15,5,8,60,41,19,50
Melbourne C,7474,3,15,4,10,47,36,11,49
Melbourne V,7474,4,14,5,10,47,39,8,47
Adelaide Utd,7474,5,11,6,11,37,40,-3,39
Brisbane,7474,6,10,5,13,33,42,-9,35
Western Sydn,7474,7,8,9,10,38,47,-9,33
Perth Glory,7474,8,10,2,15,37,50,-13,32
Wellington P,7474,9,5,6,16,31,55,-24,21
CC Mariners,7474,10,4,8,15,28,49,-21,20
Sydney FC,7475,1,20,5,3,65,23,42,65
N'castle Jet,7475,2,16,5,7,59,37,22,53
Melbourne C,7475,3,14,4,11,43,35,8,46
Melbourne V,7475,4,13,6,10,46,39,7,45
Adelaide Utd,7475,5,11,6,11,37,40,-3,39
Brisbane,7475,6,10,5,13,33,42,-9,35
Western Sydn,7475,7,8,9,10,38,47,-9,33
Perth Glory,7475,8,10,2,15,37,50,-13,32
Wellington P,7475,9,5,6,16,31,55,-24,21
CC Mariners,7475,10,4,8,15,28,49,-21,20
Sydney FC,7476,1,21,4,3,65,22,43,67
N'castle Jet,7476,2,15,5,8,58,39,19,50
Melbourne C,7476,3,15,4,10,45,34,11,49
Melbourne V,7476,4,13,5,11,45,39,6,44
Adelaide Utd,7476,5,11,6,11,37,40,-3,39
Brisbane,7476,6,10,5,13,33,42,-9,35
Western Sydn,7476,7,8,9,10,38,47,-9,33
Perth Glory,7476,8,10,2,15,37,50,-13,32
Wellington P,7476,9,5,6,16,31,55,-24,21
CC Mariners,7476,10,4,8,15,28,49,-21,20
Sydney FC,7477,1,21,4,3,66,23,43,67
N'castle Jet,7477,2,15,6,7,60,40,20,51
Melbourne C,7477,3,14,5,10,46,36,10,47
Melbourne V,7477,4,13,5,11,46,40,6,44
Adelaide Utd,7477,5,11,6,11,37,40,-3,39
Brisbane,7477,6,10,5,13,33,42,-9,35
Western Sydn,7477,7,8,9,10,38,47,-9,33
Perth Glory,7477,8,10,2,15,37,50,-13,32
Wellington P,7477,9,5,6,16,31,55,-24,21
CC Mariners,7477,10,4,8,15,28,49,-21,20
Sydney FC,7478,1,21,4,3,68,22,46,67
N'castle Jet,7478,2,15,6,7,58,38,20,51
Melbourne C,7478,3,14,5,10,44,34,10,47
Melbourne V,7478,4,13,5,11,45,42,3,44
Adelaide Utd,7478,5,11,6,11,37,40,-3,39
Brisbane,7478,6,10,5,13,33,42,-9,35
Western Sydn,7478,7,8,9,10,38,47,-9,33
Perth Glory,7478,8,10,2,15,37,50,-13,32
Wellington P,7478,9,5,6,16,31,55,-24,21
CC Mariners,7478,10,4,8,15,28,49,-21,20
Sydney FC,7479,1,20,5,3,65,23,42,65
N'castle Jet,7479,2,15,6,7,58,38,20,51
Melbourne C,7479,3,14,5,10,44,34,10,47
Melbourne V,7479,4,13,6,10,46,39,7,45
Adelaide Utd,7479,5,11,6,11,37,40,-3,39
Brisbane,7479,6,10,5,13,33,42,-9,35
Western Sydn,7479,7,8,9,10,38,47,-9,33
Perth Glory,7479,8,10,2,15,37,50,-13,32
Wellington P,7479,9,5,6,16,31,55,-24,21
CC Mariners,7479,10,4,8,15,28,49,-21,20
Sydney FC,7480,1,21,4,3,65,22,43,67
N'castle Jet,7480,2,15,5,8,57,38,19,50
Melbourne C,7480,3,15,4,10,44,33,11,49
Melbourne V,7480,4,13,5,11,45,39,6,44
Adelaide Utd,7480,5,11,6,11,37,40,-3,39
Brisbane,7480,6,10,5,13,33,42,-9,35
Western Sydn,7480,7,8,9,10,38,47,-9,33
Perth Glory,7480,8,10,2,15,37,50,-13,32
Wellington P,7480,9,5,6,16,31,55,-24,21
CC Mariners,7480,10,4,8,15,28,49,-21,20
Sydney FC,7481,1,21,4,3,67,23,44,67
N'castle Jet,7481,2,15,6,7,57,37,20,51
Melbourne C,7481,3,14,5,10,43,33,10,47
Melbourne V,7481,4,13,5,11,46,41,5,44
Adelaide Utd,7481,5,11,6,11,37,40,-3,39
Brisbane,7481,6,10,5,13,33,42,-9,35
Western Sydn,7481,7,8,9,10,38,47,-9,33
Perth Glory,7481,8,10,2,15,37,50,-13,32
Wellington P,7481,9,5,6,16,31,55,-24,21
CC Mariners,7481,10,4,8,15,28,49,-21,20
Sydney FC,7482,1,21,4,3,66,23,43,67
N'castle Jet,7482,2,15,6,7,58,38,20,51
Melbourne C,7482,3,14,5,10,44,34,10,47
Melbourne V,7482,4,13,5,11,46,40,6,44
Adelaide Utd,7482,5,11,6,11,37,40,-3,39
Brisbane,7482,6,10,5,13,33,42,-9,35
Western Sydn,7482,7,8,9,10,38,47,-9,33
Perth Glory,7482,8,10,2,15,37,50,-13,32
Wellington P,7482,9,5,6,16,31,55,-24,21
CC Mariners,7482,10,4,8,15,28,49,-21,20
Sydney FC,7483,1,21,4,3,66,22,44,67
N'castle Jet,7483,2,16,5,7,60,38,22,53
Melbourne C,7483,3,14,4,11,44,36,8,46
Melbourne V,7483,4,13,5,11,45,40,5,44
Adelaide Utd,7483,5,11,6,11,37,40,-3,39
Brisbane,7483,6,10,5,13,33,42,-9,35
Western Sydn,7483,7,8,9,10,38,47,-9,33
Perth Glory,7483,8,10,2,15,37,50,-13,32
Wellington P,7483,9,5,6,16,31,55,-24,21
CC Mariners,7483,10,4,8,15,28,49,-21,20
Sydney FC,7484,1,21,4,3,66,22,44,67
N'castle Jet,7484,2,15,5,8,58,39,19,50
Melbourne C,7484,3,15,4,10,45,34,11,49
Melbourne V,7484,4,13,5,11,45,40,5,44
Adelaide Utd,7484,5,11,6,11,37,40,-3,39
Brisbane,7484,6,10,5,13,33,42,-9,35
Western Sydn,7484,7,8,9,10,38,47,-9,33
Perth Glory,7484,8,10,2,15,37,50,-13,32
Wellington P,7484,9,5,6,16,31,55,-24,21
CC Mariners,7484,10,4,8,15,28,49,-21,20
Sydney FC,7485,1,21,4,3,68,24,44,67
N'castle Jet,7485,2,16,5,7,61,38,23,53
Melbourne C,7485,3,14,4,11,44,37,7,46
Melbourne V,7485,4,13,5,11,47,42,5,44
Adelaide Utd,7485,5,11,6,11,37,40,-3,39
Brisbane,7485,6,10,5,13,33,42,-9,35
Western Sydn,7485,7,8,9,10,38,47,-9,33
Perth Glory,7485,8,10,2,15,37,50,-13,32
Wellington P,7485,9,5,6,16,31,55,-24,21
CC Mariners,7485,10,4,8,15,28,49,-21,20
Sydney FC,7486,1,21,4,3,65,22,43,67
N'castle Jet,7486,2,15,6,7,59,39,20,51
Melbourne C,7486,3,14,5,10,45,35,10,47
Melbourne V,7486,4,13,5,11,45,39,6,44
Adelaide Utd,7486,5,11,6,11,37,40,-3,39
Brisbane,7486,6,10,5,13,33,42,-9,35
Western Sydn,7486,7,8,9,10,38,47,-9,33
Perth Glory,7486,8,10,2,15,37,50,-13,32
Wellington P,7486,9,5,6,16,31,55,-24,21
CC Mariners,7486,10,4,8,15,28,49,-21,20
Sydney FC,7487,1,21,4,3,68,22,46,67
N'castle Jet,7487,2,16,5,7,61,39,22,53
Melbourne C,7487,3,14,4,11,45,37,8,46
Melbourne V,7487,4,13,5,11,45,42,3,44
Adelaide Utd,7487,5,11,6,11,37,40,-3,39
Brisbane,7487,6,10,5,13,33,42,-9,35
Western Sydn,7487,7,8,9,10,38,47,-9,33
Perth Glory,7487,8,10,2,15,37,50,-13,32
Wellington P,7487,9,5,6,16,31,55,-24,21
CC Mariners,7487,10,4,8,15,28,49,-21,20
Sydney FC,7488,1,21,4,3,66,23,43,67
N'castle Jet,7488,2,16,5,7,60,38,22,53
Melbourne C,7488,3,14,4,11,44,36,8,46
Melbourne V,7488,4,13,5,11,46,40,6,44
Adelaide Utd,7488,5,11,6,11,37,40,-3,39
Brisbane,7488,6,10,5,13,33,42,-9,35
Western Sydn,7488,7,8,9,10,38,47,-9,33
Perth Glory,7488,8,10,2,15,37,50,-13,32
Wellington P,7488,9,5,6,16,31,55,-24,21
CC Mariners,7488,10,4,8,15,28,49,-21,20
Sydney FC,7489,1,21,4,3,69,22,47,67
N'castle Jet,7489,2,15,6,7,57,37,20,51
Melbourne C,7489,3,14,5,10,43,33,10,47
Melbourne V,7489,4,13,5,11,45,43,2,44
Adelaide Utd,7489,5,11,6,11,37,40,-3,39
Brisbane,7489,6,10,5,13,33,42,-9,35
Western Sydn,7489,7,8,9,10,38,47,-9,33
Perth Glory,7489,8,10,2,15,37,50,-13,32
Wellington P,7489,9,5,6,16,31,55,-24,21
CC Mariners,7489,10,4,8,15,28,49,-21,20
Sydney FC,7490,1,21,4,3,67,22,45,67
N'castle Jet,7490,2,16,5,7,59,37,22,53
Melbourne C,7490,3,14,4,11,43,35,8,46
Melbourne V,7490,4,13,5,11,45,41,4,44
Adelaide Utd,7490,5,11,6,11,37,40,-3,39
Brisbane,7490,6,10,5,13,33,42,-9,35
Western Sydn,7490,7,8,9,10,38,47,-9,33
Perth Glory,7490,8,10,2,15,37,50,-13,32
Wellington P,7490,9,5,6,16,31,55,-24,21
CC Mariners,7490,10,4,8,15,28,49,-21,20
Sydney FC,7491,1,20,5,3,66,24,42,65
N'castle Jet,7491,2,15,5,8,59,40,19,50
Melbourne C,7491,3,15,4,10,46,35,11,49
Melbourne V,7491,4,13,6,10,47,40,7,45
Adelaide Utd,7491,5,11,6,11,37,40,-3,39
Brisbane,7491,6,10,5,13,33,42,-9,35
Western Sydn,7491,7,8,9,10,38,47,-9,33
Perth Glory,7491,8,10,2,15,37,50,-13,32
Wellington P,7491,9,5,6,16,31,55,-24,21
CC Mariners,7491,10,4,8,15,28,49,-21,20
Sydney FC,7492,1,21,4,3,65,22,43,67
N'castle Jet,7492,2,15,6,7,58,38,20,51
Melbourne C,7492,3,14,5,10,44,34,10,47
Melbourne V,7492,4,13,5,11,45,39,6,44
Adelaide Utd,7492,5,11,6,11,37,40,-3,39
Brisbane,7492,6,10,5,13,33,42,-9,35
Western Sydn,7492,7,8,9,10,38,47,-9,33
Perth Glory,7492,8,10,2,15,37,50,-13,32
Wellington P,7492,9,5,6,16,31,55,-24,21
CC Mariners,7492,10,4,8,15,28,49,-21,20
Sydney FC,7493,1,20,5,3,65,23,42,65
N'castle Jet,7493,2,15,6,7,58,38,20,51
Melbourne C,7493,3,14,5,10,44,34,10,47
Melbourne V,7493,4,13,6,10,46,39,7,45
Adelaide Utd,7493,5,11,6,11,37,40,-3,39
Brisbane,7493,6,10,5,13,33,42,-9,35
Western Sydn,7493,7,8,9,10,38,47,-9,33
Perth Glory,7493,8,10,2,15,37,50,-13,32
Wellington P,7493,9,5,6,16,31,55,-24,21
CC Mariners,7493,10,4,8,15,28,49,-21,20
Sydney FC,7494,1,21,4,3,66,23,43,67
N'castle Jet,7494,2,15,5,8,57,40,17,50
Melbourne C,7494,3,15,4,10,46,33,13,49
Melbourne V,7494,4,13,5,11,46,40,6,44
Adelaide Utd,7494,5,11,6,11,37,40,-3,39
Brisbane,7494,6,10,5,13,33,42,-9,35
Western Sydn,7494,7,8,9,10,38,47,-9,33
Perth Glory,7494,8,10,2,15,37,50,-13,32
Wellington P,7494,9,5,6,16,31,55,-24,21
CC Mariners,7494,10,4,8,15,28,49,-21,20
Sydney FC,7495,1,21,4,3,68,24,44,67
N'castle Jet,7495,2,15,5,8,59,40,19,50
Melbourne C,7495,3,15,4,10,46,35,11,49
Melbourne V,7495,4,13,5,11,47,42,5,44
Adelaide Utd,7495,5,11,6,11,37,40,-3,39
Brisbane,7495,6,10,5,13,33,42,-9,35
Western Sydn,7495,7,8,9,10,38,47,-9,33
Perth Glory,7495,8,10,2,15,37,50,-13,32
Wellington P,7495,9,5,6,16,31,55,-24,21
CC Mariners,7495,10,4,8,15,28,49,-21,20
Sydney FC,7496,1,21,4,3,69,23,46,67
N'castle Jet,7496,2,15,5,8,58,39,19,50
Melbourne C,7496,3,15,4,10,45,34,11,49
Melbourne V,7496,4,13,5,11,46,43,3,44
Adelaide Utd,7496,5,11,6,11,37,40,-3,39
Brisbane,7496,6,10,5,13,33,42,-9,35
Western Sydn,7496,7,8,9,10,38,47,-9,33
Perth Glory,7496,8,10,2,15,37,50,-13,32
Wellington P,7496,9,5,6,16,31,55,-24,21
CC Mariners,7496,10,4,8,15,28,49,-21,20
Sydney FC,7497,1,21,4,3,71,23,48,67
N'castle Jet,7497,2,15,6,7,58,38,20,51
Melbourne C,7497,3,14,5,10,44,34,10,47
Melbourne V,7497,4,13,5,11,46,45,1,44
Adelaide Utd,7497,5,11,6,11,37,40,-3,39
Brisbane,7497,6,10,5,13,33,42,-9,35
Western Sydn,7497,7,8,9,10,38,47,-9,33
Perth Glory,7497,8,10,2,15,37,50,-13,32
Wellington P,7497,9,5,6,16,31,55,-24,21
CC Mariners,7497,10,4,8,15,28,49,-21,20
Sydney FC,7498,1,20,4,4,65,25,40,64
N'castle Jet,7498,2,16,5,7,60,39,21,53
Melbourne V,7498,3,14,5,10,48,39,9,47
Melbourne C,7498,4,14,4,11,45,36,9,46
Adelaide Utd,7498,5,11,6,11,37,40,-3,39
Brisbane,7498,6,10,5,13,33,42,-9,35
Western Sydn,7498,7,8,9,10,38,47,-9,33
Perth Glory,7498,8,10,2,15,37,50,-13,32
Wellington P,7498,9,5,6,16,31,55,-24,21
CC Mariners,7498,10,4,8,15,28,49,-21,20
Sydney FC,7499,1,20,4,4,65,24,41,64
N'castle Jet,7499,2,15,6,7,58,38,20,51
Melbourne C,7499,3,14,5,10,44,34,10,47
Melbourne V,7499,4,14,5,10,47,39,8,47
Adelaide Utd,7499,5,11,6,11,37,40,-3,39
Brisbane,7499,6,10,5,13,33,42,-9,35
Western Sydn,7499,7,8,9,10,38,47,-9,33
Perth Glory,7499,8,10,2,15,37,50,-13,32
Wellington P,7499,9,5,6,16,31,55,-24,21
CC Mariners,7499,10,4,8,15,28,49,-21,20
Sydney FC,7500,1,21,4,3,69,22,47,67
N'castle Jet,7500,2,15,5,8,58,40,18,50
Melbourne C,7500,3,15,4,10,46,34,12,49
Melbourne V,7500,4,13,5,11,45,43,2,44
Adelaide Utd,7500,5,11,6,11,37,40,-3,39
Brisbane,7500,6,10,5,13,33,42,-9,35
Western Sydn,7500,7,8,9,10,38,47,-9,33
Perth Glory,7500,8,10,2,15,37,50,-13,32
Wellington P,7500,9,5,6,16,31,55,-24,21
CC Mariners,7500,10,4,8,15,28,49,-21,20
Sydney FC,7501,1,21,4,3,70,23,47,67
N'castle Jet,7501,2,15,6,7,58,38,20,51
Melbourne C,7501,3,14,5,10,44,34,10,47
Melbourne V,7501,4,13,5,11,46,44,2,44
Adelaide Utd,7501,5,11,6,11,37,40,-3,39
Brisbane,7501,6,10,5,13,33,42,-9,35
Western Sydn,7501,7,8,9,10,38,47,-9,33
Perth Glory,7501,8,10,2,15,37,50,-13,32
Wellington P,7501,9,5,6,16,31,55,-24,21
CC Mariners,7501,10,4,8,15,28,49,-21,20
Sydney FC,7502,1,20,4,4,64,23,41,64
N'castle Jet,7502,2,16,5,7,61,37,24,53
Melbourne V,7502,3,14,5,10,46,38,8,47
Melbourne C,7502,4,14,4,11,43,37,6,46
Adelaide Utd,7502,5,11,6,11,37,40,-3,39
Brisbane,7502,6,10,5,13,33,42,-9,35
Western Sydn,7502,7,8,9,10,38,47,-9,33
Perth Glory,7502,8,10,2,15,37,50,-13,32
Wellington P,7502,9,5,6,16,31,55,-24,21
CC Mariners,7502,10,4,8,15,28,49,-21,20
Sydney FC,7503,1,21,4,3,66,23,43,67
N'castle Jet,7503,2,15,5,8,57,38,19,50
Melbourne C,7503,3,15,4,10,44,33,11,49
Melbourne V,7503,4,13,5,11,46,40,6,44
Adelaide Utd,7503,5,11,6,11,37,40,-3,39
Brisbane,7503,6,10,5,13,33,42,-9,35
Western Sydn,7503,7,8,9,10,38,47,-9,33
Perth Glory,7503,8,10,2,15,37,50,-13,32
Wellington P,7503,9,5,6,16,31,55,-24,21
CC Mariners,7503,10,4,8,15,28,49,-21,20
Sydney FC,7504,1,21,4,3,67,22,45,67
N'castle Jet,7504,2,15,6,7,59,39,20,51
Melbourne C,7504,3,14,5,10,45,35,10,47
Melbourne V,7504,4,13,5,11,45,41,4,44
Adelaide Utd,7504,5,11,6,11,37,40,-3,39
Brisbane,7504,6,10,5,13,33,42,-9,35
Western Sydn,7504,7,8,9,10,38,47,-9,33
Perth Glory,7504,8,10,2,15,37,50,-13,32
Wellington P,7504,9,5,6,16,31,55,-24,21
CC Mariners,7504,10,4,8,15,28,49,-21,20
Sydney FC,7505,1,20,5,3,64,22,42,65
N'castle Jet,7505,2,16,5,7,63,40,23,53
Melbourne C,7505,3,14,4,11,46,39,7,46
Melbourne V,7505,4,13,6,10,45,38,7,45
Adelaide Utd,7505,5,11,6,11,37,40,-3,39
Brisbane,7505,6,10,5,13,33,42,-9,35
Western Sydn,7505,7,8,9,10,38,47,-9,33
Perth Glory,7505,8,10,2,15,37,50,-13,32
Wellington P,7505,9,5,6,16,31,55,-24,21
CC Mariners,7505,10,4,8,15,28,49,-21,20
Sydney FC,7506,1,21,4,3,66,22,44,67
N'castle Jet,7506,2,16,5,7,59,37,22,53
Melbourne C,7506,3,14,4,11,43,35,8,46
Melbourne V,7506,4,13,5,11,45,40,5,44
Adelaide Utd,7506,5,11,6,11,37,40,-3,39
Brisbane,7506,6,10,5,13,33,42,-9,35
Western Sydn,7506,7,8,9,10,38,47,-9,33
Perth Glory,7506,8,10,2,15,37,50,-13,32
Wellington P,7506,9,5,6,16,31,55,-24,21
CC Mariners,7506,10,4,8,15,28,49,-21,20
Sydney FC,7507,1,21,4,3,67,22,45,67
N'castle Jet,7507,2,16,5,7,60,37,23,53
Melbourne C,7507,3,14,4,11,43,36,7,46
Melbourne V,7507,4,13,5,11,45,41,4,44
Adelaide Utd,7507,5,11,6,11,37,40,-3,39
Brisbane,7507,6,10,5,13,33,42,-9,35
Western Sydn,7507,7,8,9,10,38,47,-9,33
Perth Glory,7507,8,10,2,15,37,50,-13,32
Wellington P,7507,9,5,6,16,31,55,-24,21
CC Mariners,7507,10,4,8,15,28,49,-21,20
Sydney FC,7508,1,20,5,3,64,22,42,65
N'castle Jet,7508,2,16,5,7,59,37,22,53
Melbourne C,7508,3,14,4,11,43,35,8,46
Melbourne V,7508,4,13,6,10,45,38,7,45
Adelaide Utd,7508,5,11,6,11,37,40,-3,39
Brisbane,7508,6,10,5,13,33,42,-9,35
Western Sydn,7508,7,8,9,10,38,47,-9,33
Perth Glory,7508,8,10,2,15,37,50,-13,32
Wellington P,7508,9,5,6,16,31,55,-24,21
CC Mariners,7508,10,4,8,15,28,49,-21,20
Sydney FC,7509,1,21,4,3,69,24,45,67
N'castle Jet,7509,2,16,5,7,60,38,22,53
Melbourne C,7509,3,14,4,11,44,36,8,46
Melbourne V,7509,4,13,5,11,47,43,4,44
Adelaide Utd,7509,5,11,6,11,37,40,-3,39
Brisbane,7509,6,10,5,13,33,42,-9,35
Western Sydn,7509,7,8,9,10,38,47,-9,33
Perth Glory,7509,8,10,2,15,37,50,-13,32
Wellington P,7509,9,5,6,16,31,55,-24,21
CC Mariners,7509,10,4,8,15,28,49,-21,20
Sydney FC,7510,1,21,4,3,66,22,44,67
N'castle Jet,7510,2,15,6,7,57,37,20,51
Melbourne C,7510,3,14,5,10,43,33,10,47
Melbourne V,7510,4,13,5,11,45,40,5,44
Adelaide Utd,7510,5,11,6,11,37,40,-3,39
Brisbane,7510,6,10,5,13,33,42,-9,35
Western Sydn,7510,7,8,9,10,38,47,-9,33
Perth Glory,7510,8,10,2,15,37,50,-13,32
Wellington P,7510,9,5,6,16,31,55,-24,21
CC Mariners,7510,10,4,8,15,28,49,-21,20
Sydney FC,7511,1,21,4,3,67,23,44,67
N'castle Jet,7511,2,16,5,7,61,39,22,53
Melbourne C,7511,3,14,4,11,45,37,8,46
Melbourne V,7511,4,13,5,11,46,41,5,44
Adelaide Utd,7511,5,11,6,11,37,40,-3,39
Brisbane,7511,6,10,5,13,33,42,-9,35
Western Sydn,7511,7,8,9,10,38,47,-9,33
Perth Glory,7511,8,10,2,15,37,50,-13,32
Wellington P,7511,9,5,6,16,31,55,-24,21
CC Mariners,7511,10,4,8,15,28,49,-21,20
Sydney FC,7512,1,20,4,4,65,25,40,64
N'castle Jet,7512,2,16,5,7,60,39,21,53
Melbourne V,7512,3,14,5,10,48,39,9,47
Melbourne C,7512,4,14,4,11,45,36,9,46
Adelaide Utd,7512,5,11,6,11,37,40,-3,39
Brisbane,7512,6,10,5,13,33,42,-9,35
Western Sydn,7512,7,8,9,10,38,47,-9,33
Perth Glory,7512,8,10,2,15,37,50,-13,32
Wellington P,7512,9,5,6,16,31,55,-24,21
CC Mariners,7512,10,4,8,15,28,49,-21,20
Sydney FC,7513,1,21,4,3,66,22,44,67
N'castle Jet,7513,2,15,6,7,59,39,20,51
Melbourne C,7513,3,14,5,10,45,35,10,47
Melbourne V,7513,4,13,5,11,45,40,5,44
Adelaide Utd,7513,5,11,6,11,37,40,-3,39
Brisbane,7513,6,10,5,13,33,42,-9,35
Western Sydn,7513,7,8,9,10,38,47,-9,33
Perth Glory,7513,8,10,2,15,37,50,-13,32
Wellington P,7513,9,5,6,16,31,55,-24,21
CC Mariners,7513,10,4,8,15,28,49,-21,20
Sydney FC,7514,1,21,4,3,67,22,45,67
N'castle Jet,7514,2,16,5,7,58,37,21,53
Melbourne C,7514,3,14,4,11,43,34,9,46
Melbourne V,7514,4,13,5,11,45,41,4,44
Adelaide Utd,7514,5,11,6,11,37,40,-3,39
Brisbane,7514,6,10,5,13,33,42,-9,35
Western Sydn,7514,7,8,9,10,38,47,-9,33
Perth Glory,7514,8,10,2,15,37,50,-13,32
Wellington P,7514,9,5,6,16,31,55,-24,21
CC Mariners,7514,10,4,8,15,28,49,-21,20
Sydney FC,7515,1,20,4,4,64,23,41,64
N'castle Jet,7515,2,15,5,8,58,39,19,50
Melbourne C,7515,3,15,4,10,45,34,11,49
Melbourne V,7515,4,14,5,10,46,38,8,47
Adelaide Utd,7515,5,11,6,11,37,40,-3,39
Brisbane,7515,6,10,5,13,33,42,-9,35
Western Sydn,7515,7,8,9,10,38,47,-9,33
Perth Glory,7515,8,10,2,15,37,50,-13,32
Wellington P,7515,9,5,6,16,31,55,-24,21
CC Mariners,7515,10,4,8,15,28,49,-21,20
Sydney FC,7516,1,20,5,3,66,24,42,65
N'castle Jet,7516,2,16,5,7,61,37,24,53
Melbourne C,7516,3,14,4,11,43,37,6,46
Melbourne V,7516,4,13,6,10,47,40,7,45
Adelaide Utd,7516,5,11,6,11,37,40,-3,39
Brisbane,7516,6,10,5,13,33,42,-9,35
Western Sydn,7516,7,8,9,10,38,47,-9,33
Perth Glory,7516,8,10,2,15,37,50,-13,32
Wellington P,7516,9,5,6,16,31,55,-24,21
CC Mariners,7516,10,4,8,15,28,49,-21,20
Sydney FC,7517,1,20,5,3,64,22,42,65
N'castle Jet,7517,2,15,6,7,59,39,20,51
Melbourne C,7517,3,14,5,10,45,35,10,47
Melbourne V,7517,4,13,6,10,45,38,7,45
Adelaide Utd,7517,5,11,6,11,37,40,-3,39
Brisbane,7517,6,10,5,13,33,42,-9,35
Western Sydn,7517,7,8,9,10,38,47,-9,33
Perth Glory,7517,8,10,2,15,37,50,-13,32
Wellington P,7517,9,5,6,16,31,55,-24,21
CC Mariners,7517,10,4,8,15,28,49,-21,20
Sydney FC,7518,1,21,4,3,65,22,43,67
N'castle Jet,7518,2,15,6,7,58,38,20,51
Melbourne C,7518,3,14,5,10,44,34,10,47
Melbourne V,7518,4,13,5,11,45,39,6,44
Adelaide Utd,7518,5,11,6,11,37,40,-3,39
Brisbane,7518,6,10,5,13,33,42,-9,35
Western Sydn,7518,7,8,9,10,38,47,-9,33
Perth Glory,7518,8,10,2,15,37,50,-13,32
Wellington P,7518,9,5,6,16,31,55,-24,21
CC Mariners,7518,10,4,8,15,28,49,-21,20
Sydney FC,7519,1,20,5,3,65,23,42,65
N'castle Jet,7519,2,16,5,7,60,39,21,53
Melbourne C,7519,3,14,4,11,45,36,9,46
Melbourne V,7519,4,13,6,10,46,39,7,45
Adelaide Utd,7519,5,11,6,11,37,40,-3,39
Brisbane,7519,6,10,5,13,33,42,-9,35
Western Sydn,7519,7,8,9,10,38,47,-9,33
Perth Glory,7519,8,10,2,15,37,50,-13,32
Wellington P,7519,9,5,6,16,31,55,-24,21
CC Mariners,7519,10,4,8,15,28,49,-21,20
Sydney FC,7520,1,21,4,3,69,22,47,67
N'castle Jet,7520,2,16,5,7,60,38,22,53
Melbourne C,7520,3,14,4,11,44,36,8,46
Melbourne V,7520,4,13,5,11,45,43,2,44
Adelaide Utd,7520,5,11,6,11,37,40,-3,39
Brisbane,7520,6,10,5,13,33,42,-9,35
Western Sydn,7520,7,8,9,10,38,47,-9,33
Perth Glory,7520,8,10,2,15,37,50,-13,32
Wellington P,7520,9,5,6,16,31,55,-24,21
CC Mariners,7520,10,4,8,15,28,49,-21,20
Sydney FC,7521,1,21,4,3,70,22,48,67
N'castle Jet,7521,2,16,5,7,58,37,21,53
Melbourne C,7521,3,14,4,11,43,34,9,46
Melbourne V,7521,4,13,5,11,45,44,1,44
Adelaide Utd,7521,5,11,6,11,37,40,-3,39
Brisbane,7521,6,10,5,13,33,42,-9,35
Western Sydn,7521,7,8,9,10,38,47,-9,33
Perth Glory,7521,8,10,2,15,37,50,-13,32
Wellington P,7521,9,5,6,16,31,55,-24,21
CC Mariners,7521,10,4,8,15,28,49,-21,20
Sydney FC,7522,1,21,4,3,66,23,43,67
N'castle Jet,7522,2,15,5,8,57,38,19,50
Melbourne C,7522,3,15,4,10,44,33,11,49
Melbourne V,7522,4,13,5,11,46,40,6,44
Adelaide Utd,7522,5,11,6,11,37,40,-3,39
Brisbane,7522,6,10,5,13,33,42,-9,35
Western Sydn,7522,7,8,9,10,38,47,-9,33
Perth Glory,7522,8,10,2,15,37,50,-13,32
Wellington P,7522,9,5,6,16,31,55,-24,21
CC Mariners,7522,10,4,8,15,28,49,-21,20
Sydney FC,7523,1,20,5,3,66,24,42,65
N'castle Jet,7523,2,16,5,7,59,38,21,53
Melbourne C,7523,3,14,4,11,44,35,9,46
Melbourne V,7523,4,13,6,10,47,40,7,45
Adelaide Utd,7523,5,11,6,11,37,40,-3,39
Brisbane,7523,6,10,5,13,33,42,-9,35
Western Sydn,7523,7,8,9,10,38,47,-9,33
Perth Glory,7523,8,10,2,15,37,50,-13,32
Wellington P,7523,9,5,6,16,31,55,-24,21
CC Mariners,7523,10,4,8,15,28,49,-21,20
Sydney FC,7524,1,20,4,4,64,23,41,64
N'castle Jet,7524,2,15,5,8,59,40,19,50
Melbourne C,7524,3,15,4,10,46,35,11,49
Melbourne V,7524,4,14,5,10,46,38,8,47
Adelaide Utd,7524,5,11,6,11,37,40,-3,39
Brisbane,7524,6,10,5,13,33,42,-9,35
Western Sydn,7524,7,8,9,10,38,47,-9,33
Perth Glory,7524,8,10,2,15,37,50,-13,32
Wellington P,7524,9,5,6,16,31,55,-24,21
CC Mariners,7524,10,4,8,15,28,49,-21,20
Sydney FC,7525,1,20,5,3,64,22,42,65
N'castle Jet,7525,2,15,6,7,59,39,20,51
Melbourne C,7525,3,14,5,10,45,35,10,47
Melbourne V,7525,4,13,6,10,45,38,7,45
Adelaide Utd,7525,5,11,6,11,37,40,-3,39
Brisbane,7525,6,10,5,13,33,42,-9,35
Western Sydn,7525,7,8,9,10,38,47,-9,33
Perth Glory,7525,8,10,2,15,37,50,-13,32
Wellington P,7525,9,5,6,16,31,55,-24,21
CC Mariners,7525,10,4,8,15,28,49,-21,20
Sydney FC,7526,1,21,4,3,67,24,43,67
N'castle Jet,7526,2,16,5,7,60,38,22,53
Melbourne C,7526,3,14,4,11,44,36,8,46
Melbourne V,7526,4,13,5,11,47,41,6,44
Adelaide Utd,7526,5,11,6,11,37,40,-3,39
Brisbane,7526,6,10,5,13,33,42,-9,35
Western Sydn,7526,7,8,9,10,38,47,-9,33
Perth Glory,7526,8,10,2,15,37,50,-13,32
Wellington P,7526,9,5,6,16,31,55,-24,21
CC Mariners,7526,10,4,8,15,28,49,-21,20
Sydney FC,7527,1,21,4,3,66,23,43,67
N'castle Jet,7527,2,16,5,7,58,37,21,53
Melbourne C,7527,3,14,4,11,43,34,9,46
Melbourne V,7527,4,13,5,11,46,40,6,44
Adelaide Utd,7527,5,11,6,11,37,40,-3,39
Brisbane,7527,6,10,5,13,33,42,-9,35
Western Sydn,7527,7,8,9,10,38,47,-9,33
Perth Glory,7527,8,10,2,15,37,50,-13,32
Wellington P,7527,9,5,6,16,31,55,-24,21
CC Mariners,7527,10,4,8,15,28,49,-21,20
Sydney FC,7528,1,20,5,3,65,23,42,65
N'castle Jet,7528,2,16,5,7,60,38,22,53
Melbourne C,7528,3,14,4,11,44,36,8,46
Melbourne V,7528,4,13,6,10,46,39,7,45
Adelaide Utd,7528,5,11,6,11,37,40,-3,39
Brisbane,7528,6,10,5,13,33,42,-9,35
Western Sydn,7528,7,8,9,10,38,47,-9,33
Perth Glory,7528,8,10,2,15,37,50,-13,32
Wellington P,7528,9,5,6,16,31,55,-24,21
CC Mariners,7528,10,4,8,15,28,49,-21,20
Sydney FC,7529,1,20,4,4,66,25,41,64
N'castle Jet,7529,2,15,5,8,57,39,18,50
Melbourne C,7529,3,15,4,10,45,33,12,49
Melbourne V,7529,4,14,5,10,48,40,8,47
Adelaide Utd,7529,5,11,6,11,37,40,-3,39
Brisbane,7529,6,10,5,13,33,42,-9,35
Western Sydn,7529,7,8,9,10,38,47,-9,33
Perth Glory,7529,8,10,2,15,37,50,-13,32
Wellington P,7529,9,5,6,16,31,55,-24,21
CC Mariners,7529,10,4,8,15,28,49,-21,20
Sydney FC,7530,1,20,4,4,64,24,40,64
N'castle Jet,7530,2,16,5,7,59,38,21,53
Melbourne V,7530,3,14,5,10,47,38,9,47
Melbourne C,7530,4,14,4,11,44,35,9,46
Adelaide Utd,7530,5,11,6,11,37,40,-3,39
Brisbane,7530,6,10,5,13,33,42,-9,35
Western Sydn,7530,7,8,9,10,38,47,-9,33
Perth Glory,7530,8,10,2,15,37,50,-13,32
Wellington P,7530,9,5,6,16,31,55,-24,21
CC Mariners,7530,10,4,8,15,28,49,-21,20
Sydney FC,7531,1,21,4,3,67,24,43,67
N'castle Jet,7531,2,15,6,7,58,38,20,51
Melbourne C,7531,3,14,5,10,44,34,10,47
Melbourne V,7531,4,13,5,11,47,41,6,44
Adelaide Utd,7531,5,11,6,11,37,40,-3,39
Brisbane,7531,6,10,5,13,33,42,-9,35
Western Sydn,7531,7,8,9,10,38,47,-9,33
Perth Glory,7531,8,10,2,15,37,50,-13,32
Wellington P,7531,9,5,6,16,31,55,-24,21
CC Mariners,7531,10,4,8,15,28,49,-21,20
Sydney FC,7532,1,21,4,3,65,22,43,67
N'castle Jet,7532,2,16,5,7,59,37,22,53
Melbourne C,7532,3,14,4,11,43,35,8,46
Melbourne V,7532,4,13,5,11,45,39,6,44
Adelaide Utd,7532,5,11,6,11,37,40,-3,39
Brisbane,7532,6,10,5,13,33,42,-9,35
Western Sydn,7532,7,8,9,10,38,47,-9,33
Perth Glory,7532,8,10,2,15,37,50,-13,32
Wellington P,7532,9,5,6,16,31,55,-24,21
CC Mariners,7532,10,4,8,15,28,49,-21,20
Sydney FC,7533,1,20,4,4,67,27,40,64
N'castle Jet,7533,2,16,5,7,59,37,22,53
Melbourne V,7533,3,14,5,10,50,41,9,47
Melbourne C,7533,4,14,4,11,43,35,8,46
Adelaide Utd,7533,5,11,6,11,37,40,-3,39
Brisbane,7533,6,10,5,13,33,42,-9,35
Western Sydn,7533,7,8,9,10,38,47,-9,33
Perth Glory,7533,8,10,2,15,37,50,-13,32
Wellington P,7533,9,5,6,16,31,55,-24,21
CC Mariners,7533,10,4,8,15,28,49,-21,20
Sydney FC,7534,1,20,5,3,66,24,42,65
N'castle Jet,7534,2,16,5,7,60,38,22,53
Melbourne C,7534,3,14,4,11,44,36,8,46
Melbourne V,7534,4,13,6,10,47,40,7,45
Adelaide Utd,7534,5,11,6,11,37,40,-3,39
Brisbane,7534,6,10,5,13,33,42,-9,35
Western Sydn,7534,7,8,9,10,38,47,-9,33
Perth Glory,7534,8,10,2,15,37,50,-13,32
Wellington P,7534,9,5,6,16,31,55,-24,21
CC Mariners,7534,10,4,8,15,28,49,-21,20
Sydney FC,7535,1,20,4,4,64,25,39,64
N'castle Jet,7535,2,16,5,7,62,38,24,53
Melbourne V,7535,3,14,5,10,48,38,10,47
Melbourne C,7535,4,14,4,11,44,38,6,46
Adelaide Utd,7535,5,11,6,11,37,40,-3,39
Brisbane,7535,6,10,5,13,33,42,-9,35
Western Sydn,7535,7,8,9,10,38,47,-9,33
Perth Glory,7535,8,10,2,15,37,50,-13,32
Wellington P,7535,9,5,6,16,31,55,-24,21
CC Mariners,7535,10,4,8,15,28,49,-21,20
Sydney FC,7536,1,21,4,3,67,23,44,67
N'castle Jet,7536,2,15,6,7,58,38,20,51
Melbourne C,7536,3,14,5,10,44,34,10,47
Melbourne V,7536,4,13,5,11,46,41,5,44
Adelaide Utd,7536,5,11,6,11,37,40,-3,39
Brisbane,7536,6,10,5,13,33,42,-9,35
Western Sydn,7536,7,8,9,10,38,47,-9,33
Perth Glory,7536,8,10,2,15,37,50,-13,32
Wellington P,7536,9,5,6,16,31,55,-24,21
CC Mariners,7536,10,4,8,15,28,49,-21,20
Sydney FC,7537,1,21,4,3,67,24,43,67
N'castle Jet,7537,2,15,6,7,57,37,20,51
Melbourne C,7537,3,14,5,10,43,33,10,47
Melbourne V,7537,4,13,5,11,47,41,6,44
Adelaide Utd,7537,5,11,6,11,37,40,-3,39
Brisbane,7537,6,10,5,13,33,42,-9,35
Western Sydn,7537,7,8,9,10,38,47,-9,33
Perth Glory,7537,8,10,2,15,37,50,-13,32
Wellington P,7537,9,5,6,16,31,55,-24,21
CC Mariners,7537,10,4,8,15,28,49,-21,20
Sydney FC,7538,1,20,5,3,65,23,42,65
N'castle Jet,7538,2,16,5,7,60,39,21,53
Melbourne C,7538,3,14,4,11,45,36,9,46
Melbourne V,7538,4,13,6,10,46,39,7,45
Adelaide Utd,7538,5,11,6,11,37,40,-3,39
Brisbane,7538,6,10,5,13,33,42,-9,35
Western Sydn,7538,7,8,9,10,38,47,-9,33
Perth Glory,7538,8,10,2,15,37,50,-13,32
Wellington P,7538,9,5,6,16,31,55,-24,21
CC Mariners,7538,10,4,8,15,28,49,-21,20
Sydney FC,7539,1,20,4,4,64,23,41,64
N'castle Jet,7539,2,16,5,7,59,38,21,53
Melbourne V,7539,3,14,5,10,46,38,8,47
Melbourne C,7539,4,14,4,11,44,35,9,46
Adelaide Utd,7539,5,11,6,11,37,40,-3,39
Brisbane,7539,6,10,5,13,33,42,-9,35
Western Sydn,7539,7,8,9,10,38,47,-9,33
Perth Glory,7539,8,10,2,15,37,50,-13,32
Wellington P,7539,9,5,6,16,31,55,-24,21
CC Mariners,7539,10,4,8,15,28,49,-21,20
Sydney FC,7540,1,21,4,3,68,23,45,67
N'castle Jet,7540,2,16,5,7,58,37,21,53
Melbourne C,7540,3,14,4,11,43,34,9,46
Melbourne V,7540,4,13,5,11,46,42,4,44
Adelaide Utd,7540,5,11,6,11,37,40,-3,39
Brisbane,7540,6,10,5,13,33,42,-9,35
Western Sydn,7540,7,8,9,10,38,47,-9,33
Perth Glory,7540,8,10,2,15,37,50,-13,32
Wellington P,7540,9,5,6,16,31,55,-24,21
CC Mariners,7540,10,4,8,15,28,49,-21,20
Sydney FC,7541,1,20,4,4,65,24,41,64
N'castle Jet,7541,2,15,5,8,58,39,19,50
Melbourne C,7541,3,15,4,10,45,34,11,49
Melbourne V,7541,4,14,5,10,47,39,8,47
Adelaide Utd,7541,5,11,6,11,37,40,-3,39
Brisbane,7541,6,10,5,13,33,42,-9,35
Western Sydn,7541,7,8,9,10,38,47,-9,33
Perth Glory,7541,8,10,2,15,37,50,-13,32
Wellington P,7541,9,5,6,16,31,55,-24,21
CC Mariners,7541,10,4,8,15,28,49,-21,20
Sydney FC,7542,1,21,4,3,66,22,44,67
N'castle Jet,7542,2,15,5,8,59,40,19,50
Melbourne C,7542,3,15,4,10,46,35,11,49
Melbourne V,7542,4,13,5,11,45,40,5,44
Adelaide Utd,7542,5,11,6,11,37,40,-3,39
Brisbane,7542,6,10,5,13,33,42,-9,35
Western Sydn,7542,7,8,9,10,38,47,-9,33
Perth Glory,7542,8,10,2,15,37,50,-13,32
Wellington P,7542,9,5,6,16,31,55,-24,21
CC Mariners,7542,10,4,8,15,28,49,-21,20
Sydney FC,7543,1,21,4,3,66,23,43,67
N'castle Jet,7543,2,16,5,7,59,38,21,53
Melbourne C,7543,3,14,4,11,44,35,9,46
Melbourne V,7543,4,13,5,11,46,40,6,44
Adelaide Utd,7543,5,11,6,11,37,40,-3,39
Brisbane,7543,6,10,5,13,33,42,-9,35
Western Sydn,7543,7,8,9,10,38,47,-9,33
Perth Glory,7543,8,10,2,15,37,50,-13,32
Wellington P,7543,9,5,6,16,31,55,-24,21
CC Mariners,7543,10,4,8,15,28,49,-21,20
Sydney FC,7544,1,21,4,3,66,23,43,67
N'castle Jet,7544,2,15,5,8,58,40,18,50
Melbourne C,7544,3,15,4,10,46,34,12,49
Melbourne V,7544,4,13,5,11,46,40,6,44
Adelaide Utd,7544,5,11,6,11,37,40,-3,39
Brisbane,7544,6,10,5,13,33,42,-9,35
Western Sydn,7544,7,8,9,10,38,47,-9,33
Perth Glory,7544,8,10,2,15,37,50,-13,32
Wellington P,7544,9,5,6,16,31,55,-24,21
CC Mariners,7544,10,4,8,15,28,49,-21,20
Sydney FC,7545,1,21,4,3,69,25,44,67
N'castle Jet,7545,2,15,6,7,57,37,20,51
Melbourne C,7545,3,14,5,10,43,33,10,47
Melbourne V,7545,4,13,5,11,48,43,5,44
Adelaide Utd,7545,5,11,6,11,37,40,-3,39
Brisbane,7545,6,10,5,13,33,42,-9,35
Western Sydn,7545,7,8,9,10,38,47,-9,33
Perth Glory,7545,8,10,2,15,37,50,-13,32
Wellington P,7545,9,5,6,16,31,55,-24,21
CC Mariners,7545,10,4,8,15,28,49,-21,20
Sydney FC,7546,1,21,4,3,65,22,43,67
N'castle Jet,7546,2,15,5,8,58,39,19,50
Melbourne C,7546,3,15,4,10,45,34,11,49
Melbourne V,7546,4,13,5,11,45,39,6,44
Adelaide Utd,7546,5,11,6,11,37,40,-3,39
Brisbane,7546,6,10,5,13,33,42,-9,35
Western Sydn,7546,7,8,9,10,38,47,-9,33
Perth Glory,7546,8,10,2,15,37,50,-13,32
Wellington P,7546,9,5,6,16,31,55,-24,21
CC Mariners,7546,10,4,8,15,28,49,-21,20
Sydney FC,7547,1,20,5,3,65,23,42,65
N'castle Jet,7547,2,15,6,7,60,40,20,51
Melbourne C,7547,3,14,5,10,46,36,10,47
Melbourne V,7547,4,13,6,10,46,39,7,45
Adelaide Utd,7547,5,11,6,11,37,40,-3,39
Brisbane,7547,6,10,5,13,33,42,-9,35
Western Sydn,7547,7,8,9,10,38,47,-9,33
Perth Glory,7547,8,10,2,15,37,50,-13,32
Wellington P,7547,9,5,6,16,31,55,-24,21
CC Mariners,7547,10,4,8,15,28,49,-21,20
Sydney FC,7548,1,21,4,3,70,23,47,67
N'castle Jet,7548,2,15,5,8,57,40,17,50
Melbourne C,7548,3,15,4,10,46,33,13,49
Melbourne V,7548,4,13,5,11,46,44,2,44
Adelaide Utd,7548,5,11,6,11,37,40,-3,39
Brisbane,7548,6,10,5,13,33,42,-9,35
Western Sydn,7548,7,8,9,10,38,47,-9,33
Perth Glory,7548,8,10,2,15,37,50,-13,32
Wellington P,7548,9,5,6,16,31,55,-24,21
CC Mariners,7548,10,4,8,15,28,49,-21,20
Sydney FC,7549,1,21,4,3,67,24,43,67
N'castle Jet,7549,2,15,6,7,58,38,20,51
Melbourne C,7549,3,14,5,10,44,34,10,47
Melbourne V,7549,4,13,5,11,47,41,6,44
Adelaide Utd,7549,5,11,6,11,37,40,-3,39
Brisbane,7549,6,10,5,13,33,42,-9,35
Western Sydn,7549,7,8,9,10,38,47,-9,33
Perth Glory,7549,8,10,2,15,37,50,-13,32
Wellington P,7549,9,5,6,16,31,55,-24,21
CC Mariners,7549,10,4,8,15,28,49,-21,20
Sydney FC,7550,1,21,4,3,68,23,45,67
N'castle Jet,7550,2,15,5,8,57,40,17,50
Melbourne C,7550,3,15,4,10,46,33,13,49
Melbourne V,7550,4,13,5,11,46,42,4,44
Adelaide Utd,7550,5,11,6,11,37,40,-3,39
Brisbane,7550,6,10,5,13,33,42,-9,35
Western Sydn,7550,7,8,9,10,38,47,-9,33
Perth Glory,7550,8,10,2,15,37,50,-13,32
Wellington P,7550,9,5,6,16,31,55,-24,21
CC Mariners,7550,10,4,8,15,28,49,-21,20
Sydney FC,7551,1,21,4,3,67,23,44,67
N'castle Jet,7551,2,16,5,7,61,39,22,53
Melbourne C,7551,3,14,4,11,45,37,8,46
Melbourne V,7551,4,13,5,11,46,41,5,44
Adelaide Utd,7551,5,11,6,11,37,40,-3,39
Brisbane,7551,6,10,5,13,33,42,-9,35
Western Sydn,7551,7,8,9,10,38,47,-9,33
Perth Glory,7551,8,10,2,15,37,50,-13,32
Wellington P,7551,9,5,6,16,31,55,-24,21
CC Mariners,7551,10,4,8,15,28,49,-21,20
Sydney FC,7552,1,21,4,3,68,22,46,67
N'castle Jet,7552,2,16,5,7,60,38,22,53
Melbourne C,7552,3,14,4,11,44,36,8,46
Melbourne V,7552,4,13,5,11,45,42,3,44
Adelaide Utd,7552,5,11,6,11,37,40,-3,39
Brisbane,7552,6,10,5,13,33,42,-9,35
Western Sydn,7552,7,8,9,10,38,47,-9,33
Perth Glory,7552,8,10,2,15,37,50,-13,32
Wellington P,7552,9,5,6,16,31,55,-24,21
CC Mariners,7552,10,4,8,15,28,49,-21,20
Sydney FC,7553,1,20,5,3,65,23,42,65
N'castle Jet,7553,2,15,6,7,58,38,20,51
Melbourne C,7553,3,14,5,10,44,34,10,47
Melbourne V,7553,4,13,6,10,46,39,7,45
Adelaide Utd,7553,5,11,6,11,37,40,-3,39
Brisbane,7553,6,10,5,13,33,42,-9,35
Western Sydn,7553,7,8,9,10,38,47,-9,33
Perth Glory,7553,8,10,2,15,37,50,-13,32
Wellington P,7553,9,5,6,16,31,55,-24,21
CC Mariners,7553,10,4,8,15,28,49,-21,20
Sydney FC,7554,1,20,5,3,65,23,42,65
N'castle Jet,7554,2,15,6,7,58,38,20,51
Melbourne C,7554,3,14,5,10,44,34,10,47
Melbourne V,7554,4,13,6,10,46,39,7,45
Adelaide Utd,7554,5,11,6,11,37,40,-3,39
Brisbane,7554,6,10,5,13,33,42,-9,35
Western Sydn,7554,7,8,9,10,38,47,-9,33
Perth Glory,7554,8,10,2,15,37,50,-13,32
Wellington P,7554,9,5,6,16,31,55,-24,21
CC Mariners,7554,10,4,8,15,28,49,-21,20
Sydney FC,7555,1,21,4,3,65,22,43,67
N'castle Jet,7555,2,15,5,8,57,40,17,50
Melbourne C,7555,3,15,4,10,46,33,13,49
Melbourne V,7555,4,13,5,11,45,39,6,44
Adelaide Utd,7555,5,11,6,11,37,40,-3,39
Brisbane,7555,6,10,5,13,33,42,-9,35
Western Sydn,7555,7,8,9,10,38,47,-9,33
Perth Glory,7555,8,10,2,15,37,50,-13,32
Wellington P,7555,9,5,6,16,31,55,-24,21
CC Mariners,7555,10,4,8,15,28,49,-21,20
Sydney FC,7556,1,21,4,3,68,22,46,67
N'castle Jet,7556,2,16,5,7,59,37,22,53
Melbourne C,7556,3,14,4,11,43,35,8,46
Melbourne V,7556,4,13,5,11,45,42,3,44
Adelaide Utd,7556,5,11,6,11,37,40,-3,39
Brisbane,7556,6,10,5,13,33,42,-9,35
Western Sydn,7556,7,8,9,10,38,47,-9,33
Perth Glory,7556,8,10,2,15,37,50,-13,32
Wellington P,7556,9,5,6,16,31,55,-24,21
CC Mariners,7556,10,4,8,15,28,49,-21,20
Sydney FC,7557,1,21,4,3,65,22,43,67
N'castle Jet,7557,2,16,5,7,60,38,22,53
Melbourne C,7557,3,14,4,11,44,36,8,46
Melbourne V,7557,4,13,5,11,45,39,6,44
Adelaide Utd,7557,5,11,6,11,37,40,-3,39
Brisbane,7557,6,10,5,13,33,42,-9,35
Western Sydn,7557,7,8,9,10,38,47,-9,33
Perth Glory,7557,8,10,2,15,37,50,-13,32
Wellington P,7557,9,5,6,16,31,55,-24,21
CC Mariners,7557,10,4,8,15,28,49,-21,20
Sydney FC,7558,1,21,4,3,66,22,44,67
N'castle Jet,7558,2,15,6,7,57,37,20,51
Melbourne C,7558,3,14,5,10,43,33,10,47
Melbourne V,7558,4,13,5,11,45,40,5,44
Adelaide Utd,7558,5,11,6,11,37,40,-3,39
Brisbane,7558,6,10,5,13,33,42,-9,35
Western Sydn,7558,7,8,9,10,38,47,-9,33
Perth Glory,7558,8,10,2,15,37,50,-13,32
Wellington P,7558,9,5,6,16,31,55,-24,21
CC Mariners,7558,10,4,8,15,28,49,-21,20
Sydney FC,7559,1,21,4,3,70,23,47,67
N'castle Jet,7559,2,15,5,8,58,39,19,50
Melbourne C,7559,3,15,4,10,45,34,11,49
Melbourne V,7559,4,13,5,11,46,44,2,44
Adelaide Utd,7559,5,11,6,11,37,40,-3,39
Brisbane,7559,6,10,5,13,33,42,-9,35
Western Sydn,7559,7,8,9,10,38,47,-9,33
Perth Glory,7559,8,10,2,15,37,50,-13,32
Wellington P,7559,9,5,6,16,31,55,-24,21
CC Mariners,7559,10,4,8,15,28,49,-21,20
Sydney FC,7560,1,21,4,3,66,22,44,67
N'castle Jet,7560,2,16,5,7,59,37,22,53
Melbourne C,7560,3,14,4,11,43,35,8,46
Melbourne V,7560,4,13,5,11,45,40,5,44
Adelaide Utd,7560,5,11,6,11,37,40,-3,39
Brisbane,7560,6,10,5,13,33,42,-9,35
Western Sydn,7560,7,8,9,10,38,47,-9,33
Perth Glory,7560,8,10,2,15,37,50,-13,32
Wellington P,7560,9,5,6,16,31,55,-24,21
CC Mariners,7560,10,4,8,15,28,49,-21,20
Sydney FC,7561,1,21,4,3,67,23,44,67
N'castle Jet,7561,2,16,5,7,60,37,23,53
Melbourne C,7561,3,14,4,11,43,36,7,46
Melbourne V,7561,4,13,5,11,46,41,5,44
Adelaide Utd,7561,5,11,6,11,37,40,-3,39
Brisbane,7561,6,10,5,13,33,42,-9,35
Western Sydn,7561,7,8,9,10,38,47,-9,33
Perth Glory,7561,8,10,2,15,37,50,-13,32
Wellington P,7561,9,5,6,16,31,55,-24,21
CC Mariners,7561,10,4,8,15,28,49,-21,20
Sydney FC,7562,1,21,4,3,67,23,44,67
N'castle Jet,7562,2,15,6,7,60,40,20,51
Melbourne C,7562,3,14,5,10,46,36,10,47
Melbourne V,7562,4,13,5,11,46,41,5,44
Adelaide Utd,7562,5,11,6,11,37,40,-3,39
Brisbane,7562,6,10,5,13,33,42,-9,35
Western Sydn,7562,7,8,9,10,38,47,-9,33
Perth Glory,7562,8,10,2,15,37,50,-13,32
Wellington P,7562,9,5,6,16,31,55,-24,21
CC Mariners,7562,10,4,8,15,28,49,-21,20
Sydney FC,7563,1,20,5,3,64,22,42,65
N'castle Jet,7563,2,16,5,7,59,38,21,53
Melbourne C,7563,3,14,4,11,44,35,9,46
Melbourne V,7563,4,13,6,10,45,38,7,45
Adelaide Utd,7563,5,11,6,11,37,40,-3,39
Brisbane,7563,6,10,5,13,33,42,-9,35
Western Sydn,7563,7,8,9,10,38,47,-9,33
Perth Glory,7563,8,10,2,15,37,50,-13,32
Wellington P,7563,9,5,6,16,31,55,-24,21
CC Mariners,7563,10,4,8,15,28,49,-21,20
Sydney FC,7564,1,20,5,3,65,23,42,65
N'castle Jet,7564,2,15,6,7,58,38,20,51
Melbourne C,7564,3,14,5,10,44,34,10,47
Melbourne V,7564,4,13,6,10,46,39,7,45
Adelaide Utd,7564,5,11,6,11,37,40,-3,39
Brisbane,7564,6,10,5,13,33,42,-9,35
Western Sydn,7564,7,8,9,10,38,47,-9,33
Perth Glory,7564,8,10,2,15,37,50,-13,32
Wellington P,7564,9,5,6,16,31,55,-24,21
CC Mariners,7564,10,4,8,15,28,49,-21,20
Sydney FC,7565,1,20,4,4,64,23,41,64
N'castle Jet,7565,2,15,5,8,58,39,19,50
Melbourne C,7565,3,15,4,10,45,34,11,49
Melbourne V,7565,4,14,5,10,46,38,8,47
Adelaide Utd,7565,5,11,6,11,37,40,-3,39
Brisbane,7565,6,10,5,13,33,42,-9,35
Western Sydn,7565,7,8,9,10,38,47,-9,33
Perth Glory,7565,8,10,2,15,37,50,-13,32
Wellington P,7565,9,5,6,16,31,55,-24,21
CC Mariners,7565,10,4,8,15,28,49,-21,20
Sydney FC,7566,1,21,4,3,65,22,43,67
N'castle Jet,7566,2,15,5,8,57,38,19,50
Melbourne C,7566,3,15,4,10,44,33,11,49
Melbourne V,7566,4,13,5,11,45,39,6,44
Adelaide Utd,7566,5,11,6,11,37,40,-3,39
Brisbane,7566,6,10,5,13,33,42,-9,35
Western Sydn,7566,7,8,9,10,38,47,-9,33
Perth Glory,7566,8,10,2,15,37,50,-13,32
Wellington P,7566,9,5,6,16,31,55,-24,21
CC Mariners,7566,10,4,8,15,28,49,-21,20
Sydney FC,7567,1,20,5,3,65,23,42,65
N'castle Jet,7567,2,16,5,7,58,37,21,53
Melbourne C,7567,3,14,4,11,43,34,9,46
Melbourne V,7567,4,13,6,10,46,39,7,45
Adelaide Utd,7567,5,11,6,11,37,40,-3,39
Brisbane,7567,6,10,5,13,33,42,-9,35
Western Sydn,7567,7,8,9,10,38,47,-9,33
Perth Glory,7567,8,10,2,15,37,50,-13,32
Wellington P,7567,9,5,6,16,31,55,-24,21
CC Mariners,7567,10,4,8,15,28,49,-21,20
Sydney FC,7568,1,20,4,4,66,25,41,64
N'castle Jet,7568,2,16,5,7,60,38,22,53
Melbourne V,7568,3,14,5,10,48,40,8,47
Melbourne C,7568,4,14,4,11,44,36,8,46
Adelaide Utd,7568,5,11,6,11,37,40,-3,39
Brisbane,7568,6,10,5,13,33,42,-9,35
Western Sydn,7568,7,8,9,10,38,47,-9,33
Perth Glory,7568,8,10,2,15,37,50,-13,32
Wellington P,7568,9,5,6,16,31,55,-24,21
CC Mariners,7568,10,4,8,15,28,49,-21,20
Sydney FC,7569,1,20,4,4,64,23,41,64
N'castle Jet,7569,2,15,6,7,59,39,20,51
Melbourne C,7569,3,14,5,10,45,35,10,47
Melbourne V,7569,4,14,5,10,46,38,8,47
Adelaide Utd,7569,5,11,6,11,37,40,-3,39
Brisbane,7569,6,10,5,13,33,42,-9,35
Western Sydn,7569,7,8,9,10,38,47,-9,33
Perth Glory,7569,8,10,2,15,37,50,-13,32
Wellington P,7569,9,5,6,16,31,55,-24,21
CC Mariners,7569,10,4,8,15,28,49,-21,20
Sydney FC,7570,1,21,4,3,67,22,45,67
N'castle Jet,7570,2,16,5,7,58,37,21,53
Melbourne C,7570,3,14,4,11,43,34,9,46
Melbourne V,7570,4,13,5,11,45,41,4,44
Adelaide Utd,7570,5,11,6,11,37,40,-3,39
Brisbane,7570,6,10,5,13,33,42,-9,35
Western Sydn,7570,7,8,9,10,38,47,-9,33
Perth Glory,7570,8,10,2,15,37,50,-13,32
Wellington P,7570,9,5,6,16,31,55,-24,21
CC Mariners,7570,10,4,8,15,28,49,-21,20
Sydney FC,7571,1,21,4,3,67,22,45,67
N'castle Jet,7571,2,15,5,8,57,39,18,50
Melbourne C,7571,3,15,4,10,45,33,12,49
Melbourne V,7571,4,13,5,11,45,41,4,44
Adelaide Utd,7571,5,11,6,11,37,40,-3,39
Brisbane,7571,6,10,5,13,33,42,-9,35
Western Sydn,7571,7,8,9,10,38,47,-9,33
Perth Glory,7571,8,10,2,15,37,50,-13,32
Wellington P,7571,9,5,6,16,31,55,-24,21
CC Mariners,7571,10,4,8,15,28,49,-21,20
Sydney FC,7572,1,20,4,4,64,23,41,64
N'castle Jet,7572,2,16,5,7,60,39,21,53
Melbourne V,7572,3,14,5,10,46,38,8,47
Melbourne C,7572,4,14,4,11,45,36,9,46
Adelaide Utd,7572,5,11,6,11,37,40,-3,39
Brisbane,7572,6,10,5,13,33,42,-9,35
Western Sydn,7572,7,8,9,10,38,47,-9,33
Perth Glory,7572,8,10,2,15,37,50,-13,32
Wellington P,7572,9,5,6,16,31,55,-24,21
CC Mariners,7572,10,4,8,15,28,49,-21,20
Sydney FC,7573,1,21,4,3,67,22,45,67
N'castle Jet,7573,2,16,5,7,60,38,22,53
Melbourne C,7573,3,14,4,11,44,36,8,46
Melbourne V,7573,4,13,5,11,45,41,4,44
Adelaide Utd,7573,5,11,6,11,37,40,-3,39
Brisbane,7573,6,10,5,13,33,42,-9,35
Western Sydn,7573,7,8,9,10,38,47,-9,33
Perth Glory,7573,8,10,2,15,37,50,-13,32
Wellington P,7573,9,5,6,16,31,55,-24,21
CC Mariners,7573,10,4,8,15,28,49,-21,20
Sydney FC,7574,1,20,5,3,65,23,42,65
N'castle Jet,7574,2,16,5,7,59,37,22,53
Melbourne C,7574,3,14,4,11,43,35,8,46
Melbourne V,7574,4,13,6,10,46,39,7,45
Adelaide Utd,7574,5,11,6,11,37,40,-3,39
Brisbane,7574,6,10,5,13,33,42,-9,35
Western Sydn,7574,7,8,9,10,38,47,-9,33
Perth Glory,7574,8,10,2,15,37,50,-13,32
Wellington P,7574,9,5,6,16,31,55,-24,21
CC Mariners,7574,10,4,8,15,28,49,-21,20
Sydney FC,7575,1,21,4,3,68,24,44,67
N'castle Jet,7575,2,15,5,8,57,38,19,50
Melbourne C,7575,3,15,4,10,44,33,11,49
Melbourne V,7575,4,13,5,11,47,42,5,44
Adelaide Utd,7575,5,11,6,11,37,40,-3,39
Brisbane,7575,6,10,5,13,33,42,-9,35
Western Sydn,7575,7,8,9,10,38,47,-9,33
Perth Glory,7575,8,10,2,15,37,50,-13,32
Wellington P,7575,9,5,6,16,31,55,-24,21
CC Mariners,7575,10,4,8,15,28,49,-21,20
Sydney FC,7576,1,21,4,3,68,23,45,67
N'castle Jet,7576,2,15,5,8,58,39,19,50
Melbourne C,7576,3,15,4,10,45,34,11,49
Melbourne V,7576,4,13,5,11,46,42,4,44
Adelaide Utd,7576,5,11,6,11,37,40,-3,39
Brisbane,7576,6,10,5,13,33,42,-9,35
Western Sydn,7576,7,8,9,10,38,47,-9,33
Perth Glory,7576,8,10,2,15,37,50,-13,32
Wellington P,7576,9,5,6,16,31,55,-24,21
CC Mariners,7576,10,4,8,15,28,49,-21,20
Sydney FC,7577,1,20,5,3,65,23,42,65
N'castle Jet,7577,2,15,6,7,58,38,20,51
Melbourne C,7577,3,14,5,10,44,34,10,47
Melbourne V,7577,4,13,6,10,46,39,7,45
Adelaide Utd,7577,5,11,6,11,37,40,-3,39
Brisbane,7577,6,10,5,13,33,42,-9,35
Western Sydn,7577,7,8,9,10,38,47,-9,33
Perth Glory,7577,8,10,2,15,37,50,-13,32
Wellington P,7577,9,5,6,16,31,55,-24,21
CC Mariners,7577,10,4,8,15,28,49,-21,20
Sydney FC,7578,1,21,4,3,67,23,44,67
N'castle Jet,7578,2,16,5,7,61,38,23,53
Melbourne C,7578,3,14,4,11,44,37,7,46
Melbourne V,7578,4,13,5,11,46,41,5,44
Adelaide Utd,7578,5,11,6,11,37,40,-3,39
Brisbane,7578,6,10,5,13,33,42,-9,35
Western Sydn,7578,7,8,9,10,38,47,-9,33
Perth Glory,7578,8,10,2,15,37,50,-13,32
Wellington P,7578,9,5,6,16,31,55,-24,21
CC Mariners,7578,10,4,8,15,28,49,-21,20
Sydney FC,7579,1,21,4,3,66,22,44,67
N'castle Jet,7579,2,15,5,8,57,40,17,50
Melbourne C,7579,3,15,4,10,46,33,13,49
Melbourne V,7579,4,13,5,11,45,40,5,44
Adelaide Utd,7579,5,11,6,11,37,40,-3,39
Brisbane,7579,6,10,5,13,33,42,-9,35
Western Sydn,7579,7,8,9,10,38,47,-9,33
Perth Glory,7579,8,10,2,15,37,50,-13,32
Wellington P,7579,9,5,6,16,31,55,-24,21
CC Mariners,7579,10,4,8,15,28,49,-21,20
Sydney FC,7580,1,20,4,4,64,24,40,64
N'castle Jet,7580,2,16,5,7,61,38,23,53
Melbourne V,7580,3,14,5,10,47,38,9,47
Melbourne C,7580,4,14,4,11,44,37,7,46
Adelaide Utd,7580,5,11,6,11,37,40,-3,39
Brisbane,7580,6,10,5,13,33,42,-9,35
Western Sydn,7580,7,8,9,10,38,47,-9,33
Perth Glory,7580,8,10,2,15,37,50,-13,32
Wellington P,7580,9,5,6,16,31,55,-24,21
CC Mariners,7580,10,4,8,15,28,49,-21,20
Sydney FC,7581,1,20,4,4,66,25,41,64
N'castle Jet,7581,2,16,5,7,60,39,21,53
Melbourne V,7581,3,14,5,10,48,40,8,47
Melbourne C,7581,4,14,4,11,45,36,9,46
Adelaide Utd,7581,5,11,6,11,37,40,-3,39
Brisbane,7581,6,10,5,13,33,42,-9,35
Western Sydn,7581,7,8,9,10,38,47,-9,33
Perth Glory,7581,8,10,2,15,37,50,-13,32
Wellington P,7581,9,5,6,16,31,55,-24,21
CC Mariners,7581,10,4,8,15,28,49,-21,20
Sydney FC,7582,1,20,4,4,66,25,41,64
N'castle Jet,7582,2,15,6,7,59,39,20,51
Melbourne C,7582,3,14,5,10,45,35,10,47
Melbourne V,7582,4,14,5,10,48,40,8,47
Adelaide Utd,7582,5,11,6,11,37,40,-3,39
Brisbane,7582,6,10,5,13,33,42,-9,35
Western Sydn,7582,7,8,9,10,38,47,-9,33
Perth Glory,7582,8,10,2,15,37,50,-13,32
Wellington P,7582,9,5,6,16,31,55,-24,21
CC Mariners,7582,10,4,8,15,28,49,-21,20
Sydney FC,7583,1,21,4,3,69,23,46,67
N'castle Jet,7583,2,15,6,7,58,38,20,51
Melbourne C,7583,3,14,5,10,44,34,10,47
Melbourne V,7583,4,13,5,11,46,43,3,44
Adelaide Utd,7583,5,11,6,11,37,40,-3,39
Brisbane,7583,6,10,5,13,33,42,-9,35
Western Sydn,7583,7,8,9,10,38,47,-9,33
Perth Glory,7583,8,10,2,15,37,50,-13,32
Wellington P,7583,9,5,6,16,31,55,-24,21
CC Mariners,7583,10,4,8,15,28,49,-21,20
Sydney FC,7584,1,21,4,3,66,22,44,67
N'castle Jet,7584,2,16,5,7,59,38,21,53
Melbourne C,7584,3,14,4,11,44,35,9,46
Melbourne V,7584,4,13,5,11,45,40,5,44
Adelaide Utd,7584,5,11,6,11,37,40,-3,39
Brisbane,7584,6,10,5,13,33,42,-9,35
Western Sydn,7584,7,8,9,10,38,47,-9,33
Perth Glory,7584,8,10,2,15,37,50,-13,32
Wellington P,7584,9,5,6,16,31,55,-24,21
CC Mariners,7584,10,4,8,15,28,49,-21,20
Sydney FC,7585,1,21,4,3,68,22,46,67
N'castle Jet,7585,2,15,6,7,58,38,20,51
Melbourne C,7585,3,14,5,10,44,34,10,47
Melbourne V,7585,4,13,5,11,45,42,3,44
Adelaide Utd,7585,5,11,6,11,37,40,-3,39
Brisbane,7585,6,10,5,13,33,42,-9,35
Western Sydn,7585,7,8,9,10,38,47,-9,33
Perth Glory,7585,8,10,2,15,37,50,-13,32
Wellington P,7585,9,5,6,16,31,55,-24,21
CC Mariners,7585,10,4,8,15,28,49,-21,20
Sydney FC,7586,1,20,5,3,64,22,42,65
N'castle Jet,7586,2,15,5,8,57,38,19,50
Melbourne C,7586,3,15,4,10,44,33,11,49
Melbourne V,7586,4,13,6,10,45,38,7,45
Adelaide Utd,7586,5,11,6,11,37,40,-3,39
Brisbane,7586,6,10,5,13,33,42,-9,35
Western Sydn,7586,7,8,9,10,38,47,-9,33
Perth Glory,7586,8,10,2,15,37,50,-13,32
Wellington P,7586,9,5,6,16,31,55,-24,21
CC Mariners,7586,10,4,8,15,28,49,-21,20
Sydney FC,7587,1,20,5,3,64,22,42,65
N'castle Jet,7587,2,16,5,7,59,38,21,53
Melbourne C,7587,3,14,4,11,44,35,9,46
Melbourne V,7587,4,13,6,10,45,38,7,45
Adelaide Utd,7587,5,11,6,11,37,40,-3,39
Brisbane,7587,6,10,5,13,33,42,-9,35
Western Sydn,7587,7,8,9,10,38,47,-9,33
Perth Glory,7587,8,10,2,15,37,50,-13,32
Wellington P,7587,9,5,6,16,31,55,-24,21
CC Mariners,7587,10,4,8,15,28,49,-21,20
Sydney FC,7588,1,20,5,3,66,24,42,65
N'castle Jet,7588,2,15,6,7,58,38,20,51
Melbourne C,7588,3,14,5,10,44,34,10,47
Melbourne V,7588,4,13,6,10,47,40,7,45
Adelaide Utd,7588,5,11,6,11,37,40,-3,39
Brisbane,7588,6,10,5,13,33,42,-9,35
Western Sydn,7588,7,8,9,10,38,47,-9,33
Perth Glory,7588,8,10,2,15,37,50,-13,32
Wellington P,7588,9,5,6,16,31,55,-24,21
CC Mariners,7588,10,4,8,15,28,49,-21,20
Sydney FC,7589,1,20,5,3,66,24,42,65
N'castle Jet,7589,2,16,5,7,60,39,21,53
Melbourne C,7589,3,14,4,11,45,36,9,46
Melbourne V,7589,4,13,6,10,47,40,7,45
Adelaide Utd,7589,5,11,6,11,37,40,-3,39
Brisbane,7589,6,10,5,13,33,42,-9,35
Western Sydn,7589,7,8,9,10,38,47,-9,33
Perth Glory,7589,8,10,2,15,37,50,-13,32
Wellington P,7589,9,5,6,16,31,55,-24,21
CC Mariners,7589,10,4,8,15,28,49,-21,20
Sydney FC,7590,1,20,4,4,64,23,41,64
N'castle Jet,7590,2,16,5,7,60,39,21,53
Melbourne V,7590,3,14,5,10,46,38,8,47
Melbourne C,7590,4,14,4,11,45,36,9,46
Adelaide Utd,7590,5,11,6,11,37,40,-3,39
Brisbane,7590,6,10,5,13,33,42,-9,35
Western Sydn,7590,7,8,9,10,38,47,-9,33
Perth Glory,7590,8,10,2,15,37,50,-13,32
Wellington P,7590,9,5,6,16,31,55,-24,21
CC Mariners,7590,10,4,8,15,28,49,-21,20
Sydney FC,7591,1,21,4,3,66,23,43,67
N'castle Jet,7591,2,16,5,7,60,38,22,53
Melbourne C,7591,3,14,4,11,44,36,8,46
Melbourne V,7591,4,13,5,11,46,40,6,44
Adelaide Utd,7591,5,11,6,11,37,40,-3,39
Brisbane,7591,6,10,5,13,33,42,-9,35
Western Sydn,7591,7,8,9,10,38,47,-9,33
Perth Glory,7591,8,10,2,15,37,50,-13,32
Wellington P,7591,9,5,6,16,31,55,-24,21
CC Mariners,7591,10,4,8,15,28,49,-21,20
Sydney FC,7592,1,21,4,3,70,23,47,67
N'castle Jet,7592,2,16,5,7,59,37,22,53
Melbourne C,7592,3,14,4,11,43,35,8,46
Melbourne V,7592,4,13,5,11,46,44,2,44
Adelaide Utd,7592,5,11,6,11,37,40,-3,39
Brisbane,7592,6,10,5,13,33,42,-9,35
Western Sydn,7592,7,8,9,10,38,47,-9,33
Perth Glory,7592,8,10,2,15,37,50,-13,32
Wellington P,7592,9,5,6,16,31,55,-24,21
CC Mariners,7592,10,4,8,15,28,49,-21,20
Sydney FC,7593,1,21,4,3,67,23,44,67
N'castle Jet,7593,2,15,5,8,58,40,18,50
Melbourne C,7593,3,15,4,10,46,34,12,49
Melbourne V,7593,4,13,5,11,46,41,5,44
Adelaide Utd,7593,5,11,6,11,37,40,-3,39
Brisbane,7593,6,10,5,13,33,42,-9,35
Western Sydn,7593,7,8,9,10,38,47,-9,33
Perth Glory,7593,8,10,2,15,37,50,-13,32
Wellington P,7593,9,5,6,16,31,55,-24,21
CC Mariners,7593,10,4,8,15,28,49,-21,20
Sydney FC,7594,1,20,5,3,65,23,42,65
N'castle Jet,7594,2,16,5,7,61,38,23,53
Melbourne C,7594,3,14,4,11,44,37,7,46
Melbourne V,7594,4,13,6,10,46,39,7,45
Adelaide Utd,7594,5,11,6,11,37,40,-3,39
Brisbane,7594,6,10,5,13,33,42,-9,35
Western Sydn,7594,7,8,9,10,38,47,-9,33
Perth Glory,7594,8,10,2,15,37,50,-13,32
Wellington P,7594,9,5,6,16,31,55,-24,21
CC Mariners,7594,10,4,8,15,28,49,-21,20
Sydney FC,7595,1,20,5,3,66,24,42,65
N'castle Jet,7595,2,15,5,8,58,39,19,50
Melbourne C,7595,3,15,4,10,45,34,11,49
Melbourne V,7595,4,13,6,10,47,40,7,45
Adelaide Utd,7595,5,11,6,11,37,40,-3,39
Brisbane,7595,6,10,5,13,33,42,-9,35
Western Sydn,7595,7,8,9,10,38,47,-9,33
Perth Glory,7595,8,10,2,15,37,50,-13,32
Wellington P,7595,9,5,6,16,31,55,-24,21
CC Mariners,7595,10,4,8,15,28,49,-21,20
Sydney FC,7596,1,21,4,3,65,22,43,67
N'castle Jet,7596,2,16,5,7,59,38,21,53
Melbourne C,7596,3,14,4,11,44,35,9,46
Melbourne V,7596,4,13,5,11,45,39,6,44
Adelaide Utd,7596,5,11,6,11,37,40,-3,39
Brisbane,7596,6,10,5,13,33,42,-9,35
Western Sydn,7596,7,8,9,10,38,47,-9,33
Perth Glory,7596,8,10,2,15,37,50,-13,32
Wellington P,7596,9,5,6,16,31,55,-24,21
CC Mariners,7596,10,4,8,15,28,49,-21,20
Sydney FC,7597,1,20,5,3,64,22,42,65
N'castle Jet,7597,2,16,5,7,60,38,22,53
Melbourne C,7597,3,14,4,11,44,36,8,46
Melbourne V,7597,4,13,6,10,45,38,7,45
Adelaide Utd,7597,5,11,6,11,37,40,-3,39
Brisbane,7597,6,10,5,13,33,42,-9,35
Western Sydn,7597,7,8,9,10,38,47,-9,33
Perth Glory,7597,8,10,2,15,37,50,-13,32
Wellington P,7597,9,5,6,16,31,55,-24,21
CC Mariners,7597,10,4,8,15,28,49,-21,20
Sydney FC,7598,1,20,5,3,64,22,42,65
N'castle Jet,7598,2,15,5,8,57,39,18,50
Melbourne C,7598,3,15,4,10,45,33,12,49
Melbourne V,7598,4,13,6,10,45,38,7,45
Adelaide Utd,7598,5,11,6,11,37,40,-3,39
Brisbane,7598,6,10,5,13,33,42,-9,35
Western Sydn,7598,7,8,9,10,38,47,-9,33
Perth Glory,7598,8,10,2,15,37,50,-13,32
Wellington P,7598,9,5,6,16,31,55,-24,21
CC Mariners,7598,10,4,8,15,28,49,-21,20
Sydney FC,7599,1,20,5,3,65,23,42,65
N'castle Jet,7599,2,16,5,7,59,38,21,53
Melbourne C,7599,3,14,4,11,44,35,9,46
Melbourne V,7599,4,13,6,10,46,39,7,45
Adelaide Utd,7599,5,11,6,11,37,40,-3,39
Brisbane,7599,6,10,5,13,33,42,-9,35
Western Sydn,7599,7,8,9,10,38,47,-9,33
Perth Glory,7599,8,10,2,15,37,50,-13,32
Wellington P,7599,9,5,6,16,31,55,-24,21
CC Mariners,7599,10,4,8,15,28,49,-21,20
Sydney FC,7600,1,20,5,3,64,22,42,65
N'castle Jet,7600,2,15,5,8,57,39,18,50
Melbourne C,7600,3,15,4,10,45,33,12,49
Melbourne V,7600,4,13,6,10,45,38,7,45
Adelaide Utd,7600,5,11,6,11,37,40,-3,39
Brisbane,7600,6,10,5,13,33,42,-9,35
Western Sydn,7600,7,8,9,10,38,47,-9,33
Perth Glory,7600,8,10,2,15,37,50,-13,32
Wellington P,7600,9,5,6,16,31,55,-24,21
CC Mariners,7600,10,4,8,15,28,49,-21,20
Sydney FC,7601,1,21,4,3,65,22,43,67
N'castle Jet,7601,2,16,5,7,61,38,23,53
Melbourne C,7601,3,14,4,11,44,37,7,46
Melbourne V,7601,4,13,5,11,45,39,6,44
Adelaide Utd,7601,5,11,6,11,37,40,-3,39
Brisbane,7601,6,10,5,13,33,42,-9,35
Western Sydn,7601,7,8,9,10,38,47,-9,33
Perth Glory,7601,8,10,2,15,37,50,-13,32
Wellington P,7601,9,5,6,16,31,55,-24,21
CC Mariners,7601,10,4,8,15,28,49,-21,20
Sydney FC,7602,1,20,4,4,65,24,41,64
N'castle Jet,7602,2,16,5,7,59,37,22,53
Melbourne V,7602,3,14,5,10,47,39,8,47
Melbourne C,7602,4,14,4,11,43,35,8,46
Adelaide Utd,7602,5,11,6,11,37,40,-3,39
Brisbane,7602,6,10,5,13,33,42,-9,35
Western Sydn,7602,7,8,9,10,38,47,-9,33
Perth Glory,7602,8,10,2,15,37,50,-13,32
Wellington P,7602,9,5,6,16,31,55,-24,21
CC Mariners,7602,10,4,8,15,28,49,-21,20
Sydney FC,7603,1,21,4,3,65,22,43,67
N'castle Jet,7603,2,16,5,7,59,37,22,53
Melbourne C,7603,3,14,4,11,43,35,8,46
Melbourne V,7603,4,13,5,11,45,39,6,44
Adelaide Utd,7603,5,11,6,11,37,40,-3,39
Brisbane,7603,6,10,5,13,33,42,-9,35
Western Sydn,7603,7,8,9,10,38,47,-9,33
Perth Glory,7603,8,10,2,15,37,50,-13,32
Wellington P,7603,9,5,6,16,31,55,-24,21
CC Mariners,7603,10,4,8,15,28,49,-21,20
Sydney FC,7604,1,21,4,3,66,23,43,67
N'castle Jet,7604,2,16,5,7,59,38,21,53
Melbourne C,7604,3,14,4,11,44,35,9,46
Melbourne V,7604,4,13,5,11,46,40,6,44
Adelaide Utd,7604,5,11,6,11,37,40,-3,39
Brisbane,7604,6,10,5,13,33,42,-9,35
Western Sydn,7604,7,8,9,10,38,47,-9,33
Perth Glory,7604,8,10,2,15,37,50,-13,32
Wellington P,7604,9,5,6,16,31,55,-24,21
CC Mariners,7604,10,4,8,15,28,49,-21,20
Sydney FC,7605,1,21,4,3,67,23,44,67
N'castle Jet,7605,2,16,5,7,59,38,21,53
Melbourne C,7605,3,14,4,11,44,35,9,46
Melbourne V,7605,4,13,5,11,46,41,5,44
Adelaide Utd,7605,5,11,6,11,37,40,-3,39
Brisbane,7605,6,10,5,13,33,42,-9,35
Western Sydn,7605,7,8,9,10,38,47,-9,33
Perth Glory,7605,8,10,2,15,37,50,-13,32
Wellington P,7605,9,5,6,16,31,55,-24,21
CC Mariners,7605,10,4,8,15,28,49,-21,20
Sydney FC,7606,1,20,4,4,65,24,41,64
N'castle Jet,7606,2,16,5,7,62,38,24,53
Melbourne V,7606,3,14,5,10,47,39,8,47
Melbourne C,7606,4,14,4,11,44,38,6,46
Adelaide Utd,7606,5,11,6,11,37,40,-3,39
Brisbane,7606,6,10,5,13,33,42,-9,35
Western Sydn,7606,7,8,9,10,38,47,-9,33
Perth Glory,7606,8,10,2,15,37,50,-13,32
Wellington P,7606,9,5,6,16,31,55,-24,21
CC Mariners,7606,10,4,8,15,28,49,-21,20
Sydney FC,7607,1,20,5,3,64,22,42,65
N'castle Jet,7607,2,16,5,7,59,37,22,53
Melbourne C,7607,3,14,4,11,43,35,8,46
Melbourne V,7607,4,13,6,10,45,38,7,45
Adelaide Utd,7607,5,11,6,11,37,40,-3,39
Brisbane,7607,6,10,5,13,33,42,-9,35
Western Sydn,7607,7,8,9,10,38,47,-9,33
Perth Glory,7607,8,10,2,15,37,50,-13,32
Wellington P,7607,9,5,6,16,31,55,-24,21
CC Mariners,7607,10,4,8,15,28,49,-21,20
Sydney FC,7608,1,20,5,3,65,23,42,65
N'castle Jet,7608,2,16,5,7,60,38,22,53
Melbourne C,7608,3,14,4,11,44,36,8,46
Melbourne V,7608,4,13,6,10,46,39,7,45
Adelaide Utd,7608,5,11,6,11,37,40,-3,39
Brisbane,7608,6,10,5,13,33,42,-9,35
Western Sydn,7608,7,8,9,10,38,47,-9,33
Perth Glory,7608,8,10,2,15,37,50,-13,32
Wellington P,7608,9,5,6,16,31,55,-24,21
CC Mariners,7608,10,4,8,15,28,49,-21,20
Sydney FC,7609,1,21,4,3,66,22,44,67
N'castle Jet,7609,2,16,5,7,61,39,22,53
Melbourne C,7609,3,14,4,11,45,37,8,46
Melbourne V,7609,4,13,5,11,45,40,5,44
Adelaide Utd,7609,5,11,6,11,37,40,-3,39
Brisbane,7609,6,10,5,13,33,42,-9,35
Western Sydn,7609,7,8,9,10,38,47,-9,33
Perth Glory,7609,8,10,2,15,37,50,-13,32
Wellington P,7609,9,5,6,16,31,55,-24,21
CC Mariners,7609,10,4,8,15,28,49,-21,20
Sydney FC,7610,1,21,4,3,66,22,44,67
N'castle Jet,7610,2,16,5,7,60,39,21,53
Melbourne C,7610,3,14,4,11,45,36,9,46
Melbourne V,7610,4,13,5,11,45,40,5,44
Adelaide Utd,7610,5,11,6,11,37,40,-3,39
Brisbane,7610,6,10,5,13,33,42,-9,35
Western Sydn,7610,7,8,9,10,38,47,-9,33
Perth Glory,7610,8,10,2,15,37,50,-13,32
Wellington P,7610,9,5,6,16,31,55,-24,21
CC Mariners,7610,10,4,8,15,28,49,-21,20
Sydney FC,7611,1,20,4,4,64,24,40,64
N'castle Jet,7611,2,16,5,7,60,37,23,53
Melbourne V,7611,3,14,5,10,47,38,9,47
Melbourne C,7611,4,14,4,11,43,36,7,46
Adelaide Utd,7611,5,11,6,11,37,40,-3,39
Brisbane,7611,6,10,5,13,33,42,-9,35
Western Sydn,7611,7,8,9,10,38,47,-9,33
Perth Glory,7611,8,10,2,15,37,50,-13,32
Wellington P,7611,9,5,6,16,31,55,-24,21
CC Mariners,7611,10,4,8,15,28,49,-21,20
Sydney FC,7612,1,21,4,3,68,23,45,67
N'castle Jet,7612,2,16,5,7,59,37,22,53
Melbourne C,7612,3,14,4,11,43,35,8,46
Melbourne V,7612,4,13,5,11,46,42,4,44
Adelaide Utd,7612,5,11,6,11,37,40,-3,39
Brisbane,7612,6,10,5,13,33,42,-9,35
Western Sydn,7612,7,8,9,10,38,47,-9,33
Perth Glory,7612,8,10,2,15,37,50,-13,32
Wellington P,7612,9,5,6,16,31,55,-24,21
CC Mariners,7612,10,4,8,15,28,49,-21,20
Sydney FC,7613,1,21,4,3,66,22,44,67
N'castle Jet,7613,2,15,6,7,59,39,20,51
Melbourne C,7613,3,14,5,10,45,35,10,47
Melbourne V,7613,4,13,5,11,45,40,5,44
Adelaide Utd,7613,5,11,6,11,37,40,-3,39
Brisbane,7613,6,10,5,13,33,42,-9,35
Western Sydn,7613,7,8,9,10,38,47,-9,33
Perth Glory,7613,8,10,2,15,37,50,-13,32
Wellington P,7613,9,5,6,16,31,55,-24,21
CC Mariners,7613,10,4,8,15,28,49,-21,20
Sydney FC,7614,1,21,4,3,65,22,43,67
N'castle Jet,7614,2,16,5,7,58,37,21,53
Melbourne C,7614,3,14,4,11,43,34,9,46
Melbourne V,7614,4,13,5,11,45,39,6,44
Adelaide Utd,7614,5,11,6,11,37,40,-3,39
Brisbane,7614,6,10,5,13,33,42,-9,35
Western Sydn,7614,7,8,9,10,38,47,-9,33
Perth Glory,7614,8,10,2,15,37,50,-13,32
Wellington P,7614,9,5,6,16,31,55,-24,21
CC Mariners,7614,10,4,8,15,28,49,-21,20
Sydney FC,7615,1,20,4,4,65,24,41,64
N'castle Jet,7615,2,16,5,7,58,37,21,53
Melbourne V,7615,3,14,5,10,47,39,8,47
Melbourne C,7615,4,14,4,11,43,34,9,46
Adelaide Utd,7615,5,11,6,11,37,40,-3,39
Brisbane,7615,6,10,5,13,33,42,-9,35
Western Sydn,7615,7,8,9,10,38,47,-9,33
Perth Glory,7615,8,10,2,15,37,50,-13,32
Wellington P,7615,9,5,6,16,31,55,-24,21
CC Mariners,7615,10,4,8,15,28,49,-21,20
Sydney FC,7616,1,20,5,3,65,23,42,65
N'castle Jet,7616,2,16,5,7,59,37,22,53
Melbourne C,7616,3,14,4,11,43,35,8,46
Melbourne V,7616,4,13,6,10,46,39,7,45
Adelaide Utd,7616,5,11,6,11,37,40,-3,39
Brisbane,7616,6,10,5,13,33,42,-9,35
Western Sydn,7616,7,8,9,10,38,47,-9,33
Perth Glory,7616,8,10,2,15,37,50,-13,32
Wellington P,7616,9,5,6,16,31,55,-24,21
CC Mariners,7616,10,4,8,15,28,49,-21,20
Sydney FC,7617,1,21,4,3,70,22,48,67
N'castle Jet,7617,2,15,6,7,57,37,20,51
Melbourne C,7617,3,14,5,10,43,33,10,47
Melbourne V,7617,4,13,5,11,45,44,1,44
Adelaide Utd,7617,5,11,6,11,37,40,-3,39
Brisbane,7617,6,10,5,13,33,42,-9,35
Western Sydn,7617,7,8,9,10,38,47,-9,33
Perth Glory,7617,8,10,2,15,37,50,-13,32
Wellington P,7617,9,5,6,16,31,55,-24,21
CC Mariners,7617,10,4,8,15,28,49,-21,20
Sydney FC,7618,1,20,5,3,66,24,42,65
N'castle Jet,7618,2,15,6,7,59,39,20,51
Melbourne C,7618,3,14,5,10,45,35,10,47
Melbourne V,7618,4,13,6,10,47,40,7,45
Adelaide Utd,7618,5,11,6,11,37,40,-3,39
Brisbane,7618,6,10,5,13,33,42,-9,35
Western Sydn,7618,7,8,9,10,38,47,-9,33
Perth Glory,7618,8,10,2,15,37,50,-13,32
Wellington P,7618,9,5,6,16,31,55,-24,21
CC Mariners,7618,10,4,8,15,28,49,-21,20
Sydney FC,7619,1,21,4,3,67,23,44,67
N'castle Jet,7619,2,15,6,7,57,37,20,51
Melbourne C,7619,3,14,5,10,43,33,10,47
Melbourne V,7619,4,13,5,11,46,41,5,44
Adelaide Utd,7619,5,11,6,11,37,40,-3,39
Brisbane,7619,6,10,5,13,33,42,-9,35
Western Sydn,7619,7,8,9,10,38,47,-9,33
Perth Glory,7619,8,10,2,15,37,50,-13,32
Wellington P,7619,9,5,6,16,31,55,-24,21
CC Mariners,7619,10,4,8,15,28,49,-21,20
Sydney FC,7620,1,20,5,3,65,23,42,65
N'castle Jet,7620,2,16,5,7,59,37,22,53
Melbourne C,7620,3,14,4,11,43,35,8,46
Melbourne V,7620,4,13,6,10,46,39,7,45
Adelaide Utd,7620,5,11,6,11,37,40,-3,39
Brisbane,7620,6,10,5,13,33,42,-9,35
Western Sydn,7620,7,8,9,10,38,47,-9,33
Perth Glory,7620,8,10,2,15,37,50,-13,32
Wellington P,7620,9,5,6,16,31,55,-24,21
CC Mariners,7620,10,4,8,15,28,49,-21,20
Sydney FC,7621,1,21,4,3,66,23,43,67
N'castle Jet,7621,2,15,6,7,60,40,20,51
Melbourne C,7621,3,14,5,10,46,36,10,47
Melbourne V,7621,4,13,5,11,46,40,6,44
Adelaide Utd,7621,5,11,6,11,37,40,-3,39
Brisbane,7621,6,10,5,13,33,42,-9,35
Western Sydn,7621,7,8,9,10,38,47,-9,33
Perth Glory,7621,8,10,2,15,37,50,-13,32
Wellington P,7621,9,5,6,16,31,55,-24,21
CC Mariners,7621,10,4,8,15,28,49,-21,20
Sydney FC,7622,1,20,5,3,66,24,42,65
N'castle Jet,7622,2,16,5,7,59,38,21,53
Melbourne C,7622,3,14,4,11,44,35,9,46
Melbourne V,7622,4,13,6,10,47,40,7,45
Adelaide Utd,7622,5,11,6,11,37,40,-3,39
Brisbane,7622,6,10,5,13,33,42,-9,35
Western Sydn,7622,7,8,9,10,38,47,-9,33
Perth Glory,7622,8,10,2,15,37,50,-13,32
Wellington P,7622,9,5,6,16,31,55,-24,21
CC Mariners,7622,10,4,8,15,28,49,-21,20
Sydney FC,7623,1,20,4,4,65,25,40,64
N'castle Jet,7623,2,15,6,7,58,38,20,51
Melbourne C,7623,3,14,5,10,44,34,10,47
Melbourne V,7623,4,14,5,10,48,39,9,47
Adelaide Utd,7623,5,11,6,11,37,40,-3,39
Brisbane,7623,6,10,5,13,33,42,-9,35
Western Sydn,7623,7,8,9,10,38,47,-9,33
Perth Glory,7623,8,10,2,15,37,50,-13,32
Wellington P,7623,9,5,6,16,31,55,-24,21
CC Mariners,7623,10,4,8,15,28,49,-21,20
Sydney FC,7624,1,20,5,3,65,23,42,65
N'castle Jet,7624,2,15,6,7,59,39,20,51
Melbourne C,7624,3,14,5,10,45,35,10,47
Melbourne V,7624,4,13,6,10,46,39,7,45
Adelaide Utd,7624,5,11,6,11,37,40,-3,39
Brisbane,7624,6,10,5,13,33,42,-9,35
Western Sydn,7624,7,8,9,10,38,47,-9,33
Perth Glory,7624,8,10,2,15,37,50,-13,32
Wellington P,7624,9,5,6,16,31,55,-24,21
CC Mariners,7624,10,4,8,15,28,49,-21,20
Sydney FC,7625,1,20,4,4,64,24,40,64
N'castle Jet,7625,2,16,5,7,59,38,21,53
Melbourne V,7625,3,14,5,10,47,38,9,47
Melbourne C,7625,4,14,4,11,44,35,9,46
Adelaide Utd,7625,5,11,6,11,37,40,-3,39
Brisbane,7625,6,10,5,13,33,42,-9,35
Western Sydn,7625,7,8,9,10,38,47,-9,33
Perth Glory,7625,8,10,2,15,37,50,-13,32
Wellington P,7625,9,5,6,16,31,55,-24,21
CC Mariners,7625,10,4,8,15,28,49,-21,20
Sydney FC,7626,1,21,4,3,66,23,43,67
N'castle Jet,7626,2,15,6,7,59,39,20,51
Melbourne C,7626,3,14,5,10,45,35,10,47
Melbourne V,7626,4,13,5,11,46,40,6,44
Adelaide Utd,7626,5,11,6,11,37,40,-3,39
Brisbane,7626,6,10,5,13,33,42,-9,35
Western Sydn,7626,7,8,9,10,38,47,-9,33
Perth Glory,7626,8,10,2,15,37,50,-13,32
Wellington P,7626,9,5,6,16,31,55,-24,21
CC Mariners,7626,10,4,8,15,28,49,-21,20
Sydney FC,7627,1,21,4,3,66,22,44,67
N'castle Jet,7627,2,16,5,7,59,38,21,53
Melbourne C,7627,3,14,4,11,44,35,9,46
Melbourne V,7627,4,13,5,11,45,40,5,44
Adelaide Utd,7627,5,11,6,11,37,40,-3,39
Brisbane,7627,6,10,5,13,33,42,-9,35
Western Sydn,7627,7,8,9,10,38,47,-9,33
Perth Glory,7627,8,10,2,15,37,50,-13,32
Wellington P,7627,9,5,6,16,31,55,-24,21
CC Mariners,7627,10,4,8,15,28,49,-21,20
Sydney FC,7628,1,21,4,3,65,22,43,67
N'castle Jet,7628,2,16,5,7,59,38,21,53
Melbourne C,7628,3,14,4,11,44,35,9,46
Melbourne V,7628,4,13,5,11,45,39,6,44
Adelaide Utd,7628,5,11,6,11,37,40,-3,39
Brisbane,7628,6,10,5,13,33,42,-9,35
Western Sydn,7628,7,8,9,10,38,47,-9,33
Perth Glory,7628,8,10,2,15,37,50,-13,32
Wellington P,7628,9,5,6,16,31,55,-24,21
CC Mariners,7628,10,4,8,15,28,49,-21,20
Sydney FC,7629,1,21,4,3,68,24,44,67
N'castle Jet,7629,2,16,5,7,59,38,21,53
Melbourne C,7629,3,14,4,11,44,35,9,46
Melbourne V,7629,4,13,5,11,47,42,5,44
Adelaide Utd,7629,5,11,6,11,37,40,-3,39
Brisbane,7629,6,10,5,13,33,42,-9,35
Western Sydn,7629,7,8,9,10,38,47,-9,33
Perth Glory,7629,8,10,2,15,37,50,-13,32
Wellington P,7629,9,5,6,16,31,55,-24,21
CC Mariners,7629,10,4,8,15,28,49,-21,20
Sydney FC,7630,1,21,4,3,67,23,44,67
N'castle Jet,7630,2,15,6,7,58,38,20,51
Melbourne C,7630,3,14,5,10,44,34,10,47
Melbourne V,7630,4,13,5,11,46,41,5,44
Adelaide Utd,7630,5,11,6,11,37,40,-3,39
Brisbane,7630,6,10,5,13,33,42,-9,35
Western Sydn,7630,7,8,9,10,38,47,-9,33
Perth Glory,7630,8,10,2,15,37,50,-13,32
Wellington P,7630,9,5,6,16,31,55,-24,21
CC Mariners,7630,10,4,8,15,28,49,-21,20
Sydney FC,7631,1,20,5,3,64,22,42,65
N'castle Jet,7631,2,16,5,7,59,38,21,53
Melbourne C,7631,3,14,4,11,44,35,9,46
Melbourne V,7631,4,13,6,10,45,38,7,45
Adelaide Utd,7631,5,11,6,11,37,40,-3,39
Brisbane,7631,6,10,5,13,33,42,-9,35
Western Sydn,7631,7,8,9,10,38,47,-9,33
Perth Glory,7631,8,10,2,15,37,50,-13,32
Wellington P,7631,9,5,6,16,31,55,-24,21
CC Mariners,7631,10,4,8,15,28,49,-21,20
Sydney FC,7632,1,21,4,3,67,23,44,67
N'castle Jet,7632,2,16,5,7,58,37,21,53
Melbourne C,7632,3,14,4,11,43,34,9,46
Melbourne V,7632,4,13,5,11,46,41,5,44
Adelaide Utd,7632,5,11,6,11,37,40,-3,39
Brisbane,7632,6,10,5,13,33,42,-9,35
Western Sydn,7632,7,8,9,10,38,47,-9,33
Perth Glory,7632,8,10,2,15,37,50,-13,32
Wellington P,7632,9,5,6,16,31,55,-24,21
CC Mariners,7632,10,4,8,15,28,49,-21,20
Sydney FC,7633,1,21,4,3,66,23,43,67
N'castle Jet,7633,2,16,5,7,61,39,22,53
Melbourne C,7633,3,14,4,11,45,37,8,46
Melbourne V,7633,4,13,5,11,46,40,6,44
Adelaide Utd,7633,5,11,6,11,37,40,-3,39
Brisbane,7633,6,10,5,13,33,42,-9,35
Western Sydn,7633,7,8,9,10,38,47,-9,33
Perth Glory,7633,8,10,2,15,37,50,-13,32
Wellington P,7633,9,5,6,16,31,55,-24,21
CC Mariners,7633,10,4,8,15,28,49,-21,20
Sydney FC,7634,1,20,4,4,65,25,40,64
N'castle Jet,7634,2,15,6,7,60,40,20,51
Melbourne C,7634,3,14,5,10,46,36,10,47
Melbourne V,7634,4,14,5,10,48,39,9,47
Adelaide Utd,7634,5,11,6,11,37,40,-3,39
Brisbane,7634,6,10,5,13,33,42,-9,35
Western Sydn,7634,7,8,9,10,38,47,-9,33
Perth Glory,7634,8,10,2,15,37,50,-13,32
Wellington P,7634,9,5,6,16,31,55,-24,21
CC Mariners,7634,10,4,8,15,28,49,-21,20
Sydney FC,7635,1,21,4,3,65,22,43,67
N'castle Jet,7635,2,15,6,7,58,38,20,51
Melbourne C,7635,3,14,5,10,44,34,10,47
Melbourne V,7635,4,13,5,11,45,39,6,44
Adelaide Utd,7635,5,11,6,11,37,40,-3,39
Brisbane,7635,6,10,5,13,33,42,-9,35
Western Sydn,7635,7,8,9,10,38,47,-9,33
Perth Glory,7635,8,10,2,15,37,50,-13,32
Wellington P,7635,9,5,6,16,31,55,-24,21
CC Mariners,7635,10,4,8,15,28,49,-21,20
Sydney FC,7636,1,21,4,3,67,23,44,67
N'castle Jet,7636,2,15,5,8,58,40,18,50
Melbourne C,7636,3,15,4,10,46,34,12,49
Melbourne V,7636,4,13,5,11,46,41,5,44
Adelaide Utd,7636,5,11,6,11,37,40,-3,39
Brisbane,7636,6,10,5,13,33,42,-9,35
Western Sydn,7636,7,8,9,10,38,47,-9,33
Perth Glory,7636,8,10,2,15,37,50,-13,32
Wellington P,7636,9,5,6,16,31,55,-24,21
CC Mariners,7636,10,4,8,15,28,49,-21,20
Sydney FC,7637,1,21,4,3,68,23,45,67
N'castle Jet,7637,2,15,6,7,57,37,20,51
Melbourne C,7637,3,14,5,10,43,33,10,47
Melbourne V,7637,4,13,5,11,46,42,4,44
Adelaide Utd,7637,5,11,6,11,37,40,-3,39
Brisbane,7637,6,10,5,13,33,42,-9,35
Western Sydn,7637,7,8,9,10,38,47,-9,33
Perth Glory,7637,8,10,2,15,37,50,-13,32
Wellington P,7637,9,5,6,16,31,55,-24,21
CC Mariners,7637,10,4,8,15,28,49,-21,20
Sydney FC,7638,1,21,4,3,66,22,44,67
N'castle Jet,7638,2,16,5,7,63,37,26,53
Melbourne C,7638,3,14,4,11,43,39,4,46
Melbourne V,7638,4,13,5,11,45,40,5,44
Adelaide Utd,7638,5,11,6,11,37,40,-3,39
Brisbane,7638,6,10,5,13,33,42,-9,35
Western Sydn,7638,7,8,9,10,38,47,-9,33
Perth Glory,7638,8,10,2,15,37,50,-13,32
Wellington P,7638,9,5,6,16,31,55,-24,21
CC Mariners,7638,10,4,8,15,28,49,-21,20
Sydney FC,7639,1,21,4,3,66,23,43,67
N'castle Jet,7639,2,15,6,7,58,38,20,51
Melbourne C,7639,3,14,5,10,44,34,10,47
Melbourne V,7639,4,13,5,11,46,40,6,44
Adelaide Utd,7639,5,11,6,11,37,40,-3,39
Brisbane,7639,6,10,5,13,33,42,-9,35
Western Sydn,7639,7,8,9,10,38,47,-9,33
Perth Glory,7639,8,10,2,15,37,50,-13,32
Wellington P,7639,9,5,6,16,31,55,-24,21
CC Mariners,7639,10,4,8,15,28,49,-21,20
Sydney FC,7640,1,21,4,3,66,23,43,67
N'castle Jet,7640,2,15,5,8,59,40,19,50
Melbourne C,7640,3,15,4,10,46,35,11,49
Melbourne V,7640,4,13,5,11,46,40,6,44
Adelaide Utd,7640,5,11,6,11,37,40,-3,39
Brisbane,7640,6,10,5,13,33,42,-9,35
Western Sydn,7640,7,8,9,10,38,47,-9,33
Perth Glory,7640,8,10,2,15,37,50,-13,32
Wellington P,7640,9,5,6,16,31,55,-24,21
CC Mariners,7640,10,4,8,15,28,49,-21,20
Sydney FC,7641,1,21,4,3,69,24,45,67
N'castle Jet,7641,2,15,6,7,58,38,20,51
Melbourne C,7641,3,14,5,10,44,34,10,47
Melbourne V,7641,4,13,5,11,47,43,4,44
Adelaide Utd,7641,5,11,6,11,37,40,-3,39
Brisbane,7641,6,10,5,13,33,42,-9,35
Western Sydn,7641,7,8,9,10,38,47,-9,33
Perth Glory,7641,8,10,2,15,37,50,-13,32
Wellington P,7641,9,5,6,16,31,55,-24,21
CC Mariners,7641,10,4,8,15,28,49,-21,20
Sydney FC,7642,1,21,4,3,66,23,43,67
N'castle Jet,7642,2,15,5,8,58,39,19,50
Melbourne C,7642,3,15,4,10,45,34,11,49
Melbourne V,7642,4,13,5,11,46,40,6,44
Adelaide Utd,7642,5,11,6,11,37,40,-3,39
Brisbane,7642,6,10,5,13,33,42,-9,35
Western Sydn,7642,7,8,9,10,38,47,-9,33
Perth Glory,7642,8,10,2,15,37,50,-13,32
Wellington P,7642,9,5,6,16,31,55,-24,21
CC Mariners,7642,10,4,8,15,28,49,-21,20
Sydney FC,7643,1,20,5,3,64,22,42,65
N'castle Jet,7643,2,15,6,7,59,39,20,51
Melbourne C,7643,3,14,5,10,45,35,10,47
Melbourne V,7643,4,13,6,10,45,38,7,45
Adelaide Utd,7643,5,11,6,11,37,40,-3,39
Brisbane,7643,6,10,5,13,33,42,-9,35
Western Sydn,7643,7,8,9,10,38,47,-9,33
Perth Glory,7643,8,10,2,15,37,50,-13,32
Wellington P,7643,9,5,6,16,31,55,-24,21
CC Mariners,7643,10,4,8,15,28,49,-21,20
Sydney FC,7644,1,21,4,3,67,24,43,67
N'castle Jet,7644,2,16,5,7,59,38,21,53
Melbourne C,7644,3,14,4,11,44,35,9,46
Melbourne V,7644,4,13,5,11,47,41,6,44
Adelaide Utd,7644,5,11,6,11,37,40,-3,39
Brisbane,7644,6,10,5,13,33,42,-9,35
Western Sydn,7644,7,8,9,10,38,47,-9,33
Perth Glory,7644,8,10,2,15,37,50,-13,32
Wellington P,7644,9,5,6,16,31,55,-24,21
CC Mariners,7644,10,4,8,15,28,49,-21,20
Sydney FC,7645,1,20,5,3,64,22,42,65
N'castle Jet,7645,2,15,5,8,57,40,17,50
Melbourne C,7645,3,15,4,10,46,33,13,49
Melbourne V,7645,4,13,6,10,45,38,7,45
Adelaide Utd,7645,5,11,6,11,37,40,-3,39
Brisbane,7645,6,10,5,13,33,42,-9,35
Western Sydn,7645,7,8,9,10,38,47,-9,33
Perth Glory,7645,8,10,2,15,37,50,-13,32
Wellington P,7645,9,5,6,16,31,55,-24,21
CC Mariners,7645,10,4,8,15,28,49,-21,20
Sydney FC,7646,1,21,4,3,69,23,46,67
N'castle Jet,7646,2,15,6,7,58,38,20,51
Melbourne C,7646,3,14,5,10,44,34,10,47
Melbourne V,7646,4,13,5,11,46,43,3,44
Adelaide Utd,7646,5,11,6,11,37,40,-3,39
Brisbane,7646,6,10,5,13,33,42,-9,35
Western Sydn,7646,7,8,9,10,38,47,-9,33
Perth Glory,7646,8,10,2,15,37,50,-13,32
Wellington P,7646,9,5,6,16,31,55,-24,21
CC Mariners,7646,10,4,8,15,28,49,-21,20
Sydney FC,7647,1,21,4,3,68,24,44,67
N'castle Jet,7647,2,16,5,7,61,38,23,53
Melbourne C,7647,3,14,4,11,44,37,7,46
Melbourne V,7647,4,13,5,11,47,42,5,44
Adelaide Utd,7647,5,11,6,11,37,40,-3,39
Brisbane,7647,6,10,5,13,33,42,-9,35
Western Sydn,7647,7,8,9,10,38,47,-9,33
Perth Glory,7647,8,10,2,15,37,50,-13,32
Wellington P,7647,9,5,6,16,31,55,-24,21
CC Mariners,7647,10,4,8,15,28,49,-21,20
Sydney FC,7648,1,21,4,3,65,22,43,67
N'castle Jet,7648,2,15,6,7,58,38,20,51
Melbourne C,7648,3,14,5,10,44,34,10,47
Melbourne V,7648,4,13,5,11,45,39,6,44
Adelaide Utd,7648,5,11,6,11,37,40,-3,39
Brisbane,7648,6,10,5,13,33,42,-9,35
Western Sydn,7648,7,8,9,10,38,47,-9,33
Perth Glory,7648,8,10,2,15,37,50,-13,32
Wellington P,7648,9,5,6,16,31,55,-24,21
CC Mariners,7648,10,4,8,15,28,49,-21,20
Sydney FC,7649,1,21,4,3,68,25,43,67
N'castle Jet,7649,2,16,5,7,59,38,21,53
Melbourne C,7649,3,14,4,11,44,35,9,46
Melbourne V,7649,4,13,5,11,48,42,6,44
Adelaide Utd,7649,5,11,6,11,37,40,-3,39
Brisbane,7649,6,10,5,13,33,42,-9,35
Western Sydn,7649,7,8,9,10,38,47,-9,33
Perth Glory,7649,8,10,2,15,37,50,-13,32
Wellington P,7649,9,5,6,16,31,55,-24,21
CC Mariners,7649,10,4,8,15,28,49,-21,20
Sydney FC,7650,1,21,4,3,70,24,46,67
N'castle Jet,7650,2,16,5,7,60,37,23,53
Melbourne C,7650,3,14,4,11,43,36,7,46
Melbourne V,7650,4,13,5,11,47,44,3,44
Adelaide Utd,7650,5,11,6,11,37,40,-3,39
Brisbane,7650,6,10,5,13,33,42,-9,35
Western Sydn,7650,7,8,9,10,38,47,-9,33
Perth Glory,7650,8,10,2,15,37,50,-13,32
Wellington P,7650,9,5,6,16,31,55,-24,21
CC Mariners,7650,10,4,8,15,28,49,-21,20
Sydney FC,7651,1,20,4,4,64,24,40,64
N'castle Jet,7651,2,15,5,8,59,40,19,50
Melbourne C,7651,3,15,4,10,46,35,11,49
Melbourne V,7651,4,14,5,10,47,38,9,47
Adelaide Utd,7651,5,11,6,11,37,40,-3,39
Brisbane,7651,6,10,5,13,33,42,-9,35
Western Sydn,7651,7,8,9,10,38,47,-9,33
Perth Glory,7651,8,10,2,15,37,50,-13,32
Wellington P,7651,9,5,6,16,31,55,-24,21
CC Mariners,7651,10,4,8,15,28,49,-21,20
Sydney FC,7652,1,21,4,3,65,22,43,67
N'castle Jet,7652,2,15,5,8,59,41,18,50
Melbourne C,7652,3,15,4,10,47,35,12,49
Melbourne V,7652,4,13,5,11,45,39,6,44
Adelaide Utd,7652,5,11,6,11,37,40,-3,39
Brisbane,7652,6,10,5,13,33,42,-9,35
Western Sydn,7652,7,8,9,10,38,47,-9,33
Perth Glory,7652,8,10,2,15,37,50,-13,32
Wellington P,7652,9,5,6,16,31,55,-24,21
CC Mariners,7652,10,4,8,15,28,49,-21,20
Sydney FC,7653,1,20,5,3,66,24,42,65
N'castle Jet,7653,2,15,6,7,59,39,20,51
Melbourne C,7653,3,14,5,10,45,35,10,47
Melbourne V,7653,4,13,6,10,47,40,7,45
Adelaide Utd,7653,5,11,6,11,37,40,-3,39
Brisbane,7653,6,10,5,13,33,42,-9,35
Western Sydn,7653,7,8,9,10,38,47,-9,33
Perth Glory,7653,8,10,2,15,37,50,-13,32
Wellington P,7653,9,5,6,16,31,55,-24,21
CC Mariners,7653,10,4,8,15,28,49,-21,20
Sydney FC,7654,1,20,5,3,65,23,42,65
N'castle Jet,7654,2,15,5,8,58,40,18,50
Melbourne C,7654,3,15,4,10,46,34,12,49
Melbourne V,7654,4,13,6,10,46,39,7,45
Adelaide Utd,7654,5,11,6,11,37,40,-3,39
Brisbane,7654,6,10,5,13,33,42,-9,35
Western Sydn,7654,7,8,9,10,38,47,-9,33
Perth Glory,7654,8,10,2,15,37,50,-13,32
Wellington P,7654,9,5,6,16,31,55,-24,21
CC Mariners,7654,10,4,8,15,28,49,-21,20
Sydney FC,7655,1,20,4,4,65,24,41,64
N'castle Jet,7655,2,16,5,7,61,37,24,53
Melbourne V,7655,3,14,5,10,47,39,8,47
Melbourne C,7655,4,14,4,11,43,37,6,46
Adelaide Utd,7655,5,11,6,11,37,40,-3,39
Brisbane,7655,6,10,5,13,33,42,-9,35
Western Sydn,7655,7,8,9,10,38,47,-9,33
Perth Glory,7655,8,10,2,15,37,50,-13,32
Wellington P,7655,9,5,6,16,31,55,-24,21
CC Mariners,7655,10,4,8,15,28,49,-21,20
Sydney FC,7656,1,21,4,3,67,23,44,67
N'castle Jet,7656,2,16,5,7,62,38,24,53
Melbourne C,7656,3,14,4,11,44,38,6,46
Melbourne V,7656,4,13,5,11,46,41,5,44
Adelaide Utd,7656,5,11,6,11,37,40,-3,39
Brisbane,7656,6,10,5,13,33,42,-9,35
Western Sydn,7656,7,8,9,10,38,47,-9,33
Perth Glory,7656,8,10,2,15,37,50,-13,32
Wellington P,7656,9,5,6,16,31,55,-24,21
CC Mariners,7656,10,4,8,15,28,49,-21,20
Sydney FC,7657,1,20,4,4,65,25,40,64
N'castle Jet,7657,2,15,6,7,58,38,20,51
Melbourne C,7657,3,14,5,10,44,34,10,47
Melbourne V,7657,4,14,5,10,48,39,9,47
Adelaide Utd,7657,5,11,6,11,37,40,-3,39
Brisbane,7657,6,10,5,13,33,42,-9,35
Western Sydn,7657,7,8,9,10,38,47,-9,33
Perth Glory,7657,8,10,2,15,37,50,-13,32
Wellington P,7657,9,5,6,16,31,55,-24,21
CC Mariners,7657,10,4,8,15,28,49,-21,20
Sydney FC,7658,1,21,4,3,67,22,45,67
N'castle Jet,7658,2,16,5,7,61,37,24,53
Melbourne C,7658,3,14,4,11,43,37,6,46
Melbourne V,7658,4,13,5,11,45,41,4,44
Adelaide Utd,7658,5,11,6,11,37,40,-3,39
Brisbane,7658,6,10,5,13,33,42,-9,35
Western Sydn,7658,7,8,9,10,38,47,-9,33
Perth Glory,7658,8,10,2,15,37,50,-13,32
Wellington P,7658,9,5,6,16,31,55,-24,21
CC Mariners,7658,10,4,8,15,28,49,-21,20
Sydney FC,7659,1,21,4,3,66,22,44,67
N'castle Jet,7659,2,15,5,8,58,39,19,50
Melbourne C,7659,3,15,4,10,45,34,11,49
Melbourne V,7659,4,13,5,11,45,40,5,44
Adelaide Utd,7659,5,11,6,11,37,40,-3,39
Brisbane,7659,6,10,5,13,33,42,-9,35
Western Sydn,7659,7,8,9,10,38,47,-9,33
Perth Glory,7659,8,10,2,15,37,50,-13,32
Wellington P,7659,9,5,6,16,31,55,-24,21
CC Mariners,7659,10,4,8,15,28,49,-21,20
Sydney FC,7660,1,21,4,3,65,22,43,67
N'castle Jet,7660,2,16,5,7,59,37,22,53
Melbourne C,7660,3,14,4,11,43,35,8,46
Melbourne V,7660,4,13,5,11,45,39,6,44
Adelaide Utd,7660,5,11,6,11,37,40,-3,39
Brisbane,7660,6,10,5,13,33,42,-9,35
Western Sydn,7660,7,8,9,10,38,47,-9,33
Perth Glory,7660,8,10,2,15,37,50,-13,32
Wellington P,7660,9,5,6,16,31,55,-24,21
CC Mariners,7660,10,4,8,15,28,49,-21,20
Sydney FC,7661,1,21,4,3,67,23,44,67
N'castle Jet,7661,2,16,5,7,59,37,22,53
Melbourne C,7661,3,14,4,11,43,35,8,46
Melbourne V,7661,4,13,5,11,46,41,5,44
Adelaide Utd,7661,5,11,6,11,37,40,-3,39
Brisbane,7661,6,10,5,13,33,42,-9,35
Western Sydn,7661,7,8,9,10,38,47,-9,33
Perth Glory,7661,8,10,2,15,37,50,-13,32
Wellington P,7661,9,5,6,16,31,55,-24,21
CC Mariners,7661,10,4,8,15,28,49,-21,20
Sydney FC,7662,1,21,4,3,66,22,44,67
N'castle Jet,7662,2,15,6,7,59,39,20,51
Melbourne C,7662,3,14,5,10,45,35,10,47
Melbourne V,7662,4,13,5,11,45,40,5,44
Adelaide Utd,7662,5,11,6,11,37,40,-3,39
Brisbane,7662,6,10,5,13,33,42,-9,35
Western Sydn,7662,7,8,9,10,38,47,-9,33
Perth Glory,7662,8,10,2,15,37,50,-13,32
Wellington P,7662,9,5,6,16,31,55,-24,21
CC Mariners,7662,10,4,8,15,28,49,-21,20
Sydney FC,7663,1,20,5,3,65,23,42,65
N'castle Jet,7663,2,15,6,7,58,38,20,51
Melbourne C,7663,3,14,5,10,44,34,10,47
Melbourne V,7663,4,13,6,10,46,39,7,45
Adelaide Utd,7663,5,11,6,11,37,40,-3,39
Brisbane,7663,6,10,5,13,33,42,-9,35
Western Sydn,7663,7,8,9,10,38,47,-9,33
Perth Glory,7663,8,10,2,15,37,50,-13,32
Wellington P,7663,9,5,6,16,31,55,-24,21
CC Mariners,7663,10,4,8,15,28,49,-21,20
Sydney FC,7664,1,21,4,3,66,23,43,67
N'castle Jet,7664,2,16,5,7,61,39,22,53
Melbourne C,7664,3,14,4,11,45,37,8,46
Melbourne V,7664,4,13,5,11,46,40,6,44
Adelaide Utd,7664,5,11,6,11,37,40,-3,39
Brisbane,7664,6,10,5,13,33,42,-9,35
Western Sydn,7664,7,8,9,10,38,47,-9,33
Perth Glory,7664,8,10,2,15,37,50,-13,32
Wellington P,7664,9,5,6,16,31,55,-24,21
CC Mariners,7664,10,4,8,15,28,49,-21,20
Sydney FC,7665,1,20,5,3,65,23,42,65
N'castle Jet,7665,2,15,6,7,60,40,20,51
Melbourne C,7665,3,14,5,10,46,36,10,47
Melbourne V,7665,4,13,6,10,46,39,7,45
Adelaide Utd,7665,5,11,6,11,37,40,-3,39
Brisbane,7665,6,10,5,13,33,42,-9,35
Western Sydn,7665,7,8,9,10,38,47,-9,33
Perth Glory,7665,8,10,2,15,37,50,-13,32
Wellington P,7665,9,5,6,16,31,55,-24,21
CC Mariners,7665,10,4,8,15,28,49,-21,20
Sydney FC,7666,1,20,5,3,65,23,42,65
N'castle Jet,7666,2,16,5,7,60,39,21,53
Melbourne C,7666,3,14,4,11,45,36,9,46
Melbourne V,7666,4,13,6,10,46,39,7,45
Adelaide Utd,7666,5,11,6,11,37,40,-3,39
Brisbane,7666,6,10,5,13,33,42,-9,35
Western Sydn,7666,7,8,9,10,38,47,-9,33
Perth Glory,7666,8,10,2,15,37,50,-13,32
Wellington P,7666,9,5,6,16,31,55,-24,21
CC Mariners,7666,10,4,8,15,28,49,-21,20
Sydney FC,7667,1,21,4,3,67,23,44,67
N'castle Jet,7667,2,15,6,7,58,38,20,51
Melbourne C,7667,3,14,5,10,44,34,10,47
Melbourne V,7667,4,13,5,11,46,41,5,44
Adelaide Utd,7667,5,11,6,11,37,40,-3,39
Brisbane,7667,6,10,5,13,33,42,-9,35
Western Sydn,7667,7,8,9,10,38,47,-9,33
Perth Glory,7667,8,10,2,15,37,50,-13,32
Wellington P,7667,9,5,6,16,31,55,-24,21
CC Mariners,7667,10,4,8,15,28,49,-21,20
Sydney FC,7668,1,21,4,3,66,22,44,67
N'castle Jet,7668,2,16,5,7,61,38,23,53
Melbourne C,7668,3,14,4,11,44,37,7,46
Melbourne V,7668,4,13,5,11,45,40,5,44
Adelaide Utd,7668,5,11,6,11,37,40,-3,39
Brisbane,7668,6,10,5,13,33,42,-9,35
Western Sydn,7668,7,8,9,10,38,47,-9,33
Perth Glory,7668,8,10,2,15,37,50,-13,32
Wellington P,7668,9,5,6,16,31,55,-24,21
CC Mariners,7668,10,4,8,15,28,49,-21,20
Sydney FC,7669,1,20,4,4,65,24,41,64
N'castle Jet,7669,2,16,5,7,59,37,22,53
Melbourne V,7669,3,14,5,10,47,39,8,47
Melbourne C,7669,4,14,4,11,43,35,8,46
Adelaide Utd,7669,5,11,6,11,37,40,-3,39
Brisbane,7669,6,10,5,13,33,42,-9,35
Western Sydn,7669,7,8,9,10,38,47,-9,33
Perth Glory,7669,8,10,2,15,37,50,-13,32
Wellington P,7669,9,5,6,16,31,55,-24,21
CC Mariners,7669,10,4,8,15,28,49,-21,20
Sydney FC,7670,1,20,5,3,66,24,42,65
N'castle Jet,7670,2,16,5,7,62,41,21,53
Melbourne C,7670,3,14,4,11,47,38,9,46
Melbourne V,7670,4,13,6,10,47,40,7,45
Adelaide Utd,7670,5,11,6,11,37,40,-3,39
Brisbane,7670,6,10,5,13,33,42,-9,35
Western Sydn,7670,7,8,9,10,38,47,-9,33
Perth Glory,7670,8,10,2,15,37,50,-13,32
Wellington P,7670,9,5,6,16,31,55,-24,21
CC Mariners,7670,10,4,8,15,28,49,-21,20
Sydney FC,7671,1,20,5,3,66,24,42,65
N'castle Jet,7671,2,16,5,7,60,37,23,53
Melbourne C,7671,3,14,4,11,43,36,7,46
Melbourne V,7671,4,13,6,10,47,40,7,45
Adelaide Utd,7671,5,11,6,11,37,40,-3,39
Brisbane,7671,6,10,5,13,33,42,-9,35
Western Sydn,7671,7,8,9,10,38,47,-9,33
Perth Glory,7671,8,10,2,15,37,50,-13,32
Wellington P,7671,9,5,6,16,31,55,-24,21
CC Mariners,7671,10,4,8,15,28,49,-21,20
Sydney FC,7672,1,20,5,3,65,23,42,65
N'castle Jet,7672,2,15,5,8,58,39,19,50
Melbourne C,7672,3,15,4,10,45,34,11,49
Melbourne V,7672,4,13,6,10,46,39,7,45
Adelaide Utd,7672,5,11,6,11,37,40,-3,39
Brisbane,7672,6,10,5,13,33,42,-9,35
Western Sydn,7672,7,8,9,10,38,47,-9,33
Perth Glory,7672,8,10,2,15,37,50,-13,32
Wellington P,7672,9,5,6,16,31,55,-24,21
CC Mariners,7672,10,4,8,15,28,49,-21,20
Sydney FC,7673,1,20,5,3,64,22,42,65
N'castle Jet,7673,2,15,6,7,60,40,20,51
Melbourne C,7673,3,14,5,10,46,36,10,47
Melbourne V,7673,4,13,6,10,45,38,7,45
Adelaide Utd,7673,5,11,6,11,37,40,-3,39
Brisbane,7673,6,10,5,13,33,42,-9,35
Western Sydn,7673,7,8,9,10,38,47,-9,33
Perth Glory,7673,8,10,2,15,37,50,-13,32
Wellington P,7673,9,5,6,16,31,55,-24,21
CC Mariners,7673,10,4,8,15,28,49,-21,20
Sydney FC,7674,1,21,4,3,66,23,43,67
N'castle Jet,7674,2,16,5,7,59,37,22,53
Melbourne C,7674,3,14,4,11,43,35,8,46
Melbourne V,7674,4,13,5,11,46,40,6,44
Adelaide Utd,7674,5,11,6,11,37,40,-3,39
Brisbane,7674,6,10,5,13,33,42,-9,35
Western Sydn,7674,7,8,9,10,38,47,-9,33
Perth Glory,7674,8,10,2,15,37,50,-13,32
Wellington P,7674,9,5,6,16,31,55,-24,21
CC Mariners,7674,10,4,8,15,28,49,-21,20
Sydney FC,7675,1,20,4,4,65,25,40,64
N'castle Jet,7675,2,16,5,7,60,38,22,53
Melbourne V,7675,3,14,5,10,48,39,9,47
Melbourne C,7675,4,14,4,11,44,36,8,46
Adelaide Utd,7675,5,11,6,11,37,40,-3,39
Brisbane,7675,6,10,5,13,33,42,-9,35
Western Sydn,7675,7,8,9,10,38,47,-9,33
Perth Glory,7675,8,10,2,15,37,50,-13,32
Wellington P,7675,9,5,6,16,31,55,-24,21
CC Mariners,7675,10,4,8,15,28,49,-21,20
Sydney FC,7676,1,21,4,3,66,22,44,67
N'castle Jet,7676,2,15,5,8,58,42,16,50
Melbourne C,7676,3,15,4,10,48,34,14,49
Melbourne V,7676,4,13,5,11,45,40,5,44
Adelaide Utd,7676,5,11,6,11,37,40,-3,39
Brisbane,7676,6,10,5,13,33,42,-9,35
Western Sydn,7676,7,8,9,10,38,47,-9,33
Perth Glory,7676,8,10,2,15,37,50,-13,32
Wellington P,7676,9,5,6,16,31,55,-24,21
CC Mariners,7676,10,4,8,15,28,49,-21,20
Sydney FC,7677,1,21,4,3,66,22,44,67
N'castle Jet,7677,2,15,5,8,57,38,19,50
Melbourne C,7677,3,15,4,10,44,33,11,49
Melbourne V,7677,4,13,5,11,45,40,5,44
Adelaide Utd,7677,5,11,6,11,37,40,-3,39
Brisbane,7677,6,10,5,13,33,42,-9,35
Western Sydn,7677,7,8,9,10,38,47,-9,33
Perth Glory,7677,8,10,2,15,37,50,-13,32
Wellington P,7677,9,5,6,16,31,55,-24,21
CC Mariners,7677,10,4,8,15,28,49,-21,20
Sydney FC,7678,1,21,4,3,65,22,43,67
N'castle Jet,7678,2,16,5,7,59,37,22,53
Melbourne C,7678,3,14,4,11,43,35,8,46
Melbourne V,7678,4,13,5,11,45,39,6,44
Adelaide Utd,7678,5,11,6,11,37,40,-3,39
Brisbane,7678,6,10,5,13,33,42,-9,35
Western Sydn,7678,7,8,9,10,38,47,-9,33
Perth Glory,7678,8,10,2,15,37,50,-13,32
Wellington P,7678,9,5,6,16,31,55,-24,21
CC Mariners,7678,10,4,8,15,28,49,-21,20
Sydney FC,7679,1,20,4,4,65,25,40,64
N'castle Jet,7679,2,15,5,8,57,38,19,50
Melbourne C,7679,3,15,4,10,44,33,11,49
Melbourne V,7679,4,14,5,10,48,39,9,47
Adelaide Utd,7679,5,11,6,11,37,40,-3,39
Brisbane,7679,6,10,5,13,33,42,-9,35
Western Sydn,7679,7,8,9,10,38,47,-9,33
Perth Glory,7679,8,10,2,15,37,50,-13,32
Wellington P,7679,9,5,6,16,31,55,-24,21
CC Mariners,7679,10,4,8,15,28,49,-21,20
Sydney FC,7680,1,21,4,3,67,24,43,67
N'castle Jet,7680,2,16,5,7,61,37,24,53
Melbourne C,7680,3,14,4,11,43,37,6,46
Melbourne V,7680,4,13,5,11,47,41,6,44
Adelaide Utd,7680,5,11,6,11,37,40,-3,39
Brisbane,7680,6,10,5,13,33,42,-9,35
Western Sydn,7680,7,8,9,10,38,47,-9,33
Perth Glory,7680,8,10,2,15,37,50,-13,32
Wellington P,7680,9,5,6,16,31,55,-24,21
CC Mariners,7680,10,4,8,15,28,49,-21,20
Sydney FC,7681,1,21,4,3,71,23,48,67
N'castle Jet,7681,2,15,6,7,59,39,20,51
Melbourne C,7681,3,14,5,10,45,35,10,47
Melbourne V,7681,4,13,5,11,46,45,1,44
Adelaide Utd,7681,5,11,6,11,37,40,-3,39
Brisbane,7681,6,10,5,13,33,42,-9,35
Western Sydn,7681,7,8,9,10,38,47,-9,33
Perth Glory,7681,8,10,2,15,37,50,-13,32
Wellington P,7681,9,5,6,16,31,55,-24,21
CC Mariners,7681,10,4,8,15,28,49,-21,20
Sydney FC,7682,1,20,4,4,64,23,41,64
N'castle Jet,7682,2,16,5,7,58,37,21,53
Melbourne V,7682,3,14,5,10,46,38,8,47
Melbourne C,7682,4,14,4,11,43,34,9,46
Adelaide Utd,7682,5,11,6,11,37,40,-3,39
Brisbane,7682,6,10,5,13,33,42,-9,35
Western Sydn,7682,7,8,9,10,38,47,-9,33
Perth Glory,7682,8,10,2,15,37,50,-13,32
Wellington P,7682,9,5,6,16,31,55,-24,21
CC Mariners,7682,10,4,8,15,28,49,-21,20
Sydney FC,7683,1,21,4,3,67,23,44,67
N'castle Jet,7683,2,16,5,7,62,39,23,53
Melbourne C,7683,3,14,4,11,45,38,7,46
Melbourne V,7683,4,13,5,11,46,41,5,44
Adelaide Utd,7683,5,11,6,11,37,40,-3,39
Brisbane,7683,6,10,5,13,33,42,-9,35
Western Sydn,7683,7,8,9,10,38,47,-9,33
Perth Glory,7683,8,10,2,15,37,50,-13,32
Wellington P,7683,9,5,6,16,31,55,-24,21
CC Mariners,7683,10,4,8,15,28,49,-21,20
Sydney FC,7684,1,21,4,3,68,24,44,67
N'castle Jet,7684,2,15,6,7,58,38,20,51
Melbourne C,7684,3,14,5,10,44,34,10,47
Melbourne V,7684,4,13,5,11,47,42,5,44
Adelaide Utd,7684,5,11,6,11,37,40,-3,39
Brisbane,7684,6,10,5,13,33,42,-9,35
Western Sydn,7684,7,8,9,10,38,47,-9,33
Perth Glory,7684,8,10,2,15,37,50,-13,32
Wellington P,7684,9,5,6,16,31,55,-24,21
CC Mariners,7684,10,4,8,15,28,49,-21,20
Sydney FC,7685,1,21,4,3,67,22,45,67
N'castle Jet,7685,2,16,5,7,59,38,21,53
Melbourne C,7685,3,14,4,11,44,35,9,46
Melbourne V,7685,4,13,5,11,45,41,4,44
Adelaide Utd,7685,5,11,6,11,37,40,-3,39
Brisbane,7685,6,10,5,13,33,42,-9,35
Western Sydn,7685,7,8,9,10,38,47,-9,33
Perth Glory,7685,8,10,2,15,37,50,-13,32
Wellington P,7685,9,5,6,16,31,55,-24,21
CC Mariners,7685,10,4,8,15,28,49,-21,20
Sydney FC,7686,1,21,4,3,66,23,43,67
N'castle Jet,7686,2,16,5,7,60,39,21,53
Melbourne C,7686,3,14,4,11,45,36,9,46
Melbourne V,7686,4,13,5,11,46,40,6,44
Adelaide Utd,7686,5,11,6,11,37,40,-3,39
Brisbane,7686,6,10,5,13,33,42,-9,35
Western Sydn,7686,7,8,9,10,38,47,-9,33
Perth Glory,7686,8,10,2,15,37,50,-13,32
Wellington P,7686,9,5,6,16,31,55,-24,21
CC Mariners,7686,10,4,8,15,28,49,-21,20
Sydney FC,7687,1,21,4,3,66,23,43,67
N'castle Jet,7687,2,16,5,7,60,38,22,53
Melbourne C,7687,3,14,4,11,44,36,8,46
Melbourne V,7687,4,13,5,11,46,40,6,44
Adelaide Utd,7687,5,11,6,11,37,40,-3,39
Brisbane,7687,6,10,5,13,33,42,-9,35
Western Sydn,7687,7,8,9,10,38,47,-9,33
Perth Glory,7687,8,10,2,15,37,50,-13,32
Wellington P,7687,9,5,6,16,31,55,-24,21
CC Mariners,7687,10,4,8,15,28,49,-21,20
Sydney FC,7688,1,21,4,3,67,22,45,67
N'castle Jet,7688,2,15,6,7,58,38,20,51
Melbourne C,7688,3,14,5,10,44,34,10,47
Melbourne V,7688,4,13,5,11,45,41,4,44
Adelaide Utd,7688,5,11,6,11,37,40,-3,39
Brisbane,7688,6,10,5,13,33,42,-9,35
Western Sydn,7688,7,8,9,10,38,47,-9,33
Perth Glory,7688,8,10,2,15,37,50,-13,32
Wellington P,7688,9,5,6,16,31,55,-24,21
CC Mariners,7688,10,4,8,15,28,49,-21,20
Sydney FC,7689,1,21,4,3,66,22,44,67
N'castle Jet,7689,2,15,6,7,59,39,20,51
Melbourne C,7689,3,14,5,10,45,35,10,47
Melbourne V,7689,4,13,5,11,45,40,5,44
Adelaide Utd,7689,5,11,6,11,37,40,-3,39
Brisbane,7689,6,10,5,13,33,42,-9,35
Western Sydn,7689,7,8,9,10,38,47,-9,33
Perth Glory,7689,8,10,2,15,37,50,-13,32
Wellington P,7689,9,5,6,16,31,55,-24,21
CC Mariners,7689,10,4,8,15,28,49,-21,20
Sydney FC,7690,1,20,5,3,64,22,42,65
N'castle Jet,7690,2,16,5,7,59,38,21,53
Melbourne C,7690,3,14,4,11,44,35,9,46
Melbourne V,7690,4,13,6,10,45,38,7,45
Adelaide Utd,7690,5,11,6,11,37,40,-3,39
Brisbane,7690,6,10,5,13,33,42,-9,35
Western Sydn,7690,7,8,9,10,38,47,-9,33
Perth Glory,7690,8,10,2,15,37,50,-13,32
Wellington P,7690,9,5,6,16,31,55,-24,21
CC Mariners,7690,10,4,8,15,28,49,-21,20
Sydney FC,7691,1,20,5,3,65,23,42,65
N'castle Jet,7691,2,16,5,7,60,39,21,53
Melbourne C,7691,3,14,4,11,45,36,9,46
Melbourne V,7691,4,13,6,10,46,39,7,45
Adelaide Utd,7691,5,11,6,11,37,40,-3,39
Brisbane,7691,6,10,5,13,33,42,-9,35
Western Sydn,7691,7,8,9,10,38,47,-9,33
Perth Glory,7691,8,10,2,15,37,50,-13,32
Wellington P,7691,9,5,6,16,31,55,-24,21
CC Mariners,7691,10,4,8,15,28,49,-21,20
Sydney FC,7692,1,21,4,3,66,23,43,67
N'castle Jet,7692,2,16,5,7,59,38,21,53
Melbourne C,7692,3,14,4,11,44,35,9,46
Melbourne V,7692,4,13,5,11,46,40,6,44
Adelaide Utd,7692,5,11,6,11,37,40,-3,39
Brisbane,7692,6,10,5,13,33,42,-9,35
Western Sydn,7692,7,8,9,10,38,47,-9,33
Perth Glory,7692,8,10,2,15,37,50,-13,32
Wellington P,7692,9,5,6,16,31,55,-24,21
CC Mariners,7692,10,4,8,15,28,49,-21,20
Sydney FC,7693,1,20,5,3,64,22,42,65
N'castle Jet,7693,2,16,5,7,60,39,21,53
Melbourne C,7693,3,14,4,11,45,36,9,46
Melbourne V,7693,4,13,6,10,45,38,7,45
Adelaide Utd,7693,5,11,6,11,37,40,-3,39
Brisbane,7693,6,10,5,13,33,42,-9,35
Western Sydn,7693,7,8,9,10,38,47,-9,33
Perth Glory,7693,8,10,2,15,37,50,-13,32
Wellington P,7693,9,5,6,16,31,55,-24,21
CC Mariners,7693,10,4,8,15,28,49,-21,20
Sydney FC,7694,1,21,4,3,66,22,44,67
N'castle Jet,7694,2,16,5,7,59,38,21,53
Melbourne C,7694,3,14,4,11,44,35,9,46
Melbourne V,7694,4,13,5,11,45,40,5,44
Adelaide Utd,7694,5,11,6,11,37,40,-3,39
Brisbane,7694,6,10,5,13,33,42,-9,35
Western Sydn,7694,7,8,9,10,38,47,-9,33
Perth Glory,7694,8,10,2,15,37,50,-13,32
Wellington P,7694,9,5,6,16,31,55,-24,21
CC Mariners,7694,10,4,8,15,28,49,-21,20
Sydney FC,7695,1,21,4,3,67,23,44,67
N'castle Jet,7695,2,15,6,7,57,37,20,51
Melbourne C,7695,3,14,5,10,43,33,10,47
Melbourne V,7695,4,13,5,11,46,41,5,44
Adelaide Utd,7695,5,11,6,11,37,40,-3,39
Brisbane,7695,6,10,5,13,33,42,-9,35
Western Sydn,7695,7,8,9,10,38,47,-9,33
Perth Glory,7695,8,10,2,15,37,50,-13,32
Wellington P,7695,9,5,6,16,31,55,-24,21
CC Mariners,7695,10,4,8,15,28,49,-21,20
Sydney FC,7696,1,20,4,4,66,26,40,64
N'castle Jet,7696,2,15,5,8,57,39,18,50
Melbourne C,7696,3,15,4,10,45,33,12,49
Melbourne V,7696,4,14,5,10,49,40,9,47
Adelaide Utd,7696,5,11,6,11,37,40,-3,39
Brisbane,7696,6,10,5,13,33,42,-9,35
Western Sydn,7696,7,8,9,10,38,47,-9,33
Perth Glory,7696,8,10,2,15,37,50,-13,32
Wellington P,7696,9,5,6,16,31,55,-24,21
CC Mariners,7696,10,4,8,15,28,49,-21,20
Sydney FC,7697,1,21,4,3,67,23,44,67
N'castle Jet,7697,2,16,5,7,62,40,22,53
Melbourne C,7697,3,14,4,11,46,38,8,46
Melbourne V,7697,4,13,5,11,46,41,5,44
Adelaide Utd,7697,5,11,6,11,37,40,-3,39
Brisbane,7697,6,10,5,13,33,42,-9,35
Western Sydn,7697,7,8,9,10,38,47,-9,33
Perth Glory,7697,8,10,2,15,37,50,-13,32
Wellington P,7697,9,5,6,16,31,55,-24,21
CC Mariners,7697,10,4,8,15,28,49,-21,20
Sydney FC,7698,1,21,4,3,66,22,44,67
N'castle Jet,7698,2,16,5,7,60,38,22,53
Melbourne C,7698,3,14,4,11,44,36,8,46
Melbourne V,7698,4,13,5,11,45,40,5,44
Adelaide Utd,7698,5,11,6,11,37,40,-3,39
Brisbane,7698,6,10,5,13,33,42,-9,35
Western Sydn,7698,7,8,9,10,38,47,-9,33
Perth Glory,7698,8,10,2,15,37,50,-13,32
Wellington P,7698,9,5,6,16,31,55,-24,21
CC Mariners,7698,10,4,8,15,28,49,-21,20
Sydney FC,7699,1,20,4,4,65,24,41,64
N'castle Jet,7699,2,16,5,7,58,37,21,53
Melbourne V,7699,3,14,5,10,47,39,8,47
Melbourne C,7699,4,14,4,11,43,34,9,46
Adelaide Utd,7699,5,11,6,11,37,40,-3,39
Brisbane,7699,6,10,5,13,33,42,-9,35
Western Sydn,7699,7,8,9,10,38,47,-9,33
Perth Glory,7699,8,10,2,15,37,50,-13,32
Wellington P,7699,9,5,6,16,31,55,-24,21
CC Mariners,7699,10,4,8,15,28,49,-21,20
Sydney FC,7700,1,21,4,3,67,23,44,67
N'castle Jet,7700,2,15,5,8,57,38,19,50
Melbourne C,7700,3,15,4,10,44,33,11,49
Melbourne V,7700,4,13,5,11,46,41,5,44
Adelaide Utd,7700,5,11,6,11,37,40,-3,39
Brisbane,7700,6,10,5,13,33,42,-9,35
Western Sydn,7700,7,8,9,10,38,47,-9,33
Perth Glory,7700,8,10,2,15,37,50,-13,32
Wellington P,7700,9,5,6,16,31,55,-24,21
CC Mariners,7700,10,4,8,15,28,49,-21,20
Sydney FC,7701,1,21,4,3,69,24,45,67
N'castle Jet,7701,2,15,5,8,57,38,19,50
Melbourne C,7701,3,15,4,10,44,33,11,49
Melbourne V,7701,4,13,5,11,47,43,4,44
Adelaide Utd,7701,5,11,6,11,37,40,-3,39
Brisbane,7701,6,10,5,13,33,42,-9,35
Western Sydn,7701,7,8,9,10,38,47,-9,33
Perth Glory,7701,8,10,2,15,37,50,-13,32
Wellington P,7701,9,5,6,16,31,55,-24,21
CC Mariners,7701,10,4,8,15,28,49,-21,20
Sydney FC,7702,1,20,4,4,65,24,41,64
N'castle Jet,7702,2,15,5,8,57,38,19,50
Melbourne C,7702,3,15,4,10,44,33,11,49
Melbourne V,7702,4,14,5,10,47,39,8,47
Adelaide Utd,7702,5,11,6,11,37,40,-3,39
Brisbane,7702,6,10,5,13,33,42,-9,35
Western Sydn,7702,7,8,9,10,38,47,-9,33
Perth Glory,7702,8,10,2,15,37,50,-13,32
Wellington P,7702,9,5,6,16,31,55,-24,21
CC Mariners,7702,10,4,8,15,28,49,-21,20
Sydney FC,7703,1,20,5,3,64,22,42,65
N'castle Jet,7703,2,16,5,7,60,38,22,53
Melbourne C,7703,3,14,4,11,44,36,8,46
Melbourne V,7703,4,13,6,10,45,38,7,45
Adelaide Utd,7703,5,11,6,11,37,40,-3,39
Brisbane,7703,6,10,5,13,33,42,-9,35
Western Sydn,7703,7,8,9,10,38,47,-9,33
Perth Glory,7703,8,10,2,15,37,50,-13,32
Wellington P,7703,9,5,6,16,31,55,-24,21
CC Mariners,7703,10,4,8,15,28,49,-21,20
Sydney FC,7704,1,21,4,3,69,23,46,67
N'castle Jet,7704,2,16,5,7,58,37,21,53
Melbourne C,7704,3,14,4,11,43,34,9,46
Melbourne V,7704,4,13,5,11,46,43,3,44
Adelaide Utd,7704,5,11,6,11,37,40,-3,39
Brisbane,7704,6,10,5,13,33,42,-9,35
Western Sydn,7704,7,8,9,10,38,47,-9,33
Perth Glory,7704,8,10,2,15,37,50,-13,32
Wellington P,7704,9,5,6,16,31,55,-24,21
CC Mariners,7704,10,4,8,15,28,49,-21,20
Sydney FC,7705,1,21,4,3,67,23,44,67
N'castle Jet,7705,2,16,5,7,63,38,25,53
Melbourne C,7705,3,14,4,11,44,39,5,46
Melbourne V,7705,4,13,5,11,46,41,5,44
Adelaide Utd,7705,5,11,6,11,37,40,-3,39
Brisbane,7705,6,10,5,13,33,42,-9,35
Western Sydn,7705,7,8,9,10,38,47,-9,33
Perth Glory,7705,8,10,2,15,37,50,-13,32
Wellington P,7705,9,5,6,16,31,55,-24,21
CC Mariners,7705,10,4,8,15,28,49,-21,20
Sydney FC,7706,1,21,4,3,67,23,44,67
N'castle Jet,7706,2,15,6,7,59,39,20,51
Melbourne C,7706,3,14,5,10,45,35,10,47
Melbourne V,7706,4,13,5,11,46,41,5,44
Adelaide Utd,7706,5,11,6,11,37,40,-3,39
Brisbane,7706,6,10,5,13,33,42,-9,35
Western Sydn,7706,7,8,9,10,38,47,-9,33
Perth Glory,7706,8,10,2,15,37,50,-13,32
Wellington P,7706,9,5,6,16,31,55,-24,21
CC Mariners,7706,10,4,8,15,28,49,-21,20
Sydney FC,7707,1,20,4,4,65,24,41,64
N'castle Jet,7707,2,15,6,7,57,37,20,51
Melbourne C,7707,3,14,5,10,43,33,10,47
Melbourne V,7707,4,14,5,10,47,39,8,47
Adelaide Utd,7707,5,11,6,11,37,40,-3,39
Brisbane,7707,6,10,5,13,33,42,-9,35
Western Sydn,7707,7,8,9,10,38,47,-9,33
Perth Glory,7707,8,10,2,15,37,50,-13,32
Wellington P,7707,9,5,6,16,31,55,-24,21
CC Mariners,7707,10,4,8,15,28,49,-21,20
Sydney FC,7708,1,21,4,3,69,22,47,67
N'castle Jet,7708,2,16,5,7,61,39,22,53
Melbourne C,7708,3,14,4,11,45,37,8,46
Melbourne V,7708,4,13,5,11,45,43,2,44
Adelaide Utd,7708,5,11,6,11,37,40,-3,39
Brisbane,7708,6,10,5,13,33,42,-9,35
Western Sydn,7708,7,8,9,10,38,47,-9,33
Perth Glory,7708,8,10,2,15,37,50,-13,32
Wellington P,7708,9,5,6,16,31,55,-24,21
CC Mariners,7708,10,4,8,15,28,49,-21,20
Sydney FC,7709,1,21,4,3,66,23,43,67
N'castle Jet,7709,2,16,5,7,62,37,25,53
Melbourne C,7709,3,14,4,11,43,38,5,46
Melbourne V,7709,4,13,5,11,46,40,6,44
Adelaide Utd,7709,5,11,6,11,37,40,-3,39
Brisbane,7709,6,10,5,13,33,42,-9,35
Western Sydn,7709,7,8,9,10,38,47,-9,33
Perth Glory,7709,8,10,2,15,37,50,-13,32
Wellington P,7709,9,5,6,16,31,55,-24,21
CC Mariners,7709,10,4,8,15,28,49,-21,20
Sydney FC,7710,1,20,4,4,64,23,41,64
N'castle Jet,7710,2,16,5,7,60,39,21,53
Melbourne V,7710,3,14,5,10,46,38,8,47
Melbourne C,7710,4,14,4,11,45,36,9,46
Adelaide Utd,7710,5,11,6,11,37,40,-3,39
Brisbane,7710,6,10,5,13,33,42,-9,35
Western Sydn,7710,7,8,9,10,38,47,-9,33
Perth Glory,7710,8,10,2,15,37,50,-13,32
Wellington P,7710,9,5,6,16,31,55,-24,21
CC Mariners,7710,10,4,8,15,28,49,-21,20
Sydney FC,7711,1,21,4,3,68,22,46,67
N'castle Jet,7711,2,16,5,7,61,38,23,53
Melbourne C,7711,3,14,4,11,44,37,7,46
Melbourne V,7711,4,13,5,11,45,42,3,44
Adelaide Utd,7711,5,11,6,11,37,40,-3,39
Brisbane,7711,6,10,5,13,33,42,-9,35
Western Sydn,7711,7,8,9,10,38,47,-9,33
Perth Glory,7711,8,10,2,15,37,50,-13,32
Wellington P,7711,9,5,6,16,31,55,-24,21
CC Mariners,7711,10,4,8,15,28,49,-21,20
Sydney FC,7712,1,21,4,3,67,23,44,67
N'castle Jet,7712,2,16,5,7,60,38,22,53
Melbourne C,7712,3,14,4,11,44,36,8,46
Melbourne V,7712,4,13,5,11,46,41,5,44
Adelaide Utd,7712,5,11,6,11,37,40,-3,39
Brisbane,7712,6,10,5,13,33,42,-9,35
Western Sydn,7712,7,8,9,10,38,47,-9,33
Perth Glory,7712,8,10,2,15,37,50,-13,32
Wellington P,7712,9,5,6,16,31,55,-24,21
CC Mariners,7712,10,4,8,15,28,49,-21,20
Sydney FC,7713,1,20,4,4,64,24,40,64
N'castle Jet,7713,2,15,5,8,57,38,19,50
Melbourne C,7713,3,15,4,10,44,33,11,49
Melbourne V,7713,4,14,5,10,47,38,9,47
Adelaide Utd,7713,5,11,6,11,37,40,-3,39
Brisbane,7713,6,10,5,13,33,42,-9,35
Western Sydn,7713,7,8,9,10,38,47,-9,33
Perth Glory,7713,8,10,2,15,37,50,-13,32
Wellington P,7713,9,5,6,16,31,55,-24,21
CC Mariners,7713,10,4,8,15,28,49,-21,20
Sydney FC,7714,1,21,4,3,69,23,46,67
N'castle Jet,7714,2,16,5,7,62,38,24,53
Melbourne C,7714,3,14,4,11,44,38,6,46
Melbourne V,7714,4,13,5,11,46,43,3,44
Adelaide Utd,7714,5,11,6,11,37,40,-3,39
Brisbane,7714,6,10,5,13,33,42,-9,35
Western Sydn,7714,7,8,9,10,38,47,-9,33
Perth Glory,7714,8,10,2,15,37,50,-13,32
Wellington P,7714,9,5,6,16,31,55,-24,21
CC Mariners,7714,10,4,8,15,28,49,-21,20
Sydney FC,7715,1,20,4,4,66,25,41,64
N'castle Jet,7715,2,16,5,7,60,38,22,53
Melbourne V,7715,3,14,5,10,48,40,8,47
Melbourne C,7715,4,14,4,11,44,36,8,46
Adelaide Utd,7715,5,11,6,11,37,40,-3,39
Brisbane,7715,6,10,5,13,33,42,-9,35
Western Sydn,7715,7,8,9,10,38,47,-9,33
Perth Glory,7715,8,10,2,15,37,50,-13,32
Wellington P,7715,9,5,6,16,31,55,-24,21
CC Mariners,7715,10,4,8,15,28,49,-21,20
Sydney FC,7716,1,21,4,3,67,22,45,67
N'castle Jet,7716,2,15,6,7,57,37,20,51
Melbourne C,7716,3,14,5,10,43,33,10,47
Melbourne V,7716,4,13,5,11,45,41,4,44
Adelaide Utd,7716,5,11,6,11,37,40,-3,39
Brisbane,7716,6,10,5,13,33,42,-9,35
Western Sydn,7716,7,8,9,10,38,47,-9,33
Perth Glory,7716,8,10,2,15,37,50,-13,32
Wellington P,7716,9,5,6,16,31,55,-24,21
CC Mariners,7716,10,4,8,15,28,49,-21,20
Sydney FC,7717,1,21,4,3,66,22,44,67
N'castle Jet,7717,2,16,5,7,58,37,21,53
Melbourne C,7717,3,14,4,11,43,34,9,46
Melbourne V,7717,4,13,5,11,45,40,5,44
Adelaide Utd,7717,5,11,6,11,37,40,-3,39
Brisbane,7717,6,10,5,13,33,42,-9,35
Western Sydn,7717,7,8,9,10,38,47,-9,33
Perth Glory,7717,8,10,2,15,37,50,-13,32
Wellington P,7717,9,5,6,16,31,55,-24,21
CC Mariners,7717,10,4,8,15,28,49,-21,20
Sydney FC,7718,1,20,4,4,65,24,41,64
N'castle Jet,7718,2,16,5,7,60,37,23,53
Melbourne V,7718,3,14,5,10,47,39,8,47
Melbourne C,7718,4,14,4,11,43,36,7,46
Adelaide Utd,7718,5,11,6,11,37,40,-3,39
Brisbane,7718,6,10,5,13,33,42,-9,35
Western Sydn,7718,7,8,9,10,38,47,-9,33
Perth Glory,7718,8,10,2,15,37,50,-13,32
Wellington P,7718,9,5,6,16,31,55,-24,21
CC Mariners,7718,10,4,8,15,28,49,-21,20
Sydney FC,7719,1,20,5,3,65,23,42,65
N'castle Jet,7719,2,16,5,7,61,37,24,53
Melbourne C,7719,3,14,4,11,43,37,6,46
Melbourne V,7719,4,13,6,10,46,39,7,45
Adelaide Utd,7719,5,11,6,11,37,40,-3,39
Brisbane,7719,6,10,5,13,33,42,-9,35
Western Sydn,7719,7,8,9,10,38,47,-9,33
Perth Glory,7719,8,10,2,15,37,50,-13,32
Wellington P,7719,9,5,6,16,31,55,-24,21
CC Mariners,7719,10,4,8,15,28,49,-21,20
Sydney FC,7720,1,20,5,3,64,22,42,65
N'castle Jet,7720,2,16,5,7,58,37,21,53
Melbourne C,7720,3,14,4,11,43,34,9,46
Melbourne V,7720,4,13,6,10,45,38,7,45
Adelaide Utd,7720,5,11,6,11,37,40,-3,39
Brisbane,7720,6,10,5,13,33,42,-9,35
Western Sydn,7720,7,8,9,10,38,47,-9,33
Perth Glory,7720,8,10,2,15,37,50,-13,32
Wellington P,7720,9,5,6,16,31,55,-24,21
CC Mariners,7720,10,4,8,15,28,49,-21,20
Sydney FC,7721,1,21,4,3,69,23,46,67
N'castle Jet,7721,2,16,5,7,58,37,21,53
Melbourne C,7721,3,14,4,11,43,34,9,46
Melbourne V,7721,4,13,5,11,46,43,3,44
Adelaide Utd,7721,5,11,6,11,37,40,-3,39
Brisbane,7721,6,10,5,13,33,42,-9,35
Western Sydn,7721,7,8,9,10,38,47,-9,33
Perth Glory,7721,8,10,2,15,37,50,-13,32
Wellington P,7721,9,5,6,16,31,55,-24,21
CC Mariners,7721,10,4,8,15,28,49,-21,20
Sydney FC,7722,1,21,4,3,69,22,47,67
N'castle Jet,7722,2,15,6,7,59,39,20,51
Melbourne C,7722,3,14,5,10,45,35,10,47
Melbourne V,7722,4,13,5,11,45,43,2,44
Adelaide Utd,7722,5,11,6,11,37,40,-3,39
Brisbane,7722,6,10,5,13,33,42,-9,35
Western Sydn,7722,7,8,9,10,38,47,-9,33
Perth Glory,7722,8,10,2,15,37,50,-13,32
Wellington P,7722,9,5,6,16,31,55,-24,21
CC Mariners,7722,10,4,8,15,28,49,-21,20
Sydney FC,7723,1,20,4,4,65,24,41,64
N'castle Jet,7723,2,15,5,8,59,40,19,50
Melbourne C,7723,3,15,4,10,46,35,11,49
Melbourne V,7723,4,14,5,10,47,39,8,47
Adelaide Utd,7723,5,11,6,11,37,40,-3,39
Brisbane,7723,6,10,5,13,33,42,-9,35
Western Sydn,7723,7,8,9,10,38,47,-9,33
Perth Glory,7723,8,10,2,15,37,50,-13,32
Wellington P,7723,9,5,6,16,31,55,-24,21
CC Mariners,7723,10,4,8,15,28,49,-21,20
Sydney FC,7724,1,21,4,3,67,24,43,67
N'castle Jet,7724,2,16,5,7,60,39,21,53
Melbourne C,7724,3,14,4,11,45,36,9,46
Melbourne V,7724,4,13,5,11,47,41,6,44
Adelaide Utd,7724,5,11,6,11,37,40,-3,39
Brisbane,7724,6,10,5,13,33,42,-9,35
Western Sydn,7724,7,8,9,10,38,47,-9,33
Perth Glory,7724,8,10,2,15,37,50,-13,32
Wellington P,7724,9,5,6,16,31,55,-24,21
CC Mariners,7724,10,4,8,15,28,49,-21,20
Sydney FC,7725,1,20,4,4,67,26,41,64
N'castle Jet,7725,2,16,5,7,59,37,22,53
Melbourne V,7725,3,14,5,10,49,41,8,47
Melbourne C,7725,4,14,4,11,43,35,8,46
Adelaide Utd,7725,5,11,6,11,37,40,-3,39
Brisbane,7725,6,10,5,13,33,42,-9,35
Western Sydn,7725,7,8,9,10,38,47,-9,33
Perth Glory,7725,8,10,2,15,37,50,-13,32
Wellington P,7725,9,5,6,16,31,55,-24,21
CC Mariners,7725,10,4,8,15,28,49,-21,20
Sydney FC,7726,1,20,4,4,64,24,40,64
N'castle Jet,7726,2,16,5,7,63,37,26,53
Melbourne V,7726,3,14,5,10,47,38,9,47
Melbourne C,7726,4,14,4,11,43,39,4,46
Adelaide Utd,7726,5,11,6,11,37,40,-3,39
Brisbane,7726,6,10,5,13,33,42,-9,35
Western Sydn,7726,7,8,9,10,38,47,-9,33
Perth Glory,7726,8,10,2,15,37,50,-13,32
Wellington P,7726,9,5,6,16,31,55,-24,21
CC Mariners,7726,10,4,8,15,28,49,-21,20
Sydney FC,7727,1,21,4,3,66,22,44,67
N'castle Jet,7727,2,16,5,7,58,37,21,53
Melbourne C,7727,3,14,4,11,43,34,9,46
Melbourne V,7727,4,13,5,11,45,40,5,44
Adelaide Utd,7727,5,11,6,11,37,40,-3,39
Brisbane,7727,6,10,5,13,33,42,-9,35
Western Sydn,7727,7,8,9,10,38,47,-9,33
Perth Glory,7727,8,10,2,15,37,50,-13,32
Wellington P,7727,9,5,6,16,31,55,-24,21
CC Mariners,7727,10,4,8,15,28,49,-21,20
Sydney FC,7728,1,21,4,3,68,22,46,67
N'castle Jet,7728,2,16,5,7,58,37,21,53
Melbourne C,7728,3,14,4,11,43,34,9,46
Melbourne V,7728,4,13,5,11,45,42,3,44
Adelaide Utd,7728,5,11,6,11,37,40,-3,39
Brisbane,7728,6,10,5,13,33,42,-9,35
Western Sydn,7728,7,8,9,10,38,47,-9,33
Perth Glory,7728,8,10,2,15,37,50,-13,32
Wellington P,7728,9,5,6,16,31,55,-24,21
CC Mariners,7728,10,4,8,15,28,49,-21,20
Sydney FC,7729,1,21,4,3,67,22,45,67
N'castle Jet,7729,2,15,6,7,59,39,20,51
Melbourne C,7729,3,14,5,10,45,35,10,47
Melbourne V,7729,4,13,5,11,45,41,4,44
Adelaide Utd,7729,5,11,6,11,37,40,-3,39
Brisbane,7729,6,10,5,13,33,42,-9,35
Western Sydn,7729,7,8,9,10,38,47,-9,33
Perth Glory,7729,8,10,2,15,37,50,-13,32
Wellington P,7729,9,5,6,16,31,55,-24,21
CC Mariners,7729,10,4,8,15,28,49,-21,20
Sydney FC,7730,1,20,4,4,64,23,41,64
N'castle Jet,7730,2,16,5,7,60,37,23,53
Melbourne V,7730,3,14,5,10,46,38,8,47
Melbourne C,7730,4,14,4,11,43,36,7,46
Adelaide Utd,7730,5,11,6,11,37,40,-3,39
Brisbane,7730,6,10,5,13,33,42,-9,35
Western Sydn,7730,7,8,9,10,38,47,-9,33
Perth Glory,7730,8,10,2,15,37,50,-13,32
Wellington P,7730,9,5,6,16,31,55,-24,21
CC Mariners,7730,10,4,8,15,28,49,-21,20
Sydney FC,7731,1,20,5,3,65,23,42,65
N'castle Jet,7731,2,16,5,7,61,37,24,53
Melbourne C,7731,3,14,4,11,43,37,6,46
Melbourne V,7731,4,13,6,10,46,39,7,45
Adelaide Utd,7731,5,11,6,11,37,40,-3,39
Brisbane,7731,6,10,5,13,33,42,-9,35
Western Sydn,7731,7,8,9,10,38,47,-9,33
Perth Glory,7731,8,10,2,15,37,50,-13,32
Wellington P,7731,9,5,6,16,31,55,-24,21
CC Mariners,7731,10,4,8,15,28,49,-21,20
Sydney FC,7732,1,20,5,3,65,23,42,65
N'castle Jet,7732,2,15,5,8,58,39,19,50
Melbourne C,7732,3,15,4,10,45,34,11,49
Melbourne V,7732,4,13,6,10,46,39,7,45
Adelaide Utd,7732,5,11,6,11,37,40,-3,39
Brisbane,7732,6,10,5,13,33,42,-9,35
Western Sydn,7732,7,8,9,10,38,47,-9,33
Perth Glory,7732,8,10,2,15,37,50,-13,32
Wellington P,7732,9,5,6,16,31,55,-24,21
CC Mariners,7732,10,4,8,15,28,49,-21,20
Sydney FC,7733,1,21,4,3,65,22,43,67
N'castle Jet,7733,2,16,5,7,60,39,21,53
Melbourne C,7733,3,14,4,11,45,36,9,46
Melbourne V,7733,4,13,5,11,45,39,6,44
Adelaide Utd,7733,5,11,6,11,37,40,-3,39
Brisbane,7733,6,10,5,13,33,42,-9,35
Western Sydn,7733,7,8,9,10,38,47,-9,33
Perth Glory,7733,8,10,2,15,37,50,-13,32
Wellington P,7733,9,5,6,16,31,55,-24,21
CC Mariners,7733,10,4,8,15,28,49,-21,20
Sydney FC,7734,1,20,5,3,65,23,42,65
N'castle Jet,7734,2,16,5,7,58,37,21,53
Melbourne C,7734,3,14,4,11,43,34,9,46
Melbourne V,7734,4,13,6,10,46,39,7,45
Adelaide Utd,7734,5,11,6,11,37,40,-3,39
Brisbane,7734,6,10,5,13,33,42,-9,35
Western Sydn,7734,7,8,9,10,38,47,-9,33
Perth Glory,7734,8,10,2,15,37,50,-13,32
Wellington P,7734,9,5,6,16,31,55,-24,21
CC Mariners,7734,10,4,8,15,28,49,-21,20
Sydney FC,7735,1,21,4,3,65,22,43,67
N'castle Jet,7735,2,16,5,7,59,38,21,53
Melbourne C,7735,3,14,4,11,44,35,9,46
Melbourne V,7735,4,13,5,11,45,39,6,44
Adelaide Utd,7735,5,11,6,11,37,40,-3,39
Brisbane,7735,6,10,5,13,33,42,-9,35
Western Sydn,7735,7,8,9,10,38,47,-9,33
Perth Glory,7735,8,10,2,15,37,50,-13,32
Wellington P,7735,9,5,6,16,31,55,-24,21
CC Mariners,7735,10,4,8,15,28,49,-21,20
Sydney FC,7736,1,21,4,3,66,23,43,67
N'castle Jet,7736,2,16,5,7,60,38,22,53
Melbourne C,7736,3,14,4,11,44,36,8,46
Melbourne V,7736,4,13,5,11,46,40,6,44
Adelaide Utd,7736,5,11,6,11,37,40,-3,39
Brisbane,7736,6,10,5,13,33,42,-9,35
Western Sydn,7736,7,8,9,10,38,47,-9,33
Perth Glory,7736,8,10,2,15,37,50,-13,32
Wellington P,7736,9,5,6,16,31,55,-24,21
CC Mariners,7736,10,4,8,15,28,49,-21,20
Sydney FC,7737,1,20,5,3,65,23,42,65
N'castle Jet,7737,2,16,5,7,59,38,21,53
Melbourne C,7737,3,14,4,11,44,35,9,46
Melbourne V,7737,4,13,6,10,46,39,7,45
Adelaide Utd,7737,5,11,6,11,37,40,-3,39
Brisbane,7737,6,10,5,13,33,42,-9,35
Western Sydn,7737,7,8,9,10,38,47,-9,33
Perth Glory,7737,8,10,2,15,37,50,-13,32
Wellington P,7737,9,5,6,16,31,55,-24,21
CC Mariners,7737,10,4,8,15,28,49,-21,20
Sydney FC,7738,1,21,4,3,67,22,45,67
N'castle Jet,7738,2,15,6,7,58,38,20,51
Melbourne C,7738,3,14,5,10,44,34,10,47
Melbourne V,7738,4,13,5,11,45,41,4,44
Adelaide Utd,7738,5,11,6,11,37,40,-3,39
Brisbane,7738,6,10,5,13,33,42,-9,35
Western Sydn,7738,7,8,9,10,38,47,-9,33
Perth Glory,7738,8,10,2,15,37,50,-13,32
Wellington P,7738,9,5,6,16,31,55,-24,21
CC Mariners,7738,10,4,8,15,28,49,-21,20
Sydney FC,7739,1,21,4,3,67,23,44,67
N'castle Jet,7739,2,16,5,7,60,39,21,53
Melbourne C,7739,3,14,4,11,45,36,9,46
Melbourne V,7739,4,13,5,11,46,41,5,44
Adelaide Utd,7739,5,11,6,11,37,40,-3,39
Brisbane,7739,6,10,5,13,33,42,-9,35
Western Sydn,7739,7,8,9,10,38,47,-9,33
Perth Glory,7739,8,10,2,15,37,50,-13,32
Wellington P,7739,9,5,6,16,31,55,-24,21
CC Mariners,7739,10,4,8,15,28,49,-21,20
Sydney FC,7740,1,21,4,3,68,23,45,67
N'castle Jet,7740,2,16,5,7,61,39,22,53
Melbourne C,7740,3,14,4,11,45,37,8,46
Melbourne V,7740,4,13,5,11,46,42,4,44
Adelaide Utd,7740,5,11,6,11,37,40,-3,39
Brisbane,7740,6,10,5,13,33,42,-9,35
Western Sydn,7740,7,8,9,10,38,47,-9,33
Perth Glory,7740,8,10,2,15,37,50,-13,32
Wellington P,7740,9,5,6,16,31,55,-24,21
CC Mariners,7740,10,4,8,15,28,49,-21,20
Sydney FC,7741,1,20,5,3,64,22,42,65
N'castle Jet,7741,2,15,6,7,58,38,20,51
Melbourne C,7741,3,14,5,10,44,34,10,47
Melbourne V,7741,4,13,6,10,45,38,7,45
Adelaide Utd,7741,5,11,6,11,37,40,-3,39
Brisbane,7741,6,10,5,13,33,42,-9,35
Western Sydn,7741,7,8,9,10,38,47,-9,33
Perth Glory,7741,8,10,2,15,37,50,-13,32
Wellington P,7741,9,5,6,16,31,55,-24,21
CC Mariners,7741,10,4,8,15,28,49,-21,20
Sydney FC,7742,1,20,5,3,66,24,42,65
N'castle Jet,7742,2,15,5,8,57,38,19,50
Melbourne C,7742,3,15,4,10,44,33,11,49
Melbourne V,7742,4,13,6,10,47,40,7,45
Adelaide Utd,7742,5,11,6,11,37,40,-3,39
Brisbane,7742,6,10,5,13,33,42,-9,35
Western Sydn,7742,7,8,9,10,38,47,-9,33
Perth Glory,7742,8,10,2,15,37,50,-13,32
Wellington P,7742,9,5,6,16,31,55,-24,21
CC Mariners,7742,10,4,8,15,28,49,-21,20
Sydney FC,7743,1,20,4,4,65,24,41,64
N'castle Jet,7743,2,15,6,7,58,38,20,51
Melbourne C,7743,3,14,5,10,44,34,10,47
Melbourne V,7743,4,14,5,10,47,39,8,47
Adelaide Utd,7743,5,11,6,11,37,40,-3,39
Brisbane,7743,6,10,5,13,33,42,-9,35
Western Sydn,7743,7,8,9,10,38,47,-9,33
Perth Glory,7743,8,10,2,15,37,50,-13,32
Wellington P,7743,9,5,6,16,31,55,-24,21
CC Mariners,7743,10,4,8,15,28,49,-21,20
Sydney FC,7744,1,20,4,4,64,23,41,64
N'castle Jet,7744,2,15,6,7,59,39,20,51
Melbourne C,7744,3,14,5,10,45,35,10,47
Melbourne V,7744,4,14,5,10,46,38,8,47
Adelaide Utd,7744,5,11,6,11,37,40,-3,39
Brisbane,7744,6,10,5,13,33,42,-9,35
Western Sydn,7744,7,8,9,10,38,47,-9,33
Perth Glory,7744,8,10,2,15,37,50,-13,32
Wellington P,7744,9,5,6,16,31,55,-24,21
CC Mariners,7744,10,4,8,15,28,49,-21,20
Sydney FC,7745,1,21,4,3,67,22,45,67
N'castle Jet,7745,2,16,5,7,59,38,21,53
Melbourne C,7745,3,14,4,11,44,35,9,46
Melbourne V,7745,4,13,5,11,45,41,4,44
Adelaide Utd,7745,5,11,6,11,37,40,-3,39
Brisbane,7745,6,10,5,13,33,42,-9,35
Western Sydn,7745,7,8,9,10,38,47,-9,33
Perth Glory,7745,8,10,2,15,37,50,-13,32
Wellington P,7745,9,5,6,16,31,55,-24,21
CC Mariners,7745,10,4,8,15,28,49,-21,20
Sydney FC,7746,1,21,4,3,67,23,44,67
N'castle Jet,7746,2,16,5,7,60,38,22,53
Melbourne C,7746,3,14,4,11,44,36,8,46
Melbourne V,7746,4,13,5,11,46,41,5,44
Adelaide Utd,7746,5,11,6,11,37,40,-3,39
Brisbane,7746,6,10,5,13,33,42,-9,35
Western Sydn,7746,7,8,9,10,38,47,-9,33
Perth Glory,7746,8,10,2,15,37,50,-13,32
Wellington P,7746,9,5,6,16,31,55,-24,21
CC Mariners,7746,10,4,8,15,28,49,-21,20
Sydney FC,7747,1,21,4,3,68,23,45,67
N'castle Jet,7747,2,15,6,7,59,39,20,51
Melbourne C,7747,3,14,5,10,45,35,10,47
Melbourne V,7747,4,13,5,11,46,42,4,44
Adelaide Utd,7747,5,11,6,11,37,40,-3,39
Brisbane,7747,6,10,5,13,33,42,-9,35
Western Sydn,7747,7,8,9,10,38,47,-9,33
Perth Glory,7747,8,10,2,15,37,50,-13,32
Wellington P,7747,9,5,6,16,31,55,-24,21
CC Mariners,7747,10,4,8,15,28,49,-21,20
Sydney FC,7748,1,21,4,3,65,22,43,67
N'castle Jet,7748,2,15,6,7,58,38,20,51
Melbourne C,7748,3,14,5,10,44,34,10,47
Melbourne V,7748,4,13,5,11,45,39,6,44
Adelaide Utd,7748,5,11,6,11,37,40,-3,39
Brisbane,7748,6,10,5,13,33,42,-9,35
Western Sydn,7748,7,8,9,10,38,47,-9,33
Perth Glory,7748,8,10,2,15,37,50,-13,32
Wellington P,7748,9,5,6,16,31,55,-24,21
CC Mariners,7748,10,4,8,15,28,49,-21,20
Sydney FC,7749,1,20,5,3,66,24,42,65
N'castle Jet,7749,2,15,5,8,57,38,19,50
Melbourne C,7749,3,15,4,10,44,33,11,49
Melbourne V,7749,4,13,6,10,47,40,7,45
Adelaide Utd,7749,5,11,6,11,37,40,-3,39
Brisbane,7749,6,10,5,13,33,42,-9,35
Western Sydn,7749,7,8,9,10,38,47,-9,33
Perth Glory,7749,8,10,2,15,37,50,-13,32
Wellington P,7749,9,5,6,16,31,55,-24,21
CC Mariners,7749,10,4,8,15,28,49,-21,20
Sydney FC,7750,1,21,4,3,65,22,43,67
N'castle Jet,7750,2,15,6,7,59,39,20,51
Melbourne C,7750,3,14,5,10,45,35,10,47
Melbourne V,7750,4,13,5,11,45,39,6,44
Adelaide Utd,7750,5,11,6,11,37,40,-3,39
Brisbane,7750,6,10,5,13,33,42,-9,35
Western Sydn,7750,7,8,9,10,38,47,-9,33
Perth Glory,7750,8,10,2,15,37,50,-13,32
Wellington P,7750,9,5,6,16,31,55,-24,21
CC Mariners,7750,10,4,8,15,28,49,-21,20
Sydney FC,7751,1,21,4,3,67,22,45,67
N'castle Jet,7751,2,16,5,7,59,37,22,53
Melbourne C,7751,3,14,4,11,43,35,8,46
Melbourne V,7751,4,13,5,11,45,41,4,44
Adelaide Utd,7751,5,11,6,11,37,40,-3,39
Brisbane,7751,6,10,5,13,33,42,-9,35
Western Sydn,7751,7,8,9,10,38,47,-9,33
Perth Glory,7751,8,10,2,15,37,50,-13,32
Wellington P,7751,9,5,6,16,31,55,-24,21
CC Mariners,7751,10,4,8,15,28,49,-21,20
Sydney FC,7752,1,21,4,3,70,23,47,67
N'castle Jet,7752,2,15,6,7,57,37,20,51
Melbourne C,7752,3,14,5,10,43,33,10,47
Melbourne V,7752,4,13,5,11,46,44,2,44
Adelaide Utd,7752,5,11,6,11,37,40,-3,39
Brisbane,7752,6,10,5,13,33,42,-9,35
Western Sydn,7752,7,8,9,10,38,47,-9,33
Perth Glory,7752,8,10,2,15,37,50,-13,32
Wellington P,7752,9,5,6,16,31,55,-24,21
CC Mariners,7752,10,4,8,15,28,49,-21,20
Sydney FC,7753,1,21,4,3,69,22,47,67
N'castle Jet,7753,2,15,6,7,58,38,20,51
Melbourne C,7753,3,14,5,10,44,34,10,47
Melbourne V,7753,4,13,5,11,45,43,2,44
Adelaide Utd,7753,5,11,6,11,37,40,-3,39
Brisbane,7753,6,10,5,13,33,42,-9,35
Western Sydn,7753,7,8,9,10,38,47,-9,33
Perth Glory,7753,8,10,2,15,37,50,-13,32
Wellington P,7753,9,5,6,16,31,55,-24,21
CC Mariners,7753,10,4,8,15,28,49,-21,20
Sydney FC,7754,1,21,4,3,66,23,43,67
N'castle Jet,7754,2,15,6,7,59,39,20,51
Melbourne C,7754,3,14,5,10,45,35,10,47
Melbourne V,7754,4,13,5,11,46,40,6,44
Adelaide Utd,7754,5,11,6,11,37,40,-3,39
Brisbane,7754,6,10,5,13,33,42,-9,35
Western Sydn,7754,7,8,9,10,38,47,-9,33
Perth Glory,7754,8,10,2,15,37,50,-13,32
Wellington P,7754,9,5,6,16,31,55,-24,21
CC Mariners,7754,10,4,8,15,28,49,-21,20
Sydney FC,7755,1,20,5,3,65,23,42,65
N'castle Jet,7755,2,16,5,7,59,38,21,53
Melbourne C,7755,3,14,4,11,44,35,9,46
Melbourne V,7755,4,13,6,10,46,39,7,45
Adelaide Utd,7755,5,11,6,11,37,40,-3,39
Brisbane,7755,6,10,5,13,33,42,-9,35
Western Sydn,7755,7,8,9,10,38,47,-9,33
Perth Glory,7755,8,10,2,15,37,50,-13,32
Wellington P,7755,9,5,6,16,31,55,-24,21
CC Mariners,7755,10,4,8,15,28,49,-21,20
Sydney FC,7756,1,20,4,4,65,25,40,64
N'castle Jet,7756,2,16,5,7,61,39,22,53
Melbourne V,7756,3,14,5,10,48,39,9,47
Melbourne C,7756,4,14,4,11,45,37,8,46
Adelaide Utd,7756,5,11,6,11,37,40,-3,39
Brisbane,7756,6,10,5,13,33,42,-9,35
Western Sydn,7756,7,8,9,10,38,47,-9,33
Perth Glory,7756,8,10,2,15,37,50,-13,32
Wellington P,7756,9,5,6,16,31,55,-24,21
CC Mariners,7756,10,4,8,15,28,49,-21,20
Sydney FC,7757,1,21,4,3,65,22,43,67
N'castle Jet,7757,2,16,5,7,61,38,23,53
Melbourne C,7757,3,14,4,11,44,37,7,46
Melbourne V,7757,4,13,5,11,45,39,6,44
Adelaide Utd,7757,5,11,6,11,37,40,-3,39
Brisbane,7757,6,10,5,13,33,42,-9,35
Western Sydn,7757,7,8,9,10,38,47,-9,33
Perth Glory,7757,8,10,2,15,37,50,-13,32
Wellington P,7757,9,5,6,16,31,55,-24,21
CC Mariners,7757,10,4,8,15,28,49,-21,20
Sydney FC,7758,1,20,5,3,64,22,42,65
N'castle Jet,7758,2,15,5,8,59,40,19,50
Melbourne C,7758,3,15,4,10,46,35,11,49
Melbourne V,7758,4,13,6,10,45,38,7,45
Adelaide Utd,7758,5,11,6,11,37,40,-3,39
Brisbane,7758,6,10,5,13,33,42,-9,35
Western Sydn,7758,7,8,9,10,38,47,-9,33
Perth Glory,7758,8,10,2,15,37,50,-13,32
Wellington P,7758,9,5,6,16,31,55,-24,21
CC Mariners,7758,10,4,8,15,28,49,-21,20
Sydney FC,7759,1,21,4,3,69,22,47,67
N'castle Jet,7759,2,16,5,7,59,37,22,53
Melbourne C,7759,3,14,4,11,43,35,8,46
Melbourne V,7759,4,13,5,11,45,43,2,44
Adelaide Utd,7759,5,11,6,11,37,40,-3,39
Brisbane,7759,6,10,5,13,33,42,-9,35
Western Sydn,7759,7,8,9,10,38,47,-9,33
Perth Glory,7759,8,10,2,15,37,50,-13,32
Wellington P,7759,9,5,6,16,31,55,-24,21
CC Mariners,7759,10,4,8,15,28,49,-21,20
Sydney FC,7760,1,21,4,3,65,22,43,67
N'castle Jet,7760,2,16,5,7,63,37,26,53
Melbourne C,7760,3,14,4,11,43,39,4,46
Melbourne V,7760,4,13,5,11,45,39,6,44
Adelaide Utd,7760,5,11,6,11,37,40,-3,39
Brisbane,7760,6,10,5,13,33,42,-9,35
Western Sydn,7760,7,8,9,10,38,47,-9,33
Perth Glory,7760,8,10,2,15,37,50,-13,32
Wellington P,7760,9,5,6,16,31,55,-24,21
CC Mariners,7760,10,4,8,15,28,49,-21,20
Sydney FC,7761,1,21,4,3,67,23,44,67
N'castle Jet,7761,2,16,5,7,59,38,21,53
Melbourne C,7761,3,14,4,11,44,35,9,46
Melbourne V,7761,4,13,5,11,46,41,5,44
Adelaide Utd,7761,5,11,6,11,37,40,-3,39
Brisbane,7761,6,10,5,13,33,42,-9,35
Western Sydn,7761,7,8,9,10,38,47,-9,33
Perth Glory,7761,8,10,2,15,37,50,-13,32
Wellington P,7761,9,5,6,16,31,55,-24,21
CC Mariners,7761,10,4,8,15,28,49,-21,20
Sydney FC,7762,1,21,4,3,66,23,43,67
N'castle Jet,7762,2,15,6,7,59,39,20,51
Melbourne C,7762,3,14,5,10,45,35,10,47
Melbourne V,7762,4,13,5,11,46,40,6,44
Adelaide Utd,7762,5,11,6,11,37,40,-3,39
Brisbane,7762,6,10,5,13,33,42,-9,35
Western Sydn,7762,7,8,9,10,38,47,-9,33
Perth Glory,7762,8,10,2,15,37,50,-13,32
Wellington P,7762,9,5,6,16,31,55,-24,21
CC Mariners,7762,10,4,8,15,28,49,-21,20
Sydney FC,7763,1,21,4,3,67,22,45,67
N'castle Jet,7763,2,16,5,7,60,37,23,53
Melbourne C,7763,3,14,4,11,43,36,7,46
Melbourne V,7763,4,13,5,11,45,41,4,44
Adelaide Utd,7763,5,11,6,11,37,40,-3,39
Brisbane,7763,6,10,5,13,33,42,-9,35
Western Sydn,7763,7,8,9,10,38,47,-9,33
Perth Glory,7763,8,10,2,15,37,50,-13,32
Wellington P,7763,9,5,6,16,31,55,-24,21
CC Mariners,7763,10,4,8,15,28,49,-21,20
Sydney FC,7764,1,21,4,3,67,23,44,67
N'castle Jet,7764,2,15,5,8,57,40,17,50
Melbourne C,7764,3,15,4,10,46,33,13,49
Melbourne V,7764,4,13,5,11,46,41,5,44
Adelaide Utd,7764,5,11,6,11,37,40,-3,39
Brisbane,7764,6,10,5,13,33,42,-9,35
Western Sydn,7764,7,8,9,10,38,47,-9,33
Perth Glory,7764,8,10,2,15,37,50,-13,32
Wellington P,7764,9,5,6,16,31,55,-24,21
CC Mariners,7764,10,4,8,15,28,49,-21,20
Sydney FC,7765,1,20,4,4,64,23,41,64
N'castle Jet,7765,2,15,5,8,58,39,19,50
Melbourne C,7765,3,15,4,10,45,34,11,49
Melbourne V,7765,4,14,5,10,46,38,8,47
Adelaide Utd,7765,5,11,6,11,37,40,-3,39
Brisbane,7765,6,10,5,13,33,42,-9,35
Western Sydn,7765,7,8,9,10,38,47,-9,33
Perth Glory,7765,8,10,2,15,37,50,-13,32
Wellington P,7765,9,5,6,16,31,55,-24,21
CC Mariners,7765,10,4,8,15,28,49,-21,20
Sydney FC,7766,1,21,4,3,68,22,46,67
N'castle Jet,7766,2,16,5,7,61,37,24,53
Melbourne C,7766,3,14,4,11,43,37,6,46
Melbourne V,7766,4,13,5,11,45,42,3,44
Adelaide Utd,7766,5,11,6,11,37,40,-3,39
Brisbane,7766,6,10,5,13,33,42,-9,35
Western Sydn,7766,7,8,9,10,38,47,-9,33
Perth Glory,7766,8,10,2,15,37,50,-13,32
Wellington P,7766,9,5,6,16,31,55,-24,21
CC Mariners,7766,10,4,8,15,28,49,-21,20
Sydney FC,7767,1,20,4,4,65,24,41,64
N'castle Jet,7767,2,16,5,7,59,38,21,53
Melbourne V,7767,3,14,5,10,47,39,8,47
Melbourne C,7767,4,14,4,11,44,35,9,46
Adelaide Utd,7767,5,11,6,11,37,40,-3,39
Brisbane,7767,6,10,5,13,33,42,-9,35
Western Sydn,7767,7,8,9,10,38,47,-9,33
Perth Glory,7767,8,10,2,15,37,50,-13,32
Wellington P,7767,9,5,6,16,31,55,-24,21
CC Mariners,7767,10,4,8,15,28,49,-21,20
Sydney FC,7768,1,20,5,3,65,23,42,65
N'castle Jet,7768,2,16,5,7,59,38,21,53
Melbourne C,7768,3,14,4,11,44,35,9,46
Melbourne V,7768,4,13,6,10,46,39,7,45
Adelaide Utd,7768,5,11,6,11,37,40,-3,39
Brisbane,7768,6,10,5,13,33,42,-9,35
Western Sydn,7768,7,8,9,10,38,47,-9,33
Perth Glory,7768,8,10,2,15,37,50,-13,32
Wellington P,7768,9,5,6,16,31,55,-24,21
CC Mariners,7768,10,4,8,15,28,49,-21,20
Sydney FC,7769,1,21,4,3,67,24,43,67
N'castle Jet,7769,2,16,5,7,59,37,22,53
Melbourne C,7769,3,14,4,11,43,35,8,46
Melbourne V,7769,4,13,5,11,47,41,6,44
Adelaide Utd,7769,5,11,6,11,37,40,-3,39
Brisbane,7769,6,10,5,13,33,42,-9,35
Western Sydn,7769,7,8,9,10,38,47,-9,33
Perth Glory,7769,8,10,2,15,37,50,-13,32
Wellington P,7769,9,5,6,16,31,55,-24,21
CC Mariners,7769,10,4,8,15,28,49,-21,20
Sydney FC,7770,1,21,4,3,65,22,43,67
N'castle Jet,7770,2,16,5,7,58,37,21,53
Melbourne C,7770,3,14,4,11,43,34,9,46
Melbourne V,7770,4,13,5,11,45,39,6,44
Adelaide Utd,7770,5,11,6,11,37,40,-3,39
Brisbane,7770,6,10,5,13,33,42,-9,35
Western Sydn,7770,7,8,9,10,38,47,-9,33
Perth Glory,7770,8,10,2,15,37,50,-13,32
Wellington P,7770,9,5,6,16,31,55,-24,21
CC Mariners,7770,10,4,8,15,28,49,-21,20
Sydney FC,7771,1,21,4,3,68,22,46,67
N'castle Jet,7771,2,16,5,7,61,38,23,53
Melbourne C,7771,3,14,4,11,44,37,7,46
Melbourne V,7771,4,13,5,11,45,42,3,44
Adelaide Utd,7771,5,11,6,11,37,40,-3,39
Brisbane,7771,6,10,5,13,33,42,-9,35
Western Sydn,7771,7,8,9,10,38,47,-9,33
Perth Glory,7771,8,10,2,15,37,50,-13,32
Wellington P,7771,9,5,6,16,31,55,-24,21
CC Mariners,7771,10,4,8,15,28,49,-21,20
Sydney FC,7772,1,20,5,3,64,22,42,65
N'castle Jet,7772,2,15,5,8,59,42,17,50
Melbourne C,7772,3,15,4,10,48,35,13,49
Melbourne V,7772,4,13,6,10,45,38,7,45
Adelaide Utd,7772,5,11,6,11,37,40,-3,39
Brisbane,7772,6,10,5,13,33,42,-9,35
Western Sydn,7772,7,8,9,10,38,47,-9,33
Perth Glory,7772,8,10,2,15,37,50,-13,32
Wellington P,7772,9,5,6,16,31,55,-24,21
CC Mariners,7772,10,4,8,15,28,49,-21,20
Sydney FC,7773,1,21,4,3,68,25,43,67
N'castle Jet,7773,2,16,5,7,59,37,22,53
Melbourne C,7773,3,14,4,11,43,35,8,46
Melbourne V,7773,4,13,5,11,48,42,6,44
Adelaide Utd,7773,5,11,6,11,37,40,-3,39
Brisbane,7773,6,10,5,13,33,42,-9,35
Western Sydn,7773,7,8,9,10,38,47,-9,33
Perth Glory,7773,8,10,2,15,37,50,-13,32
Wellington P,7773,9,5,6,16,31,55,-24,21
CC Mariners,7773,10,4,8,15,28,49,-21,20
Sydney FC,7774,1,21,4,3,66,23,43,67
N'castle Jet,7774,2,16,5,7,60,38,22,53
Melbourne C,7774,3,14,4,11,44,36,8,46
Melbourne V,7774,4,13,5,11,46,40,6,44
Adelaide Utd,7774,5,11,6,11,37,40,-3,39
Brisbane,7774,6,10,5,13,33,42,-9,35
Western Sydn,7774,7,8,9,10,38,47,-9,33
Perth Glory,7774,8,10,2,15,37,50,-13,32
Wellington P,7774,9,5,6,16,31,55,-24,21
CC Mariners,7774,10,4,8,15,28,49,-21,20
Sydney FC,7775,1,21,4,3,65,22,43,67
N'castle Jet,7775,2,15,5,8,57,38,19,50
Melbourne C,7775,3,15,4,10,44,33,11,49
Melbourne V,7775,4,13,5,11,45,39,6,44
Adelaide Utd,7775,5,11,6,11,37,40,-3,39
Brisbane,7775,6,10,5,13,33,42,-9,35
Western Sydn,7775,7,8,9,10,38,47,-9,33
Perth Glory,7775,8,10,2,15,37,50,-13,32
Wellington P,7775,9,5,6,16,31,55,-24,21
CC Mariners,7775,10,4,8,15,28,49,-21,20
Sydney FC,7776,1,21,4,3,69,23,46,67
N'castle Jet,7776,2,16,5,7,60,39,21,53
Melbourne C,7776,3,14,4,11,45,36,9,46
Melbourne V,7776,4,13,5,11,46,43,3,44
Adelaide Utd,7776,5,11,6,11,37,40,-3,39
Brisbane,7776,6,10,5,13,33,42,-9,35
Western Sydn,7776,7,8,9,10,38,47,-9,33
Perth Glory,7776,8,10,2,15,37,50,-13,32
Wellington P,7776,9,5,6,16,31,55,-24,21
CC Mariners,7776,10,4,8,15,28,49,-21,20
Sydney FC,7777,1,21,4,3,67,22,45,67
N'castle Jet,7777,2,15,5,8,57,38,19,50
Melbourne C,7777,3,15,4,10,44,33,11,49
Melbourne V,7777,4,13,5,11,45,41,4,44
Adelaide Utd,7777,5,11,6,11,37,40,-3,39
Brisbane,7777,6,10,5,13,33,42,-9,35
Western Sydn,7777,7,8,9,10,38,47,-9,33
Perth Glory,7777,8,10,2,15,37,50,-13,32
Wellington P,7777,9,5,6,16,31,55,-24,21
CC Mariners,7777,10,4,8,15,28,49,-21,20
Sydney FC,7778,1,21,4,3,66,22,44,67
N'castle Jet,7778,2,16,5,7,59,38,21,53
Melbourne C,7778,3,14,4,11,44,35,9,46
Melbourne V,7778,4,13,5,11,45,40,5,44
Adelaide Utd,7778,5,11,6,11,37,40,-3,39
Brisbane,7778,6,10,5,13,33,42,-9,35
Western Sydn,7778,7,8,9,10,38,47,-9,33
Perth Glory,7778,8,10,2,15,37,50,-13,32
Wellington P,7778,9,5,6,16,31,55,-24,21
CC Mariners,7778,10,4,8,15,28,49,-21,20
Sydney FC,7779,1,20,5,3,65,23,42,65
N'castle Jet,7779,2,15,6,7,58,38,20,51
Melbourne C,7779,3,14,5,10,44,34,10,47
Melbourne V,7779,4,13,6,10,46,39,7,45
Adelaide Utd,7779,5,11,6,11,37,40,-3,39
Brisbane,7779,6,10,5,13,33,42,-9,35
Western Sydn,7779,7,8,9,10,38,47,-9,33
Perth Glory,7779,8,10,2,15,37,50,-13,32
Wellington P,7779,9,5,6,16,31,55,-24,21
CC Mariners,7779,10,4,8,15,28,49,-21,20
Sydney FC,7780,1,21,4,3,67,23,44,67
N'castle Jet,7780,2,16,5,7,60,38,22,53
Melbourne C,7780,3,14,4,11,44,36,8,46
Melbourne V,7780,4,13,5,11,46,41,5,44
Adelaide Utd,7780,5,11,6,11,37,40,-3,39
Brisbane,7780,6,10,5,13,33,42,-9,35
Western Sydn,7780,7,8,9,10,38,47,-9,33
Perth Glory,7780,8,10,2,15,37,50,-13,32
Wellington P,7780,9,5,6,16,31,55,-24,21
CC Mariners,7780,10,4,8,15,28,49,-21,20
Sydney FC,7781,1,21,4,3,68,22,46,67
N'castle Jet,7781,2,16,5,7,59,37,22,53
Melbourne C,7781,3,14,4,11,43,35,8,46
Melbourne V,7781,4,13,5,11,45,42,3,44
Adelaide Utd,7781,5,11,6,11,37,40,-3,39
Brisbane,7781,6,10,5,13,33,42,-9,35
Western Sydn,7781,7,8,9,10,38,47,-9,33
Perth Glory,7781,8,10,2,15,37,50,-13,32
Wellington P,7781,9,5,6,16,31,55,-24,21
CC Mariners,7781,10,4,8,15,28,49,-21,20
Sydney FC,7782,1,21,4,3,65,22,43,67
N'castle Jet,7782,2,15,6,7,61,41,20,51
Melbourne C,7782,3,14,5,10,47,37,10,47
Melbourne V,7782,4,13,5,11,45,39,6,44
Adelaide Utd,7782,5,11,6,11,37,40,-3,39
Brisbane,7782,6,10,5,13,33,42,-9,35
Western Sydn,7782,7,8,9,10,38,47,-9,33
Perth Glory,7782,8,10,2,15,37,50,-13,32
Wellington P,7782,9,5,6,16,31,55,-24,21
CC Mariners,7782,10,4,8,15,28,49,-21,20
Sydney FC,7783,1,21,4,3,66,22,44,67
N'castle Jet,7783,2,15,5,8,59,40,19,50
Melbourne C,7783,3,15,4,10,46,35,11,49
Melbourne V,7783,4,13,5,11,45,40,5,44
Adelaide Utd,7783,5,11,6,11,37,40,-3,39
Brisbane,7783,6,10,5,13,33,42,-9,35
Western Sydn,7783,7,8,9,10,38,47,-9,33
Perth Glory,7783,8,10,2,15,37,50,-13,32
Wellington P,7783,9,5,6,16,31,55,-24,21
CC Mariners,7783,10,4,8,15,28,49,-21,20
Sydney FC,7784,1,20,4,4,65,25,40,64
N'castle Jet,7784,2,16,5,7,61,38,23,53
Melbourne V,7784,3,14,5,10,48,39,9,47
Melbourne C,7784,4,14,4,11,44,37,7,46
Adelaide Utd,7784,5,11,6,11,37,40,-3,39
Brisbane,7784,6,10,5,13,33,42,-9,35
Western Sydn,7784,7,8,9,10,38,47,-9,33
Perth Glory,7784,8,10,2,15,37,50,-13,32
Wellington P,7784,9,5,6,16,31,55,-24,21
CC Mariners,7784,10,4,8,15,28,49,-21,20
Sydney FC,7785,1,20,5,3,64,22,42,65
N'castle Jet,7785,2,16,5,7,59,37,22,53
Melbourne C,7785,3,14,4,11,43,35,8,46
Melbourne V,7785,4,13,6,10,45,38,7,45
Adelaide Utd,7785,5,11,6,11,37,40,-3,39
Brisbane,7785,6,10,5,13,33,42,-9,35
Western Sydn,7785,7,8,9,10,38,47,-9,33
Perth Glory,7785,8,10,2,15,37,50,-13,32
Wellington P,7785,9,5,6,16,31,55,-24,21
CC Mariners,7785,10,4,8,15,28,49,-21,20
Sydney FC,7786,1,21,4,3,69,22,47,67
N'castle Jet,7786,2,16,5,7,60,39,21,53
Melbourne C,7786,3,14,4,11,45,36,9,46
Melbourne V,7786,4,13,5,11,45,43,2,44
Adelaide Utd,7786,5,11,6,11,37,40,-3,39
Brisbane,7786,6,10,5,13,33,42,-9,35
Western Sydn,7786,7,8,9,10,38,47,-9,33
Perth Glory,7786,8,10,2,15,37,50,-13,32
Wellington P,7786,9,5,6,16,31,55,-24,21
CC Mariners,7786,10,4,8,15,28,49,-21,20
Sydney FC,7787,1,21,4,3,67,23,44,67
N'castle Jet,7787,2,15,6,7,59,39,20,51
Melbourne C,7787,3,14,5,10,45,35,10,47
Melbourne V,7787,4,13,5,11,46,41,5,44
Adelaide Utd,7787,5,11,6,11,37,40,-3,39
Brisbane,7787,6,10,5,13,33,42,-9,35
Western Sydn,7787,7,8,9,10,38,47,-9,33
Perth Glory,7787,8,10,2,15,37,50,-13,32
Wellington P,7787,9,5,6,16,31,55,-24,21
CC Mariners,7787,10,4,8,15,28,49,-21,20
Sydney FC,7788,1,20,5,3,64,22,42,65
N'castle Jet,7788,2,15,6,7,58,38,20,51
Melbourne C,7788,3,14,5,10,44,34,10,47
Melbourne V,7788,4,13,6,10,45,38,7,45
Adelaide Utd,7788,5,11,6,11,37,40,-3,39
Brisbane,7788,6,10,5,13,33,42,-9,35
Western Sydn,7788,7,8,9,10,38,47,-9,33
Perth Glory,7788,8,10,2,15,37,50,-13,32
Wellington P,7788,9,5,6,16,31,55,-24,21
CC Mariners,7788,10,4,8,15,28,49,-21,20
Sydney FC,7789,1,20,5,3,65,23,42,65
N'castle Jet,7789,2,16,5,7,60,37,23,53
Melbourne C,7789,3,14,4,11,43,36,7,46
Melbourne V,7789,4,13,6,10,46,39,7,45
Adelaide Utd,7789,5,11,6,11,37,40,-3,39
Brisbane,7789,6,10,5,13,33,42,-9,35
Western Sydn,7789,7,8,9,10,38,47,-9,33
Perth Glory,7789,8,10,2,15,37,50,-13,32
Wellington P,7789,9,5,6,16,31,55,-24,21
CC Mariners,7789,10,4,8,15,28,49,-21,20
Sydney FC,7790,1,21,4,3,67,23,44,67
N'castle Jet,7790,2,15,6,7,59,39,20,51
Melbourne C,7790,3,14,5,10,45,35,10,47
Melbourne V,7790,4,13,5,11,46,41,5,44
Adelaide Utd,7790,5,11,6,11,37,40,-3,39
Brisbane,7790,6,10,5,13,33,42,-9,35
Western Sydn,7790,7,8,9,10,38,47,-9,33
Perth Glory,7790,8,10,2,15,37,50,-13,32
Wellington P,7790,9,5,6,16,31,55,-24,21
CC Mariners,7790,10,4,8,15,28,49,-21,20
Sydney FC,7791,1,21,4,3,66,22,44,67
N'castle Jet,7791,2,15,5,8,58,39,19,50
Melbourne C,7791,3,15,4,10,45,34,11,49
Melbourne V,7791,4,13,5,11,45,40,5,44
Adelaide Utd,7791,5,11,6,11,37,40,-3,39
Brisbane,7791,6,10,5,13,33,42,-9,35
Western Sydn,7791,7,8,9,10,38,47,-9,33
Perth Glory,7791,8,10,2,15,37,50,-13,32
Wellington P,7791,9,5,6,16,31,55,-24,21
CC Mariners,7791,10,4,8,15,28,49,-21,20
Sydney FC,7792,1,20,5,3,66,24,42,65
N'castle Jet,7792,2,16,5,7,59,38,21,53
Melbourne C,7792,3,14,4,11,44,35,9,46
Melbourne V,7792,4,13,6,10,47,40,7,45
Adelaide Utd,7792,5,11,6,11,37,40,-3,39
Brisbane,7792,6,10,5,13,33,42,-9,35
Western Sydn,7792,7,8,9,10,38,47,-9,33
Perth Glory,7792,8,10,2,15,37,50,-13,32
Wellington P,7792,9,5,6,16,31,55,-24,21
CC Mariners,7792,10,4,8,15,28,49,-21,20
Sydney FC,7793,1,21,4,3,68,23,45,67
N'castle Jet,7793,2,16,5,7,59,37,22,53
Melbourne C,7793,3,14,4,11,43,35,8,46
Melbourne V,7793,4,13,5,11,46,42,4,44
Adelaide Utd,7793,5,11,6,11,37,40,-3,39
Brisbane,7793,6,10,5,13,33,42,-9,35
Western Sydn,7793,7,8,9,10,38,47,-9,33
Perth Glory,7793,8,10,2,15,37,50,-13,32
Wellington P,7793,9,5,6,16,31,55,-24,21
CC Mariners,7793,10,4,8,15,28,49,-21,20
Sydney FC,7794,1,21,4,3,65,22,43,67
N'castle Jet,7794,2,16,5,7,58,37,21,53
Melbourne C,7794,3,14,4,11,43,34,9,46
Melbourne V,7794,4,13,5,11,45,39,6,44
Adelaide Utd,7794,5,11,6,11,37,40,-3,39
Brisbane,7794,6,10,5,13,33,42,-9,35
Western Sydn,7794,7,8,9,10,38,47,-9,33
Perth Glory,7794,8,10,2,15,37,50,-13,32
Wellington P,7794,9,5,6,16,31,55,-24,21
CC Mariners,7794,10,4,8,15,28,49,-21,20
Sydney FC,7795,1,20,4,4,65,24,41,64
N'castle Jet,7795,2,15,5,8,57,38,19,50
Melbourne C,7795,3,15,4,10,44,33,11,49
Melbourne V,7795,4,14,5,10,47,39,8,47
Adelaide Utd,7795,5,11,6,11,37,40,-3,39
Brisbane,7795,6,10,5,13,33,42,-9,35
Western Sydn,7795,7,8,9,10,38,47,-9,33
Perth Glory,7795,8,10,2,15,37,50,-13,32
Wellington P,7795,9,5,6,16,31,55,-24,21
CC Mariners,7795,10,4,8,15,28,49,-21,20
Sydney FC,7796,1,21,4,3,66,22,44,67
N'castle Jet,7796,2,16,5,7,59,38,21,53
Melbourne C,7796,3,14,4,11,44,35,9,46
Melbourne V,7796,4,13,5,11,45,40,5,44
Adelaide Utd,7796,5,11,6,11,37,40,-3,39
Brisbane,7796,6,10,5,13,33,42,-9,35
Western Sydn,7796,7,8,9,10,38,47,-9,33
Perth Glory,7796,8,10,2,15,37,50,-13,32
Wellington P,7796,9,5,6,16,31,55,-24,21
CC Mariners,7796,10,4,8,15,28,49,-21,20
Sydney FC,7797,1,20,4,4,64,23,41,64
N'castle Jet,7797,2,15,5,8,58,40,18,50
Melbourne C,7797,3,15,4,10,46,34,12,49
Melbourne V,7797,4,14,5,10,46,38,8,47
Adelaide Utd,7797,5,11,6,11,37,40,-3,39
Brisbane,7797,6,10,5,13,33,42,-9,35
Western Sydn,7797,7,8,9,10,38,47,-9,33
Perth Glory,7797,8,10,2,15,37,50,-13,32
Wellington P,7797,9,5,6,16,31,55,-24,21
CC Mariners,7797,10,4,8,15,28,49,-21,20
Sydney FC,7798,1,21,4,3,68,23,45,67
N'castle Jet,7798,2,16,5,7,59,37,22,53
Melbourne C,7798,3,14,4,11,43,35,8,46
Melbourne V,7798,4,13,5,11,46,42,4,44
Adelaide Utd,7798,5,11,6,11,37,40,-3,39
Brisbane,7798,6,10,5,13,33,42,-9,35
Western Sydn,7798,7,8,9,10,38,47,-9,33
Perth Glory,7798,8,10,2,15,37,50,-13,32
Wellington P,7798,9,5,6,16,31,55,-24,21
CC Mariners,7798,10,4,8,15,28,49,-21,20
Sydney FC,7799,1,20,5,3,65,23,42,65
N'castle Jet,7799,2,16,5,7,59,38,21,53
Melbourne C,7799,3,14,4,11,44,35,9,46
Melbourne V,7799,4,13,6,10,46,39,7,45
Adelaide Utd,7799,5,11,6,11,37,40,-3,39
Brisbane,7799,6,10,5,13,33,42,-9,35
Western Sydn,7799,7,8,9,10,38,47,-9,33
Perth Glory,7799,8,10,2,15,37,50,-13,32
Wellington P,7799,9,5,6,16,31,55,-24,21
CC Mariners,7799,10,4,8,15,28,49,-21,20
Sydney FC,7800,1,21,4,3,68,24,44,67
N'castle Jet,7800,2,16,5,7,61,39,22,53
Melbourne C,7800,3,14,4,11,45,37,8,46
Melbourne V,7800,4,13,5,11,47,42,5,44
Adelaide Utd,7800,5,11,6,11,37,40,-3,39
Brisbane,7800,6,10,5,13,33,42,-9,35
Western Sydn,7800,7,8,9,10,38,47,-9,33
Perth Glory,7800,8,10,2,15,37,50,-13,32
Wellington P,7800,9,5,6,16,31,55,-24,21
CC Mariners,7800,10,4,8,15,28,49,-21,20
Sydney FC,7801,1,21,4,3,66,23,43,67
N'castle Jet,7801,2,16,5,7,59,37,22,53
Melbourne C,7801,3,14,4,11,43,35,8,46
Melbourne V,7801,4,13,5,11,46,40,6,44
Adelaide Utd,7801,5,11,6,11,37,40,-3,39
Brisbane,7801,6,10,5,13,33,42,-9,35
Western Sydn,7801,7,8,9,10,38,47,-9,33
Perth Glory,7801,8,10,2,15,37,50,-13,32
Wellington P,7801,9,5,6,16,31,55,-24,21
CC Mariners,7801,10,4,8,15,28,49,-21,20
Sydney FC,7802,1,21,4,3,65,22,43,67
N'castle Jet,7802,2,15,6,7,58,38,20,51
Melbourne C,7802,3,14,5,10,44,34,10,47
Melbourne V,7802,4,13,5,11,45,39,6,44
Adelaide Utd,7802,5,11,6,11,37,40,-3,39
Brisbane,7802,6,10,5,13,33,42,-9,35
Western Sydn,7802,7,8,9,10,38,47,-9,33
Perth Glory,7802,8,10,2,15,37,50,-13,32
Wellington P,7802,9,5,6,16,31,55,-24,21
CC Mariners,7802,10,4,8,15,28,49,-21,20
Sydney FC,7803,1,21,4,3,67,23,44,67
N'castle Jet,7803,2,15,6,7,58,38,20,51
Melbourne C,7803,3,14,5,10,44,34,10,47
Melbourne V,7803,4,13,5,11,46,41,5,44
Adelaide Utd,7803,5,11,6,11,37,40,-3,39
Brisbane,7803,6,10,5,13,33,42,-9,35
Western Sydn,7803,7,8,9,10,38,47,-9,33
Perth Glory,7803,8,10,2,15,37,50,-13,32
Wellington P,7803,9,5,6,16,31,55,-24,21
CC Mariners,7803,10,4,8,15,28,49,-21,20
Sydney FC,7804,1,20,4,4,66,25,41,64
N'castle Jet,7804,2,15,6,7,57,37,20,51
Melbourne C,7804,3,14,5,10,43,33,10,47
Melbourne V,7804,4,14,5,10,48,40,8,47
Adelaide Utd,7804,5,11,6,11,37,40,-3,39
Brisbane,7804,6,10,5,13,33,42,-9,35
Western Sydn,7804,7,8,9,10,38,47,-9,33
Perth Glory,7804,8,10,2,15,37,50,-13,32
Wellington P,7804,9,5,6,16,31,55,-24,21
CC Mariners,7804,10,4,8,15,28,49,-21,20
Sydney FC,7805,1,21,4,3,68,24,44,67
N'castle Jet,7805,2,16,5,7,59,38,21,53
Melbourne C,7805,3,14,4,11,44,35,9,46
Melbourne V,7805,4,13,5,11,47,42,5,44
Adelaide Utd,7805,5,11,6,11,37,40,-3,39
Brisbane,7805,6,10,5,13,33,42,-9,35
Western Sydn,7805,7,8,9,10,38,47,-9,33
Perth Glory,7805,8,10,2,15,37,50,-13,32
Wellington P,7805,9,5,6,16,31,55,-24,21
CC Mariners,7805,10,4,8,15,28,49,-21,20
Sydney FC,7806,1,20,4,4,65,24,41,64
N'castle Jet,7806,2,15,6,7,58,38,20,51
Melbourne C,7806,3,14,5,10,44,34,10,47
Melbourne V,7806,4,14,5,10,47,39,8,47
Adelaide Utd,7806,5,11,6,11,37,40,-3,39
Brisbane,7806,6,10,5,13,33,42,-9,35
Western Sydn,7806,7,8,9,10,38,47,-9,33
Perth Glory,7806,8,10,2,15,37,50,-13,32
Wellington P,7806,9,5,6,16,31,55,-24,21
CC Mariners,7806,10,4,8,15,28,49,-21,20
Sydney FC,7807,1,20,5,3,66,24,42,65
N'castle Jet,7807,2,15,5,8,58,39,19,50
Melbourne C,7807,3,15,4,10,45,34,11,49
Melbourne V,7807,4,13,6,10,47,40,7,45
Adelaide Utd,7807,5,11,6,11,37,40,-3,39
Brisbane,7807,6,10,5,13,33,42,-9,35
Western Sydn,7807,7,8,9,10,38,47,-9,33
Perth Glory,7807,8,10,2,15,37,50,-13,32
Wellington P,7807,9,5,6,16,31,55,-24,21
CC Mariners,7807,10,4,8,15,28,49,-21,20
Sydney FC,7808,1,21,4,3,69,25,44,67
N'castle Jet,7808,2,15,5,8,57,39,18,50
Melbourne C,7808,3,15,4,10,45,33,12,49
Melbourne V,7808,4,13,5,11,48,43,5,44
Adelaide Utd,7808,5,11,6,11,37,40,-3,39
Brisbane,7808,6,10,5,13,33,42,-9,35
Western Sydn,7808,7,8,9,10,38,47,-9,33
Perth Glory,7808,8,10,2,15,37,50,-13,32
Wellington P,7808,9,5,6,16,31,55,-24,21
CC Mariners,7808,10,4,8,15,28,49,-21,20
Sydney FC,7809,1,21,4,3,67,22,45,67
N'castle Jet,7809,2,15,6,7,58,38,20,51
Melbourne C,7809,3,14,5,10,44,34,10,47
Melbourne V,7809,4,13,5,11,45,41,4,44
Adelaide Utd,7809,5,11,6,11,37,40,-3,39
Brisbane,7809,6,10,5,13,33,42,-9,35
Western Sydn,7809,7,8,9,10,38,47,-9,33
Perth Glory,7809,8,10,2,15,37,50,-13,32
Wellington P,7809,9,5,6,16,31,55,-24,21
CC Mariners,7809,10,4,8,15,28,49,-21,20
Sydney FC,7810,1,20,4,4,66,26,40,64
N'castle Jet,7810,2,15,6,7,59,39,20,51
Melbourne C,7810,3,14,5,10,45,35,10,47
Melbourne V,7810,4,14,5,10,49,40,9,47
Adelaide Utd,7810,5,11,6,11,37,40,-3,39
Brisbane,7810,6,10,5,13,33,42,-9,35
Western Sydn,7810,7,8,9,10,38,47,-9,33
Perth Glory,7810,8,10,2,15,37,50,-13,32
Wellington P,7810,9,5,6,16,31,55,-24,21
CC Mariners,7810,10,4,8,15,28,49,-21,20
Sydney FC,7811,1,21,4,3,68,25,43,67
N'castle Jet,7811,2,15,6,7,59,39,20,51
Melbourne C,7811,3,14,5,10,45,35,10,47
Melbourne V,7811,4,13,5,11,48,42,6,44
Adelaide Utd,7811,5,11,6,11,37,40,-3,39
Brisbane,7811,6,10,5,13,33,42,-9,35
Western Sydn,7811,7,8,9,10,38,47,-9,33
Perth Glory,7811,8,10,2,15,37,50,-13,32
Wellington P,7811,9,5,6,16,31,55,-24,21
CC Mariners,7811,10,4,8,15,28,49,-21,20
Sydney FC,7812,1,21,4,3,66,22,44,67
N'castle Jet,7812,2,15,6,7,58,38,20,51
Melbourne C,7812,3,14,5,10,44,34,10,47
Melbourne V,7812,4,13,5,11,45,40,5,44
Adelaide Utd,7812,5,11,6,11,37,40,-3,39
Brisbane,7812,6,10,5,13,33,42,-9,35
Western Sydn,7812,7,8,9,10,38,47,-9,33
Perth Glory,7812,8,10,2,15,37,50,-13,32
Wellington P,7812,9,5,6,16,31,55,-24,21
CC Mariners,7812,10,4,8,15,28,49,-21,20
Sydney FC,7813,1,20,4,4,64,23,41,64
N'castle Jet,7813,2,15,5,8,58,39,19,50
Melbourne C,7813,3,15,4,10,45,34,11,49
Melbourne V,7813,4,14,5,10,46,38,8,47
Adelaide Utd,7813,5,11,6,11,37,40,-3,39
Brisbane,7813,6,10,5,13,33,42,-9,35
Western Sydn,7813,7,8,9,10,38,47,-9,33
Perth Glory,7813,8,10,2,15,37,50,-13,32
Wellington P,7813,9,5,6,16,31,55,-24,21
CC Mariners,7813,10,4,8,15,28,49,-21,20
Sydney FC,7814,1,20,5,3,65,23,42,65
N'castle Jet,7814,2,16,5,7,61,37,24,53
Melbourne C,7814,3,14,4,11,43,37,6,46
Melbourne V,7814,4,13,6,10,46,39,7,45
Adelaide Utd,7814,5,11,6,11,37,40,-3,39
Brisbane,7814,6,10,5,13,33,42,-9,35
Western Sydn,7814,7,8,9,10,38,47,-9,33
Perth Glory,7814,8,10,2,15,37,50,-13,32
Wellington P,7814,9,5,6,16,31,55,-24,21
CC Mariners,7814,10,4,8,15,28,49,-21,20
Sydney FC,7815,1,21,4,3,68,23,45,67
N'castle Jet,7815,2,15,5,8,58,41,17,50
Melbourne C,7815,3,15,4,10,47,34,13,49
Melbourne V,7815,4,13,5,11,46,42,4,44
Adelaide Utd,7815,5,11,6,11,37,40,-3,39
Brisbane,7815,6,10,5,13,33,42,-9,35
Western Sydn,7815,7,8,9,10,38,47,-9,33
Perth Glory,7815,8,10,2,15,37,50,-13,32
Wellington P,7815,9,5,6,16,31,55,-24,21
CC Mariners,7815,10,4,8,15,28,49,-21,20
Sydney FC,7816,1,21,4,3,66,22,44,67
N'castle Jet,7816,2,16,5,7,59,38,21,53
Melbourne C,7816,3,14,4,11,44,35,9,46
Melbourne V,7816,4,13,5,11,45,40,5,44
Adelaide Utd,7816,5,11,6,11,37,40,-3,39
Brisbane,7816,6,10,5,13,33,42,-9,35
Western Sydn,7816,7,8,9,10,38,47,-9,33
Perth Glory,7816,8,10,2,15,37,50,-13,32
Wellington P,7816,9,5,6,16,31,55,-24,21
CC Mariners,7816,10,4,8,15,28,49,-21,20
Sydney FC,7817,1,20,4,4,64,23,41,64
N'castle Jet,7817,2,15,5,8,57,38,19,50
Melbourne C,7817,3,15,4,10,44,33,11,49
Melbourne V,7817,4,14,5,10,46,38,8,47
Adelaide Utd,7817,5,11,6,11,37,40,-3,39
Brisbane,7817,6,10,5,13,33,42,-9,35
Western Sydn,7817,7,8,9,10,38,47,-9,33
Perth Glory,7817,8,10,2,15,37,50,-13,32
Wellington P,7817,9,5,6,16,31,55,-24,21
CC Mariners,7817,10,4,8,15,28,49,-21,20
Sydney FC,7818,1,21,4,3,67,23,44,67
N'castle Jet,7818,2,16,5,7,58,37,21,53
Melbourne C,7818,3,14,4,11,43,34,9,46
Melbourne V,7818,4,13,5,11,46,41,5,44
Adelaide Utd,7818,5,11,6,11,37,40,-3,39
Brisbane,7818,6,10,5,13,33,42,-9,35
Western Sydn,7818,7,8,9,10,38,47,-9,33
Perth Glory,7818,8,10,2,15,37,50,-13,32
Wellington P,7818,9,5,6,16,31,55,-24,21
CC Mariners,7818,10,4,8,15,28,49,-21,20
Sydney FC,7819,1,21,4,3,69,23,46,67
N'castle Jet,7819,2,15,6,7,57,37,20,51
Melbourne C,7819,3,14,5,10,43,33,10,47
Melbourne V,7819,4,13,5,11,46,43,3,44
Adelaide Utd,7819,5,11,6,11,37,40,-3,39
Brisbane,7819,6,10,5,13,33,42,-9,35
Western Sydn,7819,7,8,9,10,38,47,-9,33
Perth Glory,7819,8,10,2,15,37,50,-13,32
Wellington P,7819,9,5,6,16,31,55,-24,21
CC Mariners,7819,10,4,8,15,28,49,-21,20
Sydney FC,7820,1,21,4,3,65,22,43,67
N'castle Jet,7820,2,15,5,8,58,40,18,50
Melbourne C,7820,3,15,4,10,46,34,12,49
Melbourne V,7820,4,13,5,11,45,39,6,44
Adelaide Utd,7820,5,11,6,11,37,40,-3,39
Brisbane,7820,6,10,5,13,33,42,-9,35
Western Sydn,7820,7,8,9,10,38,47,-9,33
Perth Glory,7820,8,10,2,15,37,50,-13,32
Wellington P,7820,9,5,6,16,31,55,-24,21
CC Mariners,7820,10,4,8,15,28,49,-21,20
Sydney FC,7821,1,20,4,4,65,24,41,64
N'castle Jet,7821,2,15,6,7,58,38,20,51
Melbourne C,7821,3,14,5,10,44,34,10,47
Melbourne V,7821,4,14,5,10,47,39,8,47
Adelaide Utd,7821,5,11,6,11,37,40,-3,39
Brisbane,7821,6,10,5,13,33,42,-9,35
Western Sydn,7821,7,8,9,10,38,47,-9,33
Perth Glory,7821,8,10,2,15,37,50,-13,32
Wellington P,7821,9,5,6,16,31,55,-24,21
CC Mariners,7821,10,4,8,15,28,49,-21,20
Sydney FC,7822,1,21,4,3,66,23,43,67
N'castle Jet,7822,2,16,5,7,60,39,21,53
Melbourne C,7822,3,14,4,11,45,36,9,46
Melbourne V,7822,4,13,5,11,46,40,6,44
Adelaide Utd,7822,5,11,6,11,37,40,-3,39
Brisbane,7822,6,10,5,13,33,42,-9,35
Western Sydn,7822,7,8,9,10,38,47,-9,33
Perth Glory,7822,8,10,2,15,37,50,-13,32
Wellington P,7822,9,5,6,16,31,55,-24,21
CC Mariners,7822,10,4,8,15,28,49,-21,20
Sydney FC,7823,1,21,4,3,65,22,43,67
N'castle Jet,7823,2,16,5,7,60,37,23,53
Melbourne C,7823,3,14,4,11,43,36,7,46
Melbourne V,7823,4,13,5,11,45,39,6,44
Adelaide Utd,7823,5,11,6,11,37,40,-3,39
Brisbane,7823,6,10,5,13,33,42,-9,35
Western Sydn,7823,7,8,9,10,38,47,-9,33
Perth Glory,7823,8,10,2,15,37,50,-13,32
Wellington P,7823,9,5,6,16,31,55,-24,21
CC Mariners,7823,10,4,8,15,28,49,-21,20
Sydney FC,7824,1,21,4,3,65,22,43,67
N'castle Jet,7824,2,15,5,8,58,39,19,50
Melbourne C,7824,3,15,4,10,45,34,11,49
Melbourne V,7824,4,13,5,11,45,39,6,44
Adelaide Utd,7824,5,11,6,11,37,40,-3,39
Brisbane,7824,6,10,5,13,33,42,-9,35
Western Sydn,7824,7,8,9,10,38,47,-9,33
Perth Glory,7824,8,10,2,15,37,50,-13,32
Wellington P,7824,9,5,6,16,31,55,-24,21
CC Mariners,7824,10,4,8,15,28,49,-21,20
Sydney FC,7825,1,21,4,3,66,22,44,67
N'castle Jet,7825,2,15,5,8,60,42,18,50
Melbourne C,7825,3,15,4,10,48,36,12,49
Melbourne V,7825,4,13,5,11,45,40,5,44
Adelaide Utd,7825,5,11,6,11,37,40,-3,39
Brisbane,7825,6,10,5,13,33,42,-9,35
Western Sydn,7825,7,8,9,10,38,47,-9,33
Perth Glory,7825,8,10,2,15,37,50,-13,32
Wellington P,7825,9,5,6,16,31,55,-24,21
CC Mariners,7825,10,4,8,15,28,49,-21,20
Sydney FC,7826,1,21,4,3,65,22,43,67
N'castle Jet,7826,2,15,6,7,58,38,20,51
Melbourne C,7826,3,14,5,10,44,34,10,47
Melbourne V,7826,4,13,5,11,45,39,6,44
Adelaide Utd,7826,5,11,6,11,37,40,-3,39
Brisbane,7826,6,10,5,13,33,42,-9,35
Western Sydn,7826,7,8,9,10,38,47,-9,33
Perth Glory,7826,8,10,2,15,37,50,-13,32
Wellington P,7826,9,5,6,16,31,55,-24,21
CC Mariners,7826,10,4,8,15,28,49,-21,20
Sydney FC,7827,1,21,4,3,66,23,43,67
N'castle Jet,7827,2,15,5,8,57,40,17,50
Melbourne C,7827,3,15,4,10,46,33,13,49
Melbourne V,7827,4,13,5,11,46,40,6,44
Adelaide Utd,7827,5,11,6,11,37,40,-3,39
Brisbane,7827,6,10,5,13,33,42,-9,35
Western Sydn,7827,7,8,9,10,38,47,-9,33
Perth Glory,7827,8,10,2,15,37,50,-13,32
Wellington P,7827,9,5,6,16,31,55,-24,21
CC Mariners,7827,10,4,8,15,28,49,-21,20
Sydney FC,7828,1,20,5,3,64,22,42,65
N'castle Jet,7828,2,16,5,7,60,38,22,53
Melbourne C,7828,3,14,4,11,44,36,8,46
Melbourne V,7828,4,13,6,10,45,38,7,45
Adelaide Utd,7828,5,11,6,11,37,40,-3,39
Brisbane,7828,6,10,5,13,33,42,-9,35
Western Sydn,7828,7,8,9,10,38,47,-9,33
Perth Glory,7828,8,10,2,15,37,50,-13,32
Wellington P,7828,9,5,6,16,31,55,-24,21
CC Mariners,7828,10,4,8,15,28,49,-21,20
Sydney FC,7829,1,20,4,4,66,25,41,64
N'castle Jet,7829,2,16,5,7,59,38,21,53
Melbourne V,7829,3,14,5,10,48,40,8,47
Melbourne C,7829,4,14,4,11,44,35,9,46
Adelaide Utd,7829,5,11,6,11,37,40,-3,39
Brisbane,7829,6,10,5,13,33,42,-9,35
Western Sydn,7829,7,8,9,10,38,47,-9,33
Perth Glory,7829,8,10,2,15,37,50,-13,32
Wellington P,7829,9,5,6,16,31,55,-24,21
CC Mariners,7829,10,4,8,15,28,49,-21,20
Sydney FC,7830,1,21,4,3,68,22,46,67
N'castle Jet,7830,2,15,6,7,59,39,20,51
Melbourne C,7830,3,14,5,10,45,35,10,47
Melbourne V,7830,4,13,5,11,45,42,3,44
Adelaide Utd,7830,5,11,6,11,37,40,-3,39
Brisbane,7830,6,10,5,13,33,42,-9,35
Western Sydn,7830,7,8,9,10,38,47,-9,33
Perth Glory,7830,8,10,2,15,37,50,-13,32
Wellington P,7830,9,5,6,16,31,55,-24,21
CC Mariners,7830,10,4,8,15,28,49,-21,20
Sydney FC,7831,1,21,4,3,69,22,47,67
N'castle Jet,7831,2,15,6,7,59,39,20,51
Melbourne C,7831,3,14,5,10,45,35,10,47
Melbourne V,7831,4,13,5,11,45,43,2,44
Adelaide Utd,7831,5,11,6,11,37,40,-3,39
Brisbane,7831,6,10,5,13,33,42,-9,35
Western Sydn,7831,7,8,9,10,38,47,-9,33
Perth Glory,7831,8,10,2,15,37,50,-13,32
Wellington P,7831,9,5,6,16,31,55,-24,21
CC Mariners,7831,10,4,8,15,28,49,-21,20
Sydney FC,7832,1,21,4,3,65,22,43,67
N'castle Jet,7832,2,15,5,8,58,39,19,50
Melbourne C,7832,3,15,4,10,45,34,11,49
Melbourne V,7832,4,13,5,11,45,39,6,44
Adelaide Utd,7832,5,11,6,11,37,40,-3,39
Brisbane,7832,6,10,5,13,33,42,-9,35
Western Sydn,7832,7,8,9,10,38,47,-9,33
Perth Glory,7832,8,10,2,15,37,50,-13,32
Wellington P,7832,9,5,6,16,31,55,-24,21
CC Mariners,7832,10,4,8,15,28,49,-21,20
Sydney FC,7833,1,21,4,3,68,22,46,67
N'castle Jet,7833,2,16,5,7,60,37,23,53
Melbourne C,7833,3,14,4,11,43,36,7,46
Melbourne V,7833,4,13,5,11,45,42,3,44
Adelaide Utd,7833,5,11,6,11,37,40,-3,39
Brisbane,7833,6,10,5,13,33,42,-9,35
Western Sydn,7833,7,8,9,10,38,47,-9,33
Perth Glory,7833,8,10,2,15,37,50,-13,32
Wellington P,7833,9,5,6,16,31,55,-24,21
CC Mariners,7833,10,4,8,15,28,49,-21,20
Sydney FC,7834,1,21,4,3,65,22,43,67
N'castle Jet,7834,2,15,5,8,58,39,19,50
Melbourne C,7834,3,15,4,10,45,34,11,49
Melbourne V,7834,4,13,5,11,45,39,6,44
Adelaide Utd,7834,5,11,6,11,37,40,-3,39
Brisbane,7834,6,10,5,13,33,42,-9,35
Western Sydn,7834,7,8,9,10,38,47,-9,33
Perth Glory,7834,8,10,2,15,37,50,-13,32
Wellington P,7834,9,5,6,16,31,55,-24,21
CC Mariners,7834,10,4,8,15,28,49,-21,20
Sydney FC,7835,1,20,5,3,65,23,42,65
N'castle Jet,7835,2,15,5,8,57,39,18,50
Melbourne C,7835,3,15,4,10,45,33,12,49
Melbourne V,7835,4,13,6,10,46,39,7,45
Adelaide Utd,7835,5,11,6,11,37,40,-3,39
Brisbane,7835,6,10,5,13,33,42,-9,35
Western Sydn,7835,7,8,9,10,38,47,-9,33
Perth Glory,7835,8,10,2,15,37,50,-13,32
Wellington P,7835,9,5,6,16,31,55,-24,21
CC Mariners,7835,10,4,8,15,28,49,-21,20
Sydney FC,7836,1,20,5,3,66,24,42,65
N'castle Jet,7836,2,16,5,7,60,38,22,53
Melbourne C,7836,3,14,4,11,44,36,8,46
Melbourne V,7836,4,13,6,10,47,40,7,45
Adelaide Utd,7836,5,11,6,11,37,40,-3,39
Brisbane,7836,6,10,5,13,33,42,-9,35
Western Sydn,7836,7,8,9,10,38,47,-9,33
Perth Glory,7836,8,10,2,15,37,50,-13,32
Wellington P,7836,9,5,6,16,31,55,-24,21
CC Mariners,7836,10,4,8,15,28,49,-21,20
Sydney FC,7837,1,21,4,3,66,22,44,67
N'castle Jet,7837,2,16,5,7,61,39,22,53
Melbourne C,7837,3,14,4,11,45,37,8,46
Melbourne V,7837,4,13,5,11,45,40,5,44
Adelaide Utd,7837,5,11,6,11,37,40,-3,39
Brisbane,7837,6,10,5,13,33,42,-9,35
Western Sydn,7837,7,8,9,10,38,47,-9,33
Perth Glory,7837,8,10,2,15,37,50,-13,32
Wellington P,7837,9,5,6,16,31,55,-24,21
CC Mariners,7837,10,4,8,15,28,49,-21,20
Sydney FC,7838,1,21,4,3,65,22,43,67
N'castle Jet,7838,2,16,5,7,60,37,23,53
Melbourne C,7838,3,14,4,11,43,36,7,46
Melbourne V,7838,4,13,5,11,45,39,6,44
Adelaide Utd,7838,5,11,6,11,37,40,-3,39
Brisbane,7838,6,10,5,13,33,42,-9,35
Western Sydn,7838,7,8,9,10,38,47,-9,33
Perth Glory,7838,8,10,2,15,37,50,-13,32
Wellington P,7838,9,5,6,16,31,55,-24,21
CC Mariners,7838,10,4,8,15,28,49,-21,20
Sydney FC,7839,1,21,4,3,66,23,43,67
N'castle Jet,7839,2,15,6,7,57,37,20,51
Melbourne C,7839,3,14,5,10,43,33,10,47
Melbourne V,7839,4,13,5,11,46,40,6,44
Adelaide Utd,7839,5,11,6,11,37,40,-3,39
Brisbane,7839,6,10,5,13,33,42,-9,35
Western Sydn,7839,7,8,9,10,38,47,-9,33
Perth Glory,7839,8,10,2,15,37,50,-13,32
Wellington P,7839,9,5,6,16,31,55,-24,21
CC Mariners,7839,10,4,8,15,28,49,-21,20
Sydney FC,7840,1,20,5,3,65,23,42,65
N'castle Jet,7840,2,15,5,8,59,41,18,50
Melbourne C,7840,3,15,4,10,47,35,12,49
Melbourne V,7840,4,13,6,10,46,39,7,45
Adelaide Utd,7840,5,11,6,11,37,40,-3,39
Brisbane,7840,6,10,5,13,33,42,-9,35
Western Sydn,7840,7,8,9,10,38,47,-9,33
Perth Glory,7840,8,10,2,15,37,50,-13,32
Wellington P,7840,9,5,6,16,31,55,-24,21
CC Mariners,7840,10,4,8,15,28,49,-21,20
Sydney FC,7841,1,20,5,3,66,24,42,65
N'castle Jet,7841,2,16,5,7,60,38,22,53
Melbourne C,7841,3,14,4,11,44,36,8,46
Melbourne V,7841,4,13,6,10,47,40,7,45
Adelaide Utd,7841,5,11,6,11,37,40,-3,39
Brisbane,7841,6,10,5,13,33,42,-9,35
Western Sydn,7841,7,8,9,10,38,47,-9,33
Perth Glory,7841,8,10,2,15,37,50,-13,32
Wellington P,7841,9,5,6,16,31,55,-24,21
CC Mariners,7841,10,4,8,15,28,49,-21,20
Sydney FC,7842,1,21,4,3,66,22,44,67
N'castle Jet,7842,2,16,5,7,59,38,21,53
Melbourne C,7842,3,14,4,11,44,35,9,46
Melbourne V,7842,4,13,5,11,45,40,5,44
Adelaide Utd,7842,5,11,6,11,37,40,-3,39
Brisbane,7842,6,10,5,13,33,42,-9,35
Western Sydn,7842,7,8,9,10,38,47,-9,33
Perth Glory,7842,8,10,2,15,37,50,-13,32
Wellington P,7842,9,5,6,16,31,55,-24,21
CC Mariners,7842,10,4,8,15,28,49,-21,20
Sydney FC,7843,1,21,4,3,66,23,43,67
N'castle Jet,7843,2,15,6,7,59,39,20,51
Melbourne C,7843,3,14,5,10,45,35,10,47
Melbourne V,7843,4,13,5,11,46,40,6,44
Adelaide Utd,7843,5,11,6,11,37,40,-3,39
Brisbane,7843,6,10,5,13,33,42,-9,35
Western Sydn,7843,7,8,9,10,38,47,-9,33
Perth Glory,7843,8,10,2,15,37,50,-13,32
Wellington P,7843,9,5,6,16,31,55,-24,21
CC Mariners,7843,10,4,8,15,28,49,-21,20
Sydney FC,7844,1,20,4,4,64,24,40,64
N'castle Jet,7844,2,16,5,7,61,38,23,53
Melbourne V,7844,3,14,5,10,47,38,9,47
Melbourne C,7844,4,14,4,11,44,37,7,46
Adelaide Utd,7844,5,11,6,11,37,40,-3,39
Brisbane,7844,6,10,5,13,33,42,-9,35
Western Sydn,7844,7,8,9,10,38,47,-9,33
Perth Glory,7844,8,10,2,15,37,50,-13,32
Wellington P,7844,9,5,6,16,31,55,-24,21
CC Mariners,7844,10,4,8,15,28,49,-21,20
Sydney FC,7845,1,21,4,3,68,22,46,67
N'castle Jet,7845,2,16,5,7,59,38,21,53
Melbourne C,7845,3,14,4,11,44,35,9,46
Melbourne V,7845,4,13,5,11,45,42,3,44
Adelaide Utd,7845,5,11,6,11,37,40,-3,39
Brisbane,7845,6,10,5,13,33,42,-9,35
Western Sydn,7845,7,8,9,10,38,47,-9,33
Perth Glory,7845,8,10,2,15,37,50,-13,32
Wellington P,7845,9,5,6,16,31,55,-24,21
CC Mariners,7845,10,4,8,15,28,49,-21,20
Sydney FC,7846,1,21,4,3,65,22,43,67
N'castle Jet,7846,2,16,5,7,59,37,22,53
Melbourne C,7846,3,14,4,11,43,35,8,46
Melbourne V,7846,4,13,5,11,45,39,6,44
Adelaide Utd,7846,5,11,6,11,37,40,-3,39
Brisbane,7846,6,10,5,13,33,42,-9,35
Western Sydn,7846,7,8,9,10,38,47,-9,33
Perth Glory,7846,8,10,2,15,37,50,-13,32
Wellington P,7846,9,5,6,16,31,55,-24,21
CC Mariners,7846,10,4,8,15,28,49,-21,20
Sydney FC,7847,1,20,4,4,64,23,41,64
N'castle Jet,7847,2,15,6,7,58,38,20,51
Melbourne C,7847,3,14,5,10,44,34,10,47
Melbourne V,7847,4,14,5,10,46,38,8,47
Adelaide Utd,7847,5,11,6,11,37,40,-3,39
Brisbane,7847,6,10,5,13,33,42,-9,35
Western Sydn,7847,7,8,9,10,38,47,-9,33
Perth Glory,7847,8,10,2,15,37,50,-13,32
Wellington P,7847,9,5,6,16,31,55,-24,21
CC Mariners,7847,10,4,8,15,28,49,-21,20
Sydney FC,7848,1,20,5,3,64,22,42,65
N'castle Jet,7848,2,15,5,8,58,39,19,50
Melbourne C,7848,3,15,4,10,45,34,11,49
Melbourne V,7848,4,13,6,10,45,38,7,45
Adelaide Utd,7848,5,11,6,11,37,40,-3,39
Brisbane,7848,6,10,5,13,33,42,-9,35
Western Sydn,7848,7,8,9,10,38,47,-9,33
Perth Glory,7848,8,10,2,15,37,50,-13,32
Wellington P,7848,9,5,6,16,31,55,-24,21
CC Mariners,7848,10,4,8,15,28,49,-21,20
Sydney FC,7849,1,21,4,3,68,24,44,67
N'castle Jet,7849,2,16,5,7,60,39,21,53
Melbourne C,7849,3,14,4,11,45,36,9,46
Melbourne V,7849,4,13,5,11,47,42,5,44
Adelaide Utd,7849,5,11,6,11,37,40,-3,39
Brisbane,7849,6,10,5,13,33,42,-9,35
Western Sydn,7849,7,8,9,10,38,47,-9,33
Perth Glory,7849,8,10,2,15,37,50,-13,32
Wellington P,7849,9,5,6,16,31,55,-24,21
CC Mariners,7849,10,4,8,15,28,49,-21,20
Sydney FC,7850,1,20,5,3,66,24,42,65
N'castle Jet,7850,2,15,6,7,59,39,20,51
Melbourne C,7850,3,14,5,10,45,35,10,47
Melbourne V,7850,4,13,6,10,47,40,7,45
Adelaide Utd,7850,5,11,6,11,37,40,-3,39
Brisbane,7850,6,10,5,13,33,42,-9,35
Western Sydn,7850,7,8,9,10,38,47,-9,33
Perth Glory,7850,8,10,2,15,37,50,-13,32
Wellington P,7850,9,5,6,16,31,55,-24,21
CC Mariners,7850,10,4,8,15,28,49,-21,20
Sydney FC,7851,1,20,5,3,66,24,42,65
N'castle Jet,7851,2,16,5,7,59,38,21,53
Melbourne C,7851,3,14,4,11,44,35,9,46
Melbourne V,7851,4,13,6,10,47,40,7,45
Adelaide Utd,7851,5,11,6,11,37,40,-3,39
Brisbane,7851,6,10,5,13,33,42,-9,35
Western Sydn,7851,7,8,9,10,38,47,-9,33
Perth Glory,7851,8,10,2,15,37,50,-13,32
Wellington P,7851,9,5,6,16,31,55,-24,21
CC Mariners,7851,10,4,8,15,28,49,-21,20
Sydney FC,7852,1,21,4,3,66,23,43,67
N'castle Jet,7852,2,16,5,7,60,37,23,53
Melbourne C,7852,3,14,4,11,43,36,7,46
Melbourne V,7852,4,13,5,11,46,40,6,44
Adelaide Utd,7852,5,11,6,11,37,40,-3,39
Brisbane,7852,6,10,5,13,33,42,-9,35
Western Sydn,7852,7,8,9,10,38,47,-9,33
Perth Glory,7852,8,10,2,15,37,50,-13,32
Wellington P,7852,9,5,6,16,31,55,-24,21
CC Mariners,7852,10,4,8,15,28,49,-21,20
Sydney FC,7853,1,21,4,3,67,24,43,67
N'castle Jet,7853,2,16,5,7,61,38,23,53
Melbourne C,7853,3,14,4,11,44,37,7,46
Melbourne V,7853,4,13,5,11,47,41,6,44
Adelaide Utd,7853,5,11,6,11,37,40,-3,39
Brisbane,7853,6,10,5,13,33,42,-9,35
Western Sydn,7853,7,8,9,10,38,47,-9,33
Perth Glory,7853,8,10,2,15,37,50,-13,32
Wellington P,7853,9,5,6,16,31,55,-24,21
CC Mariners,7853,10,4,8,15,28,49,-21,20
Sydney FC,7854,1,20,5,3,65,23,42,65
N'castle Jet,7854,2,16,5,7,60,37,23,53
Melbourne C,7854,3,14,4,11,43,36,7,46
Melbourne V,7854,4,13,6,10,46,39,7,45
Adelaide Utd,7854,5,11,6,11,37,40,-3,39
Brisbane,7854,6,10,5,13,33,42,-9,35
Western Sydn,7854,7,8,9,10,38,47,-9,33
Perth Glory,7854,8,10,2,15,37,50,-13,32
Wellington P,7854,9,5,6,16,31,55,-24,21
CC Mariners,7854,10,4,8,15,28,49,-21,20
Sydney FC,7855,1,20,4,4,64,23,41,64
N'castle Jet,7855,2,15,5,8,57,39,18,50
Melbourne C,7855,3,15,4,10,45,33,12,49
Melbourne V,7855,4,14,5,10,46,38,8,47
Adelaide Utd,7855,5,11,6,11,37,40,-3,39
Brisbane,7855,6,10,5,13,33,42,-9,35
Western Sydn,7855,7,8,9,10,38,47,-9,33
Perth Glory,7855,8,10,2,15,37,50,-13,32
Wellington P,7855,9,5,6,16,31,55,-24,21
CC Mariners,7855,10,4,8,15,28,49,-21,20
Sydney FC,7856,1,21,4,3,67,22,45,67
N'castle Jet,7856,2,15,6,7,59,39,20,51
Melbourne C,7856,3,14,5,10,45,35,10,47
Melbourne V,7856,4,13,5,11,45,41,4,44
Adelaide Utd,7856,5,11,6,11,37,40,-3,39
Brisbane,7856,6,10,5,13,33,42,-9,35
Western Sydn,7856,7,8,9,10,38,47,-9,33
Perth Glory,7856,8,10,2,15,37,50,-13,32
Wellington P,7856,9,5,6,16,31,55,-24,21
CC Mariners,7856,10,4,8,15,28,49,-21,20
Sydney FC,7857,1,21,4,3,67,23,44,67
N'castle Jet,7857,2,16,5,7,59,38,21,53
Melbourne C,7857,3,14,4,11,44,35,9,46
Melbourne V,7857,4,13,5,11,46,41,5,44
Adelaide Utd,7857,5,11,6,11,37,40,-3,39
Brisbane,7857,6,10,5,13,33,42,-9,35
Western Sydn,7857,7,8,9,10,38,47,-9,33
Perth Glory,7857,8,10,2,15,37,50,-13,32
Wellington P,7857,9,5,6,16,31,55,-24,21
CC Mariners,7857,10,4,8,15,28,49,-21,20
Sydney FC,7858,1,20,5,3,66,24,42,65
N'castle Jet,7858,2,15,5,8,57,40,17,50
Melbourne C,7858,3,15,4,10,46,33,13,49
Melbourne V,7858,4,13,6,10,47,40,7,45
Adelaide Utd,7858,5,11,6,11,37,40,-3,39
Brisbane,7858,6,10,5,13,33,42,-9,35
Western Sydn,7858,7,8,9,10,38,47,-9,33
Perth Glory,7858,8,10,2,15,37,50,-13,32
Wellington P,7858,9,5,6,16,31,55,-24,21
CC Mariners,7858,10,4,8,15,28,49,-21,20
Sydney FC,7859,1,21,4,3,65,22,43,67
N'castle Jet,7859,2,16,5,7,59,38,21,53
Melbourne C,7859,3,14,4,11,44,35,9,46
Melbourne V,7859,4,13,5,11,45,39,6,44
Adelaide Utd,7859,5,11,6,11,37,40,-3,39
Brisbane,7859,6,10,5,13,33,42,-9,35
Western Sydn,7859,7,8,9,10,38,47,-9,33
Perth Glory,7859,8,10,2,15,37,50,-13,32
Wellington P,7859,9,5,6,16,31,55,-24,21
CC Mariners,7859,10,4,8,15,28,49,-21,20
Sydney FC,7860,1,21,4,3,65,22,43,67
N'castle Jet,7860,2,16,5,7,59,38,21,53
Melbourne C,7860,3,14,4,11,44,35,9,46
Melbourne V,7860,4,13,5,11,45,39,6,44
Adelaide Utd,7860,5,11,6,11,37,40,-3,39
Brisbane,7860,6,10,5,13,33,42,-9,35
Western Sydn,7860,7,8,9,10,38,47,-9,33
Perth Glory,7860,8,10,2,15,37,50,-13,32
Wellington P,7860,9,5,6,16,31,55,-24,21
CC Mariners,7860,10,4,8,15,28,49,-21,20
Sydney FC,7861,1,21,4,3,67,23,44,67
N'castle Jet,7861,2,16,5,7,61,40,21,53
Melbourne C,7861,3,14,4,11,46,37,9,46
Melbourne V,7861,4,13,5,11,46,41,5,44
Adelaide Utd,7861,5,11,6,11,37,40,-3,39
Brisbane,7861,6,10,5,13,33,42,-9,35
Western Sydn,7861,7,8,9,10,38,47,-9,33
Perth Glory,7861,8,10,2,15,37,50,-13,32
Wellington P,7861,9,5,6,16,31,55,-24,21
CC Mariners,7861,10,4,8,15,28,49,-21,20
Sydney FC,7862,1,21,4,3,65,22,43,67
N'castle Jet,7862,2,15,5,8,57,38,19,50
Melbourne C,7862,3,15,4,10,44,33,11,49
Melbourne V,7862,4,13,5,11,45,39,6,44
Adelaide Utd,7862,5,11,6,11,37,40,-3,39
Brisbane,7862,6,10,5,13,33,42,-9,35
Western Sydn,7862,7,8,9,10,38,47,-9,33
Perth Glory,7862,8,10,2,15,37,50,-13,32
Wellington P,7862,9,5,6,16,31,55,-24,21
CC Mariners,7862,10,4,8,15,28,49,-21,20
Sydney FC,7863,1,20,4,4,67,26,41,64
N'castle Jet,7863,2,16,5,7,61,37,24,53
Melbourne V,7863,3,14,5,10,49,41,8,47
Melbourne C,7863,4,14,4,11,43,37,6,46
Adelaide Utd,7863,5,11,6,11,37,40,-3,39
Brisbane,7863,6,10,5,13,33,42,-9,35
Western Sydn,7863,7,8,9,10,38,47,-9,33
Perth Glory,7863,8,10,2,15,37,50,-13,32
Wellington P,7863,9,5,6,16,31,55,-24,21
CC Mariners,7863,10,4,8,15,28,49,-21,20
Sydney FC,7864,1,20,5,3,64,22,42,65
N'castle Jet,7864,2,16,5,7,58,37,21,53
Melbourne C,7864,3,14,4,11,43,34,9,46
Melbourne V,7864,4,13,6,10,45,38,7,45
Adelaide Utd,7864,5,11,6,11,37,40,-3,39
Brisbane,7864,6,10,5,13,33,42,-9,35
Western Sydn,7864,7,8,9,10,38,47,-9,33
Perth Glory,7864,8,10,2,15,37,50,-13,32
Wellington P,7864,9,5,6,16,31,55,-24,21
CC Mariners,7864,10,4,8,15,28,49,-21,20
Sydney FC,7865,1,20,5,3,65,23,42,65
N'castle Jet,7865,2,16,5,7,59,38,21,53
Melbourne C,7865,3,14,4,11,44,35,9,46
Melbourne V,7865,4,13,6,10,46,39,7,45
Adelaide Utd,7865,5,11,6,11,37,40,-3,39
Brisbane,7865,6,10,5,13,33,42,-9,35
Western Sydn,7865,7,8,9,10,38,47,-9,33
Perth Glory,7865,8,10,2,15,37,50,-13,32
Wellington P,7865,9,5,6,16,31,55,-24,21
CC Mariners,7865,10,4,8,15,28,49,-21,20
Sydney FC,7866,1,20,5,3,65,23,42,65
N'castle Jet,7866,2,15,6,7,58,38,20,51
Melbourne C,7866,3,14,5,10,44,34,10,47
Melbourne V,7866,4,13,6,10,46,39,7,45
Adelaide Utd,7866,5,11,6,11,37,40,-3,39
Brisbane,7866,6,10,5,13,33,42,-9,35
Western Sydn,7866,7,8,9,10,38,47,-9,33
Perth Glory,7866,8,10,2,15,37,50,-13,32
Wellington P,7866,9,5,6,16,31,55,-24,21
CC Mariners,7866,10,4,8,15,28,49,-21,20
Sydney FC,7867,1,20,4,4,64,23,41,64
N'castle Jet,7867,2,16,5,7,61,37,24,53
Melbourne V,7867,3,14,5,10,46,38,8,47
Melbourne C,7867,4,14,4,11,43,37,6,46
Adelaide Utd,7867,5,11,6,11,37,40,-3,39
Brisbane,7867,6,10,5,13,33,42,-9,35
Western Sydn,7867,7,8,9,10,38,47,-9,33
Perth Glory,7867,8,10,2,15,37,50,-13,32
Wellington P,7867,9,5,6,16,31,55,-24,21
CC Mariners,7867,10,4,8,15,28,49,-21,20
Sydney FC,7868,1,21,4,3,68,22,46,67
N'castle Jet,7868,2,16,5,7,59,37,22,53
Melbourne C,7868,3,14,4,11,43,35,8,46
Melbourne V,7868,4,13,5,11,45,42,3,44
Adelaide Utd,7868,5,11,6,11,37,40,-3,39
Brisbane,7868,6,10,5,13,33,42,-9,35
Western Sydn,7868,7,8,9,10,38,47,-9,33
Perth Glory,7868,8,10,2,15,37,50,-13,32
Wellington P,7868,9,5,6,16,31,55,-24,21
CC Mariners,7868,10,4,8,15,28,49,-21,20
Sydney FC,7869,1,21,4,3,65,22,43,67
N'castle Jet,7869,2,15,5,8,57,38,19,50
Melbourne C,7869,3,15,4,10,44,33,11,49
Melbourne V,7869,4,13,5,11,45,39,6,44
Adelaide Utd,7869,5,11,6,11,37,40,-3,39
Brisbane,7869,6,10,5,13,33,42,-9,35
Western Sydn,7869,7,8,9,10,38,47,-9,33
Perth Glory,7869,8,10,2,15,37,50,-13,32
Wellington P,7869,9,5,6,16,31,55,-24,21
CC Mariners,7869,10,4,8,15,28,49,-21,20
Sydney FC,7870,1,20,4,4,64,23,41,64
N'castle Jet,7870,2,16,5,7,59,37,22,53
Melbourne V,7870,3,14,5,10,46,38,8,47
Melbourne C,7870,4,14,4,11,43,35,8,46
Adelaide Utd,7870,5,11,6,11,37,40,-3,39
Brisbane,7870,6,10,5,13,33,42,-9,35
Western Sydn,7870,7,8,9,10,38,47,-9,33
Perth Glory,7870,8,10,2,15,37,50,-13,32
Wellington P,7870,9,5,6,16,31,55,-24,21
CC Mariners,7870,10,4,8,15,28,49,-21,20
Sydney FC,7871,1,20,5,3,66,24,42,65
N'castle Jet,7871,2,15,5,8,57,39,18,50
Melbourne C,7871,3,15,4,10,45,33,12,49
Melbourne V,7871,4,13,6,10,47,40,7,45
Adelaide Utd,7871,5,11,6,11,37,40,-3,39
Brisbane,7871,6,10,5,13,33,42,-9,35
Western Sydn,7871,7,8,9,10,38,47,-9,33
Perth Glory,7871,8,10,2,15,37,50,-13,32
Wellington P,7871,9,5,6,16,31,55,-24,21
CC Mariners,7871,10,4,8,15,28,49,-21,20
Sydney FC,7872,1,21,4,3,65,22,43,67
N'castle Jet,7872,2,16,5,7,59,38,21,53
Melbourne C,7872,3,14,4,11,44,35,9,46
Melbourne V,7872,4,13,5,11,45,39,6,44
Adelaide Utd,7872,5,11,6,11,37,40,-3,39
Brisbane,7872,6,10,5,13,33,42,-9,35
Western Sydn,7872,7,8,9,10,38,47,-9,33
Perth Glory,7872,8,10,2,15,37,50,-13,32
Wellington P,7872,9,5,6,16,31,55,-24,21
CC Mariners,7872,10,4,8,15,28,49,-21,20
Sydney FC,7873,1,21,4,3,68,22,46,67
N'castle Jet,7873,2,15,5,8,59,41,18,50
Melbourne C,7873,3,15,4,10,47,35,12,49
Melbourne V,7873,4,13,5,11,45,42,3,44
Adelaide Utd,7873,5,11,6,11,37,40,-3,39
Brisbane,7873,6,10,5,13,33,42,-9,35
Western Sydn,7873,7,8,9,10,38,47,-9,33
Perth Glory,7873,8,10,2,15,37,50,-13,32
Wellington P,7873,9,5,6,16,31,55,-24,21
CC Mariners,7873,10,4,8,15,28,49,-21,20
Sydney FC,7874,1,20,4,4,65,25,40,64
N'castle Jet,7874,2,15,5,8,59,41,18,50
Melbourne C,7874,3,15,4,10,47,35,12,49
Melbourne V,7874,4,14,5,10,48,39,9,47
Adelaide Utd,7874,5,11,6,11,37,40,-3,39
Brisbane,7874,6,10,5,13,33,42,-9,35
Western Sydn,7874,7,8,9,10,38,47,-9,33
Perth Glory,7874,8,10,2,15,37,50,-13,32
Wellington P,7874,9,5,6,16,31,55,-24,21
CC Mariners,7874,10,4,8,15,28,49,-21,20
Sydney FC,7875,1,21,4,3,66,22,44,67
N'castle Jet,7875,2,15,5,8,58,39,19,50
Melbourne C,7875,3,15,4,10,45,34,11,49
Melbourne V,7875,4,13,5,11,45,40,5,44
Adelaide Utd,7875,5,11,6,11,37,40,-3,39
Brisbane,7875,6,10,5,13,33,42,-9,35
Western Sydn,7875,7,8,9,10,38,47,-9,33
Perth Glory,7875,8,10,2,15,37,50,-13,32
Wellington P,7875,9,5,6,16,31,55,-24,21
CC Mariners,7875,10,4,8,15,28,49,-21,20
Sydney FC,7876,1,21,4,3,66,22,44,67
N'castle Jet,7876,2,15,5,8,57,39,18,50
Melbourne C,7876,3,15,4,10,45,33,12,49
Melbourne V,7876,4,13,5,11,45,40,5,44
Adelaide Utd,7876,5,11,6,11,37,40,-3,39
Brisbane,7876,6,10,5,13,33,42,-9,35
Western Sydn,7876,7,8,9,10,38,47,-9,33
Perth Glory,7876,8,10,2,15,37,50,-13,32
Wellington P,7876,9,5,6,16,31,55,-24,21
CC Mariners,7876,10,4,8,15,28,49,-21,20
Sydney FC,7877,1,20,4,4,64,25,39,64
N'castle Jet,7877,2,15,6,7,58,38,20,51
Melbourne V,7877,3,14,5,10,48,38,10,47
Melbourne C,7877,4,14,5,10,44,34,10,47
Adelaide Utd,7877,5,11,6,11,37,40,-3,39
Brisbane,7877,6,10,5,13,33,42,-9,35
Western Sydn,7877,7,8,9,10,38,47,-9,33
Perth Glory,7877,8,10,2,15,37,50,-13,32
Wellington P,7877,9,5,6,16,31,55,-24,21
CC Mariners,7877,10,4,8,15,28,49,-21,20
Sydney FC,7878,1,20,5,3,67,25,42,65
N'castle Jet,7878,2,15,5,8,57,38,19,50
Melbourne C,7878,3,15,4,10,44,33,11,49
Melbourne V,7878,4,13,6,10,48,41,7,45
Adelaide Utd,7878,5,11,6,11,37,40,-3,39
Brisbane,7878,6,10,5,13,33,42,-9,35
Western Sydn,7878,7,8,9,10,38,47,-9,33
Perth Glory,7878,8,10,2,15,37,50,-13,32
Wellington P,7878,9,5,6,16,31,55,-24,21
CC Mariners,7878,10,4,8,15,28,49,-21,20
Sydney FC,7879,1,20,5,3,66,24,42,65
N'castle Jet,7879,2,16,5,7,59,38,21,53
Melbourne C,7879,3,14,4,11,44,35,9,46
Melbourne V,7879,4,13,6,10,47,40,7,45
Adelaide Utd,7879,5,11,6,11,37,40,-3,39
Brisbane,7879,6,10,5,13,33,42,-9,35
Western Sydn,7879,7,8,9,10,38,47,-9,33
Perth Glory,7879,8,10,2,15,37,50,-13,32
Wellington P,7879,9,5,6,16,31,55,-24,21
CC Mariners,7879,10,4,8,15,28,49,-21,20
Sydney FC,7880,1,20,5,3,66,24,42,65
N'castle Jet,7880,2,15,6,7,58,38,20,51
Melbourne C,7880,3,14,5,10,44,34,10,47
Melbourne V,7880,4,13,6,10,47,40,7,45
Adelaide Utd,7880,5,11,6,11,37,40,-3,39
Brisbane,7880,6,10,5,13,33,42,-9,35
Western Sydn,7880,7,8,9,10,38,47,-9,33
Perth Glory,7880,8,10,2,15,37,50,-13,32
Wellington P,7880,9,5,6,16,31,55,-24,21
CC Mariners,7880,10,4,8,15,28,49,-21,20
Sydney FC,7881,1,21,4,3,67,22,45,67
N'castle Jet,7881,2,16,5,7,60,38,22,53
Melbourne C,7881,3,14,4,11,44,36,8,46
Melbourne V,7881,4,13,5,11,45,41,4,44
Adelaide Utd,7881,5,11,6,11,37,40,-3,39
Brisbane,7881,6,10,5,13,33,42,-9,35
Western Sydn,7881,7,8,9,10,38,47,-9,33
Perth Glory,7881,8,10,2,15,37,50,-13,32
Wellington P,7881,9,5,6,16,31,55,-24,21
CC Mariners,7881,10,4,8,15,28,49,-21,20
Sydney FC,7882,1,21,4,3,66,22,44,67
N'castle Jet,7882,2,15,6,7,58,38,20,51
Melbourne C,7882,3,14,5,10,44,34,10,47
Melbourne V,7882,4,13,5,11,45,40,5,44
Adelaide Utd,7882,5,11,6,11,37,40,-3,39
Brisbane,7882,6,10,5,13,33,42,-9,35
Western Sydn,7882,7,8,9,10,38,47,-9,33
Perth Glory,7882,8,10,2,15,37,50,-13,32
Wellington P,7882,9,5,6,16,31,55,-24,21
CC Mariners,7882,10,4,8,15,28,49,-21,20
Sydney FC,7883,1,21,4,3,66,22,44,67
N'castle Jet,7883,2,16,5,7,60,37,23,53
Melbourne C,7883,3,14,4,11,43,36,7,46
Melbourne V,7883,4,13,5,11,45,40,5,44
Adelaide Utd,7883,5,11,6,11,37,40,-3,39
Brisbane,7883,6,10,5,13,33,42,-9,35
Western Sydn,7883,7,8,9,10,38,47,-9,33
Perth Glory,7883,8,10,2,15,37,50,-13,32
Wellington P,7883,9,5,6,16,31,55,-24,21
CC Mariners,7883,10,4,8,15,28,49,-21,20
Sydney FC,7884,1,21,4,3,67,23,44,67
N'castle Jet,7884,2,16,5,7,59,37,22,53
Melbourne C,7884,3,14,4,11,43,35,8,46
Melbourne V,7884,4,13,5,11,46,41,5,44
Adelaide Utd,7884,5,11,6,11,37,40,-3,39
Brisbane,7884,6,10,5,13,33,42,-9,35
Western Sydn,7884,7,8,9,10,38,47,-9,33
Perth Glory,7884,8,10,2,15,37,50,-13,32
Wellington P,7884,9,5,6,16,31,55,-24,21
CC Mariners,7884,10,4,8,15,28,49,-21,20
Sydney FC,7885,1,21,4,3,69,23,46,67
N'castle Jet,7885,2,16,5,7,60,38,22,53
Melbourne C,7885,3,14,4,11,44,36,8,46
Melbourne V,7885,4,13,5,11,46,43,3,44
Adelaide Utd,7885,5,11,6,11,37,40,-3,39
Brisbane,7885,6,10,5,13,33,42,-9,35
Western Sydn,7885,7,8,9,10,38,47,-9,33
Perth Glory,7885,8,10,2,15,37,50,-13,32
Wellington P,7885,9,5,6,16,31,55,-24,21
CC Mariners,7885,10,4,8,15,28,49,-21,20
Sydney FC,7886,1,20,4,4,64,23,41,64
N'castle Jet,7886,2,16,5,7,61,39,22,53
Melbourne V,7886,3,14,5,10,46,38,8,47
Melbourne C,7886,4,14,4,11,45,37,8,46
Adelaide Utd,7886,5,11,6,11,37,40,-3,39
Brisbane,7886,6,10,5,13,33,42,-9,35
Western Sydn,7886,7,8,9,10,38,47,-9,33
Perth Glory,7886,8,10,2,15,37,50,-13,32
Wellington P,7886,9,5,6,16,31,55,-24,21
CC Mariners,7886,10,4,8,15,28,49,-21,20
Sydney FC,7887,1,21,4,3,67,23,44,67
N'castle Jet,7887,2,15,5,8,59,40,19,50
Melbourne C,7887,3,15,4,10,46,35,11,49
Melbourne V,7887,4,13,5,11,46,41,5,44
Adelaide Utd,7887,5,11,6,11,37,40,-3,39
Brisbane,7887,6,10,5,13,33,42,-9,35
Western Sydn,7887,7,8,9,10,38,47,-9,33
Perth Glory,7887,8,10,2,15,37,50,-13,32
Wellington P,7887,9,5,6,16,31,55,-24,21
CC Mariners,7887,10,4,8,15,28,49,-21,20
Sydney FC,7888,1,20,4,4,65,24,41,64
N'castle Jet,7888,2,15,5,8,59,41,18,50
Melbourne C,7888,3,15,4,10,47,35,12,49
Melbourne V,7888,4,14,5,10,47,39,8,47
Adelaide Utd,7888,5,11,6,11,37,40,-3,39
Brisbane,7888,6,10,5,13,33,42,-9,35
Western Sydn,7888,7,8,9,10,38,47,-9,33
Perth Glory,7888,8,10,2,15,37,50,-13,32
Wellington P,7888,9,5,6,16,31,55,-24,21
CC Mariners,7888,10,4,8,15,28,49,-21,20
Sydney FC,7889,1,21,4,3,69,23,46,67
N'castle Jet,7889,2,15,5,8,57,38,19,50
Melbourne C,7889,3,15,4,10,44,33,11,49
Melbourne V,7889,4,13,5,11,46,43,3,44
Adelaide Utd,7889,5,11,6,11,37,40,-3,39
Brisbane,7889,6,10,5,13,33,42,-9,35
Western Sydn,7889,7,8,9,10,38,47,-9,33
Perth Glory,7889,8,10,2,15,37,50,-13,32
Wellington P,7889,9,5,6,16,31,55,-24,21
CC Mariners,7889,10,4,8,15,28,49,-21,20
Sydney FC,7890,1,21,4,3,66,23,43,67
N'castle Jet,7890,2,16,5,7,59,38,21,53
Melbourne C,7890,3,14,4,11,44,35,9,46
Melbourne V,7890,4,13,5,11,46,40,6,44
Adelaide Utd,7890,5,11,6,11,37,40,-3,39
Brisbane,7890,6,10,5,13,33,42,-9,35
Western Sydn,7890,7,8,9,10,38,47,-9,33
Perth Glory,7890,8,10,2,15,37,50,-13,32
Wellington P,7890,9,5,6,16,31,55,-24,21
CC Mariners,7890,10,4,8,15,28,49,-21,20
Sydney FC,7891,1,20,5,3,65,23,42,65
N'castle Jet,7891,2,15,5,8,58,39,19,50
Melbourne C,7891,3,15,4,10,45,34,11,49
Melbourne V,7891,4,13,6,10,46,39,7,45
Adelaide Utd,7891,5,11,6,11,37,40,-3,39
Brisbane,7891,6,10,5,13,33,42,-9,35
Western Sydn,7891,7,8,9,10,38,47,-9,33
Perth Glory,7891,8,10,2,15,37,50,-13,32
Wellington P,7891,9,5,6,16,31,55,-24,21
CC Mariners,7891,10,4,8,15,28,49,-21,20
Sydney FC,7892,1,20,4,4,65,26,39,64
N'castle Jet,7892,2,16,5,7,59,38,21,53
Melbourne V,7892,3,14,5,10,49,39,10,47
Melbourne C,7892,4,14,4,11,44,35,9,46
Adelaide Utd,7892,5,11,6,11,37,40,-3,39
Brisbane,7892,6,10,5,13,33,42,-9,35
Western Sydn,7892,7,8,9,10,38,47,-9,33
Perth Glory,7892,8,10,2,15,37,50,-13,32
Wellington P,7892,9,5,6,16,31,55,-24,21
CC Mariners,7892,10,4,8,15,28,49,-21,20
Sydney FC,7893,1,21,4,3,65,22,43,67
N'castle Jet,7893,2,16,5,7,59,37,22,53
Melbourne C,7893,3,14,4,11,43,35,8,46
Melbourne V,7893,4,13,5,11,45,39,6,44
Adelaide Utd,7893,5,11,6,11,37,40,-3,39
Brisbane,7893,6,10,5,13,33,42,-9,35
Western Sydn,7893,7,8,9,10,38,47,-9,33
Perth Glory,7893,8,10,2,15,37,50,-13,32
Wellington P,7893,9,5,6,16,31,55,-24,21
CC Mariners,7893,10,4,8,15,28,49,-21,20
Sydney FC,7894,1,21,4,3,67,22,45,67
N'castle Jet,7894,2,15,6,7,58,38,20,51
Melbourne C,7894,3,14,5,10,44,34,10,47
Melbourne V,7894,4,13,5,11,45,41,4,44
Adelaide Utd,7894,5,11,6,11,37,40,-3,39
Brisbane,7894,6,10,5,13,33,42,-9,35
Western Sydn,7894,7,8,9,10,38,47,-9,33
Perth Glory,7894,8,10,2,15,37,50,-13,32
Wellington P,7894,9,5,6,16,31,55,-24,21
CC Mariners,7894,10,4,8,15,28,49,-21,20
Sydney FC,7895,1,21,4,3,67,23,44,67
N'castle Jet,7895,2,16,5,7,60,37,23,53
Melbourne C,7895,3,14,4,11,43,36,7,46
Melbourne V,7895,4,13,5,11,46,41,5,44
Adelaide Utd,7895,5,11,6,11,37,40,-3,39
Brisbane,7895,6,10,5,13,33,42,-9,35
Western Sydn,7895,7,8,9,10,38,47,-9,33
Perth Glory,7895,8,10,2,15,37,50,-13,32
Wellington P,7895,9,5,6,16,31,55,-24,21
CC Mariners,7895,10,4,8,15,28,49,-21,20
Sydney FC,7896,1,21,4,3,66,23,43,67
N'castle Jet,7896,2,16,5,7,60,38,22,53
Melbourne C,7896,3,14,4,11,44,36,8,46
Melbourne V,7896,4,13,5,11,46,40,6,44
Adelaide Utd,7896,5,11,6,11,37,40,-3,39
Brisbane,7896,6,10,5,13,33,42,-9,35
Western Sydn,7896,7,8,9,10,38,47,-9,33
Perth Glory,7896,8,10,2,15,37,50,-13,32
Wellington P,7896,9,5,6,16,31,55,-24,21
CC Mariners,7896,10,4,8,15,28,49,-21,20
Sydney FC,7897,1,21,4,3,65,22,43,67
N'castle Jet,7897,2,16,5,7,60,39,21,53
Melbourne C,7897,3,14,4,11,45,36,9,46
Melbourne V,7897,4,13,5,11,45,39,6,44
Adelaide Utd,7897,5,11,6,11,37,40,-3,39
Brisbane,7897,6,10,5,13,33,42,-9,35
Western Sydn,7897,7,8,9,10,38,47,-9,33
Perth Glory,7897,8,10,2,15,37,50,-13,32
Wellington P,7897,9,5,6,16,31,55,-24,21
CC Mariners,7897,10,4,8,15,28,49,-21,20
Sydney FC,7898,1,21,4,3,66,23,43,67
N'castle Jet,7898,2,16,5,7,60,37,23,53
Melbourne C,7898,3,14,4,11,43,36,7,46
Melbourne V,7898,4,13,5,11,46,40,6,44
Adelaide Utd,7898,5,11,6,11,37,40,-3,39
Brisbane,7898,6,10,5,13,33,42,-9,35
Western Sydn,7898,7,8,9,10,38,47,-9,33
Perth Glory,7898,8,10,2,15,37,50,-13,32
Wellington P,7898,9,5,6,16,31,55,-24,21
CC Mariners,7898,10,4,8,15,28,49,-21,20
Sydney FC,7899,1,21,4,3,66,22,44,67
N'castle Jet,7899,2,15,6,7,58,38,20,51
Melbourne C,7899,3,14,5,10,44,34,10,47
Melbourne V,7899,4,13,5,11,45,40,5,44
Adelaide Utd,7899,5,11,6,11,37,40,-3,39
Brisbane,7899,6,10,5,13,33,42,-9,35
Western Sydn,7899,7,8,9,10,38,47,-9,33
Perth Glory,7899,8,10,2,15,37,50,-13,32
Wellington P,7899,9,5,6,16,31,55,-24,21
CC Mariners,7899,10,4,8,15,28,49,-21,20
Sydney FC,7900,1,20,5,3,64,22,42,65
N'castle Jet,7900,2,16,5,7,62,38,24,53
Melbourne C,7900,3,14,4,11,44,38,6,46
Melbourne V,7900,4,13,6,10,45,38,7,45
Adelaide Utd,7900,5,11,6,11,37,40,-3,39
Brisbane,7900,6,10,5,13,33,42,-9,35
Western Sydn,7900,7,8,9,10,38,47,-9,33
Perth Glory,7900,8,10,2,15,37,50,-13,32
Wellington P,7900,9,5,6,16,31,55,-24,21
CC Mariners,7900,10,4,8,15,28,49,-21,20
Sydney FC,7901,1,21,4,3,67,24,43,67
N'castle Jet,7901,2,15,6,7,60,40,20,51
Melbourne C,7901,3,14,5,10,46,36,10,47
Melbourne V,7901,4,13,5,11,47,41,6,44
Adelaide Utd,7901,5,11,6,11,37,40,-3,39
Brisbane,7901,6,10,5,13,33,42,-9,35
Western Sydn,7901,7,8,9,10,38,47,-9,33
Perth Glory,7901,8,10,2,15,37,50,-13,32
Wellington P,7901,9,5,6,16,31,55,-24,21
CC Mariners,7901,10,4,8,15,28,49,-21,20
Sydney FC,7902,1,21,4,3,67,23,44,67
N'castle Jet,7902,2,15,5,8,57,39,18,50
Melbourne C,7902,3,15,4,10,45,33,12,49
Melbourne V,7902,4,13,5,11,46,41,5,44
Adelaide Utd,7902,5,11,6,11,37,40,-3,39
Brisbane,7902,6,10,5,13,33,42,-9,35
Western Sydn,7902,7,8,9,10,38,47,-9,33
Perth Glory,7902,8,10,2,15,37,50,-13,32
Wellington P,7902,9,5,6,16,31,55,-24,21
CC Mariners,7902,10,4,8,15,28,49,-21,20
Sydney FC,7903,1,21,4,3,66,23,43,67
N'castle Jet,7903,2,16,5,7,59,38,21,53
Melbourne C,7903,3,14,4,11,44,35,9,46
Melbourne V,7903,4,13,5,11,46,40,6,44
Adelaide Utd,7903,5,11,6,11,37,40,-3,39
Brisbane,7903,6,10,5,13,33,42,-9,35
Western Sydn,7903,7,8,9,10,38,47,-9,33
Perth Glory,7903,8,10,2,15,37,50,-13,32
Wellington P,7903,9,5,6,16,31,55,-24,21
CC Mariners,7903,10,4,8,15,28,49,-21,20
Sydney FC,7904,1,21,4,3,65,22,43,67
N'castle Jet,7904,2,16,5,7,60,38,22,53
Melbourne C,7904,3,14,4,11,44,36,8,46
Melbourne V,7904,4,13,5,11,45,39,6,44
Adelaide Utd,7904,5,11,6,11,37,40,-3,39
Brisbane,7904,6,10,5,13,33,42,-9,35
Western Sydn,7904,7,8,9,10,38,47,-9,33
Perth Glory,7904,8,10,2,15,37,50,-13,32
Wellington P,7904,9,5,6,16,31,55,-24,21
CC Mariners,7904,10,4,8,15,28,49,-21,20
Sydney FC,7905,1,20,5,3,66,24,42,65
N'castle Jet,7905,2,16,5,7,61,38,23,53
Melbourne C,7905,3,14,4,11,44,37,7,46
Melbourne V,7905,4,13,6,10,47,40,7,45
Adelaide Utd,7905,5,11,6,11,37,40,-3,39
Brisbane,7905,6,10,5,13,33,42,-9,35
Western Sydn,7905,7,8,9,10,38,47,-9,33
Perth Glory,7905,8,10,2,15,37,50,-13,32
Wellington P,7905,9,5,6,16,31,55,-24,21
CC Mariners,7905,10,4,8,15,28,49,-21,20
Sydney FC,7906,1,21,4,3,66,22,44,67
N'castle Jet,7906,2,16,5,7,61,38,23,53
Melbourne C,7906,3,14,4,11,44,37,7,46
Melbourne V,7906,4,13,5,11,45,40,5,44
Adelaide Utd,7906,5,11,6,11,37,40,-3,39
Brisbane,7906,6,10,5,13,33,42,-9,35
Western Sydn,7906,7,8,9,10,38,47,-9,33
Perth Glory,7906,8,10,2,15,37,50,-13,32
Wellington P,7906,9,5,6,16,31,55,-24,21
CC Mariners,7906,10,4,8,15,28,49,-21,20
Sydney FC,7907,1,21,4,3,68,22,46,67
N'castle Jet,7907,2,16,5,7,59,38,21,53
Melbourne C,7907,3,14,4,11,44,35,9,46
Melbourne V,7907,4,13,5,11,45,42,3,44
Adelaide Utd,7907,5,11,6,11,37,40,-3,39
Brisbane,7907,6,10,5,13,33,42,-9,35
Western Sydn,7907,7,8,9,10,38,47,-9,33
Perth Glory,7907,8,10,2,15,37,50,-13,32
Wellington P,7907,9,5,6,16,31,55,-24,21
CC Mariners,7907,10,4,8,15,28,49,-21,20
Sydney FC,7908,1,20,5,3,65,23,42,65
N'castle Jet,7908,2,16,5,7,60,37,23,53
Melbourne C,7908,3,14,4,11,43,36,7,46
Melbourne V,7908,4,13,6,10,46,39,7,45
Adelaide Utd,7908,5,11,6,11,37,40,-3,39
Brisbane,7908,6,10,5,13,33,42,-9,35
Western Sydn,7908,7,8,9,10,38,47,-9,33
Perth Glory,7908,8,10,2,15,37,50,-13,32
Wellington P,7908,9,5,6,16,31,55,-24,21
CC Mariners,7908,10,4,8,15,28,49,-21,20
Sydney FC,7909,1,21,4,3,66,23,43,67
N'castle Jet,7909,2,15,6,7,57,37,20,51
Melbourne C,7909,3,14,5,10,43,33,10,47
Melbourne V,7909,4,13,5,11,46,40,6,44
Adelaide Utd,7909,5,11,6,11,37,40,-3,39
Brisbane,7909,6,10,5,13,33,42,-9,35
Western Sydn,7909,7,8,9,10,38,47,-9,33
Perth Glory,7909,8,10,2,15,37,50,-13,32
Wellington P,7909,9,5,6,16,31,55,-24,21
CC Mariners,7909,10,4,8,15,28,49,-21,20
Sydney FC,7910,1,20,4,4,64,23,41,64
N'castle Jet,7910,2,15,6,7,59,39,20,51
Melbourne C,7910,3,14,5,10,45,35,10,47
Melbourne V,7910,4,14,5,10,46,38,8,47
Adelaide Utd,7910,5,11,6,11,37,40,-3,39
Brisbane,7910,6,10,5,13,33,42,-9,35
Western Sydn,7910,7,8,9,10,38,47,-9,33
Perth Glory,7910,8,10,2,15,37,50,-13,32
Wellington P,7910,9,5,6,16,31,55,-24,21
CC Mariners,7910,10,4,8,15,28,49,-21,20
Sydney FC,7911,1,21,4,3,67,22,45,67
N'castle Jet,7911,2,15,6,7,58,38,20,51
Melbourne C,7911,3,14,5,10,44,34,10,47
Melbourne V,7911,4,13,5,11,45,41,4,44
Adelaide Utd,7911,5,11,6,11,37,40,-3,39
Brisbane,7911,6,10,5,13,33,42,-9,35
Western Sydn,7911,7,8,9,10,38,47,-9,33
Perth Glory,7911,8,10,2,15,37,50,-13,32
Wellington P,7911,9,5,6,16,31,55,-24,21
CC Mariners,7911,10,4,8,15,28,49,-21,20
Sydney FC,7912,1,20,4,4,64,23,41,64
N'castle Jet,7912,2,15,5,8,58,39,19,50
Melbourne C,7912,3,15,4,10,45,34,11,49
Melbourne V,7912,4,14,5,10,46,38,8,47
Adelaide Utd,7912,5,11,6,11,37,40,-3,39
Brisbane,7912,6,10,5,13,33,42,-9,35
Western Sydn,7912,7,8,9,10,38,47,-9,33
Perth Glory,7912,8,10,2,15,37,50,-13,32
Wellington P,7912,9,5,6,16,31,55,-24,21
CC Mariners,7912,10,4,8,15,28,49,-21,20
Sydney FC,7913,1,20,5,3,66,24,42,65
N'castle Jet,7913,2,15,6,7,58,38,20,51
Melbourne C,7913,3,14,5,10,44,34,10,47
Melbourne V,7913,4,13,6,10,47,40,7,45
Adelaide Utd,7913,5,11,6,11,37,40,-3,39
Brisbane,7913,6,10,5,13,33,42,-9,35
Western Sydn,7913,7,8,9,10,38,47,-9,33
Perth Glory,7913,8,10,2,15,37,50,-13,32
Wellington P,7913,9,5,6,16,31,55,-24,21
CC Mariners,7913,10,4,8,15,28,49,-21,20
Sydney FC,7914,1,21,4,3,66,23,43,67
N'castle Jet,7914,2,16,5,7,59,37,22,53
Melbourne C,7914,3,14,4,11,43,35,8,46
Melbourne V,7914,4,13,5,11,46,40,6,44
Adelaide Utd,7914,5,11,6,11,37,40,-3,39
Brisbane,7914,6,10,5,13,33,42,-9,35
Western Sydn,7914,7,8,9,10,38,47,-9,33
Perth Glory,7914,8,10,2,15,37,50,-13,32
Wellington P,7914,9,5,6,16,31,55,-24,21
CC Mariners,7914,10,4,8,15,28,49,-21,20
Sydney FC,7915,1,21,4,3,68,22,46,67
N'castle Jet,7915,2,15,6,7,59,39,20,51
Melbourne C,7915,3,14,5,10,45,35,10,47
Melbourne V,7915,4,13,5,11,45,42,3,44
Adelaide Utd,7915,5,11,6,11,37,40,-3,39
Brisbane,7915,6,10,5,13,33,42,-9,35
Western Sydn,7915,7,8,9,10,38,47,-9,33
Perth Glory,7915,8,10,2,15,37,50,-13,32
Wellington P,7915,9,5,6,16,31,55,-24,21
CC Mariners,7915,10,4,8,15,28,49,-21,20
Sydney FC,7916,1,20,5,3,64,22,42,65
N'castle Jet,7916,2,15,5,8,57,39,18,50
Melbourne C,7916,3,15,4,10,45,33,12,49
Melbourne V,7916,4,13,6,10,45,38,7,45
Adelaide Utd,7916,5,11,6,11,37,40,-3,39
Brisbane,7916,6,10,5,13,33,42,-9,35
Western Sydn,7916,7,8,9,10,38,47,-9,33
Perth Glory,7916,8,10,2,15,37,50,-13,32
Wellington P,7916,9,5,6,16,31,55,-24,21
CC Mariners,7916,10,4,8,15,28,49,-21,20
Sydney FC,7917,1,21,4,3,65,22,43,67
N'castle Jet,7917,2,15,5,8,58,39,19,50
Melbourne C,7917,3,15,4,10,45,34,11,49
Melbourne V,7917,4,13,5,11,45,39,6,44
Adelaide Utd,7917,5,11,6,11,37,40,-3,39
Brisbane,7917,6,10,5,13,33,42,-9,35
Western Sydn,7917,7,8,9,10,38,47,-9,33
Perth Glory,7917,8,10,2,15,37,50,-13,32
Wellington P,7917,9,5,6,16,31,55,-24,21
CC Mariners,7917,10,4,8,15,28,49,-21,20
Sydney FC,7918,1,20,5,3,67,25,42,65
N'castle Jet,7918,2,15,5,8,58,39,19,50
Melbourne C,7918,3,15,4,10,45,34,11,49
Melbourne V,7918,4,13,6,10,48,41,7,45
Adelaide Utd,7918,5,11,6,11,37,40,-3,39
Brisbane,7918,6,10,5,13,33,42,-9,35
Western Sydn,7918,7,8,9,10,38,47,-9,33
Perth Glory,7918,8,10,2,15,37,50,-13,32
Wellington P,7918,9,5,6,16,31,55,-24,21
CC Mariners,7918,10,4,8,15,28,49,-21,20
Sydney FC,7919,1,21,4,3,68,23,45,67
N'castle Jet,7919,2,15,5,8,57,38,19,50
Melbourne C,7919,3,15,4,10,44,33,11,49
Melbourne V,7919,4,13,5,11,46,42,4,44
Adelaide Utd,7919,5,11,6,11,37,40,-3,39
Brisbane,7919,6,10,5,13,33,42,-9,35
Western Sydn,7919,7,8,9,10,38,47,-9,33
Perth Glory,7919,8,10,2,15,37,50,-13,32
Wellington P,7919,9,5,6,16,31,55,-24,21
CC Mariners,7919,10,4,8,15,28,49,-21,20
Sydney FC,7920,1,20,4,4,66,25,41,64
N'castle Jet,7920,2,16,5,7,59,38,21,53
Melbourne V,7920,3,14,5,10,48,40,8,47
Melbourne C,7920,4,14,4,11,44,35,9,46
Adelaide Utd,7920,5,11,6,11,37,40,-3,39
Brisbane,7920,6,10,5,13,33,42,-9,35
Western Sydn,7920,7,8,9,10,38,47,-9,33
Perth Glory,7920,8,10,2,15,37,50,-13,32
Wellington P,7920,9,5,6,16,31,55,-24,21
CC Mariners,7920,10,4,8,15,28,49,-21,20
Sydney FC,7921,1,20,5,3,67,25,42,65
N'castle Jet,7921,2,16,5,7,59,37,22,53
Melbourne C,7921,3,14,4,11,43,35,8,46
Melbourne V,7921,4,13,6,10,48,41,7,45
Adelaide Utd,7921,5,11,6,11,37,40,-3,39
Brisbane,7921,6,10,5,13,33,42,-9,35
Western Sydn,7921,7,8,9,10,38,47,-9,33
Perth Glory,7921,8,10,2,15,37,50,-13,32
Wellington P,7921,9,5,6,16,31,55,-24,21
CC Mariners,7921,10,4,8,15,28,49,-21,20
Sydney FC,7922,1,21,4,3,66,22,44,67
N'castle Jet,7922,2,16,5,7,59,38,21,53
Melbourne C,7922,3,14,4,11,44,35,9,46
Melbourne V,7922,4,13,5,11,45,40,5,44
Adelaide Utd,7922,5,11,6,11,37,40,-3,39
Brisbane,7922,6,10,5,13,33,42,-9,35
Western Sydn,7922,7,8,9,10,38,47,-9,33
Perth Glory,7922,8,10,2,15,37,50,-13,32
Wellington P,7922,9,5,6,16,31,55,-24,21
CC Mariners,7922,10,4,8,15,28,49,-21,20
Sydney FC,7923,1,21,4,3,67,23,44,67
N'castle Jet,7923,2,15,5,8,57,38,19,50
Melbourne C,7923,3,15,4,10,44,33,11,49
Melbourne V,7923,4,13,5,11,46,41,5,44
Adelaide Utd,7923,5,11,6,11,37,40,-3,39
Brisbane,7923,6,10,5,13,33,42,-9,35
Western Sydn,7923,7,8,9,10,38,47,-9,33
Perth Glory,7923,8,10,2,15,37,50,-13,32
Wellington P,7923,9,5,6,16,31,55,-24,21
CC Mariners,7923,10,4,8,15,28,49,-21,20
Sydney FC,7924,1,20,5,3,65,23,42,65
N'castle Jet,7924,2,15,5,8,58,39,19,50
Melbourne C,7924,3,15,4,10,45,34,11,49
Melbourne V,7924,4,13,6,10,46,39,7,45
Adelaide Utd,7924,5,11,6,11,37,40,-3,39
Brisbane,7924,6,10,5,13,33,42,-9,35
Western Sydn,7924,7,8,9,10,38,47,-9,33
Perth Glory,7924,8,10,2,15,37,50,-13,32
Wellington P,7924,9,5,6,16,31,55,-24,21
CC Mariners,7924,10,4,8,15,28,49,-21,20
Sydney FC,7925,1,20,5,3,65,23,42,65
N'castle Jet,7925,2,15,5,8,59,40,19,50
Melbourne C,7925,3,15,4,10,46,35,11,49
Melbourne V,7925,4,13,6,10,46,39,7,45
Adelaide Utd,7925,5,11,6,11,37,40,-3,39
Brisbane,7925,6,10,5,13,33,42,-9,35
Western Sydn,7925,7,8,9,10,38,47,-9,33
Perth Glory,7925,8,10,2,15,37,50,-13,32
Wellington P,7925,9,5,6,16,31,55,-24,21
CC Mariners,7925,10,4,8,15,28,49,-21,20
Sydney FC,7926,1,21,4,3,66,22,44,67
N'castle Jet,7926,2,15,5,8,59,41,18,50
Melbourne C,7926,3,15,4,10,47,35,12,49
Melbourne V,7926,4,13,5,11,45,40,5,44
Adelaide Utd,7926,5,11,6,11,37,40,-3,39
Brisbane,7926,6,10,5,13,33,42,-9,35
Western Sydn,7926,7,8,9,10,38,47,-9,33
Perth Glory,7926,8,10,2,15,37,50,-13,32
Wellington P,7926,9,5,6,16,31,55,-24,21
CC Mariners,7926,10,4,8,15,28,49,-21,20
Sydney FC,7927,1,20,5,3,65,23,42,65
N'castle Jet,7927,2,16,5,7,59,37,22,53
Melbourne C,7927,3,14,4,11,43,35,8,46
Melbourne V,7927,4,13,6,10,46,39,7,45
Adelaide Utd,7927,5,11,6,11,37,40,-3,39
Brisbane,7927,6,10,5,13,33,42,-9,35
Western Sydn,7927,7,8,9,10,38,47,-9,33
Perth Glory,7927,8,10,2,15,37,50,-13,32
Wellington P,7927,9,5,6,16,31,55,-24,21
CC Mariners,7927,10,4,8,15,28,49,-21,20
Sydney FC,7928,1,21,4,3,65,22,43,67
N'castle Jet,7928,2,16,5,7,59,37,22,53
Melbourne C,7928,3,14,4,11,43,35,8,46
Melbourne V,7928,4,13,5,11,45,39,6,44
Adelaide Utd,7928,5,11,6,11,37,40,-3,39
Brisbane,7928,6,10,5,13,33,42,-9,35
Western Sydn,7928,7,8,9,10,38,47,-9,33
Perth Glory,7928,8,10,2,15,37,50,-13,32
Wellington P,7928,9,5,6,16,31,55,-24,21
CC Mariners,7928,10,4,8,15,28,49,-21,20
Sydney FC,7929,1,20,4,4,64,24,40,64
N'castle Jet,7929,2,16,5,7,60,37,23,53
Melbourne V,7929,3,14,5,10,47,38,9,47
Melbourne C,7929,4,14,4,11,43,36,7,46
Adelaide Utd,7929,5,11,6,11,37,40,-3,39
Brisbane,7929,6,10,5,13,33,42,-9,35
Western Sydn,7929,7,8,9,10,38,47,-9,33
Perth Glory,7929,8,10,2,15,37,50,-13,32
Wellington P,7929,9,5,6,16,31,55,-24,21
CC Mariners,7929,10,4,8,15,28,49,-21,20
Sydney FC,7930,1,20,5,3,65,23,42,65
N'castle Jet,7930,2,16,5,7,59,37,22,53
Melbourne C,7930,3,14,4,11,43,35,8,46
Melbourne V,7930,4,13,6,10,46,39,7,45
Adelaide Utd,7930,5,11,6,11,37,40,-3,39
Brisbane,7930,6,10,5,13,33,42,-9,35
Western Sydn,7930,7,8,9,10,38,47,-9,33
Perth Glory,7930,8,10,2,15,37,50,-13,32
Wellington P,7930,9,5,6,16,31,55,-24,21
CC Mariners,7930,10,4,8,15,28,49,-21,20
Sydney FC,7931,1,20,4,4,64,23,41,64
N'castle Jet,7931,2,16,5,7,58,37,21,53
Melbourne V,7931,3,14,5,10,46,38,8,47
Melbourne C,7931,4,14,4,11,43,34,9,46
Adelaide Utd,7931,5,11,6,11,37,40,-3,39
Brisbane,7931,6,10,5,13,33,42,-9,35
Western Sydn,7931,7,8,9,10,38,47,-9,33
Perth Glory,7931,8,10,2,15,37,50,-13,32
Wellington P,7931,9,5,6,16,31,55,-24,21
CC Mariners,7931,10,4,8,15,28,49,-21,20
Sydney FC,7932,1,21,4,3,68,22,46,67
N'castle Jet,7932,2,16,5,7,59,38,21,53
Melbourne C,7932,3,14,4,11,44,35,9,46
Melbourne V,7932,4,13,5,11,45,42,3,44
Adelaide Utd,7932,5,11,6,11,37,40,-3,39
Brisbane,7932,6,10,5,13,33,42,-9,35
Western Sydn,7932,7,8,9,10,38,47,-9,33
Perth Glory,7932,8,10,2,15,37,50,-13,32
Wellington P,7932,9,5,6,16,31,55,-24,21
CC Mariners,7932,10,4,8,15,28,49,-21,20
Sydney FC,7933,1,21,4,3,66,22,44,67
N'castle Jet,7933,2,15,5,8,57,39,18,50
Melbourne C,7933,3,15,4,10,45,33,12,49
Melbourne V,7933,4,13,5,11,45,40,5,44
Adelaide Utd,7933,5,11,6,11,37,40,-3,39
Brisbane,7933,6,10,5,13,33,42,-9,35
Western Sydn,7933,7,8,9,10,38,47,-9,33
Perth Glory,7933,8,10,2,15,37,50,-13,32
Wellington P,7933,9,5,6,16,31,55,-24,21
CC Mariners,7933,10,4,8,15,28,49,-21,20
Sydney FC,7934,1,21,4,3,65,22,43,67
N'castle Jet,7934,2,15,6,7,59,39,20,51
Melbourne C,7934,3,14,5,10,45,35,10,47
Melbourne V,7934,4,13,5,11,45,39,6,44
Adelaide Utd,7934,5,11,6,11,37,40,-3,39
Brisbane,7934,6,10,5,13,33,42,-9,35
Western Sydn,7934,7,8,9,10,38,47,-9,33
Perth Glory,7934,8,10,2,15,37,50,-13,32
Wellington P,7934,9,5,6,16,31,55,-24,21
CC Mariners,7934,10,4,8,15,28,49,-21,20
Sydney FC,7935,1,21,4,3,66,23,43,67
N'castle Jet,7935,2,16,5,7,60,39,21,53
Melbourne C,7935,3,14,4,11,45,36,9,46
Melbourne V,7935,4,13,5,11,46,40,6,44
Adelaide Utd,7935,5,11,6,11,37,40,-3,39
Brisbane,7935,6,10,5,13,33,42,-9,35
Western Sydn,7935,7,8,9,10,38,47,-9,33
Perth Glory,7935,8,10,2,15,37,50,-13,32
Wellington P,7935,9,5,6,16,31,55,-24,21
CC Mariners,7935,10,4,8,15,28,49,-21,20
Sydney FC,7936,1,21,4,3,66,23,43,67
N'castle Jet,7936,2,16,5,7,59,38,21,53
Melbourne C,7936,3,14,4,11,44,35,9,46
Melbourne V,7936,4,13,5,11,46,40,6,44
Adelaide Utd,7936,5,11,6,11,37,40,-3,39
Brisbane,7936,6,10,5,13,33,42,-9,35
Western Sydn,7936,7,8,9,10,38,47,-9,33
Perth Glory,7936,8,10,2,15,37,50,-13,32
Wellington P,7936,9,5,6,16,31,55,-24,21
CC Mariners,7936,10,4,8,15,28,49,-21,20
Sydney FC,7937,1,20,4,4,64,24,40,64
N'castle Jet,7937,2,15,5,8,57,38,19,50
Melbourne C,7937,3,15,4,10,44,33,11,49
Melbourne V,7937,4,14,5,10,47,38,9,47
Adelaide Utd,7937,5,11,6,11,37,40,-3,39
Brisbane,7937,6,10,5,13,33,42,-9,35
Western Sydn,7937,7,8,9,10,38,47,-9,33
Perth Glory,7937,8,10,2,15,37,50,-13,32
Wellington P,7937,9,5,6,16,31,55,-24,21
CC Mariners,7937,10,4,8,15,28,49,-21,20
Sydney FC,7938,1,20,5,3,65,23,42,65
N'castle Jet,7938,2,15,6,7,60,40,20,51
Melbourne C,7938,3,14,5,10,46,36,10,47
Melbourne V,7938,4,13,6,10,46,39,7,45
Adelaide Utd,7938,5,11,6,11,37,40,-3,39
Brisbane,7938,6,10,5,13,33,42,-9,35
Western Sydn,7938,7,8,9,10,38,47,-9,33
Perth Glory,7938,8,10,2,15,37,50,-13,32
Wellington P,7938,9,5,6,16,31,55,-24,21
CC Mariners,7938,10,4,8,15,28,49,-21,20
Sydney FC,7939,1,21,4,3,67,22,45,67
N'castle Jet,7939,2,15,5,8,57,39,18,50
Melbourne C,7939,3,15,4,10,45,33,12,49
Melbourne V,7939,4,13,5,11,45,41,4,44
Adelaide Utd,7939,5,11,6,11,37,40,-3,39
Brisbane,7939,6,10,5,13,33,42,-9,35
Western Sydn,7939,7,8,9,10,38,47,-9,33
Perth Glory,7939,8,10,2,15,37,50,-13,32
Wellington P,7939,9,5,6,16,31,55,-24,21
CC Mariners,7939,10,4,8,15,28,49,-21,20
Sydney FC,7940,1,20,4,4,64,24,40,64
N'castle Jet,7940,2,16,5,7,60,39,21,53
Melbourne V,7940,3,14,5,10,47,38,9,47
Melbourne C,7940,4,14,4,11,45,36,9,46
Adelaide Utd,7940,5,11,6,11,37,40,-3,39
Brisbane,7940,6,10,5,13,33,42,-9,35
Western Sydn,7940,7,8,9,10,38,47,-9,33
Perth Glory,7940,8,10,2,15,37,50,-13,32
Wellington P,7940,9,5,6,16,31,55,-24,21
CC Mariners,7940,10,4,8,15,28,49,-21,20
Sydney FC,7941,1,21,4,3,66,22,44,67
N'castle Jet,7941,2,16,5,7,60,38,22,53
Melbourne C,7941,3,14,4,11,44,36,8,46
Melbourne V,7941,4,13,5,11,45,40,5,44
Adelaide Utd,7941,5,11,6,11,37,40,-3,39
Brisbane,7941,6,10,5,13,33,42,-9,35
Western Sydn,7941,7,8,9,10,38,47,-9,33
Perth Glory,7941,8,10,2,15,37,50,-13,32
Wellington P,7941,9,5,6,16,31,55,-24,21
CC Mariners,7941,10,4,8,15,28,49,-21,20
Sydney FC,7942,1,20,4,4,64,23,41,64
N'castle Jet,7942,2,15,6,7,58,38,20,51
Melbourne C,7942,3,14,5,10,44,34,10,47
Melbourne V,7942,4,14,5,10,46,38,8,47
Adelaide Utd,7942,5,11,6,11,37,40,-3,39
Brisbane,7942,6,10,5,13,33,42,-9,35
Western Sydn,7942,7,8,9,10,38,47,-9,33
Perth Glory,7942,8,10,2,15,37,50,-13,32
Wellington P,7942,9,5,6,16,31,55,-24,21
CC Mariners,7942,10,4,8,15,28,49,-21,20
Sydney FC,7943,1,21,4,3,66,23,43,67
N'castle Jet,7943,2,16,5,7,61,39,22,53
Melbourne C,7943,3,14,4,11,45,37,8,46
Melbourne V,7943,4,13,5,11,46,40,6,44
Adelaide Utd,7943,5,11,6,11,37,40,-3,39
Brisbane,7943,6,10,5,13,33,42,-9,35
Western Sydn,7943,7,8,9,10,38,47,-9,33
Perth Glory,7943,8,10,2,15,37,50,-13,32
Wellington P,7943,9,5,6,16,31,55,-24,21
CC Mariners,7943,10,4,8,15,28,49,-21,20
Sydney FC,7944,1,20,4,4,65,24,41,64
N'castle Jet,7944,2,15,5,8,58,39,19,50
Melbourne C,7944,3,15,4,10,45,34,11,49
Melbourne V,7944,4,14,5,10,47,39,8,47
Adelaide Utd,7944,5,11,6,11,37,40,-3,39
Brisbane,7944,6,10,5,13,33,42,-9,35
Western Sydn,7944,7,8,9,10,38,47,-9,33
Perth Glory,7944,8,10,2,15,37,50,-13,32
Wellington P,7944,9,5,6,16,31,55,-24,21
CC Mariners,7944,10,4,8,15,28,49,-21,20
Sydney FC,7945,1,21,4,3,67,22,45,67
N'castle Jet,7945,2,16,5,7,60,39,21,53
Melbourne C,7945,3,14,4,11,45,36,9,46
Melbourne V,7945,4,13,5,11,45,41,4,44
Adelaide Utd,7945,5,11,6,11,37,40,-3,39
Brisbane,7945,6,10,5,13,33,42,-9,35
Western Sydn,7945,7,8,9,10,38,47,-9,33
Perth Glory,7945,8,10,2,15,37,50,-13,32
Wellington P,7945,9,5,6,16,31,55,-24,21
CC Mariners,7945,10,4,8,15,28,49,-21,20
Sydney FC,7946,1,20,4,4,64,23,41,64
N'castle Jet,7946,2,16,5,7,59,38,21,53
Melbourne V,7946,3,14,5,10,46,38,8,47
Melbourne C,7946,4,14,4,11,44,35,9,46
Adelaide Utd,7946,5,11,6,11,37,40,-3,39
Brisbane,7946,6,10,5,13,33,42,-9,35
Western Sydn,7946,7,8,9,10,38,47,-9,33
Perth Glory,7946,8,10,2,15,37,50,-13,32
Wellington P,7946,9,5,6,16,31,55,-24,21
CC Mariners,7946,10,4,8,15,28,49,-21,20
Sydney FC,7947,1,21,4,3,65,22,43,67
N'castle Jet,7947,2,16,5,7,59,37,22,53
Melbourne C,7947,3,14,4,11,43,35,8,46
Melbourne V,7947,4,13,5,11,45,39,6,44
Adelaide Utd,7947,5,11,6,11,37,40,-3,39
Brisbane,7947,6,10,5,13,33,42,-9,35
Western Sydn,7947,7,8,9,10,38,47,-9,33
Perth Glory,7947,8,10,2,15,37,50,-13,32
Wellington P,7947,9,5,6,16,31,55,-24,21
CC Mariners,7947,10,4,8,15,28,49,-21,20
Sydney FC,7948,1,20,5,3,65,23,42,65
N'castle Jet,7948,2,16,5,7,60,38,22,53
Melbourne C,7948,3,14,4,11,44,36,8,46
Melbourne V,7948,4,13,6,10,46,39,7,45
Adelaide Utd,7948,5,11,6,11,37,40,-3,39
Brisbane,7948,6,10,5,13,33,42,-9,35
Western Sydn,7948,7,8,9,10,38,47,-9,33
Perth Glory,7948,8,10,2,15,37,50,-13,32
Wellington P,7948,9,5,6,16,31,55,-24,21
CC Mariners,7948,10,4,8,15,28,49,-21,20
Sydney FC,7949,1,20,4,4,64,23,41,64
N'castle Jet,7949,2,16,5,7,60,39,21,53
Melbourne V,7949,3,14,5,10,46,38,8,47
Melbourne C,7949,4,14,4,11,45,36,9,46
Adelaide Utd,7949,5,11,6,11,37,40,-3,39
Brisbane,7949,6,10,5,13,33,42,-9,35
Western Sydn,7949,7,8,9,10,38,47,-9,33
Perth Glory,7949,8,10,2,15,37,50,-13,32
Wellington P,7949,9,5,6,16,31,55,-24,21
CC Mariners,7949,10,4,8,15,28,49,-21,20
Sydney FC,7950,1,21,4,3,69,22,47,67
N'castle Jet,7950,2,15,5,8,58,39,19,50
Melbourne C,7950,3,15,4,10,45,34,11,49
Melbourne V,7950,4,13,5,11,45,43,2,44
Adelaide Utd,7950,5,11,6,11,37,40,-3,39
Brisbane,7950,6,10,5,13,33,42,-9,35
Western Sydn,7950,7,8,9,10,38,47,-9,33
Perth Glory,7950,8,10,2,15,37,50,-13,32
Wellington P,7950,9,5,6,16,31,55,-24,21
CC Mariners,7950,10,4,8,15,28,49,-21,20
Sydney FC,7951,1,20,5,3,65,23,42,65
N'castle Jet,7951,2,16,5,7,59,37,22,53
Melbourne C,7951,3,14,4,11,43,35,8,46
Melbourne V,7951,4,13,6,10,46,39,7,45
Adelaide Utd,7951,5,11,6,11,37,40,-3,39
Brisbane,7951,6,10,5,13,33,42,-9,35
Western Sydn,7951,7,8,9,10,38,47,-9,33
Perth Glory,7951,8,10,2,15,37,50,-13,32
Wellington P,7951,9,5,6,16,31,55,-24,21
CC Mariners,7951,10,4,8,15,28,49,-21,20
Sydney FC,7952,1,21,4,3,68,22,46,67
N'castle Jet,7952,2,16,5,7,61,38,23,53
Melbourne C,7952,3,14,4,11,44,37,7,46
Melbourne V,7952,4,13,5,11,45,42,3,44
Adelaide Utd,7952,5,11,6,11,37,40,-3,39
Brisbane,7952,6,10,5,13,33,42,-9,35
Western Sydn,7952,7,8,9,10,38,47,-9,33
Perth Glory,7952,8,10,2,15,37,50,-13,32
Wellington P,7952,9,5,6,16,31,55,-24,21
CC Mariners,7952,10,4,8,15,28,49,-21,20
Sydney FC,7953,1,21,4,3,66,22,44,67
N'castle Jet,7953,2,16,5,7,61,38,23,53
Melbourne C,7953,3,14,4,11,44,37,7,46
Melbourne V,7953,4,13,5,11,45,40,5,44
Adelaide Utd,7953,5,11,6,11,37,40,-3,39
Brisbane,7953,6,10,5,13,33,42,-9,35
Western Sydn,7953,7,8,9,10,38,47,-9,33
Perth Glory,7953,8,10,2,15,37,50,-13,32
Wellington P,7953,9,5,6,16,31,55,-24,21
CC Mariners,7953,10,4,8,15,28,49,-21,20
Sydney FC,7954,1,21,4,3,65,22,43,67
N'castle Jet,7954,2,15,6,7,58,38,20,51
Melbourne C,7954,3,14,5,10,44,34,10,47
Melbourne V,7954,4,13,5,11,45,39,6,44
Adelaide Utd,7954,5,11,6,11,37,40,-3,39
Brisbane,7954,6,10,5,13,33,42,-9,35
Western Sydn,7954,7,8,9,10,38,47,-9,33
Perth Glory,7954,8,10,2,15,37,50,-13,32
Wellington P,7954,9,5,6,16,31,55,-24,21
CC Mariners,7954,10,4,8,15,28,49,-21,20
Sydney FC,7955,1,21,4,3,66,23,43,67
N'castle Jet,7955,2,15,5,8,59,43,16,50
Melbourne C,7955,3,15,4,10,49,35,14,49
Melbourne V,7955,4,13,5,11,46,40,6,44
Adelaide Utd,7955,5,11,6,11,37,40,-3,39
Brisbane,7955,6,10,5,13,33,42,-9,35
Western Sydn,7955,7,8,9,10,38,47,-9,33
Perth Glory,7955,8,10,2,15,37,50,-13,32
Wellington P,7955,9,5,6,16,31,55,-24,21
CC Mariners,7955,10,4,8,15,28,49,-21,20
Sydney FC,7956,1,21,4,3,68,22,46,67
N'castle Jet,7956,2,15,5,8,58,39,19,50
Melbourne C,7956,3,15,4,10,45,34,11,49
Melbourne V,7956,4,13,5,11,45,42,3,44
Adelaide Utd,7956,5,11,6,11,37,40,-3,39
Brisbane,7956,6,10,5,13,33,42,-9,35
Western Sydn,7956,7,8,9,10,38,47,-9,33
Perth Glory,7956,8,10,2,15,37,50,-13,32
Wellington P,7956,9,5,6,16,31,55,-24,21
CC Mariners,7956,10,4,8,15,28,49,-21,20
Sydney FC,7957,1,21,4,3,70,23,47,67
N'castle Jet,7957,2,16,5,7,61,38,23,53
Melbourne C,7957,3,14,4,11,44,37,7,46
Melbourne V,7957,4,13,5,11,46,44,2,44
Adelaide Utd,7957,5,11,6,11,37,40,-3,39
Brisbane,7957,6,10,5,13,33,42,-9,35
Western Sydn,7957,7,8,9,10,38,47,-9,33
Perth Glory,7957,8,10,2,15,37,50,-13,32
Wellington P,7957,9,5,6,16,31,55,-24,21
CC Mariners,7957,10,4,8,15,28,49,-21,20
Sydney FC,7958,1,21,4,3,68,23,45,67
N'castle Jet,7958,2,15,6,7,57,37,20,51
Melbourne C,7958,3,14,5,10,43,33,10,47
Melbourne V,7958,4,13,5,11,46,42,4,44
Adelaide Utd,7958,5,11,6,11,37,40,-3,39
Brisbane,7958,6,10,5,13,33,42,-9,35
Western Sydn,7958,7,8,9,10,38,47,-9,33
Perth Glory,7958,8,10,2,15,37,50,-13,32
Wellington P,7958,9,5,6,16,31,55,-24,21
CC Mariners,7958,10,4,8,15,28,49,-21,20
Sydney FC,7959,1,20,4,4,65,24,41,64
N'castle Jet,7959,2,15,6,7,60,40,20,51
Melbourne C,7959,3,14,5,10,46,36,10,47
Melbourne V,7959,4,14,5,10,47,39,8,47
Adelaide Utd,7959,5,11,6,11,37,40,-3,39
Brisbane,7959,6,10,5,13,33,42,-9,35
Western Sydn,7959,7,8,9,10,38,47,-9,33
Perth Glory,7959,8,10,2,15,37,50,-13,32
Wellington P,7959,9,5,6,16,31,55,-24,21
CC Mariners,7959,10,4,8,15,28,49,-21,20
Sydney FC,7960,1,20,4,4,65,26,39,64
N'castle Jet,7960,2,16,5,7,59,38,21,53
Melbourne V,7960,3,14,5,10,49,39,10,47
Melbourne C,7960,4,14,4,11,44,35,9,46
Adelaide Utd,7960,5,11,6,11,37,40,-3,39
Brisbane,7960,6,10,5,13,33,42,-9,35
Western Sydn,7960,7,8,9,10,38,47,-9,33
Perth Glory,7960,8,10,2,15,37,50,-13,32
Wellington P,7960,9,5,6,16,31,55,-24,21
CC Mariners,7960,10,4,8,15,28,49,-21,20
Sydney FC,7961,1,21,4,3,65,22,43,67
N'castle Jet,7961,2,16,5,7,59,37,22,53
Melbourne C,7961,3,14,4,11,43,35,8,46
Melbourne V,7961,4,13,5,11,45,39,6,44
Adelaide Utd,7961,5,11,6,11,37,40,-3,39
Brisbane,7961,6,10,5,13,33,42,-9,35
Western Sydn,7961,7,8,9,10,38,47,-9,33
Perth Glory,7961,8,10,2,15,37,50,-13,32
Wellington P,7961,9,5,6,16,31,55,-24,21
CC Mariners,7961,10,4,8,15,28,49,-21,20
Sydney FC,7962,1,21,4,3,68,23,45,67
N'castle Jet,7962,2,15,6,7,58,38,20,51
Melbourne C,7962,3,14,5,10,44,34,10,47
Melbourne V,7962,4,13,5,11,46,42,4,44
Adelaide Utd,7962,5,11,6,11,37,40,-3,39
Brisbane,7962,6,10,5,13,33,42,-9,35
Western Sydn,7962,7,8,9,10,38,47,-9,33
Perth Glory,7962,8,10,2,15,37,50,-13,32
Wellington P,7962,9,5,6,16,31,55,-24,21
CC Mariners,7962,10,4,8,15,28,49,-21,20
Sydney FC,7963,1,20,5,3,66,24,42,65
N'castle Jet,7963,2,16,5,7,61,38,23,53
Melbourne C,7963,3,14,4,11,44,37,7,46
Melbourne V,7963,4,13,6,10,47,40,7,45
Adelaide Utd,7963,5,11,6,11,37,40,-3,39
Brisbane,7963,6,10,5,13,33,42,-9,35
Western Sydn,7963,7,8,9,10,38,47,-9,33
Perth Glory,7963,8,10,2,15,37,50,-13,32
Wellington P,7963,9,5,6,16,31,55,-24,21
CC Mariners,7963,10,4,8,15,28,49,-21,20
Sydney FC,7964,1,20,5,3,65,23,42,65
N'castle Jet,7964,2,16,5,7,60,39,21,53
Melbourne C,7964,3,14,4,11,45,36,9,46
Melbourne V,7964,4,13,6,10,46,39,7,45
Adelaide Utd,7964,5,11,6,11,37,40,-3,39
Brisbane,7964,6,10,5,13,33,42,-9,35
Western Sydn,7964,7,8,9,10,38,47,-9,33
Perth Glory,7964,8,10,2,15,37,50,-13,32
Wellington P,7964,9,5,6,16,31,55,-24,21
CC Mariners,7964,10,4,8,15,28,49,-21,20
Sydney FC,7965,1,21,4,3,66,23,43,67
N'castle Jet,7965,2,15,5,8,59,40,19,50
Melbourne C,7965,3,15,4,10,46,35,11,49
Melbourne V,7965,4,13,5,11,46,40,6,44
Adelaide Utd,7965,5,11,6,11,37,40,-3,39
Brisbane,7965,6,10,5,13,33,42,-9,35
Western Sydn,7965,7,8,9,10,38,47,-9,33
Perth Glory,7965,8,10,2,15,37,50,-13,32
Wellington P,7965,9,5,6,16,31,55,-24,21
CC Mariners,7965,10,4,8,15,28,49,-21,20
Sydney FC,7966,1,21,4,3,67,23,44,67
N'castle Jet,7966,2,15,5,8,58,39,19,50
Melbourne C,7966,3,15,4,10,45,34,11,49
Melbourne V,7966,4,13,5,11,46,41,5,44
Adelaide Utd,7966,5,11,6,11,37,40,-3,39
Brisbane,7966,6,10,5,13,33,42,-9,35
Western Sydn,7966,7,8,9,10,38,47,-9,33
Perth Glory,7966,8,10,2,15,37,50,-13,32
Wellington P,7966,9,5,6,16,31,55,-24,21
CC Mariners,7966,10,4,8,15,28,49,-21,20
Sydney FC,7967,1,21,4,3,66,23,43,67
N'castle Jet,7967,2,15,6,7,57,37,20,51
Melbourne C,7967,3,14,5,10,43,33,10,47
Melbourne V,7967,4,13,5,11,46,40,6,44
Adelaide Utd,7967,5,11,6,11,37,40,-3,39
Brisbane,7967,6,10,5,13,33,42,-9,35
Western Sydn,7967,7,8,9,10,38,47,-9,33
Perth Glory,7967,8,10,2,15,37,50,-13,32
Wellington P,7967,9,5,6,16,31,55,-24,21
CC Mariners,7967,10,4,8,15,28,49,-21,20
Sydney FC,7968,1,21,4,3,69,23,46,67
N'castle Jet,7968,2,15,6,7,57,37,20,51
Melbourne C,7968,3,14,5,10,43,33,10,47
Melbourne V,7968,4,13,5,11,46,43,3,44
Adelaide Utd,7968,5,11,6,11,37,40,-3,39
Brisbane,7968,6,10,5,13,33,42,-9,35
Western Sydn,7968,7,8,9,10,38,47,-9,33
Perth Glory,7968,8,10,2,15,37,50,-13,32
Wellington P,7968,9,5,6,16,31,55,-24,21
CC Mariners,7968,10,4,8,15,28,49,-21,20
Sydney FC,7969,1,21,4,3,65,22,43,67
N'castle Jet,7969,2,15,6,7,57,37,20,51
Melbourne C,7969,3,14,5,10,43,33,10,47
Melbourne V,7969,4,13,5,11,45,39,6,44
Adelaide Utd,7969,5,11,6,11,37,40,-3,39
Brisbane,7969,6,10,5,13,33,42,-9,35
Western Sydn,7969,7,8,9,10,38,47,-9,33
Perth Glory,7969,8,10,2,15,37,50,-13,32
Wellington P,7969,9,5,6,16,31,55,-24,21
CC Mariners,7969,10,4,8,15,28,49,-21,20
Sydney FC,7970,1,21,4,3,67,23,44,67
N'castle Jet,7970,2,16,5,7,59,37,22,53
Melbourne C,7970,3,14,4,11,43,35,8,46
Melbourne V,7970,4,13,5,11,46,41,5,44
Adelaide Utd,7970,5,11,6,11,37,40,-3,39
Brisbane,7970,6,10,5,13,33,42,-9,35
Western Sydn,7970,7,8,9,10,38,47,-9,33
Perth Glory,7970,8,10,2,15,37,50,-13,32
Wellington P,7970,9,5,6,16,31,55,-24,21
CC Mariners,7970,10,4,8,15,28,49,-21,20
Sydney FC,7971,1,21,4,3,67,22,45,67
N'castle Jet,7971,2,16,5,7,59,37,22,53
Melbourne C,7971,3,14,4,11,43,35,8,46
Melbourne V,7971,4,13,5,11,45,41,4,44
Adelaide Utd,7971,5,11,6,11,37,40,-3,39
Brisbane,7971,6,10,5,13,33,42,-9,35
Western Sydn,7971,7,8,9,10,38,47,-9,33
Perth Glory,7971,8,10,2,15,37,50,-13,32
Wellington P,7971,9,5,6,16,31,55,-24,21
CC Mariners,7971,10,4,8,15,28,49,-21,20
Sydney FC,7972,1,20,4,4,65,24,41,64
N'castle Jet,7972,2,15,6,7,57,37,20,51
Melbourne C,7972,3,14,5,10,43,33,10,47
Melbourne V,7972,4,14,5,10,47,39,8,47
Adelaide Utd,7972,5,11,6,11,37,40,-3,39
Brisbane,7972,6,10,5,13,33,42,-9,35
Western Sydn,7972,7,8,9,10,38,47,-9,33
Perth Glory,7972,8,10,2,15,37,50,-13,32
Wellington P,7972,9,5,6,16,31,55,-24,21
CC Mariners,7972,10,4,8,15,28,49,-21,20
Sydney FC,7973,1,21,4,3,65,22,43,67
N'castle Jet,7973,2,16,5,7,60,38,22,53
Melbourne C,7973,3,14,4,11,44,36,8,46
Melbourne V,7973,4,13,5,11,45,39,6,44
Adelaide Utd,7973,5,11,6,11,37,40,-3,39
Brisbane,7973,6,10,5,13,33,42,-9,35
Western Sydn,7973,7,8,9,10,38,47,-9,33
Perth Glory,7973,8,10,2,15,37,50,-13,32
Wellington P,7973,9,5,6,16,31,55,-24,21
CC Mariners,7973,10,4,8,15,28,49,-21,20
Sydney FC,7974,1,20,5,3,64,22,42,65
N'castle Jet,7974,2,15,6,7,57,37,20,51
Melbourne C,7974,3,14,5,10,43,33,10,47
Melbourne V,7974,4,13,6,10,45,38,7,45
Adelaide Utd,7974,5,11,6,11,37,40,-3,39
Brisbane,7974,6,10,5,13,33,42,-9,35
Western Sydn,7974,7,8,9,10,38,47,-9,33
Perth Glory,7974,8,10,2,15,37,50,-13,32
Wellington P,7974,9,5,6,16,31,55,-24,21
CC Mariners,7974,10,4,8,15,28,49,-21,20
Sydney FC,7975,1,21,4,3,68,22,46,67
N'castle Jet,7975,2,16,5,7,59,38,21,53
Melbourne C,7975,3,14,4,11,44,35,9,46
Melbourne V,7975,4,13,5,11,45,42,3,44
Adelaide Utd,7975,5,11,6,11,37,40,-3,39
Brisbane,7975,6,10,5,13,33,42,-9,35
Western Sydn,7975,7,8,9,10,38,47,-9,33
Perth Glory,7975,8,10,2,15,37,50,-13,32
Wellington P,7975,9,5,6,16,31,55,-24,21
CC Mariners,7975,10,4,8,15,28,49,-21,20
Sydney FC,7976,1,21,4,3,66,23,43,67
N'castle Jet,7976,2,15,6,7,58,38,20,51
Melbourne C,7976,3,14,5,10,44,34,10,47
Melbourne V,7976,4,13,5,11,46,40,6,44
Adelaide Utd,7976,5,11,6,11,37,40,-3,39
Brisbane,7976,6,10,5,13,33,42,-9,35
Western Sydn,7976,7,8,9,10,38,47,-9,33
Perth Glory,7976,8,10,2,15,37,50,-13,32
Wellington P,7976,9,5,6,16,31,55,-24,21
CC Mariners,7976,10,4,8,15,28,49,-21,20
Sydney FC,7977,1,21,4,3,66,23,43,67
N'castle Jet,7977,2,16,5,7,60,39,21,53
Melbourne C,7977,3,14,4,11,45,36,9,46
Melbourne V,7977,4,13,5,11,46,40,6,44
Adelaide Utd,7977,5,11,6,11,37,40,-3,39
Brisbane,7977,6,10,5,13,33,42,-9,35
Western Sydn,7977,7,8,9,10,38,47,-9,33
Perth Glory,7977,8,10,2,15,37,50,-13,32
Wellington P,7977,9,5,6,16,31,55,-24,21
CC Mariners,7977,10,4,8,15,28,49,-21,20
Sydney FC,7978,1,21,4,3,66,22,44,67
N'castle Jet,7978,2,15,5,8,58,41,17,50
Melbourne C,7978,3,15,4,10,47,34,13,49
Melbourne V,7978,4,13,5,11,45,40,5,44
Adelaide Utd,7978,5,11,6,11,37,40,-3,39
Brisbane,7978,6,10,5,13,33,42,-9,35
Western Sydn,7978,7,8,9,10,38,47,-9,33
Perth Glory,7978,8,10,2,15,37,50,-13,32
Wellington P,7978,9,5,6,16,31,55,-24,21
CC Mariners,7978,10,4,8,15,28,49,-21,20
Sydney FC,7979,1,21,4,3,67,24,43,67
N'castle Jet,7979,2,15,6,7,59,39,20,51
Melbourne C,7979,3,14,5,10,45,35,10,47
Melbourne V,7979,4,13,5,11,47,41,6,44
Adelaide Utd,7979,5,11,6,11,37,40,-3,39
Brisbane,7979,6,10,5,13,33,42,-9,35
Western Sydn,7979,7,8,9,10,38,47,-9,33
Perth Glory,7979,8,10,2,15,37,50,-13,32
Wellington P,7979,9,5,6,16,31,55,-24,21
CC Mariners,7979,10,4,8,15,28,49,-21,20
Sydney FC,7980,1,21,4,3,67,24,43,67
N'castle Jet,7980,2,15,5,8,58,40,18,50
Melbourne C,7980,3,15,4,10,46,34,12,49
Melbourne V,7980,4,13,5,11,47,41,6,44
Adelaide Utd,7980,5,11,6,11,37,40,-3,39
Brisbane,7980,6,10,5,13,33,42,-9,35
Western Sydn,7980,7,8,9,10,38,47,-9,33
Perth Glory,7980,8,10,2,15,37,50,-13,32
Wellington P,7980,9,5,6,16,31,55,-24,21
CC Mariners,7980,10,4,8,15,28,49,-21,20
Sydney FC,7981,1,20,4,4,64,23,41,64
N'castle Jet,7981,2,15,5,8,57,42,15,50
Melbourne C,7981,3,15,4,10,48,33,15,49
Melbourne V,7981,4,14,5,10,46,38,8,47
Adelaide Utd,7981,5,11,6,11,37,40,-3,39
Brisbane,7981,6,10,5,13,33,42,-9,35
Western Sydn,7981,7,8,9,10,38,47,-9,33
Perth Glory,7981,8,10,2,15,37,50,-13,32
Wellington P,7981,9,5,6,16,31,55,-24,21
CC Mariners,7981,10,4,8,15,28,49,-21,20
Sydney FC,7982,1,21,4,3,68,23,45,67
N'castle Jet,7982,2,16,5,7,59,38,21,53
Melbourne C,7982,3,14,4,11,44,35,9,46
Melbourne V,7982,4,13,5,11,46,42,4,44
Adelaide Utd,7982,5,11,6,11,37,40,-3,39
Brisbane,7982,6,10,5,13,33,42,-9,35
Western Sydn,7982,7,8,9,10,38,47,-9,33
Perth Glory,7982,8,10,2,15,37,50,-13,32
Wellington P,7982,9,5,6,16,31,55,-24,21
CC Mariners,7982,10,4,8,15,28,49,-21,20
Sydney FC,7983,1,21,4,3,67,23,44,67
N'castle Jet,7983,2,16,5,7,58,37,21,53
Melbourne C,7983,3,14,4,11,43,34,9,46
Melbourne V,7983,4,13,5,11,46,41,5,44
Adelaide Utd,7983,5,11,6,11,37,40,-3,39
Brisbane,7983,6,10,5,13,33,42,-9,35
Western Sydn,7983,7,8,9,10,38,47,-9,33
Perth Glory,7983,8,10,2,15,37,50,-13,32
Wellington P,7983,9,5,6,16,31,55,-24,21
CC Mariners,7983,10,4,8,15,28,49,-21,20
Sydney FC,7984,1,21,4,3,67,22,45,67
N'castle Jet,7984,2,16,5,7,60,38,22,53
Melbourne C,7984,3,14,4,11,44,36,8,46
Melbourne V,7984,4,13,5,11,45,41,4,44
Adelaide Utd,7984,5,11,6,11,37,40,-3,39
Brisbane,7984,6,10,5,13,33,42,-9,35
Western Sydn,7984,7,8,9,10,38,47,-9,33
Perth Glory,7984,8,10,2,15,37,50,-13,32
Wellington P,7984,9,5,6,16,31,55,-24,21
CC Mariners,7984,10,4,8,15,28,49,-21,20
Sydney FC,7985,1,21,4,3,69,22,47,67
N'castle Jet,7985,2,16,5,7,60,38,22,53
Melbourne C,7985,3,14,4,11,44,36,8,46
Melbourne V,7985,4,13,5,11,45,43,2,44
Adelaide Utd,7985,5,11,6,11,37,40,-3,39
Brisbane,7985,6,10,5,13,33,42,-9,35
Western Sydn,7985,7,8,9,10,38,47,-9,33
Perth Glory,7985,8,10,2,15,37,50,-13,32
Wellington P,7985,9,5,6,16,31,55,-24,21
CC Mariners,7985,10,4,8,15,28,49,-21,20
Sydney FC,7986,1,20,4,4,64,24,40,64
N'castle Jet,7986,2,16,5,7,59,38,21,53
Melbourne V,7986,3,14,5,10,47,38,9,47
Melbourne C,7986,4,14,4,11,44,35,9,46
Adelaide Utd,7986,5,11,6,11,37,40,-3,39
Brisbane,7986,6,10,5,13,33,42,-9,35
Western Sydn,7986,7,8,9,10,38,47,-9,33
Perth Glory,7986,8,10,2,15,37,50,-13,32
Wellington P,7986,9,5,6,16,31,55,-24,21
CC Mariners,7986,10,4,8,15,28,49,-21,20
Sydney FC,7987,1,21,4,3,65,22,43,67
N'castle Jet,7987,2,16,5,7,59,37,22,53
Melbourne C,7987,3,14,4,11,43,35,8,46
Melbourne V,7987,4,13,5,11,45,39,6,44
Adelaide Utd,7987,5,11,6,11,37,40,-3,39
Brisbane,7987,6,10,5,13,33,42,-9,35
Western Sydn,7987,7,8,9,10,38,47,-9,33
Perth Glory,7987,8,10,2,15,37,50,-13,32
Wellington P,7987,9,5,6,16,31,55,-24,21
CC Mariners,7987,10,4,8,15,28,49,-21,20
Sydney FC,7988,1,20,5,3,67,25,42,65
N'castle Jet,7988,2,16,5,7,60,38,22,53
Melbourne C,7988,3,14,4,11,44,36,8,46
Melbourne V,7988,4,13,6,10,48,41,7,45
Adelaide Utd,7988,5,11,6,11,37,40,-3,39
Brisbane,7988,6,10,5,13,33,42,-9,35
Western Sydn,7988,7,8,9,10,38,47,-9,33
Perth Glory,7988,8,10,2,15,37,50,-13,32
Wellington P,7988,9,5,6,16,31,55,-24,21
CC Mariners,7988,10,4,8,15,28,49,-21,20
Sydney FC,7989,1,21,4,3,65,22,43,67
N'castle Jet,7989,2,16,5,7,60,39,21,53
Melbourne C,7989,3,14,4,11,45,36,9,46
Melbourne V,7989,4,13,5,11,45,39,6,44
Adelaide Utd,7989,5,11,6,11,37,40,-3,39
Brisbane,7989,6,10,5,13,33,42,-9,35
Western Sydn,7989,7,8,9,10,38,47,-9,33
Perth Glory,7989,8,10,2,15,37,50,-13,32
Wellington P,7989,9,5,6,16,31,55,-24,21
CC Mariners,7989,10,4,8,15,28,49,-21,20
Sydney FC,7990,1,21,4,3,68,25,43,67
N'castle Jet,7990,2,15,6,7,59,39,20,51
Melbourne C,7990,3,14,5,10,45,35,10,47
Melbourne V,7990,4,13,5,11,48,42,6,44
Adelaide Utd,7990,5,11,6,11,37,40,-3,39
Brisbane,7990,6,10,5,13,33,42,-9,35
Western Sydn,7990,7,8,9,10,38,47,-9,33
Perth Glory,7990,8,10,2,15,37,50,-13,32
Wellington P,7990,9,5,6,16,31,55,-24,21
CC Mariners,7990,10,4,8,15,28,49,-21,20
Sydney FC,7991,1,21,4,3,66,22,44,67
N'castle Jet,7991,2,15,5,8,57,39,18,50
Melbourne C,7991,3,15,4,10,45,33,12,49
Melbourne V,7991,4,13,5,11,45,40,5,44
Adelaide Utd,7991,5,11,6,11,37,40,-3,39
Brisbane,7991,6,10,5,13,33,42,-9,35
Western Sydn,7991,7,8,9,10,38,47,-9,33
Perth Glory,7991,8,10,2,15,37,50,-13,32
Wellington P,7991,9,5,6,16,31,55,-24,21
CC Mariners,7991,10,4,8,15,28,49,-21,20
Sydney FC,7992,1,20,4,4,64,24,40,64
N'castle Jet,7992,2,16,5,7,59,37,22,53
Melbourne V,7992,3,14,5,10,47,38,9,47
Melbourne C,7992,4,14,4,11,43,35,8,46
Adelaide Utd,7992,5,11,6,11,37,40,-3,39
Brisbane,7992,6,10,5,13,33,42,-9,35
Western Sydn,7992,7,8,9,10,38,47,-9,33
Perth Glory,7992,8,10,2,15,37,50,-13,32
Wellington P,7992,9,5,6,16,31,55,-24,21
CC Mariners,7992,10,4,8,15,28,49,-21,20
Sydney FC,7993,1,21,4,3,68,24,44,67
N'castle Jet,7993,2,15,5,8,57,39,18,50
Melbourne C,7993,3,15,4,10,45,33,12,49
Melbourne V,7993,4,13,5,11,47,42,5,44
Adelaide Utd,7993,5,11,6,11,37,40,-3,39
Brisbane,7993,6,10,5,13,33,42,-9,35
Western Sydn,7993,7,8,9,10,38,47,-9,33
Perth Glory,7993,8,10,2,15,37,50,-13,32
Wellington P,7993,9,5,6,16,31,55,-24,21
CC Mariners,7993,10,4,8,15,28,49,-21,20
Sydney FC,7994,1,21,4,3,68,24,44,67
N'castle Jet,7994,2,15,5,8,57,40,17,50
Melbourne C,7994,3,15,4,10,46,33,13,49
Melbourne V,7994,4,13,5,11,47,42,5,44
Adelaide Utd,7994,5,11,6,11,37,40,-3,39
Brisbane,7994,6,10,5,13,33,42,-9,35
Western Sydn,7994,7,8,9,10,38,47,-9,33
Perth Glory,7994,8,10,2,15,37,50,-13,32
Wellington P,7994,9,5,6,16,31,55,-24,21
CC Mariners,7994,10,4,8,15,28,49,-21,20
Sydney FC,7995,1,21,4,3,67,24,43,67
N'castle Jet,7995,2,15,6,7,58,38,20,51
Melbourne C,7995,3,14,5,10,44,34,10,47
Melbourne V,7995,4,13,5,11,47,41,6,44
Adelaide Utd,7995,5,11,6,11,37,40,-3,39
Brisbane,7995,6,10,5,13,33,42,-9,35
Western Sydn,7995,7,8,9,10,38,47,-9,33
Perth Glory,7995,8,10,2,15,37,50,-13,32
Wellington P,7995,9,5,6,16,31,55,-24,21
CC Mariners,7995,10,4,8,15,28,49,-21,20
Sydney FC,7996,1,21,4,3,68,22,46,67
N'castle Jet,7996,2,16,5,7,59,37,22,53
Melbourne C,7996,3,14,4,11,43,35,8,46
Melbourne V,7996,4,13,5,11,45,42,3,44
Adelaide Utd,7996,5,11,6,11,37,40,-3,39
Brisbane,7996,6,10,5,13,33,42,-9,35
Western Sydn,7996,7,8,9,10,38,47,-9,33
Perth Glory,7996,8,10,2,15,37,50,-13,32
Wellington P,7996,9,5,6,16,31,55,-24,21
CC Mariners,7996,10,4,8,15,28,49,-21,20
Sydney FC,7997,1,20,4,4,64,23,41,64
N'castle Jet,7997,2,16,5,7,58,37,21,53
Melbourne V,7997,3,14,5,10,46,38,8,47
Melbourne C,7997,4,14,4,11,43,34,9,46
Adelaide Utd,7997,5,11,6,11,37,40,-3,39
Brisbane,7997,6,10,5,13,33,42,-9,35
Western Sydn,7997,7,8,9,10,38,47,-9,33
Perth Glory,7997,8,10,2,15,37,50,-13,32
Wellington P,7997,9,5,6,16,31,55,-24,21
CC Mariners,7997,10,4,8,15,28,49,-21,20
Sydney FC,7998,1,21,4,3,66,23,43,67
N'castle Jet,7998,2,16,5,7,65,41,24,53
Melbourne C,7998,3,14,4,11,47,41,6,46
Melbourne V,7998,4,13,5,11,46,40,6,44
Adelaide Utd,7998,5,11,6,11,37,40,-3,39
Brisbane,7998,6,10,5,13,33,42,-9,35
Western Sydn,7998,7,8,9,10,38,47,-9,33
Perth Glory,7998,8,10,2,15,37,50,-13,32
Wellington P,7998,9,5,6,16,31,55,-24,21
CC Mariners,7998,10,4,8,15,28,49,-21,20
Sydney FC,7999,1,20,4,4,65,24,41,64
N'castle Jet,7999,2,15,6,7,57,37,20,51
Melbourne C,7999,3,14,5,10,43,33,10,47
Melbourne V,7999,4,14,5,10,47,39,8,47
Adelaide Utd,7999,5,11,6,11,37,40,-3,39
Brisbane,7999,6,10,5,13,33,42,-9,35
Western Sydn,7999,7,8,9,10,38,47,-9,33
Perth Glory,7999,8,10,2,15,37,50,-13,32
Wellington P,7999,9,5,6,16,31,55,-24,21
CC Mariners,7999,10,4,8,15,28,49,-21,20
Sydney FC,8000,1,21,4,3,67,22,45,67
N'castle Jet,8000,2,15,6,7,58,38,20,51
Melbourne C,8000,3,14,5,10,44,34,10,47
Melbourne V,8000,4,13,5,11,45,41,4,44
Adelaide Utd,8000,5,11,6,11,37,40,-3,39
Brisbane,8000,6,10,5,13,33,42,-9,35
Western Sydn,8000,7,8,9,10,38,47,-9,33
Perth Glory,8000,8,10,2,15,37,50,-13,32
Wellington P,8000,9,5,6,16,31,55,-24,21
CC Mariners,8000,10,4,8,15,28,49,-21,20
Sydney FC,8001,1,20,5,3,66,24,42,65
N'castle Jet,8001,2,16,5,7,60,39,21,53
Melbourne C,8001,3,14,4,11,45,36,9,46
Melbourne V,8001,4,13,6,10,47,40,7,45
Adelaide Utd,8001,5,11,6,11,37,40,-3,39
Brisbane,8001,6,10,5,13,33,42,-9,35
Western Sydn,8001,7,8,9,10,38,47,-9,33
Perth Glory,8001,8,10,2,15,37,50,-13,32
Wellington P,8001,9,5,6,16,31,55,-24,21
CC Mariners,8001,10,4,8,15,28,49,-21,20
Sydney FC,8002,1,20,4,4,64,26,38,64
N'castle Jet,8002,2,16,5,7,60,38,22,53
Melbourne V,8002,3,14,5,10,49,38,11,47
Melbourne C,8002,4,14,4,11,44,36,8,46
Adelaide Utd,8002,5,11,6,11,37,40,-3,39
Brisbane,8002,6,10,5,13,33,42,-9,35
Western Sydn,8002,7,8,9,10,38,47,-9,33
Perth Glory,8002,8,10,2,15,37,50,-13,32
Wellington P,8002,9,5,6,16,31,55,-24,21
CC Mariners,8002,10,4,8,15,28,49,-21,20
Sydney FC,8003,1,21,4,3,68,22,46,67
N'castle Jet,8003,2,15,6,7,59,39,20,51
Melbourne C,8003,3,14,5,10,45,35,10,47
Melbourne V,8003,4,13,5,11,45,42,3,44
Adelaide Utd,8003,5,11,6,11,37,40,-3,39
Brisbane,8003,6,10,5,13,33,42,-9,35
Western Sydn,8003,7,8,9,10,38,47,-9,33
Perth Glory,8003,8,10,2,15,37,50,-13,32
Wellington P,8003,9,5,6,16,31,55,-24,21
CC Mariners,8003,10,4,8,15,28,49,-21,20
Sydney FC,8004,1,21,4,3,65,22,43,67
N'castle Jet,8004,2,16,5,7,58,37,21,53
Melbourne C,8004,3,14,4,11,43,34,9,46
Melbourne V,8004,4,13,5,11,45,39,6,44
Adelaide Utd,8004,5,11,6,11,37,40,-3,39
Brisbane,8004,6,10,5,13,33,42,-9,35
Western Sydn,8004,7,8,9,10,38,47,-9,33
Perth Glory,8004,8,10,2,15,37,50,-13,32
Wellington P,8004,9,5,6,16,31,55,-24,21
CC Mariners,8004,10,4,8,15,28,49,-21,20
Sydney FC,8005,1,21,4,3,65,22,43,67
N'castle Jet,8005,2,16,5,7,58,37,21,53
Melbourne C,8005,3,14,4,11,43,34,9,46
Melbourne V,8005,4,13,5,11,45,39,6,44
Adelaide Utd,8005,5,11,6,11,37,40,-3,39
Brisbane,8005,6,10,5,13,33,42,-9,35
Western Sydn,8005,7,8,9,10,38,47,-9,33
Perth Glory,8005,8,10,2,15,37,50,-13,32
Wellington P,8005,9,5,6,16,31,55,-24,21
CC Mariners,8005,10,4,8,15,28,49,-21,20
Sydney FC,8006,1,21,4,3,65,22,43,67
N'castle Jet,8006,2,15,6,7,59,39,20,51
Melbourne C,8006,3,14,5,10,45,35,10,47
Melbourne V,8006,4,13,5,11,45,39,6,44
Adelaide Utd,8006,5,11,6,11,37,40,-3,39
Brisbane,8006,6,10,5,13,33,42,-9,35
Western Sydn,8006,7,8,9,10,38,47,-9,33
Perth Glory,8006,8,10,2,15,37,50,-13,32
Wellington P,8006,9,5,6,16,31,55,-24,21
CC Mariners,8006,10,4,8,15,28,49,-21,20
Sydney FC,8007,1,20,4,4,66,25,41,64
N'castle Jet,8007,2,15,5,8,58,39,19,50
Melbourne C,8007,3,15,4,10,45,34,11,49
Melbourne V,8007,4,14,5,10,48,40,8,47
Adelaide Utd,8007,5,11,6,11,37,40,-3,39
Brisbane,8007,6,10,5,13,33,42,-9,35
Western Sydn,8007,7,8,9,10,38,47,-9,33
Perth Glory,8007,8,10,2,15,37,50,-13,32
Wellington P,8007,9,5,6,16,31,55,-24,21
CC Mariners,8007,10,4,8,15,28,49,-21,20
Sydney FC,8008,1,21,4,3,67,22,45,67
N'castle Jet,8008,2,16,5,7,59,37,22,53
Melbourne C,8008,3,14,4,11,43,35,8,46
Melbourne V,8008,4,13,5,11,45,41,4,44
Adelaide Utd,8008,5,11,6,11,37,40,-3,39
Brisbane,8008,6,10,5,13,33,42,-9,35
Western Sydn,8008,7,8,9,10,38,47,-9,33
Perth Glory,8008,8,10,2,15,37,50,-13,32
Wellington P,8008,9,5,6,16,31,55,-24,21
CC Mariners,8008,10,4,8,15,28,49,-21,20
Sydney FC,8009,1,20,4,4,66,26,40,64
N'castle Jet,8009,2,15,5,8,58,39,19,50
Melbourne C,8009,3,15,4,10,45,34,11,49
Melbourne V,8009,4,14,5,10,49,40,9,47
Adelaide Utd,8009,5,11,6,11,37,40,-3,39
Brisbane,8009,6,10,5,13,33,42,-9,35
Western Sydn,8009,7,8,9,10,38,47,-9,33
Perth Glory,8009,8,10,2,15,37,50,-13,32
Wellington P,8009,9,5,6,16,31,55,-24,21
CC Mariners,8009,10,4,8,15,28,49,-21,20
Sydney FC,8010,1,21,4,3,67,22,45,67
N'castle Jet,8010,2,16,5,7,58,37,21,53
Melbourne C,8010,3,14,4,11,43,34,9,46
Melbourne V,8010,4,13,5,11,45,41,4,44
Adelaide Utd,8010,5,11,6,11,37,40,-3,39
Brisbane,8010,6,10,5,13,33,42,-9,35
Western Sydn,8010,7,8,9,10,38,47,-9,33
Perth Glory,8010,8,10,2,15,37,50,-13,32
Wellington P,8010,9,5,6,16,31,55,-24,21
CC Mariners,8010,10,4,8,15,28,49,-21,20
Sydney FC,8011,1,21,4,3,66,23,43,67
N'castle Jet,8011,2,16,5,7,59,38,21,53
Melbourne C,8011,3,14,4,11,44,35,9,46
Melbourne V,8011,4,13,5,11,46,40,6,44
Adelaide Utd,8011,5,11,6,11,37,40,-3,39
Brisbane,8011,6,10,5,13,33,42,-9,35
Western Sydn,8011,7,8,9,10,38,47,-9,33
Perth Glory,8011,8,10,2,15,37,50,-13,32
Wellington P,8011,9,5,6,16,31,55,-24,21
CC Mariners,8011,10,4,8,15,28,49,-21,20
Sydney FC,8012,1,21,4,3,67,23,44,67
N'castle Jet,8012,2,15,6,7,59,39,20,51
Melbourne C,8012,3,14,5,10,45,35,10,47
Melbourne V,8012,4,13,5,11,46,41,5,44
Adelaide Utd,8012,5,11,6,11,37,40,-3,39
Brisbane,8012,6,10,5,13,33,42,-9,35
Western Sydn,8012,7,8,9,10,38,47,-9,33
Perth Glory,8012,8,10,2,15,37,50,-13,32
Wellington P,8012,9,5,6,16,31,55,-24,21
CC Mariners,8012,10,4,8,15,28,49,-21,20
Sydney FC,8013,1,21,4,3,67,23,44,67
N'castle Jet,8013,2,16,5,7,59,38,21,53
Melbourne C,8013,3,14,4,11,44,35,9,46
Melbourne V,8013,4,13,5,11,46,41,5,44
Adelaide Utd,8013,5,11,6,11,37,40,-3,39
Brisbane,8013,6,10,5,13,33,42,-9,35
Western Sydn,8013,7,8,9,10,38,47,-9,33
Perth Glory,8013,8,10,2,15,37,50,-13,32
Wellington P,8013,9,5,6,16,31,55,-24,21
CC Mariners,8013,10,4,8,15,28,49,-21,20
Sydney FC,8014,1,21,4,3,66,22,44,67
N'castle Jet,8014,2,15,6,7,59,39,20,51
Melbourne C,8014,3,14,5,10,45,35,10,47
Melbourne V,8014,4,13,5,11,45,40,5,44
Adelaide Utd,8014,5,11,6,11,37,40,-3,39
Brisbane,8014,6,10,5,13,33,42,-9,35
Western Sydn,8014,7,8,9,10,38,47,-9,33
Perth Glory,8014,8,10,2,15,37,50,-13,32
Wellington P,8014,9,5,6,16,31,55,-24,21
CC Mariners,8014,10,4,8,15,28,49,-21,20
Sydney FC,8015,1,21,4,3,66,23,43,67
N'castle Jet,8015,2,16,5,7,60,38,22,53
Melbourne C,8015,3,14,4,11,44,36,8,46
Melbourne V,8015,4,13,5,11,46,40,6,44
Adelaide Utd,8015,5,11,6,11,37,40,-3,39
Brisbane,8015,6,10,5,13,33,42,-9,35
Western Sydn,8015,7,8,9,10,38,47,-9,33
Perth Glory,8015,8,10,2,15,37,50,-13,32
Wellington P,8015,9,5,6,16,31,55,-24,21
CC Mariners,8015,10,4,8,15,28,49,-21,20
Sydney FC,8016,1,21,4,3,67,22,45,67
N'castle Jet,8016,2,15,5,8,58,39,19,50
Melbourne C,8016,3,15,4,10,45,34,11,49
Melbourne V,8016,4,13,5,11,45,41,4,44
Adelaide Utd,8016,5,11,6,11,37,40,-3,39
Brisbane,8016,6,10,5,13,33,42,-9,35
Western Sydn,8016,7,8,9,10,38,47,-9,33
Perth Glory,8016,8,10,2,15,37,50,-13,32
Wellington P,8016,9,5,6,16,31,55,-24,21
CC Mariners,8016,10,4,8,15,28,49,-21,20
Sydney FC,8017,1,21,4,3,66,22,44,67
N'castle Jet,8017,2,16,5,7,58,37,21,53
Melbourne C,8017,3,14,4,11,43,34,9,46
Melbourne V,8017,4,13,5,11,45,40,5,44
Adelaide Utd,8017,5,11,6,11,37,40,-3,39
Brisbane,8017,6,10,5,13,33,42,-9,35
Western Sydn,8017,7,8,9,10,38,47,-9,33
Perth Glory,8017,8,10,2,15,37,50,-13,32
Wellington P,8017,9,5,6,16,31,55,-24,21
CC Mariners,8017,10,4,8,15,28,49,-21,20
Sydney FC,8018,1,20,5,3,65,23,42,65
N'castle Jet,8018,2,15,5,8,57,38,19,50
Melbourne C,8018,3,15,4,10,44,33,11,49
Melbourne V,8018,4,13,6,10,46,39,7,45
Adelaide Utd,8018,5,11,6,11,37,40,-3,39
Brisbane,8018,6,10,5,13,33,42,-9,35
Western Sydn,8018,7,8,9,10,38,47,-9,33
Perth Glory,8018,8,10,2,15,37,50,-13,32
Wellington P,8018,9,5,6,16,31,55,-24,21
CC Mariners,8018,10,4,8,15,28,49,-21,20
Sydney FC,8019,1,21,4,3,66,22,44,67
N'castle Jet,8019,2,15,6,7,58,38,20,51
Melbourne C,8019,3,14,5,10,44,34,10,47
Melbourne V,8019,4,13,5,11,45,40,5,44
Adelaide Utd,8019,5,11,6,11,37,40,-3,39
Brisbane,8019,6,10,5,13,33,42,-9,35
Western Sydn,8019,7,8,9,10,38,47,-9,33
Perth Glory,8019,8,10,2,15,37,50,-13,32
Wellington P,8019,9,5,6,16,31,55,-24,21
CC Mariners,8019,10,4,8,15,28,49,-21,20
Sydney FC,8020,1,21,4,3,68,23,45,67
N'castle Jet,8020,2,15,5,8,57,40,17,50
Melbourne C,8020,3,15,4,10,46,33,13,49
Melbourne V,8020,4,13,5,11,46,42,4,44
Adelaide Utd,8020,5,11,6,11,37,40,-3,39
Brisbane,8020,6,10,5,13,33,42,-9,35
Western Sydn,8020,7,8,9,10,38,47,-9,33
Perth Glory,8020,8,10,2,15,37,50,-13,32
Wellington P,8020,9,5,6,16,31,55,-24,21
CC Mariners,8020,10,4,8,15,28,49,-21,20
Sydney FC,8021,1,21,4,3,66,22,44,67
N'castle Jet,8021,2,16,5,7,58,37,21,53
Melbourne C,8021,3,14,4,11,43,34,9,46
Melbourne V,8021,4,13,5,11,45,40,5,44
Adelaide Utd,8021,5,11,6,11,37,40,-3,39
Brisbane,8021,6,10,5,13,33,42,-9,35
Western Sydn,8021,7,8,9,10,38,47,-9,33
Perth Glory,8021,8,10,2,15,37,50,-13,32
Wellington P,8021,9,5,6,16,31,55,-24,21
CC Mariners,8021,10,4,8,15,28,49,-21,20
Sydney FC,8022,1,20,5,3,64,22,42,65
N'castle Jet,8022,2,15,6,7,57,37,20,51
Melbourne C,8022,3,14,5,10,43,33,10,47
Melbourne V,8022,4,13,6,10,45,38,7,45
Adelaide Utd,8022,5,11,6,11,37,40,-3,39
Brisbane,8022,6,10,5,13,33,42,-9,35
Western Sydn,8022,7,8,9,10,38,47,-9,33
Perth Glory,8022,8,10,2,15,37,50,-13,32
Wellington P,8022,9,5,6,16,31,55,-24,21
CC Mariners,8022,10,4,8,15,28,49,-21,20
Sydney FC,8023,1,20,4,4,65,25,40,64
N'castle Jet,8023,2,15,6,7,57,37,20,51
Melbourne C,8023,3,14,5,10,43,33,10,47
Melbourne V,8023,4,14,5,10,48,39,9,47
Adelaide Utd,8023,5,11,6,11,37,40,-3,39
Brisbane,8023,6,10,5,13,33,42,-9,35
Western Sydn,8023,7,8,9,10,38,47,-9,33
Perth Glory,8023,8,10,2,15,37,50,-13,32
Wellington P,8023,9,5,6,16,31,55,-24,21
CC Mariners,8023,10,4,8,15,28,49,-21,20
Sydney FC,8024,1,20,5,3,66,24,42,65
N'castle Jet,8024,2,16,5,7,58,37,21,53
Melbourne C,8024,3,14,4,11,43,34,9,46
Melbourne V,8024,4,13,6,10,47,40,7,45
Adelaide Utd,8024,5,11,6,11,37,40,-3,39
Brisbane,8024,6,10,5,13,33,42,-9,35
Western Sydn,8024,7,8,9,10,38,47,-9,33
Perth Glory,8024,8,10,2,15,37,50,-13,32
Wellington P,8024,9,5,6,16,31,55,-24,21
CC Mariners,8024,10,4,8,15,28,49,-21,20
Sydney FC,8025,1,21,4,3,69,25,44,67
N'castle Jet,8025,2,16,5,7,58,37,21,53
Melbourne C,8025,3,14,4,11,43,34,9,46
Melbourne V,8025,4,13,5,11,48,43,5,44
Adelaide Utd,8025,5,11,6,11,37,40,-3,39
Brisbane,8025,6,10,5,13,33,42,-9,35
Western Sydn,8025,7,8,9,10,38,47,-9,33
Perth Glory,8025,8,10,2,15,37,50,-13,32
Wellington P,8025,9,5,6,16,31,55,-24,21
CC Mariners,8025,10,4,8,15,28,49,-21,20
Sydney FC,8026,1,21,4,3,66,23,43,67
N'castle Jet,8026,2,15,5,8,58,39,19,50
Melbourne C,8026,3,15,4,10,45,34,11,49
Melbourne V,8026,4,13,5,11,46,40,6,44
Adelaide Utd,8026,5,11,6,11,37,40,-3,39
Brisbane,8026,6,10,5,13,33,42,-9,35
Western Sydn,8026,7,8,9,10,38,47,-9,33
Perth Glory,8026,8,10,2,15,37,50,-13,32
Wellington P,8026,9,5,6,16,31,55,-24,21
CC Mariners,8026,10,4,8,15,28,49,-21,20
Sydney FC,8027,1,20,4,4,64,24,40,64
N'castle Jet,8027,2,16,5,7,58,37,21,53
Melbourne V,8027,3,14,5,10,47,38,9,47
Melbourne C,8027,4,14,4,11,43,34,9,46
Adelaide Utd,8027,5,11,6,11,37,40,-3,39
Brisbane,8027,6,10,5,13,33,42,-9,35
Western Sydn,8027,7,8,9,10,38,47,-9,33
Perth Glory,8027,8,10,2,15,37,50,-13,32
Wellington P,8027,9,5,6,16,31,55,-24,21
CC Mariners,8027,10,4,8,15,28,49,-21,20
Sydney FC,8028,1,21,4,3,68,24,44,67
N'castle Jet,8028,2,15,5,8,57,38,19,50
Melbourne C,8028,3,15,4,10,44,33,11,49
Melbourne V,8028,4,13,5,11,47,42,5,44
Adelaide Utd,8028,5,11,6,11,37,40,-3,39
Brisbane,8028,6,10,5,13,33,42,-9,35
Western Sydn,8028,7,8,9,10,38,47,-9,33
Perth Glory,8028,8,10,2,15,37,50,-13,32
Wellington P,8028,9,5,6,16,31,55,-24,21
CC Mariners,8028,10,4,8,15,28,49,-21,20
Sydney FC,8029,1,21,4,3,67,22,45,67
N'castle Jet,8029,2,16,5,7,61,39,22,53
Melbourne C,8029,3,14,4,11,45,37,8,46
Melbourne V,8029,4,13,5,11,45,41,4,44
Adelaide Utd,8029,5,11,6,11,37,40,-3,39
Brisbane,8029,6,10,5,13,33,42,-9,35
Western Sydn,8029,7,8,9,10,38,47,-9,33
Perth Glory,8029,8,10,2,15,37,50,-13,32
Wellington P,8029,9,5,6,16,31,55,-24,21
CC Mariners,8029,10,4,8,15,28,49,-21,20
Sydney FC,8030,1,21,4,3,65,22,43,67
N'castle Jet,8030,2,15,5,8,57,39,18,50
Melbourne C,8030,3,15,4,10,45,33,12,49
Melbourne V,8030,4,13,5,11,45,39,6,44
Adelaide Utd,8030,5,11,6,11,37,40,-3,39
Brisbane,8030,6,10,5,13,33,42,-9,35
Western Sydn,8030,7,8,9,10,38,47,-9,33
Perth Glory,8030,8,10,2,15,37,50,-13,32
Wellington P,8030,9,5,6,16,31,55,-24,21
CC Mariners,8030,10,4,8,15,28,49,-21,20
Sydney FC,8031,1,20,5,3,67,25,42,65
N'castle Jet,8031,2,15,5,8,59,41,18,50
Melbourne C,8031,3,15,4,10,47,35,12,49
Melbourne V,8031,4,13,6,10,48,41,7,45
Adelaide Utd,8031,5,11,6,11,37,40,-3,39
Brisbane,8031,6,10,5,13,33,42,-9,35
Western Sydn,8031,7,8,9,10,38,47,-9,33
Perth Glory,8031,8,10,2,15,37,50,-13,32
Wellington P,8031,9,5,6,16,31,55,-24,21
CC Mariners,8031,10,4,8,15,28,49,-21,20
Sydney FC,8032,1,21,4,3,66,22,44,67
N'castle Jet,8032,2,16,5,7,59,38,21,53
Melbourne C,8032,3,14,4,11,44,35,9,46
Melbourne V,8032,4,13,5,11,45,40,5,44
Adelaide Utd,8032,5,11,6,11,37,40,-3,39
Brisbane,8032,6,10,5,13,33,42,-9,35
Western Sydn,8032,7,8,9,10,38,47,-9,33
Perth Glory,8032,8,10,2,15,37,50,-13,32
Wellington P,8032,9,5,6,16,31,55,-24,21
CC Mariners,8032,10,4,8,15,28,49,-21,20
Sydney FC,8033,1,20,5,3,65,23,42,65
N'castle Jet,8033,2,15,6,7,57,37,20,51
Melbourne C,8033,3,14,5,10,43,33,10,47
Melbourne V,8033,4,13,6,10,46,39,7,45
Adelaide Utd,8033,5,11,6,11,37,40,-3,39
Brisbane,8033,6,10,5,13,33,42,-9,35
Western Sydn,8033,7,8,9,10,38,47,-9,33
Perth Glory,8033,8,10,2,15,37,50,-13,32
Wellington P,8033,9,5,6,16,31,55,-24,21
CC Mariners,8033,10,4,8,15,28,49,-21,20
Sydney FC,8034,1,20,4,4,65,24,41,64
N'castle Jet,8034,2,15,6,7,59,39,20,51
Melbourne C,8034,3,14,5,10,45,35,10,47
Melbourne V,8034,4,14,5,10,47,39,8,47
Adelaide Utd,8034,5,11,6,11,37,40,-3,39
Brisbane,8034,6,10,5,13,33,42,-9,35
Western Sydn,8034,7,8,9,10,38,47,-9,33
Perth Glory,8034,8,10,2,15,37,50,-13,32
Wellington P,8034,9,5,6,16,31,55,-24,21
CC Mariners,8034,10,4,8,15,28,49,-21,20
Sydney FC,8035,1,21,4,3,67,23,44,67
N'castle Jet,8035,2,15,6,7,58,38,20,51
Melbourne C,8035,3,14,5,10,44,34,10,47
Melbourne V,8035,4,13,5,11,46,41,5,44
Adelaide Utd,8035,5,11,6,11,37,40,-3,39
Brisbane,8035,6,10,5,13,33,42,-9,35
Western Sydn,8035,7,8,9,10,38,47,-9,33
Perth Glory,8035,8,10,2,15,37,50,-13,32
Wellington P,8035,9,5,6,16,31,55,-24,21
CC Mariners,8035,10,4,8,15,28,49,-21,20
Sydney FC,8036,1,21,4,3,65,22,43,67
N'castle Jet,8036,2,16,5,7,59,37,22,53
Melbourne C,8036,3,14,4,11,43,35,8,46
Melbourne V,8036,4,13,5,11,45,39,6,44
Adelaide Utd,8036,5,11,6,11,37,40,-3,39
Brisbane,8036,6,10,5,13,33,42,-9,35
Western Sydn,8036,7,8,9,10,38,47,-9,33
Perth Glory,8036,8,10,2,15,37,50,-13,32
Wellington P,8036,9,5,6,16,31,55,-24,21
CC Mariners,8036,10,4,8,15,28,49,-21,20
Sydney FC,8037,1,21,4,3,65,22,43,67
N'castle Jet,8037,2,16,5,7,58,37,21,53
Melbourne C,8037,3,14,4,11,43,34,9,46
Melbourne V,8037,4,13,5,11,45,39,6,44
Adelaide Utd,8037,5,11,6,11,37,40,-3,39
Brisbane,8037,6,10,5,13,33,42,-9,35
Western Sydn,8037,7,8,9,10,38,47,-9,33
Perth Glory,8037,8,10,2,15,37,50,-13,32
Wellington P,8037,9,5,6,16,31,55,-24,21
CC Mariners,8037,10,4,8,15,28,49,-21,20
Sydney FC,8038,1,21,4,3,67,22,45,67
N'castle Jet,8038,2,15,6,7,58,38,20,51
Melbourne C,8038,3,14,5,10,44,34,10,47
Melbourne V,8038,4,13,5,11,45,41,4,44
Adelaide Utd,8038,5,11,6,11,37,40,-3,39
Brisbane,8038,6,10,5,13,33,42,-9,35
Western Sydn,8038,7,8,9,10,38,47,-9,33
Perth Glory,8038,8,10,2,15,37,50,-13,32
Wellington P,8038,9,5,6,16,31,55,-24,21
CC Mariners,8038,10,4,8,15,28,49,-21,20
Sydney FC,8039,1,21,4,3,66,22,44,67
N'castle Jet,8039,2,15,6,7,57,37,20,51
Melbourne C,8039,3,14,5,10,43,33,10,47
Melbourne V,8039,4,13,5,11,45,40,5,44
Adelaide Utd,8039,5,11,6,11,37,40,-3,39
Brisbane,8039,6,10,5,13,33,42,-9,35
Western Sydn,8039,7,8,9,10,38,47,-9,33
Perth Glory,8039,8,10,2,15,37,50,-13,32
Wellington P,8039,9,5,6,16,31,55,-24,21
CC Mariners,8039,10,4,8,15,28,49,-21,20
Sydney FC,8040,1,21,4,3,67,23,44,67
N'castle Jet,8040,2,16,5,7,60,37,23,53
Melbourne C,8040,3,14,4,11,43,36,7,46
Melbourne V,8040,4,13,5,11,46,41,5,44
Adelaide Utd,8040,5,11,6,11,37,40,-3,39
Brisbane,8040,6,10,5,13,33,42,-9,35
Western Sydn,8040,7,8,9,10,38,47,-9,33
Perth Glory,8040,8,10,2,15,37,50,-13,32
Wellington P,8040,9,5,6,16,31,55,-24,21
CC Mariners,8040,10,4,8,15,28,49,-21,20
Sydney FC,8041,1,20,5,3,66,24,42,65
N'castle Jet,8041,2,16,5,7,59,37,22,53
Melbourne C,8041,3,14,4,11,43,35,8,46
Melbourne V,8041,4,13,6,10,47,40,7,45
Adelaide Utd,8041,5,11,6,11,37,40,-3,39
Brisbane,8041,6,10,5,13,33,42,-9,35
Western Sydn,8041,7,8,9,10,38,47,-9,33
Perth Glory,8041,8,10,2,15,37,50,-13,32
Wellington P,8041,9,5,6,16,31,55,-24,21
CC Mariners,8041,10,4,8,15,28,49,-21,20
Sydney FC,8042,1,21,4,3,68,23,45,67
N'castle Jet,8042,2,16,5,7,60,37,23,53
Melbourne C,8042,3,14,4,11,43,36,7,46
Melbourne V,8042,4,13,5,11,46,42,4,44
Adelaide Utd,8042,5,11,6,11,37,40,-3,39
Brisbane,8042,6,10,5,13,33,42,-9,35
Western Sydn,8042,7,8,9,10,38,47,-9,33
Perth Glory,8042,8,10,2,15,37,50,-13,32
Wellington P,8042,9,5,6,16,31,55,-24,21
CC Mariners,8042,10,4,8,15,28,49,-21,20
Sydney FC,8043,1,20,5,3,65,23,42,65
N'castle Jet,8043,2,15,5,8,59,40,19,50
Melbourne C,8043,3,15,4,10,46,35,11,49
Melbourne V,8043,4,13,6,10,46,39,7,45
Adelaide Utd,8043,5,11,6,11,37,40,-3,39
Brisbane,8043,6,10,5,13,33,42,-9,35
Western Sydn,8043,7,8,9,10,38,47,-9,33
Perth Glory,8043,8,10,2,15,37,50,-13,32
Wellington P,8043,9,5,6,16,31,55,-24,21
CC Mariners,8043,10,4,8,15,28,49,-21,20
Sydney FC,8044,1,20,5,3,66,24,42,65
N'castle Jet,8044,2,16,5,7,59,37,22,53
Melbourne C,8044,3,14,4,11,43,35,8,46
Melbourne V,8044,4,13,6,10,47,40,7,45
Adelaide Utd,8044,5,11,6,11,37,40,-3,39
Brisbane,8044,6,10,5,13,33,42,-9,35
Western Sydn,8044,7,8,9,10,38,47,-9,33
Perth Glory,8044,8,10,2,15,37,50,-13,32
Wellington P,8044,9,5,6,16,31,55,-24,21
CC Mariners,8044,10,4,8,15,28,49,-21,20
Sydney FC,8045,1,21,4,3,68,24,44,67
N'castle Jet,8045,2,16,5,7,58,37,21,53
Melbourne C,8045,3,14,4,11,43,34,9,46
Melbourne V,8045,4,13,5,11,47,42,5,44
Adelaide Utd,8045,5,11,6,11,37,40,-3,39
Brisbane,8045,6,10,5,13,33,42,-9,35
Western Sydn,8045,7,8,9,10,38,47,-9,33
Perth Glory,8045,8,10,2,15,37,50,-13,32
Wellington P,8045,9,5,6,16,31,55,-24,21
CC Mariners,8045,10,4,8,15,28,49,-21,20
Sydney FC,8046,1,20,5,3,66,24,42,65
N'castle Jet,8046,2,15,6,7,58,38,20,51
Melbourne C,8046,3,14,5,10,44,34,10,47
Melbourne V,8046,4,13,6,10,47,40,7,45
Adelaide Utd,8046,5,11,6,11,37,40,-3,39
Brisbane,8046,6,10,5,13,33,42,-9,35
Western Sydn,8046,7,8,9,10,38,47,-9,33
Perth Glory,8046,8,10,2,15,37,50,-13,32
Wellington P,8046,9,5,6,16,31,55,-24,21
CC Mariners,8046,10,4,8,15,28,49,-21,20
Sydney FC,8047,1,21,4,3,67,22,45,67
N'castle Jet,8047,2,15,5,8,57,39,18,50
Melbourne C,8047,3,15,4,10,45,33,12,49
Melbourne V,8047,4,13,5,11,45,41,4,44
Adelaide Utd,8047,5,11,6,11,37,40,-3,39
Brisbane,8047,6,10,5,13,33,42,-9,35
Western Sydn,8047,7,8,9,10,38,47,-9,33
Perth Glory,8047,8,10,2,15,37,50,-13,32
Wellington P,8047,9,5,6,16,31,55,-24,21
CC Mariners,8047,10,4,8,15,28,49,-21,20
Sydney FC,8048,1,20,5,3,67,25,42,65
N'castle Jet,8048,2,15,5,8,57,40,17,50
Melbourne C,8048,3,15,4,10,46,33,13,49
Melbourne V,8048,4,13,6,10,48,41,7,45
Adelaide Utd,8048,5,11,6,11,37,40,-3,39
Brisbane,8048,6,10,5,13,33,42,-9,35
Western Sydn,8048,7,8,9,10,38,47,-9,33
Perth Glory,8048,8,10,2,15,37,50,-13,32
Wellington P,8048,9,5,6,16,31,55,-24,21
CC Mariners,8048,10,4,8,15,28,49,-21,20
Sydney FC,8049,1,21,4,3,69,22,47,67
N'castle Jet,8049,2,15,6,7,59,39,20,51
Melbourne C,8049,3,14,5,10,45,35,10,47
Melbourne V,8049,4,13,5,11,45,43,2,44
Adelaide Utd,8049,5,11,6,11,37,40,-3,39
Brisbane,8049,6,10,5,13,33,42,-9,35
Western Sydn,8049,7,8,9,10,38,47,-9,33
Perth Glory,8049,8,10,2,15,37,50,-13,32
Wellington P,8049,9,5,6,16,31,55,-24,21
CC Mariners,8049,10,4,8,15,28,49,-21,20
Sydney FC,8050,1,21,4,3,66,22,44,67
N'castle Jet,8050,2,15,5,8,57,39,18,50
Melbourne C,8050,3,15,4,10,45,33,12,49
Melbourne V,8050,4,13,5,11,45,40,5,44
Adelaide Utd,8050,5,11,6,11,37,40,-3,39
Brisbane,8050,6,10,5,13,33,42,-9,35
Western Sydn,8050,7,8,9,10,38,47,-9,33
Perth Glory,8050,8,10,2,15,37,50,-13,32
Wellington P,8050,9,5,6,16,31,55,-24,21
CC Mariners,8050,10,4,8,15,28,49,-21,20
Sydney FC,8051,1,21,4,3,71,23,48,67
N'castle Jet,8051,2,15,5,8,58,39,19,50
Melbourne C,8051,3,15,4,10,45,34,11,49
Melbourne V,8051,4,13,5,11,46,45,1,44
Adelaide Utd,8051,5,11,6,11,37,40,-3,39
Brisbane,8051,6,10,5,13,33,42,-9,35
Western Sydn,8051,7,8,9,10,38,47,-9,33
Perth Glory,8051,8,10,2,15,37,50,-13,32
Wellington P,8051,9,5,6,16,31,55,-24,21
CC Mariners,8051,10,4,8,15,28,49,-21,20
Sydney FC,8052,1,20,5,3,65,23,42,65
N'castle Jet,8052,2,15,5,8,57,38,19,50
Melbourne C,8052,3,15,4,10,44,33,11,49
Melbourne V,8052,4,13,6,10,46,39,7,45
Adelaide Utd,8052,5,11,6,11,37,40,-3,39
Brisbane,8052,6,10,5,13,33,42,-9,35
Western Sydn,8052,7,8,9,10,38,47,-9,33
Perth Glory,8052,8,10,2,15,37,50,-13,32
Wellington P,8052,9,5,6,16,31,55,-24,21
CC Mariners,8052,10,4,8,15,28,49,-21,20
Sydney FC,8053,1,21,4,3,69,22,47,67
N'castle Jet,8053,2,15,6,7,58,38,20,51
Melbourne C,8053,3,14,5,10,44,34,10,47
Melbourne V,8053,4,13,5,11,45,43,2,44
Adelaide Utd,8053,5,11,6,11,37,40,-3,39
Brisbane,8053,6,10,5,13,33,42,-9,35
Western Sydn,8053,7,8,9,10,38,47,-9,33
Perth Glory,8053,8,10,2,15,37,50,-13,32
Wellington P,8053,9,5,6,16,31,55,-24,21
CC Mariners,8053,10,4,8,15,28,49,-21,20
Sydney FC,8054,1,20,5,3,64,22,42,65
N'castle Jet,8054,2,15,6,7,58,38,20,51
Melbourne C,8054,3,14,5,10,44,34,10,47
Melbourne V,8054,4,13,6,10,45,38,7,45
Adelaide Utd,8054,5,11,6,11,37,40,-3,39
Brisbane,8054,6,10,5,13,33,42,-9,35
Western Sydn,8054,7,8,9,10,38,47,-9,33
Perth Glory,8054,8,10,2,15,37,50,-13,32
Wellington P,8054,9,5,6,16,31,55,-24,21
CC Mariners,8054,10,4,8,15,28,49,-21,20
Sydney FC,8055,1,20,5,3,65,23,42,65
N'castle Jet,8055,2,15,6,7,58,38,20,51
Melbourne C,8055,3,14,5,10,44,34,10,47
Melbourne V,8055,4,13,6,10,46,39,7,45
Adelaide Utd,8055,5,11,6,11,37,40,-3,39
Brisbane,8055,6,10,5,13,33,42,-9,35
Western Sydn,8055,7,8,9,10,38,47,-9,33
Perth Glory,8055,8,10,2,15,37,50,-13,32
Wellington P,8055,9,5,6,16,31,55,-24,21
CC Mariners,8055,10,4,8,15,28,49,-21,20
Sydney FC,8056,1,20,4,4,65,24,41,64
N'castle Jet,8056,2,15,5,8,57,38,19,50
Melbourne C,8056,3,15,4,10,44,33,11,49
Melbourne V,8056,4,14,5,10,47,39,8,47
Adelaide Utd,8056,5,11,6,11,37,40,-3,39
Brisbane,8056,6,10,5,13,33,42,-9,35
Western Sydn,8056,7,8,9,10,38,47,-9,33
Perth Glory,8056,8,10,2,15,37,50,-13,32
Wellington P,8056,9,5,6,16,31,55,-24,21
CC Mariners,8056,10,4,8,15,28,49,-21,20
Sydney FC,8057,1,20,4,4,65,24,41,64
N'castle Jet,8057,2,16,5,7,60,38,22,53
Melbourne V,8057,3,14,5,10,47,39,8,47
Melbourne C,8057,4,14,4,11,44,36,8,46
Adelaide Utd,8057,5,11,6,11,37,40,-3,39
Brisbane,8057,6,10,5,13,33,42,-9,35
Western Sydn,8057,7,8,9,10,38,47,-9,33
Perth Glory,8057,8,10,2,15,37,50,-13,32
Wellington P,8057,9,5,6,16,31,55,-24,21
CC Mariners,8057,10,4,8,15,28,49,-21,20
Sydney FC,8058,1,21,4,3,65,22,43,67
N'castle Jet,8058,2,15,5,8,59,42,17,50
Melbourne C,8058,3,15,4,10,48,35,13,49
Melbourne V,8058,4,13,5,11,45,39,6,44
Adelaide Utd,8058,5,11,6,11,37,40,-3,39
Brisbane,8058,6,10,5,13,33,42,-9,35
Western Sydn,8058,7,8,9,10,38,47,-9,33
Perth Glory,8058,8,10,2,15,37,50,-13,32
Wellington P,8058,9,5,6,16,31,55,-24,21
CC Mariners,8058,10,4,8,15,28,49,-21,20
Sydney FC,8059,1,20,5,3,64,22,42,65
N'castle Jet,8059,2,16,5,7,60,38,22,53
Melbourne C,8059,3,14,4,11,44,36,8,46
Melbourne V,8059,4,13,6,10,45,38,7,45
Adelaide Utd,8059,5,11,6,11,37,40,-3,39
Brisbane,8059,6,10,5,13,33,42,-9,35
Western Sydn,8059,7,8,9,10,38,47,-9,33
Perth Glory,8059,8,10,2,15,37,50,-13,32
Wellington P,8059,9,5,6,16,31,55,-24,21
CC Mariners,8059,10,4,8,15,28,49,-21,20
Sydney FC,8060,1,21,4,3,66,22,44,67
N'castle Jet,8060,2,16,5,7,61,40,21,53
Melbourne C,8060,3,14,4,11,46,37,9,46
Melbourne V,8060,4,13,5,11,45,40,5,44
Adelaide Utd,8060,5,11,6,11,37,40,-3,39
Brisbane,8060,6,10,5,13,33,42,-9,35
Western Sydn,8060,7,8,9,10,38,47,-9,33
Perth Glory,8060,8,10,2,15,37,50,-13,32
Wellington P,8060,9,5,6,16,31,55,-24,21
CC Mariners,8060,10,4,8,15,28,49,-21,20
Sydney FC,8061,1,21,4,3,67,22,45,67
N'castle Jet,8061,2,15,5,8,57,40,17,50
Melbourne C,8061,3,15,4,10,46,33,13,49
Melbourne V,8061,4,13,5,11,45,41,4,44
Adelaide Utd,8061,5,11,6,11,37,40,-3,39
Brisbane,8061,6,10,5,13,33,42,-9,35
Western Sydn,8061,7,8,9,10,38,47,-9,33
Perth Glory,8061,8,10,2,15,37,50,-13,32
Wellington P,8061,9,5,6,16,31,55,-24,21
CC Mariners,8061,10,4,8,15,28,49,-21,20
Sydney FC,8062,1,21,4,3,69,23,46,67
N'castle Jet,8062,2,15,5,8,57,38,19,50
Melbourne C,8062,3,15,4,10,44,33,11,49
Melbourne V,8062,4,13,5,11,46,43,3,44
Adelaide Utd,8062,5,11,6,11,37,40,-3,39
Brisbane,8062,6,10,5,13,33,42,-9,35
Western Sydn,8062,7,8,9,10,38,47,-9,33
Perth Glory,8062,8,10,2,15,37,50,-13,32
Wellington P,8062,9,5,6,16,31,55,-24,21
CC Mariners,8062,10,4,8,15,28,49,-21,20
Sydney FC,8063,1,20,5,3,66,24,42,65
N'castle Jet,8063,2,15,5,8,57,38,19,50
Melbourne C,8063,3,15,4,10,44,33,11,49
Melbourne V,8063,4,13,6,10,47,40,7,45
Adelaide Utd,8063,5,11,6,11,37,40,-3,39
Brisbane,8063,6,10,5,13,33,42,-9,35
Western Sydn,8063,7,8,9,10,38,47,-9,33
Perth Glory,8063,8,10,2,15,37,50,-13,32
Wellington P,8063,9,5,6,16,31,55,-24,21
CC Mariners,8063,10,4,8,15,28,49,-21,20
Sydney FC,8064,1,21,4,3,66,23,43,67
N'castle Jet,8064,2,16,5,7,59,38,21,53
Melbourne C,8064,3,14,4,11,44,35,9,46
Melbourne V,8064,4,13,5,11,46,40,6,44
Adelaide Utd,8064,5,11,6,11,37,40,-3,39
Brisbane,8064,6,10,5,13,33,42,-9,35
Western Sydn,8064,7,8,9,10,38,47,-9,33
Perth Glory,8064,8,10,2,15,37,50,-13,32
Wellington P,8064,9,5,6,16,31,55,-24,21
CC Mariners,8064,10,4,8,15,28,49,-21,20
Sydney FC,8065,1,21,4,3,65,22,43,67
N'castle Jet,8065,2,16,5,7,63,39,24,53
Melbourne C,8065,3,14,4,11,45,39,6,46
Melbourne V,8065,4,13,5,11,45,39,6,44
Adelaide Utd,8065,5,11,6,11,37,40,-3,39
Brisbane,8065,6,10,5,13,33,42,-9,35
Western Sydn,8065,7,8,9,10,38,47,-9,33
Perth Glory,8065,8,10,2,15,37,50,-13,32
Wellington P,8065,9,5,6,16,31,55,-24,21
CC Mariners,8065,10,4,8,15,28,49,-21,20
Sydney FC,8066,1,21,4,3,68,22,46,67
N'castle Jet,8066,2,16,5,7,60,38,22,53
Melbourne C,8066,3,14,4,11,44,36,8,46
Melbourne V,8066,4,13,5,11,45,42,3,44
Adelaide Utd,8066,5,11,6,11,37,40,-3,39
Brisbane,8066,6,10,5,13,33,42,-9,35
Western Sydn,8066,7,8,9,10,38,47,-9,33
Perth Glory,8066,8,10,2,15,37,50,-13,32
Wellington P,8066,9,5,6,16,31,55,-24,21
CC Mariners,8066,10,4,8,15,28,49,-21,20
Sydney FC,8067,1,21,4,3,65,22,43,67
N'castle Jet,8067,2,16,5,7,61,39,22,53
Melbourne C,8067,3,14,4,11,45,37,8,46
Melbourne V,8067,4,13,5,11,45,39,6,44
Adelaide Utd,8067,5,11,6,11,37,40,-3,39
Brisbane,8067,6,10,5,13,33,42,-9,35
Western Sydn,8067,7,8,9,10,38,47,-9,33
Perth Glory,8067,8,10,2,15,37,50,-13,32
Wellington P,8067,9,5,6,16,31,55,-24,21
CC Mariners,8067,10,4,8,15,28,49,-21,20
Sydney FC,8068,1,21,4,3,69,22,47,67
N'castle Jet,8068,2,16,5,7,59,38,21,53
Melbourne C,8068,3,14,4,11,44,35,9,46
Melbourne V,8068,4,13,5,11,45,43,2,44
Adelaide Utd,8068,5,11,6,11,37,40,-3,39
Brisbane,8068,6,10,5,13,33,42,-9,35
Western Sydn,8068,7,8,9,10,38,47,-9,33
Perth Glory,8068,8,10,2,15,37,50,-13,32
Wellington P,8068,9,5,6,16,31,55,-24,21
CC Mariners,8068,10,4,8,15,28,49,-21,20
Sydney FC,8069,1,20,5,3,65,23,42,65
N'castle Jet,8069,2,16,5,7,60,38,22,53
Melbourne C,8069,3,14,4,11,44,36,8,46
Melbourne V,8069,4,13,6,10,46,39,7,45
Adelaide Utd,8069,5,11,6,11,37,40,-3,39
Brisbane,8069,6,10,5,13,33,42,-9,35
Western Sydn,8069,7,8,9,10,38,47,-9,33
Perth Glory,8069,8,10,2,15,37,50,-13,32
Wellington P,8069,9,5,6,16,31,55,-24,21
CC Mariners,8069,10,4,8,15,28,49,-21,20
Sydney FC,8070,1,21,4,3,65,22,43,67
N'castle Jet,8070,2,16,5,7,61,40,21,53
Melbourne C,8070,3,14,4,11,46,37,9,46
Melbourne V,8070,4,13,5,11,45,39,6,44
Adelaide Utd,8070,5,11,6,11,37,40,-3,39
Brisbane,8070,6,10,5,13,33,42,-9,35
Western Sydn,8070,7,8,9,10,38,47,-9,33
Perth Glory,8070,8,10,2,15,37,50,-13,32
Wellington P,8070,9,5,6,16,31,55,-24,21
CC Mariners,8070,10,4,8,15,28,49,-21,20
Sydney FC,8071,1,20,5,3,67,25,42,65
N'castle Jet,8071,2,16,5,7,59,38,21,53
Melbourne C,8071,3,14,4,11,44,35,9,46
Melbourne V,8071,4,13,6,10,48,41,7,45
Adelaide Utd,8071,5,11,6,11,37,40,-3,39
Brisbane,8071,6,10,5,13,33,42,-9,35
Western Sydn,8071,7,8,9,10,38,47,-9,33
Perth Glory,8071,8,10,2,15,37,50,-13,32
Wellington P,8071,9,5,6,16,31,55,-24,21
CC Mariners,8071,10,4,8,15,28,49,-21,20
Sydney FC,8072,1,20,5,3,66,24,42,65
N'castle Jet,8072,2,15,5,8,57,39,18,50
Melbourne C,8072,3,15,4,10,45,33,12,49
Melbourne V,8072,4,13,6,10,47,40,7,45
Adelaide Utd,8072,5,11,6,11,37,40,-3,39
Brisbane,8072,6,10,5,13,33,42,-9,35
Western Sydn,8072,7,8,9,10,38,47,-9,33
Perth Glory,8072,8,10,2,15,37,50,-13,32
Wellington P,8072,9,5,6,16,31,55,-24,21
CC Mariners,8072,10,4,8,15,28,49,-21,20
Sydney FC,8073,1,21,4,3,68,22,46,67
N'castle Jet,8073,2,16,5,7,61,37,24,53
Melbourne C,8073,3,14,4,11,43,37,6,46
Melbourne V,8073,4,13,5,11,45,42,3,44
Adelaide Utd,8073,5,11,6,11,37,40,-3,39
Brisbane,8073,6,10,5,13,33,42,-9,35
Western Sydn,8073,7,8,9,10,38,47,-9,33
Perth Glory,8073,8,10,2,15,37,50,-13,32
Wellington P,8073,9,5,6,16,31,55,-24,21
CC Mariners,8073,10,4,8,15,28,49,-21,20
Sydney FC,8074,1,20,5,3,66,24,42,65
N'castle Jet,8074,2,15,5,8,57,38,19,50
Melbourne C,8074,3,15,4,10,44,33,11,49
Melbourne V,8074,4,13,6,10,47,40,7,45
Adelaide Utd,8074,5,11,6,11,37,40,-3,39
Brisbane,8074,6,10,5,13,33,42,-9,35
Western Sydn,8074,7,8,9,10,38,47,-9,33
Perth Glory,8074,8,10,2,15,37,50,-13,32
Wellington P,8074,9,5,6,16,31,55,-24,21
CC Mariners,8074,10,4,8,15,28,49,-21,20
Sydney FC,8075,1,21,4,3,70,23,47,67
N'castle Jet,8075,2,16,5,7,60,38,22,53
Melbourne C,8075,3,14,4,11,44,36,8,46
Melbourne V,8075,4,13,5,11,46,44,2,44
Adelaide Utd,8075,5,11,6,11,37,40,-3,39
Brisbane,8075,6,10,5,13,33,42,-9,35
Western Sydn,8075,7,8,9,10,38,47,-9,33
Perth Glory,8075,8,10,2,15,37,50,-13,32
Wellington P,8075,9,5,6,16,31,55,-24,21
CC Mariners,8075,10,4,8,15,28,49,-21,20
Sydney FC,8076,1,21,4,3,66,23,43,67
N'castle Jet,8076,2,16,5,7,58,37,21,53
Melbourne C,8076,3,14,4,11,43,34,9,46
Melbourne V,8076,4,13,5,11,46,40,6,44
Adelaide Utd,8076,5,11,6,11,37,40,-3,39
Brisbane,8076,6,10,5,13,33,42,-9,35
Western Sydn,8076,7,8,9,10,38,47,-9,33
Perth Glory,8076,8,10,2,15,37,50,-13,32
Wellington P,8076,9,5,6,16,31,55,-24,21
CC Mariners,8076,10,4,8,15,28,49,-21,20
Sydney FC,8077,1,20,5,3,67,25,42,65
N'castle Jet,8077,2,15,5,8,57,42,15,50
Melbourne C,8077,3,15,4,10,48,33,15,49
Melbourne V,8077,4,13,6,10,48,41,7,45
Adelaide Utd,8077,5,11,6,11,37,40,-3,39
Brisbane,8077,6,10,5,13,33,42,-9,35
Western Sydn,8077,7,8,9,10,38,47,-9,33
Perth Glory,8077,8,10,2,15,37,50,-13,32
Wellington P,8077,9,5,6,16,31,55,-24,21
CC Mariners,8077,10,4,8,15,28,49,-21,20
Sydney FC,8078,1,20,5,3,64,22,42,65
N'castle Jet,8078,2,15,5,8,58,39,19,50
Melbourne C,8078,3,15,4,10,45,34,11,49
Melbourne V,8078,4,13,6,10,45,38,7,45
Adelaide Utd,8078,5,11,6,11,37,40,-3,39
Brisbane,8078,6,10,5,13,33,42,-9,35
Western Sydn,8078,7,8,9,10,38,47,-9,33
Perth Glory,8078,8,10,2,15,37,50,-13,32
Wellington P,8078,9,5,6,16,31,55,-24,21
CC Mariners,8078,10,4,8,15,28,49,-21,20
Sydney FC,8079,1,21,4,3,65,22,43,67
N'castle Jet,8079,2,15,6,7,57,37,20,51
Melbourne C,8079,3,14,5,10,43,33,10,47
Melbourne V,8079,4,13,5,11,45,39,6,44
Adelaide Utd,8079,5,11,6,11,37,40,-3,39
Brisbane,8079,6,10,5,13,33,42,-9,35
Western Sydn,8079,7,8,9,10,38,47,-9,33
Perth Glory,8079,8,10,2,15,37,50,-13,32
Wellington P,8079,9,5,6,16,31,55,-24,21
CC Mariners,8079,10,4,8,15,28,49,-21,20
Sydney FC,8080,1,20,4,4,65,25,40,64
N'castle Jet,8080,2,15,5,8,57,38,19,50
Melbourne C,8080,3,15,4,10,44,33,11,49
Melbourne V,8080,4,14,5,10,48,39,9,47
Adelaide Utd,8080,5,11,6,11,37,40,-3,39
Brisbane,8080,6,10,5,13,33,42,-9,35
Western Sydn,8080,7,8,9,10,38,47,-9,33
Perth Glory,8080,8,10,2,15,37,50,-13,32
Wellington P,8080,9,5,6,16,31,55,-24,21
CC Mariners,8080,10,4,8,15,28,49,-21,20
Sydney FC,8081,1,21,4,3,67,23,44,67
N'castle Jet,8081,2,15,5,8,58,39,19,50
Melbourne C,8081,3,15,4,10,45,34,11,49
Melbourne V,8081,4,13,5,11,46,41,5,44
Adelaide Utd,8081,5,11,6,11,37,40,-3,39
Brisbane,8081,6,10,5,13,33,42,-9,35
Western Sydn,8081,7,8,9,10,38,47,-9,33
Perth Glory,8081,8,10,2,15,37,50,-13,32
Wellington P,8081,9,5,6,16,31,55,-24,21
CC Mariners,8081,10,4,8,15,28,49,-21,20
Sydney FC,8082,1,20,4,4,65,24,41,64
N'castle Jet,8082,2,16,5,7,59,38,21,53
Melbourne V,8082,3,14,5,10,47,39,8,47
Melbourne C,8082,4,14,4,11,44,35,9,46
Adelaide Utd,8082,5,11,6,11,37,40,-3,39
Brisbane,8082,6,10,5,13,33,42,-9,35
Western Sydn,8082,7,8,9,10,38,47,-9,33
Perth Glory,8082,8,10,2,15,37,50,-13,32
Wellington P,8082,9,5,6,16,31,55,-24,21
CC Mariners,8082,10,4,8,15,28,49,-21,20
Sydney FC,8083,1,21,4,3,68,23,45,67
N'castle Jet,8083,2,16,5,7,59,37,22,53
Melbourne C,8083,3,14,4,11,43,35,8,46
Melbourne V,8083,4,13,5,11,46,42,4,44
Adelaide Utd,8083,5,11,6,11,37,40,-3,39
Brisbane,8083,6,10,5,13,33,42,-9,35
Western Sydn,8083,7,8,9,10,38,47,-9,33
Perth Glory,8083,8,10,2,15,37,50,-13,32
Wellington P,8083,9,5,6,16,31,55,-24,21
CC Mariners,8083,10,4,8,15,28,49,-21,20
Sydney FC,8084,1,21,4,3,68,22,46,67
N'castle Jet,8084,2,16,5,7,60,38,22,53
Melbourne C,8084,3,14,4,11,44,36,8,46
Melbourne V,8084,4,13,5,11,45,42,3,44
Adelaide Utd,8084,5,11,6,11,37,40,-3,39
Brisbane,8084,6,10,5,13,33,42,-9,35
Western Sydn,8084,7,8,9,10,38,47,-9,33
Perth Glory,8084,8,10,2,15,37,50,-13,32
Wellington P,8084,9,5,6,16,31,55,-24,21
CC Mariners,8084,10,4,8,15,28,49,-21,20
Sydney FC,8085,1,20,5,3,65,23,42,65
N'castle Jet,8085,2,16,5,7,60,38,22,53
Melbourne C,8085,3,14,4,11,44,36,8,46
Melbourne V,8085,4,13,6,10,46,39,7,45
Adelaide Utd,8085,5,11,6,11,37,40,-3,39
Brisbane,8085,6,10,5,13,33,42,-9,35
Western Sydn,8085,7,8,9,10,38,47,-9,33
Perth Glory,8085,8,10,2,15,37,50,-13,32
Wellington P,8085,9,5,6,16,31,55,-24,21
CC Mariners,8085,10,4,8,15,28,49,-21,20
Sydney FC,8086,1,20,4,4,64,23,41,64
N'castle Jet,8086,2,16,5,7,59,38,21,53
Melbourne V,8086,3,14,5,10,46,38,8,47
Melbourne C,8086,4,14,4,11,44,35,9,46
Adelaide Utd,8086,5,11,6,11,37,40,-3,39
Brisbane,8086,6,10,5,13,33,42,-9,35
Western Sydn,8086,7,8,9,10,38,47,-9,33
Perth Glory,8086,8,10,2,15,37,50,-13,32
Wellington P,8086,9,5,6,16,31,55,-24,21
CC Mariners,8086,10,4,8,15,28,49,-21,20
Sydney FC,8087,1,20,4,4,65,24,41,64
N'castle Jet,8087,2,16,5,7,58,37,21,53
Melbourne V,8087,3,14,5,10,47,39,8,47
Melbourne C,8087,4,14,4,11,43,34,9,46
Adelaide Utd,8087,5,11,6,11,37,40,-3,39
Brisbane,8087,6,10,5,13,33,42,-9,35
Western Sydn,8087,7,8,9,10,38,47,-9,33
Perth Glory,8087,8,10,2,15,37,50,-13,32
Wellington P,8087,9,5,6,16,31,55,-24,21
CC Mariners,8087,10,4,8,15,28,49,-21,20
Sydney FC,8088,1,20,5,3,65,23,42,65
N'castle Jet,8088,2,15,6,7,59,39,20,51
Melbourne C,8088,3,14,5,10,45,35,10,47
Melbourne V,8088,4,13,6,10,46,39,7,45
Adelaide Utd,8088,5,11,6,11,37,40,-3,39
Brisbane,8088,6,10,5,13,33,42,-9,35
Western Sydn,8088,7,8,9,10,38,47,-9,33
Perth Glory,8088,8,10,2,15,37,50,-13,32
Wellington P,8088,9,5,6,16,31,55,-24,21
CC Mariners,8088,10,4,8,15,28,49,-21,20
Sydney FC,8089,1,21,4,3,66,22,44,67
N'castle Jet,8089,2,16,5,7,61,37,24,53
Melbourne C,8089,3,14,4,11,43,37,6,46
Melbourne V,8089,4,13,5,11,45,40,5,44
Adelaide Utd,8089,5,11,6,11,37,40,-3,39
Brisbane,8089,6,10,5,13,33,42,-9,35
Western Sydn,8089,7,8,9,10,38,47,-9,33
Perth Glory,8089,8,10,2,15,37,50,-13,32
Wellington P,8089,9,5,6,16,31,55,-24,21
CC Mariners,8089,10,4,8,15,28,49,-21,20
Sydney FC,8090,1,21,4,3,68,24,44,67
N'castle Jet,8090,2,15,5,8,59,40,19,50
Melbourne C,8090,3,15,4,10,46,35,11,49
Melbourne V,8090,4,13,5,11,47,42,5,44
Adelaide Utd,8090,5,11,6,11,37,40,-3,39
Brisbane,8090,6,10,5,13,33,42,-9,35
Western Sydn,8090,7,8,9,10,38,47,-9,33
Perth Glory,8090,8,10,2,15,37,50,-13,32
Wellington P,8090,9,5,6,16,31,55,-24,21
CC Mariners,8090,10,4,8,15,28,49,-21,20
Sydney FC,8091,1,21,4,3,66,22,44,67
N'castle Jet,8091,2,16,5,7,60,38,22,53
Melbourne C,8091,3,14,4,11,44,36,8,46
Melbourne V,8091,4,13,5,11,45,40,5,44
Adelaide Utd,8091,5,11,6,11,37,40,-3,39
Brisbane,8091,6,10,5,13,33,42,-9,35
Western Sydn,8091,7,8,9,10,38,47,-9,33
Perth Glory,8091,8,10,2,15,37,50,-13,32
Wellington P,8091,9,5,6,16,31,55,-24,21
CC Mariners,8091,10,4,8,15,28,49,-21,20
Sydney FC,8092,1,20,5,3,65,23,42,65
N'castle Jet,8092,2,16,5,7,61,38,23,53
Melbourne C,8092,3,14,4,11,44,37,7,46
Melbourne V,8092,4,13,6,10,46,39,7,45
Adelaide Utd,8092,5,11,6,11,37,40,-3,39
Brisbane,8092,6,10,5,13,33,42,-9,35
Western Sydn,8092,7,8,9,10,38,47,-9,33
Perth Glory,8092,8,10,2,15,37,50,-13,32
Wellington P,8092,9,5,6,16,31,55,-24,21
CC Mariners,8092,10,4,8,15,28,49,-21,20
Sydney FC,8093,1,21,4,3,68,23,45,67
N'castle Jet,8093,2,16,5,7,60,37,23,53
Melbourne C,8093,3,14,4,11,43,36,7,46
Melbourne V,8093,4,13,5,11,46,42,4,44
Adelaide Utd,8093,5,11,6,11,37,40,-3,39
Brisbane,8093,6,10,5,13,33,42,-9,35
Western Sydn,8093,7,8,9,10,38,47,-9,33
Perth Glory,8093,8,10,2,15,37,50,-13,32
Wellington P,8093,9,5,6,16,31,55,-24,21
CC Mariners,8093,10,4,8,15,28,49,-21,20
Sydney FC,8094,1,21,4,3,66,23,43,67
N'castle Jet,8094,2,15,6,7,59,39,20,51
Melbourne C,8094,3,14,5,10,45,35,10,47
Melbourne V,8094,4,13,5,11,46,40,6,44
Adelaide Utd,8094,5,11,6,11,37,40,-3,39
Brisbane,8094,6,10,5,13,33,42,-9,35
Western Sydn,8094,7,8,9,10,38,47,-9,33
Perth Glory,8094,8,10,2,15,37,50,-13,32
Wellington P,8094,9,5,6,16,31,55,-24,21
CC Mariners,8094,10,4,8,15,28,49,-21,20
Sydney FC,8095,1,20,4,4,67,26,41,64
N'castle Jet,8095,2,15,5,8,59,40,19,50
Melbourne C,8095,3,15,4,10,46,35,11,49
Melbourne V,8095,4,14,5,10,49,41,8,47
Adelaide Utd,8095,5,11,6,11,37,40,-3,39
Brisbane,8095,6,10,5,13,33,42,-9,35
Western Sydn,8095,7,8,9,10,38,47,-9,33
Perth Glory,8095,8,10,2,15,37,50,-13,32
Wellington P,8095,9,5,6,16,31,55,-24,21
CC Mariners,8095,10,4,8,15,28,49,-21,20
Sydney FC,8096,1,21,4,3,65,22,43,67
N'castle Jet,8096,2,15,6,7,59,39,20,51
Melbourne C,8096,3,14,5,10,45,35,10,47
Melbourne V,8096,4,13,5,11,45,39,6,44
Adelaide Utd,8096,5,11,6,11,37,40,-3,39
Brisbane,8096,6,10,5,13,33,42,-9,35
Western Sydn,8096,7,8,9,10,38,47,-9,33
Perth Glory,8096,8,10,2,15,37,50,-13,32
Wellington P,8096,9,5,6,16,31,55,-24,21
CC Mariners,8096,10,4,8,15,28,49,-21,20
Sydney FC,8097,1,20,4,4,66,27,39,64
N'castle Jet,8097,2,15,6,7,57,37,20,51
Melbourne V,8097,3,14,5,10,50,40,10,47
Melbourne C,8097,4,14,5,10,43,33,10,47
Adelaide Utd,8097,5,11,6,11,37,40,-3,39
Brisbane,8097,6,10,5,13,33,42,-9,35
Western Sydn,8097,7,8,9,10,38,47,-9,33
Perth Glory,8097,8,10,2,15,37,50,-13,32
Wellington P,8097,9,5,6,16,31,55,-24,21
CC Mariners,8097,10,4,8,15,28,49,-21,20
Sydney FC,8098,1,21,4,3,70,24,46,67
N'castle Jet,8098,2,16,5,7,60,37,23,53
Melbourne C,8098,3,14,4,11,43,36,7,46
Melbourne V,8098,4,13,5,11,47,44,3,44
Adelaide Utd,8098,5,11,6,11,37,40,-3,39
Brisbane,8098,6,10,5,13,33,42,-9,35
Western Sydn,8098,7,8,9,10,38,47,-9,33
Perth Glory,8098,8,10,2,15,37,50,-13,32
Wellington P,8098,9,5,6,16,31,55,-24,21
CC Mariners,8098,10,4,8,15,28,49,-21,20
Sydney FC,8099,1,20,4,4,65,24,41,64
N'castle Jet,8099,2,16,5,7,59,38,21,53
Melbourne V,8099,3,14,5,10,47,39,8,47
Melbourne C,8099,4,14,4,11,44,35,9,46
Adelaide Utd,8099,5,11,6,11,37,40,-3,39
Brisbane,8099,6,10,5,13,33,42,-9,35
Western Sydn,8099,7,8,9,10,38,47,-9,33
Perth Glory,8099,8,10,2,15,37,50,-13,32
Wellington P,8099,9,5,6,16,31,55,-24,21
CC Mariners,8099,10,4,8,15,28,49,-21,20
Sydney FC,8100,1,21,4,3,67,23,44,67
N'castle Jet,8100,2,16,5,7,58,37,21,53
Melbourne C,8100,3,14,4,11,43,34,9,46
Melbourne V,8100,4,13,5,11,46,41,5,44
Adelaide Utd,8100,5,11,6,11,37,40,-3,39
Brisbane,8100,6,10,5,13,33,42,-9,35
Western Sydn,8100,7,8,9,10,38,47,-9,33
Perth Glory,8100,8,10,2,15,37,50,-13,32
Wellington P,8100,9,5,6,16,31,55,-24,21
CC Mariners,8100,10,4,8,15,28,49,-21,20
Sydney FC,8101,1,21,4,3,66,23,43,67
N'castle Jet,8101,2,15,6,7,58,38,20,51
Melbourne C,8101,3,14,5,10,44,34,10,47
Melbourne V,8101,4,13,5,11,46,40,6,44
Adelaide Utd,8101,5,11,6,11,37,40,-3,39
Brisbane,8101,6,10,5,13,33,42,-9,35
Western Sydn,8101,7,8,9,10,38,47,-9,33
Perth Glory,8101,8,10,2,15,37,50,-13,32
Wellington P,8101,9,5,6,16,31,55,-24,21
CC Mariners,8101,10,4,8,15,28,49,-21,20
Sydney FC,8102,1,21,4,3,65,22,43,67
N'castle Jet,8102,2,16,5,7,59,38,21,53
Melbourne C,8102,3,14,4,11,44,35,9,46
Melbourne V,8102,4,13,5,11,45,39,6,44
Adelaide Utd,8102,5,11,6,11,37,40,-3,39
Brisbane,8102,6,10,5,13,33,42,-9,35
Western Sydn,8102,7,8,9,10,38,47,-9,33
Perth Glory,8102,8,10,2,15,37,50,-13,32
Wellington P,8102,9,5,6,16,31,55,-24,21
CC Mariners,8102,10,4,8,15,28,49,-21,20
Sydney FC,8103,1,21,4,3,66,22,44,67
N'castle Jet,8103,2,16,5,7,59,38,21,53
Melbourne C,8103,3,14,4,11,44,35,9,46
Melbourne V,8103,4,13,5,11,45,40,5,44
Adelaide Utd,8103,5,11,6,11,37,40,-3,39
Brisbane,8103,6,10,5,13,33,42,-9,35
Western Sydn,8103,7,8,9,10,38,47,-9,33
Perth Glory,8103,8,10,2,15,37,50,-13,32
Wellington P,8103,9,5,6,16,31,55,-24,21
CC Mariners,8103,10,4,8,15,28,49,-21,20
Sydney FC,8104,1,20,5,3,64,22,42,65
N'castle Jet,8104,2,16,5,7,58,37,21,53
Melbourne C,8104,3,14,4,11,43,34,9,46
Melbourne V,8104,4,13,6,10,45,38,7,45
Adelaide Utd,8104,5,11,6,11,37,40,-3,39
Brisbane,8104,6,10,5,13,33,42,-9,35
Western Sydn,8104,7,8,9,10,38,47,-9,33
Perth Glory,8104,8,10,2,15,37,50,-13,32
Wellington P,8104,9,5,6,16,31,55,-24,21
CC Mariners,8104,10,4,8,15,28,49,-21,20
Sydney FC,8105,1,21,4,3,68,23,45,67
N'castle Jet,8105,2,16,5,7,61,39,22,53
Melbourne C,8105,3,14,4,11,45,37,8,46
Melbourne V,8105,4,13,5,11,46,42,4,44
Adelaide Utd,8105,5,11,6,11,37,40,-3,39
Brisbane,8105,6,10,5,13,33,42,-9,35
Western Sydn,8105,7,8,9,10,38,47,-9,33
Perth Glory,8105,8,10,2,15,37,50,-13,32
Wellington P,8105,9,5,6,16,31,55,-24,21
CC Mariners,8105,10,4,8,15,28,49,-21,20
Sydney FC,8106,1,21,4,3,66,23,43,67
N'castle Jet,8106,2,16,5,7,61,39,22,53
Melbourne C,8106,3,14,4,11,45,37,8,46
Melbourne V,8106,4,13,5,11,46,40,6,44
Adelaide Utd,8106,5,11,6,11,37,40,-3,39
Brisbane,8106,6,10,5,13,33,42,-9,35
Western Sydn,8106,7,8,9,10,38,47,-9,33
Perth Glory,8106,8,10,2,15,37,50,-13,32
Wellington P,8106,9,5,6,16,31,55,-24,21
CC Mariners,8106,10,4,8,15,28,49,-21,20
Sydney FC,8107,1,20,4,4,66,25,41,64
N'castle Jet,8107,2,16,5,7,59,37,22,53
Melbourne V,8107,3,14,5,10,48,40,8,47
Melbourne C,8107,4,14,4,11,43,35,8,46
Adelaide Utd,8107,5,11,6,11,37,40,-3,39
Brisbane,8107,6,10,5,13,33,42,-9,35
Western Sydn,8107,7,8,9,10,38,47,-9,33
Perth Glory,8107,8,10,2,15,37,50,-13,32
Wellington P,8107,9,5,6,16,31,55,-24,21
CC Mariners,8107,10,4,8,15,28,49,-21,20
Sydney FC,8108,1,21,4,3,65,22,43,67
N'castle Jet,8108,2,15,6,7,57,37,20,51
Melbourne C,8108,3,14,5,10,43,33,10,47
Melbourne V,8108,4,13,5,11,45,39,6,44
Adelaide Utd,8108,5,11,6,11,37,40,-3,39
Brisbane,8108,6,10,5,13,33,42,-9,35
Western Sydn,8108,7,8,9,10,38,47,-9,33
Perth Glory,8108,8,10,2,15,37,50,-13,32
Wellington P,8108,9,5,6,16,31,55,-24,21
CC Mariners,8108,10,4,8,15,28,49,-21,20
Sydney FC,8109,1,20,5,3,65,23,42,65
N'castle Jet,8109,2,15,5,8,59,40,19,50
Melbourne C,8109,3,15,4,10,46,35,11,49
Melbourne V,8109,4,13,6,10,46,39,7,45
Adelaide Utd,8109,5,11,6,11,37,40,-3,39
Brisbane,8109,6,10,5,13,33,42,-9,35
Western Sydn,8109,7,8,9,10,38,47,-9,33
Perth Glory,8109,8,10,2,15,37,50,-13,32
Wellington P,8109,9,5,6,16,31,55,-24,21
CC Mariners,8109,10,4,8,15,28,49,-21,20
Sydney FC,8110,1,21,4,3,65,22,43,67
N'castle Jet,8110,2,16,5,7,60,37,23,53
Melbourne C,8110,3,14,4,11,43,36,7,46
Melbourne V,8110,4,13,5,11,45,39,6,44
Adelaide Utd,8110,5,11,6,11,37,40,-3,39
Brisbane,8110,6,10,5,13,33,42,-9,35
Western Sydn,8110,7,8,9,10,38,47,-9,33
Perth Glory,8110,8,10,2,15,37,50,-13,32
Wellington P,8110,9,5,6,16,31,55,-24,21
CC Mariners,8110,10,4,8,15,28,49,-21,20
Sydney FC,8111,1,21,4,3,66,23,43,67
N'castle Jet,8111,2,16,5,7,59,38,21,53
Melbourne C,8111,3,14,4,11,44,35,9,46
Melbourne V,8111,4,13,5,11,46,40,6,44
Adelaide Utd,8111,5,11,6,11,37,40,-3,39
Brisbane,8111,6,10,5,13,33,42,-9,35
Western Sydn,8111,7,8,9,10,38,47,-9,33
Perth Glory,8111,8,10,2,15,37,50,-13,32
Wellington P,8111,9,5,6,16,31,55,-24,21
CC Mariners,8111,10,4,8,15,28,49,-21,20
Sydney FC,8112,1,20,4,4,65,24,41,64
N'castle Jet,8112,2,16,5,7,59,38,21,53
Melbourne V,8112,3,14,5,10,47,39,8,47
Melbourne C,8112,4,14,4,11,44,35,9,46
Adelaide Utd,8112,5,11,6,11,37,40,-3,39
Brisbane,8112,6,10,5,13,33,42,-9,35
Western Sydn,8112,7,8,9,10,38,47,-9,33
Perth Glory,8112,8,10,2,15,37,50,-13,32
Wellington P,8112,9,5,6,16,31,55,-24,21
CC Mariners,8112,10,4,8,15,28,49,-21,20
Sydney FC,8113,1,21,4,3,66,22,44,67
N'castle Jet,8113,2,15,5,8,58,39,19,50
Melbourne C,8113,3,15,4,10,45,34,11,49
Melbourne V,8113,4,13,5,11,45,40,5,44
Adelaide Utd,8113,5,11,6,11,37,40,-3,39
Brisbane,8113,6,10,5,13,33,42,-9,35
Western Sydn,8113,7,8,9,10,38,47,-9,33
Perth Glory,8113,8,10,2,15,37,50,-13,32
Wellington P,8113,9,5,6,16,31,55,-24,21
CC Mariners,8113,10,4,8,15,28,49,-21,20
Sydney FC,8114,1,21,4,3,66,23,43,67
N'castle Jet,8114,2,15,5,8,57,40,17,50
Melbourne C,8114,3,15,4,10,46,33,13,49
Melbourne V,8114,4,13,5,11,46,40,6,44
Adelaide Utd,8114,5,11,6,11,37,40,-3,39
Brisbane,8114,6,10,5,13,33,42,-9,35
Western Sydn,8114,7,8,9,10,38,47,-9,33
Perth Glory,8114,8,10,2,15,37,50,-13,32
Wellington P,8114,9,5,6,16,31,55,-24,21
CC Mariners,8114,10,4,8,15,28,49,-21,20
Sydney FC,8115,1,20,4,4,65,25,40,64
N'castle Jet,8115,2,15,5,8,58,39,19,50
Melbourne C,8115,3,15,4,10,45,34,11,49
Melbourne V,8115,4,14,5,10,48,39,9,47
Adelaide Utd,8115,5,11,6,11,37,40,-3,39
Brisbane,8115,6,10,5,13,33,42,-9,35
Western Sydn,8115,7,8,9,10,38,47,-9,33
Perth Glory,8115,8,10,2,15,37,50,-13,32
Wellington P,8115,9,5,6,16,31,55,-24,21
CC Mariners,8115,10,4,8,15,28,49,-21,20
Sydney FC,8116,1,20,5,3,66,24,42,65
N'castle Jet,8116,2,15,6,7,57,37,20,51
Melbourne C,8116,3,14,5,10,43,33,10,47
Melbourne V,8116,4,13,6,10,47,40,7,45
Adelaide Utd,8116,5,11,6,11,37,40,-3,39
Brisbane,8116,6,10,5,13,33,42,-9,35
Western Sydn,8116,7,8,9,10,38,47,-9,33
Perth Glory,8116,8,10,2,15,37,50,-13,32
Wellington P,8116,9,5,6,16,31,55,-24,21
CC Mariners,8116,10,4,8,15,28,49,-21,20
Sydney FC,8117,1,20,5,3,64,22,42,65
N'castle Jet,8117,2,16,5,7,59,38,21,53
Melbourne C,8117,3,14,4,11,44,35,9,46
Melbourne V,8117,4,13,6,10,45,38,7,45
Adelaide Utd,8117,5,11,6,11,37,40,-3,39
Brisbane,8117,6,10,5,13,33,42,-9,35
Western Sydn,8117,7,8,9,10,38,47,-9,33
Perth Glory,8117,8,10,2,15,37,50,-13,32
Wellington P,8117,9,5,6,16,31,55,-24,21
CC Mariners,8117,10,4,8,15,28,49,-21,20
Sydney FC,8118,1,21,4,3,66,23,43,67
N'castle Jet,8118,2,15,6,7,60,40,20,51
Melbourne C,8118,3,14,5,10,46,36,10,47
Melbourne V,8118,4,13,5,11,46,40,6,44
Adelaide Utd,8118,5,11,6,11,37,40,-3,39
Brisbane,8118,6,10,5,13,33,42,-9,35
Western Sydn,8118,7,8,9,10,38,47,-9,33
Perth Glory,8118,8,10,2,15,37,50,-13,32
Wellington P,8118,9,5,6,16,31,55,-24,21
CC Mariners,8118,10,4,8,15,28,49,-21,20
Sydney FC,8119,1,20,5,3,66,24,42,65
N'castle Jet,8119,2,16,5,7,59,38,21,53
Melbourne C,8119,3,14,4,11,44,35,9,46
Melbourne V,8119,4,13,6,10,47,40,7,45
Adelaide Utd,8119,5,11,6,11,37,40,-3,39
Brisbane,8119,6,10,5,13,33,42,-9,35
Western Sydn,8119,7,8,9,10,38,47,-9,33
Perth Glory,8119,8,10,2,15,37,50,-13,32
Wellington P,8119,9,5,6,16,31,55,-24,21
CC Mariners,8119,10,4,8,15,28,49,-21,20
Sydney FC,8120,1,21,4,3,70,23,47,67
N'castle Jet,8120,2,16,5,7,60,38,22,53
Melbourne C,8120,3,14,4,11,44,36,8,46
Melbourne V,8120,4,13,5,11,46,44,2,44
Adelaide Utd,8120,5,11,6,11,37,40,-3,39
Brisbane,8120,6,10,5,13,33,42,-9,35
Western Sydn,8120,7,8,9,10,38,47,-9,33
Perth Glory,8120,8,10,2,15,37,50,-13,32
Wellington P,8120,9,5,6,16,31,55,-24,21
CC Mariners,8120,10,4,8,15,28,49,-21,20
Sydney FC,8121,1,21,4,3,67,24,43,67
N'castle Jet,8121,2,15,5,8,57,39,18,50
Melbourne C,8121,3,15,4,10,45,33,12,49
Melbourne V,8121,4,13,5,11,47,41,6,44
Adelaide Utd,8121,5,11,6,11,37,40,-3,39
Brisbane,8121,6,10,5,13,33,42,-9,35
Western Sydn,8121,7,8,9,10,38,47,-9,33
Perth Glory,8121,8,10,2,15,37,50,-13,32
Wellington P,8121,9,5,6,16,31,55,-24,21
CC Mariners,8121,10,4,8,15,28,49,-21,20
Sydney FC,8122,1,21,4,3,67,24,43,67
N'castle Jet,8122,2,16,5,7,60,37,23,53
Melbourne C,8122,3,14,4,11,43,36,7,46
Melbourne V,8122,4,13,5,11,47,41,6,44
Adelaide Utd,8122,5,11,6,11,37,40,-3,39
Brisbane,8122,6,10,5,13,33,42,-9,35
Western Sydn,8122,7,8,9,10,38,47,-9,33
Perth Glory,8122,8,10,2,15,37,50,-13,32
Wellington P,8122,9,5,6,16,31,55,-24,21
CC Mariners,8122,10,4,8,15,28,49,-21,20
Sydney FC,8123,1,21,4,3,66,23,43,67
N'castle Jet,8123,2,16,5,7,59,38,21,53
Melbourne C,8123,3,14,4,11,44,35,9,46
Melbourne V,8123,4,13,5,11,46,40,6,44
Adelaide Utd,8123,5,11,6,11,37,40,-3,39
Brisbane,8123,6,10,5,13,33,42,-9,35
Western Sydn,8123,7,8,9,10,38,47,-9,33
Perth Glory,8123,8,10,2,15,37,50,-13,32
Wellington P,8123,9,5,6,16,31,55,-24,21
CC Mariners,8123,10,4,8,15,28,49,-21,20
Sydney FC,8124,1,21,4,3,66,23,43,67
N'castle Jet,8124,2,15,5,8,57,38,19,50
Melbourne C,8124,3,15,4,10,44,33,11,49
Melbourne V,8124,4,13,5,11,46,40,6,44
Adelaide Utd,8124,5,11,6,11,37,40,-3,39
Brisbane,8124,6,10,5,13,33,42,-9,35
Western Sydn,8124,7,8,9,10,38,47,-9,33
Perth Glory,8124,8,10,2,15,37,50,-13,32
Wellington P,8124,9,5,6,16,31,55,-24,21
CC Mariners,8124,10,4,8,15,28,49,-21,20
Sydney FC,8125,1,20,4,4,66,26,40,64
N'castle Jet,8125,2,16,5,7,59,38,21,53
Melbourne V,8125,3,14,5,10,49,40,9,47
Melbourne C,8125,4,14,4,11,44,35,9,46
Adelaide Utd,8125,5,11,6,11,37,40,-3,39
Brisbane,8125,6,10,5,13,33,42,-9,35
Western Sydn,8125,7,8,9,10,38,47,-9,33
Perth Glory,8125,8,10,2,15,37,50,-13,32
Wellington P,8125,9,5,6,16,31,55,-24,21
CC Mariners,8125,10,4,8,15,28,49,-21,20
Sydney FC,8126,1,21,4,3,67,24,43,67
N'castle Jet,8126,2,15,6,7,58,38,20,51
Melbourne C,8126,3,14,5,10,44,34,10,47
Melbourne V,8126,4,13,5,11,47,41,6,44
Adelaide Utd,8126,5,11,6,11,37,40,-3,39
Brisbane,8126,6,10,5,13,33,42,-9,35
Western Sydn,8126,7,8,9,10,38,47,-9,33
Perth Glory,8126,8,10,2,15,37,50,-13,32
Wellington P,8126,9,5,6,16,31,55,-24,21
CC Mariners,8126,10,4,8,15,28,49,-21,20
Sydney FC,8127,1,20,4,4,67,26,41,64
N'castle Jet,8127,2,15,6,7,59,39,20,51
Melbourne C,8127,3,14,5,10,45,35,10,47
Melbourne V,8127,4,14,5,10,49,41,8,47
Adelaide Utd,8127,5,11,6,11,37,40,-3,39
Brisbane,8127,6,10,5,13,33,42,-9,35
Western Sydn,8127,7,8,9,10,38,47,-9,33
Perth Glory,8127,8,10,2,15,37,50,-13,32
Wellington P,8127,9,5,6,16,31,55,-24,21
CC Mariners,8127,10,4,8,15,28,49,-21,20
Sydney FC,8128,1,21,4,3,66,22,44,67
N'castle Jet,8128,2,15,6,7,59,39,20,51
Melbourne C,8128,3,14,5,10,45,35,10,47
Melbourne V,8128,4,13,5,11,45,40,5,44
Adelaide Utd,8128,5,11,6,11,37,40,-3,39
Brisbane,8128,6,10,5,13,33,42,-9,35
Western Sydn,8128,7,8,9,10,38,47,-9,33
Perth Glory,8128,8,10,2,15,37,50,-13,32
Wellington P,8128,9,5,6,16,31,55,-24,21
CC Mariners,8128,10,4,8,15,28,49,-21,20
Sydney FC,8129,1,21,4,3,67,22,45,67
N'castle Jet,8129,2,16,5,7,59,37,22,53
Melbourne C,8129,3,14,4,11,43,35,8,46
Melbourne V,8129,4,13,5,11,45,41,4,44
Adelaide Utd,8129,5,11,6,11,37,40,-3,39
Brisbane,8129,6,10,5,13,33,42,-9,35
Western Sydn,8129,7,8,9,10,38,47,-9,33
Perth Glory,8129,8,10,2,15,37,50,-13,32
Wellington P,8129,9,5,6,16,31,55,-24,21
CC Mariners,8129,10,4,8,15,28,49,-21,20
Sydney FC,8130,1,20,5,3,66,24,42,65
N'castle Jet,8130,2,15,6,7,57,37,20,51
Melbourne C,8130,3,14,5,10,43,33,10,47
Melbourne V,8130,4,13,6,10,47,40,7,45
Adelaide Utd,8130,5,11,6,11,37,40,-3,39
Brisbane,8130,6,10,5,13,33,42,-9,35
Western Sydn,8130,7,8,9,10,38,47,-9,33
Perth Glory,8130,8,10,2,15,37,50,-13,32
Wellington P,8130,9,5,6,16,31,55,-24,21
CC Mariners,8130,10,4,8,15,28,49,-21,20
Sydney FC,8131,1,21,4,3,66,22,44,67
N'castle Jet,8131,2,16,5,7,61,40,21,53
Melbourne C,8131,3,14,4,11,46,37,9,46
Melbourne V,8131,4,13,5,11,45,40,5,44
Adelaide Utd,8131,5,11,6,11,37,40,-3,39
Brisbane,8131,6,10,5,13,33,42,-9,35
Western Sydn,8131,7,8,9,10,38,47,-9,33
Perth Glory,8131,8,10,2,15,37,50,-13,32
Wellington P,8131,9,5,6,16,31,55,-24,21
CC Mariners,8131,10,4,8,15,28,49,-21,20
Sydney FC,8132,1,21,4,3,68,24,44,67
N'castle Jet,8132,2,15,5,8,57,39,18,50
Melbourne C,8132,3,15,4,10,45,33,12,49
Melbourne V,8132,4,13,5,11,47,42,5,44
Adelaide Utd,8132,5,11,6,11,37,40,-3,39
Brisbane,8132,6,10,5,13,33,42,-9,35
Western Sydn,8132,7,8,9,10,38,47,-9,33
Perth Glory,8132,8,10,2,15,37,50,-13,32
Wellington P,8132,9,5,6,16,31,55,-24,21
CC Mariners,8132,10,4,8,15,28,49,-21,20
Sydney FC,8133,1,21,4,3,66,23,43,67
N'castle Jet,8133,2,15,6,7,60,40,20,51
Melbourne C,8133,3,14,5,10,46,36,10,47
Melbourne V,8133,4,13,5,11,46,40,6,44
Adelaide Utd,8133,5,11,6,11,37,40,-3,39
Brisbane,8133,6,10,5,13,33,42,-9,35
Western Sydn,8133,7,8,9,10,38,47,-9,33
Perth Glory,8133,8,10,2,15,37,50,-13,32
Wellington P,8133,9,5,6,16,31,55,-24,21
CC Mariners,8133,10,4,8,15,28,49,-21,20
Sydney FC,8134,1,20,5,3,67,25,42,65
N'castle Jet,8134,2,15,6,7,60,40,20,51
Melbourne C,8134,3,14,5,10,46,36,10,47
Melbourne V,8134,4,13,6,10,48,41,7,45
Adelaide Utd,8134,5,11,6,11,37,40,-3,39
Brisbane,8134,6,10,5,13,33,42,-9,35
Western Sydn,8134,7,8,9,10,38,47,-9,33
Perth Glory,8134,8,10,2,15,37,50,-13,32
Wellington P,8134,9,5,6,16,31,55,-24,21
CC Mariners,8134,10,4,8,15,28,49,-21,20
Sydney FC,8135,1,21,4,3,67,22,45,67
N'castle Jet,8135,2,15,5,8,57,38,19,50
Melbourne C,8135,3,15,4,10,44,33,11,49
Melbourne V,8135,4,13,5,11,45,41,4,44
Adelaide Utd,8135,5,11,6,11,37,40,-3,39
Brisbane,8135,6,10,5,13,33,42,-9,35
Western Sydn,8135,7,8,9,10,38,47,-9,33
Perth Glory,8135,8,10,2,15,37,50,-13,32
Wellington P,8135,9,5,6,16,31,55,-24,21
CC Mariners,8135,10,4,8,15,28,49,-21,20
Sydney FC,8136,1,21,4,3,67,22,45,67
N'castle Jet,8136,2,15,5,8,59,41,18,50
Melbourne C,8136,3,15,4,10,47,35,12,49
Melbourne V,8136,4,13,5,11,45,41,4,44
Adelaide Utd,8136,5,11,6,11,37,40,-3,39
Brisbane,8136,6,10,5,13,33,42,-9,35
Western Sydn,8136,7,8,9,10,38,47,-9,33
Perth Glory,8136,8,10,2,15,37,50,-13,32
Wellington P,8136,9,5,6,16,31,55,-24,21
CC Mariners,8136,10,4,8,15,28,49,-21,20
Sydney FC,8137,1,20,5,3,66,24,42,65
N'castle Jet,8137,2,16,5,7,58,37,21,53
Melbourne C,8137,3,14,4,11,43,34,9,46
Melbourne V,8137,4,13,6,10,47,40,7,45
Adelaide Utd,8137,5,11,6,11,37,40,-3,39
Brisbane,8137,6,10,5,13,33,42,-9,35
Western Sydn,8137,7,8,9,10,38,47,-9,33
Perth Glory,8137,8,10,2,15,37,50,-13,32
Wellington P,8137,9,5,6,16,31,55,-24,21
CC Mariners,8137,10,4,8,15,28,49,-21,20
Sydney FC,8138,1,21,4,3,66,23,43,67
N'castle Jet,8138,2,15,5,8,58,39,19,50
Melbourne C,8138,3,15,4,10,45,34,11,49
Melbourne V,8138,4,13,5,11,46,40,6,44
Adelaide Utd,8138,5,11,6,11,37,40,-3,39
Brisbane,8138,6,10,5,13,33,42,-9,35
Western Sydn,8138,7,8,9,10,38,47,-9,33
Perth Glory,8138,8,10,2,15,37,50,-13,32
Wellington P,8138,9,5,6,16,31,55,-24,21
CC Mariners,8138,10,4,8,15,28,49,-21,20
Sydney FC,8139,1,20,5,3,64,22,42,65
N'castle Jet,8139,2,16,5,7,59,38,21,53
Melbourne C,8139,3,14,4,11,44,35,9,46
Melbourne V,8139,4,13,6,10,45,38,7,45
Adelaide Utd,8139,5,11,6,11,37,40,-3,39
Brisbane,8139,6,10,5,13,33,42,-9,35
Western Sydn,8139,7,8,9,10,38,47,-9,33
Perth Glory,8139,8,10,2,15,37,50,-13,32
Wellington P,8139,9,5,6,16,31,55,-24,21
CC Mariners,8139,10,4,8,15,28,49,-21,20
Sydney FC,8140,1,20,4,4,64,23,41,64
N'castle Jet,8140,2,15,6,7,58,38,20,51
Melbourne C,8140,3,14,5,10,44,34,10,47
Melbourne V,8140,4,14,5,10,46,38,8,47
Adelaide Utd,8140,5,11,6,11,37,40,-3,39
Brisbane,8140,6,10,5,13,33,42,-9,35
Western Sydn,8140,7,8,9,10,38,47,-9,33
Perth Glory,8140,8,10,2,15,37,50,-13,32
Wellington P,8140,9,5,6,16,31,55,-24,21
CC Mariners,8140,10,4,8,15,28,49,-21,20
Sydney FC,8141,1,20,5,3,65,23,42,65
N'castle Jet,8141,2,15,6,7,58,38,20,51
Melbourne C,8141,3,14,5,10,44,34,10,47
Melbourne V,8141,4,13,6,10,46,39,7,45
Adelaide Utd,8141,5,11,6,11,37,40,-3,39
Brisbane,8141,6,10,5,13,33,42,-9,35
Western Sydn,8141,7,8,9,10,38,47,-9,33
Perth Glory,8141,8,10,2,15,37,50,-13,32
Wellington P,8141,9,5,6,16,31,55,-24,21
CC Mariners,8141,10,4,8,15,28,49,-21,20
Sydney FC,8142,1,21,4,3,70,22,48,67
N'castle Jet,8142,2,16,5,7,61,38,23,53
Melbourne C,8142,3,14,4,11,44,37,7,46
Melbourne V,8142,4,13,5,11,45,44,1,44
Adelaide Utd,8142,5,11,6,11,37,40,-3,39
Brisbane,8142,6,10,5,13,33,42,-9,35
Western Sydn,8142,7,8,9,10,38,47,-9,33
Perth Glory,8142,8,10,2,15,37,50,-13,32
Wellington P,8142,9,5,6,16,31,55,-24,21
CC Mariners,8142,10,4,8,15,28,49,-21,20
Sydney FC,8143,1,20,4,4,65,24,41,64
N'castle Jet,8143,2,16,5,7,59,38,21,53
Melbourne V,8143,3,14,5,10,47,39,8,47
Melbourne C,8143,4,14,4,11,44,35,9,46
Adelaide Utd,8143,5,11,6,11,37,40,-3,39
Brisbane,8143,6,10,5,13,33,42,-9,35
Western Sydn,8143,7,8,9,10,38,47,-9,33
Perth Glory,8143,8,10,2,15,37,50,-13,32
Wellington P,8143,9,5,6,16,31,55,-24,21
CC Mariners,8143,10,4,8,15,28,49,-21,20
Sydney FC,8144,1,21,4,3,70,22,48,67
N'castle Jet,8144,2,16,5,7,60,39,21,53
Melbourne C,8144,3,14,4,11,45,36,9,46
Melbourne V,8144,4,13,5,11,45,44,1,44
Adelaide Utd,8144,5,11,6,11,37,40,-3,39
Brisbane,8144,6,10,5,13,33,42,-9,35
Western Sydn,8144,7,8,9,10,38,47,-9,33
Perth Glory,8144,8,10,2,15,37,50,-13,32
Wellington P,8144,9,5,6,16,31,55,-24,21
CC Mariners,8144,10,4,8,15,28,49,-21,20
Sydney FC,8145,1,21,4,3,65,22,43,67
N'castle Jet,8145,2,16,5,7,60,39,21,53
Melbourne C,8145,3,14,4,11,45,36,9,46
Melbourne V,8145,4,13,5,11,45,39,6,44
Adelaide Utd,8145,5,11,6,11,37,40,-3,39
Brisbane,8145,6,10,5,13,33,42,-9,35
Western Sydn,8145,7,8,9,10,38,47,-9,33
Perth Glory,8145,8,10,2,15,37,50,-13,32
Wellington P,8145,9,5,6,16,31,55,-24,21
CC Mariners,8145,10,4,8,15,28,49,-21,20
Sydney FC,8146,1,21,4,3,68,23,45,67
N'castle Jet,8146,2,15,5,8,58,40,18,50
Melbourne C,8146,3,15,4,10,46,34,12,49
Melbourne V,8146,4,13,5,11,46,42,4,44
Adelaide Utd,8146,5,11,6,11,37,40,-3,39
Brisbane,8146,6,10,5,13,33,42,-9,35
Western Sydn,8146,7,8,9,10,38,47,-9,33
Perth Glory,8146,8,10,2,15,37,50,-13,32
Wellington P,8146,9,5,6,16,31,55,-24,21
CC Mariners,8146,10,4,8,15,28,49,-21,20
Sydney FC,8147,1,20,5,3,64,22,42,65
N'castle Jet,8147,2,15,6,7,59,39,20,51
Melbourne C,8147,3,14,5,10,45,35,10,47
Melbourne V,8147,4,13,6,10,45,38,7,45
Adelaide Utd,8147,5,11,6,11,37,40,-3,39
Brisbane,8147,6,10,5,13,33,42,-9,35
Western Sydn,8147,7,8,9,10,38,47,-9,33
Perth Glory,8147,8,10,2,15,37,50,-13,32
Wellington P,8147,9,5,6,16,31,55,-24,21
CC Mariners,8147,10,4,8,15,28,49,-21,20
Sydney FC,8148,1,21,4,3,67,24,43,67
N'castle Jet,8148,2,15,5,8,57,41,16,50
Melbourne C,8148,3,15,4,10,47,33,14,49
Melbourne V,8148,4,13,5,11,47,41,6,44
Adelaide Utd,8148,5,11,6,11,37,40,-3,39
Brisbane,8148,6,10,5,13,33,42,-9,35
Western Sydn,8148,7,8,9,10,38,47,-9,33
Perth Glory,8148,8,10,2,15,37,50,-13,32
Wellington P,8148,9,5,6,16,31,55,-24,21
CC Mariners,8148,10,4,8,15,28,49,-21,20
Sydney FC,8149,1,21,4,3,66,23,43,67
N'castle Jet,8149,2,15,6,7,59,39,20,51
Melbourne C,8149,3,14,5,10,45,35,10,47
Melbourne V,8149,4,13,5,11,46,40,6,44
Adelaide Utd,8149,5,11,6,11,37,40,-3,39
Brisbane,8149,6,10,5,13,33,42,-9,35
Western Sydn,8149,7,8,9,10,38,47,-9,33
Perth Glory,8149,8,10,2,15,37,50,-13,32
Wellington P,8149,9,5,6,16,31,55,-24,21
CC Mariners,8149,10,4,8,15,28,49,-21,20
Sydney FC,8150,1,20,4,4,64,23,41,64
N'castle Jet,8150,2,15,5,8,58,39,19,50
Melbourne C,8150,3,15,4,10,45,34,11,49
Melbourne V,8150,4,14,5,10,46,38,8,47
Adelaide Utd,8150,5,11,6,11,37,40,-3,39
Brisbane,8150,6,10,5,13,33,42,-9,35
Western Sydn,8150,7,8,9,10,38,47,-9,33
Perth Glory,8150,8,10,2,15,37,50,-13,32
Wellington P,8150,9,5,6,16,31,55,-24,21
CC Mariners,8150,10,4,8,15,28,49,-21,20
Sydney FC,8151,1,20,5,3,65,23,42,65
N'castle Jet,8151,2,15,6,7,57,37,20,51
Melbourne C,8151,3,14,5,10,43,33,10,47
Melbourne V,8151,4,13,6,10,46,39,7,45
Adelaide Utd,8151,5,11,6,11,37,40,-3,39
Brisbane,8151,6,10,5,13,33,42,-9,35
Western Sydn,8151,7,8,9,10,38,47,-9,33
Perth Glory,8151,8,10,2,15,37,50,-13,32
Wellington P,8151,9,5,6,16,31,55,-24,21
CC Mariners,8151,10,4,8,15,28,49,-21,20
Sydney FC,8152,1,21,4,3,66,23,43,67
N'castle Jet,8152,2,15,5,8,59,40,19,50
Melbourne C,8152,3,15,4,10,46,35,11,49
Melbourne V,8152,4,13,5,11,46,40,6,44
Adelaide Utd,8152,5,11,6,11,37,40,-3,39
Brisbane,8152,6,10,5,13,33,42,-9,35
Western Sydn,8152,7,8,9,10,38,47,-9,33
Perth Glory,8152,8,10,2,15,37,50,-13,32
Wellington P,8152,9,5,6,16,31,55,-24,21
CC Mariners,8152,10,4,8,15,28,49,-21,20
Sydney FC,8153,1,20,5,3,64,22,42,65
N'castle Jet,8153,2,15,6,7,59,39,20,51
Melbourne C,8153,3,14,5,10,45,35,10,47
Melbourne V,8153,4,13,6,10,45,38,7,45
Adelaide Utd,8153,5,11,6,11,37,40,-3,39
Brisbane,8153,6,10,5,13,33,42,-9,35
Western Sydn,8153,7,8,9,10,38,47,-9,33
Perth Glory,8153,8,10,2,15,37,50,-13,32
Wellington P,8153,9,5,6,16,31,55,-24,21
CC Mariners,8153,10,4,8,15,28,49,-21,20
Sydney FC,8154,1,21,4,3,65,22,43,67
N'castle Jet,8154,2,15,5,8,58,39,19,50
Melbourne C,8154,3,15,4,10,45,34,11,49
Melbourne V,8154,4,13,5,11,45,39,6,44
Adelaide Utd,8154,5,11,6,11,37,40,-3,39
Brisbane,8154,6,10,5,13,33,42,-9,35
Western Sydn,8154,7,8,9,10,38,47,-9,33
Perth Glory,8154,8,10,2,15,37,50,-13,32
Wellington P,8154,9,5,6,16,31,55,-24,21
CC Mariners,8154,10,4,8,15,28,49,-21,20
Sydney FC,8155,1,20,4,4,67,26,41,64
N'castle Jet,8155,2,15,6,7,58,38,20,51
Melbourne C,8155,3,14,5,10,44,34,10,47
Melbourne V,8155,4,14,5,10,49,41,8,47
Adelaide Utd,8155,5,11,6,11,37,40,-3,39
Brisbane,8155,6,10,5,13,33,42,-9,35
Western Sydn,8155,7,8,9,10,38,47,-9,33
Perth Glory,8155,8,10,2,15,37,50,-13,32
Wellington P,8155,9,5,6,16,31,55,-24,21
CC Mariners,8155,10,4,8,15,28,49,-21,20
Sydney FC,8156,1,20,4,4,64,23,41,64
N'castle Jet,8156,2,15,6,7,58,38,20,51
Melbourne C,8156,3,14,5,10,44,34,10,47
Melbourne V,8156,4,14,5,10,46,38,8,47
Adelaide Utd,8156,5,11,6,11,37,40,-3,39
Brisbane,8156,6,10,5,13,33,42,-9,35
Western Sydn,8156,7,8,9,10,38,47,-9,33
Perth Glory,8156,8,10,2,15,37,50,-13,32
Wellington P,8156,9,5,6,16,31,55,-24,21
CC Mariners,8156,10,4,8,15,28,49,-21,20
Sydney FC,8157,1,21,4,3,65,22,43,67
N'castle Jet,8157,2,16,5,7,60,38,22,53
Melbourne C,8157,3,14,4,11,44,36,8,46
Melbourne V,8157,4,13,5,11,45,39,6,44
Adelaide Utd,8157,5,11,6,11,37,40,-3,39
Brisbane,8157,6,10,5,13,33,42,-9,35
Western Sydn,8157,7,8,9,10,38,47,-9,33
Perth Glory,8157,8,10,2,15,37,50,-13,32
Wellington P,8157,9,5,6,16,31,55,-24,21
CC Mariners,8157,10,4,8,15,28,49,-21,20
Sydney FC,8158,1,21,4,3,67,22,45,67
N'castle Jet,8158,2,15,5,8,58,39,19,50
Melbourne C,8158,3,15,4,10,45,34,11,49
Melbourne V,8158,4,13,5,11,45,41,4,44
Adelaide Utd,8158,5,11,6,11,37,40,-3,39
Brisbane,8158,6,10,5,13,33,42,-9,35
Western Sydn,8158,7,8,9,10,38,47,-9,33
Perth Glory,8158,8,10,2,15,37,50,-13,32
Wellington P,8158,9,5,6,16,31,55,-24,21
CC Mariners,8158,10,4,8,15,28,49,-21,20
Sydney FC,8159,1,21,4,3,65,22,43,67
N'castle Jet,8159,2,15,5,8,58,39,19,50
Melbourne C,8159,3,15,4,10,45,34,11,49
Melbourne V,8159,4,13,5,11,45,39,6,44
Adelaide Utd,8159,5,11,6,11,37,40,-3,39
Brisbane,8159,6,10,5,13,33,42,-9,35
Western Sydn,8159,7,8,9,10,38,47,-9,33
Perth Glory,8159,8,10,2,15,37,50,-13,32
Wellington P,8159,9,5,6,16,31,55,-24,21
CC Mariners,8159,10,4,8,15,28,49,-21,20
Sydney FC,8160,1,20,4,4,64,24,40,64
N'castle Jet,8160,2,15,6,7,59,39,20,51
Melbourne C,8160,3,14,5,10,45,35,10,47
Melbourne V,8160,4,14,5,10,47,38,9,47
Adelaide Utd,8160,5,11,6,11,37,40,-3,39
Brisbane,8160,6,10,5,13,33,42,-9,35
Western Sydn,8160,7,8,9,10,38,47,-9,33
Perth Glory,8160,8,10,2,15,37,50,-13,32
Wellington P,8160,9,5,6,16,31,55,-24,21
CC Mariners,8160,10,4,8,15,28,49,-21,20
Sydney FC,8161,1,20,4,4,66,26,40,64
N'castle Jet,8161,2,16,5,7,58,37,21,53
Melbourne V,8161,3,14,5,10,49,40,9,47
Melbourne C,8161,4,14,4,11,43,34,9,46
Adelaide Utd,8161,5,11,6,11,37,40,-3,39
Brisbane,8161,6,10,5,13,33,42,-9,35
Western Sydn,8161,7,8,9,10,38,47,-9,33
Perth Glory,8161,8,10,2,15,37,50,-13,32
Wellington P,8161,9,5,6,16,31,55,-24,21
CC Mariners,8161,10,4,8,15,28,49,-21,20
Sydney FC,8162,1,21,4,3,66,23,43,67
N'castle Jet,8162,2,16,5,7,59,37,22,53
Melbourne C,8162,3,14,4,11,43,35,8,46
Melbourne V,8162,4,13,5,11,46,40,6,44
Adelaide Utd,8162,5,11,6,11,37,40,-3,39
Brisbane,8162,6,10,5,13,33,42,-9,35
Western Sydn,8162,7,8,9,10,38,47,-9,33
Perth Glory,8162,8,10,2,15,37,50,-13,32
Wellington P,8162,9,5,6,16,31,55,-24,21
CC Mariners,8162,10,4,8,15,28,49,-21,20
Sydney FC,8163,1,21,4,3,66,23,43,67
N'castle Jet,8163,2,16,5,7,59,37,22,53
Melbourne C,8163,3,14,4,11,43,35,8,46
Melbourne V,8163,4,13,5,11,46,40,6,44
Adelaide Utd,8163,5,11,6,11,37,40,-3,39
Brisbane,8163,6,10,5,13,33,42,-9,35
Western Sydn,8163,7,8,9,10,38,47,-9,33
Perth Glory,8163,8,10,2,15,37,50,-13,32
Wellington P,8163,9,5,6,16,31,55,-24,21
CC Mariners,8163,10,4,8,15,28,49,-21,20
Sydney FC,8164,1,21,4,3,66,23,43,67
N'castle Jet,8164,2,16,5,7,59,37,22,53
Melbourne C,8164,3,14,4,11,43,35,8,46
Melbourne V,8164,4,13,5,11,46,40,6,44
Adelaide Utd,8164,5,11,6,11,37,40,-3,39
Brisbane,8164,6,10,5,13,33,42,-9,35
Western Sydn,8164,7,8,9,10,38,47,-9,33
Perth Glory,8164,8,10,2,15,37,50,-13,32
Wellington P,8164,9,5,6,16,31,55,-24,21
CC Mariners,8164,10,4,8,15,28,49,-21,20
Sydney FC,8165,1,21,4,3,66,23,43,67
N'castle Jet,8165,2,15,5,8,58,40,18,50
Melbourne C,8165,3,15,4,10,46,34,12,49
Melbourne V,8165,4,13,5,11,46,40,6,44
Adelaide Utd,8165,5,11,6,11,37,40,-3,39
Brisbane,8165,6,10,5,13,33,42,-9,35
Western Sydn,8165,7,8,9,10,38,47,-9,33
Perth Glory,8165,8,10,2,15,37,50,-13,32
Wellington P,8165,9,5,6,16,31,55,-24,21
CC Mariners,8165,10,4,8,15,28,49,-21,20
Sydney FC,8166,1,20,4,4,64,26,38,64
N'castle Jet,8166,2,15,5,8,58,41,17,50
Melbourne C,8166,3,15,4,10,47,34,13,49
Melbourne V,8166,4,14,5,10,49,38,11,47
Adelaide Utd,8166,5,11,6,11,37,40,-3,39
Brisbane,8166,6,10,5,13,33,42,-9,35
Western Sydn,8166,7,8,9,10,38,47,-9,33
Perth Glory,8166,8,10,2,15,37,50,-13,32
Wellington P,8166,9,5,6,16,31,55,-24,21
CC Mariners,8166,10,4,8,15,28,49,-21,20
Sydney FC,8167,1,20,5,3,65,23,42,65
N'castle Jet,8167,2,16,5,7,59,37,22,53
Melbourne C,8167,3,14,4,11,43,35,8,46
Melbourne V,8167,4,13,6,10,46,39,7,45
Adelaide Utd,8167,5,11,6,11,37,40,-3,39
Brisbane,8167,6,10,5,13,33,42,-9,35
Western Sydn,8167,7,8,9,10,38,47,-9,33
Perth Glory,8167,8,10,2,15,37,50,-13,32
Wellington P,8167,9,5,6,16,31,55,-24,21
CC Mariners,8167,10,4,8,15,28,49,-21,20
Sydney FC,8168,1,20,4,4,65,24,41,64
N'castle Jet,8168,2,15,5,8,57,39,18,50
Melbourne C,8168,3,15,4,10,45,33,12,49
Melbourne V,8168,4,14,5,10,47,39,8,47
Adelaide Utd,8168,5,11,6,11,37,40,-3,39
Brisbane,8168,6,10,5,13,33,42,-9,35
Western Sydn,8168,7,8,9,10,38,47,-9,33
Perth Glory,8168,8,10,2,15,37,50,-13,32
Wellington P,8168,9,5,6,16,31,55,-24,21
CC Mariners,8168,10,4,8,15,28,49,-21,20
Sydney FC,8169,1,21,4,3,66,22,44,67
N'castle Jet,8169,2,15,6,7,58,38,20,51
Melbourne C,8169,3,14,5,10,44,34,10,47
Melbourne V,8169,4,13,5,11,45,40,5,44
Adelaide Utd,8169,5,11,6,11,37,40,-3,39
Brisbane,8169,6,10,5,13,33,42,-9,35
Western Sydn,8169,7,8,9,10,38,47,-9,33
Perth Glory,8169,8,10,2,15,37,50,-13,32
Wellington P,8169,9,5,6,16,31,55,-24,21
CC Mariners,8169,10,4,8,15,28,49,-21,20
Sydney FC,8170,1,20,4,4,66,26,40,64
N'castle Jet,8170,2,15,6,7,59,39,20,51
Melbourne C,8170,3,14,5,10,45,35,10,47
Melbourne V,8170,4,14,5,10,49,40,9,47
Adelaide Utd,8170,5,11,6,11,37,40,-3,39
Brisbane,8170,6,10,5,13,33,42,-9,35
Western Sydn,8170,7,8,9,10,38,47,-9,33
Perth Glory,8170,8,10,2,15,37,50,-13,32
Wellington P,8170,9,5,6,16,31,55,-24,21
CC Mariners,8170,10,4,8,15,28,49,-21,20
Sydney FC,8171,1,20,4,4,64,23,41,64
N'castle Jet,8171,2,16,5,7,58,37,21,53
Melbourne V,8171,3,14,5,10,46,38,8,47
Melbourne C,8171,4,14,4,11,43,34,9,46
Adelaide Utd,8171,5,11,6,11,37,40,-3,39
Brisbane,8171,6,10,5,13,33,42,-9,35
Western Sydn,8171,7,8,9,10,38,47,-9,33
Perth Glory,8171,8,10,2,15,37,50,-13,32
Wellington P,8171,9,5,6,16,31,55,-24,21
CC Mariners,8171,10,4,8,15,28,49,-21,20
Sydney FC,8172,1,21,4,3,67,22,45,67
N'castle Jet,8172,2,16,5,7,61,38,23,53
Melbourne C,8172,3,14,4,11,44,37,7,46
Melbourne V,8172,4,13,5,11,45,41,4,44
Adelaide Utd,8172,5,11,6,11,37,40,-3,39
Brisbane,8172,6,10,5,13,33,42,-9,35
Western Sydn,8172,7,8,9,10,38,47,-9,33
Perth Glory,8172,8,10,2,15,37,50,-13,32
Wellington P,8172,9,5,6,16,31,55,-24,21
CC Mariners,8172,10,4,8,15,28,49,-21,20
Sydney FC,8173,1,20,5,3,65,23,42,65
N'castle Jet,8173,2,16,5,7,60,37,23,53
Melbourne C,8173,3,14,4,11,43,36,7,46
Melbourne V,8173,4,13,6,10,46,39,7,45
Adelaide Utd,8173,5,11,6,11,37,40,-3,39
Brisbane,8173,6,10,5,13,33,42,-9,35
Western Sydn,8173,7,8,9,10,38,47,-9,33
Perth Glory,8173,8,10,2,15,37,50,-13,32
Wellington P,8173,9,5,6,16,31,55,-24,21
CC Mariners,8173,10,4,8,15,28,49,-21,20
Sydney FC,8174,1,20,5,3,64,22,42,65
N'castle Jet,8174,2,16,5,7,59,37,22,53
Melbourne C,8174,3,14,4,11,43,35,8,46
Melbourne V,8174,4,13,6,10,45,38,7,45
Adelaide Utd,8174,5,11,6,11,37,40,-3,39
Brisbane,8174,6,10,5,13,33,42,-9,35
Western Sydn,8174,7,8,9,10,38,47,-9,33
Perth Glory,8174,8,10,2,15,37,50,-13,32
Wellington P,8174,9,5,6,16,31,55,-24,21
CC Mariners,8174,10,4,8,15,28,49,-21,20
Sydney FC,8175,1,21,4,3,67,22,45,67
N'castle Jet,8175,2,16,5,7,60,37,23,53
Melbourne C,8175,3,14,4,11,43,36,7,46
Melbourne V,8175,4,13,5,11,45,41,4,44
Adelaide Utd,8175,5,11,6,11,37,40,-3,39
Brisbane,8175,6,10,5,13,33,42,-9,35
Western Sydn,8175,7,8,9,10,38,47,-9,33
Perth Glory,8175,8,10,2,15,37,50,-13,32
Wellington P,8175,9,5,6,16,31,55,-24,21
CC Mariners,8175,10,4,8,15,28,49,-21,20
Sydney FC,8176,1,20,5,3,65,23,42,65
N'castle Jet,8176,2,16,5,7,60,39,21,53
Melbourne C,8176,3,14,4,11,45,36,9,46
Melbourne V,8176,4,13,6,10,46,39,7,45
Adelaide Utd,8176,5,11,6,11,37,40,-3,39
Brisbane,8176,6,10,5,13,33,42,-9,35
Western Sydn,8176,7,8,9,10,38,47,-9,33
Perth Glory,8176,8,10,2,15,37,50,-13,32
Wellington P,8176,9,5,6,16,31,55,-24,21
CC Mariners,8176,10,4,8,15,28,49,-21,20
Sydney FC,8177,1,21,4,3,65,22,43,67
N'castle Jet,8177,2,15,5,8,57,38,19,50
Melbourne C,8177,3,15,4,10,44,33,11,49
Melbourne V,8177,4,13,5,11,45,39,6,44
Adelaide Utd,8177,5,11,6,11,37,40,-3,39
Brisbane,8177,6,10,5,13,33,42,-9,35
Western Sydn,8177,7,8,9,10,38,47,-9,33
Perth Glory,8177,8,10,2,15,37,50,-13,32
Wellington P,8177,9,5,6,16,31,55,-24,21
CC Mariners,8177,10,4,8,15,28,49,-21,20
Sydney FC,8178,1,20,5,3,65,23,42,65
N'castle Jet,8178,2,16,5,7,61,37,24,53
Melbourne C,8178,3,14,4,11,43,37,6,46
Melbourne V,8178,4,13,6,10,46,39,7,45
Adelaide Utd,8178,5,11,6,11,37,40,-3,39
Brisbane,8178,6,10,5,13,33,42,-9,35
Western Sydn,8178,7,8,9,10,38,47,-9,33
Perth Glory,8178,8,10,2,15,37,50,-13,32
Wellington P,8178,9,5,6,16,31,55,-24,21
CC Mariners,8178,10,4,8,15,28,49,-21,20
Sydney FC,8179,1,20,5,3,66,24,42,65
N'castle Jet,8179,2,15,5,8,58,40,18,50
Melbourne C,8179,3,15,4,10,46,34,12,49
Melbourne V,8179,4,13,6,10,47,40,7,45
Adelaide Utd,8179,5,11,6,11,37,40,-3,39
Brisbane,8179,6,10,5,13,33,42,-9,35
Western Sydn,8179,7,8,9,10,38,47,-9,33
Perth Glory,8179,8,10,2,15,37,50,-13,32
Wellington P,8179,9,5,6,16,31,55,-24,21
CC Mariners,8179,10,4,8,15,28,49,-21,20
Sydney FC,8180,1,20,4,4,64,23,41,64
N'castle Jet,8180,2,16,5,7,59,37,22,53
Melbourne V,8180,3,14,5,10,46,38,8,47
Melbourne C,8180,4,14,4,11,43,35,8,46
Adelaide Utd,8180,5,11,6,11,37,40,-3,39
Brisbane,8180,6,10,5,13,33,42,-9,35
Western Sydn,8180,7,8,9,10,38,47,-9,33
Perth Glory,8180,8,10,2,15,37,50,-13,32
Wellington P,8180,9,5,6,16,31,55,-24,21
CC Mariners,8180,10,4,8,15,28,49,-21,20
Sydney FC,8181,1,21,4,3,67,22,45,67
N'castle Jet,8181,2,16,5,7,58,37,21,53
Melbourne C,8181,3,14,4,11,43,34,9,46
Melbourne V,8181,4,13,5,11,45,41,4,44
Adelaide Utd,8181,5,11,6,11,37,40,-3,39
Brisbane,8181,6,10,5,13,33,42,-9,35
Western Sydn,8181,7,8,9,10,38,47,-9,33
Perth Glory,8181,8,10,2,15,37,50,-13,32
Wellington P,8181,9,5,6,16,31,55,-24,21
CC Mariners,8181,10,4,8,15,28,49,-21,20
Sydney FC,8182,1,20,4,4,64,24,40,64
N'castle Jet,8182,2,15,5,8,57,38,19,50
Melbourne C,8182,3,15,4,10,44,33,11,49
Melbourne V,8182,4,14,5,10,47,38,9,47
Adelaide Utd,8182,5,11,6,11,37,40,-3,39
Brisbane,8182,6,10,5,13,33,42,-9,35
Western Sydn,8182,7,8,9,10,38,47,-9,33
Perth Glory,8182,8,10,2,15,37,50,-13,32
Wellington P,8182,9,5,6,16,31,55,-24,21
CC Mariners,8182,10,4,8,15,28,49,-21,20
Sydney FC,8183,1,21,4,3,70,22,48,67
N'castle Jet,8183,2,15,5,8,57,39,18,50
Melbourne C,8183,3,15,4,10,45,33,12,49
Melbourne V,8183,4,13,5,11,45,44,1,44
Adelaide Utd,8183,5,11,6,11,37,40,-3,39
Brisbane,8183,6,10,5,13,33,42,-9,35
Western Sydn,8183,7,8,9,10,38,47,-9,33
Perth Glory,8183,8,10,2,15,37,50,-13,32
Wellington P,8183,9,5,6,16,31,55,-24,21
CC Mariners,8183,10,4,8,15,28,49,-21,20
Sydney FC,8184,1,20,4,4,64,25,39,64
N'castle Jet,8184,2,16,5,7,60,37,23,53
Melbourne V,8184,3,14,5,10,48,38,10,47
Melbourne C,8184,4,14,4,11,43,36,7,46
Adelaide Utd,8184,5,11,6,11,37,40,-3,39
Brisbane,8184,6,10,5,13,33,42,-9,35
Western Sydn,8184,7,8,9,10,38,47,-9,33
Perth Glory,8184,8,10,2,15,37,50,-13,32
Wellington P,8184,9,5,6,16,31,55,-24,21
CC Mariners,8184,10,4,8,15,28,49,-21,20
Sydney FC,8185,1,20,5,3,64,22,42,65
N'castle Jet,8185,2,16,5,7,59,38,21,53
Melbourne C,8185,3,14,4,11,44,35,9,46
Melbourne V,8185,4,13,6,10,45,38,7,45
Adelaide Utd,8185,5,11,6,11,37,40,-3,39
Brisbane,8185,6,10,5,13,33,42,-9,35
Western Sydn,8185,7,8,9,10,38,47,-9,33
Perth Glory,8185,8,10,2,15,37,50,-13,32
Wellington P,8185,9,5,6,16,31,55,-24,21
CC Mariners,8185,10,4,8,15,28,49,-21,20
Sydney FC,8186,1,21,4,3,67,22,45,67
N'castle Jet,8186,2,16,5,7,60,38,22,53
Melbourne C,8186,3,14,4,11,44,36,8,46
Melbourne V,8186,4,13,5,11,45,41,4,44
Adelaide Utd,8186,5,11,6,11,37,40,-3,39
Brisbane,8186,6,10,5,13,33,42,-9,35
Western Sydn,8186,7,8,9,10,38,47,-9,33
Perth Glory,8186,8,10,2,15,37,50,-13,32
Wellington P,8186,9,5,6,16,31,55,-24,21
CC Mariners,8186,10,4,8,15,28,49,-21,20
Sydney FC,8187,1,21,4,3,68,23,45,67
N'castle Jet,8187,2,16,5,7,60,38,22,53
Melbourne C,8187,3,14,4,11,44,36,8,46
Melbourne V,8187,4,13,5,11,46,42,4,44
Adelaide Utd,8187,5,11,6,11,37,40,-3,39
Brisbane,8187,6,10,5,13,33,42,-9,35
Western Sydn,8187,7,8,9,10,38,47,-9,33
Perth Glory,8187,8,10,2,15,37,50,-13,32
Wellington P,8187,9,5,6,16,31,55,-24,21
CC Mariners,8187,10,4,8,15,28,49,-21,20
Sydney FC,8188,1,21,4,3,66,22,44,67
N'castle Jet,8188,2,16,5,7,62,37,25,53
Melbourne C,8188,3,14,4,11,43,38,5,46
Melbourne V,8188,4,13,5,11,45,40,5,44
Adelaide Utd,8188,5,11,6,11,37,40,-3,39
Brisbane,8188,6,10,5,13,33,42,-9,35
Western Sydn,8188,7,8,9,10,38,47,-9,33
Perth Glory,8188,8,10,2,15,37,50,-13,32
Wellington P,8188,9,5,6,16,31,55,-24,21
CC Mariners,8188,10,4,8,15,28,49,-21,20
Sydney FC,8189,1,21,4,3,67,23,44,67
N'castle Jet,8189,2,16,5,7,59,38,21,53
Melbourne C,8189,3,14,4,11,44,35,9,46
Melbourne V,8189,4,13,5,11,46,41,5,44
Adelaide Utd,8189,5,11,6,11,37,40,-3,39
Brisbane,8189,6,10,5,13,33,42,-9,35
Western Sydn,8189,7,8,9,10,38,47,-9,33
Perth Glory,8189,8,10,2,15,37,50,-13,32
Wellington P,8189,9,5,6,16,31,55,-24,21
CC Mariners,8189,10,4,8,15,28,49,-21,20
Sydney FC,8190,1,20,4,4,64,23,41,64
N'castle Jet,8190,2,15,5,8,59,41,18,50
Melbourne C,8190,3,15,4,10,47,35,12,49
Melbourne V,8190,4,14,5,10,46,38,8,47
Adelaide Utd,8190,5,11,6,11,37,40,-3,39
Brisbane,8190,6,10,5,13,33,42,-9,35
Western Sydn,8190,7,8,9,10,38,47,-9,33
Perth Glory,8190,8,10,2,15,37,50,-13,32
Wellington P,8190,9,5,6,16,31,55,-24,21
CC Mariners,8190,10,4,8,15,28,49,-21,20
Sydney FC,8191,1,21,4,3,66,22,44,67
N'castle Jet,8191,2,16,5,7,59,38,21,53
Melbourne C,8191,3,14,4,11,44,35,9,46
Melbourne V,8191,4,13,5,11,45,40,5,44
Adelaide Utd,8191,5,11,6,11,37,40,-3,39
Brisbane,8191,6,10,5,13,33,42,-9,35
Western Sydn,8191,7,8,9,10,38,47,-9,33
Perth Glory,8191,8,10,2,15,37,50,-13,32
Wellington P,8191,9,5,6,16,31,55,-24,21
CC Mariners,8191,10,4,8,15,28,49,-21,20
Sydney FC,8192,1,20,4,4,64,23,41,64
N'castle Jet,8192,2,16,5,7,58,37,21,53
Melbourne V,8192,3,14,5,10,46,38,8,47
Melbourne C,8192,4,14,4,11,43,34,9,46
Adelaide Utd,8192,5,11,6,11,37,40,-3,39
Brisbane,8192,6,10,5,13,33,42,-9,35
Western Sydn,8192,7,8,9,10,38,47,-9,33
Perth Glory,8192,8,10,2,15,37,50,-13,32
Wellington P,8192,9,5,6,16,31,55,-24,21
CC Mariners,8192,10,4,8,15,28,49,-21,20
Sydney FC,8193,1,20,4,4,65,24,41,64
N'castle Jet,8193,2,15,5,8,57,38,19,50
Melbourne C,8193,3,15,4,10,44,33,11,49
Melbourne V,8193,4,14,5,10,47,39,8,47
Adelaide Utd,8193,5,11,6,11,37,40,-3,39
Brisbane,8193,6,10,5,13,33,42,-9,35
Western Sydn,8193,7,8,9,10,38,47,-9,33
Perth Glory,8193,8,10,2,15,37,50,-13,32
Wellington P,8193,9,5,6,16,31,55,-24,21
CC Mariners,8193,10,4,8,15,28,49,-21,20
Sydney FC,8194,1,20,4,4,65,24,41,64
N'castle Jet,8194,2,15,5,8,57,39,18,50
Melbourne C,8194,3,15,4,10,45,33,12,49
Melbourne V,8194,4,14,5,10,47,39,8,47
Adelaide Utd,8194,5,11,6,11,37,40,-3,39
Brisbane,8194,6,10,5,13,33,42,-9,35
Western Sydn,8194,7,8,9,10,38,47,-9,33
Perth Glory,8194,8,10,2,15,37,50,-13,32
Wellington P,8194,9,5,6,16,31,55,-24,21
CC Mariners,8194,10,4,8,15,28,49,-21,20
Sydney FC,8195,1,21,4,3,66,23,43,67
N'castle Jet,8195,2,16,5,7,58,37,21,53
Melbourne C,8195,3,14,4,11,43,34,9,46
Melbourne V,8195,4,13,5,11,46,40,6,44
Adelaide Utd,8195,5,11,6,11,37,40,-3,39
Brisbane,8195,6,10,5,13,33,42,-9,35
Western Sydn,8195,7,8,9,10,38,47,-9,33
Perth Glory,8195,8,10,2,15,37,50,-13,32
Wellington P,8195,9,5,6,16,31,55,-24,21
CC Mariners,8195,10,4,8,15,28,49,-21,20
Sydney FC,8196,1,20,4,4,64,24,40,64
N'castle Jet,8196,2,15,5,8,60,41,19,50
Melbourne C,8196,3,15,4,10,47,36,11,49
Melbourne V,8196,4,14,5,10,47,38,9,47
Adelaide Utd,8196,5,11,6,11,37,40,-3,39
Brisbane,8196,6,10,5,13,33,42,-9,35
Western Sydn,8196,7,8,9,10,38,47,-9,33
Perth Glory,8196,8,10,2,15,37,50,-13,32
Wellington P,8196,9,5,6,16,31,55,-24,21
CC Mariners,8196,10,4,8,15,28,49,-21,20
Sydney FC,8197,1,21,4,3,67,23,44,67
N'castle Jet,8197,2,15,6,7,59,39,20,51
Melbourne C,8197,3,14,5,10,45,35,10,47
Melbourne V,8197,4,13,5,11,46,41,5,44
Adelaide Utd,8197,5,11,6,11,37,40,-3,39
Brisbane,8197,6,10,5,13,33,42,-9,35
Western Sydn,8197,7,8,9,10,38,47,-9,33
Perth Glory,8197,8,10,2,15,37,50,-13,32
Wellington P,8197,9,5,6,16,31,55,-24,21
CC Mariners,8197,10,4,8,15,28,49,-21,20
Sydney FC,8198,1,20,5,3,66,24,42,65
N'castle Jet,8198,2,16,5,7,58,37,21,53
Melbourne C,8198,3,14,4,11,43,34,9,46
Melbourne V,8198,4,13,6,10,47,40,7,45
Adelaide Utd,8198,5,11,6,11,37,40,-3,39
Brisbane,8198,6,10,5,13,33,42,-9,35
Western Sydn,8198,7,8,9,10,38,47,-9,33
Perth Glory,8198,8,10,2,15,37,50,-13,32
Wellington P,8198,9,5,6,16,31,55,-24,21
CC Mariners,8198,10,4,8,15,28,49,-21,20
Sydney FC,8199,1,21,4,3,67,22,45,67
N'castle Jet,8199,2,15,6,7,58,38,20,51
Melbourne C,8199,3,14,5,10,44,34,10,47
Melbourne V,8199,4,13,5,11,45,41,4,44
Adelaide Utd,8199,5,11,6,11,37,40,-3,39
Brisbane,8199,6,10,5,13,33,42,-9,35
Western Sydn,8199,7,8,9,10,38,47,-9,33
Perth Glory,8199,8,10,2,15,37,50,-13,32
Wellington P,8199,9,5,6,16,31,55,-24,21
CC Mariners,8199,10,4,8,15,28,49,-21,20
Sydney FC,8200,1,21,4,3,67,23,44,67
N'castle Jet,8200,2,16,5,7,59,37,22,53
Melbourne C,8200,3,14,4,11,43,35,8,46
Melbourne V,8200,4,13,5,11,46,41,5,44
Adelaide Utd,8200,5,11,6,11,37,40,-3,39
Brisbane,8200,6,10,5,13,33,42,-9,35
Western Sydn,8200,7,8,9,10,38,47,-9,33
Perth Glory,8200,8,10,2,15,37,50,-13,32
Wellington P,8200,9,5,6,16,31,55,-24,21
CC Mariners,8200,10,4,8,15,28,49,-21,20
Sydney FC,8201,1,21,4,3,69,24,45,67
N'castle Jet,8201,2,16,5,7,58,37,21,53
Melbourne C,8201,3,14,4,11,43,34,9,46
Melbourne V,8201,4,13,5,11,47,43,4,44
Adelaide Utd,8201,5,11,6,11,37,40,-3,39
Brisbane,8201,6,10,5,13,33,42,-9,35
Western Sydn,8201,7,8,9,10,38,47,-9,33
Perth Glory,8201,8,10,2,15,37,50,-13,32
Wellington P,8201,9,5,6,16,31,55,-24,21
CC Mariners,8201,10,4,8,15,28,49,-21,20
Sydney FC,8202,1,21,4,3,68,23,45,67
N'castle Jet,8202,2,15,5,8,59,40,19,50
Melbourne C,8202,3,15,4,10,46,35,11,49
Melbourne V,8202,4,13,5,11,46,42,4,44
Adelaide Utd,8202,5,11,6,11,37,40,-3,39
Brisbane,8202,6,10,5,13,33,42,-9,35
Western Sydn,8202,7,8,9,10,38,47,-9,33
Perth Glory,8202,8,10,2,15,37,50,-13,32
Wellington P,8202,9,5,6,16,31,55,-24,21
CC Mariners,8202,10,4,8,15,28,49,-21,20
Sydney FC,8203,1,21,4,3,67,23,44,67
N'castle Jet,8203,2,16,5,7,61,38,23,53
Melbourne C,8203,3,14,4,11,44,37,7,46
Melbourne V,8203,4,13,5,11,46,41,5,44
Adelaide Utd,8203,5,11,6,11,37,40,-3,39
Brisbane,8203,6,10,5,13,33,42,-9,35
Western Sydn,8203,7,8,9,10,38,47,-9,33
Perth Glory,8203,8,10,2,15,37,50,-13,32
Wellington P,8203,9,5,6,16,31,55,-24,21
CC Mariners,8203,10,4,8,15,28,49,-21,20
Sydney FC,8204,1,20,4,4,65,24,41,64
N'castle Jet,8204,2,15,5,8,57,38,19,50
Melbourne C,8204,3,15,4,10,44,33,11,49
Melbourne V,8204,4,14,5,10,47,39,8,47
Adelaide Utd,8204,5,11,6,11,37,40,-3,39
Brisbane,8204,6,10,5,13,33,42,-9,35
Western Sydn,8204,7,8,9,10,38,47,-9,33
Perth Glory,8204,8,10,2,15,37,50,-13,32
Wellington P,8204,9,5,6,16,31,55,-24,21
CC Mariners,8204,10,4,8,15,28,49,-21,20
Sydney FC,8205,1,21,4,3,65,22,43,67
N'castle Jet,8205,2,15,6,7,57,37,20,51
Melbourne C,8205,3,14,5,10,43,33,10,47
Melbourne V,8205,4,13,5,11,45,39,6,44
Adelaide Utd,8205,5,11,6,11,37,40,-3,39
Brisbane,8205,6,10,5,13,33,42,-9,35
Western Sydn,8205,7,8,9,10,38,47,-9,33
Perth Glory,8205,8,10,2,15,37,50,-13,32
Wellington P,8205,9,5,6,16,31,55,-24,21
CC Mariners,8205,10,4,8,15,28,49,-21,20
Sydney FC,8206,1,21,4,3,65,22,43,67
N'castle Jet,8206,2,15,5,8,57,38,19,50
Melbourne C,8206,3,15,4,10,44,33,11,49
Melbourne V,8206,4,13,5,11,45,39,6,44
Adelaide Utd,8206,5,11,6,11,37,40,-3,39
Brisbane,8206,6,10,5,13,33,42,-9,35
Western Sydn,8206,7,8,9,10,38,47,-9,33
Perth Glory,8206,8,10,2,15,37,50,-13,32
Wellington P,8206,9,5,6,16,31,55,-24,21
CC Mariners,8206,10,4,8,15,28,49,-21,20
Sydney FC,8207,1,20,5,3,65,23,42,65
N'castle Jet,8207,2,15,6,7,59,39,20,51
Melbourne C,8207,3,14,5,10,45,35,10,47
Melbourne V,8207,4,13,6,10,46,39,7,45
Adelaide Utd,8207,5,11,6,11,37,40,-3,39
Brisbane,8207,6,10,5,13,33,42,-9,35
Western Sydn,8207,7,8,9,10,38,47,-9,33
Perth Glory,8207,8,10,2,15,37,50,-13,32
Wellington P,8207,9,5,6,16,31,55,-24,21
CC Mariners,8207,10,4,8,15,28,49,-21,20
Sydney FC,8208,1,20,4,4,64,25,39,64
N'castle Jet,8208,2,15,5,8,57,38,19,50
Melbourne C,8208,3,15,4,10,44,33,11,49
Melbourne V,8208,4,14,5,10,48,38,10,47
Adelaide Utd,8208,5,11,6,11,37,40,-3,39
Brisbane,8208,6,10,5,13,33,42,-9,35
Western Sydn,8208,7,8,9,10,38,47,-9,33
Perth Glory,8208,8,10,2,15,37,50,-13,32
Wellington P,8208,9,5,6,16,31,55,-24,21
CC Mariners,8208,10,4,8,15,28,49,-21,20
Sydney FC,8209,1,21,4,3,68,23,45,67
N'castle Jet,8209,2,16,5,7,58,37,21,53
Melbourne C,8209,3,14,4,11,43,34,9,46
Melbourne V,8209,4,13,5,11,46,42,4,44
Adelaide Utd,8209,5,11,6,11,37,40,-3,39
Brisbane,8209,6,10,5,13,33,42,-9,35
Western Sydn,8209,7,8,9,10,38,47,-9,33
Perth Glory,8209,8,10,2,15,37,50,-13,32
Wellington P,8209,9,5,6,16,31,55,-24,21
CC Mariners,8209,10,4,8,15,28,49,-21,20
Sydney FC,8210,1,20,5,3,64,22,42,65
N'castle Jet,8210,2,15,6,7,57,37,20,51
Melbourne C,8210,3,14,5,10,43,33,10,47
Melbourne V,8210,4,13,6,10,45,38,7,45
Adelaide Utd,8210,5,11,6,11,37,40,-3,39
Brisbane,8210,6,10,5,13,33,42,-9,35
Western Sydn,8210,7,8,9,10,38,47,-9,33
Perth Glory,8210,8,10,2,15,37,50,-13,32
Wellington P,8210,9,5,6,16,31,55,-24,21
CC Mariners,8210,10,4,8,15,28,49,-21,20
Sydney FC,8211,1,20,5,3,65,23,42,65
N'castle Jet,8211,2,16,5,7,59,38,21,53
Melbourne C,8211,3,14,4,11,44,35,9,46
Melbourne V,8211,4,13,6,10,46,39,7,45
Adelaide Utd,8211,5,11,6,11,37,40,-3,39
Brisbane,8211,6,10,5,13,33,42,-9,35
Western Sydn,8211,7,8,9,10,38,47,-9,33
Perth Glory,8211,8,10,2,15,37,50,-13,32
Wellington P,8211,9,5,6,16,31,55,-24,21
CC Mariners,8211,10,4,8,15,28,49,-21,20
Sydney FC,8212,1,21,4,3,68,25,43,67
N'castle Jet,8212,2,16,5,7,60,37,23,53
Melbourne C,8212,3,14,4,11,43,36,7,46
Melbourne V,8212,4,13,5,11,48,42,6,44
Adelaide Utd,8212,5,11,6,11,37,40,-3,39
Brisbane,8212,6,10,5,13,33,42,-9,35
Western Sydn,8212,7,8,9,10,38,47,-9,33
Perth Glory,8212,8,10,2,15,37,50,-13,32
Wellington P,8212,9,5,6,16,31,55,-24,21
CC Mariners,8212,10,4,8,15,28,49,-21,20
Sydney FC,8213,1,20,4,4,67,27,40,64
N'castle Jet,8213,2,16,5,7,61,38,23,53
Melbourne V,8213,3,14,5,10,50,41,9,47
Melbourne C,8213,4,14,4,11,44,37,7,46
Adelaide Utd,8213,5,11,6,11,37,40,-3,39
Brisbane,8213,6,10,5,13,33,42,-9,35
Western Sydn,8213,7,8,9,10,38,47,-9,33
Perth Glory,8213,8,10,2,15,37,50,-13,32
Wellington P,8213,9,5,6,16,31,55,-24,21
CC Mariners,8213,10,4,8,15,28,49,-21,20
Sydney FC,8214,1,20,4,4,65,24,41,64
N'castle Jet,8214,2,15,6,7,58,38,20,51
Melbourne C,8214,3,14,5,10,44,34,10,47
Melbourne V,8214,4,14,5,10,47,39,8,47
Adelaide Utd,8214,5,11,6,11,37,40,-3,39
Brisbane,8214,6,10,5,13,33,42,-9,35
Western Sydn,8214,7,8,9,10,38,47,-9,33
Perth Glory,8214,8,10,2,15,37,50,-13,32
Wellington P,8214,9,5,6,16,31,55,-24,21
CC Mariners,8214,10,4,8,15,28,49,-21,20
Sydney FC,8215,1,21,4,3,68,22,46,67
N'castle Jet,8215,2,15,5,8,57,38,19,50
Melbourne C,8215,3,15,4,10,44,33,11,49
Melbourne V,8215,4,13,5,11,45,42,3,44
Adelaide Utd,8215,5,11,6,11,37,40,-3,39
Brisbane,8215,6,10,5,13,33,42,-9,35
Western Sydn,8215,7,8,9,10,38,47,-9,33
Perth Glory,8215,8,10,2,15,37,50,-13,32
Wellington P,8215,9,5,6,16,31,55,-24,21
CC Mariners,8215,10,4,8,15,28,49,-21,20
Sydney FC,8216,1,21,4,3,71,23,48,67
N'castle Jet,8216,2,16,5,7,61,37,24,53
Melbourne C,8216,3,14,4,11,43,37,6,46
Melbourne V,8216,4,13,5,11,46,45,1,44
Adelaide Utd,8216,5,11,6,11,37,40,-3,39
Brisbane,8216,6,10,5,13,33,42,-9,35
Western Sydn,8216,7,8,9,10,38,47,-9,33
Perth Glory,8216,8,10,2,15,37,50,-13,32
Wellington P,8216,9,5,6,16,31,55,-24,21
CC Mariners,8216,10,4,8,15,28,49,-21,20
Sydney FC,8217,1,20,4,4,66,25,41,64
N'castle Jet,8217,2,16,5,7,59,38,21,53
Melbourne V,8217,3,14,5,10,48,40,8,47
Melbourne C,8217,4,14,4,11,44,35,9,46
Adelaide Utd,8217,5,11,6,11,37,40,-3,39
Brisbane,8217,6,10,5,13,33,42,-9,35
Western Sydn,8217,7,8,9,10,38,47,-9,33
Perth Glory,8217,8,10,2,15,37,50,-13,32
Wellington P,8217,9,5,6,16,31,55,-24,21
CC Mariners,8217,10,4,8,15,28,49,-21,20
Sydney FC,8218,1,21,4,3,67,22,45,67
N'castle Jet,8218,2,16,5,7,61,38,23,53
Melbourne C,8218,3,14,4,11,44,37,7,46
Melbourne V,8218,4,13,5,11,45,41,4,44
Adelaide Utd,8218,5,11,6,11,37,40,-3,39
Brisbane,8218,6,10,5,13,33,42,-9,35
Western Sydn,8218,7,8,9,10,38,47,-9,33
Perth Glory,8218,8,10,2,15,37,50,-13,32
Wellington P,8218,9,5,6,16,31,55,-24,21
CC Mariners,8218,10,4,8,15,28,49,-21,20
Sydney FC,8219,1,21,4,3,66,23,43,67
N'castle Jet,8219,2,15,5,8,59,40,19,50
Melbourne C,8219,3,15,4,10,46,35,11,49
Melbourne V,8219,4,13,5,11,46,40,6,44
Adelaide Utd,8219,5,11,6,11,37,40,-3,39
Brisbane,8219,6,10,5,13,33,42,-9,35
Western Sydn,8219,7,8,9,10,38,47,-9,33
Perth Glory,8219,8,10,2,15,37,50,-13,32
Wellington P,8219,9,5,6,16,31,55,-24,21
CC Mariners,8219,10,4,8,15,28,49,-21,20
Sydney FC,8220,1,21,4,3,66,23,43,67
N'castle Jet,8220,2,15,5,8,60,41,19,50
Melbourne C,8220,3,15,4,10,47,36,11,49
Melbourne V,8220,4,13,5,11,46,40,6,44
Adelaide Utd,8220,5,11,6,11,37,40,-3,39
Brisbane,8220,6,10,5,13,33,42,-9,35
Western Sydn,8220,7,8,9,10,38,47,-9,33
Perth Glory,8220,8,10,2,15,37,50,-13,32
Wellington P,8220,9,5,6,16,31,55,-24,21
CC Mariners,8220,10,4,8,15,28,49,-21,20
Sydney FC,8221,1,21,4,3,65,22,43,67
N'castle Jet,8221,2,15,6,7,59,39,20,51
Melbourne C,8221,3,14,5,10,45,35,10,47
Melbourne V,8221,4,13,5,11,45,39,6,44
Adelaide Utd,8221,5,11,6,11,37,40,-3,39
Brisbane,8221,6,10,5,13,33,42,-9,35
Western Sydn,8221,7,8,9,10,38,47,-9,33
Perth Glory,8221,8,10,2,15,37,50,-13,32
Wellington P,8221,9,5,6,16,31,55,-24,21
CC Mariners,8221,10,4,8,15,28,49,-21,20
Sydney FC,8222,1,21,4,3,68,23,45,67
N'castle Jet,8222,2,15,5,8,57,38,19,50
Melbourne C,8222,3,15,4,10,44,33,11,49
Melbourne V,8222,4,13,5,11,46,42,4,44
Adelaide Utd,8222,5,11,6,11,37,40,-3,39
Brisbane,8222,6,10,5,13,33,42,-9,35
Western Sydn,8222,7,8,9,10,38,47,-9,33
Perth Glory,8222,8,10,2,15,37,50,-13,32
Wellington P,8222,9,5,6,16,31,55,-24,21
CC Mariners,8222,10,4,8,15,28,49,-21,20
Sydney FC,8223,1,21,4,3,68,22,46,67
N'castle Jet,8223,2,16,5,7,60,37,23,53
Melbourne C,8223,3,14,4,11,43,36,7,46
Melbourne V,8223,4,13,5,11,45,42,3,44
Adelaide Utd,8223,5,11,6,11,37,40,-3,39
Brisbane,8223,6,10,5,13,33,42,-9,35
Western Sydn,8223,7,8,9,10,38,47,-9,33
Perth Glory,8223,8,10,2,15,37,50,-13,32
Wellington P,8223,9,5,6,16,31,55,-24,21
CC Mariners,8223,10,4,8,15,28,49,-21,20
Sydney FC,8224,1,20,4,4,65,25,40,64
N'castle Jet,8224,2,15,6,7,58,38,20,51
Melbourne C,8224,3,14,5,10,44,34,10,47
Melbourne V,8224,4,14,5,10,48,39,9,47
Adelaide Utd,8224,5,11,6,11,37,40,-3,39
Brisbane,8224,6,10,5,13,33,42,-9,35
Western Sydn,8224,7,8,9,10,38,47,-9,33
Perth Glory,8224,8,10,2,15,37,50,-13,32
Wellington P,8224,9,5,6,16,31,55,-24,21
CC Mariners,8224,10,4,8,15,28,49,-21,20
Sydney FC,8225,1,20,5,3,65,23,42,65
N'castle Jet,8225,2,16,5,7,60,39,21,53
Melbourne C,8225,3,14,4,11,45,36,9,46
Melbourne V,8225,4,13,6,10,46,39,7,45
Adelaide Utd,8225,5,11,6,11,37,40,-3,39
Brisbane,8225,6,10,5,13,33,42,-9,35
Western Sydn,8225,7,8,9,10,38,47,-9,33
Perth Glory,8225,8,10,2,15,37,50,-13,32
Wellington P,8225,9,5,6,16,31,55,-24,21
CC Mariners,8225,10,4,8,15,28,49,-21,20
Sydney FC,8226,1,20,4,4,65,25,40,64
N'castle Jet,8226,2,16,5,7,58,37,21,53
Melbourne V,8226,3,14,5,10,48,39,9,47
Melbourne C,8226,4,14,4,11,43,34,9,46
Adelaide Utd,8226,5,11,6,11,37,40,-3,39
Brisbane,8226,6,10,5,13,33,42,-9,35
Western Sydn,8226,7,8,9,10,38,47,-9,33
Perth Glory,8226,8,10,2,15,37,50,-13,32
Wellington P,8226,9,5,6,16,31,55,-24,21
CC Mariners,8226,10,4,8,15,28,49,-21,20
Sydney FC,8227,1,20,4,4,65,25,40,64
N'castle Jet,8227,2,16,5,7,61,38,23,53
Melbourne V,8227,3,14,5,10,48,39,9,47
Melbourne C,8227,4,14,4,11,44,37,7,46
Adelaide Utd,8227,5,11,6,11,37,40,-3,39
Brisbane,8227,6,10,5,13,33,42,-9,35
Western Sydn,8227,7,8,9,10,38,47,-9,33
Perth Glory,8227,8,10,2,15,37,50,-13,32
Wellington P,8227,9,5,6,16,31,55,-24,21
CC Mariners,8227,10,4,8,15,28,49,-21,20
Sydney FC,8228,1,21,4,3,66,23,43,67
N'castle Jet,8228,2,16,5,7,63,39,24,53
Melbourne C,8228,3,14,4,11,45,39,6,46
Melbourne V,8228,4,13,5,11,46,40,6,44
Adelaide Utd,8228,5,11,6,11,37,40,-3,39
Brisbane,8228,6,10,5,13,33,42,-9,35
Western Sydn,8228,7,8,9,10,38,47,-9,33
Perth Glory,8228,8,10,2,15,37,50,-13,32
Wellington P,8228,9,5,6,16,31,55,-24,21
CC Mariners,8228,10,4,8,15,28,49,-21,20
Sydney FC,8229,1,21,4,3,66,22,44,67
N'castle Jet,8229,2,16,5,7,60,38,22,53
Melbourne C,8229,3,14,4,11,44,36,8,46
Melbourne V,8229,4,13,5,11,45,40,5,44
Adelaide Utd,8229,5,11,6,11,37,40,-3,39
Brisbane,8229,6,10,5,13,33,42,-9,35
Western Sydn,8229,7,8,9,10,38,47,-9,33
Perth Glory,8229,8,10,2,15,37,50,-13,32
Wellington P,8229,9,5,6,16,31,55,-24,21
CC Mariners,8229,10,4,8,15,28,49,-21,20
Sydney FC,8230,1,20,4,4,65,25,40,64
N'castle Jet,8230,2,15,6,7,57,37,20,51
Melbourne C,8230,3,14,5,10,43,33,10,47
Melbourne V,8230,4,14,5,10,48,39,9,47
Adelaide Utd,8230,5,11,6,11,37,40,-3,39
Brisbane,8230,6,10,5,13,33,42,-9,35
Western Sydn,8230,7,8,9,10,38,47,-9,33
Perth Glory,8230,8,10,2,15,37,50,-13,32
Wellington P,8230,9,5,6,16,31,55,-24,21
CC Mariners,8230,10,4,8,15,28,49,-21,20
Sydney FC,8231,1,21,4,3,65,22,43,67
N'castle Jet,8231,2,16,5,7,58,37,21,53
Melbourne C,8231,3,14,4,11,43,34,9,46
Melbourne V,8231,4,13,5,11,45,39,6,44
Adelaide Utd,8231,5,11,6,11,37,40,-3,39
Brisbane,8231,6,10,5,13,33,42,-9,35
Western Sydn,8231,7,8,9,10,38,47,-9,33
Perth Glory,8231,8,10,2,15,37,50,-13,32
Wellington P,8231,9,5,6,16,31,55,-24,21
CC Mariners,8231,10,4,8,15,28,49,-21,20
Sydney FC,8232,1,20,5,3,65,23,42,65
N'castle Jet,8232,2,16,5,7,60,38,22,53
Melbourne C,8232,3,14,4,11,44,36,8,46
Melbourne V,8232,4,13,6,10,46,39,7,45
Adelaide Utd,8232,5,11,6,11,37,40,-3,39
Brisbane,8232,6,10,5,13,33,42,-9,35
Western Sydn,8232,7,8,9,10,38,47,-9,33
Perth Glory,8232,8,10,2,15,37,50,-13,32
Wellington P,8232,9,5,6,16,31,55,-24,21
CC Mariners,8232,10,4,8,15,28,49,-21,20
Sydney FC,8233,1,20,4,4,65,25,40,64
N'castle Jet,8233,2,16,5,7,61,40,21,53
Melbourne V,8233,3,14,5,10,48,39,9,47
Melbourne C,8233,4,14,4,11,46,37,9,46
Adelaide Utd,8233,5,11,6,11,37,40,-3,39
Brisbane,8233,6,10,5,13,33,42,-9,35
Western Sydn,8233,7,8,9,10,38,47,-9,33
Perth Glory,8233,8,10,2,15,37,50,-13,32
Wellington P,8233,9,5,6,16,31,55,-24,21
CC Mariners,8233,10,4,8,15,28,49,-21,20
Sydney FC,8234,1,20,4,4,65,24,41,64
N'castle Jet,8234,2,15,5,8,58,39,19,50
Melbourne C,8234,3,15,4,10,45,34,11,49
Melbourne V,8234,4,14,5,10,47,39,8,47
Adelaide Utd,8234,5,11,6,11,37,40,-3,39
Brisbane,8234,6,10,5,13,33,42,-9,35
Western Sydn,8234,7,8,9,10,38,47,-9,33
Perth Glory,8234,8,10,2,15,37,50,-13,32
Wellington P,8234,9,5,6,16,31,55,-24,21
CC Mariners,8234,10,4,8,15,28,49,-21,20
Sydney FC,8235,1,21,4,3,69,23,46,67
N'castle Jet,8235,2,16,5,7,62,39,23,53
Melbourne C,8235,3,14,4,11,45,38,7,46
Melbourne V,8235,4,13,5,11,46,43,3,44
Adelaide Utd,8235,5,11,6,11,37,40,-3,39
Brisbane,8235,6,10,5,13,33,42,-9,35
Western Sydn,8235,7,8,9,10,38,47,-9,33
Perth Glory,8235,8,10,2,15,37,50,-13,32
Wellington P,8235,9,5,6,16,31,55,-24,21
CC Mariners,8235,10,4,8,15,28,49,-21,20
Sydney FC,8236,1,21,4,3,68,23,45,67
N'castle Jet,8236,2,16,5,7,60,38,22,53
Melbourne C,8236,3,14,4,11,44,36,8,46
Melbourne V,8236,4,13,5,11,46,42,4,44
Adelaide Utd,8236,5,11,6,11,37,40,-3,39
Brisbane,8236,6,10,5,13,33,42,-9,35
Western Sydn,8236,7,8,9,10,38,47,-9,33
Perth Glory,8236,8,10,2,15,37,50,-13,32
Wellington P,8236,9,5,6,16,31,55,-24,21
CC Mariners,8236,10,4,8,15,28,49,-21,20
Sydney FC,8237,1,21,4,3,68,22,46,67
N'castle Jet,8237,2,16,5,7,60,38,22,53
Melbourne C,8237,3,14,4,11,44,36,8,46
Melbourne V,8237,4,13,5,11,45,42,3,44
Adelaide Utd,8237,5,11,6,11,37,40,-3,39
Brisbane,8237,6,10,5,13,33,42,-9,35
Western Sydn,8237,7,8,9,10,38,47,-9,33
Perth Glory,8237,8,10,2,15,37,50,-13,32
Wellington P,8237,9,5,6,16,31,55,-24,21
CC Mariners,8237,10,4,8,15,28,49,-21,20
Sydney FC,8238,1,21,4,3,66,22,44,67
N'castle Jet,8238,2,16,5,7,61,37,24,53
Melbourne C,8238,3,14,4,11,43,37,6,46
Melbourne V,8238,4,13,5,11,45,40,5,44
Adelaide Utd,8238,5,11,6,11,37,40,-3,39
Brisbane,8238,6,10,5,13,33,42,-9,35
Western Sydn,8238,7,8,9,10,38,47,-9,33
Perth Glory,8238,8,10,2,15,37,50,-13,32
Wellington P,8238,9,5,6,16,31,55,-24,21
CC Mariners,8238,10,4,8,15,28,49,-21,20
Sydney FC,8239,1,21,4,3,68,22,46,67
N'castle Jet,8239,2,16,5,7,62,38,24,53
Melbourne C,8239,3,14,4,11,44,38,6,46
Melbourne V,8239,4,13,5,11,45,42,3,44
Adelaide Utd,8239,5,11,6,11,37,40,-3,39
Brisbane,8239,6,10,5,13,33,42,-9,35
Western Sydn,8239,7,8,9,10,38,47,-9,33
Perth Glory,8239,8,10,2,15,37,50,-13,32
Wellington P,8239,9,5,6,16,31,55,-24,21
CC Mariners,8239,10,4,8,15,28,49,-21,20
Sydney FC,8240,1,21,4,3,67,23,44,67
N'castle Jet,8240,2,16,5,7,58,37,21,53
Melbourne C,8240,3,14,4,11,43,34,9,46
Melbourne V,8240,4,13,5,11,46,41,5,44
Adelaide Utd,8240,5,11,6,11,37,40,-3,39
Brisbane,8240,6,10,5,13,33,42,-9,35
Western Sydn,8240,7,8,9,10,38,47,-9,33
Perth Glory,8240,8,10,2,15,37,50,-13,32
Wellington P,8240,9,5,6,16,31,55,-24,21
CC Mariners,8240,10,4,8,15,28,49,-21,20
Sydney FC,8241,1,21,4,3,68,23,45,67
N'castle Jet,8241,2,15,5,8,57,38,19,50
Melbourne C,8241,3,15,4,10,44,33,11,49
Melbourne V,8241,4,13,5,11,46,42,4,44
Adelaide Utd,8241,5,11,6,11,37,40,-3,39
Brisbane,8241,6,10,5,13,33,42,-9,35
Western Sydn,8241,7,8,9,10,38,47,-9,33
Perth Glory,8241,8,10,2,15,37,50,-13,32
Wellington P,8241,9,5,6,16,31,55,-24,21
CC Mariners,8241,10,4,8,15,28,49,-21,20
Sydney FC,8242,1,20,4,4,65,24,41,64
N'castle Jet,8242,2,15,6,7,58,38,20,51
Melbourne C,8242,3,14,5,10,44,34,10,47
Melbourne V,8242,4,14,5,10,47,39,8,47
Adelaide Utd,8242,5,11,6,11,37,40,-3,39
Brisbane,8242,6,10,5,13,33,42,-9,35
Western Sydn,8242,7,8,9,10,38,47,-9,33
Perth Glory,8242,8,10,2,15,37,50,-13,32
Wellington P,8242,9,5,6,16,31,55,-24,21
CC Mariners,8242,10,4,8,15,28,49,-21,20
Sydney FC,8243,1,20,4,4,65,24,41,64
N'castle Jet,8243,2,15,6,7,59,39,20,51
Melbourne C,8243,3,14,5,10,45,35,10,47
Melbourne V,8243,4,14,5,10,47,39,8,47
Adelaide Utd,8243,5,11,6,11,37,40,-3,39
Brisbane,8243,6,10,5,13,33,42,-9,35
Western Sydn,8243,7,8,9,10,38,47,-9,33
Perth Glory,8243,8,10,2,15,37,50,-13,32
Wellington P,8243,9,5,6,16,31,55,-24,21
CC Mariners,8243,10,4,8,15,28,49,-21,20
Sydney FC,8244,1,20,4,4,65,24,41,64
N'castle Jet,8244,2,16,5,7,59,37,22,53
Melbourne V,8244,3,14,5,10,47,39,8,47
Melbourne C,8244,4,14,4,11,43,35,8,46
Adelaide Utd,8244,5,11,6,11,37,40,-3,39
Brisbane,8244,6,10,5,13,33,42,-9,35
Western Sydn,8244,7,8,9,10,38,47,-9,33
Perth Glory,8244,8,10,2,15,37,50,-13,32
Wellington P,8244,9,5,6,16,31,55,-24,21
CC Mariners,8244,10,4,8,15,28,49,-21,20
Sydney FC,8245,1,20,4,4,64,23,41,64
N'castle Jet,8245,2,15,5,8,58,40,18,50
Melbourne C,8245,3,15,4,10,46,34,12,49
Melbourne V,8245,4,14,5,10,46,38,8,47
Adelaide Utd,8245,5,11,6,11,37,40,-3,39
Brisbane,8245,6,10,5,13,33,42,-9,35
Western Sydn,8245,7,8,9,10,38,47,-9,33
Perth Glory,8245,8,10,2,15,37,50,-13,32
Wellington P,8245,9,5,6,16,31,55,-24,21
CC Mariners,8245,10,4,8,15,28,49,-21,20
Sydney FC,8246,1,21,4,3,67,23,44,67
N'castle Jet,8246,2,15,6,7,58,38,20,51
Melbourne C,8246,3,14,5,10,44,34,10,47
Melbourne V,8246,4,13,5,11,46,41,5,44
Adelaide Utd,8246,5,11,6,11,37,40,-3,39
Brisbane,8246,6,10,5,13,33,42,-9,35
Western Sydn,8246,7,8,9,10,38,47,-9,33
Perth Glory,8246,8,10,2,15,37,50,-13,32
Wellington P,8246,9,5,6,16,31,55,-24,21
CC Mariners,8246,10,4,8,15,28,49,-21,20
Sydney FC,8247,1,21,4,3,70,22,48,67
N'castle Jet,8247,2,15,5,8,57,40,17,50
Melbourne C,8247,3,15,4,10,46,33,13,49
Melbourne V,8247,4,13,5,11,45,44,1,44
Adelaide Utd,8247,5,11,6,11,37,40,-3,39
Brisbane,8247,6,10,5,13,33,42,-9,35
Western Sydn,8247,7,8,9,10,38,47,-9,33
Perth Glory,8247,8,10,2,15,37,50,-13,32
Wellington P,8247,9,5,6,16,31,55,-24,21
CC Mariners,8247,10,4,8,15,28,49,-21,20
Sydney FC,8248,1,20,5,3,66,24,42,65
N'castle Jet,8248,2,16,5,7,60,37,23,53
Melbourne C,8248,3,14,4,11,43,36,7,46
Melbourne V,8248,4,13,6,10,47,40,7,45
Adelaide Utd,8248,5,11,6,11,37,40,-3,39
Brisbane,8248,6,10,5,13,33,42,-9,35
Western Sydn,8248,7,8,9,10,38,47,-9,33
Perth Glory,8248,8,10,2,15,37,50,-13,32
Wellington P,8248,9,5,6,16,31,55,-24,21
CC Mariners,8248,10,4,8,15,28,49,-21,20
Sydney FC,8249,1,21,4,3,67,24,43,67
N'castle Jet,8249,2,15,5,8,57,41,16,50
Melbourne C,8249,3,15,4,10,47,33,14,49
Melbourne V,8249,4,13,5,11,47,41,6,44
Adelaide Utd,8249,5,11,6,11,37,40,-3,39
Brisbane,8249,6,10,5,13,33,42,-9,35
Western Sydn,8249,7,8,9,10,38,47,-9,33
Perth Glory,8249,8,10,2,15,37,50,-13,32
Wellington P,8249,9,5,6,16,31,55,-24,21
CC Mariners,8249,10,4,8,15,28,49,-21,20
Sydney FC,8250,1,21,4,3,66,23,43,67
N'castle Jet,8250,2,15,5,8,57,39,18,50
Melbourne C,8250,3,15,4,10,45,33,12,49
Melbourne V,8250,4,13,5,11,46,40,6,44
Adelaide Utd,8250,5,11,6,11,37,40,-3,39
Brisbane,8250,6,10,5,13,33,42,-9,35
Western Sydn,8250,7,8,9,10,38,47,-9,33
Perth Glory,8250,8,10,2,15,37,50,-13,32
Wellington P,8250,9,5,6,16,31,55,-24,21
CC Mariners,8250,10,4,8,15,28,49,-21,20
Sydney FC,8251,1,21,4,3,65,22,43,67
N'castle Jet,8251,2,15,5,8,57,38,19,50
Melbourne C,8251,3,15,4,10,44,33,11,49
Melbourne V,8251,4,13,5,11,45,39,6,44
Adelaide Utd,8251,5,11,6,11,37,40,-3,39
Brisbane,8251,6,10,5,13,33,42,-9,35
Western Sydn,8251,7,8,9,10,38,47,-9,33
Perth Glory,8251,8,10,2,15,37,50,-13,32
Wellington P,8251,9,5,6,16,31,55,-24,21
CC Mariners,8251,10,4,8,15,28,49,-21,20
Sydney FC,8252,1,20,5,3,64,22,42,65
N'castle Jet,8252,2,16,5,7,62,39,23,53
Melbourne C,8252,3,14,4,11,45,38,7,46
Melbourne V,8252,4,13,6,10,45,38,7,45
Adelaide Utd,8252,5,11,6,11,37,40,-3,39
Brisbane,8252,6,10,5,13,33,42,-9,35
Western Sydn,8252,7,8,9,10,38,47,-9,33
Perth Glory,8252,8,10,2,15,37,50,-13,32
Wellington P,8252,9,5,6,16,31,55,-24,21
CC Mariners,8252,10,4,8,15,28,49,-21,20
Sydney FC,8253,1,21,4,3,65,22,43,67
N'castle Jet,8253,2,15,6,7,58,38,20,51
Melbourne C,8253,3,14,5,10,44,34,10,47
Melbourne V,8253,4,13,5,11,45,39,6,44
Adelaide Utd,8253,5,11,6,11,37,40,-3,39
Brisbane,8253,6,10,5,13,33,42,-9,35
Western Sydn,8253,7,8,9,10,38,47,-9,33
Perth Glory,8253,8,10,2,15,37,50,-13,32
Wellington P,8253,9,5,6,16,31,55,-24,21
CC Mariners,8253,10,4,8,15,28,49,-21,20
Sydney FC,8254,1,20,5,3,67,25,42,65
N'castle Jet,8254,2,15,6,7,58,38,20,51
Melbourne C,8254,3,14,5,10,44,34,10,47
Melbourne V,8254,4,13,6,10,48,41,7,45
Adelaide Utd,8254,5,11,6,11,37,40,-3,39
Brisbane,8254,6,10,5,13,33,42,-9,35
Western Sydn,8254,7,8,9,10,38,47,-9,33
Perth Glory,8254,8,10,2,15,37,50,-13,32
Wellington P,8254,9,5,6,16,31,55,-24,21
CC Mariners,8254,10,4,8,15,28,49,-21,20
Sydney FC,8255,1,21,4,3,67,22,45,67
N'castle Jet,8255,2,16,5,7,60,37,23,53
Melbourne C,8255,3,14,4,11,43,36,7,46
Melbourne V,8255,4,13,5,11,45,41,4,44
Adelaide Utd,8255,5,11,6,11,37,40,-3,39
Brisbane,8255,6,10,5,13,33,42,-9,35
Western Sydn,8255,7,8,9,10,38,47,-9,33
Perth Glory,8255,8,10,2,15,37,50,-13,32
Wellington P,8255,9,5,6,16,31,55,-24,21
CC Mariners,8255,10,4,8,15,28,49,-21,20
Sydney FC,8256,1,20,5,3,67,25,42,65
N'castle Jet,8256,2,15,5,8,57,38,19,50
Melbourne C,8256,3,15,4,10,44,33,11,49
Melbourne V,8256,4,13,6,10,48,41,7,45
Adelaide Utd,8256,5,11,6,11,37,40,-3,39
Brisbane,8256,6,10,5,13,33,42,-9,35
Western Sydn,8256,7,8,9,10,38,47,-9,33
Perth Glory,8256,8,10,2,15,37,50,-13,32
Wellington P,8256,9,5,6,16,31,55,-24,21
CC Mariners,8256,10,4,8,15,28,49,-21,20
Sydney FC,8257,1,21,4,3,66,23,43,67
N'castle Jet,8257,2,15,6,7,58,38,20,51
Melbourne C,8257,3,14,5,10,44,34,10,47
Melbourne V,8257,4,13,5,11,46,40,6,44
Adelaide Utd,8257,5,11,6,11,37,40,-3,39
Brisbane,8257,6,10,5,13,33,42,-9,35
Western Sydn,8257,7,8,9,10,38,47,-9,33
Perth Glory,8257,8,10,2,15,37,50,-13,32
Wellington P,8257,9,5,6,16,31,55,-24,21
CC Mariners,8257,10,4,8,15,28,49,-21,20
Sydney FC,8258,1,21,4,3,65,22,43,67
N'castle Jet,8258,2,16,5,7,58,37,21,53
Melbourne C,8258,3,14,4,11,43,34,9,46
Melbourne V,8258,4,13,5,11,45,39,6,44
Adelaide Utd,8258,5,11,6,11,37,40,-3,39
Brisbane,8258,6,10,5,13,33,42,-9,35
Western Sydn,8258,7,8,9,10,38,47,-9,33
Perth Glory,8258,8,10,2,15,37,50,-13,32
Wellington P,8258,9,5,6,16,31,55,-24,21
CC Mariners,8258,10,4,8,15,28,49,-21,20
Sydney FC,8259,1,21,4,3,66,23,43,67
N'castle Jet,8259,2,15,6,7,58,38,20,51
Melbourne C,8259,3,14,5,10,44,34,10,47
Melbourne V,8259,4,13,5,11,46,40,6,44
Adelaide Utd,8259,5,11,6,11,37,40,-3,39
Brisbane,8259,6,10,5,13,33,42,-9,35
Western Sydn,8259,7,8,9,10,38,47,-9,33
Perth Glory,8259,8,10,2,15,37,50,-13,32
Wellington P,8259,9,5,6,16,31,55,-24,21
CC Mariners,8259,10,4,8,15,28,49,-21,20
Sydney FC,8260,1,20,5,3,65,23,42,65
N'castle Jet,8260,2,16,5,7,62,38,24,53
Melbourne C,8260,3,14,4,11,44,38,6,46
Melbourne V,8260,4,13,6,10,46,39,7,45
Adelaide Utd,8260,5,11,6,11,37,40,-3,39
Brisbane,8260,6,10,5,13,33,42,-9,35
Western Sydn,8260,7,8,9,10,38,47,-9,33
Perth Glory,8260,8,10,2,15,37,50,-13,32
Wellington P,8260,9,5,6,16,31,55,-24,21
CC Mariners,8260,10,4,8,15,28,49,-21,20
Sydney FC,8261,1,21,4,3,66,23,43,67
N'castle Jet,8261,2,15,5,8,58,39,19,50
Melbourne C,8261,3,15,4,10,45,34,11,49
Melbourne V,8261,4,13,5,11,46,40,6,44
Adelaide Utd,8261,5,11,6,11,37,40,-3,39
Brisbane,8261,6,10,5,13,33,42,-9,35
Western Sydn,8261,7,8,9,10,38,47,-9,33
Perth Glory,8261,8,10,2,15,37,50,-13,32
Wellington P,8261,9,5,6,16,31,55,-24,21
CC Mariners,8261,10,4,8,15,28,49,-21,20
Sydney FC,8262,1,20,4,4,64,23,41,64
N'castle Jet,8262,2,16,5,7,59,38,21,53
Melbourne V,8262,3,14,5,10,46,38,8,47
Melbourne C,8262,4,14,4,11,44,35,9,46
Adelaide Utd,8262,5,11,6,11,37,40,-3,39
Brisbane,8262,6,10,5,13,33,42,-9,35
Western Sydn,8262,7,8,9,10,38,47,-9,33
Perth Glory,8262,8,10,2,15,37,50,-13,32
Wellington P,8262,9,5,6,16,31,55,-24,21
CC Mariners,8262,10,4,8,15,28,49,-21,20
Sydney FC,8263,1,21,4,3,67,23,44,67
N'castle Jet,8263,2,15,5,8,57,40,17,50
Melbourne C,8263,3,15,4,10,46,33,13,49
Melbourne V,8263,4,13,5,11,46,41,5,44
Adelaide Utd,8263,5,11,6,11,37,40,-3,39
Brisbane,8263,6,10,5,13,33,42,-9,35
Western Sydn,8263,7,8,9,10,38,47,-9,33
Perth Glory,8263,8,10,2,15,37,50,-13,32
Wellington P,8263,9,5,6,16,31,55,-24,21
CC Mariners,8263,10,4,8,15,28,49,-21,20
Sydney FC,8264,1,21,4,3,67,24,43,67
N'castle Jet,8264,2,15,5,8,57,38,19,50
Melbourne C,8264,3,15,4,10,44,33,11,49
Melbourne V,8264,4,13,5,11,47,41,6,44
Adelaide Utd,8264,5,11,6,11,37,40,-3,39
Brisbane,8264,6,10,5,13,33,42,-9,35
Western Sydn,8264,7,8,9,10,38,47,-9,33
Perth Glory,8264,8,10,2,15,37,50,-13,32
Wellington P,8264,9,5,6,16,31,55,-24,21
CC Mariners,8264,10,4,8,15,28,49,-21,20
Sydney FC,8265,1,21,4,3,66,23,43,67
N'castle Jet,8265,2,16,5,7,60,38,22,53
Melbourne C,8265,3,14,4,11,44,36,8,46
Melbourne V,8265,4,13,5,11,46,40,6,44
Adelaide Utd,8265,5,11,6,11,37,40,-3,39
Brisbane,8265,6,10,5,13,33,42,-9,35
Western Sydn,8265,7,8,9,10,38,47,-9,33
Perth Glory,8265,8,10,2,15,37,50,-13,32
Wellington P,8265,9,5,6,16,31,55,-24,21
CC Mariners,8265,10,4,8,15,28,49,-21,20
Sydney FC,8266,1,21,4,3,66,22,44,67
N'castle Jet,8266,2,15,6,7,58,38,20,51
Melbourne C,8266,3,14,5,10,44,34,10,47
Melbourne V,8266,4,13,5,11,45,40,5,44
Adelaide Utd,8266,5,11,6,11,37,40,-3,39
Brisbane,8266,6,10,5,13,33,42,-9,35
Western Sydn,8266,7,8,9,10,38,47,-9,33
Perth Glory,8266,8,10,2,15,37,50,-13,32
Wellington P,8266,9,5,6,16,31,55,-24,21
CC Mariners,8266,10,4,8,15,28,49,-21,20
Sydney FC,8267,1,21,4,3,69,25,44,67
N'castle Jet,8267,2,16,5,7,58,37,21,53
Melbourne C,8267,3,14,4,11,43,34,9,46
Melbourne V,8267,4,13,5,11,48,43,5,44
Adelaide Utd,8267,5,11,6,11,37,40,-3,39
Brisbane,8267,6,10,5,13,33,42,-9,35
Western Sydn,8267,7,8,9,10,38,47,-9,33
Perth Glory,8267,8,10,2,15,37,50,-13,32
Wellington P,8267,9,5,6,16,31,55,-24,21
CC Mariners,8267,10,4,8,15,28,49,-21,20
Sydney FC,8268,1,20,4,4,64,23,41,64
N'castle Jet,8268,2,15,5,8,58,39,19,50
Melbourne C,8268,3,15,4,10,45,34,11,49
Melbourne V,8268,4,14,5,10,46,38,8,47
Adelaide Utd,8268,5,11,6,11,37,40,-3,39
Brisbane,8268,6,10,5,13,33,42,-9,35
Western Sydn,8268,7,8,9,10,38,47,-9,33
Perth Glory,8268,8,10,2,15,37,50,-13,32
Wellington P,8268,9,5,6,16,31,55,-24,21
CC Mariners,8268,10,4,8,15,28,49,-21,20
Sydney FC,8269,1,21,4,3,66,23,43,67
N'castle Jet,8269,2,15,5,8,57,38,19,50
Melbourne C,8269,3,15,4,10,44,33,11,49
Melbourne V,8269,4,13,5,11,46,40,6,44
Adelaide Utd,8269,5,11,6,11,37,40,-3,39
Brisbane,8269,6,10,5,13,33,42,-9,35
Western Sydn,8269,7,8,9,10,38,47,-9,33
Perth Glory,8269,8,10,2,15,37,50,-13,32
Wellington P,8269,9,5,6,16,31,55,-24,21
CC Mariners,8269,10,4,8,15,28,49,-21,20
Sydney FC,8270,1,21,4,3,66,22,44,67
N'castle Jet,8270,2,16,5,7,59,37,22,53
Melbourne C,8270,3,14,4,11,43,35,8,46
Melbourne V,8270,4,13,5,11,45,40,5,44
Adelaide Utd,8270,5,11,6,11,37,40,-3,39
Brisbane,8270,6,10,5,13,33,42,-9,35
Western Sydn,8270,7,8,9,10,38,47,-9,33
Perth Glory,8270,8,10,2,15,37,50,-13,32
Wellington P,8270,9,5,6,16,31,55,-24,21
CC Mariners,8270,10,4,8,15,28,49,-21,20
Sydney FC,8271,1,21,4,3,67,22,45,67
N'castle Jet,8271,2,15,6,7,57,37,20,51
Melbourne C,8271,3,14,5,10,43,33,10,47
Melbourne V,8271,4,13,5,11,45,41,4,44
Adelaide Utd,8271,5,11,6,11,37,40,-3,39
Brisbane,8271,6,10,5,13,33,42,-9,35
Western Sydn,8271,7,8,9,10,38,47,-9,33
Perth Glory,8271,8,10,2,15,37,50,-13,32
Wellington P,8271,9,5,6,16,31,55,-24,21
CC Mariners,8271,10,4,8,15,28,49,-21,20
Sydney FC,8272,1,21,4,3,65,22,43,67
N'castle Jet,8272,2,16,5,7,60,38,22,53
Melbourne C,8272,3,14,4,11,44,36,8,46
Melbourne V,8272,4,13,5,11,45,39,6,44
Adelaide Utd,8272,5,11,6,11,37,40,-3,39
Brisbane,8272,6,10,5,13,33,42,-9,35
Western Sydn,8272,7,8,9,10,38,47,-9,33
Perth Glory,8272,8,10,2,15,37,50,-13,32
Wellington P,8272,9,5,6,16,31,55,-24,21
CC Mariners,8272,10,4,8,15,28,49,-21,20
Sydney FC,8273,1,20,4,4,64,23,41,64
N'castle Jet,8273,2,15,5,8,57,38,19,50
Melbourne C,8273,3,15,4,10,44,33,11,49
Melbourne V,8273,4,14,5,10,46,38,8,47
Adelaide Utd,8273,5,11,6,11,37,40,-3,39
Brisbane,8273,6,10,5,13,33,42,-9,35
Western Sydn,8273,7,8,9,10,38,47,-9,33
Perth Glory,8273,8,10,2,15,37,50,-13,32
Wellington P,8273,9,5,6,16,31,55,-24,21
CC Mariners,8273,10,4,8,15,28,49,-21,20
Sydney FC,8274,1,20,5,3,64,22,42,65
N'castle Jet,8274,2,16,5,7,59,38,21,53
Melbourne C,8274,3,14,4,11,44,35,9,46
Melbourne V,8274,4,13,6,10,45,38,7,45
Adelaide Utd,8274,5,11,6,11,37,40,-3,39
Brisbane,8274,6,10,5,13,33,42,-9,35
Western Sydn,8274,7,8,9,10,38,47,-9,33
Perth Glory,8274,8,10,2,15,37,50,-13,32
Wellington P,8274,9,5,6,16,31,55,-24,21
CC Mariners,8274,10,4,8,15,28,49,-21,20
Sydney FC,8275,1,21,4,3,66,22,44,67
N'castle Jet,8275,2,16,5,7,58,37,21,53
Melbourne C,8275,3,14,4,11,43,34,9,46
Melbourne V,8275,4,13,5,11,45,40,5,44
Adelaide Utd,8275,5,11,6,11,37,40,-3,39
Brisbane,8275,6,10,5,13,33,42,-9,35
Western Sydn,8275,7,8,9,10,38,47,-9,33
Perth Glory,8275,8,10,2,15,37,50,-13,32
Wellington P,8275,9,5,6,16,31,55,-24,21
CC Mariners,8275,10,4,8,15,28,49,-21,20
Sydney FC,8276,1,21,4,3,66,23,43,67
N'castle Jet,8276,2,16,5,7,59,37,22,53
Melbourne C,8276,3,14,4,11,43,35,8,46
Melbourne V,8276,4,13,5,11,46,40,6,44
Adelaide Utd,8276,5,11,6,11,37,40,-3,39
Brisbane,8276,6,10,5,13,33,42,-9,35
Western Sydn,8276,7,8,9,10,38,47,-9,33
Perth Glory,8276,8,10,2,15,37,50,-13,32
Wellington P,8276,9,5,6,16,31,55,-24,21
CC Mariners,8276,10,4,8,15,28,49,-21,20
Sydney FC,8277,1,21,4,3,68,24,44,67
N'castle Jet,8277,2,15,6,7,57,37,20,51
Melbourne C,8277,3,14,5,10,43,33,10,47
Melbourne V,8277,4,13,5,11,47,42,5,44
Adelaide Utd,8277,5,11,6,11,37,40,-3,39
Brisbane,8277,6,10,5,13,33,42,-9,35
Western Sydn,8277,7,8,9,10,38,47,-9,33
Perth Glory,8277,8,10,2,15,37,50,-13,32
Wellington P,8277,9,5,6,16,31,55,-24,21
CC Mariners,8277,10,4,8,15,28,49,-21,20
Sydney FC,8278,1,21,4,3,68,24,44,67
N'castle Jet,8278,2,16,5,7,58,37,21,53
Melbourne C,8278,3,14,4,11,43,34,9,46
Melbourne V,8278,4,13,5,11,47,42,5,44
Adelaide Utd,8278,5,11,6,11,37,40,-3,39
Brisbane,8278,6,10,5,13,33,42,-9,35
Western Sydn,8278,7,8,9,10,38,47,-9,33
Perth Glory,8278,8,10,2,15,37,50,-13,32
Wellington P,8278,9,5,6,16,31,55,-24,21
CC Mariners,8278,10,4,8,15,28,49,-21,20
Sydney FC,8279,1,20,5,3,66,24,42,65
N'castle Jet,8279,2,16,5,7,61,38,23,53
Melbourne C,8279,3,14,4,11,44,37,7,46
Melbourne V,8279,4,13,6,10,47,40,7,45
Adelaide Utd,8279,5,11,6,11,37,40,-3,39
Brisbane,8279,6,10,5,13,33,42,-9,35
Western Sydn,8279,7,8,9,10,38,47,-9,33
Perth Glory,8279,8,10,2,15,37,50,-13,32
Wellington P,8279,9,5,6,16,31,55,-24,21
CC Mariners,8279,10,4,8,15,28,49,-21,20
Sydney FC,8280,1,21,4,3,65,22,43,67
N'castle Jet,8280,2,16,5,7,58,37,21,53
Melbourne C,8280,3,14,4,11,43,34,9,46
Melbourne V,8280,4,13,5,11,45,39,6,44
Adelaide Utd,8280,5,11,6,11,37,40,-3,39
Brisbane,8280,6,10,5,13,33,42,-9,35
Western Sydn,8280,7,8,9,10,38,47,-9,33
Perth Glory,8280,8,10,2,15,37,50,-13,32
Wellington P,8280,9,5,6,16,31,55,-24,21
CC Mariners,8280,10,4,8,15,28,49,-21,20
Sydney FC,8281,1,21,4,3,65,22,43,67
N'castle Jet,8281,2,16,5,7,62,40,22,53
Melbourne C,8281,3,14,4,11,46,38,8,46
Melbourne V,8281,4,13,5,11,45,39,6,44
Adelaide Utd,8281,5,11,6,11,37,40,-3,39
Brisbane,8281,6,10,5,13,33,42,-9,35
Western Sydn,8281,7,8,9,10,38,47,-9,33
Perth Glory,8281,8,10,2,15,37,50,-13,32
Wellington P,8281,9,5,6,16,31,55,-24,21
CC Mariners,8281,10,4,8,15,28,49,-21,20
Sydney FC,8282,1,21,4,3,66,23,43,67
N'castle Jet,8282,2,16,5,7,60,37,23,53
Melbourne C,8282,3,14,4,11,43,36,7,46
Melbourne V,8282,4,13,5,11,46,40,6,44
Adelaide Utd,8282,5,11,6,11,37,40,-3,39
Brisbane,8282,6,10,5,13,33,42,-9,35
Western Sydn,8282,7,8,9,10,38,47,-9,33
Perth Glory,8282,8,10,2,15,37,50,-13,32
Wellington P,8282,9,5,6,16,31,55,-24,21
CC Mariners,8282,10,4,8,15,28,49,-21,20
Sydney FC,8283,1,20,4,4,65,24,41,64
N'castle Jet,8283,2,15,5,8,57,38,19,50
Melbourne C,8283,3,15,4,10,44,33,11,49
Melbourne V,8283,4,14,5,10,47,39,8,47
Adelaide Utd,8283,5,11,6,11,37,40,-3,39
Brisbane,8283,6,10,5,13,33,42,-9,35
Western Sydn,8283,7,8,9,10,38,47,-9,33
Perth Glory,8283,8,10,2,15,37,50,-13,32
Wellington P,8283,9,5,6,16,31,55,-24,21
CC Mariners,8283,10,4,8,15,28,49,-21,20
Sydney FC,8284,1,21,4,3,66,22,44,67
N'castle Jet,8284,2,15,6,7,59,39,20,51
Melbourne C,8284,3,14,5,10,45,35,10,47
Melbourne V,8284,4,13,5,11,45,40,5,44
Adelaide Utd,8284,5,11,6,11,37,40,-3,39
Brisbane,8284,6,10,5,13,33,42,-9,35
Western Sydn,8284,7,8,9,10,38,47,-9,33
Perth Glory,8284,8,10,2,15,37,50,-13,32
Wellington P,8284,9,5,6,16,31,55,-24,21
CC Mariners,8284,10,4,8,15,28,49,-21,20
Sydney FC,8285,1,21,4,3,66,22,44,67
N'castle Jet,8285,2,16,5,7,60,37,23,53
Melbourne C,8285,3,14,4,11,43,36,7,46
Melbourne V,8285,4,13,5,11,45,40,5,44
Adelaide Utd,8285,5,11,6,11,37,40,-3,39
Brisbane,8285,6,10,5,13,33,42,-9,35
Western Sydn,8285,7,8,9,10,38,47,-9,33
Perth Glory,8285,8,10,2,15,37,50,-13,32
Wellington P,8285,9,5,6,16,31,55,-24,21
CC Mariners,8285,10,4,8,15,28,49,-21,20
Sydney FC,8286,1,20,5,3,65,23,42,65
N'castle Jet,8286,2,16,5,7,59,38,21,53
Melbourne C,8286,3,14,4,11,44,35,9,46
Melbourne V,8286,4,13,6,10,46,39,7,45
Adelaide Utd,8286,5,11,6,11,37,40,-3,39
Brisbane,8286,6,10,5,13,33,42,-9,35
Western Sydn,8286,7,8,9,10,38,47,-9,33
Perth Glory,8286,8,10,2,15,37,50,-13,32
Wellington P,8286,9,5,6,16,31,55,-24,21
CC Mariners,8286,10,4,8,15,28,49,-21,20
Sydney FC,8287,1,20,5,3,64,22,42,65
N'castle Jet,8287,2,15,5,8,57,39,18,50
Melbourne C,8287,3,15,4,10,45,33,12,49
Melbourne V,8287,4,13,6,10,45,38,7,45
Adelaide Utd,8287,5,11,6,11,37,40,-3,39
Brisbane,8287,6,10,5,13,33,42,-9,35
Western Sydn,8287,7,8,9,10,38,47,-9,33
Perth Glory,8287,8,10,2,15,37,50,-13,32
Wellington P,8287,9,5,6,16,31,55,-24,21
CC Mariners,8287,10,4,8,15,28,49,-21,20
Sydney FC,8288,1,20,4,4,64,24,40,64
N'castle Jet,8288,2,15,6,7,60,40,20,51
Melbourne C,8288,3,14,5,10,46,36,10,47
Melbourne V,8288,4,14,5,10,47,38,9,47
Adelaide Utd,8288,5,11,6,11,37,40,-3,39
Brisbane,8288,6,10,5,13,33,42,-9,35
Western Sydn,8288,7,8,9,10,38,47,-9,33
Perth Glory,8288,8,10,2,15,37,50,-13,32
Wellington P,8288,9,5,6,16,31,55,-24,21
CC Mariners,8288,10,4,8,15,28,49,-21,20
Sydney FC,8289,1,21,4,3,67,22,45,67
N'castle Jet,8289,2,16,5,7,58,37,21,53
Melbourne C,8289,3,14,4,11,43,34,9,46
Melbourne V,8289,4,13,5,11,45,41,4,44
Adelaide Utd,8289,5,11,6,11,37,40,-3,39
Brisbane,8289,6,10,5,13,33,42,-9,35
Western Sydn,8289,7,8,9,10,38,47,-9,33
Perth Glory,8289,8,10,2,15,37,50,-13,32
Wellington P,8289,9,5,6,16,31,55,-24,21
CC Mariners,8289,10,4,8,15,28,49,-21,20
Sydney FC,8290,1,20,5,3,67,25,42,65
N'castle Jet,8290,2,16,5,7,61,37,24,53
Melbourne C,8290,3,14,4,11,43,37,6,46
Melbourne V,8290,4,13,6,10,48,41,7,45
Adelaide Utd,8290,5,11,6,11,37,40,-3,39
Brisbane,8290,6,10,5,13,33,42,-9,35
Western Sydn,8290,7,8,9,10,38,47,-9,33
Perth Glory,8290,8,10,2,15,37,50,-13,32
Wellington P,8290,9,5,6,16,31,55,-24,21
CC Mariners,8290,10,4,8,15,28,49,-21,20
Sydney FC,8291,1,20,4,4,65,24,41,64
N'castle Jet,8291,2,15,6,7,59,39,20,51
Melbourne C,8291,3,14,5,10,45,35,10,47
Melbourne V,8291,4,14,5,10,47,39,8,47
Adelaide Utd,8291,5,11,6,11,37,40,-3,39
Brisbane,8291,6,10,5,13,33,42,-9,35
Western Sydn,8291,7,8,9,10,38,47,-9,33
Perth Glory,8291,8,10,2,15,37,50,-13,32
Wellington P,8291,9,5,6,16,31,55,-24,21
CC Mariners,8291,10,4,8,15,28,49,-21,20
Sydney FC,8292,1,21,4,3,68,23,45,67
N'castle Jet,8292,2,15,6,7,60,40,20,51
Melbourne C,8292,3,14,5,10,46,36,10,47
Melbourne V,8292,4,13,5,11,46,42,4,44
Adelaide Utd,8292,5,11,6,11,37,40,-3,39
Brisbane,8292,6,10,5,13,33,42,-9,35
Western Sydn,8292,7,8,9,10,38,47,-9,33
Perth Glory,8292,8,10,2,15,37,50,-13,32
Wellington P,8292,9,5,6,16,31,55,-24,21
CC Mariners,8292,10,4,8,15,28,49,-21,20
Sydney FC,8293,1,21,4,3,66,23,43,67
N'castle Jet,8293,2,15,5,8,59,40,19,50
Melbourne C,8293,3,15,4,10,46,35,11,49
Melbourne V,8293,4,13,5,11,46,40,6,44
Adelaide Utd,8293,5,11,6,11,37,40,-3,39
Brisbane,8293,6,10,5,13,33,42,-9,35
Western Sydn,8293,7,8,9,10,38,47,-9,33
Perth Glory,8293,8,10,2,15,37,50,-13,32
Wellington P,8293,9,5,6,16,31,55,-24,21
CC Mariners,8293,10,4,8,15,28,49,-21,20
Sydney FC,8294,1,21,4,3,69,23,46,67
N'castle Jet,8294,2,15,6,7,58,38,20,51
Melbourne C,8294,3,14,5,10,44,34,10,47
Melbourne V,8294,4,13,5,11,46,43,3,44
Adelaide Utd,8294,5,11,6,11,37,40,-3,39
Brisbane,8294,6,10,5,13,33,42,-9,35
Western Sydn,8294,7,8,9,10,38,47,-9,33
Perth Glory,8294,8,10,2,15,37,50,-13,32
Wellington P,8294,9,5,6,16,31,55,-24,21
CC Mariners,8294,10,4,8,15,28,49,-21,20
Sydney FC,8295,1,20,5,3,65,23,42,65
N'castle Jet,8295,2,15,6,7,57,37,20,51
Melbourne C,8295,3,14,5,10,43,33,10,47
Melbourne V,8295,4,13,6,10,46,39,7,45
Adelaide Utd,8295,5,11,6,11,37,40,-3,39
Brisbane,8295,6,10,5,13,33,42,-9,35
Western Sydn,8295,7,8,9,10,38,47,-9,33
Perth Glory,8295,8,10,2,15,37,50,-13,32
Wellington P,8295,9,5,6,16,31,55,-24,21
CC Mariners,8295,10,4,8,15,28,49,-21,20
Sydney FC,8296,1,20,5,3,65,23,42,65
N'castle Jet,8296,2,16,5,7,59,38,21,53
Melbourne C,8296,3,14,4,11,44,35,9,46
Melbourne V,8296,4,13,6,10,46,39,7,45
Adelaide Utd,8296,5,11,6,11,37,40,-3,39
Brisbane,8296,6,10,5,13,33,42,-9,35
Western Sydn,8296,7,8,9,10,38,47,-9,33
Perth Glory,8296,8,10,2,15,37,50,-13,32
Wellington P,8296,9,5,6,16,31,55,-24,21
CC Mariners,8296,10,4,8,15,28,49,-21,20
Sydney FC,8297,1,20,4,4,64,24,40,64
N'castle Jet,8297,2,15,5,8,57,39,18,50
Melbourne C,8297,3,15,4,10,45,33,12,49
Melbourne V,8297,4,14,5,10,47,38,9,47
Adelaide Utd,8297,5,11,6,11,37,40,-3,39
Brisbane,8297,6,10,5,13,33,42,-9,35
Western Sydn,8297,7,8,9,10,38,47,-9,33
Perth Glory,8297,8,10,2,15,37,50,-13,32
Wellington P,8297,9,5,6,16,31,55,-24,21
CC Mariners,8297,10,4,8,15,28,49,-21,20
Sydney FC,8298,1,20,4,4,66,27,39,64
N'castle Jet,8298,2,16,5,7,61,38,23,53
Melbourne V,8298,3,14,5,10,50,40,10,47
Melbourne C,8298,4,14,4,11,44,37,7,46
Adelaide Utd,8298,5,11,6,11,37,40,-3,39
Brisbane,8298,6,10,5,13,33,42,-9,35
Western Sydn,8298,7,8,9,10,38,47,-9,33
Perth Glory,8298,8,10,2,15,37,50,-13,32
Wellington P,8298,9,5,6,16,31,55,-24,21
CC Mariners,8298,10,4,8,15,28,49,-21,20
Sydney FC,8299,1,20,5,3,66,24,42,65
N'castle Jet,8299,2,16,5,7,62,38,24,53
Melbourne C,8299,3,14,4,11,44,38,6,46
Melbourne V,8299,4,13,6,10,47,40,7,45
Adelaide Utd,8299,5,11,6,11,37,40,-3,39
Brisbane,8299,6,10,5,13,33,42,-9,35
Western Sydn,8299,7,8,9,10,38,47,-9,33
Perth Glory,8299,8,10,2,15,37,50,-13,32
Wellington P,8299,9,5,6,16,31,55,-24,21
CC Mariners,8299,10,4,8,15,28,49,-21,20
Sydney FC,8300,1,20,4,4,64,25,39,64
N'castle Jet,8300,2,15,5,8,57,39,18,50
Melbourne C,8300,3,15,4,10,45,33,12,49
Melbourne V,8300,4,14,5,10,48,38,10,47
Adelaide Utd,8300,5,11,6,11,37,40,-3,39
Brisbane,8300,6,10,5,13,33,42,-9,35
Western Sydn,8300,7,8,9,10,38,47,-9,33
Perth Glory,8300,8,10,2,15,37,50,-13,32
Wellington P,8300,9,5,6,16,31,55,-24,21
CC Mariners,8300,10,4,8,15,28,49,-21,20
Sydney FC,8301,1,21,4,3,66,23,43,67
N'castle Jet,8301,2,16,5,7,59,37,22,53
Melbourne C,8301,3,14,4,11,43,35,8,46
Melbourne V,8301,4,13,5,11,46,40,6,44
Adelaide Utd,8301,5,11,6,11,37,40,-3,39
Brisbane,8301,6,10,5,13,33,42,-9,35
Western Sydn,8301,7,8,9,10,38,47,-9,33
Perth Glory,8301,8,10,2,15,37,50,-13,32
Wellington P,8301,9,5,6,16,31,55,-24,21
CC Mariners,8301,10,4,8,15,28,49,-21,20
Sydney FC,8302,1,20,5,3,65,23,42,65
N'castle Jet,8302,2,15,5,8,58,39,19,50
Melbourne C,8302,3,15,4,10,45,34,11,49
Melbourne V,8302,4,13,6,10,46,39,7,45
Adelaide Utd,8302,5,11,6,11,37,40,-3,39
Brisbane,8302,6,10,5,13,33,42,-9,35
Western Sydn,8302,7,8,9,10,38,47,-9,33
Perth Glory,8302,8,10,2,15,37,50,-13,32
Wellington P,8302,9,5,6,16,31,55,-24,21
CC Mariners,8302,10,4,8,15,28,49,-21,20
Sydney FC,8303,1,21,4,3,68,22,46,67
N'castle Jet,8303,2,16,5,7,62,38,24,53
Melbourne C,8303,3,14,4,11,44,38,6,46
Melbourne V,8303,4,13,5,11,45,42,3,44
Adelaide Utd,8303,5,11,6,11,37,40,-3,39
Brisbane,8303,6,10,5,13,33,42,-9,35
Western Sydn,8303,7,8,9,10,38,47,-9,33
Perth Glory,8303,8,10,2,15,37,50,-13,32
Wellington P,8303,9,5,6,16,31,55,-24,21
CC Mariners,8303,10,4,8,15,28,49,-21,20
Sydney FC,8304,1,21,4,3,67,22,45,67
N'castle Jet,8304,2,15,5,8,57,40,17,50
Melbourne C,8304,3,15,4,10,46,33,13,49
Melbourne V,8304,4,13,5,11,45,41,4,44
Adelaide Utd,8304,5,11,6,11,37,40,-3,39
Brisbane,8304,6,10,5,13,33,42,-9,35
Western Sydn,8304,7,8,9,10,38,47,-9,33
Perth Glory,8304,8,10,2,15,37,50,-13,32
Wellington P,8304,9,5,6,16,31,55,-24,21
CC Mariners,8304,10,4,8,15,28,49,-21,20
Sydney FC,8305,1,21,4,3,66,23,43,67
N'castle Jet,8305,2,15,6,7,58,38,20,51
Melbourne C,8305,3,14,5,10,44,34,10,47
Melbourne V,8305,4,13,5,11,46,40,6,44
Adelaide Utd,8305,5,11,6,11,37,40,-3,39
Brisbane,8305,6,10,5,13,33,42,-9,35
Western Sydn,8305,7,8,9,10,38,47,-9,33
Perth Glory,8305,8,10,2,15,37,50,-13,32
Wellington P,8305,9,5,6,16,31,55,-24,21
CC Mariners,8305,10,4,8,15,28,49,-21,20
Sydney FC,8306,1,21,4,3,69,22,47,67
N'castle Jet,8306,2,16,5,7,60,38,22,53
Melbourne C,8306,3,14,4,11,44,36,8,46
Melbourne V,8306,4,13,5,11,45,43,2,44
Adelaide Utd,8306,5,11,6,11,37,40,-3,39
Brisbane,8306,6,10,5,13,33,42,-9,35
Western Sydn,8306,7,8,9,10,38,47,-9,33
Perth Glory,8306,8,10,2,15,37,50,-13,32
Wellington P,8306,9,5,6,16,31,55,-24,21
CC Mariners,8306,10,4,8,15,28,49,-21,20
Sydney FC,8307,1,21,4,3,66,22,44,67
N'castle Jet,8307,2,15,5,8,58,39,19,50
Melbourne C,8307,3,15,4,10,45,34,11,49
Melbourne V,8307,4,13,5,11,45,40,5,44
Adelaide Utd,8307,5,11,6,11,37,40,-3,39
Brisbane,8307,6,10,5,13,33,42,-9,35
Western Sydn,8307,7,8,9,10,38,47,-9,33
Perth Glory,8307,8,10,2,15,37,50,-13,32
Wellington P,8307,9,5,6,16,31,55,-24,21
CC Mariners,8307,10,4,8,15,28,49,-21,20
Sydney FC,8308,1,21,4,3,67,24,43,67
N'castle Jet,8308,2,15,5,8,60,42,18,50
Melbourne C,8308,3,15,4,10,48,36,12,49
Melbourne V,8308,4,13,5,11,47,41,6,44
Adelaide Utd,8308,5,11,6,11,37,40,-3,39
Brisbane,8308,6,10,5,13,33,42,-9,35
Western Sydn,8308,7,8,9,10,38,47,-9,33
Perth Glory,8308,8,10,2,15,37,50,-13,32
Wellington P,8308,9,5,6,16,31,55,-24,21
CC Mariners,8308,10,4,8,15,28,49,-21,20
Sydney FC,8309,1,21,4,3,66,23,43,67
N'castle Jet,8309,2,15,5,8,57,38,19,50
Melbourne C,8309,3,15,4,10,44,33,11,49
Melbourne V,8309,4,13,5,11,46,40,6,44
Adelaide Utd,8309,5,11,6,11,37,40,-3,39
Brisbane,8309,6,10,5,13,33,42,-9,35
Western Sydn,8309,7,8,9,10,38,47,-9,33
Perth Glory,8309,8,10,2,15,37,50,-13,32
Wellington P,8309,9,5,6,16,31,55,-24,21
CC Mariners,8309,10,4,8,15,28,49,-21,20
Sydney FC,8310,1,20,5,3,64,22,42,65
N'castle Jet,8310,2,15,5,8,57,38,19,50
Melbourne C,8310,3,15,4,10,44,33,11,49
Melbourne V,8310,4,13,6,10,45,38,7,45
Adelaide Utd,8310,5,11,6,11,37,40,-3,39
Brisbane,8310,6,10,5,13,33,42,-9,35
Western Sydn,8310,7,8,9,10,38,47,-9,33
Perth Glory,8310,8,10,2,15,37,50,-13,32
Wellington P,8310,9,5,6,16,31,55,-24,21
CC Mariners,8310,10,4,8,15,28,49,-21,20
Sydney FC,8311,1,21,4,3,67,24,43,67
N'castle Jet,8311,2,16,5,7,59,38,21,53
Melbourne C,8311,3,14,4,11,44,35,9,46
Melbourne V,8311,4,13,5,11,47,41,6,44
Adelaide Utd,8311,5,11,6,11,37,40,-3,39
Brisbane,8311,6,10,5,13,33,42,-9,35
Western Sydn,8311,7,8,9,10,38,47,-9,33
Perth Glory,8311,8,10,2,15,37,50,-13,32
Wellington P,8311,9,5,6,16,31,55,-24,21
CC Mariners,8311,10,4,8,15,28,49,-21,20
Sydney FC,8312,1,20,4,4,65,24,41,64
N'castle Jet,8312,2,16,5,7,61,37,24,53
Melbourne V,8312,3,14,5,10,47,39,8,47
Melbourne C,8312,4,14,4,11,43,37,6,46
Adelaide Utd,8312,5,11,6,11,37,40,-3,39
Brisbane,8312,6,10,5,13,33,42,-9,35
Western Sydn,8312,7,8,9,10,38,47,-9,33
Perth Glory,8312,8,10,2,15,37,50,-13,32
Wellington P,8312,9,5,6,16,31,55,-24,21
CC Mariners,8312,10,4,8,15,28,49,-21,20
Sydney FC,8313,1,21,4,3,67,23,44,67
N'castle Jet,8313,2,16,5,7,62,38,24,53
Melbourne C,8313,3,14,4,11,44,38,6,46
Melbourne V,8313,4,13,5,11,46,41,5,44
Adelaide Utd,8313,5,11,6,11,37,40,-3,39
Brisbane,8313,6,10,5,13,33,42,-9,35
Western Sydn,8313,7,8,9,10,38,47,-9,33
Perth Glory,8313,8,10,2,15,37,50,-13,32
Wellington P,8313,9,5,6,16,31,55,-24,21
CC Mariners,8313,10,4,8,15,28,49,-21,20
Sydney FC,8314,1,21,4,3,66,22,44,67
N'castle Jet,8314,2,16,5,7,61,37,24,53
Melbourne C,8314,3,14,4,11,43,37,6,46
Melbourne V,8314,4,13,5,11,45,40,5,44
Adelaide Utd,8314,5,11,6,11,37,40,-3,39
Brisbane,8314,6,10,5,13,33,42,-9,35
Western Sydn,8314,7,8,9,10,38,47,-9,33
Perth Glory,8314,8,10,2,15,37,50,-13,32
Wellington P,8314,9,5,6,16,31,55,-24,21
CC Mariners,8314,10,4,8,15,28,49,-21,20
Sydney FC,8315,1,21,4,3,65,22,43,67
N'castle Jet,8315,2,15,6,7,57,37,20,51
Melbourne C,8315,3,14,5,10,43,33,10,47
Melbourne V,8315,4,13,5,11,45,39,6,44
Adelaide Utd,8315,5,11,6,11,37,40,-3,39
Brisbane,8315,6,10,5,13,33,42,-9,35
Western Sydn,8315,7,8,9,10,38,47,-9,33
Perth Glory,8315,8,10,2,15,37,50,-13,32
Wellington P,8315,9,5,6,16,31,55,-24,21
CC Mariners,8315,10,4,8,15,28,49,-21,20
Sydney FC,8316,1,21,4,3,66,23,43,67
N'castle Jet,8316,2,15,6,7,58,38,20,51
Melbourne C,8316,3,14,5,10,44,34,10,47
Melbourne V,8316,4,13,5,11,46,40,6,44
Adelaide Utd,8316,5,11,6,11,37,40,-3,39
Brisbane,8316,6,10,5,13,33,42,-9,35
Western Sydn,8316,7,8,9,10,38,47,-9,33
Perth Glory,8316,8,10,2,15,37,50,-13,32
Wellington P,8316,9,5,6,16,31,55,-24,21
CC Mariners,8316,10,4,8,15,28,49,-21,20
Sydney FC,8317,1,21,4,3,68,23,45,67
N'castle Jet,8317,2,15,5,8,58,39,19,50
Melbourne C,8317,3,15,4,10,45,34,11,49
Melbourne V,8317,4,13,5,11,46,42,4,44
Adelaide Utd,8317,5,11,6,11,37,40,-3,39
Brisbane,8317,6,10,5,13,33,42,-9,35
Western Sydn,8317,7,8,9,10,38,47,-9,33
Perth Glory,8317,8,10,2,15,37,50,-13,32
Wellington P,8317,9,5,6,16,31,55,-24,21
CC Mariners,8317,10,4,8,15,28,49,-21,20
Sydney FC,8318,1,21,4,3,67,22,45,67
N'castle Jet,8318,2,15,6,7,59,39,20,51
Melbourne C,8318,3,14,5,10,45,35,10,47
Melbourne V,8318,4,13,5,11,45,41,4,44
Adelaide Utd,8318,5,11,6,11,37,40,-3,39
Brisbane,8318,6,10,5,13,33,42,-9,35
Western Sydn,8318,7,8,9,10,38,47,-9,33
Perth Glory,8318,8,10,2,15,37,50,-13,32
Wellington P,8318,9,5,6,16,31,55,-24,21
CC Mariners,8318,10,4,8,15,28,49,-21,20
Sydney FC,8319,1,20,5,3,64,22,42,65
N'castle Jet,8319,2,16,5,7,59,37,22,53
Melbourne C,8319,3,14,4,11,43,35,8,46
Melbourne V,8319,4,13,6,10,45,38,7,45
Adelaide Utd,8319,5,11,6,11,37,40,-3,39
Brisbane,8319,6,10,5,13,33,42,-9,35
Western Sydn,8319,7,8,9,10,38,47,-9,33
Perth Glory,8319,8,10,2,15,37,50,-13,32
Wellington P,8319,9,5,6,16,31,55,-24,21
CC Mariners,8319,10,4,8,15,28,49,-21,20
Sydney FC,8320,1,20,4,4,65,25,40,64
N'castle Jet,8320,2,15,5,8,57,39,18,50
Melbourne C,8320,3,15,4,10,45,33,12,49
Melbourne V,8320,4,14,5,10,48,39,9,47
Adelaide Utd,8320,5,11,6,11,37,40,-3,39
Brisbane,8320,6,10,5,13,33,42,-9,35
Western Sydn,8320,7,8,9,10,38,47,-9,33
Perth Glory,8320,8,10,2,15,37,50,-13,32
Wellington P,8320,9,5,6,16,31,55,-24,21
CC Mariners,8320,10,4,8,15,28,49,-21,20
Sydney FC,8321,1,20,5,3,65,23,42,65
N'castle Jet,8321,2,15,5,8,58,41,17,50
Melbourne C,8321,3,15,4,10,47,34,13,49
Melbourne V,8321,4,13,6,10,46,39,7,45
Adelaide Utd,8321,5,11,6,11,37,40,-3,39
Brisbane,8321,6,10,5,13,33,42,-9,35
Western Sydn,8321,7,8,9,10,38,47,-9,33
Perth Glory,8321,8,10,2,15,37,50,-13,32
Wellington P,8321,9,5,6,16,31,55,-24,21
CC Mariners,8321,10,4,8,15,28,49,-21,20
Sydney FC,8322,1,20,4,4,65,24,41,64
N'castle Jet,8322,2,16,5,7,59,38,21,53
Melbourne V,8322,3,14,5,10,47,39,8,47
Melbourne C,8322,4,14,4,11,44,35,9,46
Adelaide Utd,8322,5,11,6,11,37,40,-3,39
Brisbane,8322,6,10,5,13,33,42,-9,35
Western Sydn,8322,7,8,9,10,38,47,-9,33
Perth Glory,8322,8,10,2,15,37,50,-13,32
Wellington P,8322,9,5,6,16,31,55,-24,21
CC Mariners,8322,10,4,8,15,28,49,-21,20
Sydney FC,8323,1,20,5,3,65,23,42,65
N'castle Jet,8323,2,16,5,7,60,39,21,53
Melbourne C,8323,3,14,4,11,45,36,9,46
Melbourne V,8323,4,13,6,10,46,39,7,45
Adelaide Utd,8323,5,11,6,11,37,40,-3,39
Brisbane,8323,6,10,5,13,33,42,-9,35
Western Sydn,8323,7,8,9,10,38,47,-9,33
Perth Glory,8323,8,10,2,15,37,50,-13,32
Wellington P,8323,9,5,6,16,31,55,-24,21
CC Mariners,8323,10,4,8,15,28,49,-21,20
Sydney FC,8324,1,20,4,4,64,24,40,64
N'castle Jet,8324,2,16,5,7,61,38,23,53
Melbourne V,8324,3,14,5,10,47,38,9,47
Melbourne C,8324,4,14,4,11,44,37,7,46
Adelaide Utd,8324,5,11,6,11,37,40,-3,39
Brisbane,8324,6,10,5,13,33,42,-9,35
Western Sydn,8324,7,8,9,10,38,47,-9,33
Perth Glory,8324,8,10,2,15,37,50,-13,32
Wellington P,8324,9,5,6,16,31,55,-24,21
CC Mariners,8324,10,4,8,15,28,49,-21,20
Sydney FC,8325,1,21,4,3,67,23,44,67
N'castle Jet,8325,2,16,5,7,61,39,22,53
Melbourne C,8325,3,14,4,11,45,37,8,46
Melbourne V,8325,4,13,5,11,46,41,5,44
Adelaide Utd,8325,5,11,6,11,37,40,-3,39
Brisbane,8325,6,10,5,13,33,42,-9,35
Western Sydn,8325,7,8,9,10,38,47,-9,33
Perth Glory,8325,8,10,2,15,37,50,-13,32
Wellington P,8325,9,5,6,16,31,55,-24,21
CC Mariners,8325,10,4,8,15,28,49,-21,20
Sydney FC,8326,1,20,5,3,66,24,42,65
N'castle Jet,8326,2,15,6,7,57,37,20,51
Melbourne C,8326,3,14,5,10,43,33,10,47
Melbourne V,8326,4,13,6,10,47,40,7,45
Adelaide Utd,8326,5,11,6,11,37,40,-3,39
Brisbane,8326,6,10,5,13,33,42,-9,35
Western Sydn,8326,7,8,9,10,38,47,-9,33
Perth Glory,8326,8,10,2,15,37,50,-13,32
Wellington P,8326,9,5,6,16,31,55,-24,21
CC Mariners,8326,10,4,8,15,28,49,-21,20
Sydney FC,8327,1,21,4,3,67,23,44,67
N'castle Jet,8327,2,16,5,7,64,38,26,53
Melbourne C,8327,3,14,4,11,44,40,4,46
Melbourne V,8327,4,13,5,11,46,41,5,44
Adelaide Utd,8327,5,11,6,11,37,40,-3,39
Brisbane,8327,6,10,5,13,33,42,-9,35
Western Sydn,8327,7,8,9,10,38,47,-9,33
Perth Glory,8327,8,10,2,15,37,50,-13,32
Wellington P,8327,9,5,6,16,31,55,-24,21
CC Mariners,8327,10,4,8,15,28,49,-21,20
Sydney FC,8328,1,20,4,4,64,23,41,64
N'castle Jet,8328,2,16,5,7,60,38,22,53
Melbourne V,8328,3,14,5,10,46,38,8,47
Melbourne C,8328,4,14,4,11,44,36,8,46
Adelaide Utd,8328,5,11,6,11,37,40,-3,39
Brisbane,8328,6,10,5,13,33,42,-9,35
Western Sydn,8328,7,8,9,10,38,47,-9,33
Perth Glory,8328,8,10,2,15,37,50,-13,32
Wellington P,8328,9,5,6,16,31,55,-24,21
CC Mariners,8328,10,4,8,15,28,49,-21,20
Sydney FC,8329,1,21,4,3,66,23,43,67
N'castle Jet,8329,2,16,5,7,59,38,21,53
Melbourne C,8329,3,14,4,11,44,35,9,46
Melbourne V,8329,4,13,5,11,46,40,6,44
Adelaide Utd,8329,5,11,6,11,37,40,-3,39
Brisbane,8329,6,10,5,13,33,42,-9,35
Western Sydn,8329,7,8,9,10,38,47,-9,33
Perth Glory,8329,8,10,2,15,37,50,-13,32
Wellington P,8329,9,5,6,16,31,55,-24,21
CC Mariners,8329,10,4,8,15,28,49,-21,20
Sydney FC,8330,1,21,4,3,67,22,45,67
N'castle Jet,8330,2,15,5,8,59,40,19,50
Melbourne C,8330,3,15,4,10,46,35,11,49
Melbourne V,8330,4,13,5,11,45,41,4,44
Adelaide Utd,8330,5,11,6,11,37,40,-3,39
Brisbane,8330,6,10,5,13,33,42,-9,35
Western Sydn,8330,7,8,9,10,38,47,-9,33
Perth Glory,8330,8,10,2,15,37,50,-13,32
Wellington P,8330,9,5,6,16,31,55,-24,21
CC Mariners,8330,10,4,8,15,28,49,-21,20
Sydney FC,8331,1,21,4,3,66,23,43,67
N'castle Jet,8331,2,16,5,7,60,39,21,53
Melbourne C,8331,3,14,4,11,45,36,9,46
Melbourne V,8331,4,13,5,11,46,40,6,44
Adelaide Utd,8331,5,11,6,11,37,40,-3,39
Brisbane,8331,6,10,5,13,33,42,-9,35
Western Sydn,8331,7,8,9,10,38,47,-9,33
Perth Glory,8331,8,10,2,15,37,50,-13,32
Wellington P,8331,9,5,6,16,31,55,-24,21
CC Mariners,8331,10,4,8,15,28,49,-21,20
Sydney FC,8332,1,20,4,4,64,23,41,64
N'castle Jet,8332,2,16,5,7,60,38,22,53
Melbourne V,8332,3,14,5,10,46,38,8,47
Melbourne C,8332,4,14,4,11,44,36,8,46
Adelaide Utd,8332,5,11,6,11,37,40,-3,39
Brisbane,8332,6,10,5,13,33,42,-9,35
Western Sydn,8332,7,8,9,10,38,47,-9,33
Perth Glory,8332,8,10,2,15,37,50,-13,32
Wellington P,8332,9,5,6,16,31,55,-24,21
CC Mariners,8332,10,4,8,15,28,49,-21,20
Sydney FC,8333,1,21,4,3,71,24,47,67
N'castle Jet,8333,2,15,5,8,57,40,17,50
Melbourne C,8333,3,15,4,10,46,33,13,49
Melbourne V,8333,4,13,5,11,47,45,2,44
Adelaide Utd,8333,5,11,6,11,37,40,-3,39
Brisbane,8333,6,10,5,13,33,42,-9,35
Western Sydn,8333,7,8,9,10,38,47,-9,33
Perth Glory,8333,8,10,2,15,37,50,-13,32
Wellington P,8333,9,5,6,16,31,55,-24,21
CC Mariners,8333,10,4,8,15,28,49,-21,20
Sydney FC,8334,1,21,4,3,67,22,45,67
N'castle Jet,8334,2,15,6,7,59,39,20,51
Melbourne C,8334,3,14,5,10,45,35,10,47
Melbourne V,8334,4,13,5,11,45,41,4,44
Adelaide Utd,8334,5,11,6,11,37,40,-3,39
Brisbane,8334,6,10,5,13,33,42,-9,35
Western Sydn,8334,7,8,9,10,38,47,-9,33
Perth Glory,8334,8,10,2,15,37,50,-13,32
Wellington P,8334,9,5,6,16,31,55,-24,21
CC Mariners,8334,10,4,8,15,28,49,-21,20
Sydney FC,8335,1,20,5,3,65,23,42,65
N'castle Jet,8335,2,16,5,7,59,38,21,53
Melbourne C,8335,3,14,4,11,44,35,9,46
Melbourne V,8335,4,13,6,10,46,39,7,45
Adelaide Utd,8335,5,11,6,11,37,40,-3,39
Brisbane,8335,6,10,5,13,33,42,-9,35
Western Sydn,8335,7,8,9,10,38,47,-9,33
Perth Glory,8335,8,10,2,15,37,50,-13,32
Wellington P,8335,9,5,6,16,31,55,-24,21
CC Mariners,8335,10,4,8,15,28,49,-21,20
Sydney FC,8336,1,20,4,4,64,24,40,64
N'castle Jet,8336,2,16,5,7,60,39,21,53
Melbourne V,8336,3,14,5,10,47,38,9,47
Melbourne C,8336,4,14,4,11,45,36,9,46
Adelaide Utd,8336,5,11,6,11,37,40,-3,39
Brisbane,8336,6,10,5,13,33,42,-9,35
Western Sydn,8336,7,8,9,10,38,47,-9,33
Perth Glory,8336,8,10,2,15,37,50,-13,32
Wellington P,8336,9,5,6,16,31,55,-24,21
CC Mariners,8336,10,4,8,15,28,49,-21,20
Sydney FC,8337,1,21,4,3,67,24,43,67
N'castle Jet,8337,2,15,5,8,58,39,19,50
Melbourne C,8337,3,15,4,10,45,34,11,49
Melbourne V,8337,4,13,5,11,47,41,6,44
Adelaide Utd,8337,5,11,6,11,37,40,-3,39
Brisbane,8337,6,10,5,13,33,42,-9,35
Western Sydn,8337,7,8,9,10,38,47,-9,33
Perth Glory,8337,8,10,2,15,37,50,-13,32
Wellington P,8337,9,5,6,16,31,55,-24,21
CC Mariners,8337,10,4,8,15,28,49,-21,20
Sydney FC,8338,1,21,4,3,66,22,44,67
N'castle Jet,8338,2,15,6,7,58,38,20,51
Melbourne C,8338,3,14,5,10,44,34,10,47
Melbourne V,8338,4,13,5,11,45,40,5,44
Adelaide Utd,8338,5,11,6,11,37,40,-3,39
Brisbane,8338,6,10,5,13,33,42,-9,35
Western Sydn,8338,7,8,9,10,38,47,-9,33
Perth Glory,8338,8,10,2,15,37,50,-13,32
Wellington P,8338,9,5,6,16,31,55,-24,21
CC Mariners,8338,10,4,8,15,28,49,-21,20
Sydney FC,8339,1,20,4,4,65,24,41,64
N'castle Jet,8339,2,15,6,7,58,38,20,51
Melbourne C,8339,3,14,5,10,44,34,10,47
Melbourne V,8339,4,14,5,10,47,39,8,47
Adelaide Utd,8339,5,11,6,11,37,40,-3,39
Brisbane,8339,6,10,5,13,33,42,-9,35
Western Sydn,8339,7,8,9,10,38,47,-9,33
Perth Glory,8339,8,10,2,15,37,50,-13,32
Wellington P,8339,9,5,6,16,31,55,-24,21
CC Mariners,8339,10,4,8,15,28,49,-21,20
Sydney FC,8340,1,21,4,3,67,24,43,67
N'castle Jet,8340,2,15,5,8,58,41,17,50
Melbourne C,8340,3,15,4,10,47,34,13,49
Melbourne V,8340,4,13,5,11,47,41,6,44
Adelaide Utd,8340,5,11,6,11,37,40,-3,39
Brisbane,8340,6,10,5,13,33,42,-9,35
Western Sydn,8340,7,8,9,10,38,47,-9,33
Perth Glory,8340,8,10,2,15,37,50,-13,32
Wellington P,8340,9,5,6,16,31,55,-24,21
CC Mariners,8340,10,4,8,15,28,49,-21,20
Sydney FC,8341,1,21,4,3,68,25,43,67
N'castle Jet,8341,2,15,6,7,58,38,20,51
Melbourne C,8341,3,14,5,10,44,34,10,47
Melbourne V,8341,4,13,5,11,48,42,6,44
Adelaide Utd,8341,5,11,6,11,37,40,-3,39
Brisbane,8341,6,10,5,13,33,42,-9,35
Western Sydn,8341,7,8,9,10,38,47,-9,33
Perth Glory,8341,8,10,2,15,37,50,-13,32
Wellington P,8341,9,5,6,16,31,55,-24,21
CC Mariners,8341,10,4,8,15,28,49,-21,20
Sydney FC,8342,1,20,5,3,65,23,42,65
N'castle Jet,8342,2,16,5,7,59,38,21,53
Melbourne C,8342,3,14,4,11,44,35,9,46
Melbourne V,8342,4,13,6,10,46,39,7,45
Adelaide Utd,8342,5,11,6,11,37,40,-3,39
Brisbane,8342,6,10,5,13,33,42,-9,35
Western Sydn,8342,7,8,9,10,38,47,-9,33
Perth Glory,8342,8,10,2,15,37,50,-13,32
Wellington P,8342,9,5,6,16,31,55,-24,21
CC Mariners,8342,10,4,8,15,28,49,-21,20
Sydney FC,8343,1,20,4,4,64,23,41,64
N'castle Jet,8343,2,16,5,7,61,38,23,53
Melbourne V,8343,3,14,5,10,46,38,8,47
Melbourne C,8343,4,14,4,11,44,37,7,46
Adelaide Utd,8343,5,11,6,11,37,40,-3,39
Brisbane,8343,6,10,5,13,33,42,-9,35
Western Sydn,8343,7,8,9,10,38,47,-9,33
Perth Glory,8343,8,10,2,15,37,50,-13,32
Wellington P,8343,9,5,6,16,31,55,-24,21
CC Mariners,8343,10,4,8,15,28,49,-21,20
Sydney FC,8344,1,20,5,3,66,24,42,65
N'castle Jet,8344,2,16,5,7,61,38,23,53
Melbourne C,8344,3,14,4,11,44,37,7,46
Melbourne V,8344,4,13,6,10,47,40,7,45
Adelaide Utd,8344,5,11,6,11,37,40,-3,39
Brisbane,8344,6,10,5,13,33,42,-9,35
Western Sydn,8344,7,8,9,10,38,47,-9,33
Perth Glory,8344,8,10,2,15,37,50,-13,32
Wellington P,8344,9,5,6,16,31,55,-24,21
CC Mariners,8344,10,4,8,15,28,49,-21,20
Sydney FC,8345,1,21,4,3,66,22,44,67
N'castle Jet,8345,2,15,6,7,57,37,20,51
Melbourne C,8345,3,14,5,10,43,33,10,47
Melbourne V,8345,4,13,5,11,45,40,5,44
Adelaide Utd,8345,5,11,6,11,37,40,-3,39
Brisbane,8345,6,10,5,13,33,42,-9,35
Western Sydn,8345,7,8,9,10,38,47,-9,33
Perth Glory,8345,8,10,2,15,37,50,-13,32
Wellington P,8345,9,5,6,16,31,55,-24,21
CC Mariners,8345,10,4,8,15,28,49,-21,20
Sydney FC,8346,1,21,4,3,68,23,45,67
N'castle Jet,8346,2,15,5,8,58,39,19,50
Melbourne C,8346,3,15,4,10,45,34,11,49
Melbourne V,8346,4,13,5,11,46,42,4,44
Adelaide Utd,8346,5,11,6,11,37,40,-3,39
Brisbane,8346,6,10,5,13,33,42,-9,35
Western Sydn,8346,7,8,9,10,38,47,-9,33
Perth Glory,8346,8,10,2,15,37,50,-13,32
Wellington P,8346,9,5,6,16,31,55,-24,21
CC Mariners,8346,10,4,8,15,28,49,-21,20
Sydney FC,8347,1,21,4,3,68,22,46,67
N'castle Jet,8347,2,16,5,7,59,37,22,53
Melbourne C,8347,3,14,4,11,43,35,8,46
Melbourne V,8347,4,13,5,11,45,42,3,44
Adelaide Utd,8347,5,11,6,11,37,40,-3,39
Brisbane,8347,6,10,5,13,33,42,-9,35
Western Sydn,8347,7,8,9,10,38,47,-9,33
Perth Glory,8347,8,10,2,15,37,50,-13,32
Wellington P,8347,9,5,6,16,31,55,-24,21
CC Mariners,8347,10,4,8,15,28,49,-21,20
Sydney FC,8348,1,21,4,3,68,24,44,67
N'castle Jet,8348,2,15,5,8,57,39,18,50
Melbourne C,8348,3,15,4,10,45,33,12,49
Melbourne V,8348,4,13,5,11,47,42,5,44
Adelaide Utd,8348,5,11,6,11,37,40,-3,39
Brisbane,8348,6,10,5,13,33,42,-9,35
Western Sydn,8348,7,8,9,10,38,47,-9,33
Perth Glory,8348,8,10,2,15,37,50,-13,32
Wellington P,8348,9,5,6,16,31,55,-24,21
CC Mariners,8348,10,4,8,15,28,49,-21,20
Sydney FC,8349,1,21,4,3,65,22,43,67
N'castle Jet,8349,2,15,6,7,59,39,20,51
Melbourne C,8349,3,14,5,10,45,35,10,47
Melbourne V,8349,4,13,5,11,45,39,6,44
Adelaide Utd,8349,5,11,6,11,37,40,-3,39
Brisbane,8349,6,10,5,13,33,42,-9,35
Western Sydn,8349,7,8,9,10,38,47,-9,33
Perth Glory,8349,8,10,2,15,37,50,-13,32
Wellington P,8349,9,5,6,16,31,55,-24,21
CC Mariners,8349,10,4,8,15,28,49,-21,20
Sydney FC,8350,1,21,4,3,65,22,43,67
N'castle Jet,8350,2,16,5,7,58,37,21,53
Melbourne C,8350,3,14,4,11,43,34,9,46
Melbourne V,8350,4,13,5,11,45,39,6,44
Adelaide Utd,8350,5,11,6,11,37,40,-3,39
Brisbane,8350,6,10,5,13,33,42,-9,35
Western Sydn,8350,7,8,9,10,38,47,-9,33
Perth Glory,8350,8,10,2,15,37,50,-13,32
Wellington P,8350,9,5,6,16,31,55,-24,21
CC Mariners,8350,10,4,8,15,28,49,-21,20
Sydney FC,8351,1,21,4,3,68,25,43,67
N'castle Jet,8351,2,16,5,7,62,37,25,53
Melbourne C,8351,3,14,4,11,43,38,5,46
Melbourne V,8351,4,13,5,11,48,42,6,44
Adelaide Utd,8351,5,11,6,11,37,40,-3,39
Brisbane,8351,6,10,5,13,33,42,-9,35
Western Sydn,8351,7,8,9,10,38,47,-9,33
Perth Glory,8351,8,10,2,15,37,50,-13,32
Wellington P,8351,9,5,6,16,31,55,-24,21
CC Mariners,8351,10,4,8,15,28,49,-21,20
Sydney FC,8352,1,20,5,3,64,22,42,65
N'castle Jet,8352,2,15,5,8,57,38,19,50
Melbourne C,8352,3,15,4,10,44,33,11,49
Melbourne V,8352,4,13,6,10,45,38,7,45
Adelaide Utd,8352,5,11,6,11,37,40,-3,39
Brisbane,8352,6,10,5,13,33,42,-9,35
Western Sydn,8352,7,8,9,10,38,47,-9,33
Perth Glory,8352,8,10,2,15,37,50,-13,32
Wellington P,8352,9,5,6,16,31,55,-24,21
CC Mariners,8352,10,4,8,15,28,49,-21,20
Sydney FC,8353,1,21,4,3,67,22,45,67
N'castle Jet,8353,2,16,5,7,59,37,22,53
Melbourne C,8353,3,14,4,11,43,35,8,46
Melbourne V,8353,4,13,5,11,45,41,4,44
Adelaide Utd,8353,5,11,6,11,37,40,-3,39
Brisbane,8353,6,10,5,13,33,42,-9,35
Western Sydn,8353,7,8,9,10,38,47,-9,33
Perth Glory,8353,8,10,2,15,37,50,-13,32
Wellington P,8353,9,5,6,16,31,55,-24,21
CC Mariners,8353,10,4,8,15,28,49,-21,20
Sydney FC,8354,1,20,5,3,65,23,42,65
N'castle Jet,8354,2,16,5,7,58,37,21,53
Melbourne C,8354,3,14,4,11,43,34,9,46
Melbourne V,8354,4,13,6,10,46,39,7,45
Adelaide Utd,8354,5,11,6,11,37,40,-3,39
Brisbane,8354,6,10,5,13,33,42,-9,35
Western Sydn,8354,7,8,9,10,38,47,-9,33
Perth Glory,8354,8,10,2,15,37,50,-13,32
Wellington P,8354,9,5,6,16,31,55,-24,21
CC Mariners,8354,10,4,8,15,28,49,-21,20
Sydney FC,8355,1,21,4,3,67,23,44,67
N'castle Jet,8355,2,16,5,7,60,37,23,53
Melbourne C,8355,3,14,4,11,43,36,7,46
Melbourne V,8355,4,13,5,11,46,41,5,44
Adelaide Utd,8355,5,11,6,11,37,40,-3,39
Brisbane,8355,6,10,5,13,33,42,-9,35
Western Sydn,8355,7,8,9,10,38,47,-9,33
Perth Glory,8355,8,10,2,15,37,50,-13,32
Wellington P,8355,9,5,6,16,31,55,-24,21
CC Mariners,8355,10,4,8,15,28,49,-21,20
Sydney FC,8356,1,20,4,4,64,23,41,64
N'castle Jet,8356,2,16,5,7,58,37,21,53
Melbourne V,8356,3,14,5,10,46,38,8,47
Melbourne C,8356,4,14,4,11,43,34,9,46
Adelaide Utd,8356,5,11,6,11,37,40,-3,39
Brisbane,8356,6,10,5,13,33,42,-9,35
Western Sydn,8356,7,8,9,10,38,47,-9,33
Perth Glory,8356,8,10,2,15,37,50,-13,32
Wellington P,8356,9,5,6,16,31,55,-24,21
CC Mariners,8356,10,4,8,15,28,49,-21,20
Sydney FC,8357,1,21,4,3,66,23,43,67
N'castle Jet,8357,2,16,5,7,61,39,22,53
Melbourne C,8357,3,14,4,11,45,37,8,46
Melbourne V,8357,4,13,5,11,46,40,6,44
Adelaide Utd,8357,5,11,6,11,37,40,-3,39
Brisbane,8357,6,10,5,13,33,42,-9,35
Western Sydn,8357,7,8,9,10,38,47,-9,33
Perth Glory,8357,8,10,2,15,37,50,-13,32
Wellington P,8357,9,5,6,16,31,55,-24,21
CC Mariners,8357,10,4,8,15,28,49,-21,20
Sydney FC,8358,1,21,4,3,66,23,43,67
N'castle Jet,8358,2,15,5,8,58,40,18,50
Melbourne C,8358,3,15,4,10,46,34,12,49
Melbourne V,8358,4,13,5,11,46,40,6,44
Adelaide Utd,8358,5,11,6,11,37,40,-3,39
Brisbane,8358,6,10,5,13,33,42,-9,35
Western Sydn,8358,7,8,9,10,38,47,-9,33
Perth Glory,8358,8,10,2,15,37,50,-13,32
Wellington P,8358,9,5,6,16,31,55,-24,21
CC Mariners,8358,10,4,8,15,28,49,-21,20
Sydney FC,8359,1,21,4,3,65,22,43,67
N'castle Jet,8359,2,16,5,7,58,37,21,53
Melbourne C,8359,3,14,4,11,43,34,9,46
Melbourne V,8359,4,13,5,11,45,39,6,44
Adelaide Utd,8359,5,11,6,11,37,40,-3,39
Brisbane,8359,6,10,5,13,33,42,-9,35
Western Sydn,8359,7,8,9,10,38,47,-9,33
Perth Glory,8359,8,10,2,15,37,50,-13,32
Wellington P,8359,9,5,6,16,31,55,-24,21
CC Mariners,8359,10,4,8,15,28,49,-21,20
Sydney FC,8360,1,21,4,3,69,25,44,67
N'castle Jet,8360,2,15,5,8,58,39,19,50
Melbourne C,8360,3,15,4,10,45,34,11,49
Melbourne V,8360,4,13,5,11,48,43,5,44
Adelaide Utd,8360,5,11,6,11,37,40,-3,39
Brisbane,8360,6,10,5,13,33,42,-9,35
Western Sydn,8360,7,8,9,10,38,47,-9,33
Perth Glory,8360,8,10,2,15,37,50,-13,32
Wellington P,8360,9,5,6,16,31,55,-24,21
CC Mariners,8360,10,4,8,15,28,49,-21,20
Sydney FC,8361,1,21,4,3,68,25,43,67
N'castle Jet,8361,2,16,5,7,59,37,22,53
Melbourne C,8361,3,14,4,11,43,35,8,46
Melbourne V,8361,4,13,5,11,48,42,6,44
Adelaide Utd,8361,5,11,6,11,37,40,-3,39
Brisbane,8361,6,10,5,13,33,42,-9,35
Western Sydn,8361,7,8,9,10,38,47,-9,33
Perth Glory,8361,8,10,2,15,37,50,-13,32
Wellington P,8361,9,5,6,16,31,55,-24,21
CC Mariners,8361,10,4,8,15,28,49,-21,20
Sydney FC,8362,1,20,5,3,65,23,42,65
N'castle Jet,8362,2,15,6,7,58,38,20,51
Melbourne C,8362,3,14,5,10,44,34,10,47
Melbourne V,8362,4,13,6,10,46,39,7,45
Adelaide Utd,8362,5,11,6,11,37,40,-3,39
Brisbane,8362,6,10,5,13,33,42,-9,35
Western Sydn,8362,7,8,9,10,38,47,-9,33
Perth Glory,8362,8,10,2,15,37,50,-13,32
Wellington P,8362,9,5,6,16,31,55,-24,21
CC Mariners,8362,10,4,8,15,28,49,-21,20
Sydney FC,8363,1,21,4,3,66,22,44,67
N'castle Jet,8363,2,15,5,8,58,39,19,50
Melbourne C,8363,3,15,4,10,45,34,11,49
Melbourne V,8363,4,13,5,11,45,40,5,44
Adelaide Utd,8363,5,11,6,11,37,40,-3,39
Brisbane,8363,6,10,5,13,33,42,-9,35
Western Sydn,8363,7,8,9,10,38,47,-9,33
Perth Glory,8363,8,10,2,15,37,50,-13,32
Wellington P,8363,9,5,6,16,31,55,-24,21
CC Mariners,8363,10,4,8,15,28,49,-21,20
Sydney FC,8364,1,21,4,3,67,22,45,67
N'castle Jet,8364,2,15,6,7,58,38,20,51
Melbourne C,8364,3,14,5,10,44,34,10,47
Melbourne V,8364,4,13,5,11,45,41,4,44
Adelaide Utd,8364,5,11,6,11,37,40,-3,39
Brisbane,8364,6,10,5,13,33,42,-9,35
Western Sydn,8364,7,8,9,10,38,47,-9,33
Perth Glory,8364,8,10,2,15,37,50,-13,32
Wellington P,8364,9,5,6,16,31,55,-24,21
CC Mariners,8364,10,4,8,15,28,49,-21,20
Sydney FC,8365,1,20,4,4,65,24,41,64
N'castle Jet,8365,2,16,5,7,58,37,21,53
Melbourne V,8365,3,14,5,10,47,39,8,47
Melbourne C,8365,4,14,4,11,43,34,9,46
Adelaide Utd,8365,5,11,6,11,37,40,-3,39
Brisbane,8365,6,10,5,13,33,42,-9,35
Western Sydn,8365,7,8,9,10,38,47,-9,33
Perth Glory,8365,8,10,2,15,37,50,-13,32
Wellington P,8365,9,5,6,16,31,55,-24,21
CC Mariners,8365,10,4,8,15,28,49,-21,20
Sydney FC,8366,1,21,4,3,65,22,43,67
N'castle Jet,8366,2,16,5,7,59,37,22,53
Melbourne C,8366,3,14,4,11,43,35,8,46
Melbourne V,8366,4,13,5,11,45,39,6,44
Adelaide Utd,8366,5,11,6,11,37,40,-3,39
Brisbane,8366,6,10,5,13,33,42,-9,35
Western Sydn,8366,7,8,9,10,38,47,-9,33
Perth Glory,8366,8,10,2,15,37,50,-13,32
Wellington P,8366,9,5,6,16,31,55,-24,21
CC Mariners,8366,10,4,8,15,28,49,-21,20
Sydney FC,8367,1,20,4,4,65,25,40,64
N'castle Jet,8367,2,16,5,7,60,38,22,53
Melbourne V,8367,3,14,5,10,48,39,9,47
Melbourne C,8367,4,14,4,11,44,36,8,46
Adelaide Utd,8367,5,11,6,11,37,40,-3,39
Brisbane,8367,6,10,5,13,33,42,-9,35
Western Sydn,8367,7,8,9,10,38,47,-9,33
Perth Glory,8367,8,10,2,15,37,50,-13,32
Wellington P,8367,9,5,6,16,31,55,-24,21
CC Mariners,8367,10,4,8,15,28,49,-21,20
Sydney FC,8368,1,21,4,3,66,23,43,67
N'castle Jet,8368,2,15,5,8,59,40,19,50
Melbourne C,8368,3,15,4,10,46,35,11,49
Melbourne V,8368,4,13,5,11,46,40,6,44
Adelaide Utd,8368,5,11,6,11,37,40,-3,39
Brisbane,8368,6,10,5,13,33,42,-9,35
Western Sydn,8368,7,8,9,10,38,47,-9,33
Perth Glory,8368,8,10,2,15,37,50,-13,32
Wellington P,8368,9,5,6,16,31,55,-24,21
CC Mariners,8368,10,4,8,15,28,49,-21,20
Sydney FC,8369,1,21,4,3,65,22,43,67
N'castle Jet,8369,2,15,5,8,57,39,18,50
Melbourne C,8369,3,15,4,10,45,33,12,49
Melbourne V,8369,4,13,5,11,45,39,6,44
Adelaide Utd,8369,5,11,6,11,37,40,-3,39
Brisbane,8369,6,10,5,13,33,42,-9,35
Western Sydn,8369,7,8,9,10,38,47,-9,33
Perth Glory,8369,8,10,2,15,37,50,-13,32
Wellington P,8369,9,5,6,16,31,55,-24,21
CC Mariners,8369,10,4,8,15,28,49,-21,20
Sydney FC,8370,1,21,4,3,68,25,43,67
N'castle Jet,8370,2,16,5,7,59,38,21,53
Melbourne C,8370,3,14,4,11,44,35,9,46
Melbourne V,8370,4,13,5,11,48,42,6,44
Adelaide Utd,8370,5,11,6,11,37,40,-3,39
Brisbane,8370,6,10,5,13,33,42,-9,35
Western Sydn,8370,7,8,9,10,38,47,-9,33
Perth Glory,8370,8,10,2,15,37,50,-13,32
Wellington P,8370,9,5,6,16,31,55,-24,21
CC Mariners,8370,10,4,8,15,28,49,-21,20
Sydney FC,8371,1,21,4,3,67,23,44,67
N'castle Jet,8371,2,16,5,7,58,37,21,53
Melbourne C,8371,3,14,4,11,43,34,9,46
Melbourne V,8371,4,13,5,11,46,41,5,44
Adelaide Utd,8371,5,11,6,11,37,40,-3,39
Brisbane,8371,6,10,5,13,33,42,-9,35
Western Sydn,8371,7,8,9,10,38,47,-9,33
Perth Glory,8371,8,10,2,15,37,50,-13,32
Wellington P,8371,9,5,6,16,31,55,-24,21
CC Mariners,8371,10,4,8,15,28,49,-21,20
Sydney FC,8372,1,21,4,3,68,22,46,67
N'castle Jet,8372,2,16,5,7,59,38,21,53
Melbourne C,8372,3,14,4,11,44,35,9,46
Melbourne V,8372,4,13,5,11,45,42,3,44
Adelaide Utd,8372,5,11,6,11,37,40,-3,39
Brisbane,8372,6,10,5,13,33,42,-9,35
Western Sydn,8372,7,8,9,10,38,47,-9,33
Perth Glory,8372,8,10,2,15,37,50,-13,32
Wellington P,8372,9,5,6,16,31,55,-24,21
CC Mariners,8372,10,4,8,15,28,49,-21,20
Sydney FC,8373,1,20,4,4,64,23,41,64
N'castle Jet,8373,2,16,5,7,59,37,22,53
Melbourne V,8373,3,14,5,10,46,38,8,47
Melbourne C,8373,4,14,4,11,43,35,8,46
Adelaide Utd,8373,5,11,6,11,37,40,-3,39
Brisbane,8373,6,10,5,13,33,42,-9,35
Western Sydn,8373,7,8,9,10,38,47,-9,33
Perth Glory,8373,8,10,2,15,37,50,-13,32
Wellington P,8373,9,5,6,16,31,55,-24,21
CC Mariners,8373,10,4,8,15,28,49,-21,20
Sydney FC,8374,1,20,5,3,64,22,42,65
N'castle Jet,8374,2,16,5,7,59,38,21,53
Melbourne C,8374,3,14,4,11,44,35,9,46
Melbourne V,8374,4,13,6,10,45,38,7,45
Adelaide Utd,8374,5,11,6,11,37,40,-3,39
Brisbane,8374,6,10,5,13,33,42,-9,35
Western Sydn,8374,7,8,9,10,38,47,-9,33
Perth Glory,8374,8,10,2,15,37,50,-13,32
Wellington P,8374,9,5,6,16,31,55,-24,21
CC Mariners,8374,10,4,8,15,28,49,-21,20
Sydney FC,8375,1,21,4,3,66,23,43,67
N'castle Jet,8375,2,16,5,7,61,38,23,53
Melbourne C,8375,3,14,4,11,44,37,7,46
Melbourne V,8375,4,13,5,11,46,40,6,44
Adelaide Utd,8375,5,11,6,11,37,40,-3,39
Brisbane,8375,6,10,5,13,33,42,-9,35
Western Sydn,8375,7,8,9,10,38,47,-9,33
Perth Glory,8375,8,10,2,15,37,50,-13,32
Wellington P,8375,9,5,6,16,31,55,-24,21
CC Mariners,8375,10,4,8,15,28,49,-21,20
Sydney FC,8376,1,20,5,3,65,23,42,65
N'castle Jet,8376,2,15,6,7,59,39,20,51
Melbourne C,8376,3,14,5,10,45,35,10,47
Melbourne V,8376,4,13,6,10,46,39,7,45
Adelaide Utd,8376,5,11,6,11,37,40,-3,39
Brisbane,8376,6,10,5,13,33,42,-9,35
Western Sydn,8376,7,8,9,10,38,47,-9,33
Perth Glory,8376,8,10,2,15,37,50,-13,32
Wellington P,8376,9,5,6,16,31,55,-24,21
CC Mariners,8376,10,4,8,15,28,49,-21,20
Sydney FC,8377,1,20,5,3,66,24,42,65
N'castle Jet,8377,2,16,5,7,60,38,22,53
Melbourne C,8377,3,14,4,11,44,36,8,46
Melbourne V,8377,4,13,6,10,47,40,7,45
Adelaide Utd,8377,5,11,6,11,37,40,-3,39
Brisbane,8377,6,10,5,13,33,42,-9,35
Western Sydn,8377,7,8,9,10,38,47,-9,33
Perth Glory,8377,8,10,2,15,37,50,-13,32
Wellington P,8377,9,5,6,16,31,55,-24,21
CC Mariners,8377,10,4,8,15,28,49,-21,20
Sydney FC,8378,1,20,4,4,64,23,41,64
N'castle Jet,8378,2,16,5,7,58,37,21,53
Melbourne V,8378,3,14,5,10,46,38,8,47
Melbourne C,8378,4,14,4,11,43,34,9,46
Adelaide Utd,8378,5,11,6,11,37,40,-3,39
Brisbane,8378,6,10,5,13,33,42,-9,35
Western Sydn,8378,7,8,9,10,38,47,-9,33
Perth Glory,8378,8,10,2,15,37,50,-13,32
Wellington P,8378,9,5,6,16,31,55,-24,21
CC Mariners,8378,10,4,8,15,28,49,-21,20
Sydney FC,8379,1,21,4,3,66,22,44,67
N'castle Jet,8379,2,16,5,7,61,37,24,53
Melbourne C,8379,3,14,4,11,43,37,6,46
Melbourne V,8379,4,13,5,11,45,40,5,44
Adelaide Utd,8379,5,11,6,11,37,40,-3,39
Brisbane,8379,6,10,5,13,33,42,-9,35
Western Sydn,8379,7,8,9,10,38,47,-9,33
Perth Glory,8379,8,10,2,15,37,50,-13,32
Wellington P,8379,9,5,6,16,31,55,-24,21
CC Mariners,8379,10,4,8,15,28,49,-21,20
Sydney FC,8380,1,21,4,3,68,25,43,67
N'castle Jet,8380,2,16,5,7,58,37,21,53
Melbourne C,8380,3,14,4,11,43,34,9,46
Melbourne V,8380,4,13,5,11,48,42,6,44
Adelaide Utd,8380,5,11,6,11,37,40,-3,39
Brisbane,8380,6,10,5,13,33,42,-9,35
Western Sydn,8380,7,8,9,10,38,47,-9,33
Perth Glory,8380,8,10,2,15,37,50,-13,32
Wellington P,8380,9,5,6,16,31,55,-24,21
CC Mariners,8380,10,4,8,15,28,49,-21,20
Sydney FC,8381,1,21,4,3,65,22,43,67
N'castle Jet,8381,2,16,5,7,59,38,21,53
Melbourne C,8381,3,14,4,11,44,35,9,46
Melbourne V,8381,4,13,5,11,45,39,6,44
Adelaide Utd,8381,5,11,6,11,37,40,-3,39
Brisbane,8381,6,10,5,13,33,42,-9,35
Western Sydn,8381,7,8,9,10,38,47,-9,33
Perth Glory,8381,8,10,2,15,37,50,-13,32
Wellington P,8381,9,5,6,16,31,55,-24,21
CC Mariners,8381,10,4,8,15,28,49,-21,20
Sydney FC,8382,1,20,5,3,65,23,42,65
N'castle Jet,8382,2,15,6,7,58,38,20,51
Melbourne C,8382,3,14,5,10,44,34,10,47
Melbourne V,8382,4,13,6,10,46,39,7,45
Adelaide Utd,8382,5,11,6,11,37,40,-3,39
Brisbane,8382,6,10,5,13,33,42,-9,35
Western Sydn,8382,7,8,9,10,38,47,-9,33
Perth Glory,8382,8,10,2,15,37,50,-13,32
Wellington P,8382,9,5,6,16,31,55,-24,21
CC Mariners,8382,10,4,8,15,28,49,-21,20
Sydney FC,8383,1,21,4,3,68,25,43,67
N'castle Jet,8383,2,15,6,7,58,38,20,51
Melbourne C,8383,3,14,5,10,44,34,10,47
Melbourne V,8383,4,13,5,11,48,42,6,44
Adelaide Utd,8383,5,11,6,11,37,40,-3,39
Brisbane,8383,6,10,5,13,33,42,-9,35
Western Sydn,8383,7,8,9,10,38,47,-9,33
Perth Glory,8383,8,10,2,15,37,50,-13,32
Wellington P,8383,9,5,6,16,31,55,-24,21
CC Mariners,8383,10,4,8,15,28,49,-21,20
Sydney FC,8384,1,20,4,4,64,23,41,64
N'castle Jet,8384,2,15,5,8,57,39,18,50
Melbourne C,8384,3,15,4,10,45,33,12,49
Melbourne V,8384,4,14,5,10,46,38,8,47
Adelaide Utd,8384,5,11,6,11,37,40,-3,39
Brisbane,8384,6,10,5,13,33,42,-9,35
Western Sydn,8384,7,8,9,10,38,47,-9,33
Perth Glory,8384,8,10,2,15,37,50,-13,32
Wellington P,8384,9,5,6,16,31,55,-24,21
CC Mariners,8384,10,4,8,15,28,49,-21,20
Sydney FC,8385,1,21,4,3,66,22,44,67
N'castle Jet,8385,2,16,5,7,63,37,26,53
Melbourne C,8385,3,14,4,11,43,39,4,46
Melbourne V,8385,4,13,5,11,45,40,5,44
Adelaide Utd,8385,5,11,6,11,37,40,-3,39
Brisbane,8385,6,10,5,13,33,42,-9,35
Western Sydn,8385,7,8,9,10,38,47,-9,33
Perth Glory,8385,8,10,2,15,37,50,-13,32
Wellington P,8385,9,5,6,16,31,55,-24,21
CC Mariners,8385,10,4,8,15,28,49,-21,20
Sydney FC,8386,1,21,4,3,65,22,43,67
N'castle Jet,8386,2,16,5,7,58,37,21,53
Melbourne C,8386,3,14,4,11,43,34,9,46
Melbourne V,8386,4,13,5,11,45,39,6,44
Adelaide Utd,8386,5,11,6,11,37,40,-3,39
Brisbane,8386,6,10,5,13,33,42,-9,35
Western Sydn,8386,7,8,9,10,38,47,-9,33
Perth Glory,8386,8,10,2,15,37,50,-13,32
Wellington P,8386,9,5,6,16,31,55,-24,21
CC Mariners,8386,10,4,8,15,28,49,-21,20
Sydney FC,8387,1,21,4,3,66,23,43,67
N'castle Jet,8387,2,16,5,7,58,37,21,53
Melbourne C,8387,3,14,4,11,43,34,9,46
Melbourne V,8387,4,13,5,11,46,40,6,44
Adelaide Utd,8387,5,11,6,11,37,40,-3,39
Brisbane,8387,6,10,5,13,33,42,-9,35
Western Sydn,8387,7,8,9,10,38,47,-9,33
Perth Glory,8387,8,10,2,15,37,50,-13,32
Wellington P,8387,9,5,6,16,31,55,-24,21
CC Mariners,8387,10,4,8,15,28,49,-21,20
Sydney FC,8388,1,21,4,3,68,23,45,67
N'castle Jet,8388,2,15,5,8,58,39,19,50
Melbourne C,8388,3,15,4,10,45,34,11,49
Melbourne V,8388,4,13,5,11,46,42,4,44
Adelaide Utd,8388,5,11,6,11,37,40,-3,39
Brisbane,8388,6,10,5,13,33,42,-9,35
Western Sydn,8388,7,8,9,10,38,47,-9,33
Perth Glory,8388,8,10,2,15,37,50,-13,32
Wellington P,8388,9,5,6,16,31,55,-24,21
CC Mariners,8388,10,4,8,15,28,49,-21,20
Sydney FC,8389,1,21,4,3,66,22,44,67
N'castle Jet,8389,2,16,5,7,60,37,23,53
Melbourne C,8389,3,14,4,11,43,36,7,46
Melbourne V,8389,4,13,5,11,45,40,5,44
Adelaide Utd,8389,5,11,6,11,37,40,-3,39
Brisbane,8389,6,10,5,13,33,42,-9,35
Western Sydn,8389,7,8,9,10,38,47,-9,33
Perth Glory,8389,8,10,2,15,37,50,-13,32
Wellington P,8389,9,5,6,16,31,55,-24,21
CC Mariners,8389,10,4,8,15,28,49,-21,20
Sydney FC,8390,1,20,5,3,67,25,42,65
N'castle Jet,8390,2,15,5,8,60,41,19,50
Melbourne C,8390,3,15,4,10,47,36,11,49
Melbourne V,8390,4,13,6,10,48,41,7,45
Adelaide Utd,8390,5,11,6,11,37,40,-3,39
Brisbane,8390,6,10,5,13,33,42,-9,35
Western Sydn,8390,7,8,9,10,38,47,-9,33
Perth Glory,8390,8,10,2,15,37,50,-13,32
Wellington P,8390,9,5,6,16,31,55,-24,21
CC Mariners,8390,10,4,8,15,28,49,-21,20
Sydney FC,8391,1,20,5,3,67,25,42,65
N'castle Jet,8391,2,15,6,7,59,39,20,51
Melbourne C,8391,3,14,5,10,45,35,10,47
Melbourne V,8391,4,13,6,10,48,41,7,45
Adelaide Utd,8391,5,11,6,11,37,40,-3,39
Brisbane,8391,6,10,5,13,33,42,-9,35
Western Sydn,8391,7,8,9,10,38,47,-9,33
Perth Glory,8391,8,10,2,15,37,50,-13,32
Wellington P,8391,9,5,6,16,31,55,-24,21
CC Mariners,8391,10,4,8,15,28,49,-21,20
Sydney FC,8392,1,20,5,3,65,23,42,65
N'castle Jet,8392,2,15,6,7,59,39,20,51
Melbourne C,8392,3,14,5,10,45,35,10,47
Melbourne V,8392,4,13,6,10,46,39,7,45
Adelaide Utd,8392,5,11,6,11,37,40,-3,39
Brisbane,8392,6,10,5,13,33,42,-9,35
Western Sydn,8392,7,8,9,10,38,47,-9,33
Perth Glory,8392,8,10,2,15,37,50,-13,32
Wellington P,8392,9,5,6,16,31,55,-24,21
CC Mariners,8392,10,4,8,15,28,49,-21,20
Sydney FC,8393,1,21,4,3,67,22,45,67
N'castle Jet,8393,2,15,5,8,59,40,19,50
Melbourne C,8393,3,15,4,10,46,35,11,49
Melbourne V,8393,4,13,5,11,45,41,4,44
Adelaide Utd,8393,5,11,6,11,37,40,-3,39
Brisbane,8393,6,10,5,13,33,42,-9,35
Western Sydn,8393,7,8,9,10,38,47,-9,33
Perth Glory,8393,8,10,2,15,37,50,-13,32
Wellington P,8393,9,5,6,16,31,55,-24,21
CC Mariners,8393,10,4,8,15,28,49,-21,20
Sydney FC,8394,1,20,5,3,65,23,42,65
N'castle Jet,8394,2,16,5,7,59,37,22,53
Melbourne C,8394,3,14,4,11,43,35,8,46
Melbourne V,8394,4,13,6,10,46,39,7,45
Adelaide Utd,8394,5,11,6,11,37,40,-3,39
Brisbane,8394,6,10,5,13,33,42,-9,35
Western Sydn,8394,7,8,9,10,38,47,-9,33
Perth Glory,8394,8,10,2,15,37,50,-13,32
Wellington P,8394,9,5,6,16,31,55,-24,21
CC Mariners,8394,10,4,8,15,28,49,-21,20
Sydney FC,8395,1,21,4,3,68,23,45,67
N'castle Jet,8395,2,16,5,7,60,37,23,53
Melbourne C,8395,3,14,4,11,43,36,7,46
Melbourne V,8395,4,13,5,11,46,42,4,44
Adelaide Utd,8395,5,11,6,11,37,40,-3,39
Brisbane,8395,6,10,5,13,33,42,-9,35
Western Sydn,8395,7,8,9,10,38,47,-9,33
Perth Glory,8395,8,10,2,15,37,50,-13,32
Wellington P,8395,9,5,6,16,31,55,-24,21
CC Mariners,8395,10,4,8,15,28,49,-21,20
Sydney FC,8396,1,21,4,3,68,24,44,67
N'castle Jet,8396,2,15,5,8,57,39,18,50
Melbourne C,8396,3,15,4,10,45,33,12,49
Melbourne V,8396,4,13,5,11,47,42,5,44
Adelaide Utd,8396,5,11,6,11,37,40,-3,39
Brisbane,8396,6,10,5,13,33,42,-9,35
Western Sydn,8396,7,8,9,10,38,47,-9,33
Perth Glory,8396,8,10,2,15,37,50,-13,32
Wellington P,8396,9,5,6,16,31,55,-24,21
CC Mariners,8396,10,4,8,15,28,49,-21,20
Sydney FC,8397,1,20,5,3,66,24,42,65
N'castle Jet,8397,2,15,6,7,59,39,20,51
Melbourne C,8397,3,14,5,10,45,35,10,47
Melbourne V,8397,4,13,6,10,47,40,7,45
Adelaide Utd,8397,5,11,6,11,37,40,-3,39
Brisbane,8397,6,10,5,13,33,42,-9,35
Western Sydn,8397,7,8,9,10,38,47,-9,33
Perth Glory,8397,8,10,2,15,37,50,-13,32
Wellington P,8397,9,5,6,16,31,55,-24,21
CC Mariners,8397,10,4,8,15,28,49,-21,20
Sydney FC,8398,1,21,4,3,65,22,43,67
N'castle Jet,8398,2,16,5,7,60,37,23,53
Melbourne C,8398,3,14,4,11,43,36,7,46
Melbourne V,8398,4,13,5,11,45,39,6,44
Adelaide Utd,8398,5,11,6,11,37,40,-3,39
Brisbane,8398,6,10,5,13,33,42,-9,35
Western Sydn,8398,7,8,9,10,38,47,-9,33
Perth Glory,8398,8,10,2,15,37,50,-13,32
Wellington P,8398,9,5,6,16,31,55,-24,21
CC Mariners,8398,10,4,8,15,28,49,-21,20
Sydney FC,8399,1,21,4,3,66,22,44,67
N'castle Jet,8399,2,16,5,7,58,37,21,53
Melbourne C,8399,3,14,4,11,43,34,9,46
Melbourne V,8399,4,13,5,11,45,40,5,44
Adelaide Utd,8399,5,11,6,11,37,40,-3,39
Brisbane,8399,6,10,5,13,33,42,-9,35
Western Sydn,8399,7,8,9,10,38,47,-9,33
Perth Glory,8399,8,10,2,15,37,50,-13,32
Wellington P,8399,9,5,6,16,31,55,-24,21
CC Mariners,8399,10,4,8,15,28,49,-21,20
Sydney FC,8400,1,21,4,3,68,25,43,67
N'castle Jet,8400,2,15,6,7,58,38,20,51
Melbourne C,8400,3,14,5,10,44,34,10,47
Melbourne V,8400,4,13,5,11,48,42,6,44
Adelaide Utd,8400,5,11,6,11,37,40,-3,39
Brisbane,8400,6,10,5,13,33,42,-9,35
Western Sydn,8400,7,8,9,10,38,47,-9,33
Perth Glory,8400,8,10,2,15,37,50,-13,32
Wellington P,8400,9,5,6,16,31,55,-24,21
CC Mariners,8400,10,4,8,15,28,49,-21,20
Sydney FC,8401,1,20,5,3,67,25,42,65
N'castle Jet,8401,2,15,6,7,58,38,20,51
Melbourne C,8401,3,14,5,10,44,34,10,47
Melbourne V,8401,4,13,6,10,48,41,7,45
Adelaide Utd,8401,5,11,6,11,37,40,-3,39
Brisbane,8401,6,10,5,13,33,42,-9,35
Western Sydn,8401,7,8,9,10,38,47,-9,33
Perth Glory,8401,8,10,2,15,37,50,-13,32
Wellington P,8401,9,5,6,16,31,55,-24,21
CC Mariners,8401,10,4,8,15,28,49,-21,20
Sydney FC,8402,1,21,4,3,68,23,45,67
N'castle Jet,8402,2,16,5,7,59,37,22,53
Melbourne C,8402,3,14,4,11,43,35,8,46
Melbourne V,8402,4,13,5,11,46,42,4,44
Adelaide Utd,8402,5,11,6,11,37,40,-3,39
Brisbane,8402,6,10,5,13,33,42,-9,35
Western Sydn,8402,7,8,9,10,38,47,-9,33
Perth Glory,8402,8,10,2,15,37,50,-13,32
Wellington P,8402,9,5,6,16,31,55,-24,21
CC Mariners,8402,10,4,8,15,28,49,-21,20
Sydney FC,8403,1,21,4,3,66,23,43,67
N'castle Jet,8403,2,15,6,7,58,38,20,51
Melbourne C,8403,3,14,5,10,44,34,10,47
Melbourne V,8403,4,13,5,11,46,40,6,44
Adelaide Utd,8403,5,11,6,11,37,40,-3,39
Brisbane,8403,6,10,5,13,33,42,-9,35
Western Sydn,8403,7,8,9,10,38,47,-9,33
Perth Glory,8403,8,10,2,15,37,50,-13,32
Wellington P,8403,9,5,6,16,31,55,-24,21
CC Mariners,8403,10,4,8,15,28,49,-21,20
Sydney FC,8404,1,20,4,4,64,23,41,64
N'castle Jet,8404,2,16,5,7,60,38,22,53
Melbourne V,8404,3,14,5,10,46,38,8,47
Melbourne C,8404,4,14,4,11,44,36,8,46
Adelaide Utd,8404,5,11,6,11,37,40,-3,39
Brisbane,8404,6,10,5,13,33,42,-9,35
Western Sydn,8404,7,8,9,10,38,47,-9,33
Perth Glory,8404,8,10,2,15,37,50,-13,32
Wellington P,8404,9,5,6,16,31,55,-24,21
CC Mariners,8404,10,4,8,15,28,49,-21,20
Sydney FC,8405,1,21,4,3,67,22,45,67
N'castle Jet,8405,2,16,5,7,61,40,21,53
Melbourne C,8405,3,14,4,11,46,37,9,46
Melbourne V,8405,4,13,5,11,45,41,4,44
Adelaide Utd,8405,5,11,6,11,37,40,-3,39
Brisbane,8405,6,10,5,13,33,42,-9,35
Western Sydn,8405,7,8,9,10,38,47,-9,33
Perth Glory,8405,8,10,2,15,37,50,-13,32
Wellington P,8405,9,5,6,16,31,55,-24,21
CC Mariners,8405,10,4,8,15,28,49,-21,20
Sydney FC,8406,1,21,4,3,68,22,46,67
N'castle Jet,8406,2,16,5,7,59,37,22,53
Melbourne C,8406,3,14,4,11,43,35,8,46
Melbourne V,8406,4,13,5,11,45,42,3,44
Adelaide Utd,8406,5,11,6,11,37,40,-3,39
Brisbane,8406,6,10,5,13,33,42,-9,35
Western Sydn,8406,7,8,9,10,38,47,-9,33
Perth Glory,8406,8,10,2,15,37,50,-13,32
Wellington P,8406,9,5,6,16,31,55,-24,21
CC Mariners,8406,10,4,8,15,28,49,-21,20
Sydney FC,8407,1,20,5,3,65,23,42,65
N'castle Jet,8407,2,16,5,7,59,38,21,53
Melbourne C,8407,3,14,4,11,44,35,9,46
Melbourne V,8407,4,13,6,10,46,39,7,45
Adelaide Utd,8407,5,11,6,11,37,40,-3,39
Brisbane,8407,6,10,5,13,33,42,-9,35
Western Sydn,8407,7,8,9,10,38,47,-9,33
Perth Glory,8407,8,10,2,15,37,50,-13,32
Wellington P,8407,9,5,6,16,31,55,-24,21
CC Mariners,8407,10,4,8,15,28,49,-21,20
Sydney FC,8408,1,20,5,3,66,24,42,65
N'castle Jet,8408,2,15,5,8,59,41,18,50
Melbourne C,8408,3,15,4,10,47,35,12,49
Melbourne V,8408,4,13,6,10,47,40,7,45
Adelaide Utd,8408,5,11,6,11,37,40,-3,39
Brisbane,8408,6,10,5,13,33,42,-9,35
Western Sydn,8408,7,8,9,10,38,47,-9,33
Perth Glory,8408,8,10,2,15,37,50,-13,32
Wellington P,8408,9,5,6,16,31,55,-24,21
CC Mariners,8408,10,4,8,15,28,49,-21,20
Sydney FC,8409,1,20,5,3,66,24,42,65
N'castle Jet,8409,2,15,5,8,60,41,19,50
Melbourne C,8409,3,15,4,10,47,36,11,49
Melbourne V,8409,4,13,6,10,47,40,7,45
Adelaide Utd,8409,5,11,6,11,37,40,-3,39
Brisbane,8409,6,10,5,13,33,42,-9,35
Western Sydn,8409,7,8,9,10,38,47,-9,33
Perth Glory,8409,8,10,2,15,37,50,-13,32
Wellington P,8409,9,5,6,16,31,55,-24,21
CC Mariners,8409,10,4,8,15,28,49,-21,20
Sydney FC,8410,1,20,5,3,65,23,42,65
N'castle Jet,8410,2,15,6,7,58,38,20,51
Melbourne C,8410,3,14,5,10,44,34,10,47
Melbourne V,8410,4,13,6,10,46,39,7,45
Adelaide Utd,8410,5,11,6,11,37,40,-3,39
Brisbane,8410,6,10,5,13,33,42,-9,35
Western Sydn,8410,7,8,9,10,38,47,-9,33
Perth Glory,8410,8,10,2,15,37,50,-13,32
Wellington P,8410,9,5,6,16,31,55,-24,21
CC Mariners,8410,10,4,8,15,28,49,-21,20
Sydney FC,8411,1,20,5,3,66,24,42,65
N'castle Jet,8411,2,16,5,7,61,38,23,53
Melbourne C,8411,3,14,4,11,44,37,7,46
Melbourne V,8411,4,13,6,10,47,40,7,45
Adelaide Utd,8411,5,11,6,11,37,40,-3,39
Brisbane,8411,6,10,5,13,33,42,-9,35
Western Sydn,8411,7,8,9,10,38,47,-9,33
Perth Glory,8411,8,10,2,15,37,50,-13,32
Wellington P,8411,9,5,6,16,31,55,-24,21
CC Mariners,8411,10,4,8,15,28,49,-21,20
Sydney FC,8412,1,20,5,3,66,24,42,65
N'castle Jet,8412,2,16,5,7,59,37,22,53
Melbourne C,8412,3,14,4,11,43,35,8,46
Melbourne V,8412,4,13,6,10,47,40,7,45
Adelaide Utd,8412,5,11,6,11,37,40,-3,39
Brisbane,8412,6,10,5,13,33,42,-9,35
Western Sydn,8412,7,8,9,10,38,47,-9,33
Perth Glory,8412,8,10,2,15,37,50,-13,32
Wellington P,8412,9,5,6,16,31,55,-24,21
CC Mariners,8412,10,4,8,15,28,49,-21,20
Sydney FC,8413,1,20,4,4,64,23,41,64
N'castle Jet,8413,2,15,6,7,58,38,20,51
Melbourne C,8413,3,14,5,10,44,34,10,47
Melbourne V,8413,4,14,5,10,46,38,8,47
Adelaide Utd,8413,5,11,6,11,37,40,-3,39
Brisbane,8413,6,10,5,13,33,42,-9,35
Western Sydn,8413,7,8,9,10,38,47,-9,33
Perth Glory,8413,8,10,2,15,37,50,-13,32
Wellington P,8413,9,5,6,16,31,55,-24,21
CC Mariners,8413,10,4,8,15,28,49,-21,20
Sydney FC,8414,1,21,4,3,67,23,44,67
N'castle Jet,8414,2,15,5,8,58,39,19,50
Melbourne C,8414,3,15,4,10,45,34,11,49
Melbourne V,8414,4,13,5,11,46,41,5,44
Adelaide Utd,8414,5,11,6,11,37,40,-3,39
Brisbane,8414,6,10,5,13,33,42,-9,35
Western Sydn,8414,7,8,9,10,38,47,-9,33
Perth Glory,8414,8,10,2,15,37,50,-13,32
Wellington P,8414,9,5,6,16,31,55,-24,21
CC Mariners,8414,10,4,8,15,28,49,-21,20
Sydney FC,8415,1,21,4,3,66,23,43,67
N'castle Jet,8415,2,15,6,7,61,41,20,51
Melbourne C,8415,3,14,5,10,47,37,10,47
Melbourne V,8415,4,13,5,11,46,40,6,44
Adelaide Utd,8415,5,11,6,11,37,40,-3,39
Brisbane,8415,6,10,5,13,33,42,-9,35
Western Sydn,8415,7,8,9,10,38,47,-9,33
Perth Glory,8415,8,10,2,15,37,50,-13,32
Wellington P,8415,9,5,6,16,31,55,-24,21
CC Mariners,8415,10,4,8,15,28,49,-21,20
Sydney FC,8416,1,20,4,4,64,23,41,64
N'castle Jet,8416,2,15,5,8,57,40,17,50
Melbourne C,8416,3,15,4,10,46,33,13,49
Melbourne V,8416,4,14,5,10,46,38,8,47
Adelaide Utd,8416,5,11,6,11,37,40,-3,39
Brisbane,8416,6,10,5,13,33,42,-9,35
Western Sydn,8416,7,8,9,10,38,47,-9,33
Perth Glory,8416,8,10,2,15,37,50,-13,32
Wellington P,8416,9,5,6,16,31,55,-24,21
CC Mariners,8416,10,4,8,15,28,49,-21,20
Sydney FC,8417,1,20,5,3,65,23,42,65
N'castle Jet,8417,2,15,5,8,57,39,18,50
Melbourne C,8417,3,15,4,10,45,33,12,49
Melbourne V,8417,4,13,6,10,46,39,7,45
Adelaide Utd,8417,5,11,6,11,37,40,-3,39
Brisbane,8417,6,10,5,13,33,42,-9,35
Western Sydn,8417,7,8,9,10,38,47,-9,33
Perth Glory,8417,8,10,2,15,37,50,-13,32
Wellington P,8417,9,5,6,16,31,55,-24,21
CC Mariners,8417,10,4,8,15,28,49,-21,20
Sydney FC,8418,1,20,5,3,65,23,42,65
N'castle Jet,8418,2,16,5,7,60,38,22,53
Melbourne C,8418,3,14,4,11,44,36,8,46
Melbourne V,8418,4,13,6,10,46,39,7,45
Adelaide Utd,8418,5,11,6,11,37,40,-3,39
Brisbane,8418,6,10,5,13,33,42,-9,35
Western Sydn,8418,7,8,9,10,38,47,-9,33
Perth Glory,8418,8,10,2,15,37,50,-13,32
Wellington P,8418,9,5,6,16,31,55,-24,21
CC Mariners,8418,10,4,8,15,28,49,-21,20
Sydney FC,8419,1,20,5,3,64,22,42,65
N'castle Jet,8419,2,16,5,7,59,38,21,53
Melbourne C,8419,3,14,4,11,44,35,9,46
Melbourne V,8419,4,13,6,10,45,38,7,45
Adelaide Utd,8419,5,11,6,11,37,40,-3,39
Brisbane,8419,6,10,5,13,33,42,-9,35
Western Sydn,8419,7,8,9,10,38,47,-9,33
Perth Glory,8419,8,10,2,15,37,50,-13,32
Wellington P,8419,9,5,6,16,31,55,-24,21
CC Mariners,8419,10,4,8,15,28,49,-21,20
Sydney FC,8420,1,20,4,4,66,26,40,64
N'castle Jet,8420,2,15,6,7,58,38,20,51
Melbourne C,8420,3,14,5,10,44,34,10,47
Melbourne V,8420,4,14,5,10,49,40,9,47
Adelaide Utd,8420,5,11,6,11,37,40,-3,39
Brisbane,8420,6,10,5,13,33,42,-9,35
Western Sydn,8420,7,8,9,10,38,47,-9,33
Perth Glory,8420,8,10,2,15,37,50,-13,32
Wellington P,8420,9,5,6,16,31,55,-24,21
CC Mariners,8420,10,4,8,15,28,49,-21,20
Sydney FC,8421,1,20,5,3,65,23,42,65
N'castle Jet,8421,2,15,5,8,58,40,18,50
Melbourne C,8421,3,15,4,10,46,34,12,49
Melbourne V,8421,4,13,6,10,46,39,7,45
Adelaide Utd,8421,5,11,6,11,37,40,-3,39
Brisbane,8421,6,10,5,13,33,42,-9,35
Western Sydn,8421,7,8,9,10,38,47,-9,33
Perth Glory,8421,8,10,2,15,37,50,-13,32
Wellington P,8421,9,5,6,16,31,55,-24,21
CC Mariners,8421,10,4,8,15,28,49,-21,20
Sydney FC,8422,1,20,5,3,66,24,42,65
N'castle Jet,8422,2,16,5,7,59,38,21,53
Melbourne C,8422,3,14,4,11,44,35,9,46
Melbourne V,8422,4,13,6,10,47,40,7,45
Adelaide Utd,8422,5,11,6,11,37,40,-3,39
Brisbane,8422,6,10,5,13,33,42,-9,35
Western Sydn,8422,7,8,9,10,38,47,-9,33
Perth Glory,8422,8,10,2,15,37,50,-13,32
Wellington P,8422,9,5,6,16,31,55,-24,21
CC Mariners,8422,10,4,8,15,28,49,-21,20
Sydney FC,8423,1,21,4,3,69,24,45,67
N'castle Jet,8423,2,15,6,7,61,41,20,51
Melbourne C,8423,3,14,5,10,47,37,10,47
Melbourne V,8423,4,13,5,11,47,43,4,44
Adelaide Utd,8423,5,11,6,11,37,40,-3,39
Brisbane,8423,6,10,5,13,33,42,-9,35
Western Sydn,8423,7,8,9,10,38,47,-9,33
Perth Glory,8423,8,10,2,15,37,50,-13,32
Wellington P,8423,9,5,6,16,31,55,-24,21
CC Mariners,8423,10,4,8,15,28,49,-21,20
Sydney FC,8424,1,21,4,3,66,23,43,67
N'castle Jet,8424,2,16,5,7,60,38,22,53
Melbourne C,8424,3,14,4,11,44,36,8,46
Melbourne V,8424,4,13,5,11,46,40,6,44
Adelaide Utd,8424,5,11,6,11,37,40,-3,39
Brisbane,8424,6,10,5,13,33,42,-9,35
Western Sydn,8424,7,8,9,10,38,47,-9,33
Perth Glory,8424,8,10,2,15,37,50,-13,32
Wellington P,8424,9,5,6,16,31,55,-24,21
CC Mariners,8424,10,4,8,15,28,49,-21,20
Sydney FC,8425,1,21,4,3,66,22,44,67
N'castle Jet,8425,2,15,6,7,58,38,20,51
Melbourne C,8425,3,14,5,10,44,34,10,47
Melbourne V,8425,4,13,5,11,45,40,5,44
Adelaide Utd,8425,5,11,6,11,37,40,-3,39
Brisbane,8425,6,10,5,13,33,42,-9,35
Western Sydn,8425,7,8,9,10,38,47,-9,33
Perth Glory,8425,8,10,2,15,37,50,-13,32
Wellington P,8425,9,5,6,16,31,55,-24,21
CC Mariners,8425,10,4,8,15,28,49,-21,20
Sydney FC,8426,1,20,5,3,65,23,42,65
N'castle Jet,8426,2,15,6,7,58,38,20,51
Melbourne C,8426,3,14,5,10,44,34,10,47
Melbourne V,8426,4,13,6,10,46,39,7,45
Adelaide Utd,8426,5,11,6,11,37,40,-3,39
Brisbane,8426,6,10,5,13,33,42,-9,35
Western Sydn,8426,7,8,9,10,38,47,-9,33
Perth Glory,8426,8,10,2,15,37,50,-13,32
Wellington P,8426,9,5,6,16,31,55,-24,21
CC Mariners,8426,10,4,8,15,28,49,-21,20
Sydney FC,8427,1,21,4,3,68,23,45,67
N'castle Jet,8427,2,15,5,8,58,40,18,50
Melbourne C,8427,3,15,4,10,46,34,12,49
Melbourne V,8427,4,13,5,11,46,42,4,44
Adelaide Utd,8427,5,11,6,11,37,40,-3,39
Brisbane,8427,6,10,5,13,33,42,-9,35
Western Sydn,8427,7,8,9,10,38,47,-9,33
Perth Glory,8427,8,10,2,15,37,50,-13,32
Wellington P,8427,9,5,6,16,31,55,-24,21
CC Mariners,8427,10,4,8,15,28,49,-21,20
Sydney FC,8428,1,21,4,3,67,23,44,67
N'castle Jet,8428,2,15,5,8,58,40,18,50
Melbourne C,8428,3,15,4,10,46,34,12,49
Melbourne V,8428,4,13,5,11,46,41,5,44
Adelaide Utd,8428,5,11,6,11,37,40,-3,39
Brisbane,8428,6,10,5,13,33,42,-9,35
Western Sydn,8428,7,8,9,10,38,47,-9,33
Perth Glory,8428,8,10,2,15,37,50,-13,32
Wellington P,8428,9,5,6,16,31,55,-24,21
CC Mariners,8428,10,4,8,15,28,49,-21,20
Sydney FC,8429,1,20,5,3,64,22,42,65
N'castle Jet,8429,2,15,6,7,58,38,20,51
Melbourne C,8429,3,14,5,10,44,34,10,47
Melbourne V,8429,4,13,6,10,45,38,7,45
Adelaide Utd,8429,5,11,6,11,37,40,-3,39
Brisbane,8429,6,10,5,13,33,42,-9,35
Western Sydn,8429,7,8,9,10,38,47,-9,33
Perth Glory,8429,8,10,2,15,37,50,-13,32
Wellington P,8429,9,5,6,16,31,55,-24,21
CC Mariners,8429,10,4,8,15,28,49,-21,20
Sydney FC,8430,1,20,4,4,65,26,39,64
N'castle Jet,8430,2,15,6,7,59,39,20,51
Melbourne V,8430,3,14,5,10,49,39,10,47
Melbourne C,8430,4,14,5,10,45,35,10,47
Adelaide Utd,8430,5,11,6,11,37,40,-3,39
Brisbane,8430,6,10,5,13,33,42,-9,35
Western Sydn,8430,7,8,9,10,38,47,-9,33
Perth Glory,8430,8,10,2,15,37,50,-13,32
Wellington P,8430,9,5,6,16,31,55,-24,21
CC Mariners,8430,10,4,8,15,28,49,-21,20
Sydney FC,8431,1,20,5,3,66,24,42,65
N'castle Jet,8431,2,15,5,8,59,40,19,50
Melbourne C,8431,3,15,4,10,46,35,11,49
Melbourne V,8431,4,13,6,10,47,40,7,45
Adelaide Utd,8431,5,11,6,11,37,40,-3,39
Brisbane,8431,6,10,5,13,33,42,-9,35
Western Sydn,8431,7,8,9,10,38,47,-9,33
Perth Glory,8431,8,10,2,15,37,50,-13,32
Wellington P,8431,9,5,6,16,31,55,-24,21
CC Mariners,8431,10,4,8,15,28,49,-21,20
Sydney FC,8432,1,21,4,3,68,23,45,67
N'castle Jet,8432,2,15,6,7,57,37,20,51
Melbourne C,8432,3,14,5,10,43,33,10,47
Melbourne V,8432,4,13,5,11,46,42,4,44
Adelaide Utd,8432,5,11,6,11,37,40,-3,39
Brisbane,8432,6,10,5,13,33,42,-9,35
Western Sydn,8432,7,8,9,10,38,47,-9,33
Perth Glory,8432,8,10,2,15,37,50,-13,32
Wellington P,8432,9,5,6,16,31,55,-24,21
CC Mariners,8432,10,4,8,15,28,49,-21,20
Sydney FC,8433,1,21,4,3,67,23,44,67
N'castle Jet,8433,2,16,5,7,59,38,21,53
Melbourne C,8433,3,14,4,11,44,35,9,46
Melbourne V,8433,4,13,5,11,46,41,5,44
Adelaide Utd,8433,5,11,6,11,37,40,-3,39
Brisbane,8433,6,10,5,13,33,42,-9,35
Western Sydn,8433,7,8,9,10,38,47,-9,33
Perth Glory,8433,8,10,2,15,37,50,-13,32
Wellington P,8433,9,5,6,16,31,55,-24,21
CC Mariners,8433,10,4,8,15,28,49,-21,20
Sydney FC,8434,1,21,4,3,67,23,44,67
N'castle Jet,8434,2,15,6,7,59,39,20,51
Melbourne C,8434,3,14,5,10,45,35,10,47
Melbourne V,8434,4,13,5,11,46,41,5,44
Adelaide Utd,8434,5,11,6,11,37,40,-3,39
Brisbane,8434,6,10,5,13,33,42,-9,35
Western Sydn,8434,7,8,9,10,38,47,-9,33
Perth Glory,8434,8,10,2,15,37,50,-13,32
Wellington P,8434,9,5,6,16,31,55,-24,21
CC Mariners,8434,10,4,8,15,28,49,-21,20
Sydney FC,8435,1,21,4,3,66,23,43,67
N'castle Jet,8435,2,16,5,7,59,37,22,53
Melbourne C,8435,3,14,4,11,43,35,8,46
Melbourne V,8435,4,13,5,11,46,40,6,44
Adelaide Utd,8435,5,11,6,11,37,40,-3,39
Brisbane,8435,6,10,5,13,33,42,-9,35
Western Sydn,8435,7,8,9,10,38,47,-9,33
Perth Glory,8435,8,10,2,15,37,50,-13,32
Wellington P,8435,9,5,6,16,31,55,-24,21
CC Mariners,8435,10,4,8,15,28,49,-21,20
Sydney FC,8436,1,20,4,4,65,24,41,64
N'castle Jet,8436,2,16,5,7,60,38,22,53
Melbourne V,8436,3,14,5,10,47,39,8,47
Melbourne C,8436,4,14,4,11,44,36,8,46
Adelaide Utd,8436,5,11,6,11,37,40,-3,39
Brisbane,8436,6,10,5,13,33,42,-9,35
Western Sydn,8436,7,8,9,10,38,47,-9,33
Perth Glory,8436,8,10,2,15,37,50,-13,32
Wellington P,8436,9,5,6,16,31,55,-24,21
CC Mariners,8436,10,4,8,15,28,49,-21,20
Sydney FC,8437,1,20,4,4,64,23,41,64
N'castle Jet,8437,2,16,5,7,58,37,21,53
Melbourne V,8437,3,14,5,10,46,38,8,47
Melbourne C,8437,4,14,4,11,43,34,9,46
Adelaide Utd,8437,5,11,6,11,37,40,-3,39
Brisbane,8437,6,10,5,13,33,42,-9,35
Western Sydn,8437,7,8,9,10,38,47,-9,33
Perth Glory,8437,8,10,2,15,37,50,-13,32
Wellington P,8437,9,5,6,16,31,55,-24,21
CC Mariners,8437,10,4,8,15,28,49,-21,20
Sydney FC,8438,1,21,4,3,67,24,43,67
N'castle Jet,8438,2,16,5,7,59,38,21,53
Melbourne C,8438,3,14,4,11,44,35,9,46
Melbourne V,8438,4,13,5,11,47,41,6,44
Adelaide Utd,8438,5,11,6,11,37,40,-3,39
Brisbane,8438,6,10,5,13,33,42,-9,35
Western Sydn,8438,7,8,9,10,38,47,-9,33
Perth Glory,8438,8,10,2,15,37,50,-13,32
Wellington P,8438,9,5,6,16,31,55,-24,21
CC Mariners,8438,10,4,8,15,28,49,-21,20
Sydney FC,8439,1,20,5,3,65,23,42,65
N'castle Jet,8439,2,16,5,7,61,37,24,53
Melbourne C,8439,3,14,4,11,43,37,6,46
Melbourne V,8439,4,13,6,10,46,39,7,45
Adelaide Utd,8439,5,11,6,11,37,40,-3,39
Brisbane,8439,6,10,5,13,33,42,-9,35
Western Sydn,8439,7,8,9,10,38,47,-9,33
Perth Glory,8439,8,10,2,15,37,50,-13,32
Wellington P,8439,9,5,6,16,31,55,-24,21
CC Mariners,8439,10,4,8,15,28,49,-21,20
Sydney FC,8440,1,21,4,3,65,22,43,67
N'castle Jet,8440,2,15,5,8,57,41,16,50
Melbourne C,8440,3,15,4,10,47,33,14,49
Melbourne V,8440,4,13,5,11,45,39,6,44
Adelaide Utd,8440,5,11,6,11,37,40,-3,39
Brisbane,8440,6,10,5,13,33,42,-9,35
Western Sydn,8440,7,8,9,10,38,47,-9,33
Perth Glory,8440,8,10,2,15,37,50,-13,32
Wellington P,8440,9,5,6,16,31,55,-24,21
CC Mariners,8440,10,4,8,15,28,49,-21,20
Sydney FC,8441,1,21,4,3,66,22,44,67
N'castle Jet,8441,2,16,5,7,59,38,21,53
Melbourne C,8441,3,14,4,11,44,35,9,46
Melbourne V,8441,4,13,5,11,45,40,5,44
Adelaide Utd,8441,5,11,6,11,37,40,-3,39
Brisbane,8441,6,10,5,13,33,42,-9,35
Western Sydn,8441,7,8,9,10,38,47,-9,33
Perth Glory,8441,8,10,2,15,37,50,-13,32
Wellington P,8441,9,5,6,16,31,55,-24,21
CC Mariners,8441,10,4,8,15,28,49,-21,20
Sydney FC,8442,1,20,5,3,64,22,42,65
N'castle Jet,8442,2,15,5,8,57,38,19,50
Melbourne C,8442,3,15,4,10,44,33,11,49
Melbourne V,8442,4,13,6,10,45,38,7,45
Adelaide Utd,8442,5,11,6,11,37,40,-3,39
Brisbane,8442,6,10,5,13,33,42,-9,35
Western Sydn,8442,7,8,9,10,38,47,-9,33
Perth Glory,8442,8,10,2,15,37,50,-13,32
Wellington P,8442,9,5,6,16,31,55,-24,21
CC Mariners,8442,10,4,8,15,28,49,-21,20
Sydney FC,8443,1,21,4,3,67,22,45,67
N'castle Jet,8443,2,16,5,7,60,37,23,53
Melbourne C,8443,3,14,4,11,43,36,7,46
Melbourne V,8443,4,13,5,11,45,41,4,44
Adelaide Utd,8443,5,11,6,11,37,40,-3,39
Brisbane,8443,6,10,5,13,33,42,-9,35
Western Sydn,8443,7,8,9,10,38,47,-9,33
Perth Glory,8443,8,10,2,15,37,50,-13,32
Wellington P,8443,9,5,6,16,31,55,-24,21
CC Mariners,8443,10,4,8,15,28,49,-21,20
Sydney FC,8444,1,21,4,3,67,22,45,67
N'castle Jet,8444,2,16,5,7,62,38,24,53
Melbourne C,8444,3,14,4,11,44,38,6,46
Melbourne V,8444,4,13,5,11,45,41,4,44
Adelaide Utd,8444,5,11,6,11,37,40,-3,39
Brisbane,8444,6,10,5,13,33,42,-9,35
Western Sydn,8444,7,8,9,10,38,47,-9,33
Perth Glory,8444,8,10,2,15,37,50,-13,32
Wellington P,8444,9,5,6,16,31,55,-24,21
CC Mariners,8444,10,4,8,15,28,49,-21,20
Sydney FC,8445,1,20,5,3,66,24,42,65
N'castle Jet,8445,2,15,6,7,58,38,20,51
Melbourne C,8445,3,14,5,10,44,34,10,47
Melbourne V,8445,4,13,6,10,47,40,7,45
Adelaide Utd,8445,5,11,6,11,37,40,-3,39
Brisbane,8445,6,10,5,13,33,42,-9,35
Western Sydn,8445,7,8,9,10,38,47,-9,33
Perth Glory,8445,8,10,2,15,37,50,-13,32
Wellington P,8445,9,5,6,16,31,55,-24,21
CC Mariners,8445,10,4,8,15,28,49,-21,20
Sydney FC,8446,1,21,4,3,68,23,45,67
N'castle Jet,8446,2,15,5,8,57,38,19,50
Melbourne C,8446,3,15,4,10,44,33,11,49
Melbourne V,8446,4,13,5,11,46,42,4,44
Adelaide Utd,8446,5,11,6,11,37,40,-3,39
Brisbane,8446,6,10,5,13,33,42,-9,35
Western Sydn,8446,7,8,9,10,38,47,-9,33
Perth Glory,8446,8,10,2,15,37,50,-13,32
Wellington P,8446,9,5,6,16,31,55,-24,21
CC Mariners,8446,10,4,8,15,28,49,-21,20
Sydney FC,8447,1,20,5,3,64,22,42,65
N'castle Jet,8447,2,15,5,8,58,39,19,50
Melbourne C,8447,3,15,4,10,45,34,11,49
Melbourne V,8447,4,13,6,10,45,38,7,45
Adelaide Utd,8447,5,11,6,11,37,40,-3,39
Brisbane,8447,6,10,5,13,33,42,-9,35
Western Sydn,8447,7,8,9,10,38,47,-9,33
Perth Glory,8447,8,10,2,15,37,50,-13,32
Wellington P,8447,9,5,6,16,31,55,-24,21
CC Mariners,8447,10,4,8,15,28,49,-21,20
Sydney FC,8448,1,21,4,3,68,22,46,67
N'castle Jet,8448,2,15,6,7,58,38,20,51
Melbourne C,8448,3,14,5,10,44,34,10,47
Melbourne V,8448,4,13,5,11,45,42,3,44
Adelaide Utd,8448,5,11,6,11,37,40,-3,39
Brisbane,8448,6,10,5,13,33,42,-9,35
Western Sydn,8448,7,8,9,10,38,47,-9,33
Perth Glory,8448,8,10,2,15,37,50,-13,32
Wellington P,8448,9,5,6,16,31,55,-24,21
CC Mariners,8448,10,4,8,15,28,49,-21,20
Sydney FC,8449,1,21,4,3,66,22,44,67
N'castle Jet,8449,2,16,5,7,58,37,21,53
Melbourne C,8449,3,14,4,11,43,34,9,46
Melbourne V,8449,4,13,5,11,45,40,5,44
Adelaide Utd,8449,5,11,6,11,37,40,-3,39
Brisbane,8449,6,10,5,13,33,42,-9,35
Western Sydn,8449,7,8,9,10,38,47,-9,33
Perth Glory,8449,8,10,2,15,37,50,-13,32
Wellington P,8449,9,5,6,16,31,55,-24,21
CC Mariners,8449,10,4,8,15,28,49,-21,20
Sydney FC,8450,1,20,4,4,65,24,41,64
N'castle Jet,8450,2,16,5,7,58,37,21,53
Melbourne V,8450,3,14,5,10,47,39,8,47
Melbourne C,8450,4,14,4,11,43,34,9,46
Adelaide Utd,8450,5,11,6,11,37,40,-3,39
Brisbane,8450,6,10,5,13,33,42,-9,35
Western Sydn,8450,7,8,9,10,38,47,-9,33
Perth Glory,8450,8,10,2,15,37,50,-13,32
Wellington P,8450,9,5,6,16,31,55,-24,21
CC Mariners,8450,10,4,8,15,28,49,-21,20
Sydney FC,8451,1,20,5,3,65,23,42,65
N'castle Jet,8451,2,16,5,7,63,38,25,53
Melbourne C,8451,3,14,4,11,44,39,5,46
Melbourne V,8451,4,13,6,10,46,39,7,45
Adelaide Utd,8451,5,11,6,11,37,40,-3,39
Brisbane,8451,6,10,5,13,33,42,-9,35
Western Sydn,8451,7,8,9,10,38,47,-9,33
Perth Glory,8451,8,10,2,15,37,50,-13,32
Wellington P,8451,9,5,6,16,31,55,-24,21
CC Mariners,8451,10,4,8,15,28,49,-21,20
Sydney FC,8452,1,21,4,3,66,22,44,67
N'castle Jet,8452,2,16,5,7,60,38,22,53
Melbourne C,8452,3,14,4,11,44,36,8,46
Melbourne V,8452,4,13,5,11,45,40,5,44
Adelaide Utd,8452,5,11,6,11,37,40,-3,39
Brisbane,8452,6,10,5,13,33,42,-9,35
Western Sydn,8452,7,8,9,10,38,47,-9,33
Perth Glory,8452,8,10,2,15,37,50,-13,32
Wellington P,8452,9,5,6,16,31,55,-24,21
CC Mariners,8452,10,4,8,15,28,49,-21,20
Sydney FC,8453,1,20,5,3,66,24,42,65
N'castle Jet,8453,2,16,5,7,59,37,22,53
Melbourne C,8453,3,14,4,11,43,35,8,46
Melbourne V,8453,4,13,6,10,47,40,7,45
Adelaide Utd,8453,5,11,6,11,37,40,-3,39
Brisbane,8453,6,10,5,13,33,42,-9,35
Western Sydn,8453,7,8,9,10,38,47,-9,33
Perth Glory,8453,8,10,2,15,37,50,-13,32
Wellington P,8453,9,5,6,16,31,55,-24,21
CC Mariners,8453,10,4,8,15,28,49,-21,20
Sydney FC,8454,1,21,4,3,68,24,44,67
N'castle Jet,8454,2,15,6,7,57,37,20,51
Melbourne C,8454,3,14,5,10,43,33,10,47
Melbourne V,8454,4,13,5,11,47,42,5,44
Adelaide Utd,8454,5,11,6,11,37,40,-3,39
Brisbane,8454,6,10,5,13,33,42,-9,35
Western Sydn,8454,7,8,9,10,38,47,-9,33
Perth Glory,8454,8,10,2,15,37,50,-13,32
Wellington P,8454,9,5,6,16,31,55,-24,21
CC Mariners,8454,10,4,8,15,28,49,-21,20
Sydney FC,8455,1,20,5,3,64,22,42,65
N'castle Jet,8455,2,16,5,7,61,38,23,53
Melbourne C,8455,3,14,4,11,44,37,7,46
Melbourne V,8455,4,13,6,10,45,38,7,45
Adelaide Utd,8455,5,11,6,11,37,40,-3,39
Brisbane,8455,6,10,5,13,33,42,-9,35
Western Sydn,8455,7,8,9,10,38,47,-9,33
Perth Glory,8455,8,10,2,15,37,50,-13,32
Wellington P,8455,9,5,6,16,31,55,-24,21
CC Mariners,8455,10,4,8,15,28,49,-21,20
Sydney FC,8456,1,20,4,4,64,23,41,64
N'castle Jet,8456,2,16,5,7,60,37,23,53
Melbourne V,8456,3,14,5,10,46,38,8,47
Melbourne C,8456,4,14,4,11,43,36,7,46
Adelaide Utd,8456,5,11,6,11,37,40,-3,39
Brisbane,8456,6,10,5,13,33,42,-9,35
Western Sydn,8456,7,8,9,10,38,47,-9,33
Perth Glory,8456,8,10,2,15,37,50,-13,32
Wellington P,8456,9,5,6,16,31,55,-24,21
CC Mariners,8456,10,4,8,15,28,49,-21,20
Sydney FC,8457,1,21,4,3,67,24,43,67
N'castle Jet,8457,2,15,6,7,58,38,20,51
Melbourne C,8457,3,14,5,10,44,34,10,47
Melbourne V,8457,4,13,5,11,47,41,6,44
Adelaide Utd,8457,5,11,6,11,37,40,-3,39
Brisbane,8457,6,10,5,13,33,42,-9,35
Western Sydn,8457,7,8,9,10,38,47,-9,33
Perth Glory,8457,8,10,2,15,37,50,-13,32
Wellington P,8457,9,5,6,16,31,55,-24,21
CC Mariners,8457,10,4,8,15,28,49,-21,20
Sydney FC,8458,1,20,4,4,64,24,40,64
N'castle Jet,8458,2,16,5,7,59,37,22,53
Melbourne V,8458,3,14,5,10,47,38,9,47
Melbourne C,8458,4,14,4,11,43,35,8,46
Adelaide Utd,8458,5,11,6,11,37,40,-3,39
Brisbane,8458,6,10,5,13,33,42,-9,35
Western Sydn,8458,7,8,9,10,38,47,-9,33
Perth Glory,8458,8,10,2,15,37,50,-13,32
Wellington P,8458,9,5,6,16,31,55,-24,21
CC Mariners,8458,10,4,8,15,28,49,-21,20
Sydney FC,8459,1,20,4,4,65,24,41,64
N'castle Jet,8459,2,16,5,7,60,38,22,53
Melbourne V,8459,3,14,5,10,47,39,8,47
Melbourne C,8459,4,14,4,11,44,36,8,46
Adelaide Utd,8459,5,11,6,11,37,40,-3,39
Brisbane,8459,6,10,5,13,33,42,-9,35
Western Sydn,8459,7,8,9,10,38,47,-9,33
Perth Glory,8459,8,10,2,15,37,50,-13,32
Wellington P,8459,9,5,6,16,31,55,-24,21
CC Mariners,8459,10,4,8,15,28,49,-21,20
Sydney FC,8460,1,21,4,3,68,24,44,67
N'castle Jet,8460,2,16,5,7,61,38,23,53
Melbourne C,8460,3,14,4,11,44,37,7,46
Melbourne V,8460,4,13,5,11,47,42,5,44
Adelaide Utd,8460,5,11,6,11,37,40,-3,39
Brisbane,8460,6,10,5,13,33,42,-9,35
Western Sydn,8460,7,8,9,10,38,47,-9,33
Perth Glory,8460,8,10,2,15,37,50,-13,32
Wellington P,8460,9,5,6,16,31,55,-24,21
CC Mariners,8460,10,4,8,15,28,49,-21,20
Sydney FC,8461,1,21,4,3,67,23,44,67
N'castle Jet,8461,2,15,5,8,59,41,18,50
Melbourne C,8461,3,15,4,10,47,35,12,49
Melbourne V,8461,4,13,5,11,46,41,5,44
Adelaide Utd,8461,5,11,6,11,37,40,-3,39
Brisbane,8461,6,10,5,13,33,42,-9,35
Western Sydn,8461,7,8,9,10,38,47,-9,33
Perth Glory,8461,8,10,2,15,37,50,-13,32
Wellington P,8461,9,5,6,16,31,55,-24,21
CC Mariners,8461,10,4,8,15,28,49,-21,20
Sydney FC,8462,1,21,4,3,66,22,44,67
N'castle Jet,8462,2,16,5,7,59,38,21,53
Melbourne C,8462,3,14,4,11,44,35,9,46
Melbourne V,8462,4,13,5,11,45,40,5,44
Adelaide Utd,8462,5,11,6,11,37,40,-3,39
Brisbane,8462,6,10,5,13,33,42,-9,35
Western Sydn,8462,7,8,9,10,38,47,-9,33
Perth Glory,8462,8,10,2,15,37,50,-13,32
Wellington P,8462,9,5,6,16,31,55,-24,21
CC Mariners,8462,10,4,8,15,28,49,-21,20
Sydney FC,8463,1,21,4,3,66,22,44,67
N'castle Jet,8463,2,16,5,7,59,38,21,53
Melbourne C,8463,3,14,4,11,44,35,9,46
Melbourne V,8463,4,13,5,11,45,40,5,44
Adelaide Utd,8463,5,11,6,11,37,40,-3,39
Brisbane,8463,6,10,5,13,33,42,-9,35
Western Sydn,8463,7,8,9,10,38,47,-9,33
Perth Glory,8463,8,10,2,15,37,50,-13,32
Wellington P,8463,9,5,6,16,31,55,-24,21
CC Mariners,8463,10,4,8,15,28,49,-21,20
Sydney FC,8464,1,21,4,3,68,24,44,67
N'castle Jet,8464,2,16,5,7,59,37,22,53
Melbourne C,8464,3,14,4,11,43,35,8,46
Melbourne V,8464,4,13,5,11,47,42,5,44
Adelaide Utd,8464,5,11,6,11,37,40,-3,39
Brisbane,8464,6,10,5,13,33,42,-9,35
Western Sydn,8464,7,8,9,10,38,47,-9,33
Perth Glory,8464,8,10,2,15,37,50,-13,32
Wellington P,8464,9,5,6,16,31,55,-24,21
CC Mariners,8464,10,4,8,15,28,49,-21,20
Sydney FC,8465,1,20,5,3,64,22,42,65
N'castle Jet,8465,2,16,5,7,64,38,26,53
Melbourne C,8465,3,14,4,11,44,40,4,46
Melbourne V,8465,4,13,6,10,45,38,7,45
Adelaide Utd,8465,5,11,6,11,37,40,-3,39
Brisbane,8465,6,10,5,13,33,42,-9,35
Western Sydn,8465,7,8,9,10,38,47,-9,33
Perth Glory,8465,8,10,2,15,37,50,-13,32
Wellington P,8465,9,5,6,16,31,55,-24,21
CC Mariners,8465,10,4,8,15,28,49,-21,20
Sydney FC,8466,1,21,4,3,69,24,45,67
N'castle Jet,8466,2,16,5,7,60,39,21,53
Melbourne C,8466,3,14,4,11,45,36,9,46
Melbourne V,8466,4,13,5,11,47,43,4,44
Adelaide Utd,8466,5,11,6,11,37,40,-3,39
Brisbane,8466,6,10,5,13,33,42,-9,35
Western Sydn,8466,7,8,9,10,38,47,-9,33
Perth Glory,8466,8,10,2,15,37,50,-13,32
Wellington P,8466,9,5,6,16,31,55,-24,21
CC Mariners,8466,10,4,8,15,28,49,-21,20
Sydney FC,8467,1,21,4,3,67,23,44,67
N'castle Jet,8467,2,16,5,7,62,37,25,53
Melbourne C,8467,3,14,4,11,43,38,5,46
Melbourne V,8467,4,13,5,11,46,41,5,44
Adelaide Utd,8467,5,11,6,11,37,40,-3,39
Brisbane,8467,6,10,5,13,33,42,-9,35
Western Sydn,8467,7,8,9,10,38,47,-9,33
Perth Glory,8467,8,10,2,15,37,50,-13,32
Wellington P,8467,9,5,6,16,31,55,-24,21
CC Mariners,8467,10,4,8,15,28,49,-21,20
Sydney FC,8468,1,20,5,3,65,23,42,65
N'castle Jet,8468,2,15,6,7,57,37,20,51
Melbourne C,8468,3,14,5,10,43,33,10,47
Melbourne V,8468,4,13,6,10,46,39,7,45
Adelaide Utd,8468,5,11,6,11,37,40,-3,39
Brisbane,8468,6,10,5,13,33,42,-9,35
Western Sydn,8468,7,8,9,10,38,47,-9,33
Perth Glory,8468,8,10,2,15,37,50,-13,32
Wellington P,8468,9,5,6,16,31,55,-24,21
CC Mariners,8468,10,4,8,15,28,49,-21,20
Sydney FC,8469,1,21,4,3,65,22,43,67
N'castle Jet,8469,2,16,5,7,60,39,21,53
Melbourne C,8469,3,14,4,11,45,36,9,46
Melbourne V,8469,4,13,5,11,45,39,6,44
Adelaide Utd,8469,5,11,6,11,37,40,-3,39
Brisbane,8469,6,10,5,13,33,42,-9,35
Western Sydn,8469,7,8,9,10,38,47,-9,33
Perth Glory,8469,8,10,2,15,37,50,-13,32
Wellington P,8469,9,5,6,16,31,55,-24,21
CC Mariners,8469,10,4,8,15,28,49,-21,20
Sydney FC,8470,1,21,4,3,67,23,44,67
N'castle Jet,8470,2,15,6,7,60,40,20,51
Melbourne C,8470,3,14,5,10,46,36,10,47
Melbourne V,8470,4,13,5,11,46,41,5,44
Adelaide Utd,8470,5,11,6,11,37,40,-3,39
Brisbane,8470,6,10,5,13,33,42,-9,35
Western Sydn,8470,7,8,9,10,38,47,-9,33
Perth Glory,8470,8,10,2,15,37,50,-13,32
Wellington P,8470,9,5,6,16,31,55,-24,21
CC Mariners,8470,10,4,8,15,28,49,-21,20
Sydney FC,8471,1,21,4,3,67,23,44,67
N'castle Jet,8471,2,15,5,8,57,38,19,50
Melbourne C,8471,3,15,4,10,44,33,11,49
Melbourne V,8471,4,13,5,11,46,41,5,44
Adelaide Utd,8471,5,11,6,11,37,40,-3,39
Brisbane,8471,6,10,5,13,33,42,-9,35
Western Sydn,8471,7,8,9,10,38,47,-9,33
Perth Glory,8471,8,10,2,15,37,50,-13,32
Wellington P,8471,9,5,6,16,31,55,-24,21
CC Mariners,8471,10,4,8,15,28,49,-21,20
Sydney FC,8472,1,20,4,4,64,25,39,64
N'castle Jet,8472,2,15,6,7,58,38,20,51
Melbourne V,8472,3,14,5,10,48,38,10,47
Melbourne C,8472,4,14,5,10,44,34,10,47
Adelaide Utd,8472,5,11,6,11,37,40,-3,39
Brisbane,8472,6,10,5,13,33,42,-9,35
Western Sydn,8472,7,8,9,10,38,47,-9,33
Perth Glory,8472,8,10,2,15,37,50,-13,32
Wellington P,8472,9,5,6,16,31,55,-24,21
CC Mariners,8472,10,4,8,15,28,49,-21,20
Sydney FC,8473,1,21,4,3,66,22,44,67
N'castle Jet,8473,2,15,6,7,58,38,20,51
Melbourne C,8473,3,14,5,10,44,34,10,47
Melbourne V,8473,4,13,5,11,45,40,5,44
Adelaide Utd,8473,5,11,6,11,37,40,-3,39
Brisbane,8473,6,10,5,13,33,42,-9,35
Western Sydn,8473,7,8,9,10,38,47,-9,33
Perth Glory,8473,8,10,2,15,37,50,-13,32
Wellington P,8473,9,5,6,16,31,55,-24,21
CC Mariners,8473,10,4,8,15,28,49,-21,20
Sydney FC,8474,1,20,4,4,64,24,40,64
N'castle Jet,8474,2,15,5,8,57,38,19,50
Melbourne C,8474,3,15,4,10,44,33,11,49
Melbourne V,8474,4,14,5,10,47,38,9,47
Adelaide Utd,8474,5,11,6,11,37,40,-3,39
Brisbane,8474,6,10,5,13,33,42,-9,35
Western Sydn,8474,7,8,9,10,38,47,-9,33
Perth Glory,8474,8,10,2,15,37,50,-13,32
Wellington P,8474,9,5,6,16,31,55,-24,21
CC Mariners,8474,10,4,8,15,28,49,-21,20
Sydney FC,8475,1,21,4,3,66,22,44,67
N'castle Jet,8475,2,16,5,7,60,37,23,53
Melbourne C,8475,3,14,4,11,43,36,7,46
Melbourne V,8475,4,13,5,11,45,40,5,44
Adelaide Utd,8475,5,11,6,11,37,40,-3,39
Brisbane,8475,6,10,5,13,33,42,-9,35
Western Sydn,8475,7,8,9,10,38,47,-9,33
Perth Glory,8475,8,10,2,15,37,50,-13,32
Wellington P,8475,9,5,6,16,31,55,-24,21
CC Mariners,8475,10,4,8,15,28,49,-21,20
Sydney FC,8476,1,20,5,3,64,22,42,65
N'castle Jet,8476,2,15,5,8,57,40,17,50
Melbourne C,8476,3,15,4,10,46,33,13,49
Melbourne V,8476,4,13,6,10,45,38,7,45
Adelaide Utd,8476,5,11,6,11,37,40,-3,39
Brisbane,8476,6,10,5,13,33,42,-9,35
Western Sydn,8476,7,8,9,10,38,47,-9,33
Perth Glory,8476,8,10,2,15,37,50,-13,32
Wellington P,8476,9,5,6,16,31,55,-24,21
CC Mariners,8476,10,4,8,15,28,49,-21,20
Sydney FC,8477,1,21,4,3,65,22,43,67
N'castle Jet,8477,2,15,6,7,59,39,20,51
Melbourne C,8477,3,14,5,10,45,35,10,47
Melbourne V,8477,4,13,5,11,45,39,6,44
Adelaide Utd,8477,5,11,6,11,37,40,-3,39
Brisbane,8477,6,10,5,13,33,42,-9,35
Western Sydn,8477,7,8,9,10,38,47,-9,33
Perth Glory,8477,8,10,2,15,37,50,-13,32
Wellington P,8477,9,5,6,16,31,55,-24,21
CC Mariners,8477,10,4,8,15,28,49,-21,20
Sydney FC,8478,1,20,5,3,65,23,42,65
N'castle Jet,8478,2,16,5,7,60,37,23,53
Melbourne C,8478,3,14,4,11,43,36,7,46
Melbourne V,8478,4,13,6,10,46,39,7,45
Adelaide Utd,8478,5,11,6,11,37,40,-3,39
Brisbane,8478,6,10,5,13,33,42,-9,35
Western Sydn,8478,7,8,9,10,38,47,-9,33
Perth Glory,8478,8,10,2,15,37,50,-13,32
Wellington P,8478,9,5,6,16,31,55,-24,21
CC Mariners,8478,10,4,8,15,28,49,-21,20
Sydney FC,8479,1,20,5,3,66,24,42,65
N'castle Jet,8479,2,15,5,8,58,39,19,50
Melbourne C,8479,3,15,4,10,45,34,11,49
Melbourne V,8479,4,13,6,10,47,40,7,45
Adelaide Utd,8479,5,11,6,11,37,40,-3,39
Brisbane,8479,6,10,5,13,33,42,-9,35
Western Sydn,8479,7,8,9,10,38,47,-9,33
Perth Glory,8479,8,10,2,15,37,50,-13,32
Wellington P,8479,9,5,6,16,31,55,-24,21
CC Mariners,8479,10,4,8,15,28,49,-21,20
Sydney FC,8480,1,20,4,4,64,24,40,64
N'castle Jet,8480,2,15,6,7,58,38,20,51
Melbourne C,8480,3,14,5,10,44,34,10,47
Melbourne V,8480,4,14,5,10,47,38,9,47
Adelaide Utd,8480,5,11,6,11,37,40,-3,39
Brisbane,8480,6,10,5,13,33,42,-9,35
Western Sydn,8480,7,8,9,10,38,47,-9,33
Perth Glory,8480,8,10,2,15,37,50,-13,32
Wellington P,8480,9,5,6,16,31,55,-24,21
CC Mariners,8480,10,4,8,15,28,49,-21,20
Sydney FC,8481,1,20,4,4,64,23,41,64
N'castle Jet,8481,2,15,6,7,59,39,20,51
Melbourne C,8481,3,14,5,10,45,35,10,47
Melbourne V,8481,4,14,5,10,46,38,8,47
Adelaide Utd,8481,5,11,6,11,37,40,-3,39
Brisbane,8481,6,10,5,13,33,42,-9,35
Western Sydn,8481,7,8,9,10,38,47,-9,33
Perth Glory,8481,8,10,2,15,37,50,-13,32
Wellington P,8481,9,5,6,16,31,55,-24,21
CC Mariners,8481,10,4,8,15,28,49,-21,20
Sydney FC,8482,1,21,4,3,68,24,44,67
N'castle Jet,8482,2,15,5,8,57,39,18,50
Melbourne C,8482,3,15,4,10,45,33,12,49
Melbourne V,8482,4,13,5,11,47,42,5,44
Adelaide Utd,8482,5,11,6,11,37,40,-3,39
Brisbane,8482,6,10,5,13,33,42,-9,35
Western Sydn,8482,7,8,9,10,38,47,-9,33
Perth Glory,8482,8,10,2,15,37,50,-13,32
Wellington P,8482,9,5,6,16,31,55,-24,21
CC Mariners,8482,10,4,8,15,28,49,-21,20
Sydney FC,8483,1,21,4,3,66,23,43,67
N'castle Jet,8483,2,15,5,8,58,40,18,50
Melbourne C,8483,3,15,4,10,46,34,12,49
Melbourne V,8483,4,13,5,11,46,40,6,44
Adelaide Utd,8483,5,11,6,11,37,40,-3,39
Brisbane,8483,6,10,5,13,33,42,-9,35
Western Sydn,8483,7,8,9,10,38,47,-9,33
Perth Glory,8483,8,10,2,15,37,50,-13,32
Wellington P,8483,9,5,6,16,31,55,-24,21
CC Mariners,8483,10,4,8,15,28,49,-21,20
Sydney FC,8484,1,21,4,3,67,22,45,67
N'castle Jet,8484,2,16,5,7,60,38,22,53
Melbourne C,8484,3,14,4,11,44,36,8,46
Melbourne V,8484,4,13,5,11,45,41,4,44
Adelaide Utd,8484,5,11,6,11,37,40,-3,39
Brisbane,8484,6,10,5,13,33,42,-9,35
Western Sydn,8484,7,8,9,10,38,47,-9,33
Perth Glory,8484,8,10,2,15,37,50,-13,32
Wellington P,8484,9,5,6,16,31,55,-24,21
CC Mariners,8484,10,4,8,15,28,49,-21,20
Sydney FC,8485,1,21,4,3,67,22,45,67
N'castle Jet,8485,2,15,6,7,57,37,20,51
Melbourne C,8485,3,14,5,10,43,33,10,47
Melbourne V,8485,4,13,5,11,45,41,4,44
Adelaide Utd,8485,5,11,6,11,37,40,-3,39
Brisbane,8485,6,10,5,13,33,42,-9,35
Western Sydn,8485,7,8,9,10,38,47,-9,33
Perth Glory,8485,8,10,2,15,37,50,-13,32
Wellington P,8485,9,5,6,16,31,55,-24,21
CC Mariners,8485,10,4,8,15,28,49,-21,20
Sydney FC,8486,1,21,4,3,65,22,43,67
N'castle Jet,8486,2,16,5,7,59,38,21,53
Melbourne C,8486,3,14,4,11,44,35,9,46
Melbourne V,8486,4,13,5,11,45,39,6,44
Adelaide Utd,8486,5,11,6,11,37,40,-3,39
Brisbane,8486,6,10,5,13,33,42,-9,35
Western Sydn,8486,7,8,9,10,38,47,-9,33
Perth Glory,8486,8,10,2,15,37,50,-13,32
Wellington P,8486,9,5,6,16,31,55,-24,21
CC Mariners,8486,10,4,8,15,28,49,-21,20
Sydney FC,8487,1,21,4,3,66,22,44,67
N'castle Jet,8487,2,16,5,7,60,39,21,53
Melbourne C,8487,3,14,4,11,45,36,9,46
Melbourne V,8487,4,13,5,11,45,40,5,44
Adelaide Utd,8487,5,11,6,11,37,40,-3,39
Brisbane,8487,6,10,5,13,33,42,-9,35
Western Sydn,8487,7,8,9,10,38,47,-9,33
Perth Glory,8487,8,10,2,15,37,50,-13,32
Wellington P,8487,9,5,6,16,31,55,-24,21
CC Mariners,8487,10,4,8,15,28,49,-21,20
Sydney FC,8488,1,20,4,4,64,24,40,64
N'castle Jet,8488,2,16,5,7,59,37,22,53
Melbourne V,8488,3,14,5,10,47,38,9,47
Melbourne C,8488,4,14,4,11,43,35,8,46
Adelaide Utd,8488,5,11,6,11,37,40,-3,39
Brisbane,8488,6,10,5,13,33,42,-9,35
Western Sydn,8488,7,8,9,10,38,47,-9,33
Perth Glory,8488,8,10,2,15,37,50,-13,32
Wellington P,8488,9,5,6,16,31,55,-24,21
CC Mariners,8488,10,4,8,15,28,49,-21,20
Sydney FC,8489,1,21,4,3,66,23,43,67
N'castle Jet,8489,2,15,5,8,57,40,17,50
Melbourne C,8489,3,15,4,10,46,33,13,49
Melbourne V,8489,4,13,5,11,46,40,6,44
Adelaide Utd,8489,5,11,6,11,37,40,-3,39
Brisbane,8489,6,10,5,13,33,42,-9,35
Western Sydn,8489,7,8,9,10,38,47,-9,33
Perth Glory,8489,8,10,2,15,37,50,-13,32
Wellington P,8489,9,5,6,16,31,55,-24,21
CC Mariners,8489,10,4,8,15,28,49,-21,20
Sydney FC,8490,1,21,4,3,67,22,45,67
N'castle Jet,8490,2,15,6,7,58,38,20,51
Melbourne C,8490,3,14,5,10,44,34,10,47
Melbourne V,8490,4,13,5,11,45,41,4,44
Adelaide Utd,8490,5,11,6,11,37,40,-3,39
Brisbane,8490,6,10,5,13,33,42,-9,35
Western Sydn,8490,7,8,9,10,38,47,-9,33
Perth Glory,8490,8,10,2,15,37,50,-13,32
Wellington P,8490,9,5,6,16,31,55,-24,21
CC Mariners,8490,10,4,8,15,28,49,-21,20
Sydney FC,8491,1,21,4,3,66,22,44,67
N'castle Jet,8491,2,15,5,8,58,39,19,50
Melbourne C,8491,3,15,4,10,45,34,11,49
Melbourne V,8491,4,13,5,11,45,40,5,44
Adelaide Utd,8491,5,11,6,11,37,40,-3,39
Brisbane,8491,6,10,5,13,33,42,-9,35
Western Sydn,8491,7,8,9,10,38,47,-9,33
Perth Glory,8491,8,10,2,15,37,50,-13,32
Wellington P,8491,9,5,6,16,31,55,-24,21
CC Mariners,8491,10,4,8,15,28,49,-21,20
Sydney FC,8492,1,21,4,3,67,24,43,67
N'castle Jet,8492,2,16,5,7,59,38,21,53
Melbourne C,8492,3,14,4,11,44,35,9,46
Melbourne V,8492,4,13,5,11,47,41,6,44
Adelaide Utd,8492,5,11,6,11,37,40,-3,39
Brisbane,8492,6,10,5,13,33,42,-9,35
Western Sydn,8492,7,8,9,10,38,47,-9,33
Perth Glory,8492,8,10,2,15,37,50,-13,32
Wellington P,8492,9,5,6,16,31,55,-24,21
CC Mariners,8492,10,4,8,15,28,49,-21,20
Sydney FC,8493,1,20,4,4,64,24,40,64
N'castle Jet,8493,2,16,5,7,59,37,22,53
Melbourne V,8493,3,14,5,10,47,38,9,47
Melbourne C,8493,4,14,4,11,43,35,8,46
Adelaide Utd,8493,5,11,6,11,37,40,-3,39
Brisbane,8493,6,10,5,13,33,42,-9,35
Western Sydn,8493,7,8,9,10,38,47,-9,33
Perth Glory,8493,8,10,2,15,37,50,-13,32
Wellington P,8493,9,5,6,16,31,55,-24,21
CC Mariners,8493,10,4,8,15,28,49,-21,20
Sydney FC,8494,1,21,4,3,66,23,43,67
N'castle Jet,8494,2,16,5,7,60,38,22,53
Melbourne C,8494,3,14,4,11,44,36,8,46
Melbourne V,8494,4,13,5,11,46,40,6,44
Adelaide Utd,8494,5,11,6,11,37,40,-3,39
Brisbane,8494,6,10,5,13,33,42,-9,35
Western Sydn,8494,7,8,9,10,38,47,-9,33
Perth Glory,8494,8,10,2,15,37,50,-13,32
Wellington P,8494,9,5,6,16,31,55,-24,21
CC Mariners,8494,10,4,8,15,28,49,-21,20
Sydney FC,8495,1,20,4,4,64,24,40,64
N'castle Jet,8495,2,15,5,8,57,38,19,50
Melbourne C,8495,3,15,4,10,44,33,11,49
Melbourne V,8495,4,14,5,10,47,38,9,47
Adelaide Utd,8495,5,11,6,11,37,40,-3,39
Brisbane,8495,6,10,5,13,33,42,-9,35
Western Sydn,8495,7,8,9,10,38,47,-9,33
Perth Glory,8495,8,10,2,15,37,50,-13,32
Wellington P,8495,9,5,6,16,31,55,-24,21
CC Mariners,8495,10,4,8,15,28,49,-21,20
Sydney FC,8496,1,21,4,3,66,23,43,67
N'castle Jet,8496,2,15,6,7,58,38,20,51
Melbourne C,8496,3,14,5,10,44,34,10,47
Melbourne V,8496,4,13,5,11,46,40,6,44
Adelaide Utd,8496,5,11,6,11,37,40,-3,39
Brisbane,8496,6,10,5,13,33,42,-9,35
Western Sydn,8496,7,8,9,10,38,47,-9,33
Perth Glory,8496,8,10,2,15,37,50,-13,32
Wellington P,8496,9,5,6,16,31,55,-24,21
CC Mariners,8496,10,4,8,15,28,49,-21,20
Sydney FC,8497,1,20,4,4,64,23,41,64
N'castle Jet,8497,2,16,5,7,60,37,23,53
Melbourne V,8497,3,14,5,10,46,38,8,47
Melbourne C,8497,4,14,4,11,43,36,7,46
Adelaide Utd,8497,5,11,6,11,37,40,-3,39
Brisbane,8497,6,10,5,13,33,42,-9,35
Western Sydn,8497,7,8,9,10,38,47,-9,33
Perth Glory,8497,8,10,2,15,37,50,-13,32
Wellington P,8497,9,5,6,16,31,55,-24,21
CC Mariners,8497,10,4,8,15,28,49,-21,20
Sydney FC,8498,1,20,5,3,64,22,42,65
N'castle Jet,8498,2,16,5,7,58,37,21,53
Melbourne C,8498,3,14,4,11,43,34,9,46
Melbourne V,8498,4,13,6,10,45,38,7,45
Adelaide Utd,8498,5,11,6,11,37,40,-3,39
Brisbane,8498,6,10,5,13,33,42,-9,35
Western Sydn,8498,7,8,9,10,38,47,-9,33
Perth Glory,8498,8,10,2,15,37,50,-13,32
Wellington P,8498,9,5,6,16,31,55,-24,21
CC Mariners,8498,10,4,8,15,28,49,-21,20
Sydney FC,8499,1,21,4,3,65,22,43,67
N'castle Jet,8499,2,16,5,7,59,38,21,53
Melbourne C,8499,3,14,4,11,44,35,9,46
Melbourne V,8499,4,13,5,11,45,39,6,44
Adelaide Utd,8499,5,11,6,11,37,40,-3,39
Brisbane,8499,6,10,5,13,33,42,-9,35
Western Sydn,8499,7,8,9,10,38,47,-9,33
Perth Glory,8499,8,10,2,15,37,50,-13,32
Wellington P,8499,9,5,6,16,31,55,-24,21
CC Mariners,8499,10,4,8,15,28,49,-21,20
Sydney FC,8500,1,21,4,3,69,25,44,67
N'castle Jet,8500,2,16,5,7,58,37,21,53
Melbourne C,8500,3,14,4,11,43,34,9,46
Melbourne V,8500,4,13,5,11,48,43,5,44
Adelaide Utd,8500,5,11,6,11,37,40,-3,39
Brisbane,8500,6,10,5,13,33,42,-9,35
Western Sydn,8500,7,8,9,10,38,47,-9,33
Perth Glory,8500,8,10,2,15,37,50,-13,32
Wellington P,8500,9,5,6,16,31,55,-24,21
CC Mariners,8500,10,4,8,15,28,49,-21,20
Sydney FC,8501,1,21,4,3,68,22,46,67
N'castle Jet,8501,2,15,6,7,59,39,20,51
Melbourne C,8501,3,14,5,10,45,35,10,47
Melbourne V,8501,4,13,5,11,45,42,3,44
Adelaide Utd,8501,5,11,6,11,37,40,-3,39
Brisbane,8501,6,10,5,13,33,42,-9,35
Western Sydn,8501,7,8,9,10,38,47,-9,33
Perth Glory,8501,8,10,2,15,37,50,-13,32
Wellington P,8501,9,5,6,16,31,55,-24,21
CC Mariners,8501,10,4,8,15,28,49,-21,20
Sydney FC,8502,1,21,4,3,68,22,46,67
N'castle Jet,8502,2,15,6,7,58,38,20,51
Melbourne C,8502,3,14,5,10,44,34,10,47
Melbourne V,8502,4,13,5,11,45,42,3,44
Adelaide Utd,8502,5,11,6,11,37,40,-3,39
Brisbane,8502,6,10,5,13,33,42,-9,35
Western Sydn,8502,7,8,9,10,38,47,-9,33
Perth Glory,8502,8,10,2,15,37,50,-13,32
Wellington P,8502,9,5,6,16,31,55,-24,21
CC Mariners,8502,10,4,8,15,28,49,-21,20
Sydney FC,8503,1,20,5,3,64,22,42,65
N'castle Jet,8503,2,15,5,8,59,40,19,50
Melbourne C,8503,3,15,4,10,46,35,11,49
Melbourne V,8503,4,13,6,10,45,38,7,45
Adelaide Utd,8503,5,11,6,11,37,40,-3,39
Brisbane,8503,6,10,5,13,33,42,-9,35
Western Sydn,8503,7,8,9,10,38,47,-9,33
Perth Glory,8503,8,10,2,15,37,50,-13,32
Wellington P,8503,9,5,6,16,31,55,-24,21
CC Mariners,8503,10,4,8,15,28,49,-21,20
Sydney FC,8504,1,21,4,3,66,23,43,67
N'castle Jet,8504,2,16,5,7,61,39,22,53
Melbourne C,8504,3,14,4,11,45,37,8,46
Melbourne V,8504,4,13,5,11,46,40,6,44
Adelaide Utd,8504,5,11,6,11,37,40,-3,39
Brisbane,8504,6,10,5,13,33,42,-9,35
Western Sydn,8504,7,8,9,10,38,47,-9,33
Perth Glory,8504,8,10,2,15,37,50,-13,32
Wellington P,8504,9,5,6,16,31,55,-24,21
CC Mariners,8504,10,4,8,15,28,49,-21,20
Sydney FC,8505,1,20,4,4,65,25,40,64
N'castle Jet,8505,2,16,5,7,60,39,21,53
Melbourne V,8505,3,14,5,10,48,39,9,47
Melbourne C,8505,4,14,4,11,45,36,9,46
Adelaide Utd,8505,5,11,6,11,37,40,-3,39
Brisbane,8505,6,10,5,13,33,42,-9,35
Western Sydn,8505,7,8,9,10,38,47,-9,33
Perth Glory,8505,8,10,2,15,37,50,-13,32
Wellington P,8505,9,5,6,16,31,55,-24,21
CC Mariners,8505,10,4,8,15,28,49,-21,20
Sydney FC,8506,1,20,5,3,65,23,42,65
N'castle Jet,8506,2,15,6,7,58,38,20,51
Melbourne C,8506,3,14,5,10,44,34,10,47
Melbourne V,8506,4,13,6,10,46,39,7,45
Adelaide Utd,8506,5,11,6,11,37,40,-3,39
Brisbane,8506,6,10,5,13,33,42,-9,35
Western Sydn,8506,7,8,9,10,38,47,-9,33
Perth Glory,8506,8,10,2,15,37,50,-13,32
Wellington P,8506,9,5,6,16,31,55,-24,21
CC Mariners,8506,10,4,8,15,28,49,-21,20
Sydney FC,8507,1,21,4,3,66,23,43,67
N'castle Jet,8507,2,15,6,7,59,39,20,51
Melbourne C,8507,3,14,5,10,45,35,10,47
Melbourne V,8507,4,13,5,11,46,40,6,44
Adelaide Utd,8507,5,11,6,11,37,40,-3,39
Brisbane,8507,6,10,5,13,33,42,-9,35
Western Sydn,8507,7,8,9,10,38,47,-9,33
Perth Glory,8507,8,10,2,15,37,50,-13,32
Wellington P,8507,9,5,6,16,31,55,-24,21
CC Mariners,8507,10,4,8,15,28,49,-21,20
Sydney FC,8508,1,21,4,3,68,23,45,67
N'castle Jet,8508,2,16,5,7,58,37,21,53
Melbourne C,8508,3,14,4,11,43,34,9,46
Melbourne V,8508,4,13,5,11,46,42,4,44
Adelaide Utd,8508,5,11,6,11,37,40,-3,39
Brisbane,8508,6,10,5,13,33,42,-9,35
Western Sydn,8508,7,8,9,10,38,47,-9,33
Perth Glory,8508,8,10,2,15,37,50,-13,32
Wellington P,8508,9,5,6,16,31,55,-24,21
CC Mariners,8508,10,4,8,15,28,49,-21,20
Sydney FC,8509,1,21,4,3,68,23,45,67
N'castle Jet,8509,2,15,6,7,57,37,20,51
Melbourne C,8509,3,14,5,10,43,33,10,47
Melbourne V,8509,4,13,5,11,46,42,4,44
Adelaide Utd,8509,5,11,6,11,37,40,-3,39
Brisbane,8509,6,10,5,13,33,42,-9,35
Western Sydn,8509,7,8,9,10,38,47,-9,33
Perth Glory,8509,8,10,2,15,37,50,-13,32
Wellington P,8509,9,5,6,16,31,55,-24,21
CC Mariners,8509,10,4,8,15,28,49,-21,20
Sydney FC,8510,1,21,4,3,66,22,44,67
N'castle Jet,8510,2,16,5,7,60,39,21,53
Melbourne C,8510,3,14,4,11,45,36,9,46
Melbourne V,8510,4,13,5,11,45,40,5,44
Adelaide Utd,8510,5,11,6,11,37,40,-3,39
Brisbane,8510,6,10,5,13,33,42,-9,35
Western Sydn,8510,7,8,9,10,38,47,-9,33
Perth Glory,8510,8,10,2,15,37,50,-13,32
Wellington P,8510,9,5,6,16,31,55,-24,21
CC Mariners,8510,10,4,8,15,28,49,-21,20
Sydney FC,8511,1,21,4,3,65,22,43,67
N'castle Jet,8511,2,16,5,7,61,38,23,53
Melbourne C,8511,3,14,4,11,44,37,7,46
Melbourne V,8511,4,13,5,11,45,39,6,44
Adelaide Utd,8511,5,11,6,11,37,40,-3,39
Brisbane,8511,6,10,5,13,33,42,-9,35
Western Sydn,8511,7,8,9,10,38,47,-9,33
Perth Glory,8511,8,10,2,15,37,50,-13,32
Wellington P,8511,9,5,6,16,31,55,-24,21
CC Mariners,8511,10,4,8,15,28,49,-21,20
Sydney FC,8512,1,20,4,4,64,23,41,64
N'castle Jet,8512,2,16,5,7,58,37,21,53
Melbourne V,8512,3,14,5,10,46,38,8,47
Melbourne C,8512,4,14,4,11,43,34,9,46
Adelaide Utd,8512,5,11,6,11,37,40,-3,39
Brisbane,8512,6,10,5,13,33,42,-9,35
Western Sydn,8512,7,8,9,10,38,47,-9,33
Perth Glory,8512,8,10,2,15,37,50,-13,32
Wellington P,8512,9,5,6,16,31,55,-24,21
CC Mariners,8512,10,4,8,15,28,49,-21,20
Sydney FC,8513,1,20,5,3,65,23,42,65
N'castle Jet,8513,2,16,5,7,59,37,22,53
Melbourne C,8513,3,14,4,11,43,35,8,46
Melbourne V,8513,4,13,6,10,46,39,7,45
Adelaide Utd,8513,5,11,6,11,37,40,-3,39
Brisbane,8513,6,10,5,13,33,42,-9,35
Western Sydn,8513,7,8,9,10,38,47,-9,33
Perth Glory,8513,8,10,2,15,37,50,-13,32
Wellington P,8513,9,5,6,16,31,55,-24,21
CC Mariners,8513,10,4,8,15,28,49,-21,20
Sydney FC,8514,1,20,4,4,65,24,41,64
N'castle Jet,8514,2,16,5,7,60,37,23,53
Melbourne V,8514,3,14,5,10,47,39,8,47
Melbourne C,8514,4,14,4,11,43,36,7,46
Adelaide Utd,8514,5,11,6,11,37,40,-3,39
Brisbane,8514,6,10,5,13,33,42,-9,35
Western Sydn,8514,7,8,9,10,38,47,-9,33
Perth Glory,8514,8,10,2,15,37,50,-13,32
Wellington P,8514,9,5,6,16,31,55,-24,21
CC Mariners,8514,10,4,8,15,28,49,-21,20
Sydney FC,8515,1,21,4,3,68,24,44,67
N'castle Jet,8515,2,15,6,7,57,37,20,51
Melbourne C,8515,3,14,5,10,43,33,10,47
Melbourne V,8515,4,13,5,11,47,42,5,44
Adelaide Utd,8515,5,11,6,11,37,40,-3,39
Brisbane,8515,6,10,5,13,33,42,-9,35
Western Sydn,8515,7,8,9,10,38,47,-9,33
Perth Glory,8515,8,10,2,15,37,50,-13,32
Wellington P,8515,9,5,6,16,31,55,-24,21
CC Mariners,8515,10,4,8,15,28,49,-21,20
Sydney FC,8516,1,21,4,3,65,22,43,67
N'castle Jet,8516,2,16,5,7,59,37,22,53
Melbourne C,8516,3,14,4,11,43,35,8,46
Melbourne V,8516,4,13,5,11,45,39,6,44
Adelaide Utd,8516,5,11,6,11,37,40,-3,39
Brisbane,8516,6,10,5,13,33,42,-9,35
Western Sydn,8516,7,8,9,10,38,47,-9,33
Perth Glory,8516,8,10,2,15,37,50,-13,32
Wellington P,8516,9,5,6,16,31,55,-24,21
CC Mariners,8516,10,4,8,15,28,49,-21,20
Sydney FC,8517,1,21,4,3,66,23,43,67
N'castle Jet,8517,2,16,5,7,58,37,21,53
Melbourne C,8517,3,14,4,11,43,34,9,46
Melbourne V,8517,4,13,5,11,46,40,6,44
Adelaide Utd,8517,5,11,6,11,37,40,-3,39
Brisbane,8517,6,10,5,13,33,42,-9,35
Western Sydn,8517,7,8,9,10,38,47,-9,33
Perth Glory,8517,8,10,2,15,37,50,-13,32
Wellington P,8517,9,5,6,16,31,55,-24,21
CC Mariners,8517,10,4,8,15,28,49,-21,20
Sydney FC,8518,1,21,4,3,67,23,44,67
N'castle Jet,8518,2,15,6,7,59,39,20,51
Melbourne C,8518,3,14,5,10,45,35,10,47
Melbourne V,8518,4,13,5,11,46,41,5,44
Adelaide Utd,8518,5,11,6,11,37,40,-3,39
Brisbane,8518,6,10,5,13,33,42,-9,35
Western Sydn,8518,7,8,9,10,38,47,-9,33
Perth Glory,8518,8,10,2,15,37,50,-13,32
Wellington P,8518,9,5,6,16,31,55,-24,21
CC Mariners,8518,10,4,8,15,28,49,-21,20
Sydney FC,8519,1,21,4,3,67,23,44,67
N'castle Jet,8519,2,16,5,7,58,37,21,53
Melbourne C,8519,3,14,4,11,43,34,9,46
Melbourne V,8519,4,13,5,11,46,41,5,44
Adelaide Utd,8519,5,11,6,11,37,40,-3,39
Brisbane,8519,6,10,5,13,33,42,-9,35
Western Sydn,8519,7,8,9,10,38,47,-9,33
Perth Glory,8519,8,10,2,15,37,50,-13,32
Wellington P,8519,9,5,6,16,31,55,-24,21
CC Mariners,8519,10,4,8,15,28,49,-21,20
Sydney FC,8520,1,21,4,3,66,23,43,67
N'castle Jet,8520,2,15,5,8,58,39,19,50
Melbourne C,8520,3,15,4,10,45,34,11,49
Melbourne V,8520,4,13,5,11,46,40,6,44
Adelaide Utd,8520,5,11,6,11,37,40,-3,39
Brisbane,8520,6,10,5,13,33,42,-9,35
Western Sydn,8520,7,8,9,10,38,47,-9,33
Perth Glory,8520,8,10,2,15,37,50,-13,32
Wellington P,8520,9,5,6,16,31,55,-24,21
CC Mariners,8520,10,4,8,15,28,49,-21,20
Sydney FC,8521,1,20,4,4,65,25,40,64
N'castle Jet,8521,2,16,5,7,59,37,22,53
Melbourne V,8521,3,14,5,10,48,39,9,47
Melbourne C,8521,4,14,4,11,43,35,8,46
Adelaide Utd,8521,5,11,6,11,37,40,-3,39
Brisbane,8521,6,10,5,13,33,42,-9,35
Western Sydn,8521,7,8,9,10,38,47,-9,33
Perth Glory,8521,8,10,2,15,37,50,-13,32
Wellington P,8521,9,5,6,16,31,55,-24,21
CC Mariners,8521,10,4,8,15,28,49,-21,20
Sydney FC,8522,1,21,4,3,66,23,43,67
N'castle Jet,8522,2,16,5,7,60,37,23,53
Melbourne C,8522,3,14,4,11,43,36,7,46
Melbourne V,8522,4,13,5,11,46,40,6,44
Adelaide Utd,8522,5,11,6,11,37,40,-3,39
Brisbane,8522,6,10,5,13,33,42,-9,35
Western Sydn,8522,7,8,9,10,38,47,-9,33
Perth Glory,8522,8,10,2,15,37,50,-13,32
Wellington P,8522,9,5,6,16,31,55,-24,21
CC Mariners,8522,10,4,8,15,28,49,-21,20
Sydney FC,8523,1,21,4,3,66,22,44,67
N'castle Jet,8523,2,15,5,8,57,39,18,50
Melbourne C,8523,3,15,4,10,45,33,12,49
Melbourne V,8523,4,13,5,11,45,40,5,44
Adelaide Utd,8523,5,11,6,11,37,40,-3,39
Brisbane,8523,6,10,5,13,33,42,-9,35
Western Sydn,8523,7,8,9,10,38,47,-9,33
Perth Glory,8523,8,10,2,15,37,50,-13,32
Wellington P,8523,9,5,6,16,31,55,-24,21
CC Mariners,8523,10,4,8,15,28,49,-21,20
Sydney FC,8524,1,21,4,3,67,22,45,67
N'castle Jet,8524,2,15,5,8,59,40,19,50
Melbourne C,8524,3,15,4,10,46,35,11,49
Melbourne V,8524,4,13,5,11,45,41,4,44
Adelaide Utd,8524,5,11,6,11,37,40,-3,39
Brisbane,8524,6,10,5,13,33,42,-9,35
Western Sydn,8524,7,8,9,10,38,47,-9,33
Perth Glory,8524,8,10,2,15,37,50,-13,32
Wellington P,8524,9,5,6,16,31,55,-24,21
CC Mariners,8524,10,4,8,15,28,49,-21,20
Sydney FC,8525,1,20,4,4,64,23,41,64
N'castle Jet,8525,2,15,5,8,57,38,19,50
Melbourne C,8525,3,15,4,10,44,33,11,49
Melbourne V,8525,4,14,5,10,46,38,8,47
Adelaide Utd,8525,5,11,6,11,37,40,-3,39
Brisbane,8525,6,10,5,13,33,42,-9,35
Western Sydn,8525,7,8,9,10,38,47,-9,33
Perth Glory,8525,8,10,2,15,37,50,-13,32
Wellington P,8525,9,5,6,16,31,55,-24,21
CC Mariners,8525,10,4,8,15,28,49,-21,20
Sydney FC,8526,1,20,5,3,65,23,42,65
N'castle Jet,8526,2,15,6,7,59,39,20,51
Melbourne C,8526,3,14,5,10,45,35,10,47
Melbourne V,8526,4,13,6,10,46,39,7,45
Adelaide Utd,8526,5,11,6,11,37,40,-3,39
Brisbane,8526,6,10,5,13,33,42,-9,35
Western Sydn,8526,7,8,9,10,38,47,-9,33
Perth Glory,8526,8,10,2,15,37,50,-13,32
Wellington P,8526,9,5,6,16,31,55,-24,21
CC Mariners,8526,10,4,8,15,28,49,-21,20
Sydney FC,8527,1,21,4,3,67,22,45,67
N'castle Jet,8527,2,15,5,8,58,39,19,50
Melbourne C,8527,3,15,4,10,45,34,11,49
Melbourne V,8527,4,13,5,11,45,41,4,44
Adelaide Utd,8527,5,11,6,11,37,40,-3,39
Brisbane,8527,6,10,5,13,33,42,-9,35
Western Sydn,8527,7,8,9,10,38,47,-9,33
Perth Glory,8527,8,10,2,15,37,50,-13,32
Wellington P,8527,9,5,6,16,31,55,-24,21
CC Mariners,8527,10,4,8,15,28,49,-21,20
Sydney FC,8528,1,20,4,4,65,26,39,64
N'castle Jet,8528,2,15,6,7,58,38,20,51
Melbourne V,8528,3,14,5,10,49,39,10,47
Melbourne C,8528,4,14,5,10,44,34,10,47
Adelaide Utd,8528,5,11,6,11,37,40,-3,39
Brisbane,8528,6,10,5,13,33,42,-9,35
Western Sydn,8528,7,8,9,10,38,47,-9,33
Perth Glory,8528,8,10,2,15,37,50,-13,32
Wellington P,8528,9,5,6,16,31,55,-24,21
CC Mariners,8528,10,4,8,15,28,49,-21,20
Sydney FC,8529,1,21,4,3,68,22,46,67
N'castle Jet,8529,2,16,5,7,61,39,22,53
Melbourne C,8529,3,14,4,11,45,37,8,46
Melbourne V,8529,4,13,5,11,45,42,3,44
Adelaide Utd,8529,5,11,6,11,37,40,-3,39
Brisbane,8529,6,10,5,13,33,42,-9,35
Western Sydn,8529,7,8,9,10,38,47,-9,33
Perth Glory,8529,8,10,2,15,37,50,-13,32
Wellington P,8529,9,5,6,16,31,55,-24,21
CC Mariners,8529,10,4,8,15,28,49,-21,20
Sydney FC,8530,1,21,4,3,66,22,44,67
N'castle Jet,8530,2,16,5,7,61,37,24,53
Melbourne C,8530,3,14,4,11,43,37,6,46
Melbourne V,8530,4,13,5,11,45,40,5,44
Adelaide Utd,8530,5,11,6,11,37,40,-3,39
Brisbane,8530,6,10,5,13,33,42,-9,35
Western Sydn,8530,7,8,9,10,38,47,-9,33
Perth Glory,8530,8,10,2,15,37,50,-13,32
Wellington P,8530,9,5,6,16,31,55,-24,21
CC Mariners,8530,10,4,8,15,28,49,-21,20
Sydney FC,8531,1,21,4,3,67,24,43,67
N'castle Jet,8531,2,16,5,7,58,37,21,53
Melbourne C,8531,3,14,4,11,43,34,9,46
Melbourne V,8531,4,13,5,11,47,41,6,44
Adelaide Utd,8531,5,11,6,11,37,40,-3,39
Brisbane,8531,6,10,5,13,33,42,-9,35
Western Sydn,8531,7,8,9,10,38,47,-9,33
Perth Glory,8531,8,10,2,15,37,50,-13,32
Wellington P,8531,9,5,6,16,31,55,-24,21
CC Mariners,8531,10,4,8,15,28,49,-21,20
Sydney FC,8532,1,20,5,3,68,26,42,65
N'castle Jet,8532,2,16,5,7,61,38,23,53
Melbourne C,8532,3,14,4,11,44,37,7,46
Melbourne V,8532,4,13,6,10,49,42,7,45
Adelaide Utd,8532,5,11,6,11,37,40,-3,39
Brisbane,8532,6,10,5,13,33,42,-9,35
Western Sydn,8532,7,8,9,10,38,47,-9,33
Perth Glory,8532,8,10,2,15,37,50,-13,32
Wellington P,8532,9,5,6,16,31,55,-24,21
CC Mariners,8532,10,4,8,15,28,49,-21,20
Sydney FC,8533,1,21,4,3,71,23,48,67
N'castle Jet,8533,2,15,5,8,58,43,15,50
Melbourne C,8533,3,15,4,10,49,34,15,49
Melbourne V,8533,4,13,5,11,46,45,1,44
Adelaide Utd,8533,5,11,6,11,37,40,-3,39
Brisbane,8533,6,10,5,13,33,42,-9,35
Western Sydn,8533,7,8,9,10,38,47,-9,33
Perth Glory,8533,8,10,2,15,37,50,-13,32
Wellington P,8533,9,5,6,16,31,55,-24,21
CC Mariners,8533,10,4,8,15,28,49,-21,20
Sydney FC,8534,1,20,4,4,65,26,39,64
N'castle Jet,8534,2,16,5,7,60,38,22,53
Melbourne V,8534,3,14,5,10,49,39,10,47
Melbourne C,8534,4,14,4,11,44,36,8,46
Adelaide Utd,8534,5,11,6,11,37,40,-3,39
Brisbane,8534,6,10,5,13,33,42,-9,35
Western Sydn,8534,7,8,9,10,38,47,-9,33
Perth Glory,8534,8,10,2,15,37,50,-13,32
Wellington P,8534,9,5,6,16,31,55,-24,21
CC Mariners,8534,10,4,8,15,28,49,-21,20
Sydney FC,8535,1,21,4,3,66,22,44,67
N'castle Jet,8535,2,16,5,7,61,38,23,53
Melbourne C,8535,3,14,4,11,44,37,7,46
Melbourne V,8535,4,13,5,11,45,40,5,44
Adelaide Utd,8535,5,11,6,11,37,40,-3,39
Brisbane,8535,6,10,5,13,33,42,-9,35
Western Sydn,8535,7,8,9,10,38,47,-9,33
Perth Glory,8535,8,10,2,15,37,50,-13,32
Wellington P,8535,9,5,6,16,31,55,-24,21
CC Mariners,8535,10,4,8,15,28,49,-21,20
Sydney FC,8536,1,21,4,3,68,23,45,67
N'castle Jet,8536,2,15,6,7,58,38,20,51
Melbourne C,8536,3,14,5,10,44,34,10,47
Melbourne V,8536,4,13,5,11,46,42,4,44
Adelaide Utd,8536,5,11,6,11,37,40,-3,39
Brisbane,8536,6,10,5,13,33,42,-9,35
Western Sydn,8536,7,8,9,10,38,47,-9,33
Perth Glory,8536,8,10,2,15,37,50,-13,32
Wellington P,8536,9,5,6,16,31,55,-24,21
CC Mariners,8536,10,4,8,15,28,49,-21,20
Sydney FC,8537,1,21,4,3,67,22,45,67
N'castle Jet,8537,2,15,5,8,58,39,19,50
Melbourne C,8537,3,15,4,10,45,34,11,49
Melbourne V,8537,4,13,5,11,45,41,4,44
Adelaide Utd,8537,5,11,6,11,37,40,-3,39
Brisbane,8537,6,10,5,13,33,42,-9,35
Western Sydn,8537,7,8,9,10,38,47,-9,33
Perth Glory,8537,8,10,2,15,37,50,-13,32
Wellington P,8537,9,5,6,16,31,55,-24,21
CC Mariners,8537,10,4,8,15,28,49,-21,20
Sydney FC,8538,1,21,4,3,66,22,44,67
N'castle Jet,8538,2,15,5,8,58,40,18,50
Melbourne C,8538,3,15,4,10,46,34,12,49
Melbourne V,8538,4,13,5,11,45,40,5,44
Adelaide Utd,8538,5,11,6,11,37,40,-3,39
Brisbane,8538,6,10,5,13,33,42,-9,35
Western Sydn,8538,7,8,9,10,38,47,-9,33
Perth Glory,8538,8,10,2,15,37,50,-13,32
Wellington P,8538,9,5,6,16,31,55,-24,21
CC Mariners,8538,10,4,8,15,28,49,-21,20
Sydney FC,8539,1,20,5,3,65,23,42,65
N'castle Jet,8539,2,16,5,7,58,37,21,53
Melbourne C,8539,3,14,4,11,43,34,9,46
Melbourne V,8539,4,13,6,10,46,39,7,45
Adelaide Utd,8539,5,11,6,11,37,40,-3,39
Brisbane,8539,6,10,5,13,33,42,-9,35
Western Sydn,8539,7,8,9,10,38,47,-9,33
Perth Glory,8539,8,10,2,15,37,50,-13,32
Wellington P,8539,9,5,6,16,31,55,-24,21
CC Mariners,8539,10,4,8,15,28,49,-21,20
Sydney FC,8540,1,21,4,3,68,23,45,67
N'castle Jet,8540,2,16,5,7,59,38,21,53
Melbourne C,8540,3,14,4,11,44,35,9,46
Melbourne V,8540,4,13,5,11,46,42,4,44
Adelaide Utd,8540,5,11,6,11,37,40,-3,39
Brisbane,8540,6,10,5,13,33,42,-9,35
Western Sydn,8540,7,8,9,10,38,47,-9,33
Perth Glory,8540,8,10,2,15,37,50,-13,32
Wellington P,8540,9,5,6,16,31,55,-24,21
CC Mariners,8540,10,4,8,15,28,49,-21,20
Sydney FC,8541,1,21,4,3,65,22,43,67
N'castle Jet,8541,2,15,5,8,58,39,19,50
Melbourne C,8541,3,15,4,10,45,34,11,49
Melbourne V,8541,4,13,5,11,45,39,6,44
Adelaide Utd,8541,5,11,6,11,37,40,-3,39
Brisbane,8541,6,10,5,13,33,42,-9,35
Western Sydn,8541,7,8,9,10,38,47,-9,33
Perth Glory,8541,8,10,2,15,37,50,-13,32
Wellington P,8541,9,5,6,16,31,55,-24,21
CC Mariners,8541,10,4,8,15,28,49,-21,20
Sydney FC,8542,1,21,4,3,67,24,43,67
N'castle Jet,8542,2,15,6,7,59,39,20,51
Melbourne C,8542,3,14,5,10,45,35,10,47
Melbourne V,8542,4,13,5,11,47,41,6,44
Adelaide Utd,8542,5,11,6,11,37,40,-3,39
Brisbane,8542,6,10,5,13,33,42,-9,35
Western Sydn,8542,7,8,9,10,38,47,-9,33
Perth Glory,8542,8,10,2,15,37,50,-13,32
Wellington P,8542,9,5,6,16,31,55,-24,21
CC Mariners,8542,10,4,8,15,28,49,-21,20
Sydney FC,8543,1,21,4,3,68,22,46,67
N'castle Jet,8543,2,15,5,8,58,40,18,50
Melbourne C,8543,3,15,4,10,46,34,12,49
Melbourne V,8543,4,13,5,11,45,42,3,44
Adelaide Utd,8543,5,11,6,11,37,40,-3,39
Brisbane,8543,6,10,5,13,33,42,-9,35
Western Sydn,8543,7,8,9,10,38,47,-9,33
Perth Glory,8543,8,10,2,15,37,50,-13,32
Wellington P,8543,9,5,6,16,31,55,-24,21
CC Mariners,8543,10,4,8,15,28,49,-21,20
Sydney FC,8544,1,21,4,3,66,22,44,67
N'castle Jet,8544,2,16,5,7,59,38,21,53
Melbourne C,8544,3,14,4,11,44,35,9,46
Melbourne V,8544,4,13,5,11,45,40,5,44
Adelaide Utd,8544,5,11,6,11,37,40,-3,39
Brisbane,8544,6,10,5,13,33,42,-9,35
Western Sydn,8544,7,8,9,10,38,47,-9,33
Perth Glory,8544,8,10,2,15,37,50,-13,32
Wellington P,8544,9,5,6,16,31,55,-24,21
CC Mariners,8544,10,4,8,15,28,49,-21,20
Sydney FC,8545,1,21,4,3,65,22,43,67
N'castle Jet,8545,2,16,5,7,60,37,23,53
Melbourne C,8545,3,14,4,11,43,36,7,46
Melbourne V,8545,4,13,5,11,45,39,6,44
Adelaide Utd,8545,5,11,6,11,37,40,-3,39
Brisbane,8545,6,10,5,13,33,42,-9,35
Western Sydn,8545,7,8,9,10,38,47,-9,33
Perth Glory,8545,8,10,2,15,37,50,-13,32
Wellington P,8545,9,5,6,16,31,55,-24,21
CC Mariners,8545,10,4,8,15,28,49,-21,20
Sydney FC,8546,1,21,4,3,69,24,45,67
N'castle Jet,8546,2,16,5,7,59,38,21,53
Melbourne C,8546,3,14,4,11,44,35,9,46
Melbourne V,8546,4,13,5,11,47,43,4,44
Adelaide Utd,8546,5,11,6,11,37,40,-3,39
Brisbane,8546,6,10,5,13,33,42,-9,35
Western Sydn,8546,7,8,9,10,38,47,-9,33
Perth Glory,8546,8,10,2,15,37,50,-13,32
Wellington P,8546,9,5,6,16,31,55,-24,21
CC Mariners,8546,10,4,8,15,28,49,-21,20
Sydney FC,8547,1,21,4,3,68,22,46,67
N'castle Jet,8547,2,16,5,7,62,37,25,53
Melbourne C,8547,3,14,4,11,43,38,5,46
Melbourne V,8547,4,13,5,11,45,42,3,44
Adelaide Utd,8547,5,11,6,11,37,40,-3,39
Brisbane,8547,6,10,5,13,33,42,-9,35
Western Sydn,8547,7,8,9,10,38,47,-9,33
Perth Glory,8547,8,10,2,15,37,50,-13,32
Wellington P,8547,9,5,6,16,31,55,-24,21
CC Mariners,8547,10,4,8,15,28,49,-21,20
Sydney FC,8548,1,20,4,4,64,24,40,64
N'castle Jet,8548,2,16,5,7,61,39,22,53
Melbourne V,8548,3,14,5,10,47,38,9,47
Melbourne C,8548,4,14,4,11,45,37,8,46
Adelaide Utd,8548,5,11,6,11,37,40,-3,39
Brisbane,8548,6,10,5,13,33,42,-9,35
Western Sydn,8548,7,8,9,10,38,47,-9,33
Perth Glory,8548,8,10,2,15,37,50,-13,32
Wellington P,8548,9,5,6,16,31,55,-24,21
CC Mariners,8548,10,4,8,15,28,49,-21,20
Sydney FC,8549,1,21,4,3,67,24,43,67
N'castle Jet,8549,2,15,5,8,58,39,19,50
Melbourne C,8549,3,15,4,10,45,34,11,49
Melbourne V,8549,4,13,5,11,47,41,6,44
Adelaide Utd,8549,5,11,6,11,37,40,-3,39
Brisbane,8549,6,10,5,13,33,42,-9,35
Western Sydn,8549,7,8,9,10,38,47,-9,33
Perth Glory,8549,8,10,2,15,37,50,-13,32
Wellington P,8549,9,5,6,16,31,55,-24,21
CC Mariners,8549,10,4,8,15,28,49,-21,20
Sydney FC,8550,1,21,4,3,67,22,45,67
N'castle Jet,8550,2,15,5,8,57,39,18,50
Melbourne C,8550,3,15,4,10,45,33,12,49
Melbourne V,8550,4,13,5,11,45,41,4,44
Adelaide Utd,8550,5,11,6,11,37,40,-3,39
Brisbane,8550,6,10,5,13,33,42,-9,35
Western Sydn,8550,7,8,9,10,38,47,-9,33
Perth Glory,8550,8,10,2,15,37,50,-13,32
Wellington P,8550,9,5,6,16,31,55,-24,21
CC Mariners,8550,10,4,8,15,28,49,-21,20
Sydney FC,8551,1,21,4,3,71,23,48,67
N'castle Jet,8551,2,15,5,8,57,39,18,50
Melbourne C,8551,3,15,4,10,45,33,12,49
Melbourne V,8551,4,13,5,11,46,45,1,44
Adelaide Utd,8551,5,11,6,11,37,40,-3,39
Brisbane,8551,6,10,5,13,33,42,-9,35
Western Sydn,8551,7,8,9,10,38,47,-9,33
Perth Glory,8551,8,10,2,15,37,50,-13,32
Wellington P,8551,9,5,6,16,31,55,-24,21
CC Mariners,8551,10,4,8,15,28,49,-21,20
Sydney FC,8552,1,20,4,4,66,25,41,64
N'castle Jet,8552,2,15,6,7,57,37,20,51
Melbourne C,8552,3,14,5,10,43,33,10,47
Melbourne V,8552,4,14,5,10,48,40,8,47
Adelaide Utd,8552,5,11,6,11,37,40,-3,39
Brisbane,8552,6,10,5,13,33,42,-9,35
Western Sydn,8552,7,8,9,10,38,47,-9,33
Perth Glory,8552,8,10,2,15,37,50,-13,32
Wellington P,8552,9,5,6,16,31,55,-24,21
CC Mariners,8552,10,4,8,15,28,49,-21,20
Sydney FC,8553,1,21,4,3,67,23,44,67
N'castle Jet,8553,2,15,6,7,58,38,20,51
Melbourne C,8553,3,14,5,10,44,34,10,47
Melbourne V,8553,4,13,5,11,46,41,5,44
Adelaide Utd,8553,5,11,6,11,37,40,-3,39
Brisbane,8553,6,10,5,13,33,42,-9,35
Western Sydn,8553,7,8,9,10,38,47,-9,33
Perth Glory,8553,8,10,2,15,37,50,-13,32
Wellington P,8553,9,5,6,16,31,55,-24,21
CC Mariners,8553,10,4,8,15,28,49,-21,20
Sydney FC,8554,1,21,4,3,66,23,43,67
N'castle Jet,8554,2,15,6,7,57,37,20,51
Melbourne C,8554,3,14,5,10,43,33,10,47
Melbourne V,8554,4,13,5,11,46,40,6,44
Adelaide Utd,8554,5,11,6,11,37,40,-3,39
Brisbane,8554,6,10,5,13,33,42,-9,35
Western Sydn,8554,7,8,9,10,38,47,-9,33
Perth Glory,8554,8,10,2,15,37,50,-13,32
Wellington P,8554,9,5,6,16,31,55,-24,21
CC Mariners,8554,10,4,8,15,28,49,-21,20
Sydney FC,8555,1,21,4,3,66,22,44,67
N'castle Jet,8555,2,16,5,7,58,37,21,53
Melbourne C,8555,3,14,4,11,43,34,9,46
Melbourne V,8555,4,13,5,11,45,40,5,44
Adelaide Utd,8555,5,11,6,11,37,40,-3,39
Brisbane,8555,6,10,5,13,33,42,-9,35
Western Sydn,8555,7,8,9,10,38,47,-9,33
Perth Glory,8555,8,10,2,15,37,50,-13,32
Wellington P,8555,9,5,6,16,31,55,-24,21
CC Mariners,8555,10,4,8,15,28,49,-21,20
Sydney FC,8556,1,21,4,3,67,22,45,67
N'castle Jet,8556,2,16,5,7,62,39,23,53
Melbourne C,8556,3,14,4,11,45,38,7,46
Melbourne V,8556,4,13,5,11,45,41,4,44
Adelaide Utd,8556,5,11,6,11,37,40,-3,39
Brisbane,8556,6,10,5,13,33,42,-9,35
Western Sydn,8556,7,8,9,10,38,47,-9,33
Perth Glory,8556,8,10,2,15,37,50,-13,32
Wellington P,8556,9,5,6,16,31,55,-24,21
CC Mariners,8556,10,4,8,15,28,49,-21,20
Sydney FC,8557,1,21,4,3,65,22,43,67
N'castle Jet,8557,2,15,6,7,59,39,20,51
Melbourne C,8557,3,14,5,10,45,35,10,47
Melbourne V,8557,4,13,5,11,45,39,6,44
Adelaide Utd,8557,5,11,6,11,37,40,-3,39
Brisbane,8557,6,10,5,13,33,42,-9,35
Western Sydn,8557,7,8,9,10,38,47,-9,33
Perth Glory,8557,8,10,2,15,37,50,-13,32
Wellington P,8557,9,5,6,16,31,55,-24,21
CC Mariners,8557,10,4,8,15,28,49,-21,20
Sydney FC,8558,1,20,5,3,65,23,42,65
N'castle Jet,8558,2,15,5,8,57,39,18,50
Melbourne C,8558,3,15,4,10,45,33,12,49
Melbourne V,8558,4,13,6,10,46,39,7,45
Adelaide Utd,8558,5,11,6,11,37,40,-3,39
Brisbane,8558,6,10,5,13,33,42,-9,35
Western Sydn,8558,7,8,9,10,38,47,-9,33
Perth Glory,8558,8,10,2,15,37,50,-13,32
Wellington P,8558,9,5,6,16,31,55,-24,21
CC Mariners,8558,10,4,8,15,28,49,-21,20
Sydney FC,8559,1,20,5,3,64,22,42,65
N'castle Jet,8559,2,15,5,8,57,38,19,50
Melbourne C,8559,3,15,4,10,44,33,11,49
Melbourne V,8559,4,13,6,10,45,38,7,45
Adelaide Utd,8559,5,11,6,11,37,40,-3,39
Brisbane,8559,6,10,5,13,33,42,-9,35
Western Sydn,8559,7,8,9,10,38,47,-9,33
Perth Glory,8559,8,10,2,15,37,50,-13,32
Wellington P,8559,9,5,6,16,31,55,-24,21
CC Mariners,8559,10,4,8,15,28,49,-21,20
Sydney FC,8560,1,20,5,3,65,23,42,65
N'castle Jet,8560,2,15,6,7,58,38,20,51
Melbourne C,8560,3,14,5,10,44,34,10,47
Melbourne V,8560,4,13,6,10,46,39,7,45
Adelaide Utd,8560,5,11,6,11,37,40,-3,39
Brisbane,8560,6,10,5,13,33,42,-9,35
Western Sydn,8560,7,8,9,10,38,47,-9,33
Perth Glory,8560,8,10,2,15,37,50,-13,32
Wellington P,8560,9,5,6,16,31,55,-24,21
CC Mariners,8560,10,4,8,15,28,49,-21,20
Sydney FC,8561,1,20,4,4,65,24,41,64
N'castle Jet,8561,2,15,5,8,59,40,19,50
Melbourne C,8561,3,15,4,10,46,35,11,49
Melbourne V,8561,4,14,5,10,47,39,8,47
Adelaide Utd,8561,5,11,6,11,37,40,-3,39
Brisbane,8561,6,10,5,13,33,42,-9,35
Western Sydn,8561,7,8,9,10,38,47,-9,33
Perth Glory,8561,8,10,2,15,37,50,-13,32
Wellington P,8561,9,5,6,16,31,55,-24,21
CC Mariners,8561,10,4,8,15,28,49,-21,20
Sydney FC,8562,1,21,4,3,68,23,45,67
N'castle Jet,8562,2,16,5,7,61,37,24,53
Melbourne C,8562,3,14,4,11,43,37,6,46
Melbourne V,8562,4,13,5,11,46,42,4,44
Adelaide Utd,8562,5,11,6,11,37,40,-3,39
Brisbane,8562,6,10,5,13,33,42,-9,35
Western Sydn,8562,7,8,9,10,38,47,-9,33
Perth Glory,8562,8,10,2,15,37,50,-13,32
Wellington P,8562,9,5,6,16,31,55,-24,21
CC Mariners,8562,10,4,8,15,28,49,-21,20
Sydney FC,8563,1,21,4,3,67,22,45,67
N'castle Jet,8563,2,16,5,7,60,38,22,53
Melbourne C,8563,3,14,4,11,44,36,8,46
Melbourne V,8563,4,13,5,11,45,41,4,44
Adelaide Utd,8563,5,11,6,11,37,40,-3,39
Brisbane,8563,6,10,5,13,33,42,-9,35
Western Sydn,8563,7,8,9,10,38,47,-9,33
Perth Glory,8563,8,10,2,15,37,50,-13,32
Wellington P,8563,9,5,6,16,31,55,-24,21
CC Mariners,8563,10,4,8,15,28,49,-21,20
Sydney FC,8564,1,21,4,3,66,22,44,67
N'castle Jet,8564,2,15,5,8,58,41,17,50
Melbourne C,8564,3,15,4,10,47,34,13,49
Melbourne V,8564,4,13,5,11,45,40,5,44
Adelaide Utd,8564,5,11,6,11,37,40,-3,39
Brisbane,8564,6,10,5,13,33,42,-9,35
Western Sydn,8564,7,8,9,10,38,47,-9,33
Perth Glory,8564,8,10,2,15,37,50,-13,32
Wellington P,8564,9,5,6,16,31,55,-24,21
CC Mariners,8564,10,4,8,15,28,49,-21,20
Sydney FC,8565,1,21,4,3,66,22,44,67
N'castle Jet,8565,2,16,5,7,60,39,21,53
Melbourne C,8565,3,14,4,11,45,36,9,46
Melbourne V,8565,4,13,5,11,45,40,5,44
Adelaide Utd,8565,5,11,6,11,37,40,-3,39
Brisbane,8565,6,10,5,13,33,42,-9,35
Western Sydn,8565,7,8,9,10,38,47,-9,33
Perth Glory,8565,8,10,2,15,37,50,-13,32
Wellington P,8565,9,5,6,16,31,55,-24,21
CC Mariners,8565,10,4,8,15,28,49,-21,20
Sydney FC,8566,1,20,4,4,65,26,39,64
N'castle Jet,8566,2,16,5,7,59,37,22,53
Melbourne V,8566,3,14,5,10,49,39,10,47
Melbourne C,8566,4,14,4,11,43,35,8,46
Adelaide Utd,8566,5,11,6,11,37,40,-3,39
Brisbane,8566,6,10,5,13,33,42,-9,35
Western Sydn,8566,7,8,9,10,38,47,-9,33
Perth Glory,8566,8,10,2,15,37,50,-13,32
Wellington P,8566,9,5,6,16,31,55,-24,21
CC Mariners,8566,10,4,8,15,28,49,-21,20
Sydney FC,8567,1,21,4,3,67,23,44,67
N'castle Jet,8567,2,15,5,8,57,38,19,50
Melbourne C,8567,3,15,4,10,44,33,11,49
Melbourne V,8567,4,13,5,11,46,41,5,44
Adelaide Utd,8567,5,11,6,11,37,40,-3,39
Brisbane,8567,6,10,5,13,33,42,-9,35
Western Sydn,8567,7,8,9,10,38,47,-9,33
Perth Glory,8567,8,10,2,15,37,50,-13,32
Wellington P,8567,9,5,6,16,31,55,-24,21
CC Mariners,8567,10,4,8,15,28,49,-21,20
Sydney FC,8568,1,20,4,4,64,23,41,64
N'castle Jet,8568,2,15,6,7,57,37,20,51
Melbourne C,8568,3,14,5,10,43,33,10,47
Melbourne V,8568,4,14,5,10,46,38,8,47
Adelaide Utd,8568,5,11,6,11,37,40,-3,39
Brisbane,8568,6,10,5,13,33,42,-9,35
Western Sydn,8568,7,8,9,10,38,47,-9,33
Perth Glory,8568,8,10,2,15,37,50,-13,32
Wellington P,8568,9,5,6,16,31,55,-24,21
CC Mariners,8568,10,4,8,15,28,49,-21,20
Sydney FC,8569,1,21,4,3,66,22,44,67
N'castle Jet,8569,2,16,5,7,59,37,22,53
Melbourne C,8569,3,14,4,11,43,35,8,46
Melbourne V,8569,4,13,5,11,45,40,5,44
Adelaide Utd,8569,5,11,6,11,37,40,-3,39
Brisbane,8569,6,10,5,13,33,42,-9,35
Western Sydn,8569,7,8,9,10,38,47,-9,33
Perth Glory,8569,8,10,2,15,37,50,-13,32
Wellington P,8569,9,5,6,16,31,55,-24,21
CC Mariners,8569,10,4,8,15,28,49,-21,20
Sydney FC,8570,1,21,4,3,65,22,43,67
N'castle Jet,8570,2,16,5,7,60,37,23,53
Melbourne C,8570,3,14,4,11,43,36,7,46
Melbourne V,8570,4,13,5,11,45,39,6,44
Adelaide Utd,8570,5,11,6,11,37,40,-3,39
Brisbane,8570,6,10,5,13,33,42,-9,35
Western Sydn,8570,7,8,9,10,38,47,-9,33
Perth Glory,8570,8,10,2,15,37,50,-13,32
Wellington P,8570,9,5,6,16,31,55,-24,21
CC Mariners,8570,10,4,8,15,28,49,-21,20
Sydney FC,8571,1,20,4,4,64,25,39,64
N'castle Jet,8571,2,15,5,8,58,40,18,50
Melbourne C,8571,3,15,4,10,46,34,12,49
Melbourne V,8571,4,14,5,10,48,38,10,47
Adelaide Utd,8571,5,11,6,11,37,40,-3,39
Brisbane,8571,6,10,5,13,33,42,-9,35
Western Sydn,8571,7,8,9,10,38,47,-9,33
Perth Glory,8571,8,10,2,15,37,50,-13,32
Wellington P,8571,9,5,6,16,31,55,-24,21
CC Mariners,8571,10,4,8,15,28,49,-21,20
Sydney FC,8572,1,21,4,3,66,23,43,67
N'castle Jet,8572,2,16,5,7,60,37,23,53
Melbourne C,8572,3,14,4,11,43,36,7,46
Melbourne V,8572,4,13,5,11,46,40,6,44
Adelaide Utd,8572,5,11,6,11,37,40,-3,39
Brisbane,8572,6,10,5,13,33,42,-9,35
Western Sydn,8572,7,8,9,10,38,47,-9,33
Perth Glory,8572,8,10,2,15,37,50,-13,32
Wellington P,8572,9,5,6,16,31,55,-24,21
CC Mariners,8572,10,4,8,15,28,49,-21,20
Sydney FC,8573,1,20,4,4,66,27,39,64
N'castle Jet,8573,2,16,5,7,59,38,21,53
Melbourne V,8573,3,14,5,10,50,40,10,47
Melbourne C,8573,4,14,4,11,44,35,9,46
Adelaide Utd,8573,5,11,6,11,37,40,-3,39
Brisbane,8573,6,10,5,13,33,42,-9,35
Western Sydn,8573,7,8,9,10,38,47,-9,33
Perth Glory,8573,8,10,2,15,37,50,-13,32
Wellington P,8573,9,5,6,16,31,55,-24,21
CC Mariners,8573,10,4,8,15,28,49,-21,20
Sydney FC,8574,1,21,4,3,69,23,46,67
N'castle Jet,8574,2,15,6,7,57,37,20,51
Melbourne C,8574,3,14,5,10,43,33,10,47
Melbourne V,8574,4,13,5,11,46,43,3,44
Adelaide Utd,8574,5,11,6,11,37,40,-3,39
Brisbane,8574,6,10,5,13,33,42,-9,35
Western Sydn,8574,7,8,9,10,38,47,-9,33
Perth Glory,8574,8,10,2,15,37,50,-13,32
Wellington P,8574,9,5,6,16,31,55,-24,21
CC Mariners,8574,10,4,8,15,28,49,-21,20
Sydney FC,8575,1,20,4,4,66,25,41,64
N'castle Jet,8575,2,15,5,8,58,39,19,50
Melbourne C,8575,3,15,4,10,45,34,11,49
Melbourne V,8575,4,14,5,10,48,40,8,47
Adelaide Utd,8575,5,11,6,11,37,40,-3,39
Brisbane,8575,6,10,5,13,33,42,-9,35
Western Sydn,8575,7,8,9,10,38,47,-9,33
Perth Glory,8575,8,10,2,15,37,50,-13,32
Wellington P,8575,9,5,6,16,31,55,-24,21
CC Mariners,8575,10,4,8,15,28,49,-21,20
Sydney FC,8576,1,20,5,3,65,23,42,65
N'castle Jet,8576,2,15,5,8,58,39,19,50
Melbourne C,8576,3,15,4,10,45,34,11,49
Melbourne V,8576,4,13,6,10,46,39,7,45
Adelaide Utd,8576,5,11,6,11,37,40,-3,39
Brisbane,8576,6,10,5,13,33,42,-9,35
Western Sydn,8576,7,8,9,10,38,47,-9,33
Perth Glory,8576,8,10,2,15,37,50,-13,32
Wellington P,8576,9,5,6,16,31,55,-24,21
CC Mariners,8576,10,4,8,15,28,49,-21,20
Sydney FC,8577,1,20,5,3,65,23,42,65
N'castle Jet,8577,2,15,5,8,57,39,18,50
Melbourne C,8577,3,15,4,10,45,33,12,49
Melbourne V,8577,4,13,6,10,46,39,7,45
Adelaide Utd,8577,5,11,6,11,37,40,-3,39
Brisbane,8577,6,10,5,13,33,42,-9,35
Western Sydn,8577,7,8,9,10,38,47,-9,33
Perth Glory,8577,8,10,2,15,37,50,-13,32
Wellington P,8577,9,5,6,16,31,55,-24,21
CC Mariners,8577,10,4,8,15,28,49,-21,20
Sydney FC,8578,1,21,4,3,66,22,44,67
N'castle Jet,8578,2,16,5,7,59,38,21,53
Melbourne C,8578,3,14,4,11,44,35,9,46
Melbourne V,8578,4,13,5,11,45,40,5,44
Adelaide Utd,8578,5,11,6,11,37,40,-3,39
Brisbane,8578,6,10,5,13,33,42,-9,35
Western Sydn,8578,7,8,9,10,38,47,-9,33
Perth Glory,8578,8,10,2,15,37,50,-13,32
Wellington P,8578,9,5,6,16,31,55,-24,21
CC Mariners,8578,10,4,8,15,28,49,-21,20
Sydney FC,8579,1,21,4,3,67,24,43,67
N'castle Jet,8579,2,15,6,7,58,38,20,51
Melbourne C,8579,3,14,5,10,44,34,10,47
Melbourne V,8579,4,13,5,11,47,41,6,44
Adelaide Utd,8579,5,11,6,11,37,40,-3,39
Brisbane,8579,6,10,5,13,33,42,-9,35
Western Sydn,8579,7,8,9,10,38,47,-9,33
Perth Glory,8579,8,10,2,15,37,50,-13,32
Wellington P,8579,9,5,6,16,31,55,-24,21
CC Mariners,8579,10,4,8,15,28,49,-21,20
Sydney FC,8580,1,20,4,4,66,26,40,64
N'castle Jet,8580,2,16,5,7,61,38,23,53
Melbourne V,8580,3,14,5,10,49,40,9,47
Melbourne C,8580,4,14,4,11,44,37,7,46
Adelaide Utd,8580,5,11,6,11,37,40,-3,39
Brisbane,8580,6,10,5,13,33,42,-9,35
Western Sydn,8580,7,8,9,10,38,47,-9,33
Perth Glory,8580,8,10,2,15,37,50,-13,32
Wellington P,8580,9,5,6,16,31,55,-24,21
CC Mariners,8580,10,4,8,15,28,49,-21,20
Sydney FC,8581,1,21,4,3,67,24,43,67
N'castle Jet,8581,2,15,5,8,58,41,17,50
Melbourne C,8581,3,15,4,10,47,34,13,49
Melbourne V,8581,4,13,5,11,47,41,6,44
Adelaide Utd,8581,5,11,6,11,37,40,-3,39
Brisbane,8581,6,10,5,13,33,42,-9,35
Western Sydn,8581,7,8,9,10,38,47,-9,33
Perth Glory,8581,8,10,2,15,37,50,-13,32
Wellington P,8581,9,5,6,16,31,55,-24,21
CC Mariners,8581,10,4,8,15,28,49,-21,20
Sydney FC,8582,1,21,4,3,67,24,43,67
N'castle Jet,8582,2,15,5,8,57,39,18,50
Melbourne C,8582,3,15,4,10,45,33,12,49
Melbourne V,8582,4,13,5,11,47,41,6,44
Adelaide Utd,8582,5,11,6,11,37,40,-3,39
Brisbane,8582,6,10,5,13,33,42,-9,35
Western Sydn,8582,7,8,9,10,38,47,-9,33
Perth Glory,8582,8,10,2,15,37,50,-13,32
Wellington P,8582,9,5,6,16,31,55,-24,21
CC Mariners,8582,10,4,8,15,28,49,-21,20
Sydney FC,8583,1,20,4,4,66,25,41,64
N'castle Jet,8583,2,16,5,7,58,37,21,53
Melbourne V,8583,3,14,5,10,48,40,8,47
Melbourne C,8583,4,14,4,11,43,34,9,46
Adelaide Utd,8583,5,11,6,11,37,40,-3,39
Brisbane,8583,6,10,5,13,33,42,-9,35
Western Sydn,8583,7,8,9,10,38,47,-9,33
Perth Glory,8583,8,10,2,15,37,50,-13,32
Wellington P,8583,9,5,6,16,31,55,-24,21
CC Mariners,8583,10,4,8,15,28,49,-21,20
Sydney FC,8584,1,21,4,3,66,22,44,67
N'castle Jet,8584,2,15,5,8,60,42,18,50
Melbourne C,8584,3,15,4,10,48,36,12,49
Melbourne V,8584,4,13,5,11,45,40,5,44
Adelaide Utd,8584,5,11,6,11,37,40,-3,39
Brisbane,8584,6,10,5,13,33,42,-9,35
Western Sydn,8584,7,8,9,10,38,47,-9,33
Perth Glory,8584,8,10,2,15,37,50,-13,32
Wellington P,8584,9,5,6,16,31,55,-24,21
CC Mariners,8584,10,4,8,15,28,49,-21,20
Sydney FC,8585,1,21,4,3,67,22,45,67
N'castle Jet,8585,2,15,5,8,58,40,18,50
Melbourne C,8585,3,15,4,10,46,34,12,49
Melbourne V,8585,4,13,5,11,45,41,4,44
Adelaide Utd,8585,5,11,6,11,37,40,-3,39
Brisbane,8585,6,10,5,13,33,42,-9,35
Western Sydn,8585,7,8,9,10,38,47,-9,33
Perth Glory,8585,8,10,2,15,37,50,-13,32
Wellington P,8585,9,5,6,16,31,55,-24,21
CC Mariners,8585,10,4,8,15,28,49,-21,20
Sydney FC,8586,1,20,4,4,66,25,41,64
N'castle Jet,8586,2,16,5,7,59,38,21,53
Melbourne V,8586,3,14,5,10,48,40,8,47
Melbourne C,8586,4,14,4,11,44,35,9,46
Adelaide Utd,8586,5,11,6,11,37,40,-3,39
Brisbane,8586,6,10,5,13,33,42,-9,35
Western Sydn,8586,7,8,9,10,38,47,-9,33
Perth Glory,8586,8,10,2,15,37,50,-13,32
Wellington P,8586,9,5,6,16,31,55,-24,21
CC Mariners,8586,10,4,8,15,28,49,-21,20
Sydney FC,8587,1,21,4,3,66,22,44,67
N'castle Jet,8587,2,15,6,7,58,38,20,51
Melbourne C,8587,3,14,5,10,44,34,10,47
Melbourne V,8587,4,13,5,11,45,40,5,44
Adelaide Utd,8587,5,11,6,11,37,40,-3,39
Brisbane,8587,6,10,5,13,33,42,-9,35
Western Sydn,8587,7,8,9,10,38,47,-9,33
Perth Glory,8587,8,10,2,15,37,50,-13,32
Wellington P,8587,9,5,6,16,31,55,-24,21
CC Mariners,8587,10,4,8,15,28,49,-21,20
Sydney FC,8588,1,21,4,3,67,24,43,67
N'castle Jet,8588,2,15,5,8,58,39,19,50
Melbourne C,8588,3,15,4,10,45,34,11,49
Melbourne V,8588,4,13,5,11,47,41,6,44
Adelaide Utd,8588,5,11,6,11,37,40,-3,39
Brisbane,8588,6,10,5,13,33,42,-9,35
Western Sydn,8588,7,8,9,10,38,47,-9,33
Perth Glory,8588,8,10,2,15,37,50,-13,32
Wellington P,8588,9,5,6,16,31,55,-24,21
CC Mariners,8588,10,4,8,15,28,49,-21,20
Sydney FC,8589,1,20,5,3,65,23,42,65
N'castle Jet,8589,2,16,5,7,59,38,21,53
Melbourne C,8589,3,14,4,11,44,35,9,46
Melbourne V,8589,4,13,6,10,46,39,7,45
Adelaide Utd,8589,5,11,6,11,37,40,-3,39
Brisbane,8589,6,10,5,13,33,42,-9,35
Western Sydn,8589,7,8,9,10,38,47,-9,33
Perth Glory,8589,8,10,2,15,37,50,-13,32
Wellington P,8589,9,5,6,16,31,55,-24,21
CC Mariners,8589,10,4,8,15,28,49,-21,20
Sydney FC,8590,1,21,4,3,67,23,44,67
N'castle Jet,8590,2,16,5,7,61,38,23,53
Melbourne C,8590,3,14,4,11,44,37,7,46
Melbourne V,8590,4,13,5,11,46,41,5,44
Adelaide Utd,8590,5,11,6,11,37,40,-3,39
Brisbane,8590,6,10,5,13,33,42,-9,35
Western Sydn,8590,7,8,9,10,38,47,-9,33
Perth Glory,8590,8,10,2,15,37,50,-13,32
Wellington P,8590,9,5,6,16,31,55,-24,21
CC Mariners,8590,10,4,8,15,28,49,-21,20
Sydney FC,8591,1,20,5,3,66,24,42,65
N'castle Jet,8591,2,16,5,7,60,39,21,53
Melbourne C,8591,3,14,4,11,45,36,9,46
Melbourne V,8591,4,13,6,10,47,40,7,45
Adelaide Utd,8591,5,11,6,11,37,40,-3,39
Brisbane,8591,6,10,5,13,33,42,-9,35
Western Sydn,8591,7,8,9,10,38,47,-9,33
Perth Glory,8591,8,10,2,15,37,50,-13,32
Wellington P,8591,9,5,6,16,31,55,-24,21
CC Mariners,8591,10,4,8,15,28,49,-21,20
Sydney FC,8592,1,21,4,3,65,22,43,67
N'castle Jet,8592,2,15,5,8,57,39,18,50
Melbourne C,8592,3,15,4,10,45,33,12,49
Melbourne V,8592,4,13,5,11,45,39,6,44
Adelaide Utd,8592,5,11,6,11,37,40,-3,39
Brisbane,8592,6,10,5,13,33,42,-9,35
Western Sydn,8592,7,8,9,10,38,47,-9,33
Perth Glory,8592,8,10,2,15,37,50,-13,32
Wellington P,8592,9,5,6,16,31,55,-24,21
CC Mariners,8592,10,4,8,15,28,49,-21,20
Sydney FC,8593,1,21,4,3,67,22,45,67
N'castle Jet,8593,2,15,5,8,57,38,19,50
Melbourne C,8593,3,15,4,10,44,33,11,49
Melbourne V,8593,4,13,5,11,45,41,4,44
Adelaide Utd,8593,5,11,6,11,37,40,-3,39
Brisbane,8593,6,10,5,13,33,42,-9,35
Western Sydn,8593,7,8,9,10,38,47,-9,33
Perth Glory,8593,8,10,2,15,37,50,-13,32
Wellington P,8593,9,5,6,16,31,55,-24,21
CC Mariners,8593,10,4,8,15,28,49,-21,20
Sydney FC,8594,1,21,4,3,65,22,43,67
N'castle Jet,8594,2,16,5,7,60,39,21,53
Melbourne C,8594,3,14,4,11,45,36,9,46
Melbourne V,8594,4,13,5,11,45,39,6,44
Adelaide Utd,8594,5,11,6,11,37,40,-3,39
Brisbane,8594,6,10,5,13,33,42,-9,35
Western Sydn,8594,7,8,9,10,38,47,-9,33
Perth Glory,8594,8,10,2,15,37,50,-13,32
Wellington P,8594,9,5,6,16,31,55,-24,21
CC Mariners,8594,10,4,8,15,28,49,-21,20
Sydney FC,8595,1,21,4,3,67,24,43,67
N'castle Jet,8595,2,16,5,7,60,39,21,53
Melbourne C,8595,3,14,4,11,45,36,9,46
Melbourne V,8595,4,13,5,11,47,41,6,44
Adelaide Utd,8595,5,11,6,11,37,40,-3,39
Brisbane,8595,6,10,5,13,33,42,-9,35
Western Sydn,8595,7,8,9,10,38,47,-9,33
Perth Glory,8595,8,10,2,15,37,50,-13,32
Wellington P,8595,9,5,6,16,31,55,-24,21
CC Mariners,8595,10,4,8,15,28,49,-21,20
Sydney FC,8596,1,21,4,3,68,23,45,67
N'castle Jet,8596,2,16,5,7,59,37,22,53
Melbourne C,8596,3,14,4,11,43,35,8,46
Melbourne V,8596,4,13,5,11,46,42,4,44
Adelaide Utd,8596,5,11,6,11,37,40,-3,39
Brisbane,8596,6,10,5,13,33,42,-9,35
Western Sydn,8596,7,8,9,10,38,47,-9,33
Perth Glory,8596,8,10,2,15,37,50,-13,32
Wellington P,8596,9,5,6,16,31,55,-24,21
CC Mariners,8596,10,4,8,15,28,49,-21,20
Sydney FC,8597,1,21,4,3,68,22,46,67
N'castle Jet,8597,2,16,5,7,58,37,21,53
Melbourne C,8597,3,14,4,11,43,34,9,46
Melbourne V,8597,4,13,5,11,45,42,3,44
Adelaide Utd,8597,5,11,6,11,37,40,-3,39
Brisbane,8597,6,10,5,13,33,42,-9,35
Western Sydn,8597,7,8,9,10,38,47,-9,33
Perth Glory,8597,8,10,2,15,37,50,-13,32
Wellington P,8597,9,5,6,16,31,55,-24,21
CC Mariners,8597,10,4,8,15,28,49,-21,20
Sydney FC,8598,1,20,4,4,66,25,41,64
N'castle Jet,8598,2,15,6,7,57,37,20,51
Melbourne C,8598,3,14,5,10,43,33,10,47
Melbourne V,8598,4,14,5,10,48,40,8,47
Adelaide Utd,8598,5,11,6,11,37,40,-3,39
Brisbane,8598,6,10,5,13,33,42,-9,35
Western Sydn,8598,7,8,9,10,38,47,-9,33
Perth Glory,8598,8,10,2,15,37,50,-13,32
Wellington P,8598,9,5,6,16,31,55,-24,21
CC Mariners,8598,10,4,8,15,28,49,-21,20
Sydney FC,8599,1,21,4,3,66,23,43,67
N'castle Jet,8599,2,16,5,7,59,37,22,53
Melbourne C,8599,3,14,4,11,43,35,8,46
Melbourne V,8599,4,13,5,11,46,40,6,44
Adelaide Utd,8599,5,11,6,11,37,40,-3,39
Brisbane,8599,6,10,5,13,33,42,-9,35
Western Sydn,8599,7,8,9,10,38,47,-9,33
Perth Glory,8599,8,10,2,15,37,50,-13,32
Wellington P,8599,9,5,6,16,31,55,-24,21
CC Mariners,8599,10,4,8,15,28,49,-21,20
Sydney FC,8600,1,21,4,3,66,23,43,67
N'castle Jet,8600,2,15,6,7,57,37,20,51
Melbourne C,8600,3,14,5,10,43,33,10,47
Melbourne V,8600,4,13,5,11,46,40,6,44
Adelaide Utd,8600,5,11,6,11,37,40,-3,39
Brisbane,8600,6,10,5,13,33,42,-9,35
Western Sydn,8600,7,8,9,10,38,47,-9,33
Perth Glory,8600,8,10,2,15,37,50,-13,32
Wellington P,8600,9,5,6,16,31,55,-24,21
CC Mariners,8600,10,4,8,15,28,49,-21,20
Sydney FC,8601,1,21,4,3,67,22,45,67
N'castle Jet,8601,2,16,5,7,60,37,23,53
Melbourne C,8601,3,14,4,11,43,36,7,46
Melbourne V,8601,4,13,5,11,45,41,4,44
Adelaide Utd,8601,5,11,6,11,37,40,-3,39
Brisbane,8601,6,10,5,13,33,42,-9,35
Western Sydn,8601,7,8,9,10,38,47,-9,33
Perth Glory,8601,8,10,2,15,37,50,-13,32
Wellington P,8601,9,5,6,16,31,55,-24,21
CC Mariners,8601,10,4,8,15,28,49,-21,20
Sydney FC,8602,1,21,4,3,68,23,45,67
N'castle Jet,8602,2,16,5,7,58,37,21,53
Melbourne C,8602,3,14,4,11,43,34,9,46
Melbourne V,8602,4,13,5,11,46,42,4,44
Adelaide Utd,8602,5,11,6,11,37,40,-3,39
Brisbane,8602,6,10,5,13,33,42,-9,35
Western Sydn,8602,7,8,9,10,38,47,-9,33
Perth Glory,8602,8,10,2,15,37,50,-13,32
Wellington P,8602,9,5,6,16,31,55,-24,21
CC Mariners,8602,10,4,8,15,28,49,-21,20
Sydney FC,8603,1,20,5,3,65,23,42,65
N'castle Jet,8603,2,16,5,7,60,37,23,53
Melbourne C,8603,3,14,4,11,43,36,7,46
Melbourne V,8603,4,13,6,10,46,39,7,45
Adelaide Utd,8603,5,11,6,11,37,40,-3,39
Brisbane,8603,6,10,5,13,33,42,-9,35
Western Sydn,8603,7,8,9,10,38,47,-9,33
Perth Glory,8603,8,10,2,15,37,50,-13,32
Wellington P,8603,9,5,6,16,31,55,-24,21
CC Mariners,8603,10,4,8,15,28,49,-21,20
Sydney FC,8604,1,21,4,3,65,22,43,67
N'castle Jet,8604,2,16,5,7,58,37,21,53
Melbourne C,8604,3,14,4,11,43,34,9,46
Melbourne V,8604,4,13,5,11,45,39,6,44
Adelaide Utd,8604,5,11,6,11,37,40,-3,39
Brisbane,8604,6,10,5,13,33,42,-9,35
Western Sydn,8604,7,8,9,10,38,47,-9,33
Perth Glory,8604,8,10,2,15,37,50,-13,32
Wellington P,8604,9,5,6,16,31,55,-24,21
CC Mariners,8604,10,4,8,15,28,49,-21,20
Sydney FC,8605,1,21,4,3,66,22,44,67
N'castle Jet,8605,2,15,6,7,59,39,20,51
Melbourne C,8605,3,14,5,10,45,35,10,47
Melbourne V,8605,4,13,5,11,45,40,5,44
Adelaide Utd,8605,5,11,6,11,37,40,-3,39
Brisbane,8605,6,10,5,13,33,42,-9,35
Western Sydn,8605,7,8,9,10,38,47,-9,33
Perth Glory,8605,8,10,2,15,37,50,-13,32
Wellington P,8605,9,5,6,16,31,55,-24,21
CC Mariners,8605,10,4,8,15,28,49,-21,20
Sydney FC,8606,1,21,4,3,68,24,44,67
N'castle Jet,8606,2,16,5,7,59,38,21,53
Melbourne C,8606,3,14,4,11,44,35,9,46
Melbourne V,8606,4,13,5,11,47,42,5,44
Adelaide Utd,8606,5,11,6,11,37,40,-3,39
Brisbane,8606,6,10,5,13,33,42,-9,35
Western Sydn,8606,7,8,9,10,38,47,-9,33
Perth Glory,8606,8,10,2,15,37,50,-13,32
Wellington P,8606,9,5,6,16,31,55,-24,21
CC Mariners,8606,10,4,8,15,28,49,-21,20
Sydney FC,8607,1,20,5,3,65,23,42,65
N'castle Jet,8607,2,15,5,8,57,40,17,50
Melbourne C,8607,3,15,4,10,46,33,13,49
Melbourne V,8607,4,13,6,10,46,39,7,45
Adelaide Utd,8607,5,11,6,11,37,40,-3,39
Brisbane,8607,6,10,5,13,33,42,-9,35
Western Sydn,8607,7,8,9,10,38,47,-9,33
Perth Glory,8607,8,10,2,15,37,50,-13,32
Wellington P,8607,9,5,6,16,31,55,-24,21
CC Mariners,8607,10,4,8,15,28,49,-21,20
Sydney FC,8608,1,20,5,3,65,23,42,65
N'castle Jet,8608,2,15,6,7,58,38,20,51
Melbourne C,8608,3,14,5,10,44,34,10,47
Melbourne V,8608,4,13,6,10,46,39,7,45
Adelaide Utd,8608,5,11,6,11,37,40,-3,39
Brisbane,8608,6,10,5,13,33,42,-9,35
Western Sydn,8608,7,8,9,10,38,47,-9,33
Perth Glory,8608,8,10,2,15,37,50,-13,32
Wellington P,8608,9,5,6,16,31,55,-24,21
CC Mariners,8608,10,4,8,15,28,49,-21,20
Sydney FC,8609,1,21,4,3,66,22,44,67
N'castle Jet,8609,2,15,5,8,58,40,18,50
Melbourne C,8609,3,15,4,10,46,34,12,49
Melbourne V,8609,4,13,5,11,45,40,5,44
Adelaide Utd,8609,5,11,6,11,37,40,-3,39
Brisbane,8609,6,10,5,13,33,42,-9,35
Western Sydn,8609,7,8,9,10,38,47,-9,33
Perth Glory,8609,8,10,2,15,37,50,-13,32
Wellington P,8609,9,5,6,16,31,55,-24,21
CC Mariners,8609,10,4,8,15,28,49,-21,20
Sydney FC,8610,1,21,4,3,66,22,44,67
N'castle Jet,8610,2,16,5,7,59,37,22,53
Melbourne C,8610,3,14,4,11,43,35,8,46
Melbourne V,8610,4,13,5,11,45,40,5,44
Adelaide Utd,8610,5,11,6,11,37,40,-3,39
Brisbane,8610,6,10,5,13,33,42,-9,35
Western Sydn,8610,7,8,9,10,38,47,-9,33
Perth Glory,8610,8,10,2,15,37,50,-13,32
Wellington P,8610,9,5,6,16,31,55,-24,21
CC Mariners,8610,10,4,8,15,28,49,-21,20
Sydney FC,8611,1,20,4,4,64,24,40,64
N'castle Jet,8611,2,16,5,7,58,37,21,53
Melbourne V,8611,3,14,5,10,47,38,9,47
Melbourne C,8611,4,14,4,11,43,34,9,46
Adelaide Utd,8611,5,11,6,11,37,40,-3,39
Brisbane,8611,6,10,5,13,33,42,-9,35
Western Sydn,8611,7,8,9,10,38,47,-9,33
Perth Glory,8611,8,10,2,15,37,50,-13,32
Wellington P,8611,9,5,6,16,31,55,-24,21
CC Mariners,8611,10,4,8,15,28,49,-21,20
Sydney FC,8612,1,21,4,3,65,22,43,67
N'castle Jet,8612,2,15,5,8,58,39,19,50
Melbourne C,8612,3,15,4,10,45,34,11,49
Melbourne V,8612,4,13,5,11,45,39,6,44
Adelaide Utd,8612,5,11,6,11,37,40,-3,39
Brisbane,8612,6,10,5,13,33,42,-9,35
Western Sydn,8612,7,8,9,10,38,47,-9,33
Perth Glory,8612,8,10,2,15,37,50,-13,32
Wellington P,8612,9,5,6,16,31,55,-24,21
CC Mariners,8612,10,4,8,15,28,49,-21,20
Sydney FC,8613,1,21,4,3,68,22,46,67
N'castle Jet,8613,2,15,5,8,58,39,19,50
Melbourne C,8613,3,15,4,10,45,34,11,49
Melbourne V,8613,4,13,5,11,45,42,3,44
Adelaide Utd,8613,5,11,6,11,37,40,-3,39
Brisbane,8613,6,10,5,13,33,42,-9,35
Western Sydn,8613,7,8,9,10,38,47,-9,33
Perth Glory,8613,8,10,2,15,37,50,-13,32
Wellington P,8613,9,5,6,16,31,55,-24,21
CC Mariners,8613,10,4,8,15,28,49,-21,20
Sydney FC,8614,1,21,4,3,68,23,45,67
N'castle Jet,8614,2,16,5,7,59,37,22,53
Melbourne C,8614,3,14,4,11,43,35,8,46
Melbourne V,8614,4,13,5,11,46,42,4,44
Adelaide Utd,8614,5,11,6,11,37,40,-3,39
Brisbane,8614,6,10,5,13,33,42,-9,35
Western Sydn,8614,7,8,9,10,38,47,-9,33
Perth Glory,8614,8,10,2,15,37,50,-13,32
Wellington P,8614,9,5,6,16,31,55,-24,21
CC Mariners,8614,10,4,8,15,28,49,-21,20
Sydney FC,8615,1,21,4,3,69,23,46,67
N'castle Jet,8615,2,15,5,8,59,41,18,50
Melbourne C,8615,3,15,4,10,47,35,12,49
Melbourne V,8615,4,13,5,11,46,43,3,44
Adelaide Utd,8615,5,11,6,11,37,40,-3,39
Brisbane,8615,6,10,5,13,33,42,-9,35
Western Sydn,8615,7,8,9,10,38,47,-9,33
Perth Glory,8615,8,10,2,15,37,50,-13,32
Wellington P,8615,9,5,6,16,31,55,-24,21
CC Mariners,8615,10,4,8,15,28,49,-21,20
Sydney FC,8616,1,21,4,3,66,22,44,67
N'castle Jet,8616,2,15,6,7,58,38,20,51
Melbourne C,8616,3,14,5,10,44,34,10,47
Melbourne V,8616,4,13,5,11,45,40,5,44
Adelaide Utd,8616,5,11,6,11,37,40,-3,39
Brisbane,8616,6,10,5,13,33,42,-9,35
Western Sydn,8616,7,8,9,10,38,47,-9,33
Perth Glory,8616,8,10,2,15,37,50,-13,32
Wellington P,8616,9,5,6,16,31,55,-24,21
CC Mariners,8616,10,4,8,15,28,49,-21,20
Sydney FC,8617,1,21,4,3,69,22,47,67
N'castle Jet,8617,2,15,6,7,58,38,20,51
Melbourne C,8617,3,14,5,10,44,34,10,47
Melbourne V,8617,4,13,5,11,45,43,2,44
Adelaide Utd,8617,5,11,6,11,37,40,-3,39
Brisbane,8617,6,10,5,13,33,42,-9,35
Western Sydn,8617,7,8,9,10,38,47,-9,33
Perth Glory,8617,8,10,2,15,37,50,-13,32
Wellington P,8617,9,5,6,16,31,55,-24,21
CC Mariners,8617,10,4,8,15,28,49,-21,20
Sydney FC,8618,1,20,5,3,66,24,42,65
N'castle Jet,8618,2,16,5,7,58,37,21,53
Melbourne C,8618,3,14,4,11,43,34,9,46
Melbourne V,8618,4,13,6,10,47,40,7,45
Adelaide Utd,8618,5,11,6,11,37,40,-3,39
Brisbane,8618,6,10,5,13,33,42,-9,35
Western Sydn,8618,7,8,9,10,38,47,-9,33
Perth Glory,8618,8,10,2,15,37,50,-13,32
Wellington P,8618,9,5,6,16,31,55,-24,21
CC Mariners,8618,10,4,8,15,28,49,-21,20
Sydney FC,8619,1,20,4,4,65,24,41,64
N'castle Jet,8619,2,16,5,7,60,38,22,53
Melbourne V,8619,3,14,5,10,47,39,8,47
Melbourne C,8619,4,14,4,11,44,36,8,46
Adelaide Utd,8619,5,11,6,11,37,40,-3,39
Brisbane,8619,6,10,5,13,33,42,-9,35
Western Sydn,8619,7,8,9,10,38,47,-9,33
Perth Glory,8619,8,10,2,15,37,50,-13,32
Wellington P,8619,9,5,6,16,31,55,-24,21
CC Mariners,8619,10,4,8,15,28,49,-21,20
Sydney FC,8620,1,21,4,3,66,23,43,67
N'castle Jet,8620,2,15,5,8,57,40,17,50
Melbourne C,8620,3,15,4,10,46,33,13,49
Melbourne V,8620,4,13,5,11,46,40,6,44
Adelaide Utd,8620,5,11,6,11,37,40,-3,39
Brisbane,8620,6,10,5,13,33,42,-9,35
Western Sydn,8620,7,8,9,10,38,47,-9,33
Perth Glory,8620,8,10,2,15,37,50,-13,32
Wellington P,8620,9,5,6,16,31,55,-24,21
CC Mariners,8620,10,4,8,15,28,49,-21,20
Sydney FC,8621,1,21,4,3,69,22,47,67
N'castle Jet,8621,2,15,6,7,58,38,20,51
Melbourne C,8621,3,14,5,10,44,34,10,47
Melbourne V,8621,4,13,5,11,45,43,2,44
Adelaide Utd,8621,5,11,6,11,37,40,-3,39
Brisbane,8621,6,10,5,13,33,42,-9,35
Western Sydn,8621,7,8,9,10,38,47,-9,33
Perth Glory,8621,8,10,2,15,37,50,-13,32
Wellington P,8621,9,5,6,16,31,55,-24,21
CC Mariners,8621,10,4,8,15,28,49,-21,20
Sydney FC,8622,1,21,4,3,66,23,43,67
N'castle Jet,8622,2,16,5,7,60,37,23,53
Melbourne C,8622,3,14,4,11,43,36,7,46
Melbourne V,8622,4,13,5,11,46,40,6,44
Adelaide Utd,8622,5,11,6,11,37,40,-3,39
Brisbane,8622,6,10,5,13,33,42,-9,35
Western Sydn,8622,7,8,9,10,38,47,-9,33
Perth Glory,8622,8,10,2,15,37,50,-13,32
Wellington P,8622,9,5,6,16,31,55,-24,21
CC Mariners,8622,10,4,8,15,28,49,-21,20
Sydney FC,8623,1,21,4,3,67,22,45,67
N'castle Jet,8623,2,16,5,7,60,37,23,53
Melbourne C,8623,3,14,4,11,43,36,7,46
Melbourne V,8623,4,13,5,11,45,41,4,44
Adelaide Utd,8623,5,11,6,11,37,40,-3,39
Brisbane,8623,6,10,5,13,33,42,-9,35
Western Sydn,8623,7,8,9,10,38,47,-9,33
Perth Glory,8623,8,10,2,15,37,50,-13,32
Wellington P,8623,9,5,6,16,31,55,-24,21
CC Mariners,8623,10,4,8,15,28,49,-21,20
Sydney FC,8624,1,20,5,3,65,23,42,65
N'castle Jet,8624,2,15,5,8,58,39,19,50
Melbourne C,8624,3,15,4,10,45,34,11,49
Melbourne V,8624,4,13,6,10,46,39,7,45
Adelaide Utd,8624,5,11,6,11,37,40,-3,39
Brisbane,8624,6,10,5,13,33,42,-9,35
Western Sydn,8624,7,8,9,10,38,47,-9,33
Perth Glory,8624,8,10,2,15,37,50,-13,32
Wellington P,8624,9,5,6,16,31,55,-24,21
CC Mariners,8624,10,4,8,15,28,49,-21,20
Sydney FC,8625,1,20,5,3,64,22,42,65
N'castle Jet,8625,2,15,6,7,58,38,20,51
Melbourne C,8625,3,14,5,10,44,34,10,47
Melbourne V,8625,4,13,6,10,45,38,7,45
Adelaide Utd,8625,5,11,6,11,37,40,-3,39
Brisbane,8625,6,10,5,13,33,42,-9,35
Western Sydn,8625,7,8,9,10,38,47,-9,33
Perth Glory,8625,8,10,2,15,37,50,-13,32
Wellington P,8625,9,5,6,16,31,55,-24,21
CC Mariners,8625,10,4,8,15,28,49,-21,20
Sydney FC,8626,1,21,4,3,67,23,44,67
N'castle Jet,8626,2,16,5,7,58,37,21,53
Melbourne C,8626,3,14,4,11,43,34,9,46
Melbourne V,8626,4,13,5,11,46,41,5,44
Adelaide Utd,8626,5,11,6,11,37,40,-3,39
Brisbane,8626,6,10,5,13,33,42,-9,35
Western Sydn,8626,7,8,9,10,38,47,-9,33
Perth Glory,8626,8,10,2,15,37,50,-13,32
Wellington P,8626,9,5,6,16,31,55,-24,21
CC Mariners,8626,10,4,8,15,28,49,-21,20
Sydney FC,8627,1,21,4,3,66,23,43,67
N'castle Jet,8627,2,15,6,7,61,41,20,51
Melbourne C,8627,3,14,5,10,47,37,10,47
Melbourne V,8627,4,13,5,11,46,40,6,44
Adelaide Utd,8627,5,11,6,11,37,40,-3,39
Brisbane,8627,6,10,5,13,33,42,-9,35
Western Sydn,8627,7,8,9,10,38,47,-9,33
Perth Glory,8627,8,10,2,15,37,50,-13,32
Wellington P,8627,9,5,6,16,31,55,-24,21
CC Mariners,8627,10,4,8,15,28,49,-21,20
Sydney FC,8628,1,21,4,3,66,22,44,67
N'castle Jet,8628,2,15,5,8,58,39,19,50
Melbourne C,8628,3,15,4,10,45,34,11,49
Melbourne V,8628,4,13,5,11,45,40,5,44
Adelaide Utd,8628,5,11,6,11,37,40,-3,39
Brisbane,8628,6,10,5,13,33,42,-9,35
Western Sydn,8628,7,8,9,10,38,47,-9,33
Perth Glory,8628,8,10,2,15,37,50,-13,32
Wellington P,8628,9,5,6,16,31,55,-24,21
CC Mariners,8628,10,4,8,15,28,49,-21,20
Sydney FC,8629,1,21,4,3,68,22,46,67
N'castle Jet,8629,2,15,6,7,57,37,20,51
Melbourne C,8629,3,14,5,10,43,33,10,47
Melbourne V,8629,4,13,5,11,45,42,3,44
Adelaide Utd,8629,5,11,6,11,37,40,-3,39
Brisbane,8629,6,10,5,13,33,42,-9,35
Western Sydn,8629,7,8,9,10,38,47,-9,33
Perth Glory,8629,8,10,2,15,37,50,-13,32
Wellington P,8629,9,5,6,16,31,55,-24,21
CC Mariners,8629,10,4,8,15,28,49,-21,20
Sydney FC,8630,1,21,4,3,65,22,43,67
N'castle Jet,8630,2,16,5,7,59,37,22,53
Melbourne C,8630,3,14,4,11,43,35,8,46
Melbourne V,8630,4,13,5,11,45,39,6,44
Adelaide Utd,8630,5,11,6,11,37,40,-3,39
Brisbane,8630,6,10,5,13,33,42,-9,35
Western Sydn,8630,7,8,9,10,38,47,-9,33
Perth Glory,8630,8,10,2,15,37,50,-13,32
Wellington P,8630,9,5,6,16,31,55,-24,21
CC Mariners,8630,10,4,8,15,28,49,-21,20
Sydney FC,8631,1,20,5,3,66,24,42,65
N'castle Jet,8631,2,16,5,7,60,37,23,53
Melbourne C,8631,3,14,4,11,43,36,7,46
Melbourne V,8631,4,13,6,10,47,40,7,45
Adelaide Utd,8631,5,11,6,11,37,40,-3,39
Brisbane,8631,6,10,5,13,33,42,-9,35
Western Sydn,8631,7,8,9,10,38,47,-9,33
Perth Glory,8631,8,10,2,15,37,50,-13,32
Wellington P,8631,9,5,6,16,31,55,-24,21
CC Mariners,8631,10,4,8,15,28,49,-21,20
Sydney FC,8632,1,20,4,4,65,24,41,64
N'castle Jet,8632,2,16,5,7,59,38,21,53
Melbourne V,8632,3,14,5,10,47,39,8,47
Melbourne C,8632,4,14,4,11,44,35,9,46
Adelaide Utd,8632,5,11,6,11,37,40,-3,39
Brisbane,8632,6,10,5,13,33,42,-9,35
Western Sydn,8632,7,8,9,10,38,47,-9,33
Perth Glory,8632,8,10,2,15,37,50,-13,32
Wellington P,8632,9,5,6,16,31,55,-24,21
CC Mariners,8632,10,4,8,15,28,49,-21,20
Sydney FC,8633,1,21,4,3,67,23,44,67
N'castle Jet,8633,2,15,6,7,59,39,20,51
Melbourne C,8633,3,14,5,10,45,35,10,47
Melbourne V,8633,4,13,5,11,46,41,5,44
Adelaide Utd,8633,5,11,6,11,37,40,-3,39
Brisbane,8633,6,10,5,13,33,42,-9,35
Western Sydn,8633,7,8,9,10,38,47,-9,33
Perth Glory,8633,8,10,2,15,37,50,-13,32
Wellington P,8633,9,5,6,16,31,55,-24,21
CC Mariners,8633,10,4,8,15,28,49,-21,20
Sydney FC,8634,1,20,5,3,65,23,42,65
N'castle Jet,8634,2,16,5,7,59,38,21,53
Melbourne C,8634,3,14,4,11,44,35,9,46
Melbourne V,8634,4,13,6,10,46,39,7,45
Adelaide Utd,8634,5,11,6,11,37,40,-3,39
Brisbane,8634,6,10,5,13,33,42,-9,35
Western Sydn,8634,7,8,9,10,38,47,-9,33
Perth Glory,8634,8,10,2,15,37,50,-13,32
Wellington P,8634,9,5,6,16,31,55,-24,21
CC Mariners,8634,10,4,8,15,28,49,-21,20
Sydney FC,8635,1,20,5,3,65,23,42,65
N'castle Jet,8635,2,16,5,7,59,38,21,53
Melbourne C,8635,3,14,4,11,44,35,9,46
Melbourne V,8635,4,13,6,10,46,39,7,45
Adelaide Utd,8635,5,11,6,11,37,40,-3,39
Brisbane,8635,6,10,5,13,33,42,-9,35
Western Sydn,8635,7,8,9,10,38,47,-9,33
Perth Glory,8635,8,10,2,15,37,50,-13,32
Wellington P,8635,9,5,6,16,31,55,-24,21
CC Mariners,8635,10,4,8,15,28,49,-21,20
Sydney FC,8636,1,21,4,3,66,22,44,67
N'castle Jet,8636,2,15,5,8,59,40,19,50
Melbourne C,8636,3,15,4,10,46,35,11,49
Melbourne V,8636,4,13,5,11,45,40,5,44
Adelaide Utd,8636,5,11,6,11,37,40,-3,39
Brisbane,8636,6,10,5,13,33,42,-9,35
Western Sydn,8636,7,8,9,10,38,47,-9,33
Perth Glory,8636,8,10,2,15,37,50,-13,32
Wellington P,8636,9,5,6,16,31,55,-24,21
CC Mariners,8636,10,4,8,15,28,49,-21,20
Sydney FC,8637,1,20,5,3,64,22,42,65
N'castle Jet,8637,2,15,6,7,58,38,20,51
Melbourne C,8637,3,14,5,10,44,34,10,47
Melbourne V,8637,4,13,6,10,45,38,7,45
Adelaide Utd,8637,5,11,6,11,37,40,-3,39
Brisbane,8637,6,10,5,13,33,42,-9,35
Western Sydn,8637,7,8,9,10,38,47,-9,33
Perth Glory,8637,8,10,2,15,37,50,-13,32
Wellington P,8637,9,5,6,16,31,55,-24,21
CC Mariners,8637,10,4,8,15,28,49,-21,20
Sydney FC,8638,1,21,4,3,66,22,44,67
N'castle Jet,8638,2,16,5,7,62,39,23,53
Melbourne C,8638,3,14,4,11,45,38,7,46
Melbourne V,8638,4,13,5,11,45,40,5,44
Adelaide Utd,8638,5,11,6,11,37,40,-3,39
Brisbane,8638,6,10,5,13,33,42,-9,35
Western Sydn,8638,7,8,9,10,38,47,-9,33
Perth Glory,8638,8,10,2,15,37,50,-13,32
Wellington P,8638,9,5,6,16,31,55,-24,21
CC Mariners,8638,10,4,8,15,28,49,-21,20
Sydney FC,8639,1,20,4,4,65,24,41,64
N'castle Jet,8639,2,15,5,8,59,40,19,50
Melbourne C,8639,3,15,4,10,46,35,11,49
Melbourne V,8639,4,14,5,10,47,39,8,47
Adelaide Utd,8639,5,11,6,11,37,40,-3,39
Brisbane,8639,6,10,5,13,33,42,-9,35
Western Sydn,8639,7,8,9,10,38,47,-9,33
Perth Glory,8639,8,10,2,15,37,50,-13,32
Wellington P,8639,9,5,6,16,31,55,-24,21
CC Mariners,8639,10,4,8,15,28,49,-21,20
Sydney FC,8640,1,20,5,3,65,23,42,65
N'castle Jet,8640,2,15,5,8,58,39,19,50
Melbourne C,8640,3,15,4,10,45,34,11,49
Melbourne V,8640,4,13,6,10,46,39,7,45
Adelaide Utd,8640,5,11,6,11,37,40,-3,39
Brisbane,8640,6,10,5,13,33,42,-9,35
Western Sydn,8640,7,8,9,10,38,47,-9,33
Perth Glory,8640,8,10,2,15,37,50,-13,32
Wellington P,8640,9,5,6,16,31,55,-24,21
CC Mariners,8640,10,4,8,15,28,49,-21,20
Sydney FC,8641,1,21,4,3,65,22,43,67
N'castle Jet,8641,2,16,5,7,59,37,22,53
Melbourne C,8641,3,14,4,11,43,35,8,46
Melbourne V,8641,4,13,5,11,45,39,6,44
Adelaide Utd,8641,5,11,6,11,37,40,-3,39
Brisbane,8641,6,10,5,13,33,42,-9,35
Western Sydn,8641,7,8,9,10,38,47,-9,33
Perth Glory,8641,8,10,2,15,37,50,-13,32
Wellington P,8641,9,5,6,16,31,55,-24,21
CC Mariners,8641,10,4,8,15,28,49,-21,20
Sydney FC,8642,1,21,4,3,69,24,45,67
N'castle Jet,8642,2,16,5,7,62,37,25,53
Melbourne C,8642,3,14,4,11,43,38,5,46
Melbourne V,8642,4,13,5,11,47,43,4,44
Adelaide Utd,8642,5,11,6,11,37,40,-3,39
Brisbane,8642,6,10,5,13,33,42,-9,35
Western Sydn,8642,7,8,9,10,38,47,-9,33
Perth Glory,8642,8,10,2,15,37,50,-13,32
Wellington P,8642,9,5,6,16,31,55,-24,21
CC Mariners,8642,10,4,8,15,28,49,-21,20
Sydney FC,8643,1,20,5,3,66,24,42,65
N'castle Jet,8643,2,15,5,8,57,38,19,50
Melbourne C,8643,3,15,4,10,44,33,11,49
Melbourne V,8643,4,13,6,10,47,40,7,45
Adelaide Utd,8643,5,11,6,11,37,40,-3,39
Brisbane,8643,6,10,5,13,33,42,-9,35
Western Sydn,8643,7,8,9,10,38,47,-9,33
Perth Glory,8643,8,10,2,15,37,50,-13,32
Wellington P,8643,9,5,6,16,31,55,-24,21
CC Mariners,8643,10,4,8,15,28,49,-21,20
Sydney FC,8644,1,20,5,3,65,23,42,65
N'castle Jet,8644,2,16,5,7,59,37,22,53
Melbourne C,8644,3,14,4,11,43,35,8,46
Melbourne V,8644,4,13,6,10,46,39,7,45
Adelaide Utd,8644,5,11,6,11,37,40,-3,39
Brisbane,8644,6,10,5,13,33,42,-9,35
Western Sydn,8644,7,8,9,10,38,47,-9,33
Perth Glory,8644,8,10,2,15,37,50,-13,32
Wellington P,8644,9,5,6,16,31,55,-24,21
CC Mariners,8644,10,4,8,15,28,49,-21,20
Sydney FC,8645,1,21,4,3,68,24,44,67
N'castle Jet,8645,2,15,6,7,58,38,20,51
Melbourne C,8645,3,14,5,10,44,34,10,47
Melbourne V,8645,4,13,5,11,47,42,5,44
Adelaide Utd,8645,5,11,6,11,37,40,-3,39
Brisbane,8645,6,10,5,13,33,42,-9,35
Western Sydn,8645,7,8,9,10,38,47,-9,33
Perth Glory,8645,8,10,2,15,37,50,-13,32
Wellington P,8645,9,5,6,16,31,55,-24,21
CC Mariners,8645,10,4,8,15,28,49,-21,20
Sydney FC,8646,1,20,5,3,67,25,42,65
N'castle Jet,8646,2,15,5,8,57,38,19,50
Melbourne C,8646,3,15,4,10,44,33,11,49
Melbourne V,8646,4,13,6,10,48,41,7,45
Adelaide Utd,8646,5,11,6,11,37,40,-3,39
Brisbane,8646,6,10,5,13,33,42,-9,35
Western Sydn,8646,7,8,9,10,38,47,-9,33
Perth Glory,8646,8,10,2,15,37,50,-13,32
Wellington P,8646,9,5,6,16,31,55,-24,21
CC Mariners,8646,10,4,8,15,28,49,-21,20
Sydney FC,8647,1,21,4,3,65,22,43,67
N'castle Jet,8647,2,16,5,7,59,38,21,53
Melbourne C,8647,3,14,4,11,44,35,9,46
Melbourne V,8647,4,13,5,11,45,39,6,44
Adelaide Utd,8647,5,11,6,11,37,40,-3,39
Brisbane,8647,6,10,5,13,33,42,-9,35
Western Sydn,8647,7,8,9,10,38,47,-9,33
Perth Glory,8647,8,10,2,15,37,50,-13,32
Wellington P,8647,9,5,6,16,31,55,-24,21
CC Mariners,8647,10,4,8,15,28,49,-21,20
Sydney FC,8648,1,21,4,3,65,22,43,67
N'castle Jet,8648,2,16,5,7,59,38,21,53
Melbourne C,8648,3,14,4,11,44,35,9,46
Melbourne V,8648,4,13,5,11,45,39,6,44
Adelaide Utd,8648,5,11,6,11,37,40,-3,39
Brisbane,8648,6,10,5,13,33,42,-9,35
Western Sydn,8648,7,8,9,10,38,47,-9,33
Perth Glory,8648,8,10,2,15,37,50,-13,32
Wellington P,8648,9,5,6,16,31,55,-24,21
CC Mariners,8648,10,4,8,15,28,49,-21,20
Sydney FC,8649,1,21,4,3,66,23,43,67
N'castle Jet,8649,2,16,5,7,60,37,23,53
Melbourne C,8649,3,14,4,11,43,36,7,46
Melbourne V,8649,4,13,5,11,46,40,6,44
Adelaide Utd,8649,5,11,6,11,37,40,-3,39
Brisbane,8649,6,10,5,13,33,42,-9,35
Western Sydn,8649,7,8,9,10,38,47,-9,33
Perth Glory,8649,8,10,2,15,37,50,-13,32
Wellington P,8649,9,5,6,16,31,55,-24,21
CC Mariners,8649,10,4,8,15,28,49,-21,20
Sydney FC,8650,1,21,4,3,67,22,45,67
N'castle Jet,8650,2,15,6,7,58,38,20,51
Melbourne C,8650,3,14,5,10,44,34,10,47
Melbourne V,8650,4,13,5,11,45,41,4,44
Adelaide Utd,8650,5,11,6,11,37,40,-3,39
Brisbane,8650,6,10,5,13,33,42,-9,35
Western Sydn,8650,7,8,9,10,38,47,-9,33
Perth Glory,8650,8,10,2,15,37,50,-13,32
Wellington P,8650,9,5,6,16,31,55,-24,21
CC Mariners,8650,10,4,8,15,28,49,-21,20
Sydney FC,8651,1,21,4,3,66,23,43,67
N'castle Jet,8651,2,15,5,8,58,39,19,50
Melbourne C,8651,3,15,4,10,45,34,11,49
Melbourne V,8651,4,13,5,11,46,40,6,44
Adelaide Utd,8651,5,11,6,11,37,40,-3,39
Brisbane,8651,6,10,5,13,33,42,-9,35
Western Sydn,8651,7,8,9,10,38,47,-9,33
Perth Glory,8651,8,10,2,15,37,50,-13,32
Wellington P,8651,9,5,6,16,31,55,-24,21
CC Mariners,8651,10,4,8,15,28,49,-21,20
Sydney FC,8652,1,20,4,4,64,26,38,64
N'castle Jet,8652,2,16,5,7,61,38,23,53
Melbourne V,8652,3,14,5,10,49,38,11,47
Melbourne C,8652,4,14,4,11,44,37,7,46
Adelaide Utd,8652,5,11,6,11,37,40,-3,39
Brisbane,8652,6,10,5,13,33,42,-9,35
Western Sydn,8652,7,8,9,10,38,47,-9,33
Perth Glory,8652,8,10,2,15,37,50,-13,32
Wellington P,8652,9,5,6,16,31,55,-24,21
CC Mariners,8652,10,4,8,15,28,49,-21,20
Sydney FC,8653,1,21,4,3,65,22,43,67
N'castle Jet,8653,2,16,5,7,58,37,21,53
Melbourne C,8653,3,14,4,11,43,34,9,46
Melbourne V,8653,4,13,5,11,45,39,6,44
Adelaide Utd,8653,5,11,6,11,37,40,-3,39
Brisbane,8653,6,10,5,13,33,42,-9,35
Western Sydn,8653,7,8,9,10,38,47,-9,33
Perth Glory,8653,8,10,2,15,37,50,-13,32
Wellington P,8653,9,5,6,16,31,55,-24,21
CC Mariners,8653,10,4,8,15,28,49,-21,20
Sydney FC,8654,1,21,4,3,68,24,44,67
N'castle Jet,8654,2,15,5,8,58,39,19,50
Melbourne C,8654,3,15,4,10,45,34,11,49
Melbourne V,8654,4,13,5,11,47,42,5,44
Adelaide Utd,8654,5,11,6,11,37,40,-3,39
Brisbane,8654,6,10,5,13,33,42,-9,35
Western Sydn,8654,7,8,9,10,38,47,-9,33
Perth Glory,8654,8,10,2,15,37,50,-13,32
Wellington P,8654,9,5,6,16,31,55,-24,21
CC Mariners,8654,10,4,8,15,28,49,-21,20
Sydney FC,8655,1,21,4,3,66,23,43,67
N'castle Jet,8655,2,15,6,7,59,39,20,51
Melbourne C,8655,3,14,5,10,45,35,10,47
Melbourne V,8655,4,13,5,11,46,40,6,44
Adelaide Utd,8655,5,11,6,11,37,40,-3,39
Brisbane,8655,6,10,5,13,33,42,-9,35
Western Sydn,8655,7,8,9,10,38,47,-9,33
Perth Glory,8655,8,10,2,15,37,50,-13,32
Wellington P,8655,9,5,6,16,31,55,-24,21
CC Mariners,8655,10,4,8,15,28,49,-21,20
Sydney FC,8656,1,20,4,4,65,24,41,64
N'castle Jet,8656,2,16,5,7,59,38,21,53
Melbourne V,8656,3,14,5,10,47,39,8,47
Melbourne C,8656,4,14,4,11,44,35,9,46
Adelaide Utd,8656,5,11,6,11,37,40,-3,39
Brisbane,8656,6,10,5,13,33,42,-9,35
Western Sydn,8656,7,8,9,10,38,47,-9,33
Perth Glory,8656,8,10,2,15,37,50,-13,32
Wellington P,8656,9,5,6,16,31,55,-24,21
CC Mariners,8656,10,4,8,15,28,49,-21,20
Sydney FC,8657,1,20,4,4,64,24,40,64
N'castle Jet,8657,2,15,6,7,59,39,20,51
Melbourne C,8657,3,14,5,10,45,35,10,47
Melbourne V,8657,4,14,5,10,47,38,9,47
Adelaide Utd,8657,5,11,6,11,37,40,-3,39
Brisbane,8657,6,10,5,13,33,42,-9,35
Western Sydn,8657,7,8,9,10,38,47,-9,33
Perth Glory,8657,8,10,2,15,37,50,-13,32
Wellington P,8657,9,5,6,16,31,55,-24,21
CC Mariners,8657,10,4,8,15,28,49,-21,20
Sydney FC,8658,1,20,5,3,65,23,42,65
N'castle Jet,8658,2,15,5,8,57,39,18,50
Melbourne C,8658,3,15,4,10,45,33,12,49
Melbourne V,8658,4,13,6,10,46,39,7,45
Adelaide Utd,8658,5,11,6,11,37,40,-3,39
Brisbane,8658,6,10,5,13,33,42,-9,35
Western Sydn,8658,7,8,9,10,38,47,-9,33
Perth Glory,8658,8,10,2,15,37,50,-13,32
Wellington P,8658,9,5,6,16,31,55,-24,21
CC Mariners,8658,10,4,8,15,28,49,-21,20
Sydney FC,8659,1,21,4,3,67,24,43,67
N'castle Jet,8659,2,15,5,8,58,39,19,50
Melbourne C,8659,3,15,4,10,45,34,11,49
Melbourne V,8659,4,13,5,11,47,41,6,44
Adelaide Utd,8659,5,11,6,11,37,40,-3,39
Brisbane,8659,6,10,5,13,33,42,-9,35
Western Sydn,8659,7,8,9,10,38,47,-9,33
Perth Glory,8659,8,10,2,15,37,50,-13,32
Wellington P,8659,9,5,6,16,31,55,-24,21
CC Mariners,8659,10,4,8,15,28,49,-21,20
Sydney FC,8660,1,21,4,3,67,23,44,67
N'castle Jet,8660,2,15,5,8,57,39,18,50
Melbourne C,8660,3,15,4,10,45,33,12,49
Melbourne V,8660,4,13,5,11,46,41,5,44
Adelaide Utd,8660,5,11,6,11,37,40,-3,39
Brisbane,8660,6,10,5,13,33,42,-9,35
Western Sydn,8660,7,8,9,10,38,47,-9,33
Perth Glory,8660,8,10,2,15,37,50,-13,32
Wellington P,8660,9,5,6,16,31,55,-24,21
CC Mariners,8660,10,4,8,15,28,49,-21,20
Sydney FC,8661,1,21,4,3,68,24,44,67
N'castle Jet,8661,2,15,5,8,57,39,18,50
Melbourne C,8661,3,15,4,10,45,33,12,49
Melbourne V,8661,4,13,5,11,47,42,5,44
Adelaide Utd,8661,5,11,6,11,37,40,-3,39
Brisbane,8661,6,10,5,13,33,42,-9,35
Western Sydn,8661,7,8,9,10,38,47,-9,33
Perth Glory,8661,8,10,2,15,37,50,-13,32
Wellington P,8661,9,5,6,16,31,55,-24,21
CC Mariners,8661,10,4,8,15,28,49,-21,20
Sydney FC,8662,1,21,4,3,67,23,44,67
N'castle Jet,8662,2,16,5,7,58,37,21,53
Melbourne C,8662,3,14,4,11,43,34,9,46
Melbourne V,8662,4,13,5,11,46,41,5,44
Adelaide Utd,8662,5,11,6,11,37,40,-3,39
Brisbane,8662,6,10,5,13,33,42,-9,35
Western Sydn,8662,7,8,9,10,38,47,-9,33
Perth Glory,8662,8,10,2,15,37,50,-13,32
Wellington P,8662,9,5,6,16,31,55,-24,21
CC Mariners,8662,10,4,8,15,28,49,-21,20
Sydney FC,8663,1,21,4,3,66,23,43,67
N'castle Jet,8663,2,16,5,7,59,38,21,53
Melbourne C,8663,3,14,4,11,44,35,9,46
Melbourne V,8663,4,13,5,11,46,40,6,44
Adelaide Utd,8663,5,11,6,11,37,40,-3,39
Brisbane,8663,6,10,5,13,33,42,-9,35
Western Sydn,8663,7,8,9,10,38,47,-9,33
Perth Glory,8663,8,10,2,15,37,50,-13,32
Wellington P,8663,9,5,6,16,31,55,-24,21
CC Mariners,8663,10,4,8,15,28,49,-21,20
Sydney FC,8664,1,21,4,3,66,22,44,67
N'castle Jet,8664,2,16,5,7,61,37,24,53
Melbourne C,8664,3,14,4,11,43,37,6,46
Melbourne V,8664,4,13,5,11,45,40,5,44
Adelaide Utd,8664,5,11,6,11,37,40,-3,39
Brisbane,8664,6,10,5,13,33,42,-9,35
Western Sydn,8664,7,8,9,10,38,47,-9,33
Perth Glory,8664,8,10,2,15,37,50,-13,32
Wellington P,8664,9,5,6,16,31,55,-24,21
CC Mariners,8664,10,4,8,15,28,49,-21,20
Sydney FC,8665,1,21,4,3,66,22,44,67
N'castle Jet,8665,2,16,5,7,60,37,23,53
Melbourne C,8665,3,14,4,11,43,36,7,46
Melbourne V,8665,4,13,5,11,45,40,5,44
Adelaide Utd,8665,5,11,6,11,37,40,-3,39
Brisbane,8665,6,10,5,13,33,42,-9,35
Western Sydn,8665,7,8,9,10,38,47,-9,33
Perth Glory,8665,8,10,2,15,37,50,-13,32
Wellington P,8665,9,5,6,16,31,55,-24,21
CC Mariners,8665,10,4,8,15,28,49,-21,20
Sydney FC,8666,1,21,4,3,65,22,43,67
N'castle Jet,8666,2,16,5,7,60,39,21,53
Melbourne C,8666,3,14,4,11,45,36,9,46
Melbourne V,8666,4,13,5,11,45,39,6,44
Adelaide Utd,8666,5,11,6,11,37,40,-3,39
Brisbane,8666,6,10,5,13,33,42,-9,35
Western Sydn,8666,7,8,9,10,38,47,-9,33
Perth Glory,8666,8,10,2,15,37,50,-13,32
Wellington P,8666,9,5,6,16,31,55,-24,21
CC Mariners,8666,10,4,8,15,28,49,-21,20
Sydney FC,8667,1,21,4,3,68,22,46,67
N'castle Jet,8667,2,15,5,8,57,39,18,50
Melbourne C,8667,3,15,4,10,45,33,12,49
Melbourne V,8667,4,13,5,11,45,42,3,44
Adelaide Utd,8667,5,11,6,11,37,40,-3,39
Brisbane,8667,6,10,5,13,33,42,-9,35
Western Sydn,8667,7,8,9,10,38,47,-9,33
Perth Glory,8667,8,10,2,15,37,50,-13,32
Wellington P,8667,9,5,6,16,31,55,-24,21
CC Mariners,8667,10,4,8,15,28,49,-21,20
Sydney FC,8668,1,20,5,3,65,23,42,65
N'castle Jet,8668,2,15,5,8,59,40,19,50
Melbourne C,8668,3,15,4,10,46,35,11,49
Melbourne V,8668,4,13,6,10,46,39,7,45
Adelaide Utd,8668,5,11,6,11,37,40,-3,39
Brisbane,8668,6,10,5,13,33,42,-9,35
Western Sydn,8668,7,8,9,10,38,47,-9,33
Perth Glory,8668,8,10,2,15,37,50,-13,32
Wellington P,8668,9,5,6,16,31,55,-24,21
CC Mariners,8668,10,4,8,15,28,49,-21,20
Sydney FC,8669,1,21,4,3,67,23,44,67
N'castle Jet,8669,2,16,5,7,59,37,22,53
Melbourne C,8669,3,14,4,11,43,35,8,46
Melbourne V,8669,4,13,5,11,46,41,5,44
Adelaide Utd,8669,5,11,6,11,37,40,-3,39
Brisbane,8669,6,10,5,13,33,42,-9,35
Western Sydn,8669,7,8,9,10,38,47,-9,33
Perth Glory,8669,8,10,2,15,37,50,-13,32
Wellington P,8669,9,5,6,16,31,55,-24,21
CC Mariners,8669,10,4,8,15,28,49,-21,20
Sydney FC,8670,1,20,4,4,64,23,41,64
N'castle Jet,8670,2,15,5,8,57,39,18,50
Melbourne C,8670,3,15,4,10,45,33,12,49
Melbourne V,8670,4,14,5,10,46,38,8,47
Adelaide Utd,8670,5,11,6,11,37,40,-3,39
Brisbane,8670,6,10,5,13,33,42,-9,35
Western Sydn,8670,7,8,9,10,38,47,-9,33
Perth Glory,8670,8,10,2,15,37,50,-13,32
Wellington P,8670,9,5,6,16,31,55,-24,21
CC Mariners,8670,10,4,8,15,28,49,-21,20
Sydney FC,8671,1,21,4,3,67,23,44,67
N'castle Jet,8671,2,15,5,8,57,38,19,50
Melbourne C,8671,3,15,4,10,44,33,11,49
Melbourne V,8671,4,13,5,11,46,41,5,44
Adelaide Utd,8671,5,11,6,11,37,40,-3,39
Brisbane,8671,6,10,5,13,33,42,-9,35
Western Sydn,8671,7,8,9,10,38,47,-9,33
Perth Glory,8671,8,10,2,15,37,50,-13,32
Wellington P,8671,9,5,6,16,31,55,-24,21
CC Mariners,8671,10,4,8,15,28,49,-21,20
Sydney FC,8672,1,21,4,3,68,23,45,67
N'castle Jet,8672,2,15,6,7,59,39,20,51
Melbourne C,8672,3,14,5,10,45,35,10,47
Melbourne V,8672,4,13,5,11,46,42,4,44
Adelaide Utd,8672,5,11,6,11,37,40,-3,39
Brisbane,8672,6,10,5,13,33,42,-9,35
Western Sydn,8672,7,8,9,10,38,47,-9,33
Perth Glory,8672,8,10,2,15,37,50,-13,32
Wellington P,8672,9,5,6,16,31,55,-24,21
CC Mariners,8672,10,4,8,15,28,49,-21,20
Sydney FC,8673,1,21,4,3,66,23,43,67
N'castle Jet,8673,2,16,5,7,60,38,22,53
Melbourne C,8673,3,14,4,11,44,36,8,46
Melbourne V,8673,4,13,5,11,46,40,6,44
Adelaide Utd,8673,5,11,6,11,37,40,-3,39
Brisbane,8673,6,10,5,13,33,42,-9,35
Western Sydn,8673,7,8,9,10,38,47,-9,33
Perth Glory,8673,8,10,2,15,37,50,-13,32
Wellington P,8673,9,5,6,16,31,55,-24,21
CC Mariners,8673,10,4,8,15,28,49,-21,20
Sydney FC,8674,1,21,4,3,69,23,46,67
N'castle Jet,8674,2,16,5,7,59,37,22,53
Melbourne C,8674,3,14,4,11,43,35,8,46
Melbourne V,8674,4,13,5,11,46,43,3,44
Adelaide Utd,8674,5,11,6,11,37,40,-3,39
Brisbane,8674,6,10,5,13,33,42,-9,35
Western Sydn,8674,7,8,9,10,38,47,-9,33
Perth Glory,8674,8,10,2,15,37,50,-13,32
Wellington P,8674,9,5,6,16,31,55,-24,21
CC Mariners,8674,10,4,8,15,28,49,-21,20
Sydney FC,8675,1,20,5,3,65,23,42,65
N'castle Jet,8675,2,15,6,7,57,37,20,51
Melbourne C,8675,3,14,5,10,43,33,10,47
Melbourne V,8675,4,13,6,10,46,39,7,45
Adelaide Utd,8675,5,11,6,11,37,40,-3,39
Brisbane,8675,6,10,5,13,33,42,-9,35
Western Sydn,8675,7,8,9,10,38,47,-9,33
Perth Glory,8675,8,10,2,15,37,50,-13,32
Wellington P,8675,9,5,6,16,31,55,-24,21
CC Mariners,8675,10,4,8,15,28,49,-21,20
Sydney FC,8676,1,21,4,3,71,22,49,67
N'castle Jet,8676,2,15,6,7,58,38,20,51
Melbourne C,8676,3,14,5,10,44,34,10,47
Melbourne V,8676,4,13,5,11,45,45,0,44
Adelaide Utd,8676,5,11,6,11,37,40,-3,39
Brisbane,8676,6,10,5,13,33,42,-9,35
Western Sydn,8676,7,8,9,10,38,47,-9,33
Perth Glory,8676,8,10,2,15,37,50,-13,32
Wellington P,8676,9,5,6,16,31,55,-24,21
CC Mariners,8676,10,4,8,15,28,49,-21,20
Sydney FC,8677,1,21,4,3,65,22,43,67
N'castle Jet,8677,2,15,6,7,58,38,20,51
Melbourne C,8677,3,14,5,10,44,34,10,47
Melbourne V,8677,4,13,5,11,45,39,6,44
Adelaide Utd,8677,5,11,6,11,37,40,-3,39
Brisbane,8677,6,10,5,13,33,42,-9,35
Western Sydn,8677,7,8,9,10,38,47,-9,33
Perth Glory,8677,8,10,2,15,37,50,-13,32
Wellington P,8677,9,5,6,16,31,55,-24,21
CC Mariners,8677,10,4,8,15,28,49,-21,20
Sydney FC,8678,1,21,4,3,66,23,43,67
N'castle Jet,8678,2,16,5,7,63,39,24,53
Melbourne C,8678,3,14,4,11,45,39,6,46
Melbourne V,8678,4,13,5,11,46,40,6,44
Adelaide Utd,8678,5,11,6,11,37,40,-3,39
Brisbane,8678,6,10,5,13,33,42,-9,35
Western Sydn,8678,7,8,9,10,38,47,-9,33
Perth Glory,8678,8,10,2,15,37,50,-13,32
Wellington P,8678,9,5,6,16,31,55,-24,21
CC Mariners,8678,10,4,8,15,28,49,-21,20
Sydney FC,8679,1,21,4,3,65,22,43,67
N'castle Jet,8679,2,16,5,7,60,37,23,53
Melbourne C,8679,3,14,4,11,43,36,7,46
Melbourne V,8679,4,13,5,11,45,39,6,44
Adelaide Utd,8679,5,11,6,11,37,40,-3,39
Brisbane,8679,6,10,5,13,33,42,-9,35
Western Sydn,8679,7,8,9,10,38,47,-9,33
Perth Glory,8679,8,10,2,15,37,50,-13,32
Wellington P,8679,9,5,6,16,31,55,-24,21
CC Mariners,8679,10,4,8,15,28,49,-21,20
Sydney FC,8680,1,20,4,4,65,24,41,64
N'castle Jet,8680,2,15,6,7,59,39,20,51
Melbourne C,8680,3,14,5,10,45,35,10,47
Melbourne V,8680,4,14,5,10,47,39,8,47
Adelaide Utd,8680,5,11,6,11,37,40,-3,39
Brisbane,8680,6,10,5,13,33,42,-9,35
Western Sydn,8680,7,8,9,10,38,47,-9,33
Perth Glory,8680,8,10,2,15,37,50,-13,32
Wellington P,8680,9,5,6,16,31,55,-24,21
CC Mariners,8680,10,4,8,15,28,49,-21,20
Sydney FC,8681,1,21,4,3,65,22,43,67
N'castle Jet,8681,2,15,5,8,58,40,18,50
Melbourne C,8681,3,15,4,10,46,34,12,49
Melbourne V,8681,4,13,5,11,45,39,6,44
Adelaide Utd,8681,5,11,6,11,37,40,-3,39
Brisbane,8681,6,10,5,13,33,42,-9,35
Western Sydn,8681,7,8,9,10,38,47,-9,33
Perth Glory,8681,8,10,2,15,37,50,-13,32
Wellington P,8681,9,5,6,16,31,55,-24,21
CC Mariners,8681,10,4,8,15,28,49,-21,20
Sydney FC,8682,1,21,4,3,66,22,44,67
N'castle Jet,8682,2,16,5,7,59,38,21,53
Melbourne C,8682,3,14,4,11,44,35,9,46
Melbourne V,8682,4,13,5,11,45,40,5,44
Adelaide Utd,8682,5,11,6,11,37,40,-3,39
Brisbane,8682,6,10,5,13,33,42,-9,35
Western Sydn,8682,7,8,9,10,38,47,-9,33
Perth Glory,8682,8,10,2,15,37,50,-13,32
Wellington P,8682,9,5,6,16,31,55,-24,21
CC Mariners,8682,10,4,8,15,28,49,-21,20
Sydney FC,8683,1,21,4,3,66,23,43,67
N'castle Jet,8683,2,15,6,7,58,38,20,51
Melbourne C,8683,3,14,5,10,44,34,10,47
Melbourne V,8683,4,13,5,11,46,40,6,44
Adelaide Utd,8683,5,11,6,11,37,40,-3,39
Brisbane,8683,6,10,5,13,33,42,-9,35
Western Sydn,8683,7,8,9,10,38,47,-9,33
Perth Glory,8683,8,10,2,15,37,50,-13,32
Wellington P,8683,9,5,6,16,31,55,-24,21
CC Mariners,8683,10,4,8,15,28,49,-21,20
Sydney FC,8684,1,21,4,3,69,22,47,67
N'castle Jet,8684,2,16,5,7,59,38,21,53
Melbourne C,8684,3,14,4,11,44,35,9,46
Melbourne V,8684,4,13,5,11,45,43,2,44
Adelaide Utd,8684,5,11,6,11,37,40,-3,39
Brisbane,8684,6,10,5,13,33,42,-9,35
Western Sydn,8684,7,8,9,10,38,47,-9,33
Perth Glory,8684,8,10,2,15,37,50,-13,32
Wellington P,8684,9,5,6,16,31,55,-24,21
CC Mariners,8684,10,4,8,15,28,49,-21,20
Sydney FC,8685,1,21,4,3,67,22,45,67
N'castle Jet,8685,2,16,5,7,58,37,21,53
Melbourne C,8685,3,14,4,11,43,34,9,46
Melbourne V,8685,4,13,5,11,45,41,4,44
Adelaide Utd,8685,5,11,6,11,37,40,-3,39
Brisbane,8685,6,10,5,13,33,42,-9,35
Western Sydn,8685,7,8,9,10,38,47,-9,33
Perth Glory,8685,8,10,2,15,37,50,-13,32
Wellington P,8685,9,5,6,16,31,55,-24,21
CC Mariners,8685,10,4,8,15,28,49,-21,20
Sydney FC,8686,1,21,4,3,67,23,44,67
N'castle Jet,8686,2,16,5,7,58,37,21,53
Melbourne C,8686,3,14,4,11,43,34,9,46
Melbourne V,8686,4,13,5,11,46,41,5,44
Adelaide Utd,8686,5,11,6,11,37,40,-3,39
Brisbane,8686,6,10,5,13,33,42,-9,35
Western Sydn,8686,7,8,9,10,38,47,-9,33
Perth Glory,8686,8,10,2,15,37,50,-13,32
Wellington P,8686,9,5,6,16,31,55,-24,21
CC Mariners,8686,10,4,8,15,28,49,-21,20
Sydney FC,8687,1,20,5,3,66,24,42,65
N'castle Jet,8687,2,15,5,8,58,39,19,50
Melbourne C,8687,3,15,4,10,45,34,11,49
Melbourne V,8687,4,13,6,10,47,40,7,45
Adelaide Utd,8687,5,11,6,11,37,40,-3,39
Brisbane,8687,6,10,5,13,33,42,-9,35
Western Sydn,8687,7,8,9,10,38,47,-9,33
Perth Glory,8687,8,10,2,15,37,50,-13,32
Wellington P,8687,9,5,6,16,31,55,-24,21
CC Mariners,8687,10,4,8,15,28,49,-21,20
Sydney FC,8688,1,21,4,3,69,22,47,67
N'castle Jet,8688,2,15,5,8,57,38,19,50
Melbourne C,8688,3,15,4,10,44,33,11,49
Melbourne V,8688,4,13,5,11,45,43,2,44
Adelaide Utd,8688,5,11,6,11,37,40,-3,39
Brisbane,8688,6,10,5,13,33,42,-9,35
Western Sydn,8688,7,8,9,10,38,47,-9,33
Perth Glory,8688,8,10,2,15,37,50,-13,32
Wellington P,8688,9,5,6,16,31,55,-24,21
CC Mariners,8688,10,4,8,15,28,49,-21,20
Sydney FC,8689,1,20,5,3,65,23,42,65
N'castle Jet,8689,2,15,6,7,57,37,20,51
Melbourne C,8689,3,14,5,10,43,33,10,47
Melbourne V,8689,4,13,6,10,46,39,7,45
Adelaide Utd,8689,5,11,6,11,37,40,-3,39
Brisbane,8689,6,10,5,13,33,42,-9,35
Western Sydn,8689,7,8,9,10,38,47,-9,33
Perth Glory,8689,8,10,2,15,37,50,-13,32
Wellington P,8689,9,5,6,16,31,55,-24,21
CC Mariners,8689,10,4,8,15,28,49,-21,20
Sydney FC,8690,1,21,4,3,66,22,44,67
N'castle Jet,8690,2,15,5,8,59,42,17,50
Melbourne C,8690,3,15,4,10,48,35,13,49
Melbourne V,8690,4,13,5,11,45,40,5,44
Adelaide Utd,8690,5,11,6,11,37,40,-3,39
Brisbane,8690,6,10,5,13,33,42,-9,35
Western Sydn,8690,7,8,9,10,38,47,-9,33
Perth Glory,8690,8,10,2,15,37,50,-13,32
Wellington P,8690,9,5,6,16,31,55,-24,21
CC Mariners,8690,10,4,8,15,28,49,-21,20
Sydney FC,8691,1,21,4,3,65,22,43,67
N'castle Jet,8691,2,15,5,8,58,39,19,50
Melbourne C,8691,3,15,4,10,45,34,11,49
Melbourne V,8691,4,13,5,11,45,39,6,44
Adelaide Utd,8691,5,11,6,11,37,40,-3,39
Brisbane,8691,6,10,5,13,33,42,-9,35
Western Sydn,8691,7,8,9,10,38,47,-9,33
Perth Glory,8691,8,10,2,15,37,50,-13,32
Wellington P,8691,9,5,6,16,31,55,-24,21
CC Mariners,8691,10,4,8,15,28,49,-21,20
Sydney FC,8692,1,21,4,3,68,24,44,67
N'castle Jet,8692,2,16,5,7,59,38,21,53
Melbourne C,8692,3,14,4,11,44,35,9,46
Melbourne V,8692,4,13,5,11,47,42,5,44
Adelaide Utd,8692,5,11,6,11,37,40,-3,39
Brisbane,8692,6,10,5,13,33,42,-9,35
Western Sydn,8692,7,8,9,10,38,47,-9,33
Perth Glory,8692,8,10,2,15,37,50,-13,32
Wellington P,8692,9,5,6,16,31,55,-24,21
CC Mariners,8692,10,4,8,15,28,49,-21,20
Sydney FC,8693,1,20,5,3,65,23,42,65
N'castle Jet,8693,2,15,5,8,58,39,19,50
Melbourne C,8693,3,15,4,10,45,34,11,49
Melbourne V,8693,4,13,6,10,46,39,7,45
Adelaide Utd,8693,5,11,6,11,37,40,-3,39
Brisbane,8693,6,10,5,13,33,42,-9,35
Western Sydn,8693,7,8,9,10,38,47,-9,33
Perth Glory,8693,8,10,2,15,37,50,-13,32
Wellington P,8693,9,5,6,16,31,55,-24,21
CC Mariners,8693,10,4,8,15,28,49,-21,20
Sydney FC,8694,1,21,4,3,68,23,45,67
N'castle Jet,8694,2,16,5,7,61,39,22,53
Melbourne C,8694,3,14,4,11,45,37,8,46
Melbourne V,8694,4,13,5,11,46,42,4,44
Adelaide Utd,8694,5,11,6,11,37,40,-3,39
Brisbane,8694,6,10,5,13,33,42,-9,35
Western Sydn,8694,7,8,9,10,38,47,-9,33
Perth Glory,8694,8,10,2,15,37,50,-13,32
Wellington P,8694,9,5,6,16,31,55,-24,21
CC Mariners,8694,10,4,8,15,28,49,-21,20
Sydney FC,8695,1,21,4,3,65,22,43,67
N'castle Jet,8695,2,16,5,7,60,38,22,53
Melbourne C,8695,3,14,4,11,44,36,8,46
Melbourne V,8695,4,13,5,11,45,39,6,44
Adelaide Utd,8695,5,11,6,11,37,40,-3,39
Brisbane,8695,6,10,5,13,33,42,-9,35
Western Sydn,8695,7,8,9,10,38,47,-9,33
Perth Glory,8695,8,10,2,15,37,50,-13,32
Wellington P,8695,9,5,6,16,31,55,-24,21
CC Mariners,8695,10,4,8,15,28,49,-21,20
Sydney FC,8696,1,21,4,3,65,22,43,67
N'castle Jet,8696,2,15,5,8,59,40,19,50
Melbourne C,8696,3,15,4,10,46,35,11,49
Melbourne V,8696,4,13,5,11,45,39,6,44
Adelaide Utd,8696,5,11,6,11,37,40,-3,39
Brisbane,8696,6,10,5,13,33,42,-9,35
Western Sydn,8696,7,8,9,10,38,47,-9,33
Perth Glory,8696,8,10,2,15,37,50,-13,32
Wellington P,8696,9,5,6,16,31,55,-24,21
CC Mariners,8696,10,4,8,15,28,49,-21,20
Sydney FC,8697,1,21,4,3,66,23,43,67
N'castle Jet,8697,2,15,5,8,59,40,19,50
Melbourne C,8697,3,15,4,10,46,35,11,49
Melbourne V,8697,4,13,5,11,46,40,6,44
Adelaide Utd,8697,5,11,6,11,37,40,-3,39
Brisbane,8697,6,10,5,13,33,42,-9,35
Western Sydn,8697,7,8,9,10,38,47,-9,33
Perth Glory,8697,8,10,2,15,37,50,-13,32
Wellington P,8697,9,5,6,16,31,55,-24,21
CC Mariners,8697,10,4,8,15,28,49,-21,20
Sydney FC,8698,1,21,4,3,68,23,45,67
N'castle Jet,8698,2,15,5,8,57,41,16,50
Melbourne C,8698,3,15,4,10,47,33,14,49
Melbourne V,8698,4,13,5,11,46,42,4,44
Adelaide Utd,8698,5,11,6,11,37,40,-3,39
Brisbane,8698,6,10,5,13,33,42,-9,35
Western Sydn,8698,7,8,9,10,38,47,-9,33
Perth Glory,8698,8,10,2,15,37,50,-13,32
Wellington P,8698,9,5,6,16,31,55,-24,21
CC Mariners,8698,10,4,8,15,28,49,-21,20
Sydney FC,8699,1,21,4,3,67,24,43,67
N'castle Jet,8699,2,15,6,7,58,38,20,51
Melbourne C,8699,3,14,5,10,44,34,10,47
Melbourne V,8699,4,13,5,11,47,41,6,44
Adelaide Utd,8699,5,11,6,11,37,40,-3,39
Brisbane,8699,6,10,5,13,33,42,-9,35
Western Sydn,8699,7,8,9,10,38,47,-9,33
Perth Glory,8699,8,10,2,15,37,50,-13,32
Wellington P,8699,9,5,6,16,31,55,-24,21
CC Mariners,8699,10,4,8,15,28,49,-21,20
Sydney FC,8700,1,21,4,3,67,24,43,67
N'castle Jet,8700,2,15,6,7,59,39,20,51
Melbourne C,8700,3,14,5,10,45,35,10,47
Melbourne V,8700,4,13,5,11,47,41,6,44
Adelaide Utd,8700,5,11,6,11,37,40,-3,39
Brisbane,8700,6,10,5,13,33,42,-9,35
Western Sydn,8700,7,8,9,10,38,47,-9,33
Perth Glory,8700,8,10,2,15,37,50,-13,32
Wellington P,8700,9,5,6,16,31,55,-24,21
CC Mariners,8700,10,4,8,15,28,49,-21,20
Sydney FC,8701,1,21,4,3,69,23,46,67
N'castle Jet,8701,2,15,6,7,60,40,20,51
Melbourne C,8701,3,14,5,10,46,36,10,47
Melbourne V,8701,4,13,5,11,46,43,3,44
Adelaide Utd,8701,5,11,6,11,37,40,-3,39
Brisbane,8701,6,10,5,13,33,42,-9,35
Western Sydn,8701,7,8,9,10,38,47,-9,33
Perth Glory,8701,8,10,2,15,37,50,-13,32
Wellington P,8701,9,5,6,16,31,55,-24,21
CC Mariners,8701,10,4,8,15,28,49,-21,20
Sydney FC,8702,1,21,4,3,69,22,47,67
N'castle Jet,8702,2,16,5,7,59,37,22,53
Melbourne C,8702,3,14,4,11,43,35,8,46
Melbourne V,8702,4,13,5,11,45,43,2,44
Adelaide Utd,8702,5,11,6,11,37,40,-3,39
Brisbane,8702,6,10,5,13,33,42,-9,35
Western Sydn,8702,7,8,9,10,38,47,-9,33
Perth Glory,8702,8,10,2,15,37,50,-13,32
Wellington P,8702,9,5,6,16,31,55,-24,21
CC Mariners,8702,10,4,8,15,28,49,-21,20
Sydney FC,8703,1,21,4,3,66,23,43,67
N'castle Jet,8703,2,16,5,7,61,37,24,53
Melbourne C,8703,3,14,4,11,43,37,6,46
Melbourne V,8703,4,13,5,11,46,40,6,44
Adelaide Utd,8703,5,11,6,11,37,40,-3,39
Brisbane,8703,6,10,5,13,33,42,-9,35
Western Sydn,8703,7,8,9,10,38,47,-9,33
Perth Glory,8703,8,10,2,15,37,50,-13,32
Wellington P,8703,9,5,6,16,31,55,-24,21
CC Mariners,8703,10,4,8,15,28,49,-21,20
Sydney FC,8704,1,21,4,3,66,22,44,67
N'castle Jet,8704,2,15,6,7,59,39,20,51
Melbourne C,8704,3,14,5,10,45,35,10,47
Melbourne V,8704,4,13,5,11,45,40,5,44
Adelaide Utd,8704,5,11,6,11,37,40,-3,39
Brisbane,8704,6,10,5,13,33,42,-9,35
Western Sydn,8704,7,8,9,10,38,47,-9,33
Perth Glory,8704,8,10,2,15,37,50,-13,32
Wellington P,8704,9,5,6,16,31,55,-24,21
CC Mariners,8704,10,4,8,15,28,49,-21,20
Sydney FC,8705,1,21,4,3,67,23,44,67
N'castle Jet,8705,2,16,5,7,59,38,21,53
Melbourne C,8705,3,14,4,11,44,35,9,46
Melbourne V,8705,4,13,5,11,46,41,5,44
Adelaide Utd,8705,5,11,6,11,37,40,-3,39
Brisbane,8705,6,10,5,13,33,42,-9,35
Western Sydn,8705,7,8,9,10,38,47,-9,33
Perth Glory,8705,8,10,2,15,37,50,-13,32
Wellington P,8705,9,5,6,16,31,55,-24,21
CC Mariners,8705,10,4,8,15,28,49,-21,20
Sydney FC,8706,1,21,4,3,67,24,43,67
N'castle Jet,8706,2,15,6,7,57,37,20,51
Melbourne C,8706,3,14,5,10,43,33,10,47
Melbourne V,8706,4,13,5,11,47,41,6,44
Adelaide Utd,8706,5,11,6,11,37,40,-3,39
Brisbane,8706,6,10,5,13,33,42,-9,35
Western Sydn,8706,7,8,9,10,38,47,-9,33
Perth Glory,8706,8,10,2,15,37,50,-13,32
Wellington P,8706,9,5,6,16,31,55,-24,21
CC Mariners,8706,10,4,8,15,28,49,-21,20
Sydney FC,8707,1,21,4,3,65,22,43,67
N'castle Jet,8707,2,16,5,7,62,38,24,53
Melbourne C,8707,3,14,4,11,44,38,6,46
Melbourne V,8707,4,13,5,11,45,39,6,44
Adelaide Utd,8707,5,11,6,11,37,40,-3,39
Brisbane,8707,6,10,5,13,33,42,-9,35
Western Sydn,8707,7,8,9,10,38,47,-9,33
Perth Glory,8707,8,10,2,15,37,50,-13,32
Wellington P,8707,9,5,6,16,31,55,-24,21
CC Mariners,8707,10,4,8,15,28,49,-21,20
Sydney FC,8708,1,21,4,3,67,22,45,67
N'castle Jet,8708,2,15,5,8,59,41,18,50
Melbourne C,8708,3,15,4,10,47,35,12,49
Melbourne V,8708,4,13,5,11,45,41,4,44
Adelaide Utd,8708,5,11,6,11,37,40,-3,39
Brisbane,8708,6,10,5,13,33,42,-9,35
Western Sydn,8708,7,8,9,10,38,47,-9,33
Perth Glory,8708,8,10,2,15,37,50,-13,32
Wellington P,8708,9,5,6,16,31,55,-24,21
CC Mariners,8708,10,4,8,15,28,49,-21,20
Sydney FC,8709,1,20,5,3,65,23,42,65
N'castle Jet,8709,2,15,6,7,59,39,20,51
Melbourne C,8709,3,14,5,10,45,35,10,47
Melbourne V,8709,4,13,6,10,46,39,7,45
Adelaide Utd,8709,5,11,6,11,37,40,-3,39
Brisbane,8709,6,10,5,13,33,42,-9,35
Western Sydn,8709,7,8,9,10,38,47,-9,33
Perth Glory,8709,8,10,2,15,37,50,-13,32
Wellington P,8709,9,5,6,16,31,55,-24,21
CC Mariners,8709,10,4,8,15,28,49,-21,20
Sydney FC,8710,1,20,4,4,64,23,41,64
N'castle Jet,8710,2,15,5,8,57,39,18,50
Melbourne C,8710,3,15,4,10,45,33,12,49
Melbourne V,8710,4,14,5,10,46,38,8,47
Adelaide Utd,8710,5,11,6,11,37,40,-3,39
Brisbane,8710,6,10,5,13,33,42,-9,35
Western Sydn,8710,7,8,9,10,38,47,-9,33
Perth Glory,8710,8,10,2,15,37,50,-13,32
Wellington P,8710,9,5,6,16,31,55,-24,21
CC Mariners,8710,10,4,8,15,28,49,-21,20
Sydney FC,8711,1,21,4,3,69,22,47,67
N'castle Jet,8711,2,16,5,7,59,37,22,53
Melbourne C,8711,3,14,4,11,43,35,8,46
Melbourne V,8711,4,13,5,11,45,43,2,44
Adelaide Utd,8711,5,11,6,11,37,40,-3,39
Brisbane,8711,6,10,5,13,33,42,-9,35
Western Sydn,8711,7,8,9,10,38,47,-9,33
Perth Glory,8711,8,10,2,15,37,50,-13,32
Wellington P,8711,9,5,6,16,31,55,-24,21
CC Mariners,8711,10,4,8,15,28,49,-21,20
Sydney FC,8712,1,21,4,3,66,23,43,67
N'castle Jet,8712,2,16,5,7,60,39,21,53
Melbourne C,8712,3,14,4,11,45,36,9,46
Melbourne V,8712,4,13,5,11,46,40,6,44
Adelaide Utd,8712,5,11,6,11,37,40,-3,39
Brisbane,8712,6,10,5,13,33,42,-9,35
Western Sydn,8712,7,8,9,10,38,47,-9,33
Perth Glory,8712,8,10,2,15,37,50,-13,32
Wellington P,8712,9,5,6,16,31,55,-24,21
CC Mariners,8712,10,4,8,15,28,49,-21,20
Sydney FC,8713,1,21,4,3,65,22,43,67
N'castle Jet,8713,2,16,5,7,58,37,21,53
Melbourne C,8713,3,14,4,11,43,34,9,46
Melbourne V,8713,4,13,5,11,45,39,6,44
Adelaide Utd,8713,5,11,6,11,37,40,-3,39
Brisbane,8713,6,10,5,13,33,42,-9,35
Western Sydn,8713,7,8,9,10,38,47,-9,33
Perth Glory,8713,8,10,2,15,37,50,-13,32
Wellington P,8713,9,5,6,16,31,55,-24,21
CC Mariners,8713,10,4,8,15,28,49,-21,20
Sydney FC,8714,1,20,4,4,65,24,41,64
N'castle Jet,8714,2,15,5,8,57,38,19,50
Melbourne C,8714,3,15,4,10,44,33,11,49
Melbourne V,8714,4,14,5,10,47,39,8,47
Adelaide Utd,8714,5,11,6,11,37,40,-3,39
Brisbane,8714,6,10,5,13,33,42,-9,35
Western Sydn,8714,7,8,9,10,38,47,-9,33
Perth Glory,8714,8,10,2,15,37,50,-13,32
Wellington P,8714,9,5,6,16,31,55,-24,21
CC Mariners,8714,10,4,8,15,28,49,-21,20
Sydney FC,8715,1,21,4,3,66,22,44,67
N'castle Jet,8715,2,15,5,8,58,40,18,50
Melbourne C,8715,3,15,4,10,46,34,12,49
Melbourne V,8715,4,13,5,11,45,40,5,44
Adelaide Utd,8715,5,11,6,11,37,40,-3,39
Brisbane,8715,6,10,5,13,33,42,-9,35
Western Sydn,8715,7,8,9,10,38,47,-9,33
Perth Glory,8715,8,10,2,15,37,50,-13,32
Wellington P,8715,9,5,6,16,31,55,-24,21
CC Mariners,8715,10,4,8,15,28,49,-21,20
Sydney FC,8716,1,20,5,3,64,22,42,65
N'castle Jet,8716,2,15,6,7,57,37,20,51
Melbourne C,8716,3,14,5,10,43,33,10,47
Melbourne V,8716,4,13,6,10,45,38,7,45
Adelaide Utd,8716,5,11,6,11,37,40,-3,39
Brisbane,8716,6,10,5,13,33,42,-9,35
Western Sydn,8716,7,8,9,10,38,47,-9,33
Perth Glory,8716,8,10,2,15,37,50,-13,32
Wellington P,8716,9,5,6,16,31,55,-24,21
CC Mariners,8716,10,4,8,15,28,49,-21,20
Sydney FC,8717,1,20,4,4,64,23,41,64
N'castle Jet,8717,2,16,5,7,61,39,22,53
Melbourne V,8717,3,14,5,10,46,38,8,47
Melbourne C,8717,4,14,4,11,45,37,8,46
Adelaide Utd,8717,5,11,6,11,37,40,-3,39
Brisbane,8717,6,10,5,13,33,42,-9,35
Western Sydn,8717,7,8,9,10,38,47,-9,33
Perth Glory,8717,8,10,2,15,37,50,-13,32
Wellington P,8717,9,5,6,16,31,55,-24,21
CC Mariners,8717,10,4,8,15,28,49,-21,20
Sydney FC,8718,1,21,4,3,67,23,44,67
N'castle Jet,8718,2,15,6,7,58,38,20,51
Melbourne C,8718,3,14,5,10,44,34,10,47
Melbourne V,8718,4,13,5,11,46,41,5,44
Adelaide Utd,8718,5,11,6,11,37,40,-3,39
Brisbane,8718,6,10,5,13,33,42,-9,35
Western Sydn,8718,7,8,9,10,38,47,-9,33
Perth Glory,8718,8,10,2,15,37,50,-13,32
Wellington P,8718,9,5,6,16,31,55,-24,21
CC Mariners,8718,10,4,8,15,28,49,-21,20
Sydney FC,8719,1,20,5,3,66,24,42,65
N'castle Jet,8719,2,16,5,7,60,38,22,53
Melbourne C,8719,3,14,4,11,44,36,8,46
Melbourne V,8719,4,13,6,10,47,40,7,45
Adelaide Utd,8719,5,11,6,11,37,40,-3,39
Brisbane,8719,6,10,5,13,33,42,-9,35
Western Sydn,8719,7,8,9,10,38,47,-9,33
Perth Glory,8719,8,10,2,15,37,50,-13,32
Wellington P,8719,9,5,6,16,31,55,-24,21
CC Mariners,8719,10,4,8,15,28,49,-21,20
Sydney FC,8720,1,21,4,3,69,22,47,67
N'castle Jet,8720,2,16,5,7,58,37,21,53
Melbourne C,8720,3,14,4,11,43,34,9,46
Melbourne V,8720,4,13,5,11,45,43,2,44
Adelaide Utd,8720,5,11,6,11,37,40,-3,39
Brisbane,8720,6,10,5,13,33,42,-9,35
Western Sydn,8720,7,8,9,10,38,47,-9,33
Perth Glory,8720,8,10,2,15,37,50,-13,32
Wellington P,8720,9,5,6,16,31,55,-24,21
CC Mariners,8720,10,4,8,15,28,49,-21,20
Sydney FC,8721,1,21,4,3,65,22,43,67
N'castle Jet,8721,2,16,5,7,61,39,22,53
Melbourne C,8721,3,14,4,11,45,37,8,46
Melbourne V,8721,4,13,5,11,45,39,6,44
Adelaide Utd,8721,5,11,6,11,37,40,-3,39
Brisbane,8721,6,10,5,13,33,42,-9,35
Western Sydn,8721,7,8,9,10,38,47,-9,33
Perth Glory,8721,8,10,2,15,37,50,-13,32
Wellington P,8721,9,5,6,16,31,55,-24,21
CC Mariners,8721,10,4,8,15,28,49,-21,20
Sydney FC,8722,1,21,4,3,66,22,44,67
N'castle Jet,8722,2,15,6,7,59,39,20,51
Melbourne C,8722,3,14,5,10,45,35,10,47
Melbourne V,8722,4,13,5,11,45,40,5,44
Adelaide Utd,8722,5,11,6,11,37,40,-3,39
Brisbane,8722,6,10,5,13,33,42,-9,35
Western Sydn,8722,7,8,9,10,38,47,-9,33
Perth Glory,8722,8,10,2,15,37,50,-13,32
Wellington P,8722,9,5,6,16,31,55,-24,21
CC Mariners,8722,10,4,8,15,28,49,-21,20
Sydney FC,8723,1,21,4,3,66,23,43,67
N'castle Jet,8723,2,15,5,8,58,40,18,50
Melbourne C,8723,3,15,4,10,46,34,12,49
Melbourne V,8723,4,13,5,11,46,40,6,44
Adelaide Utd,8723,5,11,6,11,37,40,-3,39
Brisbane,8723,6,10,5,13,33,42,-9,35
Western Sydn,8723,7,8,9,10,38,47,-9,33
Perth Glory,8723,8,10,2,15,37,50,-13,32
Wellington P,8723,9,5,6,16,31,55,-24,21
CC Mariners,8723,10,4,8,15,28,49,-21,20
Sydney FC,8724,1,21,4,3,69,22,47,67
N'castle Jet,8724,2,15,5,8,58,39,19,50
Melbourne C,8724,3,15,4,10,45,34,11,49
Melbourne V,8724,4,13,5,11,45,43,2,44
Adelaide Utd,8724,5,11,6,11,37,40,-3,39
Brisbane,8724,6,10,5,13,33,42,-9,35
Western Sydn,8724,7,8,9,10,38,47,-9,33
Perth Glory,8724,8,10,2,15,37,50,-13,32
Wellington P,8724,9,5,6,16,31,55,-24,21
CC Mariners,8724,10,4,8,15,28,49,-21,20
Sydney FC,8725,1,20,5,3,64,22,42,65
N'castle Jet,8725,2,15,5,8,59,40,19,50
Melbourne C,8725,3,15,4,10,46,35,11,49
Melbourne V,8725,4,13,6,10,45,38,7,45
Adelaide Utd,8725,5,11,6,11,37,40,-3,39
Brisbane,8725,6,10,5,13,33,42,-9,35
Western Sydn,8725,7,8,9,10,38,47,-9,33
Perth Glory,8725,8,10,2,15,37,50,-13,32
Wellington P,8725,9,5,6,16,31,55,-24,21
CC Mariners,8725,10,4,8,15,28,49,-21,20
Sydney FC,8726,1,21,4,3,65,22,43,67
N'castle Jet,8726,2,15,5,8,57,38,19,50
Melbourne C,8726,3,15,4,10,44,33,11,49
Melbourne V,8726,4,13,5,11,45,39,6,44
Adelaide Utd,8726,5,11,6,11,37,40,-3,39
Brisbane,8726,6,10,5,13,33,42,-9,35
Western Sydn,8726,7,8,9,10,38,47,-9,33
Perth Glory,8726,8,10,2,15,37,50,-13,32
Wellington P,8726,9,5,6,16,31,55,-24,21
CC Mariners,8726,10,4,8,15,28,49,-21,20
Sydney FC,8727,1,21,4,3,65,22,43,67
N'castle Jet,8727,2,16,5,7,58,37,21,53
Melbourne C,8727,3,14,4,11,43,34,9,46
Melbourne V,8727,4,13,5,11,45,39,6,44
Adelaide Utd,8727,5,11,6,11,37,40,-3,39
Brisbane,8727,6,10,5,13,33,42,-9,35
Western Sydn,8727,7,8,9,10,38,47,-9,33
Perth Glory,8727,8,10,2,15,37,50,-13,32
Wellington P,8727,9,5,6,16,31,55,-24,21
CC Mariners,8727,10,4,8,15,28,49,-21,20
Sydney FC,8728,1,21,4,3,68,22,46,67
N'castle Jet,8728,2,15,6,7,58,38,20,51
Melbourne C,8728,3,14,5,10,44,34,10,47
Melbourne V,8728,4,13,5,11,45,42,3,44
Adelaide Utd,8728,5,11,6,11,37,40,-3,39
Brisbane,8728,6,10,5,13,33,42,-9,35
Western Sydn,8728,7,8,9,10,38,47,-9,33
Perth Glory,8728,8,10,2,15,37,50,-13,32
Wellington P,8728,9,5,6,16,31,55,-24,21
CC Mariners,8728,10,4,8,15,28,49,-21,20
Sydney FC,8729,1,20,5,3,67,25,42,65
N'castle Jet,8729,2,16,5,7,59,37,22,53
Melbourne C,8729,3,14,4,11,43,35,8,46
Melbourne V,8729,4,13,6,10,48,41,7,45
Adelaide Utd,8729,5,11,6,11,37,40,-3,39
Brisbane,8729,6,10,5,13,33,42,-9,35
Western Sydn,8729,7,8,9,10,38,47,-9,33
Perth Glory,8729,8,10,2,15,37,50,-13,32
Wellington P,8729,9,5,6,16,31,55,-24,21
CC Mariners,8729,10,4,8,15,28,49,-21,20
Sydney FC,8730,1,21,4,3,66,22,44,67
N'castle Jet,8730,2,15,5,8,58,39,19,50
Melbourne C,8730,3,15,4,10,45,34,11,49
Melbourne V,8730,4,13,5,11,45,40,5,44
Adelaide Utd,8730,5,11,6,11,37,40,-3,39
Brisbane,8730,6,10,5,13,33,42,-9,35
Western Sydn,8730,7,8,9,10,38,47,-9,33
Perth Glory,8730,8,10,2,15,37,50,-13,32
Wellington P,8730,9,5,6,16,31,55,-24,21
CC Mariners,8730,10,4,8,15,28,49,-21,20
Sydney FC,8731,1,21,4,3,67,23,44,67
N'castle Jet,8731,2,15,5,8,57,38,19,50
Melbourne C,8731,3,15,4,10,44,33,11,49
Melbourne V,8731,4,13,5,11,46,41,5,44
Adelaide Utd,8731,5,11,6,11,37,40,-3,39
Brisbane,8731,6,10,5,13,33,42,-9,35
Western Sydn,8731,7,8,9,10,38,47,-9,33
Perth Glory,8731,8,10,2,15,37,50,-13,32
Wellington P,8731,9,5,6,16,31,55,-24,21
CC Mariners,8731,10,4,8,15,28,49,-21,20
Sydney FC,8732,1,20,5,3,65,23,42,65
N'castle Jet,8732,2,16,5,7,59,38,21,53
Melbourne C,8732,3,14,4,11,44,35,9,46
Melbourne V,8732,4,13,6,10,46,39,7,45
Adelaide Utd,8732,5,11,6,11,37,40,-3,39
Brisbane,8732,6,10,5,13,33,42,-9,35
Western Sydn,8732,7,8,9,10,38,47,-9,33
Perth Glory,8732,8,10,2,15,37,50,-13,32
Wellington P,8732,9,5,6,16,31,55,-24,21
CC Mariners,8732,10,4,8,15,28,49,-21,20
Sydney FC,8733,1,21,4,3,68,24,44,67
N'castle Jet,8733,2,15,5,8,57,40,17,50
Melbourne C,8733,3,15,4,10,46,33,13,49
Melbourne V,8733,4,13,5,11,47,42,5,44
Adelaide Utd,8733,5,11,6,11,37,40,-3,39
Brisbane,8733,6,10,5,13,33,42,-9,35
Western Sydn,8733,7,8,9,10,38,47,-9,33
Perth Glory,8733,8,10,2,15,37,50,-13,32
Wellington P,8733,9,5,6,16,31,55,-24,21
CC Mariners,8733,10,4,8,15,28,49,-21,20
Sydney FC,8734,1,21,4,3,65,22,43,67
N'castle Jet,8734,2,16,5,7,59,38,21,53
Melbourne C,8734,3,14,4,11,44,35,9,46
Melbourne V,8734,4,13,5,11,45,39,6,44
Adelaide Utd,8734,5,11,6,11,37,40,-3,39
Brisbane,8734,6,10,5,13,33,42,-9,35
Western Sydn,8734,7,8,9,10,38,47,-9,33
Perth Glory,8734,8,10,2,15,37,50,-13,32
Wellington P,8734,9,5,6,16,31,55,-24,21
CC Mariners,8734,10,4,8,15,28,49,-21,20
Sydney FC,8735,1,21,4,3,65,22,43,67
N'castle Jet,8735,2,16,5,7,59,38,21,53
Melbourne C,8735,3,14,4,11,44,35,9,46
Melbourne V,8735,4,13,5,11,45,39,6,44
Adelaide Utd,8735,5,11,6,11,37,40,-3,39
Brisbane,8735,6,10,5,13,33,42,-9,35
Western Sydn,8735,7,8,9,10,38,47,-9,33
Perth Glory,8735,8,10,2,15,37,50,-13,32
Wellington P,8735,9,5,6,16,31,55,-24,21
CC Mariners,8735,10,4,8,15,28,49,-21,20
Sydney FC,8736,1,21,4,3,68,22,46,67
N'castle Jet,8736,2,15,5,8,58,40,18,50
Melbourne C,8736,3,15,4,10,46,34,12,49
Melbourne V,8736,4,13,5,11,45,42,3,44
Adelaide Utd,8736,5,11,6,11,37,40,-3,39
Brisbane,8736,6,10,5,13,33,42,-9,35
Western Sydn,8736,7,8,9,10,38,47,-9,33
Perth Glory,8736,8,10,2,15,37,50,-13,32
Wellington P,8736,9,5,6,16,31,55,-24,21
CC Mariners,8736,10,4,8,15,28,49,-21,20
Sydney FC,8737,1,20,5,3,65,23,42,65
N'castle Jet,8737,2,15,6,7,58,38,20,51
Melbourne C,8737,3,14,5,10,44,34,10,47
Melbourne V,8737,4,13,6,10,46,39,7,45
Adelaide Utd,8737,5,11,6,11,37,40,-3,39
Brisbane,8737,6,10,5,13,33,42,-9,35
Western Sydn,8737,7,8,9,10,38,47,-9,33
Perth Glory,8737,8,10,2,15,37,50,-13,32
Wellington P,8737,9,5,6,16,31,55,-24,21
CC Mariners,8737,10,4,8,15,28,49,-21,20
Sydney FC,8738,1,20,5,3,64,22,42,65
N'castle Jet,8738,2,15,5,8,58,39,19,50
Melbourne C,8738,3,15,4,10,45,34,11,49
Melbourne V,8738,4,13,6,10,45,38,7,45
Adelaide Utd,8738,5,11,6,11,37,40,-3,39
Brisbane,8738,6,10,5,13,33,42,-9,35
Western Sydn,8738,7,8,9,10,38,47,-9,33
Perth Glory,8738,8,10,2,15,37,50,-13,32
Wellington P,8738,9,5,6,16,31,55,-24,21
CC Mariners,8738,10,4,8,15,28,49,-21,20
Sydney FC,8739,1,21,4,3,67,23,44,67
N'castle Jet,8739,2,16,5,7,60,39,21,53
Melbourne C,8739,3,14,4,11,45,36,9,46
Melbourne V,8739,4,13,5,11,46,41,5,44
Adelaide Utd,8739,5,11,6,11,37,40,-3,39
Brisbane,8739,6,10,5,13,33,42,-9,35
Western Sydn,8739,7,8,9,10,38,47,-9,33
Perth Glory,8739,8,10,2,15,37,50,-13,32
Wellington P,8739,9,5,6,16,31,55,-24,21
CC Mariners,8739,10,4,8,15,28,49,-21,20
Sydney FC,8740,1,20,5,3,65,23,42,65
N'castle Jet,8740,2,16,5,7,61,37,24,53
Melbourne C,8740,3,14,4,11,43,37,6,46
Melbourne V,8740,4,13,6,10,46,39,7,45
Adelaide Utd,8740,5,11,6,11,37,40,-3,39
Brisbane,8740,6,10,5,13,33,42,-9,35
Western Sydn,8740,7,8,9,10,38,47,-9,33
Perth Glory,8740,8,10,2,15,37,50,-13,32
Wellington P,8740,9,5,6,16,31,55,-24,21
CC Mariners,8740,10,4,8,15,28,49,-21,20
Sydney FC,8741,1,20,4,4,67,26,41,64
N'castle Jet,8741,2,15,5,8,59,40,19,50
Melbourne C,8741,3,15,4,10,46,35,11,49
Melbourne V,8741,4,14,5,10,49,41,8,47
Adelaide Utd,8741,5,11,6,11,37,40,-3,39
Brisbane,8741,6,10,5,13,33,42,-9,35
Western Sydn,8741,7,8,9,10,38,47,-9,33
Perth Glory,8741,8,10,2,15,37,50,-13,32
Wellington P,8741,9,5,6,16,31,55,-24,21
CC Mariners,8741,10,4,8,15,28,49,-21,20
Sydney FC,8742,1,21,4,3,69,26,43,67
N'castle Jet,8742,2,16,5,7,58,37,21,53
Melbourne C,8742,3,14,4,11,43,34,9,46
Melbourne V,8742,4,13,5,11,49,43,6,44
Adelaide Utd,8742,5,11,6,11,37,40,-3,39
Brisbane,8742,6,10,5,13,33,42,-9,35
Western Sydn,8742,7,8,9,10,38,47,-9,33
Perth Glory,8742,8,10,2,15,37,50,-13,32
Wellington P,8742,9,5,6,16,31,55,-24,21
CC Mariners,8742,10,4,8,15,28,49,-21,20
Sydney FC,8743,1,21,4,3,65,22,43,67
N'castle Jet,8743,2,16,5,7,60,38,22,53
Melbourne C,8743,3,14,4,11,44,36,8,46
Melbourne V,8743,4,13,5,11,45,39,6,44
Adelaide Utd,8743,5,11,6,11,37,40,-3,39
Brisbane,8743,6,10,5,13,33,42,-9,35
Western Sydn,8743,7,8,9,10,38,47,-9,33
Perth Glory,8743,8,10,2,15,37,50,-13,32
Wellington P,8743,9,5,6,16,31,55,-24,21
CC Mariners,8743,10,4,8,15,28,49,-21,20
Sydney FC,8744,1,21,4,3,68,24,44,67
N'castle Jet,8744,2,15,6,7,59,39,20,51
Melbourne C,8744,3,14,5,10,45,35,10,47
Melbourne V,8744,4,13,5,11,47,42,5,44
Adelaide Utd,8744,5,11,6,11,37,40,-3,39
Brisbane,8744,6,10,5,13,33,42,-9,35
Western Sydn,8744,7,8,9,10,38,47,-9,33
Perth Glory,8744,8,10,2,15,37,50,-13,32
Wellington P,8744,9,5,6,16,31,55,-24,21
CC Mariners,8744,10,4,8,15,28,49,-21,20
Sydney FC,8745,1,20,5,3,64,22,42,65
N'castle Jet,8745,2,15,5,8,57,38,19,50
Melbourne C,8745,3,15,4,10,44,33,11,49
Melbourne V,8745,4,13,6,10,45,38,7,45
Adelaide Utd,8745,5,11,6,11,37,40,-3,39
Brisbane,8745,6,10,5,13,33,42,-9,35
Western Sydn,8745,7,8,9,10,38,47,-9,33
Perth Glory,8745,8,10,2,15,37,50,-13,32
Wellington P,8745,9,5,6,16,31,55,-24,21
CC Mariners,8745,10,4,8,15,28,49,-21,20
Sydney FC,8746,1,21,4,3,70,22,48,67
N'castle Jet,8746,2,16,5,7,60,38,22,53
Melbourne C,8746,3,14,4,11,44,36,8,46
Melbourne V,8746,4,13,5,11,45,44,1,44
Adelaide Utd,8746,5,11,6,11,37,40,-3,39
Brisbane,8746,6,10,5,13,33,42,-9,35
Western Sydn,8746,7,8,9,10,38,47,-9,33
Perth Glory,8746,8,10,2,15,37,50,-13,32
Wellington P,8746,9,5,6,16,31,55,-24,21
CC Mariners,8746,10,4,8,15,28,49,-21,20
Sydney FC,8747,1,20,4,4,64,23,41,64
N'castle Jet,8747,2,15,5,8,58,39,19,50
Melbourne C,8747,3,15,4,10,45,34,11,49
Melbourne V,8747,4,14,5,10,46,38,8,47
Adelaide Utd,8747,5,11,6,11,37,40,-3,39
Brisbane,8747,6,10,5,13,33,42,-9,35
Western Sydn,8747,7,8,9,10,38,47,-9,33
Perth Glory,8747,8,10,2,15,37,50,-13,32
Wellington P,8747,9,5,6,16,31,55,-24,21
CC Mariners,8747,10,4,8,15,28,49,-21,20
Sydney FC,8748,1,21,4,3,67,22,45,67
N'castle Jet,8748,2,15,6,7,57,37,20,51
Melbourne C,8748,3,14,5,10,43,33,10,47
Melbourne V,8748,4,13,5,11,45,41,4,44
Adelaide Utd,8748,5,11,6,11,37,40,-3,39
Brisbane,8748,6,10,5,13,33,42,-9,35
Western Sydn,8748,7,8,9,10,38,47,-9,33
Perth Glory,8748,8,10,2,15,37,50,-13,32
Wellington P,8748,9,5,6,16,31,55,-24,21
CC Mariners,8748,10,4,8,15,28,49,-21,20
Sydney FC,8749,1,20,4,4,65,24,41,64
N'castle Jet,8749,2,15,6,7,57,37,20,51
Melbourne C,8749,3,14,5,10,43,33,10,47
Melbourne V,8749,4,14,5,10,47,39,8,47
Adelaide Utd,8749,5,11,6,11,37,40,-3,39
Brisbane,8749,6,10,5,13,33,42,-9,35
Western Sydn,8749,7,8,9,10,38,47,-9,33
Perth Glory,8749,8,10,2,15,37,50,-13,32
Wellington P,8749,9,5,6,16,31,55,-24,21
CC Mariners,8749,10,4,8,15,28,49,-21,20
Sydney FC,8750,1,20,5,3,65,23,42,65
N'castle Jet,8750,2,15,5,8,57,39,18,50
Melbourne C,8750,3,15,4,10,45,33,12,49
Melbourne V,8750,4,13,6,10,46,39,7,45
Adelaide Utd,8750,5,11,6,11,37,40,-3,39
Brisbane,8750,6,10,5,13,33,42,-9,35
Western Sydn,8750,7,8,9,10,38,47,-9,33
Perth Glory,8750,8,10,2,15,37,50,-13,32
Wellington P,8750,9,5,6,16,31,55,-24,21
CC Mariners,8750,10,4,8,15,28,49,-21,20
Sydney FC,8751,1,21,4,3,66,23,43,67
N'castle Jet,8751,2,16,5,7,58,37,21,53
Melbourne C,8751,3,14,4,11,43,34,9,46
Melbourne V,8751,4,13,5,11,46,40,6,44
Adelaide Utd,8751,5,11,6,11,37,40,-3,39
Brisbane,8751,6,10,5,13,33,42,-9,35
Western Sydn,8751,7,8,9,10,38,47,-9,33
Perth Glory,8751,8,10,2,15,37,50,-13,32
Wellington P,8751,9,5,6,16,31,55,-24,21
CC Mariners,8751,10,4,8,15,28,49,-21,20
Sydney FC,8752,1,21,4,3,68,23,45,67
N'castle Jet,8752,2,15,6,7,57,37,20,51
Melbourne C,8752,3,14,5,10,43,33,10,47
Melbourne V,8752,4,13,5,11,46,42,4,44
Adelaide Utd,8752,5,11,6,11,37,40,-3,39
Brisbane,8752,6,10,5,13,33,42,-9,35
Western Sydn,8752,7,8,9,10,38,47,-9,33
Perth Glory,8752,8,10,2,15,37,50,-13,32
Wellington P,8752,9,5,6,16,31,55,-24,21
CC Mariners,8752,10,4,8,15,28,49,-21,20
Sydney FC,8753,1,21,4,3,68,23,45,67
N'castle Jet,8753,2,16,5,7,60,39,21,53
Melbourne C,8753,3,14,4,11,45,36,9,46
Melbourne V,8753,4,13,5,11,46,42,4,44
Adelaide Utd,8753,5,11,6,11,37,40,-3,39
Brisbane,8753,6,10,5,13,33,42,-9,35
Western Sydn,8753,7,8,9,10,38,47,-9,33
Perth Glory,8753,8,10,2,15,37,50,-13,32
Wellington P,8753,9,5,6,16,31,55,-24,21
CC Mariners,8753,10,4,8,15,28,49,-21,20
Sydney FC,8754,1,21,4,3,66,22,44,67
N'castle Jet,8754,2,15,5,8,58,39,19,50
Melbourne C,8754,3,15,4,10,45,34,11,49
Melbourne V,8754,4,13,5,11,45,40,5,44
Adelaide Utd,8754,5,11,6,11,37,40,-3,39
Brisbane,8754,6,10,5,13,33,42,-9,35
Western Sydn,8754,7,8,9,10,38,47,-9,33
Perth Glory,8754,8,10,2,15,37,50,-13,32
Wellington P,8754,9,5,6,16,31,55,-24,21
CC Mariners,8754,10,4,8,15,28,49,-21,20
Sydney FC,8755,1,20,4,4,66,25,41,64
N'castle Jet,8755,2,16,5,7,59,38,21,53
Melbourne V,8755,3,14,5,10,48,40,8,47
Melbourne C,8755,4,14,4,11,44,35,9,46
Adelaide Utd,8755,5,11,6,11,37,40,-3,39
Brisbane,8755,6,10,5,13,33,42,-9,35
Western Sydn,8755,7,8,9,10,38,47,-9,33
Perth Glory,8755,8,10,2,15,37,50,-13,32
Wellington P,8755,9,5,6,16,31,55,-24,21
CC Mariners,8755,10,4,8,15,28,49,-21,20
Sydney FC,8756,1,20,4,4,64,24,40,64
N'castle Jet,8756,2,16,5,7,62,38,24,53
Melbourne V,8756,3,14,5,10,47,38,9,47
Melbourne C,8756,4,14,4,11,44,38,6,46
Adelaide Utd,8756,5,11,6,11,37,40,-3,39
Brisbane,8756,6,10,5,13,33,42,-9,35
Western Sydn,8756,7,8,9,10,38,47,-9,33
Perth Glory,8756,8,10,2,15,37,50,-13,32
Wellington P,8756,9,5,6,16,31,55,-24,21
CC Mariners,8756,10,4,8,15,28,49,-21,20
Sydney FC,8757,1,21,4,3,66,22,44,67
N'castle Jet,8757,2,15,5,8,57,38,19,50
Melbourne C,8757,3,15,4,10,44,33,11,49
Melbourne V,8757,4,13,5,11,45,40,5,44
Adelaide Utd,8757,5,11,6,11,37,40,-3,39
Brisbane,8757,6,10,5,13,33,42,-9,35
Western Sydn,8757,7,8,9,10,38,47,-9,33
Perth Glory,8757,8,10,2,15,37,50,-13,32
Wellington P,8757,9,5,6,16,31,55,-24,21
CC Mariners,8757,10,4,8,15,28,49,-21,20
Sydney FC,8758,1,21,4,3,65,22,43,67
N'castle Jet,8758,2,15,5,8,58,39,19,50
Melbourne C,8758,3,15,4,10,45,34,11,49
Melbourne V,8758,4,13,5,11,45,39,6,44
Adelaide Utd,8758,5,11,6,11,37,40,-3,39
Brisbane,8758,6,10,5,13,33,42,-9,35
Western Sydn,8758,7,8,9,10,38,47,-9,33
Perth Glory,8758,8,10,2,15,37,50,-13,32
Wellington P,8758,9,5,6,16,31,55,-24,21
CC Mariners,8758,10,4,8,15,28,49,-21,20
Sydney FC,8759,1,21,4,3,66,23,43,67
N'castle Jet,8759,2,15,6,7,58,38,20,51
Melbourne C,8759,3,14,5,10,44,34,10,47
Melbourne V,8759,4,13,5,11,46,40,6,44
Adelaide Utd,8759,5,11,6,11,37,40,-3,39
Brisbane,8759,6,10,5,13,33,42,-9,35
Western Sydn,8759,7,8,9,10,38,47,-9,33
Perth Glory,8759,8,10,2,15,37,50,-13,32
Wellington P,8759,9,5,6,16,31,55,-24,21
CC Mariners,8759,10,4,8,15,28,49,-21,20
Sydney FC,8760,1,21,4,3,67,23,44,67
N'castle Jet,8760,2,15,5,8,57,38,19,50
Melbourne C,8760,3,15,4,10,44,33,11,49
Melbourne V,8760,4,13,5,11,46,41,5,44
Adelaide Utd,8760,5,11,6,11,37,40,-3,39
Brisbane,8760,6,10,5,13,33,42,-9,35
Western Sydn,8760,7,8,9,10,38,47,-9,33
Perth Glory,8760,8,10,2,15,37,50,-13,32
Wellington P,8760,9,5,6,16,31,55,-24,21
CC Mariners,8760,10,4,8,15,28,49,-21,20
Sydney FC,8761,1,21,4,3,70,25,45,67
N'castle Jet,8761,2,15,6,7,59,39,20,51
Melbourne C,8761,3,14,5,10,45,35,10,47
Melbourne V,8761,4,13,5,11,48,44,4,44
Adelaide Utd,8761,5,11,6,11,37,40,-3,39
Brisbane,8761,6,10,5,13,33,42,-9,35
Western Sydn,8761,7,8,9,10,38,47,-9,33
Perth Glory,8761,8,10,2,15,37,50,-13,32
Wellington P,8761,9,5,6,16,31,55,-24,21
CC Mariners,8761,10,4,8,15,28,49,-21,20
Sydney FC,8762,1,21,4,3,67,23,44,67
N'castle Jet,8762,2,16,5,7,59,37,22,53
Melbourne C,8762,3,14,4,11,43,35,8,46
Melbourne V,8762,4,13,5,11,46,41,5,44
Adelaide Utd,8762,5,11,6,11,37,40,-3,39
Brisbane,8762,6,10,5,13,33,42,-9,35
Western Sydn,8762,7,8,9,10,38,47,-9,33
Perth Glory,8762,8,10,2,15,37,50,-13,32
Wellington P,8762,9,5,6,16,31,55,-24,21
CC Mariners,8762,10,4,8,15,28,49,-21,20
Sydney FC,8763,1,20,5,3,67,25,42,65
N'castle Jet,8763,2,16,5,7,58,37,21,53
Melbourne C,8763,3,14,4,11,43,34,9,46
Melbourne V,8763,4,13,6,10,48,41,7,45
Adelaide Utd,8763,5,11,6,11,37,40,-3,39
Brisbane,8763,6,10,5,13,33,42,-9,35
Western Sydn,8763,7,8,9,10,38,47,-9,33
Perth Glory,8763,8,10,2,15,37,50,-13,32
Wellington P,8763,9,5,6,16,31,55,-24,21
CC Mariners,8763,10,4,8,15,28,49,-21,20
Sydney FC,8764,1,20,4,4,64,23,41,64
N'castle Jet,8764,2,15,6,7,58,38,20,51
Melbourne C,8764,3,14,5,10,44,34,10,47
Melbourne V,8764,4,14,5,10,46,38,8,47
Adelaide Utd,8764,5,11,6,11,37,40,-3,39
Brisbane,8764,6,10,5,13,33,42,-9,35
Western Sydn,8764,7,8,9,10,38,47,-9,33
Perth Glory,8764,8,10,2,15,37,50,-13,32
Wellington P,8764,9,5,6,16,31,55,-24,21
CC Mariners,8764,10,4,8,15,28,49,-21,20
Sydney FC,8765,1,21,4,3,70,23,47,67
N'castle Jet,8765,2,16,5,7,61,38,23,53
Melbourne C,8765,3,14,4,11,44,37,7,46
Melbourne V,8765,4,13,5,11,46,44,2,44
Adelaide Utd,8765,5,11,6,11,37,40,-3,39
Brisbane,8765,6,10,5,13,33,42,-9,35
Western Sydn,8765,7,8,9,10,38,47,-9,33
Perth Glory,8765,8,10,2,15,37,50,-13,32
Wellington P,8765,9,5,6,16,31,55,-24,21
CC Mariners,8765,10,4,8,15,28,49,-21,20
Sydney FC,8766,1,20,5,3,65,23,42,65
N'castle Jet,8766,2,16,5,7,60,39,21,53
Melbourne C,8766,3,14,4,11,45,36,9,46
Melbourne V,8766,4,13,6,10,46,39,7,45
Adelaide Utd,8766,5,11,6,11,37,40,-3,39
Brisbane,8766,6,10,5,13,33,42,-9,35
Western Sydn,8766,7,8,9,10,38,47,-9,33
Perth Glory,8766,8,10,2,15,37,50,-13,32
Wellington P,8766,9,5,6,16,31,55,-24,21
CC Mariners,8766,10,4,8,15,28,49,-21,20
Sydney FC,8767,1,21,4,3,66,23,43,67
N'castle Jet,8767,2,16,5,7,58,37,21,53
Melbourne C,8767,3,14,4,11,43,34,9,46
Melbourne V,8767,4,13,5,11,46,40,6,44
Adelaide Utd,8767,5,11,6,11,37,40,-3,39
Brisbane,8767,6,10,5,13,33,42,-9,35
Western Sydn,8767,7,8,9,10,38,47,-9,33
Perth Glory,8767,8,10,2,15,37,50,-13,32
Wellington P,8767,9,5,6,16,31,55,-24,21
CC Mariners,8767,10,4,8,15,28,49,-21,20
Sydney FC,8768,1,20,4,4,66,25,41,64
N'castle Jet,8768,2,16,5,7,59,37,22,53
Melbourne V,8768,3,14,5,10,48,40,8,47
Melbourne C,8768,4,14,4,11,43,35,8,46
Adelaide Utd,8768,5,11,6,11,37,40,-3,39
Brisbane,8768,6,10,5,13,33,42,-9,35
Western Sydn,8768,7,8,9,10,38,47,-9,33
Perth Glory,8768,8,10,2,15,37,50,-13,32
Wellington P,8768,9,5,6,16,31,55,-24,21
CC Mariners,8768,10,4,8,15,28,49,-21,20
Sydney FC,8769,1,21,4,3,68,24,44,67
N'castle Jet,8769,2,15,5,8,57,38,19,50
Melbourne C,8769,3,15,4,10,44,33,11,49
Melbourne V,8769,4,13,5,11,47,42,5,44
Adelaide Utd,8769,5,11,6,11,37,40,-3,39
Brisbane,8769,6,10,5,13,33,42,-9,35
Western Sydn,8769,7,8,9,10,38,47,-9,33
Perth Glory,8769,8,10,2,15,37,50,-13,32
Wellington P,8769,9,5,6,16,31,55,-24,21
CC Mariners,8769,10,4,8,15,28,49,-21,20
Sydney FC,8770,1,20,5,3,65,23,42,65
N'castle Jet,8770,2,15,6,7,60,40,20,51
Melbourne C,8770,3,14,5,10,46,36,10,47
Melbourne V,8770,4,13,6,10,46,39,7,45
Adelaide Utd,8770,5,11,6,11,37,40,-3,39
Brisbane,8770,6,10,5,13,33,42,-9,35
Western Sydn,8770,7,8,9,10,38,47,-9,33
Perth Glory,8770,8,10,2,15,37,50,-13,32
Wellington P,8770,9,5,6,16,31,55,-24,21
CC Mariners,8770,10,4,8,15,28,49,-21,20
Sydney FC,8771,1,20,5,3,66,24,42,65
N'castle Jet,8771,2,15,5,8,58,39,19,50
Melbourne C,8771,3,15,4,10,45,34,11,49
Melbourne V,8771,4,13,6,10,47,40,7,45
Adelaide Utd,8771,5,11,6,11,37,40,-3,39
Brisbane,8771,6,10,5,13,33,42,-9,35
Western Sydn,8771,7,8,9,10,38,47,-9,33
Perth Glory,8771,8,10,2,15,37,50,-13,32
Wellington P,8771,9,5,6,16,31,55,-24,21
CC Mariners,8771,10,4,8,15,28,49,-21,20
Sydney FC,8772,1,21,4,3,67,22,45,67
N'castle Jet,8772,2,15,5,8,57,39,18,50
Melbourne C,8772,3,15,4,10,45,33,12,49
Melbourne V,8772,4,13,5,11,45,41,4,44
Adelaide Utd,8772,5,11,6,11,37,40,-3,39
Brisbane,8772,6,10,5,13,33,42,-9,35
Western Sydn,8772,7,8,9,10,38,47,-9,33
Perth Glory,8772,8,10,2,15,37,50,-13,32
Wellington P,8772,9,5,6,16,31,55,-24,21
CC Mariners,8772,10,4,8,15,28,49,-21,20
Sydney FC,8773,1,20,4,4,66,25,41,64
N'castle Jet,8773,2,15,6,7,57,37,20,51
Melbourne C,8773,3,14,5,10,43,33,10,47
Melbourne V,8773,4,14,5,10,48,40,8,47
Adelaide Utd,8773,5,11,6,11,37,40,-3,39
Brisbane,8773,6,10,5,13,33,42,-9,35
Western Sydn,8773,7,8,9,10,38,47,-9,33
Perth Glory,8773,8,10,2,15,37,50,-13,32
Wellington P,8773,9,5,6,16,31,55,-24,21
CC Mariners,8773,10,4,8,15,28,49,-21,20
Sydney FC,8774,1,21,4,3,67,24,43,67
N'castle Jet,8774,2,16,5,7,59,38,21,53
Melbourne C,8774,3,14,4,11,44,35,9,46
Melbourne V,8774,4,13,5,11,47,41,6,44
Adelaide Utd,8774,5,11,6,11,37,40,-3,39
Brisbane,8774,6,10,5,13,33,42,-9,35
Western Sydn,8774,7,8,9,10,38,47,-9,33
Perth Glory,8774,8,10,2,15,37,50,-13,32
Wellington P,8774,9,5,6,16,31,55,-24,21
CC Mariners,8774,10,4,8,15,28,49,-21,20
Sydney FC,8775,1,21,4,3,66,23,43,67
N'castle Jet,8775,2,16,5,7,60,38,22,53
Melbourne C,8775,3,14,4,11,44,36,8,46
Melbourne V,8775,4,13,5,11,46,40,6,44
Adelaide Utd,8775,5,11,6,11,37,40,-3,39
Brisbane,8775,6,10,5,13,33,42,-9,35
Western Sydn,8775,7,8,9,10,38,47,-9,33
Perth Glory,8775,8,10,2,15,37,50,-13,32
Wellington P,8775,9,5,6,16,31,55,-24,21
CC Mariners,8775,10,4,8,15,28,49,-21,20
Sydney FC,8776,1,20,4,4,64,23,41,64
N'castle Jet,8776,2,16,5,7,60,38,22,53
Melbourne V,8776,3,14,5,10,46,38,8,47
Melbourne C,8776,4,14,4,11,44,36,8,46
Adelaide Utd,8776,5,11,6,11,37,40,-3,39
Brisbane,8776,6,10,5,13,33,42,-9,35
Western Sydn,8776,7,8,9,10,38,47,-9,33
Perth Glory,8776,8,10,2,15,37,50,-13,32
Wellington P,8776,9,5,6,16,31,55,-24,21
CC Mariners,8776,10,4,8,15,28,49,-21,20
Sydney FC,8777,1,21,4,3,65,22,43,67
N'castle Jet,8777,2,16,5,7,62,38,24,53
Melbourne C,8777,3,14,4,11,44,38,6,46
Melbourne V,8777,4,13,5,11,45,39,6,44
Adelaide Utd,8777,5,11,6,11,37,40,-3,39
Brisbane,8777,6,10,5,13,33,42,-9,35
Western Sydn,8777,7,8,9,10,38,47,-9,33
Perth Glory,8777,8,10,2,15,37,50,-13,32
Wellington P,8777,9,5,6,16,31,55,-24,21
CC Mariners,8777,10,4,8,15,28,49,-21,20
Sydney FC,8778,1,20,4,4,65,25,40,64
N'castle Jet,8778,2,16,5,7,59,38,21,53
Melbourne V,8778,3,14,5,10,48,39,9,47
Melbourne C,8778,4,14,4,11,44,35,9,46
Adelaide Utd,8778,5,11,6,11,37,40,-3,39
Brisbane,8778,6,10,5,13,33,42,-9,35
Western Sydn,8778,7,8,9,10,38,47,-9,33
Perth Glory,8778,8,10,2,15,37,50,-13,32
Wellington P,8778,9,5,6,16,31,55,-24,21
CC Mariners,8778,10,4,8,15,28,49,-21,20
Sydney FC,8779,1,21,4,3,65,22,43,67
N'castle Jet,8779,2,15,6,7,59,39,20,51
Melbourne C,8779,3,14,5,10,45,35,10,47
Melbourne V,8779,4,13,5,11,45,39,6,44
Adelaide Utd,8779,5,11,6,11,37,40,-3,39
Brisbane,8779,6,10,5,13,33,42,-9,35
Western Sydn,8779,7,8,9,10,38,47,-9,33
Perth Glory,8779,8,10,2,15,37,50,-13,32
Wellington P,8779,9,5,6,16,31,55,-24,21
CC Mariners,8779,10,4,8,15,28,49,-21,20
Sydney FC,8780,1,21,4,3,66,22,44,67
N'castle Jet,8780,2,16,5,7,59,37,22,53
Melbourne C,8780,3,14,4,11,43,35,8,46
Melbourne V,8780,4,13,5,11,45,40,5,44
Adelaide Utd,8780,5,11,6,11,37,40,-3,39
Brisbane,8780,6,10,5,13,33,42,-9,35
Western Sydn,8780,7,8,9,10,38,47,-9,33
Perth Glory,8780,8,10,2,15,37,50,-13,32
Wellington P,8780,9,5,6,16,31,55,-24,21
CC Mariners,8780,10,4,8,15,28,49,-21,20
Sydney FC,8781,1,21,4,3,66,22,44,67
N'castle Jet,8781,2,15,6,7,57,37,20,51
Melbourne C,8781,3,14,5,10,43,33,10,47
Melbourne V,8781,4,13,5,11,45,40,5,44
Adelaide Utd,8781,5,11,6,11,37,40,-3,39
Brisbane,8781,6,10,5,13,33,42,-9,35
Western Sydn,8781,7,8,9,10,38,47,-9,33
Perth Glory,8781,8,10,2,15,37,50,-13,32
Wellington P,8781,9,5,6,16,31,55,-24,21
CC Mariners,8781,10,4,8,15,28,49,-21,20
Sydney FC,8782,1,20,4,4,65,24,41,64
N'castle Jet,8782,2,15,6,7,58,38,20,51
Melbourne C,8782,3,14,5,10,44,34,10,47
Melbourne V,8782,4,14,5,10,47,39,8,47
Adelaide Utd,8782,5,11,6,11,37,40,-3,39
Brisbane,8782,6,10,5,13,33,42,-9,35
Western Sydn,8782,7,8,9,10,38,47,-9,33
Perth Glory,8782,8,10,2,15,37,50,-13,32
Wellington P,8782,9,5,6,16,31,55,-24,21
CC Mariners,8782,10,4,8,15,28,49,-21,20
Sydney FC,8783,1,21,4,3,66,22,44,67
N'castle Jet,8783,2,16,5,7,66,37,29,53
Melbourne C,8783,3,14,4,11,43,42,1,46
Melbourne V,8783,4,13,5,11,45,40,5,44
Adelaide Utd,8783,5,11,6,11,37,40,-3,39
Brisbane,8783,6,10,5,13,33,42,-9,35
Western Sydn,8783,7,8,9,10,38,47,-9,33
Perth Glory,8783,8,10,2,15,37,50,-13,32
Wellington P,8783,9,5,6,16,31,55,-24,21
CC Mariners,8783,10,4,8,15,28,49,-21,20
Sydney FC,8784,1,20,5,3,65,23,42,65
N'castle Jet,8784,2,15,6,7,58,38,20,51
Melbourne C,8784,3,14,5,10,44,34,10,47
Melbourne V,8784,4,13,6,10,46,39,7,45
Adelaide Utd,8784,5,11,6,11,37,40,-3,39
Brisbane,8784,6,10,5,13,33,42,-9,35
Western Sydn,8784,7,8,9,10,38,47,-9,33
Perth Glory,8784,8,10,2,15,37,50,-13,32
Wellington P,8784,9,5,6,16,31,55,-24,21
CC Mariners,8784,10,4,8,15,28,49,-21,20
Sydney FC,8785,1,20,4,4,65,24,41,64
N'castle Jet,8785,2,15,6,7,59,39,20,51
Melbourne C,8785,3,14,5,10,45,35,10,47
Melbourne V,8785,4,14,5,10,47,39,8,47
Adelaide Utd,8785,5,11,6,11,37,40,-3,39
Brisbane,8785,6,10,5,13,33,42,-9,35
Western Sydn,8785,7,8,9,10,38,47,-9,33
Perth Glory,8785,8,10,2,15,37,50,-13,32
Wellington P,8785,9,5,6,16,31,55,-24,21
CC Mariners,8785,10,4,8,15,28,49,-21,20
Sydney FC,8786,1,20,5,3,64,22,42,65
N'castle Jet,8786,2,15,5,8,57,41,16,50
Melbourne C,8786,3,15,4,10,47,33,14,49
Melbourne V,8786,4,13,6,10,45,38,7,45
Adelaide Utd,8786,5,11,6,11,37,40,-3,39
Brisbane,8786,6,10,5,13,33,42,-9,35
Western Sydn,8786,7,8,9,10,38,47,-9,33
Perth Glory,8786,8,10,2,15,37,50,-13,32
Wellington P,8786,9,5,6,16,31,55,-24,21
CC Mariners,8786,10,4,8,15,28,49,-21,20
Sydney FC,8787,1,20,5,3,64,22,42,65
N'castle Jet,8787,2,16,5,7,65,39,26,53
Melbourne C,8787,3,14,4,11,45,41,4,46
Melbourne V,8787,4,13,6,10,45,38,7,45
Adelaide Utd,8787,5,11,6,11,37,40,-3,39
Brisbane,8787,6,10,5,13,33,42,-9,35
Western Sydn,8787,7,8,9,10,38,47,-9,33
Perth Glory,8787,8,10,2,15,37,50,-13,32
Wellington P,8787,9,5,6,16,31,55,-24,21
CC Mariners,8787,10,4,8,15,28,49,-21,20
Sydney FC,8788,1,21,4,3,67,24,43,67
N'castle Jet,8788,2,16,5,7,63,37,26,53
Melbourne C,8788,3,14,4,11,43,39,4,46
Melbourne V,8788,4,13,5,11,47,41,6,44
Adelaide Utd,8788,5,11,6,11,37,40,-3,39
Brisbane,8788,6,10,5,13,33,42,-9,35
Western Sydn,8788,7,8,9,10,38,47,-9,33
Perth Glory,8788,8,10,2,15,37,50,-13,32
Wellington P,8788,9,5,6,16,31,55,-24,21
CC Mariners,8788,10,4,8,15,28,49,-21,20
Sydney FC,8789,1,21,4,3,68,22,46,67
N'castle Jet,8789,2,16,5,7,60,38,22,53
Melbourne C,8789,3,14,4,11,44,36,8,46
Melbourne V,8789,4,13,5,11,45,42,3,44
Adelaide Utd,8789,5,11,6,11,37,40,-3,39
Brisbane,8789,6,10,5,13,33,42,-9,35
Western Sydn,8789,7,8,9,10,38,47,-9,33
Perth Glory,8789,8,10,2,15,37,50,-13,32
Wellington P,8789,9,5,6,16,31,55,-24,21
CC Mariners,8789,10,4,8,15,28,49,-21,20
Sydney FC,8790,1,21,4,3,66,22,44,67
N'castle Jet,8790,2,15,6,7,57,37,20,51
Melbourne C,8790,3,14,5,10,43,33,10,47
Melbourne V,8790,4,13,5,11,45,40,5,44
Adelaide Utd,8790,5,11,6,11,37,40,-3,39
Brisbane,8790,6,10,5,13,33,42,-9,35
Western Sydn,8790,7,8,9,10,38,47,-9,33
Perth Glory,8790,8,10,2,15,37,50,-13,32
Wellington P,8790,9,5,6,16,31,55,-24,21
CC Mariners,8790,10,4,8,15,28,49,-21,20
Sydney FC,8791,1,20,4,4,65,25,40,64
N'castle Jet,8791,2,15,6,7,59,39,20,51
Melbourne C,8791,3,14,5,10,45,35,10,47
Melbourne V,8791,4,14,5,10,48,39,9,47
Adelaide Utd,8791,5,11,6,11,37,40,-3,39
Brisbane,8791,6,10,5,13,33,42,-9,35
Western Sydn,8791,7,8,9,10,38,47,-9,33
Perth Glory,8791,8,10,2,15,37,50,-13,32
Wellington P,8791,9,5,6,16,31,55,-24,21
CC Mariners,8791,10,4,8,15,28,49,-21,20
Sydney FC,8792,1,21,4,3,67,24,43,67
N'castle Jet,8792,2,15,6,7,57,37,20,51
Melbourne C,8792,3,14,5,10,43,33,10,47
Melbourne V,8792,4,13,5,11,47,41,6,44
Adelaide Utd,8792,5,11,6,11,37,40,-3,39
Brisbane,8792,6,10,5,13,33,42,-9,35
Western Sydn,8792,7,8,9,10,38,47,-9,33
Perth Glory,8792,8,10,2,15,37,50,-13,32
Wellington P,8792,9,5,6,16,31,55,-24,21
CC Mariners,8792,10,4,8,15,28,49,-21,20
Sydney FC,8793,1,21,4,3,68,23,45,67
N'castle Jet,8793,2,15,5,8,57,39,18,50
Melbourne C,8793,3,15,4,10,45,33,12,49
Melbourne V,8793,4,13,5,11,46,42,4,44
Adelaide Utd,8793,5,11,6,11,37,40,-3,39
Brisbane,8793,6,10,5,13,33,42,-9,35
Western Sydn,8793,7,8,9,10,38,47,-9,33
Perth Glory,8793,8,10,2,15,37,50,-13,32
Wellington P,8793,9,5,6,16,31,55,-24,21
CC Mariners,8793,10,4,8,15,28,49,-21,20
Sydney FC,8794,1,21,4,3,66,23,43,67
N'castle Jet,8794,2,16,5,7,59,38,21,53
Melbourne C,8794,3,14,4,11,44,35,9,46
Melbourne V,8794,4,13,5,11,46,40,6,44
Adelaide Utd,8794,5,11,6,11,37,40,-3,39
Brisbane,8794,6,10,5,13,33,42,-9,35
Western Sydn,8794,7,8,9,10,38,47,-9,33
Perth Glory,8794,8,10,2,15,37,50,-13,32
Wellington P,8794,9,5,6,16,31,55,-24,21
CC Mariners,8794,10,4,8,15,28,49,-21,20
Sydney FC,8795,1,21,4,3,66,22,44,67
N'castle Jet,8795,2,16,5,7,61,38,23,53
Melbourne C,8795,3,14,4,11,44,37,7,46
Melbourne V,8795,4,13,5,11,45,40,5,44
Adelaide Utd,8795,5,11,6,11,37,40,-3,39
Brisbane,8795,6,10,5,13,33,42,-9,35
Western Sydn,8795,7,8,9,10,38,47,-9,33
Perth Glory,8795,8,10,2,15,37,50,-13,32
Wellington P,8795,9,5,6,16,31,55,-24,21
CC Mariners,8795,10,4,8,15,28,49,-21,20
Sydney FC,8796,1,21,4,3,69,23,46,67
N'castle Jet,8796,2,15,6,7,58,38,20,51
Melbourne C,8796,3,14,5,10,44,34,10,47
Melbourne V,8796,4,13,5,11,46,43,3,44
Adelaide Utd,8796,5,11,6,11,37,40,-3,39
Brisbane,8796,6,10,5,13,33,42,-9,35
Western Sydn,8796,7,8,9,10,38,47,-9,33
Perth Glory,8796,8,10,2,15,37,50,-13,32
Wellington P,8796,9,5,6,16,31,55,-24,21
CC Mariners,8796,10,4,8,15,28,49,-21,20
Sydney FC,8797,1,21,4,3,68,23,45,67
N'castle Jet,8797,2,15,5,8,57,40,17,50
Melbourne C,8797,3,15,4,10,46,33,13,49
Melbourne V,8797,4,13,5,11,46,42,4,44
Adelaide Utd,8797,5,11,6,11,37,40,-3,39
Brisbane,8797,6,10,5,13,33,42,-9,35
Western Sydn,8797,7,8,9,10,38,47,-9,33
Perth Glory,8797,8,10,2,15,37,50,-13,32
Wellington P,8797,9,5,6,16,31,55,-24,21
CC Mariners,8797,10,4,8,15,28,49,-21,20
Sydney FC,8798,1,21,4,3,65,22,43,67
N'castle Jet,8798,2,15,5,8,58,40,18,50
Melbourne C,8798,3,15,4,10,46,34,12,49
Melbourne V,8798,4,13,5,11,45,39,6,44
Adelaide Utd,8798,5,11,6,11,37,40,-3,39
Brisbane,8798,6,10,5,13,33,42,-9,35
Western Sydn,8798,7,8,9,10,38,47,-9,33
Perth Glory,8798,8,10,2,15,37,50,-13,32
Wellington P,8798,9,5,6,16,31,55,-24,21
CC Mariners,8798,10,4,8,15,28,49,-21,20
Sydney FC,8799,1,20,4,4,65,25,40,64
N'castle Jet,8799,2,15,6,7,59,39,20,51
Melbourne C,8799,3,14,5,10,45,35,10,47
Melbourne V,8799,4,14,5,10,48,39,9,47
Adelaide Utd,8799,5,11,6,11,37,40,-3,39
Brisbane,8799,6,10,5,13,33,42,-9,35
Western Sydn,8799,7,8,9,10,38,47,-9,33
Perth Glory,8799,8,10,2,15,37,50,-13,32
Wellington P,8799,9,5,6,16,31,55,-24,21
CC Mariners,8799,10,4,8,15,28,49,-21,20
Sydney FC,8800,1,20,4,4,64,23,41,64
N'castle Jet,8800,2,16,5,7,60,38,22,53
Melbourne V,8800,3,14,5,10,46,38,8,47
Melbourne C,8800,4,14,4,11,44,36,8,46
Adelaide Utd,8800,5,11,6,11,37,40,-3,39
Brisbane,8800,6,10,5,13,33,42,-9,35
Western Sydn,8800,7,8,9,10,38,47,-9,33
Perth Glory,8800,8,10,2,15,37,50,-13,32
Wellington P,8800,9,5,6,16,31,55,-24,21
CC Mariners,8800,10,4,8,15,28,49,-21,20
Sydney FC,8801,1,20,4,4,66,25,41,64
N'castle Jet,8801,2,16,5,7,62,37,25,53
Melbourne V,8801,3,14,5,10,48,40,8,47
Melbourne C,8801,4,14,4,11,43,38,5,46
Adelaide Utd,8801,5,11,6,11,37,40,-3,39
Brisbane,8801,6,10,5,13,33,42,-9,35
Western Sydn,8801,7,8,9,10,38,47,-9,33
Perth Glory,8801,8,10,2,15,37,50,-13,32
Wellington P,8801,9,5,6,16,31,55,-24,21
CC Mariners,8801,10,4,8,15,28,49,-21,20
Sydney FC,8802,1,21,4,3,67,22,45,67
N'castle Jet,8802,2,16,5,7,58,37,21,53
Melbourne C,8802,3,14,4,11,43,34,9,46
Melbourne V,8802,4,13,5,11,45,41,4,44
Adelaide Utd,8802,5,11,6,11,37,40,-3,39
Brisbane,8802,6,10,5,13,33,42,-9,35
Western Sydn,8802,7,8,9,10,38,47,-9,33
Perth Glory,8802,8,10,2,15,37,50,-13,32
Wellington P,8802,9,5,6,16,31,55,-24,21
CC Mariners,8802,10,4,8,15,28,49,-21,20
Sydney FC,8803,1,21,4,3,66,22,44,67
N'castle Jet,8803,2,15,6,7,58,38,20,51
Melbourne C,8803,3,14,5,10,44,34,10,47
Melbourne V,8803,4,13,5,11,45,40,5,44
Adelaide Utd,8803,5,11,6,11,37,40,-3,39
Brisbane,8803,6,10,5,13,33,42,-9,35
Western Sydn,8803,7,8,9,10,38,47,-9,33
Perth Glory,8803,8,10,2,15,37,50,-13,32
Wellington P,8803,9,5,6,16,31,55,-24,21
CC Mariners,8803,10,4,8,15,28,49,-21,20
Sydney FC,8804,1,21,4,3,66,23,43,67
N'castle Jet,8804,2,15,5,8,57,38,19,50
Melbourne C,8804,3,15,4,10,44,33,11,49
Melbourne V,8804,4,13,5,11,46,40,6,44
Adelaide Utd,8804,5,11,6,11,37,40,-3,39
Brisbane,8804,6,10,5,13,33,42,-9,35
Western Sydn,8804,7,8,9,10,38,47,-9,33
Perth Glory,8804,8,10,2,15,37,50,-13,32
Wellington P,8804,9,5,6,16,31,55,-24,21
CC Mariners,8804,10,4,8,15,28,49,-21,20
Sydney FC,8805,1,21,4,3,65,22,43,67
N'castle Jet,8805,2,15,5,8,58,39,19,50
Melbourne C,8805,3,15,4,10,45,34,11,49
Melbourne V,8805,4,13,5,11,45,39,6,44
Adelaide Utd,8805,5,11,6,11,37,40,-3,39
Brisbane,8805,6,10,5,13,33,42,-9,35
Western Sydn,8805,7,8,9,10,38,47,-9,33
Perth Glory,8805,8,10,2,15,37,50,-13,32
Wellington P,8805,9,5,6,16,31,55,-24,21
CC Mariners,8805,10,4,8,15,28,49,-21,20
Sydney FC,8806,1,21,4,3,69,22,47,67
N'castle Jet,8806,2,15,6,7,57,37,20,51
Melbourne C,8806,3,14,5,10,43,33,10,47
Melbourne V,8806,4,13,5,11,45,43,2,44
Adelaide Utd,8806,5,11,6,11,37,40,-3,39
Brisbane,8806,6,10,5,13,33,42,-9,35
Western Sydn,8806,7,8,9,10,38,47,-9,33
Perth Glory,8806,8,10,2,15,37,50,-13,32
Wellington P,8806,9,5,6,16,31,55,-24,21
CC Mariners,8806,10,4,8,15,28,49,-21,20
Sydney FC,8807,1,20,5,3,65,23,42,65
N'castle Jet,8807,2,15,5,8,57,39,18,50
Melbourne C,8807,3,15,4,10,45,33,12,49
Melbourne V,8807,4,13,6,10,46,39,7,45
Adelaide Utd,8807,5,11,6,11,37,40,-3,39
Brisbane,8807,6,10,5,13,33,42,-9,35
Western Sydn,8807,7,8,9,10,38,47,-9,33
Perth Glory,8807,8,10,2,15,37,50,-13,32
Wellington P,8807,9,5,6,16,31,55,-24,21
CC Mariners,8807,10,4,8,15,28,49,-21,20
Sydney FC,8808,1,21,4,3,66,22,44,67
N'castle Jet,8808,2,15,5,8,59,41,18,50
Melbourne C,8808,3,15,4,10,47,35,12,49
Melbourne V,8808,4,13,5,11,45,40,5,44
Adelaide Utd,8808,5,11,6,11,37,40,-3,39
Brisbane,8808,6,10,5,13,33,42,-9,35
Western Sydn,8808,7,8,9,10,38,47,-9,33
Perth Glory,8808,8,10,2,15,37,50,-13,32
Wellington P,8808,9,5,6,16,31,55,-24,21
CC Mariners,8808,10,4,8,15,28,49,-21,20
Sydney FC,8809,1,21,4,3,66,22,44,67
N'castle Jet,8809,2,15,5,8,57,38,19,50
Melbourne C,8809,3,15,4,10,44,33,11,49
Melbourne V,8809,4,13,5,11,45,40,5,44
Adelaide Utd,8809,5,11,6,11,37,40,-3,39
Brisbane,8809,6,10,5,13,33,42,-9,35
Western Sydn,8809,7,8,9,10,38,47,-9,33
Perth Glory,8809,8,10,2,15,37,50,-13,32
Wellington P,8809,9,5,6,16,31,55,-24,21
CC Mariners,8809,10,4,8,15,28,49,-21,20
Sydney FC,8810,1,21,4,3,68,24,44,67
N'castle Jet,8810,2,15,5,8,57,39,18,50
Melbourne C,8810,3,15,4,10,45,33,12,49
Melbourne V,8810,4,13,5,11,47,42,5,44
Adelaide Utd,8810,5,11,6,11,37,40,-3,39
Brisbane,8810,6,10,5,13,33,42,-9,35
Western Sydn,8810,7,8,9,10,38,47,-9,33
Perth Glory,8810,8,10,2,15,37,50,-13,32
Wellington P,8810,9,5,6,16,31,55,-24,21
CC Mariners,8810,10,4,8,15,28,49,-21,20
Sydney FC,8811,1,20,4,4,65,25,40,64
N'castle Jet,8811,2,16,5,7,60,38,22,53
Melbourne V,8811,3,14,5,10,48,39,9,47
Melbourne C,8811,4,14,4,11,44,36,8,46
Adelaide Utd,8811,5,11,6,11,37,40,-3,39
Brisbane,8811,6,10,5,13,33,42,-9,35
Western Sydn,8811,7,8,9,10,38,47,-9,33
Perth Glory,8811,8,10,2,15,37,50,-13,32
Wellington P,8811,9,5,6,16,31,55,-24,21
CC Mariners,8811,10,4,8,15,28,49,-21,20
Sydney FC,8812,1,20,5,3,66,24,42,65
N'castle Jet,8812,2,16,5,7,60,37,23,53
Melbourne C,8812,3,14,4,11,43,36,7,46
Melbourne V,8812,4,13,6,10,47,40,7,45
Adelaide Utd,8812,5,11,6,11,37,40,-3,39
Brisbane,8812,6,10,5,13,33,42,-9,35
Western Sydn,8812,7,8,9,10,38,47,-9,33
Perth Glory,8812,8,10,2,15,37,50,-13,32
Wellington P,8812,9,5,6,16,31,55,-24,21
CC Mariners,8812,10,4,8,15,28,49,-21,20
Sydney FC,8813,1,20,5,3,67,25,42,65
N'castle Jet,8813,2,16,5,7,60,39,21,53
Melbourne C,8813,3,14,4,11,45,36,9,46
Melbourne V,8813,4,13,6,10,48,41,7,45
Adelaide Utd,8813,5,11,6,11,37,40,-3,39
Brisbane,8813,6,10,5,13,33,42,-9,35
Western Sydn,8813,7,8,9,10,38,47,-9,33
Perth Glory,8813,8,10,2,15,37,50,-13,32
Wellington P,8813,9,5,6,16,31,55,-24,21
CC Mariners,8813,10,4,8,15,28,49,-21,20
Sydney FC,8814,1,21,4,3,67,22,45,67
N'castle Jet,8814,2,15,6,7,58,38,20,51
Melbourne C,8814,3,14,5,10,44,34,10,47
Melbourne V,8814,4,13,5,11,45,41,4,44
Adelaide Utd,8814,5,11,6,11,37,40,-3,39
Brisbane,8814,6,10,5,13,33,42,-9,35
Western Sydn,8814,7,8,9,10,38,47,-9,33
Perth Glory,8814,8,10,2,15,37,50,-13,32
Wellington P,8814,9,5,6,16,31,55,-24,21
CC Mariners,8814,10,4,8,15,28,49,-21,20
Sydney FC,8815,1,21,4,3,67,24,43,67
N'castle Jet,8815,2,15,6,7,59,39,20,51
Melbourne C,8815,3,14,5,10,45,35,10,47
Melbourne V,8815,4,13,5,11,47,41,6,44
Adelaide Utd,8815,5,11,6,11,37,40,-3,39
Brisbane,8815,6,10,5,13,33,42,-9,35
Western Sydn,8815,7,8,9,10,38,47,-9,33
Perth Glory,8815,8,10,2,15,37,50,-13,32
Wellington P,8815,9,5,6,16,31,55,-24,21
CC Mariners,8815,10,4,8,15,28,49,-21,20
Sydney FC,8816,1,21,4,3,66,22,44,67
N'castle Jet,8816,2,16,5,7,60,37,23,53
Melbourne C,8816,3,14,4,11,43,36,7,46
Melbourne V,8816,4,13,5,11,45,40,5,44
Adelaide Utd,8816,5,11,6,11,37,40,-3,39
Brisbane,8816,6,10,5,13,33,42,-9,35
Western Sydn,8816,7,8,9,10,38,47,-9,33
Perth Glory,8816,8,10,2,15,37,50,-13,32
Wellington P,8816,9,5,6,16,31,55,-24,21
CC Mariners,8816,10,4,8,15,28,49,-21,20
Sydney FC,8817,1,21,4,3,67,23,44,67
N'castle Jet,8817,2,16,5,7,59,37,22,53
Melbourne C,8817,3,14,4,11,43,35,8,46
Melbourne V,8817,4,13,5,11,46,41,5,44
Adelaide Utd,8817,5,11,6,11,37,40,-3,39
Brisbane,8817,6,10,5,13,33,42,-9,35
Western Sydn,8817,7,8,9,10,38,47,-9,33
Perth Glory,8817,8,10,2,15,37,50,-13,32
Wellington P,8817,9,5,6,16,31,55,-24,21
CC Mariners,8817,10,4,8,15,28,49,-21,20
Sydney FC,8818,1,20,5,3,64,22,42,65
N'castle Jet,8818,2,15,5,8,57,39,18,50
Melbourne C,8818,3,15,4,10,45,33,12,49
Melbourne V,8818,4,13,6,10,45,38,7,45
Adelaide Utd,8818,5,11,6,11,37,40,-3,39
Brisbane,8818,6,10,5,13,33,42,-9,35
Western Sydn,8818,7,8,9,10,38,47,-9,33
Perth Glory,8818,8,10,2,15,37,50,-13,32
Wellington P,8818,9,5,6,16,31,55,-24,21
CC Mariners,8818,10,4,8,15,28,49,-21,20
Sydney FC,8819,1,21,4,3,65,22,43,67
N'castle Jet,8819,2,16,5,7,59,37,22,53
Melbourne C,8819,3,14,4,11,43,35,8,46
Melbourne V,8819,4,13,5,11,45,39,6,44
Adelaide Utd,8819,5,11,6,11,37,40,-3,39
Brisbane,8819,6,10,5,13,33,42,-9,35
Western Sydn,8819,7,8,9,10,38,47,-9,33
Perth Glory,8819,8,10,2,15,37,50,-13,32
Wellington P,8819,9,5,6,16,31,55,-24,21
CC Mariners,8819,10,4,8,15,28,49,-21,20
Sydney FC,8820,1,21,4,3,65,22,43,67
N'castle Jet,8820,2,15,5,8,57,38,19,50
Melbourne C,8820,3,15,4,10,44,33,11,49
Melbourne V,8820,4,13,5,11,45,39,6,44
Adelaide Utd,8820,5,11,6,11,37,40,-3,39
Brisbane,8820,6,10,5,13,33,42,-9,35
Western Sydn,8820,7,8,9,10,38,47,-9,33
Perth Glory,8820,8,10,2,15,37,50,-13,32
Wellington P,8820,9,5,6,16,31,55,-24,21
CC Mariners,8820,10,4,8,15,28,49,-21,20
Sydney FC,8821,1,21,4,3,67,22,45,67
N'castle Jet,8821,2,16,5,7,58,37,21,53
Melbourne C,8821,3,14,4,11,43,34,9,46
Melbourne V,8821,4,13,5,11,45,41,4,44
Adelaide Utd,8821,5,11,6,11,37,40,-3,39
Brisbane,8821,6,10,5,13,33,42,-9,35
Western Sydn,8821,7,8,9,10,38,47,-9,33
Perth Glory,8821,8,10,2,15,37,50,-13,32
Wellington P,8821,9,5,6,16,31,55,-24,21
CC Mariners,8821,10,4,8,15,28,49,-21,20
Sydney FC,8822,1,20,4,4,64,23,41,64
N'castle Jet,8822,2,15,6,7,57,37,20,51
Melbourne C,8822,3,14,5,10,43,33,10,47
Melbourne V,8822,4,14,5,10,46,38,8,47
Adelaide Utd,8822,5,11,6,11,37,40,-3,39
Brisbane,8822,6,10,5,13,33,42,-9,35
Western Sydn,8822,7,8,9,10,38,47,-9,33
Perth Glory,8822,8,10,2,15,37,50,-13,32
Wellington P,8822,9,5,6,16,31,55,-24,21
CC Mariners,8822,10,4,8,15,28,49,-21,20
Sydney FC,8823,1,20,5,3,65,23,42,65
N'castle Jet,8823,2,16,5,7,62,37,25,53
Melbourne C,8823,3,14,4,11,43,38,5,46
Melbourne V,8823,4,13,6,10,46,39,7,45
Adelaide Utd,8823,5,11,6,11,37,40,-3,39
Brisbane,8823,6,10,5,13,33,42,-9,35
Western Sydn,8823,7,8,9,10,38,47,-9,33
Perth Glory,8823,8,10,2,15,37,50,-13,32
Wellington P,8823,9,5,6,16,31,55,-24,21
CC Mariners,8823,10,4,8,15,28,49,-21,20
Sydney FC,8824,1,20,4,4,66,25,41,64
N'castle Jet,8824,2,16,5,7,60,38,22,53
Melbourne V,8824,3,14,5,10,48,40,8,47
Melbourne C,8824,4,14,4,11,44,36,8,46
Adelaide Utd,8824,5,11,6,11,37,40,-3,39
Brisbane,8824,6,10,5,13,33,42,-9,35
Western Sydn,8824,7,8,9,10,38,47,-9,33
Perth Glory,8824,8,10,2,15,37,50,-13,32
Wellington P,8824,9,5,6,16,31,55,-24,21
CC Mariners,8824,10,4,8,15,28,49,-21,20
Sydney FC,8825,1,21,4,3,65,22,43,67
N'castle Jet,8825,2,15,6,7,58,38,20,51
Melbourne C,8825,3,14,5,10,44,34,10,47
Melbourne V,8825,4,13,5,11,45,39,6,44
Adelaide Utd,8825,5,11,6,11,37,40,-3,39
Brisbane,8825,6,10,5,13,33,42,-9,35
Western Sydn,8825,7,8,9,10,38,47,-9,33
Perth Glory,8825,8,10,2,15,37,50,-13,32
Wellington P,8825,9,5,6,16,31,55,-24,21
CC Mariners,8825,10,4,8,15,28,49,-21,20
Sydney FC,8826,1,20,4,4,65,24,41,64
N'castle Jet,8826,2,16,5,7,60,37,23,53
Melbourne V,8826,3,14,5,10,47,39,8,47
Melbourne C,8826,4,14,4,11,43,36,7,46
Adelaide Utd,8826,5,11,6,11,37,40,-3,39
Brisbane,8826,6,10,5,13,33,42,-9,35
Western Sydn,8826,7,8,9,10,38,47,-9,33
Perth Glory,8826,8,10,2,15,37,50,-13,32
Wellington P,8826,9,5,6,16,31,55,-24,21
CC Mariners,8826,10,4,8,15,28,49,-21,20
Sydney FC,8827,1,21,4,3,65,22,43,67
N'castle Jet,8827,2,15,6,7,58,38,20,51
Melbourne C,8827,3,14,5,10,44,34,10,47
Melbourne V,8827,4,13,5,11,45,39,6,44
Adelaide Utd,8827,5,11,6,11,37,40,-3,39
Brisbane,8827,6,10,5,13,33,42,-9,35
Western Sydn,8827,7,8,9,10,38,47,-9,33
Perth Glory,8827,8,10,2,15,37,50,-13,32
Wellington P,8827,9,5,6,16,31,55,-24,21
CC Mariners,8827,10,4,8,15,28,49,-21,20
Sydney FC,8828,1,20,5,3,64,22,42,65
N'castle Jet,8828,2,16,5,7,59,37,22,53
Melbourne C,8828,3,14,4,11,43,35,8,46
Melbourne V,8828,4,13,6,10,45,38,7,45
Adelaide Utd,8828,5,11,6,11,37,40,-3,39
Brisbane,8828,6,10,5,13,33,42,-9,35
Western Sydn,8828,7,8,9,10,38,47,-9,33
Perth Glory,8828,8,10,2,15,37,50,-13,32
Wellington P,8828,9,5,6,16,31,55,-24,21
CC Mariners,8828,10,4,8,15,28,49,-21,20
Sydney FC,8829,1,21,4,3,66,23,43,67
N'castle Jet,8829,2,16,5,7,61,39,22,53
Melbourne C,8829,3,14,4,11,45,37,8,46
Melbourne V,8829,4,13,5,11,46,40,6,44
Adelaide Utd,8829,5,11,6,11,37,40,-3,39
Brisbane,8829,6,10,5,13,33,42,-9,35
Western Sydn,8829,7,8,9,10,38,47,-9,33
Perth Glory,8829,8,10,2,15,37,50,-13,32
Wellington P,8829,9,5,6,16,31,55,-24,21
CC Mariners,8829,10,4,8,15,28,49,-21,20
Sydney FC,8830,1,20,5,3,65,23,42,65
N'castle Jet,8830,2,16,5,7,59,37,22,53
Melbourne C,8830,3,14,4,11,43,35,8,46
Melbourne V,8830,4,13,6,10,46,39,7,45
Adelaide Utd,8830,5,11,6,11,37,40,-3,39
Brisbane,8830,6,10,5,13,33,42,-9,35
Western Sydn,8830,7,8,9,10,38,47,-9,33
Perth Glory,8830,8,10,2,15,37,50,-13,32
Wellington P,8830,9,5,6,16,31,55,-24,21
CC Mariners,8830,10,4,8,15,28,49,-21,20
Sydney FC,8831,1,21,4,3,67,22,45,67
N'castle Jet,8831,2,15,5,8,57,38,19,50
Melbourne C,8831,3,15,4,10,44,33,11,49
Melbourne V,8831,4,13,5,11,45,41,4,44
Adelaide Utd,8831,5,11,6,11,37,40,-3,39
Brisbane,8831,6,10,5,13,33,42,-9,35
Western Sydn,8831,7,8,9,10,38,47,-9,33
Perth Glory,8831,8,10,2,15,37,50,-13,32
Wellington P,8831,9,5,6,16,31,55,-24,21
CC Mariners,8831,10,4,8,15,28,49,-21,20
Sydney FC,8832,1,21,4,3,68,24,44,67
N'castle Jet,8832,2,15,6,7,59,39,20,51
Melbourne C,8832,3,14,5,10,45,35,10,47
Melbourne V,8832,4,13,5,11,47,42,5,44
Adelaide Utd,8832,5,11,6,11,37,40,-3,39
Brisbane,8832,6,10,5,13,33,42,-9,35
Western Sydn,8832,7,8,9,10,38,47,-9,33
Perth Glory,8832,8,10,2,15,37,50,-13,32
Wellington P,8832,9,5,6,16,31,55,-24,21
CC Mariners,8832,10,4,8,15,28,49,-21,20
Sydney FC,8833,1,20,4,4,65,24,41,64
N'castle Jet,8833,2,16,5,7,61,40,21,53
Melbourne V,8833,3,14,5,10,47,39,8,47
Melbourne C,8833,4,14,4,11,46,37,9,46
Adelaide Utd,8833,5,11,6,11,37,40,-3,39
Brisbane,8833,6,10,5,13,33,42,-9,35
Western Sydn,8833,7,8,9,10,38,47,-9,33
Perth Glory,8833,8,10,2,15,37,50,-13,32
Wellington P,8833,9,5,6,16,31,55,-24,21
CC Mariners,8833,10,4,8,15,28,49,-21,20
Sydney FC,8834,1,21,4,3,68,22,46,67
N'castle Jet,8834,2,16,5,7,61,40,21,53
Melbourne C,8834,3,14,4,11,46,37,9,46
Melbourne V,8834,4,13,5,11,45,42,3,44
Adelaide Utd,8834,5,11,6,11,37,40,-3,39
Brisbane,8834,6,10,5,13,33,42,-9,35
Western Sydn,8834,7,8,9,10,38,47,-9,33
Perth Glory,8834,8,10,2,15,37,50,-13,32
Wellington P,8834,9,5,6,16,31,55,-24,21
CC Mariners,8834,10,4,8,15,28,49,-21,20
Sydney FC,8835,1,21,4,3,66,22,44,67
N'castle Jet,8835,2,16,5,7,61,39,22,53
Melbourne C,8835,3,14,4,11,45,37,8,46
Melbourne V,8835,4,13,5,11,45,40,5,44
Adelaide Utd,8835,5,11,6,11,37,40,-3,39
Brisbane,8835,6,10,5,13,33,42,-9,35
Western Sydn,8835,7,8,9,10,38,47,-9,33
Perth Glory,8835,8,10,2,15,37,50,-13,32
Wellington P,8835,9,5,6,16,31,55,-24,21
CC Mariners,8835,10,4,8,15,28,49,-21,20
Sydney FC,8836,1,21,4,3,69,23,46,67
N'castle Jet,8836,2,16,5,7,59,37,22,53
Melbourne C,8836,3,14,4,11,43,35,8,46
Melbourne V,8836,4,13,5,11,46,43,3,44
Adelaide Utd,8836,5,11,6,11,37,40,-3,39
Brisbane,8836,6,10,5,13,33,42,-9,35
Western Sydn,8836,7,8,9,10,38,47,-9,33
Perth Glory,8836,8,10,2,15,37,50,-13,32
Wellington P,8836,9,5,6,16,31,55,-24,21
CC Mariners,8836,10,4,8,15,28,49,-21,20
Sydney FC,8837,1,21,4,3,65,22,43,67
N'castle Jet,8837,2,16,5,7,60,38,22,53
Melbourne C,8837,3,14,4,11,44,36,8,46
Melbourne V,8837,4,13,5,11,45,39,6,44
Adelaide Utd,8837,5,11,6,11,37,40,-3,39
Brisbane,8837,6,10,5,13,33,42,-9,35
Western Sydn,8837,7,8,9,10,38,47,-9,33
Perth Glory,8837,8,10,2,15,37,50,-13,32
Wellington P,8837,9,5,6,16,31,55,-24,21
CC Mariners,8837,10,4,8,15,28,49,-21,20
Sydney FC,8838,1,20,5,3,65,23,42,65
N'castle Jet,8838,2,16,5,7,61,37,24,53
Melbourne C,8838,3,14,4,11,43,37,6,46
Melbourne V,8838,4,13,6,10,46,39,7,45
Adelaide Utd,8838,5,11,6,11,37,40,-3,39
Brisbane,8838,6,10,5,13,33,42,-9,35
Western Sydn,8838,7,8,9,10,38,47,-9,33
Perth Glory,8838,8,10,2,15,37,50,-13,32
Wellington P,8838,9,5,6,16,31,55,-24,21
CC Mariners,8838,10,4,8,15,28,49,-21,20
Sydney FC,8839,1,21,4,3,68,22,46,67
N'castle Jet,8839,2,15,6,7,59,39,20,51
Melbourne C,8839,3,14,5,10,45,35,10,47
Melbourne V,8839,4,13,5,11,45,42,3,44
Adelaide Utd,8839,5,11,6,11,37,40,-3,39
Brisbane,8839,6,10,5,13,33,42,-9,35
Western Sydn,8839,7,8,9,10,38,47,-9,33
Perth Glory,8839,8,10,2,15,37,50,-13,32
Wellington P,8839,9,5,6,16,31,55,-24,21
CC Mariners,8839,10,4,8,15,28,49,-21,20
Sydney FC,8840,1,21,4,3,66,22,44,67
N'castle Jet,8840,2,16,5,7,59,37,22,53
Melbourne C,8840,3,14,4,11,43,35,8,46
Melbourne V,8840,4,13,5,11,45,40,5,44
Adelaide Utd,8840,5,11,6,11,37,40,-3,39
Brisbane,8840,6,10,5,13,33,42,-9,35
Western Sydn,8840,7,8,9,10,38,47,-9,33
Perth Glory,8840,8,10,2,15,37,50,-13,32
Wellington P,8840,9,5,6,16,31,55,-24,21
CC Mariners,8840,10,4,8,15,28,49,-21,20
Sydney FC,8841,1,21,4,3,66,23,43,67
N'castle Jet,8841,2,16,5,7,61,38,23,53
Melbourne C,8841,3,14,4,11,44,37,7,46
Melbourne V,8841,4,13,5,11,46,40,6,44
Adelaide Utd,8841,5,11,6,11,37,40,-3,39
Brisbane,8841,6,10,5,13,33,42,-9,35
Western Sydn,8841,7,8,9,10,38,47,-9,33
Perth Glory,8841,8,10,2,15,37,50,-13,32
Wellington P,8841,9,5,6,16,31,55,-24,21
CC Mariners,8841,10,4,8,15,28,49,-21,20
Sydney FC,8842,1,20,5,3,66,24,42,65
N'castle Jet,8842,2,15,6,7,57,37,20,51
Melbourne C,8842,3,14,5,10,43,33,10,47
Melbourne V,8842,4,13,6,10,47,40,7,45
Adelaide Utd,8842,5,11,6,11,37,40,-3,39
Brisbane,8842,6,10,5,13,33,42,-9,35
Western Sydn,8842,7,8,9,10,38,47,-9,33
Perth Glory,8842,8,10,2,15,37,50,-13,32
Wellington P,8842,9,5,6,16,31,55,-24,21
CC Mariners,8842,10,4,8,15,28,49,-21,20
Sydney FC,8843,1,20,4,4,65,24,41,64
N'castle Jet,8843,2,15,6,7,59,39,20,51
Melbourne C,8843,3,14,5,10,45,35,10,47
Melbourne V,8843,4,14,5,10,47,39,8,47
Adelaide Utd,8843,5,11,6,11,37,40,-3,39
Brisbane,8843,6,10,5,13,33,42,-9,35
Western Sydn,8843,7,8,9,10,38,47,-9,33
Perth Glory,8843,8,10,2,15,37,50,-13,32
Wellington P,8843,9,5,6,16,31,55,-24,21
CC Mariners,8843,10,4,8,15,28,49,-21,20
Sydney FC,8844,1,21,4,3,68,24,44,67
N'castle Jet,8844,2,15,6,7,57,37,20,51
Melbourne C,8844,3,14,5,10,43,33,10,47
Melbourne V,8844,4,13,5,11,47,42,5,44
Adelaide Utd,8844,5,11,6,11,37,40,-3,39
Brisbane,8844,6,10,5,13,33,42,-9,35
Western Sydn,8844,7,8,9,10,38,47,-9,33
Perth Glory,8844,8,10,2,15,37,50,-13,32
Wellington P,8844,9,5,6,16,31,55,-24,21
CC Mariners,8844,10,4,8,15,28,49,-21,20
Sydney FC,8845,1,20,4,4,65,24,41,64
N'castle Jet,8845,2,15,5,8,57,40,17,50
Melbourne C,8845,3,15,4,10,46,33,13,49
Melbourne V,8845,4,14,5,10,47,39,8,47
Adelaide Utd,8845,5,11,6,11,37,40,-3,39
Brisbane,8845,6,10,5,13,33,42,-9,35
Western Sydn,8845,7,8,9,10,38,47,-9,33
Perth Glory,8845,8,10,2,15,37,50,-13,32
Wellington P,8845,9,5,6,16,31,55,-24,21
CC Mariners,8845,10,4,8,15,28,49,-21,20
Sydney FC,8846,1,21,4,3,65,22,43,67
N'castle Jet,8846,2,16,5,7,59,37,22,53
Melbourne C,8846,3,14,4,11,43,35,8,46
Melbourne V,8846,4,13,5,11,45,39,6,44
Adelaide Utd,8846,5,11,6,11,37,40,-3,39
Brisbane,8846,6,10,5,13,33,42,-9,35
Western Sydn,8846,7,8,9,10,38,47,-9,33
Perth Glory,8846,8,10,2,15,37,50,-13,32
Wellington P,8846,9,5,6,16,31,55,-24,21
CC Mariners,8846,10,4,8,15,28,49,-21,20
Sydney FC,8847,1,21,4,3,67,22,45,67
N'castle Jet,8847,2,15,5,8,57,38,19,50
Melbourne C,8847,3,15,4,10,44,33,11,49
Melbourne V,8847,4,13,5,11,45,41,4,44
Adelaide Utd,8847,5,11,6,11,37,40,-3,39
Brisbane,8847,6,10,5,13,33,42,-9,35
Western Sydn,8847,7,8,9,10,38,47,-9,33
Perth Glory,8847,8,10,2,15,37,50,-13,32
Wellington P,8847,9,5,6,16,31,55,-24,21
CC Mariners,8847,10,4,8,15,28,49,-21,20
Sydney FC,8848,1,20,4,4,64,25,39,64
N'castle Jet,8848,2,16,5,7,59,38,21,53
Melbourne V,8848,3,14,5,10,48,38,10,47
Melbourne C,8848,4,14,4,11,44,35,9,46
Adelaide Utd,8848,5,11,6,11,37,40,-3,39
Brisbane,8848,6,10,5,13,33,42,-9,35
Western Sydn,8848,7,8,9,10,38,47,-9,33
Perth Glory,8848,8,10,2,15,37,50,-13,32
Wellington P,8848,9,5,6,16,31,55,-24,21
CC Mariners,8848,10,4,8,15,28,49,-21,20
Sydney FC,8849,1,21,4,3,66,23,43,67
N'castle Jet,8849,2,16,5,7,59,38,21,53
Melbourne C,8849,3,14,4,11,44,35,9,46
Melbourne V,8849,4,13,5,11,46,40,6,44
Adelaide Utd,8849,5,11,6,11,37,40,-3,39
Brisbane,8849,6,10,5,13,33,42,-9,35
Western Sydn,8849,7,8,9,10,38,47,-9,33
Perth Glory,8849,8,10,2,15,37,50,-13,32
Wellington P,8849,9,5,6,16,31,55,-24,21
CC Mariners,8849,10,4,8,15,28,49,-21,20
Sydney FC,8850,1,20,5,3,64,22,42,65
N'castle Jet,8850,2,15,6,7,59,39,20,51
Melbourne C,8850,3,14,5,10,45,35,10,47
Melbourne V,8850,4,13,6,10,45,38,7,45
Adelaide Utd,8850,5,11,6,11,37,40,-3,39
Brisbane,8850,6,10,5,13,33,42,-9,35
Western Sydn,8850,7,8,9,10,38,47,-9,33
Perth Glory,8850,8,10,2,15,37,50,-13,32
Wellington P,8850,9,5,6,16,31,55,-24,21
CC Mariners,8850,10,4,8,15,28,49,-21,20
Sydney FC,8851,1,21,4,3,66,22,44,67
N'castle Jet,8851,2,15,6,7,59,39,20,51
Melbourne C,8851,3,14,5,10,45,35,10,47
Melbourne V,8851,4,13,5,11,45,40,5,44
Adelaide Utd,8851,5,11,6,11,37,40,-3,39
Brisbane,8851,6,10,5,13,33,42,-9,35
Western Sydn,8851,7,8,9,10,38,47,-9,33
Perth Glory,8851,8,10,2,15,37,50,-13,32
Wellington P,8851,9,5,6,16,31,55,-24,21
CC Mariners,8851,10,4,8,15,28,49,-21,20
Sydney FC,8852,1,21,4,3,66,22,44,67
N'castle Jet,8852,2,16,5,7,59,37,22,53
Melbourne C,8852,3,14,4,11,43,35,8,46
Melbourne V,8852,4,13,5,11,45,40,5,44
Adelaide Utd,8852,5,11,6,11,37,40,-3,39
Brisbane,8852,6,10,5,13,33,42,-9,35
Western Sydn,8852,7,8,9,10,38,47,-9,33
Perth Glory,8852,8,10,2,15,37,50,-13,32
Wellington P,8852,9,5,6,16,31,55,-24,21
CC Mariners,8852,10,4,8,15,28,49,-21,20
Sydney FC,8853,1,21,4,3,66,22,44,67
N'castle Jet,8853,2,16,5,7,59,37,22,53
Melbourne C,8853,3,14,4,11,43,35,8,46
Melbourne V,8853,4,13,5,11,45,40,5,44
Adelaide Utd,8853,5,11,6,11,37,40,-3,39
Brisbane,8853,6,10,5,13,33,42,-9,35
Western Sydn,8853,7,8,9,10,38,47,-9,33
Perth Glory,8853,8,10,2,15,37,50,-13,32
Wellington P,8853,9,5,6,16,31,55,-24,21
CC Mariners,8853,10,4,8,15,28,49,-21,20
Sydney FC,8854,1,20,5,3,65,23,42,65
N'castle Jet,8854,2,15,6,7,58,38,20,51
Melbourne C,8854,3,14,5,10,44,34,10,47
Melbourne V,8854,4,13,6,10,46,39,7,45
Adelaide Utd,8854,5,11,6,11,37,40,-3,39
Brisbane,8854,6,10,5,13,33,42,-9,35
Western Sydn,8854,7,8,9,10,38,47,-9,33
Perth Glory,8854,8,10,2,15,37,50,-13,32
Wellington P,8854,9,5,6,16,31,55,-24,21
CC Mariners,8854,10,4,8,15,28,49,-21,20
Sydney FC,8855,1,21,4,3,66,23,43,67
N'castle Jet,8855,2,15,5,8,57,38,19,50
Melbourne C,8855,3,15,4,10,44,33,11,49
Melbourne V,8855,4,13,5,11,46,40,6,44
Adelaide Utd,8855,5,11,6,11,37,40,-3,39
Brisbane,8855,6,10,5,13,33,42,-9,35
Western Sydn,8855,7,8,9,10,38,47,-9,33
Perth Glory,8855,8,10,2,15,37,50,-13,32
Wellington P,8855,9,5,6,16,31,55,-24,21
CC Mariners,8855,10,4,8,15,28,49,-21,20
Sydney FC,8856,1,21,4,3,69,24,45,67
N'castle Jet,8856,2,16,5,7,61,39,22,53
Melbourne C,8856,3,14,4,11,45,37,8,46
Melbourne V,8856,4,13,5,11,47,43,4,44
Adelaide Utd,8856,5,11,6,11,37,40,-3,39
Brisbane,8856,6,10,5,13,33,42,-9,35
Western Sydn,8856,7,8,9,10,38,47,-9,33
Perth Glory,8856,8,10,2,15,37,50,-13,32
Wellington P,8856,9,5,6,16,31,55,-24,21
CC Mariners,8856,10,4,8,15,28,49,-21,20
Sydney FC,8857,1,21,4,3,68,25,43,67
N'castle Jet,8857,2,15,5,8,60,41,19,50
Melbourne C,8857,3,15,4,10,47,36,11,49
Melbourne V,8857,4,13,5,11,48,42,6,44
Adelaide Utd,8857,5,11,6,11,37,40,-3,39
Brisbane,8857,6,10,5,13,33,42,-9,35
Western Sydn,8857,7,8,9,10,38,47,-9,33
Perth Glory,8857,8,10,2,15,37,50,-13,32
Wellington P,8857,9,5,6,16,31,55,-24,21
CC Mariners,8857,10,4,8,15,28,49,-21,20
Sydney FC,8858,1,21,4,3,65,22,43,67
N'castle Jet,8858,2,16,5,7,62,38,24,53
Melbourne C,8858,3,14,4,11,44,38,6,46
Melbourne V,8858,4,13,5,11,45,39,6,44
Adelaide Utd,8858,5,11,6,11,37,40,-3,39
Brisbane,8858,6,10,5,13,33,42,-9,35
Western Sydn,8858,7,8,9,10,38,47,-9,33
Perth Glory,8858,8,10,2,15,37,50,-13,32
Wellington P,8858,9,5,6,16,31,55,-24,21
CC Mariners,8858,10,4,8,15,28,49,-21,20
Sydney FC,8859,1,21,4,3,65,22,43,67
N'castle Jet,8859,2,16,5,7,58,37,21,53
Melbourne C,8859,3,14,4,11,43,34,9,46
Melbourne V,8859,4,13,5,11,45,39,6,44
Adelaide Utd,8859,5,11,6,11,37,40,-3,39
Brisbane,8859,6,10,5,13,33,42,-9,35
Western Sydn,8859,7,8,9,10,38,47,-9,33
Perth Glory,8859,8,10,2,15,37,50,-13,32
Wellington P,8859,9,5,6,16,31,55,-24,21
CC Mariners,8859,10,4,8,15,28,49,-21,20
Sydney FC,8860,1,21,4,3,65,22,43,67
N'castle Jet,8860,2,16,5,7,58,37,21,53
Melbourne C,8860,3,14,4,11,43,34,9,46
Melbourne V,8860,4,13,5,11,45,39,6,44
Adelaide Utd,8860,5,11,6,11,37,40,-3,39
Brisbane,8860,6,10,5,13,33,42,-9,35
Western Sydn,8860,7,8,9,10,38,47,-9,33
Perth Glory,8860,8,10,2,15,37,50,-13,32
Wellington P,8860,9,5,6,16,31,55,-24,21
CC Mariners,8860,10,4,8,15,28,49,-21,20
Sydney FC,8861,1,20,5,3,65,23,42,65
N'castle Jet,8861,2,16,5,7,58,37,21,53
Melbourne C,8861,3,14,4,11,43,34,9,46
Melbourne V,8861,4,13,6,10,46,39,7,45
Adelaide Utd,8861,5,11,6,11,37,40,-3,39
Brisbane,8861,6,10,5,13,33,42,-9,35
Western Sydn,8861,7,8,9,10,38,47,-9,33
Perth Glory,8861,8,10,2,15,37,50,-13,32
Wellington P,8861,9,5,6,16,31,55,-24,21
CC Mariners,8861,10,4,8,15,28,49,-21,20
Sydney FC,8862,1,21,4,3,68,22,46,67
N'castle Jet,8862,2,16,5,7,58,37,21,53
Melbourne C,8862,3,14,4,11,43,34,9,46
Melbourne V,8862,4,13,5,11,45,42,3,44
Adelaide Utd,8862,5,11,6,11,37,40,-3,39
Brisbane,8862,6,10,5,13,33,42,-9,35
Western Sydn,8862,7,8,9,10,38,47,-9,33
Perth Glory,8862,8,10,2,15,37,50,-13,32
Wellington P,8862,9,5,6,16,31,55,-24,21
CC Mariners,8862,10,4,8,15,28,49,-21,20
Sydney FC,8863,1,21,4,3,69,22,47,67
N'castle Jet,8863,2,15,5,8,58,40,18,50
Melbourne C,8863,3,15,4,10,46,34,12,49
Melbourne V,8863,4,13,5,11,45,43,2,44
Adelaide Utd,8863,5,11,6,11,37,40,-3,39
Brisbane,8863,6,10,5,13,33,42,-9,35
Western Sydn,8863,7,8,9,10,38,47,-9,33
Perth Glory,8863,8,10,2,15,37,50,-13,32
Wellington P,8863,9,5,6,16,31,55,-24,21
CC Mariners,8863,10,4,8,15,28,49,-21,20
Sydney FC,8864,1,21,4,3,67,23,44,67
N'castle Jet,8864,2,15,6,7,58,38,20,51
Melbourne C,8864,3,14,5,10,44,34,10,47
Melbourne V,8864,4,13,5,11,46,41,5,44
Adelaide Utd,8864,5,11,6,11,37,40,-3,39
Brisbane,8864,6,10,5,13,33,42,-9,35
Western Sydn,8864,7,8,9,10,38,47,-9,33
Perth Glory,8864,8,10,2,15,37,50,-13,32
Wellington P,8864,9,5,6,16,31,55,-24,21
CC Mariners,8864,10,4,8,15,28,49,-21,20
Sydney FC,8865,1,21,4,3,67,22,45,67
N'castle Jet,8865,2,16,5,7,60,38,22,53
Melbourne C,8865,3,14,4,11,44,36,8,46
Melbourne V,8865,4,13,5,11,45,41,4,44
Adelaide Utd,8865,5,11,6,11,37,40,-3,39
Brisbane,8865,6,10,5,13,33,42,-9,35
Western Sydn,8865,7,8,9,10,38,47,-9,33
Perth Glory,8865,8,10,2,15,37,50,-13,32
Wellington P,8865,9,5,6,16,31,55,-24,21
CC Mariners,8865,10,4,8,15,28,49,-21,20
Sydney FC,8866,1,20,4,4,64,23,41,64
N'castle Jet,8866,2,15,6,7,58,38,20,51
Melbourne C,8866,3,14,5,10,44,34,10,47
Melbourne V,8866,4,14,5,10,46,38,8,47
Adelaide Utd,8866,5,11,6,11,37,40,-3,39
Brisbane,8866,6,10,5,13,33,42,-9,35
Western Sydn,8866,7,8,9,10,38,47,-9,33
Perth Glory,8866,8,10,2,15,37,50,-13,32
Wellington P,8866,9,5,6,16,31,55,-24,21
CC Mariners,8866,10,4,8,15,28,49,-21,20
Sydney FC,8867,1,20,5,3,65,23,42,65
N'castle Jet,8867,2,16,5,7,59,38,21,53
Melbourne C,8867,3,14,4,11,44,35,9,46
Melbourne V,8867,4,13,6,10,46,39,7,45
Adelaide Utd,8867,5,11,6,11,37,40,-3,39
Brisbane,8867,6,10,5,13,33,42,-9,35
Western Sydn,8867,7,8,9,10,38,47,-9,33
Perth Glory,8867,8,10,2,15,37,50,-13,32
Wellington P,8867,9,5,6,16,31,55,-24,21
CC Mariners,8867,10,4,8,15,28,49,-21,20
Sydney FC,8868,1,20,4,4,67,27,40,64
N'castle Jet,8868,2,16,5,7,59,38,21,53
Melbourne V,8868,3,14,5,10,50,41,9,47
Melbourne C,8868,4,14,4,11,44,35,9,46
Adelaide Utd,8868,5,11,6,11,37,40,-3,39
Brisbane,8868,6,10,5,13,33,42,-9,35
Western Sydn,8868,7,8,9,10,38,47,-9,33
Perth Glory,8868,8,10,2,15,37,50,-13,32
Wellington P,8868,9,5,6,16,31,55,-24,21
CC Mariners,8868,10,4,8,15,28,49,-21,20
Sydney FC,8869,1,21,4,3,67,22,45,67
N'castle Jet,8869,2,15,5,8,57,38,19,50
Melbourne C,8869,3,15,4,10,44,33,11,49
Melbourne V,8869,4,13,5,11,45,41,4,44
Adelaide Utd,8869,5,11,6,11,37,40,-3,39
Brisbane,8869,6,10,5,13,33,42,-9,35
Western Sydn,8869,7,8,9,10,38,47,-9,33
Perth Glory,8869,8,10,2,15,37,50,-13,32
Wellington P,8869,9,5,6,16,31,55,-24,21
CC Mariners,8869,10,4,8,15,28,49,-21,20
Sydney FC,8870,1,21,4,3,69,22,47,67
N'castle Jet,8870,2,16,5,7,58,37,21,53
Melbourne C,8870,3,14,4,11,43,34,9,46
Melbourne V,8870,4,13,5,11,45,43,2,44
Adelaide Utd,8870,5,11,6,11,37,40,-3,39
Brisbane,8870,6,10,5,13,33,42,-9,35
Western Sydn,8870,7,8,9,10,38,47,-9,33
Perth Glory,8870,8,10,2,15,37,50,-13,32
Wellington P,8870,9,5,6,16,31,55,-24,21
CC Mariners,8870,10,4,8,15,28,49,-21,20
Sydney FC,8871,1,21,4,3,65,22,43,67
N'castle Jet,8871,2,15,6,7,58,38,20,51
Melbourne C,8871,3,14,5,10,44,34,10,47
Melbourne V,8871,4,13,5,11,45,39,6,44
Adelaide Utd,8871,5,11,6,11,37,40,-3,39
Brisbane,8871,6,10,5,13,33,42,-9,35
Western Sydn,8871,7,8,9,10,38,47,-9,33
Perth Glory,8871,8,10,2,15,37,50,-13,32
Wellington P,8871,9,5,6,16,31,55,-24,21
CC Mariners,8871,10,4,8,15,28,49,-21,20
Sydney FC,8872,1,21,4,3,67,22,45,67
N'castle Jet,8872,2,15,6,7,60,40,20,51
Melbourne C,8872,3,14,5,10,46,36,10,47
Melbourne V,8872,4,13,5,11,45,41,4,44
Adelaide Utd,8872,5,11,6,11,37,40,-3,39
Brisbane,8872,6,10,5,13,33,42,-9,35
Western Sydn,8872,7,8,9,10,38,47,-9,33
Perth Glory,8872,8,10,2,15,37,50,-13,32
Wellington P,8872,9,5,6,16,31,55,-24,21
CC Mariners,8872,10,4,8,15,28,49,-21,20
Sydney FC,8873,1,20,5,3,64,22,42,65
N'castle Jet,8873,2,16,5,7,60,37,23,53
Melbourne C,8873,3,14,4,11,43,36,7,46
Melbourne V,8873,4,13,6,10,45,38,7,45
Adelaide Utd,8873,5,11,6,11,37,40,-3,39
Brisbane,8873,6,10,5,13,33,42,-9,35
Western Sydn,8873,7,8,9,10,38,47,-9,33
Perth Glory,8873,8,10,2,15,37,50,-13,32
Wellington P,8873,9,5,6,16,31,55,-24,21
CC Mariners,8873,10,4,8,15,28,49,-21,20
Sydney FC,8874,1,21,4,3,66,22,44,67
N'castle Jet,8874,2,16,5,7,60,38,22,53
Melbourne C,8874,3,14,4,11,44,36,8,46
Melbourne V,8874,4,13,5,11,45,40,5,44
Adelaide Utd,8874,5,11,6,11,37,40,-3,39
Brisbane,8874,6,10,5,13,33,42,-9,35
Western Sydn,8874,7,8,9,10,38,47,-9,33
Perth Glory,8874,8,10,2,15,37,50,-13,32
Wellington P,8874,9,5,6,16,31,55,-24,21
CC Mariners,8874,10,4,8,15,28,49,-21,20
Sydney FC,8875,1,20,5,3,64,22,42,65
N'castle Jet,8875,2,16,5,7,61,39,22,53
Melbourne C,8875,3,14,4,11,45,37,8,46
Melbourne V,8875,4,13,6,10,45,38,7,45
Adelaide Utd,8875,5,11,6,11,37,40,-3,39
Brisbane,8875,6,10,5,13,33,42,-9,35
Western Sydn,8875,7,8,9,10,38,47,-9,33
Perth Glory,8875,8,10,2,15,37,50,-13,32
Wellington P,8875,9,5,6,16,31,55,-24,21
CC Mariners,8875,10,4,8,15,28,49,-21,20
Sydney FC,8876,1,20,5,3,65,23,42,65
N'castle Jet,8876,2,15,6,7,57,37,20,51
Melbourne C,8876,3,14,5,10,43,33,10,47
Melbourne V,8876,4,13,6,10,46,39,7,45
Adelaide Utd,8876,5,11,6,11,37,40,-3,39
Brisbane,8876,6,10,5,13,33,42,-9,35
Western Sydn,8876,7,8,9,10,38,47,-9,33
Perth Glory,8876,8,10,2,15,37,50,-13,32
Wellington P,8876,9,5,6,16,31,55,-24,21
CC Mariners,8876,10,4,8,15,28,49,-21,20
Sydney FC,8877,1,21,4,3,67,24,43,67
N'castle Jet,8877,2,15,6,7,59,39,20,51
Melbourne C,8877,3,14,5,10,45,35,10,47
Melbourne V,8877,4,13,5,11,47,41,6,44
Adelaide Utd,8877,5,11,6,11,37,40,-3,39
Brisbane,8877,6,10,5,13,33,42,-9,35
Western Sydn,8877,7,8,9,10,38,47,-9,33
Perth Glory,8877,8,10,2,15,37,50,-13,32
Wellington P,8877,9,5,6,16,31,55,-24,21
CC Mariners,8877,10,4,8,15,28,49,-21,20
Sydney FC,8878,1,21,4,3,65,22,43,67
N'castle Jet,8878,2,16,5,7,58,37,21,53
Melbourne C,8878,3,14,4,11,43,34,9,46
Melbourne V,8878,4,13,5,11,45,39,6,44
Adelaide Utd,8878,5,11,6,11,37,40,-3,39
Brisbane,8878,6,10,5,13,33,42,-9,35
Western Sydn,8878,7,8,9,10,38,47,-9,33
Perth Glory,8878,8,10,2,15,37,50,-13,32
Wellington P,8878,9,5,6,16,31,55,-24,21
CC Mariners,8878,10,4,8,15,28,49,-21,20
Sydney FC,8879,1,21,4,3,67,23,44,67
N'castle Jet,8879,2,15,6,7,59,39,20,51
Melbourne C,8879,3,14,5,10,45,35,10,47
Melbourne V,8879,4,13,5,11,46,41,5,44
Adelaide Utd,8879,5,11,6,11,37,40,-3,39
Brisbane,8879,6,10,5,13,33,42,-9,35
Western Sydn,8879,7,8,9,10,38,47,-9,33
Perth Glory,8879,8,10,2,15,37,50,-13,32
Wellington P,8879,9,5,6,16,31,55,-24,21
CC Mariners,8879,10,4,8,15,28,49,-21,20
Sydney FC,8880,1,21,4,3,66,23,43,67
N'castle Jet,8880,2,15,5,8,57,39,18,50
Melbourne C,8880,3,15,4,10,45,33,12,49
Melbourne V,8880,4,13,5,11,46,40,6,44
Adelaide Utd,8880,5,11,6,11,37,40,-3,39
Brisbane,8880,6,10,5,13,33,42,-9,35
Western Sydn,8880,7,8,9,10,38,47,-9,33
Perth Glory,8880,8,10,2,15,37,50,-13,32
Wellington P,8880,9,5,6,16,31,55,-24,21
CC Mariners,8880,10,4,8,15,28,49,-21,20
Sydney FC,8881,1,21,4,3,66,22,44,67
N'castle Jet,8881,2,15,6,7,58,38,20,51
Melbourne C,8881,3,14,5,10,44,34,10,47
Melbourne V,8881,4,13,5,11,45,40,5,44
Adelaide Utd,8881,5,11,6,11,37,40,-3,39
Brisbane,8881,6,10,5,13,33,42,-9,35
Western Sydn,8881,7,8,9,10,38,47,-9,33
Perth Glory,8881,8,10,2,15,37,50,-13,32
Wellington P,8881,9,5,6,16,31,55,-24,21
CC Mariners,8881,10,4,8,15,28,49,-21,20
Sydney FC,8882,1,21,4,3,65,22,43,67
N'castle Jet,8882,2,15,5,8,57,38,19,50
Melbourne C,8882,3,15,4,10,44,33,11,49
Melbourne V,8882,4,13,5,11,45,39,6,44
Adelaide Utd,8882,5,11,6,11,37,40,-3,39
Brisbane,8882,6,10,5,13,33,42,-9,35
Western Sydn,8882,7,8,9,10,38,47,-9,33
Perth Glory,8882,8,10,2,15,37,50,-13,32
Wellington P,8882,9,5,6,16,31,55,-24,21
CC Mariners,8882,10,4,8,15,28,49,-21,20
Sydney FC,8883,1,20,4,4,65,24,41,64
N'castle Jet,8883,2,16,5,7,62,38,24,53
Melbourne V,8883,3,14,5,10,47,39,8,47
Melbourne C,8883,4,14,4,11,44,38,6,46
Adelaide Utd,8883,5,11,6,11,37,40,-3,39
Brisbane,8883,6,10,5,13,33,42,-9,35
Western Sydn,8883,7,8,9,10,38,47,-9,33
Perth Glory,8883,8,10,2,15,37,50,-13,32
Wellington P,8883,9,5,6,16,31,55,-24,21
CC Mariners,8883,10,4,8,15,28,49,-21,20
Sydney FC,8884,1,21,4,3,66,22,44,67
N'castle Jet,8884,2,15,5,8,58,39,19,50
Melbourne C,8884,3,15,4,10,45,34,11,49
Melbourne V,8884,4,13,5,11,45,40,5,44
Adelaide Utd,8884,5,11,6,11,37,40,-3,39
Brisbane,8884,6,10,5,13,33,42,-9,35
Western Sydn,8884,7,8,9,10,38,47,-9,33
Perth Glory,8884,8,10,2,15,37,50,-13,32
Wellington P,8884,9,5,6,16,31,55,-24,21
CC Mariners,8884,10,4,8,15,28,49,-21,20
Sydney FC,8885,1,21,4,3,65,22,43,67
N'castle Jet,8885,2,15,6,7,57,37,20,51
Melbourne C,8885,3,14,5,10,43,33,10,47
Melbourne V,8885,4,13,5,11,45,39,6,44
Adelaide Utd,8885,5,11,6,11,37,40,-3,39
Brisbane,8885,6,10,5,13,33,42,-9,35
Western Sydn,8885,7,8,9,10,38,47,-9,33
Perth Glory,8885,8,10,2,15,37,50,-13,32
Wellington P,8885,9,5,6,16,31,55,-24,21
CC Mariners,8885,10,4,8,15,28,49,-21,20
Sydney FC,8886,1,20,5,3,66,24,42,65
N'castle Jet,8886,2,16,5,7,59,38,21,53
Melbourne C,8886,3,14,4,11,44,35,9,46
Melbourne V,8886,4,13,6,10,47,40,7,45
Adelaide Utd,8886,5,11,6,11,37,40,-3,39
Brisbane,8886,6,10,5,13,33,42,-9,35
Western Sydn,8886,7,8,9,10,38,47,-9,33
Perth Glory,8886,8,10,2,15,37,50,-13,32
Wellington P,8886,9,5,6,16,31,55,-24,21
CC Mariners,8886,10,4,8,15,28,49,-21,20
Sydney FC,8887,1,21,4,3,67,23,44,67
N'castle Jet,8887,2,15,5,8,57,39,18,50
Melbourne C,8887,3,15,4,10,45,33,12,49
Melbourne V,8887,4,13,5,11,46,41,5,44
Adelaide Utd,8887,5,11,6,11,37,40,-3,39
Brisbane,8887,6,10,5,13,33,42,-9,35
Western Sydn,8887,7,8,9,10,38,47,-9,33
Perth Glory,8887,8,10,2,15,37,50,-13,32
Wellington P,8887,9,5,6,16,31,55,-24,21
CC Mariners,8887,10,4,8,15,28,49,-21,20
Sydney FC,8888,1,21,4,3,66,23,43,67
N'castle Jet,8888,2,16,5,7,58,37,21,53
Melbourne C,8888,3,14,4,11,43,34,9,46
Melbourne V,8888,4,13,5,11,46,40,6,44
Adelaide Utd,8888,5,11,6,11,37,40,-3,39
Brisbane,8888,6,10,5,13,33,42,-9,35
Western Sydn,8888,7,8,9,10,38,47,-9,33
Perth Glory,8888,8,10,2,15,37,50,-13,32
Wellington P,8888,9,5,6,16,31,55,-24,21
CC Mariners,8888,10,4,8,15,28,49,-21,20
Sydney FC,8889,1,21,4,3,66,23,43,67
N'castle Jet,8889,2,15,6,7,57,37,20,51
Melbourne C,8889,3,14,5,10,43,33,10,47
Melbourne V,8889,4,13,5,11,46,40,6,44
Adelaide Utd,8889,5,11,6,11,37,40,-3,39
Brisbane,8889,6,10,5,13,33,42,-9,35
Western Sydn,8889,7,8,9,10,38,47,-9,33
Perth Glory,8889,8,10,2,15,37,50,-13,32
Wellington P,8889,9,5,6,16,31,55,-24,21
CC Mariners,8889,10,4,8,15,28,49,-21,20
Sydney FC,8890,1,20,5,3,65,23,42,65
N'castle Jet,8890,2,16,5,7,58,37,21,53
Melbourne C,8890,3,14,4,11,43,34,9,46
Melbourne V,8890,4,13,6,10,46,39,7,45
Adelaide Utd,8890,5,11,6,11,37,40,-3,39
Brisbane,8890,6,10,5,13,33,42,-9,35
Western Sydn,8890,7,8,9,10,38,47,-9,33
Perth Glory,8890,8,10,2,15,37,50,-13,32
Wellington P,8890,9,5,6,16,31,55,-24,21
CC Mariners,8890,10,4,8,15,28,49,-21,20
Sydney FC,8891,1,21,4,3,66,22,44,67
N'castle Jet,8891,2,15,6,7,59,39,20,51
Melbourne C,8891,3,14,5,10,45,35,10,47
Melbourne V,8891,4,13,5,11,45,40,5,44
Adelaide Utd,8891,5,11,6,11,37,40,-3,39
Brisbane,8891,6,10,5,13,33,42,-9,35
Western Sydn,8891,7,8,9,10,38,47,-9,33
Perth Glory,8891,8,10,2,15,37,50,-13,32
Wellington P,8891,9,5,6,16,31,55,-24,21
CC Mariners,8891,10,4,8,15,28,49,-21,20
Sydney FC,8892,1,20,5,3,65,23,42,65
N'castle Jet,8892,2,16,5,7,58,37,21,53
Melbourne C,8892,3,14,4,11,43,34,9,46
Melbourne V,8892,4,13,6,10,46,39,7,45
Adelaide Utd,8892,5,11,6,11,37,40,-3,39
Brisbane,8892,6,10,5,13,33,42,-9,35
Western Sydn,8892,7,8,9,10,38,47,-9,33
Perth Glory,8892,8,10,2,15,37,50,-13,32
Wellington P,8892,9,5,6,16,31,55,-24,21
CC Mariners,8892,10,4,8,15,28,49,-21,20
Sydney FC,8893,1,21,4,3,69,23,46,67
N'castle Jet,8893,2,16,5,7,62,39,23,53
Melbourne C,8893,3,14,4,11,45,38,7,46
Melbourne V,8893,4,13,5,11,46,43,3,44
Adelaide Utd,8893,5,11,6,11,37,40,-3,39
Brisbane,8893,6,10,5,13,33,42,-9,35
Western Sydn,8893,7,8,9,10,38,47,-9,33
Perth Glory,8893,8,10,2,15,37,50,-13,32
Wellington P,8893,9,5,6,16,31,55,-24,21
CC Mariners,8893,10,4,8,15,28,49,-21,20
Sydney FC,8894,1,20,5,3,65,23,42,65
N'castle Jet,8894,2,16,5,7,60,38,22,53
Melbourne C,8894,3,14,4,11,44,36,8,46
Melbourne V,8894,4,13,6,10,46,39,7,45
Adelaide Utd,8894,5,11,6,11,37,40,-3,39
Brisbane,8894,6,10,5,13,33,42,-9,35
Western Sydn,8894,7,8,9,10,38,47,-9,33
Perth Glory,8894,8,10,2,15,37,50,-13,32
Wellington P,8894,9,5,6,16,31,55,-24,21
CC Mariners,8894,10,4,8,15,28,49,-21,20
Sydney FC,8895,1,20,4,4,64,23,41,64
N'castle Jet,8895,2,15,5,8,58,40,18,50
Melbourne C,8895,3,15,4,10,46,34,12,49
Melbourne V,8895,4,14,5,10,46,38,8,47
Adelaide Utd,8895,5,11,6,11,37,40,-3,39
Brisbane,8895,6,10,5,13,33,42,-9,35
Western Sydn,8895,7,8,9,10,38,47,-9,33
Perth Glory,8895,8,10,2,15,37,50,-13,32
Wellington P,8895,9,5,6,16,31,55,-24,21
CC Mariners,8895,10,4,8,15,28,49,-21,20
Sydney FC,8896,1,20,5,3,66,24,42,65
N'castle Jet,8896,2,16,5,7,59,38,21,53
Melbourne C,8896,3,14,4,11,44,35,9,46
Melbourne V,8896,4,13,6,10,47,40,7,45
Adelaide Utd,8896,5,11,6,11,37,40,-3,39
Brisbane,8896,6,10,5,13,33,42,-9,35
Western Sydn,8896,7,8,9,10,38,47,-9,33
Perth Glory,8896,8,10,2,15,37,50,-13,32
Wellington P,8896,9,5,6,16,31,55,-24,21
CC Mariners,8896,10,4,8,15,28,49,-21,20
Sydney FC,8897,1,20,4,4,64,23,41,64
N'castle Jet,8897,2,15,5,8,57,38,19,50
Melbourne C,8897,3,15,4,10,44,33,11,49
Melbourne V,8897,4,14,5,10,46,38,8,47
Adelaide Utd,8897,5,11,6,11,37,40,-3,39
Brisbane,8897,6,10,5,13,33,42,-9,35
Western Sydn,8897,7,8,9,10,38,47,-9,33
Perth Glory,8897,8,10,2,15,37,50,-13,32
Wellington P,8897,9,5,6,16,31,55,-24,21
CC Mariners,8897,10,4,8,15,28,49,-21,20
Sydney FC,8898,1,21,4,3,66,22,44,67
N'castle Jet,8898,2,15,5,8,58,39,19,50
Melbourne C,8898,3,15,4,10,45,34,11,49
Melbourne V,8898,4,13,5,11,45,40,5,44
Adelaide Utd,8898,5,11,6,11,37,40,-3,39
Brisbane,8898,6,10,5,13,33,42,-9,35
Western Sydn,8898,7,8,9,10,38,47,-9,33
Perth Glory,8898,8,10,2,15,37,50,-13,32
Wellington P,8898,9,5,6,16,31,55,-24,21
CC Mariners,8898,10,4,8,15,28,49,-21,20
Sydney FC,8899,1,20,5,3,66,24,42,65
N'castle Jet,8899,2,16,5,7,61,40,21,53
Melbourne C,8899,3,14,4,11,46,37,9,46
Melbourne V,8899,4,13,6,10,47,40,7,45
Adelaide Utd,8899,5,11,6,11,37,40,-3,39
Brisbane,8899,6,10,5,13,33,42,-9,35
Western Sydn,8899,7,8,9,10,38,47,-9,33
Perth Glory,8899,8,10,2,15,37,50,-13,32
Wellington P,8899,9,5,6,16,31,55,-24,21
CC Mariners,8899,10,4,8,15,28,49,-21,20
Sydney FC,8900,1,20,5,3,67,25,42,65
N'castle Jet,8900,2,16,5,7,58,37,21,53
Melbourne C,8900,3,14,4,11,43,34,9,46
Melbourne V,8900,4,13,6,10,48,41,7,45
Adelaide Utd,8900,5,11,6,11,37,40,-3,39
Brisbane,8900,6,10,5,13,33,42,-9,35
Western Sydn,8900,7,8,9,10,38,47,-9,33
Perth Glory,8900,8,10,2,15,37,50,-13,32
Wellington P,8900,9,5,6,16,31,55,-24,21
CC Mariners,8900,10,4,8,15,28,49,-21,20
Sydney FC,8901,1,21,4,3,67,22,45,67
N'castle Jet,8901,2,15,5,8,57,42,15,50
Melbourne C,8901,3,15,4,10,48,33,15,49
Melbourne V,8901,4,13,5,11,45,41,4,44
Adelaide Utd,8901,5,11,6,11,37,40,-3,39
Brisbane,8901,6,10,5,13,33,42,-9,35
Western Sydn,8901,7,8,9,10,38,47,-9,33
Perth Glory,8901,8,10,2,15,37,50,-13,32
Wellington P,8901,9,5,6,16,31,55,-24,21
CC Mariners,8901,10,4,8,15,28,49,-21,20
Sydney FC,8902,1,20,5,3,66,24,42,65
N'castle Jet,8902,2,16,5,7,60,38,22,53
Melbourne C,8902,3,14,4,11,44,36,8,46
Melbourne V,8902,4,13,6,10,47,40,7,45
Adelaide Utd,8902,5,11,6,11,37,40,-3,39
Brisbane,8902,6,10,5,13,33,42,-9,35
Western Sydn,8902,7,8,9,10,38,47,-9,33
Perth Glory,8902,8,10,2,15,37,50,-13,32
Wellington P,8902,9,5,6,16,31,55,-24,21
CC Mariners,8902,10,4,8,15,28,49,-21,20
Sydney FC,8903,1,21,4,3,67,23,44,67
N'castle Jet,8903,2,16,5,7,61,38,23,53
Melbourne C,8903,3,14,4,11,44,37,7,46
Melbourne V,8903,4,13,5,11,46,41,5,44
Adelaide Utd,8903,5,11,6,11,37,40,-3,39
Brisbane,8903,6,10,5,13,33,42,-9,35
Western Sydn,8903,7,8,9,10,38,47,-9,33
Perth Glory,8903,8,10,2,15,37,50,-13,32
Wellington P,8903,9,5,6,16,31,55,-24,21
CC Mariners,8903,10,4,8,15,28,49,-21,20
Sydney FC,8904,1,21,4,3,65,22,43,67
N'castle Jet,8904,2,16,5,7,61,39,22,53
Melbourne C,8904,3,14,4,11,45,37,8,46
Melbourne V,8904,4,13,5,11,45,39,6,44
Adelaide Utd,8904,5,11,6,11,37,40,-3,39
Brisbane,8904,6,10,5,13,33,42,-9,35
Western Sydn,8904,7,8,9,10,38,47,-9,33
Perth Glory,8904,8,10,2,15,37,50,-13,32
Wellington P,8904,9,5,6,16,31,55,-24,21
CC Mariners,8904,10,4,8,15,28,49,-21,20
Sydney FC,8905,1,20,5,3,65,23,42,65
N'castle Jet,8905,2,16,5,7,59,37,22,53
Melbourne C,8905,3,14,4,11,43,35,8,46
Melbourne V,8905,4,13,6,10,46,39,7,45
Adelaide Utd,8905,5,11,6,11,37,40,-3,39
Brisbane,8905,6,10,5,13,33,42,-9,35
Western Sydn,8905,7,8,9,10,38,47,-9,33
Perth Glory,8905,8,10,2,15,37,50,-13,32
Wellington P,8905,9,5,6,16,31,55,-24,21
CC Mariners,8905,10,4,8,15,28,49,-21,20
Sydney FC,8906,1,20,4,4,64,24,40,64
N'castle Jet,8906,2,15,6,7,58,38,20,51
Melbourne C,8906,3,14,5,10,44,34,10,47
Melbourne V,8906,4,14,5,10,47,38,9,47
Adelaide Utd,8906,5,11,6,11,37,40,-3,39
Brisbane,8906,6,10,5,13,33,42,-9,35
Western Sydn,8906,7,8,9,10,38,47,-9,33
Perth Glory,8906,8,10,2,15,37,50,-13,32
Wellington P,8906,9,5,6,16,31,55,-24,21
CC Mariners,8906,10,4,8,15,28,49,-21,20
Sydney FC,8907,1,20,5,3,66,24,42,65
N'castle Jet,8907,2,16,5,7,60,37,23,53
Melbourne C,8907,3,14,4,11,43,36,7,46
Melbourne V,8907,4,13,6,10,47,40,7,45
Adelaide Utd,8907,5,11,6,11,37,40,-3,39
Brisbane,8907,6,10,5,13,33,42,-9,35
Western Sydn,8907,7,8,9,10,38,47,-9,33
Perth Glory,8907,8,10,2,15,37,50,-13,32
Wellington P,8907,9,5,6,16,31,55,-24,21
CC Mariners,8907,10,4,8,15,28,49,-21,20
Sydney FC,8908,1,21,4,3,70,22,48,67
N'castle Jet,8908,2,16,5,7,62,38,24,53
Melbourne C,8908,3,14,4,11,44,38,6,46
Melbourne V,8908,4,13,5,11,45,44,1,44
Adelaide Utd,8908,5,11,6,11,37,40,-3,39
Brisbane,8908,6,10,5,13,33,42,-9,35
Western Sydn,8908,7,8,9,10,38,47,-9,33
Perth Glory,8908,8,10,2,15,37,50,-13,32
Wellington P,8908,9,5,6,16,31,55,-24,21
CC Mariners,8908,10,4,8,15,28,49,-21,20
Sydney FC,8909,1,21,4,3,65,22,43,67
N'castle Jet,8909,2,15,6,7,58,38,20,51
Melbourne C,8909,3,14,5,10,44,34,10,47
Melbourne V,8909,4,13,5,11,45,39,6,44
Adelaide Utd,8909,5,11,6,11,37,40,-3,39
Brisbane,8909,6,10,5,13,33,42,-9,35
Western Sydn,8909,7,8,9,10,38,47,-9,33
Perth Glory,8909,8,10,2,15,37,50,-13,32
Wellington P,8909,9,5,6,16,31,55,-24,21
CC Mariners,8909,10,4,8,15,28,49,-21,20
Sydney FC,8910,1,21,4,3,66,22,44,67
N'castle Jet,8910,2,16,5,7,62,37,25,53
Melbourne C,8910,3,14,4,11,43,38,5,46
Melbourne V,8910,4,13,5,11,45,40,5,44
Adelaide Utd,8910,5,11,6,11,37,40,-3,39
Brisbane,8910,6,10,5,13,33,42,-9,35
Western Sydn,8910,7,8,9,10,38,47,-9,33
Perth Glory,8910,8,10,2,15,37,50,-13,32
Wellington P,8910,9,5,6,16,31,55,-24,21
CC Mariners,8910,10,4,8,15,28,49,-21,20
Sydney FC,8911,1,20,5,3,66,24,42,65
N'castle Jet,8911,2,15,6,7,59,39,20,51
Melbourne C,8911,3,14,5,10,45,35,10,47
Melbourne V,8911,4,13,6,10,47,40,7,45
Adelaide Utd,8911,5,11,6,11,37,40,-3,39
Brisbane,8911,6,10,5,13,33,42,-9,35
Western Sydn,8911,7,8,9,10,38,47,-9,33
Perth Glory,8911,8,10,2,15,37,50,-13,32
Wellington P,8911,9,5,6,16,31,55,-24,21
CC Mariners,8911,10,4,8,15,28,49,-21,20
Sydney FC,8912,1,20,4,4,64,23,41,64
N'castle Jet,8912,2,15,6,7,61,41,20,51
Melbourne C,8912,3,14,5,10,47,37,10,47
Melbourne V,8912,4,14,5,10,46,38,8,47
Adelaide Utd,8912,5,11,6,11,37,40,-3,39
Brisbane,8912,6,10,5,13,33,42,-9,35
Western Sydn,8912,7,8,9,10,38,47,-9,33
Perth Glory,8912,8,10,2,15,37,50,-13,32
Wellington P,8912,9,5,6,16,31,55,-24,21
CC Mariners,8912,10,4,8,15,28,49,-21,20
Sydney FC,8913,1,21,4,3,65,22,43,67
N'castle Jet,8913,2,15,6,7,58,38,20,51
Melbourne C,8913,3,14,5,10,44,34,10,47
Melbourne V,8913,4,13,5,11,45,39,6,44
Adelaide Utd,8913,5,11,6,11,37,40,-3,39
Brisbane,8913,6,10,5,13,33,42,-9,35
Western Sydn,8913,7,8,9,10,38,47,-9,33
Perth Glory,8913,8,10,2,15,37,50,-13,32
Wellington P,8913,9,5,6,16,31,55,-24,21
CC Mariners,8913,10,4,8,15,28,49,-21,20
Sydney FC,8914,1,21,4,3,66,22,44,67
N'castle Jet,8914,2,16,5,7,59,38,21,53
Melbourne C,8914,3,14,4,11,44,35,9,46
Melbourne V,8914,4,13,5,11,45,40,5,44
Adelaide Utd,8914,5,11,6,11,37,40,-3,39
Brisbane,8914,6,10,5,13,33,42,-9,35
Western Sydn,8914,7,8,9,10,38,47,-9,33
Perth Glory,8914,8,10,2,15,37,50,-13,32
Wellington P,8914,9,5,6,16,31,55,-24,21
CC Mariners,8914,10,4,8,15,28,49,-21,20
Sydney FC,8915,1,21,4,3,66,23,43,67
N'castle Jet,8915,2,16,5,7,60,38,22,53
Melbourne C,8915,3,14,4,11,44,36,8,46
Melbourne V,8915,4,13,5,11,46,40,6,44
Adelaide Utd,8915,5,11,6,11,37,40,-3,39
Brisbane,8915,6,10,5,13,33,42,-9,35
Western Sydn,8915,7,8,9,10,38,47,-9,33
Perth Glory,8915,8,10,2,15,37,50,-13,32
Wellington P,8915,9,5,6,16,31,55,-24,21
CC Mariners,8915,10,4,8,15,28,49,-21,20
Sydney FC,8916,1,20,4,4,65,24,41,64
N'castle Jet,8916,2,16,5,7,58,37,21,53
Melbourne V,8916,3,14,5,10,47,39,8,47
Melbourne C,8916,4,14,4,11,43,34,9,46
Adelaide Utd,8916,5,11,6,11,37,40,-3,39
Brisbane,8916,6,10,5,13,33,42,-9,35
Western Sydn,8916,7,8,9,10,38,47,-9,33
Perth Glory,8916,8,10,2,15,37,50,-13,32
Wellington P,8916,9,5,6,16,31,55,-24,21
CC Mariners,8916,10,4,8,15,28,49,-21,20
Sydney FC,8917,1,20,5,3,65,23,42,65
N'castle Jet,8917,2,15,5,8,57,38,19,50
Melbourne C,8917,3,15,4,10,44,33,11,49
Melbourne V,8917,4,13,6,10,46,39,7,45
Adelaide Utd,8917,5,11,6,11,37,40,-3,39
Brisbane,8917,6,10,5,13,33,42,-9,35
Western Sydn,8917,7,8,9,10,38,47,-9,33
Perth Glory,8917,8,10,2,15,37,50,-13,32
Wellington P,8917,9,5,6,16,31,55,-24,21
CC Mariners,8917,10,4,8,15,28,49,-21,20
Sydney FC,8918,1,21,4,3,66,23,43,67
N'castle Jet,8918,2,15,6,7,57,37,20,51
Melbourne C,8918,3,14,5,10,43,33,10,47
Melbourne V,8918,4,13,5,11,46,40,6,44
Adelaide Utd,8918,5,11,6,11,37,40,-3,39
Brisbane,8918,6,10,5,13,33,42,-9,35
Western Sydn,8918,7,8,9,10,38,47,-9,33
Perth Glory,8918,8,10,2,15,37,50,-13,32
Wellington P,8918,9,5,6,16,31,55,-24,21
CC Mariners,8918,10,4,8,15,28,49,-21,20
Sydney FC,8919,1,20,5,3,65,23,42,65
N'castle Jet,8919,2,15,6,7,60,40,20,51
Melbourne C,8919,3,14,5,10,46,36,10,47
Melbourne V,8919,4,13,6,10,46,39,7,45
Adelaide Utd,8919,5,11,6,11,37,40,-3,39
Brisbane,8919,6,10,5,13,33,42,-9,35
Western Sydn,8919,7,8,9,10,38,47,-9,33
Perth Glory,8919,8,10,2,15,37,50,-13,32
Wellington P,8919,9,5,6,16,31,55,-24,21
CC Mariners,8919,10,4,8,15,28,49,-21,20
Sydney FC,8920,1,21,4,3,66,22,44,67
N'castle Jet,8920,2,16,5,7,60,37,23,53
Melbourne C,8920,3,14,4,11,43,36,7,46
Melbourne V,8920,4,13,5,11,45,40,5,44
Adelaide Utd,8920,5,11,6,11,37,40,-3,39
Brisbane,8920,6,10,5,13,33,42,-9,35
Western Sydn,8920,7,8,9,10,38,47,-9,33
Perth Glory,8920,8,10,2,15,37,50,-13,32
Wellington P,8920,9,5,6,16,31,55,-24,21
CC Mariners,8920,10,4,8,15,28,49,-21,20
Sydney FC,8921,1,21,4,3,65,22,43,67
N'castle Jet,8921,2,15,5,8,57,39,18,50
Melbourne C,8921,3,15,4,10,45,33,12,49
Melbourne V,8921,4,13,5,11,45,39,6,44
Adelaide Utd,8921,5,11,6,11,37,40,-3,39
Brisbane,8921,6,10,5,13,33,42,-9,35
Western Sydn,8921,7,8,9,10,38,47,-9,33
Perth Glory,8921,8,10,2,15,37,50,-13,32
Wellington P,8921,9,5,6,16,31,55,-24,21
CC Mariners,8921,10,4,8,15,28,49,-21,20
Sydney FC,8922,1,21,4,3,68,22,46,67
N'castle Jet,8922,2,16,5,7,60,37,23,53
Melbourne C,8922,3,14,4,11,43,36,7,46
Melbourne V,8922,4,13,5,11,45,42,3,44
Adelaide Utd,8922,5,11,6,11,37,40,-3,39
Brisbane,8922,6,10,5,13,33,42,-9,35
Western Sydn,8922,7,8,9,10,38,47,-9,33
Perth Glory,8922,8,10,2,15,37,50,-13,32
Wellington P,8922,9,5,6,16,31,55,-24,21
CC Mariners,8922,10,4,8,15,28,49,-21,20
Sydney FC,8923,1,20,5,3,66,24,42,65
N'castle Jet,8923,2,16,5,7,63,38,25,53
Melbourne C,8923,3,14,4,11,44,39,5,46
Melbourne V,8923,4,13,6,10,47,40,7,45
Adelaide Utd,8923,5,11,6,11,37,40,-3,39
Brisbane,8923,6,10,5,13,33,42,-9,35
Western Sydn,8923,7,8,9,10,38,47,-9,33
Perth Glory,8923,8,10,2,15,37,50,-13,32
Wellington P,8923,9,5,6,16,31,55,-24,21
CC Mariners,8923,10,4,8,15,28,49,-21,20
Sydney FC,8924,1,21,4,3,67,23,44,67
N'castle Jet,8924,2,16,5,7,59,37,22,53
Melbourne C,8924,3,14,4,11,43,35,8,46
Melbourne V,8924,4,13,5,11,46,41,5,44
Adelaide Utd,8924,5,11,6,11,37,40,-3,39
Brisbane,8924,6,10,5,13,33,42,-9,35
Western Sydn,8924,7,8,9,10,38,47,-9,33
Perth Glory,8924,8,10,2,15,37,50,-13,32
Wellington P,8924,9,5,6,16,31,55,-24,21
CC Mariners,8924,10,4,8,15,28,49,-21,20
Sydney FC,8925,1,21,4,3,65,22,43,67
N'castle Jet,8925,2,15,5,8,58,40,18,50
Melbourne C,8925,3,15,4,10,46,34,12,49
Melbourne V,8925,4,13,5,11,45,39,6,44
Adelaide Utd,8925,5,11,6,11,37,40,-3,39
Brisbane,8925,6,10,5,13,33,42,-9,35
Western Sydn,8925,7,8,9,10,38,47,-9,33
Perth Glory,8925,8,10,2,15,37,50,-13,32
Wellington P,8925,9,5,6,16,31,55,-24,21
CC Mariners,8925,10,4,8,15,28,49,-21,20
Sydney FC,8926,1,21,4,3,66,23,43,67
N'castle Jet,8926,2,15,6,7,58,38,20,51
Melbourne C,8926,3,14,5,10,44,34,10,47
Melbourne V,8926,4,13,5,11,46,40,6,44
Adelaide Utd,8926,5,11,6,11,37,40,-3,39
Brisbane,8926,6,10,5,13,33,42,-9,35
Western Sydn,8926,7,8,9,10,38,47,-9,33
Perth Glory,8926,8,10,2,15,37,50,-13,32
Wellington P,8926,9,5,6,16,31,55,-24,21
CC Mariners,8926,10,4,8,15,28,49,-21,20
Sydney FC,8927,1,20,4,4,64,24,40,64
N'castle Jet,8927,2,16,5,7,58,37,21,53
Melbourne V,8927,3,14,5,10,47,38,9,47
Melbourne C,8927,4,14,4,11,43,34,9,46
Adelaide Utd,8927,5,11,6,11,37,40,-3,39
Brisbane,8927,6,10,5,13,33,42,-9,35
Western Sydn,8927,7,8,9,10,38,47,-9,33
Perth Glory,8927,8,10,2,15,37,50,-13,32
Wellington P,8927,9,5,6,16,31,55,-24,21
CC Mariners,8927,10,4,8,15,28,49,-21,20
Sydney FC,8928,1,21,4,3,66,22,44,67
N'castle Jet,8928,2,16,5,7,61,38,23,53
Melbourne C,8928,3,14,4,11,44,37,7,46
Melbourne V,8928,4,13,5,11,45,40,5,44
Adelaide Utd,8928,5,11,6,11,37,40,-3,39
Brisbane,8928,6,10,5,13,33,42,-9,35
Western Sydn,8928,7,8,9,10,38,47,-9,33
Perth Glory,8928,8,10,2,15,37,50,-13,32
Wellington P,8928,9,5,6,16,31,55,-24,21
CC Mariners,8928,10,4,8,15,28,49,-21,20
Sydney FC,8929,1,21,4,3,67,23,44,67
N'castle Jet,8929,2,16,5,7,58,37,21,53
Melbourne C,8929,3,14,4,11,43,34,9,46
Melbourne V,8929,4,13,5,11,46,41,5,44
Adelaide Utd,8929,5,11,6,11,37,40,-3,39
Brisbane,8929,6,10,5,13,33,42,-9,35
Western Sydn,8929,7,8,9,10,38,47,-9,33
Perth Glory,8929,8,10,2,15,37,50,-13,32
Wellington P,8929,9,5,6,16,31,55,-24,21
CC Mariners,8929,10,4,8,15,28,49,-21,20
Sydney FC,8930,1,20,5,3,65,23,42,65
N'castle Jet,8930,2,16,5,7,59,38,21,53
Melbourne C,8930,3,14,4,11,44,35,9,46
Melbourne V,8930,4,13,6,10,46,39,7,45
Adelaide Utd,8930,5,11,6,11,37,40,-3,39
Brisbane,8930,6,10,5,13,33,42,-9,35
Western Sydn,8930,7,8,9,10,38,47,-9,33
Perth Glory,8930,8,10,2,15,37,50,-13,32
Wellington P,8930,9,5,6,16,31,55,-24,21
CC Mariners,8930,10,4,8,15,28,49,-21,20
Sydney FC,8931,1,20,4,4,64,24,40,64
N'castle Jet,8931,2,15,5,8,58,42,16,50
Melbourne C,8931,3,15,4,10,48,34,14,49
Melbourne V,8931,4,14,5,10,47,38,9,47
Adelaide Utd,8931,5,11,6,11,37,40,-3,39
Brisbane,8931,6,10,5,13,33,42,-9,35
Western Sydn,8931,7,8,9,10,38,47,-9,33
Perth Glory,8931,8,10,2,15,37,50,-13,32
Wellington P,8931,9,5,6,16,31,55,-24,21
CC Mariners,8931,10,4,8,15,28,49,-21,20
Sydney FC,8932,1,20,5,3,65,23,42,65
N'castle Jet,8932,2,15,5,8,57,41,16,50
Melbourne C,8932,3,15,4,10,47,33,14,49
Melbourne V,8932,4,13,6,10,46,39,7,45
Adelaide Utd,8932,5,11,6,11,37,40,-3,39
Brisbane,8932,6,10,5,13,33,42,-9,35
Western Sydn,8932,7,8,9,10,38,47,-9,33
Perth Glory,8932,8,10,2,15,37,50,-13,32
Wellington P,8932,9,5,6,16,31,55,-24,21
CC Mariners,8932,10,4,8,15,28,49,-21,20
Sydney FC,8933,1,21,4,3,67,22,45,67
N'castle Jet,8933,2,15,5,8,58,39,19,50
Melbourne C,8933,3,15,4,10,45,34,11,49
Melbourne V,8933,4,13,5,11,45,41,4,44
Adelaide Utd,8933,5,11,6,11,37,40,-3,39
Brisbane,8933,6,10,5,13,33,42,-9,35
Western Sydn,8933,7,8,9,10,38,47,-9,33
Perth Glory,8933,8,10,2,15,37,50,-13,32
Wellington P,8933,9,5,6,16,31,55,-24,21
CC Mariners,8933,10,4,8,15,28,49,-21,20
Sydney FC,8934,1,20,4,4,66,25,41,64
N'castle Jet,8934,2,16,5,7,59,37,22,53
Melbourne V,8934,3,14,5,10,48,40,8,47
Melbourne C,8934,4,14,4,11,43,35,8,46
Adelaide Utd,8934,5,11,6,11,37,40,-3,39
Brisbane,8934,6,10,5,13,33,42,-9,35
Western Sydn,8934,7,8,9,10,38,47,-9,33
Perth Glory,8934,8,10,2,15,37,50,-13,32
Wellington P,8934,9,5,6,16,31,55,-24,21
CC Mariners,8934,10,4,8,15,28,49,-21,20
Sydney FC,8935,1,20,4,4,64,23,41,64
N'castle Jet,8935,2,15,5,8,57,38,19,50
Melbourne C,8935,3,15,4,10,44,33,11,49
Melbourne V,8935,4,14,5,10,46,38,8,47
Adelaide Utd,8935,5,11,6,11,37,40,-3,39
Brisbane,8935,6,10,5,13,33,42,-9,35
Western Sydn,8935,7,8,9,10,38,47,-9,33
Perth Glory,8935,8,10,2,15,37,50,-13,32
Wellington P,8935,9,5,6,16,31,55,-24,21
CC Mariners,8935,10,4,8,15,28,49,-21,20
Sydney FC,8936,1,20,5,3,65,23,42,65
N'castle Jet,8936,2,15,5,8,58,39,19,50
Melbourne C,8936,3,15,4,10,45,34,11,49
Melbourne V,8936,4,13,6,10,46,39,7,45
Adelaide Utd,8936,5,11,6,11,37,40,-3,39
Brisbane,8936,6,10,5,13,33,42,-9,35
Western Sydn,8936,7,8,9,10,38,47,-9,33
Perth Glory,8936,8,10,2,15,37,50,-13,32
Wellington P,8936,9,5,6,16,31,55,-24,21
CC Mariners,8936,10,4,8,15,28,49,-21,20
Sydney FC,8937,1,21,4,3,68,22,46,67
N'castle Jet,8937,2,16,5,7,59,37,22,53
Melbourne C,8937,3,14,4,11,43,35,8,46
Melbourne V,8937,4,13,5,11,45,42,3,44
Adelaide Utd,8937,5,11,6,11,37,40,-3,39
Brisbane,8937,6,10,5,13,33,42,-9,35
Western Sydn,8937,7,8,9,10,38,47,-9,33
Perth Glory,8937,8,10,2,15,37,50,-13,32
Wellington P,8937,9,5,6,16,31,55,-24,21
CC Mariners,8937,10,4,8,15,28,49,-21,20
Sydney FC,8938,1,21,4,3,68,22,46,67
N'castle Jet,8938,2,16,5,7,59,38,21,53
Melbourne C,8938,3,14,4,11,44,35,9,46
Melbourne V,8938,4,13,5,11,45,42,3,44
Adelaide Utd,8938,5,11,6,11,37,40,-3,39
Brisbane,8938,6,10,5,13,33,42,-9,35
Western Sydn,8938,7,8,9,10,38,47,-9,33
Perth Glory,8938,8,10,2,15,37,50,-13,32
Wellington P,8938,9,5,6,16,31,55,-24,21
CC Mariners,8938,10,4,8,15,28,49,-21,20
Sydney FC,8939,1,21,4,3,68,22,46,67
N'castle Jet,8939,2,15,5,8,58,40,18,50
Melbourne C,8939,3,15,4,10,46,34,12,49
Melbourne V,8939,4,13,5,11,45,42,3,44
Adelaide Utd,8939,5,11,6,11,37,40,-3,39
Brisbane,8939,6,10,5,13,33,42,-9,35
Western Sydn,8939,7,8,9,10,38,47,-9,33
Perth Glory,8939,8,10,2,15,37,50,-13,32
Wellington P,8939,9,5,6,16,31,55,-24,21
CC Mariners,8939,10,4,8,15,28,49,-21,20
Sydney FC,8940,1,21,4,3,68,23,45,67
N'castle Jet,8940,2,15,5,8,57,38,19,50
Melbourne C,8940,3,15,4,10,44,33,11,49
Melbourne V,8940,4,13,5,11,46,42,4,44
Adelaide Utd,8940,5,11,6,11,37,40,-3,39
Brisbane,8940,6,10,5,13,33,42,-9,35
Western Sydn,8940,7,8,9,10,38,47,-9,33
Perth Glory,8940,8,10,2,15,37,50,-13,32
Wellington P,8940,9,5,6,16,31,55,-24,21
CC Mariners,8940,10,4,8,15,28,49,-21,20
Sydney FC,8941,1,20,5,3,65,23,42,65
N'castle Jet,8941,2,15,5,8,57,38,19,50
Melbourne C,8941,3,15,4,10,44,33,11,49
Melbourne V,8941,4,13,6,10,46,39,7,45
Adelaide Utd,8941,5,11,6,11,37,40,-3,39
Brisbane,8941,6,10,5,13,33,42,-9,35
Western Sydn,8941,7,8,9,10,38,47,-9,33
Perth Glory,8941,8,10,2,15,37,50,-13,32
Wellington P,8941,9,5,6,16,31,55,-24,21
CC Mariners,8941,10,4,8,15,28,49,-21,20
Sydney FC,8942,1,21,4,3,66,22,44,67
N'castle Jet,8942,2,15,6,7,59,39,20,51
Melbourne C,8942,3,14,5,10,45,35,10,47
Melbourne V,8942,4,13,5,11,45,40,5,44
Adelaide Utd,8942,5,11,6,11,37,40,-3,39
Brisbane,8942,6,10,5,13,33,42,-9,35
Western Sydn,8942,7,8,9,10,38,47,-9,33
Perth Glory,8942,8,10,2,15,37,50,-13,32
Wellington P,8942,9,5,6,16,31,55,-24,21
CC Mariners,8942,10,4,8,15,28,49,-21,20
Sydney FC,8943,1,21,4,3,67,23,44,67
N'castle Jet,8943,2,16,5,7,60,39,21,53
Melbourne C,8943,3,14,4,11,45,36,9,46
Melbourne V,8943,4,13,5,11,46,41,5,44
Adelaide Utd,8943,5,11,6,11,37,40,-3,39
Brisbane,8943,6,10,5,13,33,42,-9,35
Western Sydn,8943,7,8,9,10,38,47,-9,33
Perth Glory,8943,8,10,2,15,37,50,-13,32
Wellington P,8943,9,5,6,16,31,55,-24,21
CC Mariners,8943,10,4,8,15,28,49,-21,20
Sydney FC,8944,1,21,4,3,65,22,43,67
N'castle Jet,8944,2,16,5,7,59,38,21,53
Melbourne C,8944,3,14,4,11,44,35,9,46
Melbourne V,8944,4,13,5,11,45,39,6,44
Adelaide Utd,8944,5,11,6,11,37,40,-3,39
Brisbane,8944,6,10,5,13,33,42,-9,35
Western Sydn,8944,7,8,9,10,38,47,-9,33
Perth Glory,8944,8,10,2,15,37,50,-13,32
Wellington P,8944,9,5,6,16,31,55,-24,21
CC Mariners,8944,10,4,8,15,28,49,-21,20
Sydney FC,8945,1,20,5,3,65,23,42,65
N'castle Jet,8945,2,15,6,7,59,39,20,51
Melbourne C,8945,3,14,5,10,45,35,10,47
Melbourne V,8945,4,13,6,10,46,39,7,45
Adelaide Utd,8945,5,11,6,11,37,40,-3,39
Brisbane,8945,6,10,5,13,33,42,-9,35
Western Sydn,8945,7,8,9,10,38,47,-9,33
Perth Glory,8945,8,10,2,15,37,50,-13,32
Wellington P,8945,9,5,6,16,31,55,-24,21
CC Mariners,8945,10,4,8,15,28,49,-21,20
Sydney FC,8946,1,21,4,3,66,22,44,67
N'castle Jet,8946,2,16,5,7,58,37,21,53
Melbourne C,8946,3,14,4,11,43,34,9,46
Melbourne V,8946,4,13,5,11,45,40,5,44
Adelaide Utd,8946,5,11,6,11,37,40,-3,39
Brisbane,8946,6,10,5,13,33,42,-9,35
Western Sydn,8946,7,8,9,10,38,47,-9,33
Perth Glory,8946,8,10,2,15,37,50,-13,32
Wellington P,8946,9,5,6,16,31,55,-24,21
CC Mariners,8946,10,4,8,15,28,49,-21,20
Sydney FC,8947,1,21,4,3,66,22,44,67
N'castle Jet,8947,2,15,5,8,58,39,19,50
Melbourne C,8947,3,15,4,10,45,34,11,49
Melbourne V,8947,4,13,5,11,45,40,5,44
Adelaide Utd,8947,5,11,6,11,37,40,-3,39
Brisbane,8947,6,10,5,13,33,42,-9,35
Western Sydn,8947,7,8,9,10,38,47,-9,33
Perth Glory,8947,8,10,2,15,37,50,-13,32
Wellington P,8947,9,5,6,16,31,55,-24,21
CC Mariners,8947,10,4,8,15,28,49,-21,20
Sydney FC,8948,1,21,4,3,66,23,43,67
N'castle Jet,8948,2,15,5,8,57,38,19,50
Melbourne C,8948,3,15,4,10,44,33,11,49
Melbourne V,8948,4,13,5,11,46,40,6,44
Adelaide Utd,8948,5,11,6,11,37,40,-3,39
Brisbane,8948,6,10,5,13,33,42,-9,35
Western Sydn,8948,7,8,9,10,38,47,-9,33
Perth Glory,8948,8,10,2,15,37,50,-13,32
Wellington P,8948,9,5,6,16,31,55,-24,21
CC Mariners,8948,10,4,8,15,28,49,-21,20
Sydney FC,8949,1,21,4,3,67,23,44,67
N'castle Jet,8949,2,16,5,7,62,38,24,53
Melbourne C,8949,3,14,4,11,44,38,6,46
Melbourne V,8949,4,13,5,11,46,41,5,44
Adelaide Utd,8949,5,11,6,11,37,40,-3,39
Brisbane,8949,6,10,5,13,33,42,-9,35
Western Sydn,8949,7,8,9,10,38,47,-9,33
Perth Glory,8949,8,10,2,15,37,50,-13,32
Wellington P,8949,9,5,6,16,31,55,-24,21
CC Mariners,8949,10,4,8,15,28,49,-21,20
Sydney FC,8950,1,20,5,3,65,23,42,65
N'castle Jet,8950,2,16,5,7,59,37,22,53
Melbourne C,8950,3,14,4,11,43,35,8,46
Melbourne V,8950,4,13,6,10,46,39,7,45
Adelaide Utd,8950,5,11,6,11,37,40,-3,39
Brisbane,8950,6,10,5,13,33,42,-9,35
Western Sydn,8950,7,8,9,10,38,47,-9,33
Perth Glory,8950,8,10,2,15,37,50,-13,32
Wellington P,8950,9,5,6,16,31,55,-24,21
CC Mariners,8950,10,4,8,15,28,49,-21,20
Sydney FC,8951,1,20,5,3,65,23,42,65
N'castle Jet,8951,2,16,5,7,60,38,22,53
Melbourne C,8951,3,14,4,11,44,36,8,46
Melbourne V,8951,4,13,6,10,46,39,7,45
Adelaide Utd,8951,5,11,6,11,37,40,-3,39
Brisbane,8951,6,10,5,13,33,42,-9,35
Western Sydn,8951,7,8,9,10,38,47,-9,33
Perth Glory,8951,8,10,2,15,37,50,-13,32
Wellington P,8951,9,5,6,16,31,55,-24,21
CC Mariners,8951,10,4,8,15,28,49,-21,20
Sydney FC,8952,1,21,4,3,69,22,47,67
N'castle Jet,8952,2,15,6,7,57,37,20,51
Melbourne C,8952,3,14,5,10,43,33,10,47
Melbourne V,8952,4,13,5,11,45,43,2,44
Adelaide Utd,8952,5,11,6,11,37,40,-3,39
Brisbane,8952,6,10,5,13,33,42,-9,35
Western Sydn,8952,7,8,9,10,38,47,-9,33
Perth Glory,8952,8,10,2,15,37,50,-13,32
Wellington P,8952,9,5,6,16,31,55,-24,21
CC Mariners,8952,10,4,8,15,28,49,-21,20
Sydney FC,8953,1,21,4,3,67,23,44,67
N'castle Jet,8953,2,16,5,7,60,38,22,53
Melbourne C,8953,3,14,4,11,44,36,8,46
Melbourne V,8953,4,13,5,11,46,41,5,44
Adelaide Utd,8953,5,11,6,11,37,40,-3,39
Brisbane,8953,6,10,5,13,33,42,-9,35
Western Sydn,8953,7,8,9,10,38,47,-9,33
Perth Glory,8953,8,10,2,15,37,50,-13,32
Wellington P,8953,9,5,6,16,31,55,-24,21
CC Mariners,8953,10,4,8,15,28,49,-21,20
Sydney FC,8954,1,21,4,3,65,22,43,67
N'castle Jet,8954,2,15,6,7,58,38,20,51
Melbourne C,8954,3,14,5,10,44,34,10,47
Melbourne V,8954,4,13,5,11,45,39,6,44
Adelaide Utd,8954,5,11,6,11,37,40,-3,39
Brisbane,8954,6,10,5,13,33,42,-9,35
Western Sydn,8954,7,8,9,10,38,47,-9,33
Perth Glory,8954,8,10,2,15,37,50,-13,32
Wellington P,8954,9,5,6,16,31,55,-24,21
CC Mariners,8954,10,4,8,15,28,49,-21,20
Sydney FC,8955,1,21,4,3,66,22,44,67
N'castle Jet,8955,2,16,5,7,59,38,21,53
Melbourne C,8955,3,14,4,11,44,35,9,46
Melbourne V,8955,4,13,5,11,45,40,5,44
Adelaide Utd,8955,5,11,6,11,37,40,-3,39
Brisbane,8955,6,10,5,13,33,42,-9,35
Western Sydn,8955,7,8,9,10,38,47,-9,33
Perth Glory,8955,8,10,2,15,37,50,-13,32
Wellington P,8955,9,5,6,16,31,55,-24,21
CC Mariners,8955,10,4,8,15,28,49,-21,20
Sydney FC,8956,1,21,4,3,68,24,44,67
N'castle Jet,8956,2,16,5,7,59,38,21,53
Melbourne C,8956,3,14,4,11,44,35,9,46
Melbourne V,8956,4,13,5,11,47,42,5,44
Adelaide Utd,8956,5,11,6,11,37,40,-3,39
Brisbane,8956,6,10,5,13,33,42,-9,35
Western Sydn,8956,7,8,9,10,38,47,-9,33
Perth Glory,8956,8,10,2,15,37,50,-13,32
Wellington P,8956,9,5,6,16,31,55,-24,21
CC Mariners,8956,10,4,8,15,28,49,-21,20
Sydney FC,8957,1,20,5,3,65,23,42,65
N'castle Jet,8957,2,15,5,8,59,40,19,50
Melbourne C,8957,3,15,4,10,46,35,11,49
Melbourne V,8957,4,13,6,10,46,39,7,45
Adelaide Utd,8957,5,11,6,11,37,40,-3,39
Brisbane,8957,6,10,5,13,33,42,-9,35
Western Sydn,8957,7,8,9,10,38,47,-9,33
Perth Glory,8957,8,10,2,15,37,50,-13,32
Wellington P,8957,9,5,6,16,31,55,-24,21
CC Mariners,8957,10,4,8,15,28,49,-21,20
Sydney FC,8958,1,21,4,3,66,23,43,67
N'castle Jet,8958,2,16,5,7,59,38,21,53
Melbourne C,8958,3,14,4,11,44,35,9,46
Melbourne V,8958,4,13,5,11,46,40,6,44
Adelaide Utd,8958,5,11,6,11,37,40,-3,39
Brisbane,8958,6,10,5,13,33,42,-9,35
Western Sydn,8958,7,8,9,10,38,47,-9,33
Perth Glory,8958,8,10,2,15,37,50,-13,32
Wellington P,8958,9,5,6,16,31,55,-24,21
CC Mariners,8958,10,4,8,15,28,49,-21,20
Sydney FC,8959,1,20,5,3,66,24,42,65
N'castle Jet,8959,2,16,5,7,60,38,22,53
Melbourne C,8959,3,14,4,11,44,36,8,46
Melbourne V,8959,4,13,6,10,47,40,7,45
Adelaide Utd,8959,5,11,6,11,37,40,-3,39
Brisbane,8959,6,10,5,13,33,42,-9,35
Western Sydn,8959,7,8,9,10,38,47,-9,33
Perth Glory,8959,8,10,2,15,37,50,-13,32
Wellington P,8959,9,5,6,16,31,55,-24,21
CC Mariners,8959,10,4,8,15,28,49,-21,20
Sydney FC,8960,1,21,4,3,68,23,45,67
N'castle Jet,8960,2,16,5,7,60,38,22,53
Melbourne C,8960,3,14,4,11,44,36,8,46
Melbourne V,8960,4,13,5,11,46,42,4,44
Adelaide Utd,8960,5,11,6,11,37,40,-3,39
Brisbane,8960,6,10,5,13,33,42,-9,35
Western Sydn,8960,7,8,9,10,38,47,-9,33
Perth Glory,8960,8,10,2,15,37,50,-13,32
Wellington P,8960,9,5,6,16,31,55,-24,21
CC Mariners,8960,10,4,8,15,28,49,-21,20
Sydney FC,8961,1,20,5,3,64,22,42,65
N'castle Jet,8961,2,15,5,8,57,39,18,50
Melbourne C,8961,3,15,4,10,45,33,12,49
Melbourne V,8961,4,13,6,10,45,38,7,45
Adelaide Utd,8961,5,11,6,11,37,40,-3,39
Brisbane,8961,6,10,5,13,33,42,-9,35
Western Sydn,8961,7,8,9,10,38,47,-9,33
Perth Glory,8961,8,10,2,15,37,50,-13,32
Wellington P,8961,9,5,6,16,31,55,-24,21
CC Mariners,8961,10,4,8,15,28,49,-21,20
Sydney FC,8962,1,20,5,3,64,22,42,65
N'castle Jet,8962,2,15,5,8,57,38,19,50
Melbourne C,8962,3,15,4,10,44,33,11,49
Melbourne V,8962,4,13,6,10,45,38,7,45
Adelaide Utd,8962,5,11,6,11,37,40,-3,39
Brisbane,8962,6,10,5,13,33,42,-9,35
Western Sydn,8962,7,8,9,10,38,47,-9,33
Perth Glory,8962,8,10,2,15,37,50,-13,32
Wellington P,8962,9,5,6,16,31,55,-24,21
CC Mariners,8962,10,4,8,15,28,49,-21,20
Sydney FC,8963,1,20,4,4,64,23,41,64
N'castle Jet,8963,2,16,5,7,59,37,22,53
Melbourne V,8963,3,14,5,10,46,38,8,47
Melbourne C,8963,4,14,4,11,43,35,8,46
Adelaide Utd,8963,5,11,6,11,37,40,-3,39
Brisbane,8963,6,10,5,13,33,42,-9,35
Western Sydn,8963,7,8,9,10,38,47,-9,33
Perth Glory,8963,8,10,2,15,37,50,-13,32
Wellington P,8963,9,5,6,16,31,55,-24,21
CC Mariners,8963,10,4,8,15,28,49,-21,20
Sydney FC,8964,1,20,5,3,65,23,42,65
N'castle Jet,8964,2,15,5,8,61,42,19,50
Melbourne C,8964,3,15,4,10,48,37,11,49
Melbourne V,8964,4,13,6,10,46,39,7,45
Adelaide Utd,8964,5,11,6,11,37,40,-3,39
Brisbane,8964,6,10,5,13,33,42,-9,35
Western Sydn,8964,7,8,9,10,38,47,-9,33
Perth Glory,8964,8,10,2,15,37,50,-13,32
Wellington P,8964,9,5,6,16,31,55,-24,21
CC Mariners,8964,10,4,8,15,28,49,-21,20
Sydney FC,8965,1,21,4,3,69,23,46,67
N'castle Jet,8965,2,16,5,7,61,37,24,53
Melbourne C,8965,3,14,4,11,43,37,6,46
Melbourne V,8965,4,13,5,11,46,43,3,44
Adelaide Utd,8965,5,11,6,11,37,40,-3,39
Brisbane,8965,6,10,5,13,33,42,-9,35
Western Sydn,8965,7,8,9,10,38,47,-9,33
Perth Glory,8965,8,10,2,15,37,50,-13,32
Wellington P,8965,9,5,6,16,31,55,-24,21
CC Mariners,8965,10,4,8,15,28,49,-21,20
Sydney FC,8966,1,21,4,3,66,23,43,67
N'castle Jet,8966,2,16,5,7,61,38,23,53
Melbourne C,8966,3,14,4,11,44,37,7,46
Melbourne V,8966,4,13,5,11,46,40,6,44
Adelaide Utd,8966,5,11,6,11,37,40,-3,39
Brisbane,8966,6,10,5,13,33,42,-9,35
Western Sydn,8966,7,8,9,10,38,47,-9,33
Perth Glory,8966,8,10,2,15,37,50,-13,32
Wellington P,8966,9,5,6,16,31,55,-24,21
CC Mariners,8966,10,4,8,15,28,49,-21,20
Sydney FC,8967,1,20,5,3,64,22,42,65
N'castle Jet,8967,2,15,5,8,57,38,19,50
Melbourne C,8967,3,15,4,10,44,33,11,49
Melbourne V,8967,4,13,6,10,45,38,7,45
Adelaide Utd,8967,5,11,6,11,37,40,-3,39
Brisbane,8967,6,10,5,13,33,42,-9,35
Western Sydn,8967,7,8,9,10,38,47,-9,33
Perth Glory,8967,8,10,2,15,37,50,-13,32
Wellington P,8967,9,5,6,16,31,55,-24,21
CC Mariners,8967,10,4,8,15,28,49,-21,20
Sydney FC,8968,1,20,4,4,65,24,41,64
N'castle Jet,8968,2,15,6,7,58,38,20,51
Melbourne C,8968,3,14,5,10,44,34,10,47
Melbourne V,8968,4,14,5,10,47,39,8,47
Adelaide Utd,8968,5,11,6,11,37,40,-3,39
Brisbane,8968,6,10,5,13,33,42,-9,35
Western Sydn,8968,7,8,9,10,38,47,-9,33
Perth Glory,8968,8,10,2,15,37,50,-13,32
Wellington P,8968,9,5,6,16,31,55,-24,21
CC Mariners,8968,10,4,8,15,28,49,-21,20
Sydney FC,8969,1,20,5,3,67,25,42,65
N'castle Jet,8969,2,15,6,7,59,39,20,51
Melbourne C,8969,3,14,5,10,45,35,10,47
Melbourne V,8969,4,13,6,10,48,41,7,45
Adelaide Utd,8969,5,11,6,11,37,40,-3,39
Brisbane,8969,6,10,5,13,33,42,-9,35
Western Sydn,8969,7,8,9,10,38,47,-9,33
Perth Glory,8969,8,10,2,15,37,50,-13,32
Wellington P,8969,9,5,6,16,31,55,-24,21
CC Mariners,8969,10,4,8,15,28,49,-21,20
Sydney FC,8970,1,20,4,4,65,24,41,64
N'castle Jet,8970,2,15,6,7,59,39,20,51
Melbourne C,8970,3,14,5,10,45,35,10,47
Melbourne V,8970,4,14,5,10,47,39,8,47
Adelaide Utd,8970,5,11,6,11,37,40,-3,39
Brisbane,8970,6,10,5,13,33,42,-9,35
Western Sydn,8970,7,8,9,10,38,47,-9,33
Perth Glory,8970,8,10,2,15,37,50,-13,32
Wellington P,8970,9,5,6,16,31,55,-24,21
CC Mariners,8970,10,4,8,15,28,49,-21,20
Sydney FC,8971,1,20,5,3,65,23,42,65
N'castle Jet,8971,2,15,6,7,58,38,20,51
Melbourne C,8971,3,14,5,10,44,34,10,47
Melbourne V,8971,4,13,6,10,46,39,7,45
Adelaide Utd,8971,5,11,6,11,37,40,-3,39
Brisbane,8971,6,10,5,13,33,42,-9,35
Western Sydn,8971,7,8,9,10,38,47,-9,33
Perth Glory,8971,8,10,2,15,37,50,-13,32
Wellington P,8971,9,5,6,16,31,55,-24,21
CC Mariners,8971,10,4,8,15,28,49,-21,20
Sydney FC,8972,1,21,4,3,67,22,45,67
N'castle Jet,8972,2,15,5,8,57,39,18,50
Melbourne C,8972,3,15,4,10,45,33,12,49
Melbourne V,8972,4,13,5,11,45,41,4,44
Adelaide Utd,8972,5,11,6,11,37,40,-3,39
Brisbane,8972,6,10,5,13,33,42,-9,35
Western Sydn,8972,7,8,9,10,38,47,-9,33
Perth Glory,8972,8,10,2,15,37,50,-13,32
Wellington P,8972,9,5,6,16,31,55,-24,21
CC Mariners,8972,10,4,8,15,28,49,-21,20
Sydney FC,8973,1,20,4,4,65,25,40,64
N'castle Jet,8973,2,16,5,7,61,39,22,53
Melbourne V,8973,3,14,5,10,48,39,9,47
Melbourne C,8973,4,14,4,11,45,37,8,46
Adelaide Utd,8973,5,11,6,11,37,40,-3,39
Brisbane,8973,6,10,5,13,33,42,-9,35
Western Sydn,8973,7,8,9,10,38,47,-9,33
Perth Glory,8973,8,10,2,15,37,50,-13,32
Wellington P,8973,9,5,6,16,31,55,-24,21
CC Mariners,8973,10,4,8,15,28,49,-21,20
Sydney FC,8974,1,21,4,3,69,22,47,67
N'castle Jet,8974,2,15,6,7,58,38,20,51
Melbourne C,8974,3,14,5,10,44,34,10,47
Melbourne V,8974,4,13,5,11,45,43,2,44
Adelaide Utd,8974,5,11,6,11,37,40,-3,39
Brisbane,8974,6,10,5,13,33,42,-9,35
Western Sydn,8974,7,8,9,10,38,47,-9,33
Perth Glory,8974,8,10,2,15,37,50,-13,32
Wellington P,8974,9,5,6,16,31,55,-24,21
CC Mariners,8974,10,4,8,15,28,49,-21,20
Sydney FC,8975,1,20,4,4,65,24,41,64
N'castle Jet,8975,2,16,5,7,61,38,23,53
Melbourne V,8975,3,14,5,10,47,39,8,47
Melbourne C,8975,4,14,4,11,44,37,7,46
Adelaide Utd,8975,5,11,6,11,37,40,-3,39
Brisbane,8975,6,10,5,13,33,42,-9,35
Western Sydn,8975,7,8,9,10,38,47,-9,33
Perth Glory,8975,8,10,2,15,37,50,-13,32
Wellington P,8975,9,5,6,16,31,55,-24,21
CC Mariners,8975,10,4,8,15,28,49,-21,20
Sydney FC,8976,1,20,5,3,66,24,42,65
N'castle Jet,8976,2,15,6,7,58,38,20,51
Melbourne C,8976,3,14,5,10,44,34,10,47
Melbourne V,8976,4,13,6,10,47,40,7,45
Adelaide Utd,8976,5,11,6,11,37,40,-3,39
Brisbane,8976,6,10,5,13,33,42,-9,35
Western Sydn,8976,7,8,9,10,38,47,-9,33
Perth Glory,8976,8,10,2,15,37,50,-13,32
Wellington P,8976,9,5,6,16,31,55,-24,21
CC Mariners,8976,10,4,8,15,28,49,-21,20
Sydney FC,8977,1,20,5,3,65,23,42,65
N'castle Jet,8977,2,16,5,7,59,38,21,53
Melbourne C,8977,3,14,4,11,44,35,9,46
Melbourne V,8977,4,13,6,10,46,39,7,45
Adelaide Utd,8977,5,11,6,11,37,40,-3,39
Brisbane,8977,6,10,5,13,33,42,-9,35
Western Sydn,8977,7,8,9,10,38,47,-9,33
Perth Glory,8977,8,10,2,15,37,50,-13,32
Wellington P,8977,9,5,6,16,31,55,-24,21
CC Mariners,8977,10,4,8,15,28,49,-21,20
Sydney FC,8978,1,21,4,3,68,22,46,67
N'castle Jet,8978,2,16,5,7,60,39,21,53
Melbourne C,8978,3,14,4,11,45,36,9,46
Melbourne V,8978,4,13,5,11,45,42,3,44
Adelaide Utd,8978,5,11,6,11,37,40,-3,39
Brisbane,8978,6,10,5,13,33,42,-9,35
Western Sydn,8978,7,8,9,10,38,47,-9,33
Perth Glory,8978,8,10,2,15,37,50,-13,32
Wellington P,8978,9,5,6,16,31,55,-24,21
CC Mariners,8978,10,4,8,15,28,49,-21,20
Sydney FC,8979,1,20,4,4,65,24,41,64
N'castle Jet,8979,2,15,6,7,57,37,20,51
Melbourne C,8979,3,14,5,10,43,33,10,47
Melbourne V,8979,4,14,5,10,47,39,8,47
Adelaide Utd,8979,5,11,6,11,37,40,-3,39
Brisbane,8979,6,10,5,13,33,42,-9,35
Western Sydn,8979,7,8,9,10,38,47,-9,33
Perth Glory,8979,8,10,2,15,37,50,-13,32
Wellington P,8979,9,5,6,16,31,55,-24,21
CC Mariners,8979,10,4,8,15,28,49,-21,20
Sydney FC,8980,1,21,4,3,70,23,47,67
N'castle Jet,8980,2,15,5,8,57,39,18,50
Melbourne C,8980,3,15,4,10,45,33,12,49
Melbourne V,8980,4,13,5,11,46,44,2,44
Adelaide Utd,8980,5,11,6,11,37,40,-3,39
Brisbane,8980,6,10,5,13,33,42,-9,35
Western Sydn,8980,7,8,9,10,38,47,-9,33
Perth Glory,8980,8,10,2,15,37,50,-13,32
Wellington P,8980,9,5,6,16,31,55,-24,21
CC Mariners,8980,10,4,8,15,28,49,-21,20
Sydney FC,8981,1,21,4,3,67,22,45,67
N'castle Jet,8981,2,15,5,8,57,39,18,50
Melbourne C,8981,3,15,4,10,45,33,12,49
Melbourne V,8981,4,13,5,11,45,41,4,44
Adelaide Utd,8981,5,11,6,11,37,40,-3,39
Brisbane,8981,6,10,5,13,33,42,-9,35
Western Sydn,8981,7,8,9,10,38,47,-9,33
Perth Glory,8981,8,10,2,15,37,50,-13,32
Wellington P,8981,9,5,6,16,31,55,-24,21
CC Mariners,8981,10,4,8,15,28,49,-21,20
Sydney FC,8982,1,20,4,4,64,24,40,64
N'castle Jet,8982,2,16,5,7,59,37,22,53
Melbourne V,8982,3,14,5,10,47,38,9,47
Melbourne C,8982,4,14,4,11,43,35,8,46
Adelaide Utd,8982,5,11,6,11,37,40,-3,39
Brisbane,8982,6,10,5,13,33,42,-9,35
Western Sydn,8982,7,8,9,10,38,47,-9,33
Perth Glory,8982,8,10,2,15,37,50,-13,32
Wellington P,8982,9,5,6,16,31,55,-24,21
CC Mariners,8982,10,4,8,15,28,49,-21,20
Sydney FC,8983,1,21,4,3,66,23,43,67
N'castle Jet,8983,2,15,6,7,59,39,20,51
Melbourne C,8983,3,14,5,10,45,35,10,47
Melbourne V,8983,4,13,5,11,46,40,6,44
Adelaide Utd,8983,5,11,6,11,37,40,-3,39
Brisbane,8983,6,10,5,13,33,42,-9,35
Western Sydn,8983,7,8,9,10,38,47,-9,33
Perth Glory,8983,8,10,2,15,37,50,-13,32
Wellington P,8983,9,5,6,16,31,55,-24,21
CC Mariners,8983,10,4,8,15,28,49,-21,20
Sydney FC,8984,1,21,4,3,67,23,44,67
N'castle Jet,8984,2,16,5,7,61,38,23,53
Melbourne C,8984,3,14,4,11,44,37,7,46
Melbourne V,8984,4,13,5,11,46,41,5,44
Adelaide Utd,8984,5,11,6,11,37,40,-3,39
Brisbane,8984,6,10,5,13,33,42,-9,35
Western Sydn,8984,7,8,9,10,38,47,-9,33
Perth Glory,8984,8,10,2,15,37,50,-13,32
Wellington P,8984,9,5,6,16,31,55,-24,21
CC Mariners,8984,10,4,8,15,28,49,-21,20
Sydney FC,8985,1,20,5,3,65,23,42,65
N'castle Jet,8985,2,16,5,7,61,38,23,53
Melbourne C,8985,3,14,4,11,44,37,7,46
Melbourne V,8985,4,13,6,10,46,39,7,45
Adelaide Utd,8985,5,11,6,11,37,40,-3,39
Brisbane,8985,6,10,5,13,33,42,-9,35
Western Sydn,8985,7,8,9,10,38,47,-9,33
Perth Glory,8985,8,10,2,15,37,50,-13,32
Wellington P,8985,9,5,6,16,31,55,-24,21
CC Mariners,8985,10,4,8,15,28,49,-21,20
Sydney FC,8986,1,21,4,3,69,24,45,67
N'castle Jet,8986,2,15,5,8,57,39,18,50
Melbourne C,8986,3,15,4,10,45,33,12,49
Melbourne V,8986,4,13,5,11,47,43,4,44
Adelaide Utd,8986,5,11,6,11,37,40,-3,39
Brisbane,8986,6,10,5,13,33,42,-9,35
Western Sydn,8986,7,8,9,10,38,47,-9,33
Perth Glory,8986,8,10,2,15,37,50,-13,32
Wellington P,8986,9,5,6,16,31,55,-24,21
CC Mariners,8986,10,4,8,15,28,49,-21,20
Sydney FC,8987,1,21,4,3,72,23,49,67
N'castle Jet,8987,2,16,5,7,59,37,22,53
Melbourne C,8987,3,14,4,11,43,35,8,46
Melbourne V,8987,4,13,5,11,46,46,0,44
Adelaide Utd,8987,5,11,6,11,37,40,-3,39
Brisbane,8987,6,10,5,13,33,42,-9,35
Western Sydn,8987,7,8,9,10,38,47,-9,33
Perth Glory,8987,8,10,2,15,37,50,-13,32
Wellington P,8987,9,5,6,16,31,55,-24,21
CC Mariners,8987,10,4,8,15,28,49,-21,20
Sydney FC,8988,1,20,4,4,65,24,41,64
N'castle Jet,8988,2,15,5,8,57,39,18,50
Melbourne C,8988,3,15,4,10,45,33,12,49
Melbourne V,8988,4,14,5,10,47,39,8,47
Adelaide Utd,8988,5,11,6,11,37,40,-3,39
Brisbane,8988,6,10,5,13,33,42,-9,35
Western Sydn,8988,7,8,9,10,38,47,-9,33
Perth Glory,8988,8,10,2,15,37,50,-13,32
Wellington P,8988,9,5,6,16,31,55,-24,21
CC Mariners,8988,10,4,8,15,28,49,-21,20
Sydney FC,8989,1,21,4,3,68,22,46,67
N'castle Jet,8989,2,16,5,7,60,37,23,53
Melbourne C,8989,3,14,4,11,43,36,7,46
Melbourne V,8989,4,13,5,11,45,42,3,44
Adelaide Utd,8989,5,11,6,11,37,40,-3,39
Brisbane,8989,6,10,5,13,33,42,-9,35
Western Sydn,8989,7,8,9,10,38,47,-9,33
Perth Glory,8989,8,10,2,15,37,50,-13,32
Wellington P,8989,9,5,6,16,31,55,-24,21
CC Mariners,8989,10,4,8,15,28,49,-21,20
Sydney FC,8990,1,20,5,3,66,24,42,65
N'castle Jet,8990,2,16,5,7,60,37,23,53
Melbourne C,8990,3,14,4,11,43,36,7,46
Melbourne V,8990,4,13,6,10,47,40,7,45
Adelaide Utd,8990,5,11,6,11,37,40,-3,39
Brisbane,8990,6,10,5,13,33,42,-9,35
Western Sydn,8990,7,8,9,10,38,47,-9,33
Perth Glory,8990,8,10,2,15,37,50,-13,32
Wellington P,8990,9,5,6,16,31,55,-24,21
CC Mariners,8990,10,4,8,15,28,49,-21,20
Sydney FC,8991,1,21,4,3,68,23,45,67
N'castle Jet,8991,2,16,5,7,60,37,23,53
Melbourne C,8991,3,14,4,11,43,36,7,46
Melbourne V,8991,4,13,5,11,46,42,4,44
Adelaide Utd,8991,5,11,6,11,37,40,-3,39
Brisbane,8991,6,10,5,13,33,42,-9,35
Western Sydn,8991,7,8,9,10,38,47,-9,33
Perth Glory,8991,8,10,2,15,37,50,-13,32
Wellington P,8991,9,5,6,16,31,55,-24,21
CC Mariners,8991,10,4,8,15,28,49,-21,20
Sydney FC,8992,1,21,4,3,68,24,44,67
N'castle Jet,8992,2,16,5,7,59,37,22,53
Melbourne C,8992,3,14,4,11,43,35,8,46
Melbourne V,8992,4,13,5,11,47,42,5,44
Adelaide Utd,8992,5,11,6,11,37,40,-3,39
Brisbane,8992,6,10,5,13,33,42,-9,35
Western Sydn,8992,7,8,9,10,38,47,-9,33
Perth Glory,8992,8,10,2,15,37,50,-13,32
Wellington P,8992,9,5,6,16,31,55,-24,21
CC Mariners,8992,10,4,8,15,28,49,-21,20
Sydney FC,8993,1,21,4,3,67,23,44,67
N'castle Jet,8993,2,16,5,7,58,37,21,53
Melbourne C,8993,3,14,4,11,43,34,9,46
Melbourne V,8993,4,13,5,11,46,41,5,44
Adelaide Utd,8993,5,11,6,11,37,40,-3,39
Brisbane,8993,6,10,5,13,33,42,-9,35
Western Sydn,8993,7,8,9,10,38,47,-9,33
Perth Glory,8993,8,10,2,15,37,50,-13,32
Wellington P,8993,9,5,6,16,31,55,-24,21
CC Mariners,8993,10,4,8,15,28,49,-21,20
Sydney FC,8994,1,21,4,3,66,23,43,67
N'castle Jet,8994,2,16,5,7,60,38,22,53
Melbourne C,8994,3,14,4,11,44,36,8,46
Melbourne V,8994,4,13,5,11,46,40,6,44
Adelaide Utd,8994,5,11,6,11,37,40,-3,39
Brisbane,8994,6,10,5,13,33,42,-9,35
Western Sydn,8994,7,8,9,10,38,47,-9,33
Perth Glory,8994,8,10,2,15,37,50,-13,32
Wellington P,8994,9,5,6,16,31,55,-24,21
CC Mariners,8994,10,4,8,15,28,49,-21,20
Sydney FC,8995,1,21,4,3,67,23,44,67
N'castle Jet,8995,2,16,5,7,59,37,22,53
Melbourne C,8995,3,14,4,11,43,35,8,46
Melbourne V,8995,4,13,5,11,46,41,5,44
Adelaide Utd,8995,5,11,6,11,37,40,-3,39
Brisbane,8995,6,10,5,13,33,42,-9,35
Western Sydn,8995,7,8,9,10,38,47,-9,33
Perth Glory,8995,8,10,2,15,37,50,-13,32
Wellington P,8995,9,5,6,16,31,55,-24,21
CC Mariners,8995,10,4,8,15,28,49,-21,20
Sydney FC,8996,1,20,5,3,66,24,42,65
N'castle Jet,8996,2,16,5,7,59,37,22,53
Melbourne C,8996,3,14,4,11,43,35,8,46
Melbourne V,8996,4,13,6,10,47,40,7,45
Adelaide Utd,8996,5,11,6,11,37,40,-3,39
Brisbane,8996,6,10,5,13,33,42,-9,35
Western Sydn,8996,7,8,9,10,38,47,-9,33
Perth Glory,8996,8,10,2,15,37,50,-13,32
Wellington P,8996,9,5,6,16,31,55,-24,21
CC Mariners,8996,10,4,8,15,28,49,-21,20
Sydney FC,8997,1,20,5,3,65,23,42,65
N'castle Jet,8997,2,16,5,7,59,37,22,53
Melbourne C,8997,3,14,4,11,43,35,8,46
Melbourne V,8997,4,13,6,10,46,39,7,45
Adelaide Utd,8997,5,11,6,11,37,40,-3,39
Brisbane,8997,6,10,5,13,33,42,-9,35
Western Sydn,8997,7,8,9,10,38,47,-9,33
Perth Glory,8997,8,10,2,15,37,50,-13,32
Wellington P,8997,9,5,6,16,31,55,-24,21
CC Mariners,8997,10,4,8,15,28,49,-21,20
Sydney FC,8998,1,21,4,3,65,22,43,67
N'castle Jet,8998,2,16,5,7,58,37,21,53
Melbourne C,8998,3,14,4,11,43,34,9,46
Melbourne V,8998,4,13,5,11,45,39,6,44
Adelaide Utd,8998,5,11,6,11,37,40,-3,39
Brisbane,8998,6,10,5,13,33,42,-9,35
Western Sydn,8998,7,8,9,10,38,47,-9,33
Perth Glory,8998,8,10,2,15,37,50,-13,32
Wellington P,8998,9,5,6,16,31,55,-24,21
CC Mariners,8998,10,4,8,15,28,49,-21,20
Sydney FC,8999,1,21,4,3,67,22,45,67
N'castle Jet,8999,2,16,5,7,58,37,21,53
Melbourne C,8999,3,14,4,11,43,34,9,46
Melbourne V,8999,4,13,5,11,45,41,4,44
Adelaide Utd,8999,5,11,6,11,37,40,-3,39
Brisbane,8999,6,10,5,13,33,42,-9,35
Western Sydn,8999,7,8,9,10,38,47,-9,33
Perth Glory,8999,8,10,2,15,37,50,-13,32
Wellington P,8999,9,5,6,16,31,55,-24,21
CC Mariners,8999,10,4,8,15,28,49,-21,20
Sydney FC,9000,1,21,4,3,66,22,44,67
N'castle Jet,9000,2,16,5,7,60,38,22,53
Melbourne C,9000,3,14,4,11,44,36,8,46
Melbourne V,9000,4,13,5,11,45,40,5,44
Adelaide Utd,9000,5,11,6,11,37,40,-3,39
Brisbane,9000,6,10,5,13,33,42,-9,35
Western Sydn,9000,7,8,9,10,38,47,-9,33
Perth Glory,9000,8,10,2,15,37,50,-13,32
Wellington P,9000,9,5,6,16,31,55,-24,21
CC Mariners,9000,10,4,8,15,28,49,-21,20
Sydney FC,9001,1,20,5,3,65,23,42,65
N'castle Jet,9001,2,16,5,7,61,37,24,53
Melbourne C,9001,3,14,4,11,43,37,6,46
Melbourne V,9001,4,13,6,10,46,39,7,45
Adelaide Utd,9001,5,11,6,11,37,40,-3,39
Brisbane,9001,6,10,5,13,33,42,-9,35
Western Sydn,9001,7,8,9,10,38,47,-9,33
Perth Glory,9001,8,10,2,15,37,50,-13,32
Wellington P,9001,9,5,6,16,31,55,-24,21
CC Mariners,9001,10,4,8,15,28,49,-21,20
Sydney FC,9002,1,20,4,4,65,24,41,64
N'castle Jet,9002,2,16,5,7,58,37,21,53
Melbourne V,9002,3,14,5,10,47,39,8,47
Melbourne C,9002,4,14,4,11,43,34,9,46
Adelaide Utd,9002,5,11,6,11,37,40,-3,39
Brisbane,9002,6,10,5,13,33,42,-9,35
Western Sydn,9002,7,8,9,10,38,47,-9,33
Perth Glory,9002,8,10,2,15,37,50,-13,32
Wellington P,9002,9,5,6,16,31,55,-24,21
CC Mariners,9002,10,4,8,15,28,49,-21,20
Sydney FC,9003,1,21,4,3,67,24,43,67
N'castle Jet,9003,2,15,6,7,63,43,20,51
Melbourne C,9003,3,14,5,10,49,39,10,47
Melbourne V,9003,4,13,5,11,47,41,6,44
Adelaide Utd,9003,5,11,6,11,37,40,-3,39
Brisbane,9003,6,10,5,13,33,42,-9,35
Western Sydn,9003,7,8,9,10,38,47,-9,33
Perth Glory,9003,8,10,2,15,37,50,-13,32
Wellington P,9003,9,5,6,16,31,55,-24,21
CC Mariners,9003,10,4,8,15,28,49,-21,20
Sydney FC,9004,1,20,5,3,65,23,42,65
N'castle Jet,9004,2,16,5,7,59,38,21,53
Melbourne C,9004,3,14,4,11,44,35,9,46
Melbourne V,9004,4,13,6,10,46,39,7,45
Adelaide Utd,9004,5,11,6,11,37,40,-3,39
Brisbane,9004,6,10,5,13,33,42,-9,35
Western Sydn,9004,7,8,9,10,38,47,-9,33
Perth Glory,9004,8,10,2,15,37,50,-13,32
Wellington P,9004,9,5,6,16,31,55,-24,21
CC Mariners,9004,10,4,8,15,28,49,-21,20
Sydney FC,9005,1,21,4,3,65,22,43,67
N'castle Jet,9005,2,15,5,8,57,39,18,50
Melbourne C,9005,3,15,4,10,45,33,12,49
Melbourne V,9005,4,13,5,11,45,39,6,44
Adelaide Utd,9005,5,11,6,11,37,40,-3,39
Brisbane,9005,6,10,5,13,33,42,-9,35
Western Sydn,9005,7,8,9,10,38,47,-9,33
Perth Glory,9005,8,10,2,15,37,50,-13,32
Wellington P,9005,9,5,6,16,31,55,-24,21
CC Mariners,9005,10,4,8,15,28,49,-21,20
Sydney FC,9006,1,20,5,3,66,24,42,65
N'castle Jet,9006,2,15,5,8,59,40,19,50
Melbourne C,9006,3,15,4,10,46,35,11,49
Melbourne V,9006,4,13,6,10,47,40,7,45
Adelaide Utd,9006,5,11,6,11,37,40,-3,39
Brisbane,9006,6,10,5,13,33,42,-9,35
Western Sydn,9006,7,8,9,10,38,47,-9,33
Perth Glory,9006,8,10,2,15,37,50,-13,32
Wellington P,9006,9,5,6,16,31,55,-24,21
CC Mariners,9006,10,4,8,15,28,49,-21,20
Sydney FC,9007,1,20,4,4,64,23,41,64
N'castle Jet,9007,2,16,5,7,58,37,21,53
Melbourne V,9007,3,14,5,10,46,38,8,47
Melbourne C,9007,4,14,4,11,43,34,9,46
Adelaide Utd,9007,5,11,6,11,37,40,-3,39
Brisbane,9007,6,10,5,13,33,42,-9,35
Western Sydn,9007,7,8,9,10,38,47,-9,33
Perth Glory,9007,8,10,2,15,37,50,-13,32
Wellington P,9007,9,5,6,16,31,55,-24,21
CC Mariners,9007,10,4,8,15,28,49,-21,20
Sydney FC,9008,1,21,4,3,66,23,43,67
N'castle Jet,9008,2,16,5,7,59,38,21,53
Melbourne C,9008,3,14,4,11,44,35,9,46
Melbourne V,9008,4,13,5,11,46,40,6,44
Adelaide Utd,9008,5,11,6,11,37,40,-3,39
Brisbane,9008,6,10,5,13,33,42,-9,35
Western Sydn,9008,7,8,9,10,38,47,-9,33
Perth Glory,9008,8,10,2,15,37,50,-13,32
Wellington P,9008,9,5,6,16,31,55,-24,21
CC Mariners,9008,10,4,8,15,28,49,-21,20
Sydney FC,9009,1,21,4,3,66,22,44,67
N'castle Jet,9009,2,16,5,7,59,37,22,53
Melbourne C,9009,3,14,4,11,43,35,8,46
Melbourne V,9009,4,13,5,11,45,40,5,44
Adelaide Utd,9009,5,11,6,11,37,40,-3,39
Brisbane,9009,6,10,5,13,33,42,-9,35
Western Sydn,9009,7,8,9,10,38,47,-9,33
Perth Glory,9009,8,10,2,15,37,50,-13,32
Wellington P,9009,9,5,6,16,31,55,-24,21
CC Mariners,9009,10,4,8,15,28,49,-21,20
Sydney FC,9010,1,21,4,3,69,24,45,67
N'castle Jet,9010,2,15,6,7,59,39,20,51
Melbourne C,9010,3,14,5,10,45,35,10,47
Melbourne V,9010,4,13,5,11,47,43,4,44
Adelaide Utd,9010,5,11,6,11,37,40,-3,39
Brisbane,9010,6,10,5,13,33,42,-9,35
Western Sydn,9010,7,8,9,10,38,47,-9,33
Perth Glory,9010,8,10,2,15,37,50,-13,32
Wellington P,9010,9,5,6,16,31,55,-24,21
CC Mariners,9010,10,4,8,15,28,49,-21,20
Sydney FC,9011,1,21,4,3,66,22,44,67
N'castle Jet,9011,2,15,5,8,58,42,16,50
Melbourne C,9011,3,15,4,10,48,34,14,49
Melbourne V,9011,4,13,5,11,45,40,5,44
Adelaide Utd,9011,5,11,6,11,37,40,-3,39
Brisbane,9011,6,10,5,13,33,42,-9,35
Western Sydn,9011,7,8,9,10,38,47,-9,33
Perth Glory,9011,8,10,2,15,37,50,-13,32
Wellington P,9011,9,5,6,16,31,55,-24,21
CC Mariners,9011,10,4,8,15,28,49,-21,20
Sydney FC,9012,1,21,4,3,68,23,45,67
N'castle Jet,9012,2,15,6,7,57,37,20,51
Melbourne C,9012,3,14,5,10,43,33,10,47
Melbourne V,9012,4,13,5,11,46,42,4,44
Adelaide Utd,9012,5,11,6,11,37,40,-3,39
Brisbane,9012,6,10,5,13,33,42,-9,35
Western Sydn,9012,7,8,9,10,38,47,-9,33
Perth Glory,9012,8,10,2,15,37,50,-13,32
Wellington P,9012,9,5,6,16,31,55,-24,21
CC Mariners,9012,10,4,8,15,28,49,-21,20
Sydney FC,9013,1,20,5,3,65,23,42,65
N'castle Jet,9013,2,15,6,7,58,38,20,51
Melbourne C,9013,3,14,5,10,44,34,10,47
Melbourne V,9013,4,13,6,10,46,39,7,45
Adelaide Utd,9013,5,11,6,11,37,40,-3,39
Brisbane,9013,6,10,5,13,33,42,-9,35
Western Sydn,9013,7,8,9,10,38,47,-9,33
Perth Glory,9013,8,10,2,15,37,50,-13,32
Wellington P,9013,9,5,6,16,31,55,-24,21
CC Mariners,9013,10,4,8,15,28,49,-21,20
Sydney FC,9014,1,20,4,4,65,24,41,64
N'castle Jet,9014,2,16,5,7,58,37,21,53
Melbourne V,9014,3,14,5,10,47,39,8,47
Melbourne C,9014,4,14,4,11,43,34,9,46
Adelaide Utd,9014,5,11,6,11,37,40,-3,39
Brisbane,9014,6,10,5,13,33,42,-9,35
Western Sydn,9014,7,8,9,10,38,47,-9,33
Perth Glory,9014,8,10,2,15,37,50,-13,32
Wellington P,9014,9,5,6,16,31,55,-24,21
CC Mariners,9014,10,4,8,15,28,49,-21,20
Sydney FC,9015,1,21,4,3,67,24,43,67
N'castle Jet,9015,2,15,5,8,58,40,18,50
Melbourne C,9015,3,15,4,10,46,34,12,49
Melbourne V,9015,4,13,5,11,47,41,6,44
Adelaide Utd,9015,5,11,6,11,37,40,-3,39
Brisbane,9015,6,10,5,13,33,42,-9,35
Western Sydn,9015,7,8,9,10,38,47,-9,33
Perth Glory,9015,8,10,2,15,37,50,-13,32
Wellington P,9015,9,5,6,16,31,55,-24,21
CC Mariners,9015,10,4,8,15,28,49,-21,20
Sydney FC,9016,1,21,4,3,66,23,43,67
N'castle Jet,9016,2,15,5,8,58,40,18,50
Melbourne C,9016,3,15,4,10,46,34,12,49
Melbourne V,9016,4,13,5,11,46,40,6,44
Adelaide Utd,9016,5,11,6,11,37,40,-3,39
Brisbane,9016,6,10,5,13,33,42,-9,35
Western Sydn,9016,7,8,9,10,38,47,-9,33
Perth Glory,9016,8,10,2,15,37,50,-13,32
Wellington P,9016,9,5,6,16,31,55,-24,21
CC Mariners,9016,10,4,8,15,28,49,-21,20
Sydney FC,9017,1,20,4,4,65,24,41,64
N'castle Jet,9017,2,16,5,7,58,37,21,53
Melbourne V,9017,3,14,5,10,47,39,8,47
Melbourne C,9017,4,14,4,11,43,34,9,46
Adelaide Utd,9017,5,11,6,11,37,40,-3,39
Brisbane,9017,6,10,5,13,33,42,-9,35
Western Sydn,9017,7,8,9,10,38,47,-9,33
Perth Glory,9017,8,10,2,15,37,50,-13,32
Wellington P,9017,9,5,6,16,31,55,-24,21
CC Mariners,9017,10,4,8,15,28,49,-21,20
Sydney FC,9018,1,21,4,3,66,22,44,67
N'castle Jet,9018,2,16,5,7,59,37,22,53
Melbourne C,9018,3,14,4,11,43,35,8,46
Melbourne V,9018,4,13,5,11,45,40,5,44
Adelaide Utd,9018,5,11,6,11,37,40,-3,39
Brisbane,9018,6,10,5,13,33,42,-9,35
Western Sydn,9018,7,8,9,10,38,47,-9,33
Perth Glory,9018,8,10,2,15,37,50,-13,32
Wellington P,9018,9,5,6,16,31,55,-24,21
CC Mariners,9018,10,4,8,15,28,49,-21,20
Sydney FC,9019,1,21,4,3,69,24,45,67
N'castle Jet,9019,2,16,5,7,60,38,22,53
Melbourne C,9019,3,14,4,11,44,36,8,46
Melbourne V,9019,4,13,5,11,47,43,4,44
Adelaide Utd,9019,5,11,6,11,37,40,-3,39
Brisbane,9019,6,10,5,13,33,42,-9,35
Western Sydn,9019,7,8,9,10,38,47,-9,33
Perth Glory,9019,8,10,2,15,37,50,-13,32
Wellington P,9019,9,5,6,16,31,55,-24,21
CC Mariners,9019,10,4,8,15,28,49,-21,20
Sydney FC,9020,1,21,4,3,66,23,43,67
N'castle Jet,9020,2,15,5,8,59,41,18,50
Melbourne C,9020,3,15,4,10,47,35,12,49
Melbourne V,9020,4,13,5,11,46,40,6,44
Adelaide Utd,9020,5,11,6,11,37,40,-3,39
Brisbane,9020,6,10,5,13,33,42,-9,35
Western Sydn,9020,7,8,9,10,38,47,-9,33
Perth Glory,9020,8,10,2,15,37,50,-13,32
Wellington P,9020,9,5,6,16,31,55,-24,21
CC Mariners,9020,10,4,8,15,28,49,-21,20
Sydney FC,9021,1,21,4,3,65,22,43,67
N'castle Jet,9021,2,16,5,7,61,39,22,53
Melbourne C,9021,3,14,4,11,45,37,8,46
Melbourne V,9021,4,13,5,11,45,39,6,44
Adelaide Utd,9021,5,11,6,11,37,40,-3,39
Brisbane,9021,6,10,5,13,33,42,-9,35
Western Sydn,9021,7,8,9,10,38,47,-9,33
Perth Glory,9021,8,10,2,15,37,50,-13,32
Wellington P,9021,9,5,6,16,31,55,-24,21
CC Mariners,9021,10,4,8,15,28,49,-21,20
Sydney FC,9022,1,21,4,3,70,23,47,67
N'castle Jet,9022,2,15,6,7,58,38,20,51
Melbourne C,9022,3,14,5,10,44,34,10,47
Melbourne V,9022,4,13,5,11,46,44,2,44
Adelaide Utd,9022,5,11,6,11,37,40,-3,39
Brisbane,9022,6,10,5,13,33,42,-9,35
Western Sydn,9022,7,8,9,10,38,47,-9,33
Perth Glory,9022,8,10,2,15,37,50,-13,32
Wellington P,9022,9,5,6,16,31,55,-24,21
CC Mariners,9022,10,4,8,15,28,49,-21,20
Sydney FC,9023,1,20,5,3,68,26,42,65
N'castle Jet,9023,2,15,5,8,57,39,18,50
Melbourne C,9023,3,15,4,10,45,33,12,49
Melbourne V,9023,4,13,6,10,49,42,7,45
Adelaide Utd,9023,5,11,6,11,37,40,-3,39
Brisbane,9023,6,10,5,13,33,42,-9,35
Western Sydn,9023,7,8,9,10,38,47,-9,33
Perth Glory,9023,8,10,2,15,37,50,-13,32
Wellington P,9023,9,5,6,16,31,55,-24,21
CC Mariners,9023,10,4,8,15,28,49,-21,20
Sydney FC,9024,1,20,4,4,65,24,41,64
N'castle Jet,9024,2,16,5,7,61,38,23,53
Melbourne V,9024,3,14,5,10,47,39,8,47
Melbourne C,9024,4,14,4,11,44,37,7,46
Adelaide Utd,9024,5,11,6,11,37,40,-3,39
Brisbane,9024,6,10,5,13,33,42,-9,35
Western Sydn,9024,7,8,9,10,38,47,-9,33
Perth Glory,9024,8,10,2,15,37,50,-13,32
Wellington P,9024,9,5,6,16,31,55,-24,21
CC Mariners,9024,10,4,8,15,28,49,-21,20
Sydney FC,9025,1,21,4,3,68,23,45,67
N'castle Jet,9025,2,16,5,7,60,37,23,53
Melbourne C,9025,3,14,4,11,43,36,7,46
Melbourne V,9025,4,13,5,11,46,42,4,44
Adelaide Utd,9025,5,11,6,11,37,40,-3,39
Brisbane,9025,6,10,5,13,33,42,-9,35
Western Sydn,9025,7,8,9,10,38,47,-9,33
Perth Glory,9025,8,10,2,15,37,50,-13,32
Wellington P,9025,9,5,6,16,31,55,-24,21
CC Mariners,9025,10,4,8,15,28,49,-21,20
Sydney FC,9026,1,21,4,3,67,22,45,67
N'castle Jet,9026,2,16,5,7,58,37,21,53
Melbourne C,9026,3,14,4,11,43,34,9,46
Melbourne V,9026,4,13,5,11,45,41,4,44
Adelaide Utd,9026,5,11,6,11,37,40,-3,39
Brisbane,9026,6,10,5,13,33,42,-9,35
Western Sydn,9026,7,8,9,10,38,47,-9,33
Perth Glory,9026,8,10,2,15,37,50,-13,32
Wellington P,9026,9,5,6,16,31,55,-24,21
CC Mariners,9026,10,4,8,15,28,49,-21,20
Sydney FC,9027,1,21,4,3,69,23,46,67
N'castle Jet,9027,2,15,5,8,58,39,19,50
Melbourne C,9027,3,15,4,10,45,34,11,49
Melbourne V,9027,4,13,5,11,46,43,3,44
Adelaide Utd,9027,5,11,6,11,37,40,-3,39
Brisbane,9027,6,10,5,13,33,42,-9,35
Western Sydn,9027,7,8,9,10,38,47,-9,33
Perth Glory,9027,8,10,2,15,37,50,-13,32
Wellington P,9027,9,5,6,16,31,55,-24,21
CC Mariners,9027,10,4,8,15,28,49,-21,20
Sydney FC,9028,1,20,4,4,64,24,40,64
N'castle Jet,9028,2,15,6,7,59,39,20,51
Melbourne C,9028,3,14,5,10,45,35,10,47
Melbourne V,9028,4,14,5,10,47,38,9,47
Adelaide Utd,9028,5,11,6,11,37,40,-3,39
Brisbane,9028,6,10,5,13,33,42,-9,35
Western Sydn,9028,7,8,9,10,38,47,-9,33
Perth Glory,9028,8,10,2,15,37,50,-13,32
Wellington P,9028,9,5,6,16,31,55,-24,21
CC Mariners,9028,10,4,8,15,28,49,-21,20
Sydney FC,9029,1,21,4,3,66,22,44,67
N'castle Jet,9029,2,15,5,8,58,39,19,50
Melbourne C,9029,3,15,4,10,45,34,11,49
Melbourne V,9029,4,13,5,11,45,40,5,44
Adelaide Utd,9029,5,11,6,11,37,40,-3,39
Brisbane,9029,6,10,5,13,33,42,-9,35
Western Sydn,9029,7,8,9,10,38,47,-9,33
Perth Glory,9029,8,10,2,15,37,50,-13,32
Wellington P,9029,9,5,6,16,31,55,-24,21
CC Mariners,9029,10,4,8,15,28,49,-21,20
Sydney FC,9030,1,20,5,3,65,23,42,65
N'castle Jet,9030,2,16,5,7,60,39,21,53
Melbourne C,9030,3,14,4,11,45,36,9,46
Melbourne V,9030,4,13,6,10,46,39,7,45
Adelaide Utd,9030,5,11,6,11,37,40,-3,39
Brisbane,9030,6,10,5,13,33,42,-9,35
Western Sydn,9030,7,8,9,10,38,47,-9,33
Perth Glory,9030,8,10,2,15,37,50,-13,32
Wellington P,9030,9,5,6,16,31,55,-24,21
CC Mariners,9030,10,4,8,15,28,49,-21,20
Sydney FC,9031,1,21,4,3,69,23,46,67
N'castle Jet,9031,2,15,6,7,58,38,20,51
Melbourne C,9031,3,14,5,10,44,34,10,47
Melbourne V,9031,4,13,5,11,46,43,3,44
Adelaide Utd,9031,5,11,6,11,37,40,-3,39
Brisbane,9031,6,10,5,13,33,42,-9,35
Western Sydn,9031,7,8,9,10,38,47,-9,33
Perth Glory,9031,8,10,2,15,37,50,-13,32
Wellington P,9031,9,5,6,16,31,55,-24,21
CC Mariners,9031,10,4,8,15,28,49,-21,20
Sydney FC,9032,1,21,4,3,67,22,45,67
N'castle Jet,9032,2,15,5,8,60,41,19,50
Melbourne C,9032,3,15,4,10,47,36,11,49
Melbourne V,9032,4,13,5,11,45,41,4,44
Adelaide Utd,9032,5,11,6,11,37,40,-3,39
Brisbane,9032,6,10,5,13,33,42,-9,35
Western Sydn,9032,7,8,9,10,38,47,-9,33
Perth Glory,9032,8,10,2,15,37,50,-13,32
Wellington P,9032,9,5,6,16,31,55,-24,21
CC Mariners,9032,10,4,8,15,28,49,-21,20
Sydney FC,9033,1,21,4,3,66,23,43,67
N'castle Jet,9033,2,15,6,7,58,38,20,51
Melbourne C,9033,3,14,5,10,44,34,10,47
Melbourne V,9033,4,13,5,11,46,40,6,44
Adelaide Utd,9033,5,11,6,11,37,40,-3,39
Brisbane,9033,6,10,5,13,33,42,-9,35
Western Sydn,9033,7,8,9,10,38,47,-9,33
Perth Glory,9033,8,10,2,15,37,50,-13,32
Wellington P,9033,9,5,6,16,31,55,-24,21
CC Mariners,9033,10,4,8,15,28,49,-21,20
Sydney FC,9034,1,20,4,4,64,25,39,64
N'castle Jet,9034,2,15,6,7,58,38,20,51
Melbourne V,9034,3,14,5,10,48,38,10,47
Melbourne C,9034,4,14,5,10,44,34,10,47
Adelaide Utd,9034,5,11,6,11,37,40,-3,39
Brisbane,9034,6,10,5,13,33,42,-9,35
Western Sydn,9034,7,8,9,10,38,47,-9,33
Perth Glory,9034,8,10,2,15,37,50,-13,32
Wellington P,9034,9,5,6,16,31,55,-24,21
CC Mariners,9034,10,4,8,15,28,49,-21,20
Sydney FC,9035,1,20,5,3,65,23,42,65
N'castle Jet,9035,2,16,5,7,60,37,23,53
Melbourne C,9035,3,14,4,11,43,36,7,46
Melbourne V,9035,4,13,6,10,46,39,7,45
Adelaide Utd,9035,5,11,6,11,37,40,-3,39
Brisbane,9035,6,10,5,13,33,42,-9,35
Western Sydn,9035,7,8,9,10,38,47,-9,33
Perth Glory,9035,8,10,2,15,37,50,-13,32
Wellington P,9035,9,5,6,16,31,55,-24,21
CC Mariners,9035,10,4,8,15,28,49,-21,20
Sydney FC,9036,1,21,4,3,67,22,45,67
N'castle Jet,9036,2,15,6,7,57,37,20,51
Melbourne C,9036,3,14,5,10,43,33,10,47
Melbourne V,9036,4,13,5,11,45,41,4,44
Adelaide Utd,9036,5,11,6,11,37,40,-3,39
Brisbane,9036,6,10,5,13,33,42,-9,35
Western Sydn,9036,7,8,9,10,38,47,-9,33
Perth Glory,9036,8,10,2,15,37,50,-13,32
Wellington P,9036,9,5,6,16,31,55,-24,21
CC Mariners,9036,10,4,8,15,28,49,-21,20
Sydney FC,9037,1,21,4,3,66,23,43,67
N'castle Jet,9037,2,15,5,8,58,39,19,50
Melbourne C,9037,3,15,4,10,45,34,11,49
Melbourne V,9037,4,13,5,11,46,40,6,44
Adelaide Utd,9037,5,11,6,11,37,40,-3,39
Brisbane,9037,6,10,5,13,33,42,-9,35
Western Sydn,9037,7,8,9,10,38,47,-9,33
Perth Glory,9037,8,10,2,15,37,50,-13,32
Wellington P,9037,9,5,6,16,31,55,-24,21
CC Mariners,9037,10,4,8,15,28,49,-21,20
Sydney FC,9038,1,21,4,3,65,22,43,67
N'castle Jet,9038,2,16,5,7,59,38,21,53
Melbourne C,9038,3,14,4,11,44,35,9,46
Melbourne V,9038,4,13,5,11,45,39,6,44
Adelaide Utd,9038,5,11,6,11,37,40,-3,39
Brisbane,9038,6,10,5,13,33,42,-9,35
Western Sydn,9038,7,8,9,10,38,47,-9,33
Perth Glory,9038,8,10,2,15,37,50,-13,32
Wellington P,9038,9,5,6,16,31,55,-24,21
CC Mariners,9038,10,4,8,15,28,49,-21,20
Sydney FC,9039,1,21,4,3,66,22,44,67
N'castle Jet,9039,2,15,5,8,57,40,17,50
Melbourne C,9039,3,15,4,10,46,33,13,49
Melbourne V,9039,4,13,5,11,45,40,5,44
Adelaide Utd,9039,5,11,6,11,37,40,-3,39
Brisbane,9039,6,10,5,13,33,42,-9,35
Western Sydn,9039,7,8,9,10,38,47,-9,33
Perth Glory,9039,8,10,2,15,37,50,-13,32
Wellington P,9039,9,5,6,16,31,55,-24,21
CC Mariners,9039,10,4,8,15,28,49,-21,20
Sydney FC,9040,1,20,4,4,64,23,41,64
N'castle Jet,9040,2,16,5,7,59,38,21,53
Melbourne V,9040,3,14,5,10,46,38,8,47
Melbourne C,9040,4,14,4,11,44,35,9,46
Adelaide Utd,9040,5,11,6,11,37,40,-3,39
Brisbane,9040,6,10,5,13,33,42,-9,35
Western Sydn,9040,7,8,9,10,38,47,-9,33
Perth Glory,9040,8,10,2,15,37,50,-13,32
Wellington P,9040,9,5,6,16,31,55,-24,21
CC Mariners,9040,10,4,8,15,28,49,-21,20
Sydney FC,9041,1,21,4,3,65,22,43,67
N'castle Jet,9041,2,15,6,7,58,38,20,51
Melbourne C,9041,3,14,5,10,44,34,10,47
Melbourne V,9041,4,13,5,11,45,39,6,44
Adelaide Utd,9041,5,11,6,11,37,40,-3,39
Brisbane,9041,6,10,5,13,33,42,-9,35
Western Sydn,9041,7,8,9,10,38,47,-9,33
Perth Glory,9041,8,10,2,15,37,50,-13,32
Wellington P,9041,9,5,6,16,31,55,-24,21
CC Mariners,9041,10,4,8,15,28,49,-21,20
Sydney FC,9042,1,21,4,3,66,22,44,67
N'castle Jet,9042,2,15,6,7,58,38,20,51
Melbourne C,9042,3,14,5,10,44,34,10,47
Melbourne V,9042,4,13,5,11,45,40,5,44
Adelaide Utd,9042,5,11,6,11,37,40,-3,39
Brisbane,9042,6,10,5,13,33,42,-9,35
Western Sydn,9042,7,8,9,10,38,47,-9,33
Perth Glory,9042,8,10,2,15,37,50,-13,32
Wellington P,9042,9,5,6,16,31,55,-24,21
CC Mariners,9042,10,4,8,15,28,49,-21,20
Sydney FC,9043,1,20,4,4,64,23,41,64
N'castle Jet,9043,2,15,6,7,58,38,20,51
Melbourne C,9043,3,14,5,10,44,34,10,47
Melbourne V,9043,4,14,5,10,46,38,8,47
Adelaide Utd,9043,5,11,6,11,37,40,-3,39
Brisbane,9043,6,10,5,13,33,42,-9,35
Western Sydn,9043,7,8,9,10,38,47,-9,33
Perth Glory,9043,8,10,2,15,37,50,-13,32
Wellington P,9043,9,5,6,16,31,55,-24,21
CC Mariners,9043,10,4,8,15,28,49,-21,20
Sydney FC,9044,1,21,4,3,67,22,45,67
N'castle Jet,9044,2,15,5,8,57,38,19,50
Melbourne C,9044,3,15,4,10,44,33,11,49
Melbourne V,9044,4,13,5,11,45,41,4,44
Adelaide Utd,9044,5,11,6,11,37,40,-3,39
Brisbane,9044,6,10,5,13,33,42,-9,35
Western Sydn,9044,7,8,9,10,38,47,-9,33
Perth Glory,9044,8,10,2,15,37,50,-13,32
Wellington P,9044,9,5,6,16,31,55,-24,21
CC Mariners,9044,10,4,8,15,28,49,-21,20
Sydney FC,9045,1,21,4,3,66,23,43,67
N'castle Jet,9045,2,16,5,7,60,37,23,53
Melbourne C,9045,3,14,4,11,43,36,7,46
Melbourne V,9045,4,13,5,11,46,40,6,44
Adelaide Utd,9045,5,11,6,11,37,40,-3,39
Brisbane,9045,6,10,5,13,33,42,-9,35
Western Sydn,9045,7,8,9,10,38,47,-9,33
Perth Glory,9045,8,10,2,15,37,50,-13,32
Wellington P,9045,9,5,6,16,31,55,-24,21
CC Mariners,9045,10,4,8,15,28,49,-21,20
Sydney FC,9046,1,21,4,3,67,24,43,67
N'castle Jet,9046,2,15,5,8,58,39,19,50
Melbourne C,9046,3,15,4,10,45,34,11,49
Melbourne V,9046,4,13,5,11,47,41,6,44
Adelaide Utd,9046,5,11,6,11,37,40,-3,39
Brisbane,9046,6,10,5,13,33,42,-9,35
Western Sydn,9046,7,8,9,10,38,47,-9,33
Perth Glory,9046,8,10,2,15,37,50,-13,32
Wellington P,9046,9,5,6,16,31,55,-24,21
CC Mariners,9046,10,4,8,15,28,49,-21,20
Sydney FC,9047,1,21,4,3,67,23,44,67
N'castle Jet,9047,2,15,5,8,57,38,19,50
Melbourne C,9047,3,15,4,10,44,33,11,49
Melbourne V,9047,4,13,5,11,46,41,5,44
Adelaide Utd,9047,5,11,6,11,37,40,-3,39
Brisbane,9047,6,10,5,13,33,42,-9,35
Western Sydn,9047,7,8,9,10,38,47,-9,33
Perth Glory,9047,8,10,2,15,37,50,-13,32
Wellington P,9047,9,5,6,16,31,55,-24,21
CC Mariners,9047,10,4,8,15,28,49,-21,20
Sydney FC,9048,1,21,4,3,68,23,45,67
N'castle Jet,9048,2,16,5,7,59,37,22,53
Melbourne C,9048,3,14,4,11,43,35,8,46
Melbourne V,9048,4,13,5,11,46,42,4,44
Adelaide Utd,9048,5,11,6,11,37,40,-3,39
Brisbane,9048,6,10,5,13,33,42,-9,35
Western Sydn,9048,7,8,9,10,38,47,-9,33
Perth Glory,9048,8,10,2,15,37,50,-13,32
Wellington P,9048,9,5,6,16,31,55,-24,21
CC Mariners,9048,10,4,8,15,28,49,-21,20
Sydney FC,9049,1,20,5,3,65,23,42,65
N'castle Jet,9049,2,16,5,7,60,39,21,53
Melbourne C,9049,3,14,4,11,45,36,9,46
Melbourne V,9049,4,13,6,10,46,39,7,45
Adelaide Utd,9049,5,11,6,11,37,40,-3,39
Brisbane,9049,6,10,5,13,33,42,-9,35
Western Sydn,9049,7,8,9,10,38,47,-9,33
Perth Glory,9049,8,10,2,15,37,50,-13,32
Wellington P,9049,9,5,6,16,31,55,-24,21
CC Mariners,9049,10,4,8,15,28,49,-21,20
Sydney FC,9050,1,21,4,3,68,22,46,67
N'castle Jet,9050,2,16,5,7,60,38,22,53
Melbourne C,9050,3,14,4,11,44,36,8,46
Melbourne V,9050,4,13,5,11,45,42,3,44
Adelaide Utd,9050,5,11,6,11,37,40,-3,39
Brisbane,9050,6,10,5,13,33,42,-9,35
Western Sydn,9050,7,8,9,10,38,47,-9,33
Perth Glory,9050,8,10,2,15,37,50,-13,32
Wellington P,9050,9,5,6,16,31,55,-24,21
CC Mariners,9050,10,4,8,15,28,49,-21,20
Sydney FC,9051,1,21,4,3,66,22,44,67
N'castle Jet,9051,2,15,6,7,57,37,20,51
Melbourne C,9051,3,14,5,10,43,33,10,47
Melbourne V,9051,4,13,5,11,45,40,5,44
Adelaide Utd,9051,5,11,6,11,37,40,-3,39
Brisbane,9051,6,10,5,13,33,42,-9,35
Western Sydn,9051,7,8,9,10,38,47,-9,33
Perth Glory,9051,8,10,2,15,37,50,-13,32
Wellington P,9051,9,5,6,16,31,55,-24,21
CC Mariners,9051,10,4,8,15,28,49,-21,20
Sydney FC,9052,1,20,5,3,66,24,42,65
N'castle Jet,9052,2,15,6,7,57,37,20,51
Melbourne C,9052,3,14,5,10,43,33,10,47
Melbourne V,9052,4,13,6,10,47,40,7,45
Adelaide Utd,9052,5,11,6,11,37,40,-3,39
Brisbane,9052,6,10,5,13,33,42,-9,35
Western Sydn,9052,7,8,9,10,38,47,-9,33
Perth Glory,9052,8,10,2,15,37,50,-13,32
Wellington P,9052,9,5,6,16,31,55,-24,21
CC Mariners,9052,10,4,8,15,28,49,-21,20
Sydney FC,9053,1,21,4,3,65,22,43,67
N'castle Jet,9053,2,16,5,7,60,37,23,53
Melbourne C,9053,3,14,4,11,43,36,7,46
Melbourne V,9053,4,13,5,11,45,39,6,44
Adelaide Utd,9053,5,11,6,11,37,40,-3,39
Brisbane,9053,6,10,5,13,33,42,-9,35
Western Sydn,9053,7,8,9,10,38,47,-9,33
Perth Glory,9053,8,10,2,15,37,50,-13,32
Wellington P,9053,9,5,6,16,31,55,-24,21
CC Mariners,9053,10,4,8,15,28,49,-21,20
Sydney FC,9054,1,21,4,3,65,22,43,67
N'castle Jet,9054,2,15,5,8,57,38,19,50
Melbourne C,9054,3,15,4,10,44,33,11,49
Melbourne V,9054,4,13,5,11,45,39,6,44
Adelaide Utd,9054,5,11,6,11,37,40,-3,39
Brisbane,9054,6,10,5,13,33,42,-9,35
Western Sydn,9054,7,8,9,10,38,47,-9,33
Perth Glory,9054,8,10,2,15,37,50,-13,32
Wellington P,9054,9,5,6,16,31,55,-24,21
CC Mariners,9054,10,4,8,15,28,49,-21,20
Sydney FC,9055,1,21,4,3,65,22,43,67
N'castle Jet,9055,2,15,5,8,57,39,18,50
Melbourne C,9055,3,15,4,10,45,33,12,49
Melbourne V,9055,4,13,5,11,45,39,6,44
Adelaide Utd,9055,5,11,6,11,37,40,-3,39
Brisbane,9055,6,10,5,13,33,42,-9,35
Western Sydn,9055,7,8,9,10,38,47,-9,33
Perth Glory,9055,8,10,2,15,37,50,-13,32
Wellington P,9055,9,5,6,16,31,55,-24,21
CC Mariners,9055,10,4,8,15,28,49,-21,20
Sydney FC,9056,1,21,4,3,66,22,44,67
N'castle Jet,9056,2,16,5,7,58,37,21,53
Melbourne C,9056,3,14,4,11,43,34,9,46
Melbourne V,9056,4,13,5,11,45,40,5,44
Adelaide Utd,9056,5,11,6,11,37,40,-3,39
Brisbane,9056,6,10,5,13,33,42,-9,35
Western Sydn,9056,7,8,9,10,38,47,-9,33
Perth Glory,9056,8,10,2,15,37,50,-13,32
Wellington P,9056,9,5,6,16,31,55,-24,21
CC Mariners,9056,10,4,8,15,28,49,-21,20
Sydney FC,9057,1,20,4,4,65,24,41,64
N'castle Jet,9057,2,16,5,7,60,39,21,53
Melbourne V,9057,3,14,5,10,47,39,8,47
Melbourne C,9057,4,14,4,11,45,36,9,46
Adelaide Utd,9057,5,11,6,11,37,40,-3,39
Brisbane,9057,6,10,5,13,33,42,-9,35
Western Sydn,9057,7,8,9,10,38,47,-9,33
Perth Glory,9057,8,10,2,15,37,50,-13,32
Wellington P,9057,9,5,6,16,31,55,-24,21
CC Mariners,9057,10,4,8,15,28,49,-21,20
Sydney FC,9058,1,21,4,3,69,24,45,67
N'castle Jet,9058,2,16,5,7,60,38,22,53
Melbourne C,9058,3,14,4,11,44,36,8,46
Melbourne V,9058,4,13,5,11,47,43,4,44
Adelaide Utd,9058,5,11,6,11,37,40,-3,39
Brisbane,9058,6,10,5,13,33,42,-9,35
Western Sydn,9058,7,8,9,10,38,47,-9,33
Perth Glory,9058,8,10,2,15,37,50,-13,32
Wellington P,9058,9,5,6,16,31,55,-24,21
CC Mariners,9058,10,4,8,15,28,49,-21,20
Sydney FC,9059,1,21,4,3,66,23,43,67
N'castle Jet,9059,2,15,6,7,58,38,20,51
Melbourne C,9059,3,14,5,10,44,34,10,47
Melbourne V,9059,4,13,5,11,46,40,6,44
Adelaide Utd,9059,5,11,6,11,37,40,-3,39
Brisbane,9059,6,10,5,13,33,42,-9,35
Western Sydn,9059,7,8,9,10,38,47,-9,33
Perth Glory,9059,8,10,2,15,37,50,-13,32
Wellington P,9059,9,5,6,16,31,55,-24,21
CC Mariners,9059,10,4,8,15,28,49,-21,20
Sydney FC,9060,1,21,4,3,67,24,43,67
N'castle Jet,9060,2,16,5,7,60,38,22,53
Melbourne C,9060,3,14,4,11,44,36,8,46
Melbourne V,9060,4,13,5,11,47,41,6,44
Adelaide Utd,9060,5,11,6,11,37,40,-3,39
Brisbane,9060,6,10,5,13,33,42,-9,35
Western Sydn,9060,7,8,9,10,38,47,-9,33
Perth Glory,9060,8,10,2,15,37,50,-13,32
Wellington P,9060,9,5,6,16,31,55,-24,21
CC Mariners,9060,10,4,8,15,28,49,-21,20
Sydney FC,9061,1,20,4,4,64,23,41,64
N'castle Jet,9061,2,16,5,7,58,37,21,53
Melbourne V,9061,3,14,5,10,46,38,8,47
Melbourne C,9061,4,14,4,11,43,34,9,46
Adelaide Utd,9061,5,11,6,11,37,40,-3,39
Brisbane,9061,6,10,5,13,33,42,-9,35
Western Sydn,9061,7,8,9,10,38,47,-9,33
Perth Glory,9061,8,10,2,15,37,50,-13,32
Wellington P,9061,9,5,6,16,31,55,-24,21
CC Mariners,9061,10,4,8,15,28,49,-21,20
Sydney FC,9062,1,20,4,4,65,24,41,64
N'castle Jet,9062,2,15,6,7,58,38,20,51
Melbourne C,9062,3,14,5,10,44,34,10,47
Melbourne V,9062,4,14,5,10,47,39,8,47
Adelaide Utd,9062,5,11,6,11,37,40,-3,39
Brisbane,9062,6,10,5,13,33,42,-9,35
Western Sydn,9062,7,8,9,10,38,47,-9,33
Perth Glory,9062,8,10,2,15,37,50,-13,32
Wellington P,9062,9,5,6,16,31,55,-24,21
CC Mariners,9062,10,4,8,15,28,49,-21,20
Sydney FC,9063,1,21,4,3,65,22,43,67
N'castle Jet,9063,2,15,6,7,58,38,20,51
Melbourne C,9063,3,14,5,10,44,34,10,47
Melbourne V,9063,4,13,5,11,45,39,6,44
Adelaide Utd,9063,5,11,6,11,37,40,-3,39
Brisbane,9063,6,10,5,13,33,42,-9,35
Western Sydn,9063,7,8,9,10,38,47,-9,33
Perth Glory,9063,8,10,2,15,37,50,-13,32
Wellington P,9063,9,5,6,16,31,55,-24,21
CC Mariners,9063,10,4,8,15,28,49,-21,20
Sydney FC,9064,1,20,4,4,64,27,37,64
N'castle Jet,9064,2,15,5,8,58,39,19,50
Melbourne C,9064,3,15,4,10,45,34,11,49
Melbourne V,9064,4,14,5,10,50,38,12,47
Adelaide Utd,9064,5,11,6,11,37,40,-3,39
Brisbane,9064,6,10,5,13,33,42,-9,35
Western Sydn,9064,7,8,9,10,38,47,-9,33
Perth Glory,9064,8,10,2,15,37,50,-13,32
Wellington P,9064,9,5,6,16,31,55,-24,21
CC Mariners,9064,10,4,8,15,28,49,-21,20
Sydney FC,9065,1,21,4,3,67,22,45,67
N'castle Jet,9065,2,15,5,8,57,38,19,50
Melbourne C,9065,3,15,4,10,44,33,11,49
Melbourne V,9065,4,13,5,11,45,41,4,44
Adelaide Utd,9065,5,11,6,11,37,40,-3,39
Brisbane,9065,6,10,5,13,33,42,-9,35
Western Sydn,9065,7,8,9,10,38,47,-9,33
Perth Glory,9065,8,10,2,15,37,50,-13,32
Wellington P,9065,9,5,6,16,31,55,-24,21
CC Mariners,9065,10,4,8,15,28,49,-21,20
Sydney FC,9066,1,21,4,3,66,23,43,67
N'castle Jet,9066,2,16,5,7,58,37,21,53
Melbourne C,9066,3,14,4,11,43,34,9,46
Melbourne V,9066,4,13,5,11,46,40,6,44
Adelaide Utd,9066,5,11,6,11,37,40,-3,39
Brisbane,9066,6,10,5,13,33,42,-9,35
Western Sydn,9066,7,8,9,10,38,47,-9,33
Perth Glory,9066,8,10,2,15,37,50,-13,32
Wellington P,9066,9,5,6,16,31,55,-24,21
CC Mariners,9066,10,4,8,15,28,49,-21,20
Sydney FC,9067,1,20,5,3,66,24,42,65
N'castle Jet,9067,2,16,5,7,58,37,21,53
Melbourne C,9067,3,14,4,11,43,34,9,46
Melbourne V,9067,4,13,6,10,47,40,7,45
Adelaide Utd,9067,5,11,6,11,37,40,-3,39
Brisbane,9067,6,10,5,13,33,42,-9,35
Western Sydn,9067,7,8,9,10,38,47,-9,33
Perth Glory,9067,8,10,2,15,37,50,-13,32
Wellington P,9067,9,5,6,16,31,55,-24,21
CC Mariners,9067,10,4,8,15,28,49,-21,20
Sydney FC,9068,1,20,4,4,66,26,40,64
N'castle Jet,9068,2,16,5,7,59,38,21,53
Melbourne V,9068,3,14,5,10,49,40,9,47
Melbourne C,9068,4,14,4,11,44,35,9,46
Adelaide Utd,9068,5,11,6,11,37,40,-3,39
Brisbane,9068,6,10,5,13,33,42,-9,35
Western Sydn,9068,7,8,9,10,38,47,-9,33
Perth Glory,9068,8,10,2,15,37,50,-13,32
Wellington P,9068,9,5,6,16,31,55,-24,21
CC Mariners,9068,10,4,8,15,28,49,-21,20
Sydney FC,9069,1,20,5,3,65,23,42,65
N'castle Jet,9069,2,16,5,7,59,37,22,53
Melbourne C,9069,3,14,4,11,43,35,8,46
Melbourne V,9069,4,13,6,10,46,39,7,45
Adelaide Utd,9069,5,11,6,11,37,40,-3,39
Brisbane,9069,6,10,5,13,33,42,-9,35
Western Sydn,9069,7,8,9,10,38,47,-9,33
Perth Glory,9069,8,10,2,15,37,50,-13,32
Wellington P,9069,9,5,6,16,31,55,-24,21
CC Mariners,9069,10,4,8,15,28,49,-21,20
Sydney FC,9070,1,20,5,3,64,22,42,65
N'castle Jet,9070,2,15,6,7,57,37,20,51
Melbourne C,9070,3,14,5,10,43,33,10,47
Melbourne V,9070,4,13,6,10,45,38,7,45
Adelaide Utd,9070,5,11,6,11,37,40,-3,39
Brisbane,9070,6,10,5,13,33,42,-9,35
Western Sydn,9070,7,8,9,10,38,47,-9,33
Perth Glory,9070,8,10,2,15,37,50,-13,32
Wellington P,9070,9,5,6,16,31,55,-24,21
CC Mariners,9070,10,4,8,15,28,49,-21,20
Sydney FC,9071,1,21,4,3,66,23,43,67
N'castle Jet,9071,2,16,5,7,61,39,22,53
Melbourne C,9071,3,14,4,11,45,37,8,46
Melbourne V,9071,4,13,5,11,46,40,6,44
Adelaide Utd,9071,5,11,6,11,37,40,-3,39
Brisbane,9071,6,10,5,13,33,42,-9,35
Western Sydn,9071,7,8,9,10,38,47,-9,33
Perth Glory,9071,8,10,2,15,37,50,-13,32
Wellington P,9071,9,5,6,16,31,55,-24,21
CC Mariners,9071,10,4,8,15,28,49,-21,20
Sydney FC,9072,1,21,4,3,66,22,44,67
N'castle Jet,9072,2,16,5,7,62,38,24,53
Melbourne C,9072,3,14,4,11,44,38,6,46
Melbourne V,9072,4,13,5,11,45,40,5,44
Adelaide Utd,9072,5,11,6,11,37,40,-3,39
Brisbane,9072,6,10,5,13,33,42,-9,35
Western Sydn,9072,7,8,9,10,38,47,-9,33
Perth Glory,9072,8,10,2,15,37,50,-13,32
Wellington P,9072,9,5,6,16,31,55,-24,21
CC Mariners,9072,10,4,8,15,28,49,-21,20
Sydney FC,9073,1,21,4,3,66,23,43,67
N'castle Jet,9073,2,16,5,7,60,37,23,53
Melbourne C,9073,3,14,4,11,43,36,7,46
Melbourne V,9073,4,13,5,11,46,40,6,44
Adelaide Utd,9073,5,11,6,11,37,40,-3,39
Brisbane,9073,6,10,5,13,33,42,-9,35
Western Sydn,9073,7,8,9,10,38,47,-9,33
Perth Glory,9073,8,10,2,15,37,50,-13,32
Wellington P,9073,9,5,6,16,31,55,-24,21
CC Mariners,9073,10,4,8,15,28,49,-21,20
Sydney FC,9074,1,21,4,3,65,22,43,67
N'castle Jet,9074,2,15,6,7,59,39,20,51
Melbourne C,9074,3,14,5,10,45,35,10,47
Melbourne V,9074,4,13,5,11,45,39,6,44
Adelaide Utd,9074,5,11,6,11,37,40,-3,39
Brisbane,9074,6,10,5,13,33,42,-9,35
Western Sydn,9074,7,8,9,10,38,47,-9,33
Perth Glory,9074,8,10,2,15,37,50,-13,32
Wellington P,9074,9,5,6,16,31,55,-24,21
CC Mariners,9074,10,4,8,15,28,49,-21,20
Sydney FC,9075,1,21,4,3,66,22,44,67
N'castle Jet,9075,2,16,5,7,61,38,23,53
Melbourne C,9075,3,14,4,11,44,37,7,46
Melbourne V,9075,4,13,5,11,45,40,5,44
Adelaide Utd,9075,5,11,6,11,37,40,-3,39
Brisbane,9075,6,10,5,13,33,42,-9,35
Western Sydn,9075,7,8,9,10,38,47,-9,33
Perth Glory,9075,8,10,2,15,37,50,-13,32
Wellington P,9075,9,5,6,16,31,55,-24,21
CC Mariners,9075,10,4,8,15,28,49,-21,20
Sydney FC,9076,1,20,5,3,65,23,42,65
N'castle Jet,9076,2,16,5,7,60,38,22,53
Melbourne C,9076,3,14,4,11,44,36,8,46
Melbourne V,9076,4,13,6,10,46,39,7,45
Adelaide Utd,9076,5,11,6,11,37,40,-3,39
Brisbane,9076,6,10,5,13,33,42,-9,35
Western Sydn,9076,7,8,9,10,38,47,-9,33
Perth Glory,9076,8,10,2,15,37,50,-13,32
Wellington P,9076,9,5,6,16,31,55,-24,21
CC Mariners,9076,10,4,8,15,28,49,-21,20
Sydney FC,9077,1,21,4,3,66,23,43,67
N'castle Jet,9077,2,16,5,7,60,38,22,53
Melbourne C,9077,3,14,4,11,44,36,8,46
Melbourne V,9077,4,13,5,11,46,40,6,44
Adelaide Utd,9077,5,11,6,11,37,40,-3,39
Brisbane,9077,6,10,5,13,33,42,-9,35
Western Sydn,9077,7,8,9,10,38,47,-9,33
Perth Glory,9077,8,10,2,15,37,50,-13,32
Wellington P,9077,9,5,6,16,31,55,-24,21
CC Mariners,9077,10,4,8,15,28,49,-21,20
Sydney FC,9078,1,21,4,3,65,22,43,67
N'castle Jet,9078,2,15,5,8,58,40,18,50
Melbourne C,9078,3,15,4,10,46,34,12,49
Melbourne V,9078,4,13,5,11,45,39,6,44
Adelaide Utd,9078,5,11,6,11,37,40,-3,39
Brisbane,9078,6,10,5,13,33,42,-9,35
Western Sydn,9078,7,8,9,10,38,47,-9,33
Perth Glory,9078,8,10,2,15,37,50,-13,32
Wellington P,9078,9,5,6,16,31,55,-24,21
CC Mariners,9078,10,4,8,15,28,49,-21,20
Sydney FC,9079,1,21,4,3,66,22,44,67
N'castle Jet,9079,2,16,5,7,59,37,22,53
Melbourne C,9079,3,14,4,11,43,35,8,46
Melbourne V,9079,4,13,5,11,45,40,5,44
Adelaide Utd,9079,5,11,6,11,37,40,-3,39
Brisbane,9079,6,10,5,13,33,42,-9,35
Western Sydn,9079,7,8,9,10,38,47,-9,33
Perth Glory,9079,8,10,2,15,37,50,-13,32
Wellington P,9079,9,5,6,16,31,55,-24,21
CC Mariners,9079,10,4,8,15,28,49,-21,20
Sydney FC,9080,1,21,4,3,67,22,45,67
N'castle Jet,9080,2,16,5,7,59,37,22,53
Melbourne C,9080,3,14,4,11,43,35,8,46
Melbourne V,9080,4,13,5,11,45,41,4,44
Adelaide Utd,9080,5,11,6,11,37,40,-3,39
Brisbane,9080,6,10,5,13,33,42,-9,35
Western Sydn,9080,7,8,9,10,38,47,-9,33
Perth Glory,9080,8,10,2,15,37,50,-13,32
Wellington P,9080,9,5,6,16,31,55,-24,21
CC Mariners,9080,10,4,8,15,28,49,-21,20
Sydney FC,9081,1,21,4,3,68,22,46,67
N'castle Jet,9081,2,16,5,7,59,38,21,53
Melbourne C,9081,3,14,4,11,44,35,9,46
Melbourne V,9081,4,13,5,11,45,42,3,44
Adelaide Utd,9081,5,11,6,11,37,40,-3,39
Brisbane,9081,6,10,5,13,33,42,-9,35
Western Sydn,9081,7,8,9,10,38,47,-9,33
Perth Glory,9081,8,10,2,15,37,50,-13,32
Wellington P,9081,9,5,6,16,31,55,-24,21
CC Mariners,9081,10,4,8,15,28,49,-21,20
Sydney FC,9082,1,20,4,4,65,25,40,64
N'castle Jet,9082,2,15,5,8,57,40,17,50
Melbourne C,9082,3,15,4,10,46,33,13,49
Melbourne V,9082,4,14,5,10,48,39,9,47
Adelaide Utd,9082,5,11,6,11,37,40,-3,39
Brisbane,9082,6,10,5,13,33,42,-9,35
Western Sydn,9082,7,8,9,10,38,47,-9,33
Perth Glory,9082,8,10,2,15,37,50,-13,32
Wellington P,9082,9,5,6,16,31,55,-24,21
CC Mariners,9082,10,4,8,15,28,49,-21,20
Sydney FC,9083,1,21,4,3,65,22,43,67
N'castle Jet,9083,2,16,5,7,59,38,21,53
Melbourne C,9083,3,14,4,11,44,35,9,46
Melbourne V,9083,4,13,5,11,45,39,6,44
Adelaide Utd,9083,5,11,6,11,37,40,-3,39
Brisbane,9083,6,10,5,13,33,42,-9,35
Western Sydn,9083,7,8,9,10,38,47,-9,33
Perth Glory,9083,8,10,2,15,37,50,-13,32
Wellington P,9083,9,5,6,16,31,55,-24,21
CC Mariners,9083,10,4,8,15,28,49,-21,20
Sydney FC,9084,1,21,4,3,67,22,45,67
N'castle Jet,9084,2,15,5,8,58,42,16,50
Melbourne C,9084,3,15,4,10,48,34,14,49
Melbourne V,9084,4,13,5,11,45,41,4,44
Adelaide Utd,9084,5,11,6,11,37,40,-3,39
Brisbane,9084,6,10,5,13,33,42,-9,35
Western Sydn,9084,7,8,9,10,38,47,-9,33
Perth Glory,9084,8,10,2,15,37,50,-13,32
Wellington P,9084,9,5,6,16,31,55,-24,21
CC Mariners,9084,10,4,8,15,28,49,-21,20
Sydney FC,9085,1,21,4,3,67,23,44,67
N'castle Jet,9085,2,16,5,7,58,37,21,53
Melbourne C,9085,3,14,4,11,43,34,9,46
Melbourne V,9085,4,13,5,11,46,41,5,44
Adelaide Utd,9085,5,11,6,11,37,40,-3,39
Brisbane,9085,6,10,5,13,33,42,-9,35
Western Sydn,9085,7,8,9,10,38,47,-9,33
Perth Glory,9085,8,10,2,15,37,50,-13,32
Wellington P,9085,9,5,6,16,31,55,-24,21
CC Mariners,9085,10,4,8,15,28,49,-21,20
Sydney FC,9086,1,20,5,3,64,22,42,65
N'castle Jet,9086,2,15,5,8,58,39,19,50
Melbourne C,9086,3,15,4,10,45,34,11,49
Melbourne V,9086,4,13,6,10,45,38,7,45
Adelaide Utd,9086,5,11,6,11,37,40,-3,39
Brisbane,9086,6,10,5,13,33,42,-9,35
Western Sydn,9086,7,8,9,10,38,47,-9,33
Perth Glory,9086,8,10,2,15,37,50,-13,32
Wellington P,9086,9,5,6,16,31,55,-24,21
CC Mariners,9086,10,4,8,15,28,49,-21,20
Sydney FC,9087,1,21,4,3,68,22,46,67
N'castle Jet,9087,2,15,6,7,59,39,20,51
Melbourne C,9087,3,14,5,10,45,35,10,47
Melbourne V,9087,4,13,5,11,45,42,3,44
Adelaide Utd,9087,5,11,6,11,37,40,-3,39
Brisbane,9087,6,10,5,13,33,42,-9,35
Western Sydn,9087,7,8,9,10,38,47,-9,33
Perth Glory,9087,8,10,2,15,37,50,-13,32
Wellington P,9087,9,5,6,16,31,55,-24,21
CC Mariners,9087,10,4,8,15,28,49,-21,20
Sydney FC,9088,1,20,5,3,65,23,42,65
N'castle Jet,9088,2,15,5,8,59,40,19,50
Melbourne C,9088,3,15,4,10,46,35,11,49
Melbourne V,9088,4,13,6,10,46,39,7,45
Adelaide Utd,9088,5,11,6,11,37,40,-3,39
Brisbane,9088,6,10,5,13,33,42,-9,35
Western Sydn,9088,7,8,9,10,38,47,-9,33
Perth Glory,9088,8,10,2,15,37,50,-13,32
Wellington P,9088,9,5,6,16,31,55,-24,21
CC Mariners,9088,10,4,8,15,28,49,-21,20
Sydney FC,9089,1,20,5,3,65,23,42,65
N'castle Jet,9089,2,16,5,7,61,39,22,53
Melbourne C,9089,3,14,4,11,45,37,8,46
Melbourne V,9089,4,13,6,10,46,39,7,45
Adelaide Utd,9089,5,11,6,11,37,40,-3,39
Brisbane,9089,6,10,5,13,33,42,-9,35
Western Sydn,9089,7,8,9,10,38,47,-9,33
Perth Glory,9089,8,10,2,15,37,50,-13,32
Wellington P,9089,9,5,6,16,31,55,-24,21
CC Mariners,9089,10,4,8,15,28,49,-21,20
Sydney FC,9090,1,21,4,3,67,24,43,67
N'castle Jet,9090,2,15,6,7,59,39,20,51
Melbourne C,9090,3,14,5,10,45,35,10,47
Melbourne V,9090,4,13,5,11,47,41,6,44
Adelaide Utd,9090,5,11,6,11,37,40,-3,39
Brisbane,9090,6,10,5,13,33,42,-9,35
Western Sydn,9090,7,8,9,10,38,47,-9,33
Perth Glory,9090,8,10,2,15,37,50,-13,32
Wellington P,9090,9,5,6,16,31,55,-24,21
CC Mariners,9090,10,4,8,15,28,49,-21,20
Sydney FC,9091,1,21,4,3,66,22,44,67
N'castle Jet,9091,2,16,5,7,62,38,24,53
Melbourne C,9091,3,14,4,11,44,38,6,46
Melbourne V,9091,4,13,5,11,45,40,5,44
Adelaide Utd,9091,5,11,6,11,37,40,-3,39
Brisbane,9091,6,10,5,13,33,42,-9,35
Western Sydn,9091,7,8,9,10,38,47,-9,33
Perth Glory,9091,8,10,2,15,37,50,-13,32
Wellington P,9091,9,5,6,16,31,55,-24,21
CC Mariners,9091,10,4,8,15,28,49,-21,20
Sydney FC,9092,1,20,5,3,66,24,42,65
N'castle Jet,9092,2,16,5,7,61,38,23,53
Melbourne C,9092,3,14,4,11,44,37,7,46
Melbourne V,9092,4,13,6,10,47,40,7,45
Adelaide Utd,9092,5,11,6,11,37,40,-3,39
Brisbane,9092,6,10,5,13,33,42,-9,35
Western Sydn,9092,7,8,9,10,38,47,-9,33
Perth Glory,9092,8,10,2,15,37,50,-13,32
Wellington P,9092,9,5,6,16,31,55,-24,21
CC Mariners,9092,10,4,8,15,28,49,-21,20
Sydney FC,9093,1,21,4,3,67,22,45,67
N'castle Jet,9093,2,15,6,7,57,37,20,51
Melbourne C,9093,3,14,5,10,43,33,10,47
Melbourne V,9093,4,13,5,11,45,41,4,44
Adelaide Utd,9093,5,11,6,11,37,40,-3,39
Brisbane,9093,6,10,5,13,33,42,-9,35
Western Sydn,9093,7,8,9,10,38,47,-9,33
Perth Glory,9093,8,10,2,15,37,50,-13,32
Wellington P,9093,9,5,6,16,31,55,-24,21
CC Mariners,9093,10,4,8,15,28,49,-21,20
Sydney FC,9094,1,21,4,3,67,23,44,67
N'castle Jet,9094,2,16,5,7,59,37,22,53
Melbourne C,9094,3,14,4,11,43,35,8,46
Melbourne V,9094,4,13,5,11,46,41,5,44
Adelaide Utd,9094,5,11,6,11,37,40,-3,39
Brisbane,9094,6,10,5,13,33,42,-9,35
Western Sydn,9094,7,8,9,10,38,47,-9,33
Perth Glory,9094,8,10,2,15,37,50,-13,32
Wellington P,9094,9,5,6,16,31,55,-24,21
CC Mariners,9094,10,4,8,15,28,49,-21,20
Sydney FC,9095,1,20,4,4,66,25,41,64
N'castle Jet,9095,2,16,5,7,60,37,23,53
Melbourne V,9095,3,14,5,10,48,40,8,47
Melbourne C,9095,4,14,4,11,43,36,7,46
Adelaide Utd,9095,5,11,6,11,37,40,-3,39
Brisbane,9095,6,10,5,13,33,42,-9,35
Western Sydn,9095,7,8,9,10,38,47,-9,33
Perth Glory,9095,8,10,2,15,37,50,-13,32
Wellington P,9095,9,5,6,16,31,55,-24,21
CC Mariners,9095,10,4,8,15,28,49,-21,20
Sydney FC,9096,1,20,4,4,64,23,41,64
N'castle Jet,9096,2,16,5,7,58,37,21,53
Melbourne V,9096,3,14,5,10,46,38,8,47
Melbourne C,9096,4,14,4,11,43,34,9,46
Adelaide Utd,9096,5,11,6,11,37,40,-3,39
Brisbane,9096,6,10,5,13,33,42,-9,35
Western Sydn,9096,7,8,9,10,38,47,-9,33
Perth Glory,9096,8,10,2,15,37,50,-13,32
Wellington P,9096,9,5,6,16,31,55,-24,21
CC Mariners,9096,10,4,8,15,28,49,-21,20
Sydney FC,9097,1,21,4,3,66,22,44,67
N'castle Jet,9097,2,15,6,7,57,37,20,51
Melbourne C,9097,3,14,5,10,43,33,10,47
Melbourne V,9097,4,13,5,11,45,40,5,44
Adelaide Utd,9097,5,11,6,11,37,40,-3,39
Brisbane,9097,6,10,5,13,33,42,-9,35
Western Sydn,9097,7,8,9,10,38,47,-9,33
Perth Glory,9097,8,10,2,15,37,50,-13,32
Wellington P,9097,9,5,6,16,31,55,-24,21
CC Mariners,9097,10,4,8,15,28,49,-21,20
Sydney FC,9098,1,21,4,3,67,22,45,67
N'castle Jet,9098,2,16,5,7,60,38,22,53
Melbourne C,9098,3,14,4,11,44,36,8,46
Melbourne V,9098,4,13,5,11,45,41,4,44
Adelaide Utd,9098,5,11,6,11,37,40,-3,39
Brisbane,9098,6,10,5,13,33,42,-9,35
Western Sydn,9098,7,8,9,10,38,47,-9,33
Perth Glory,9098,8,10,2,15,37,50,-13,32
Wellington P,9098,9,5,6,16,31,55,-24,21
CC Mariners,9098,10,4,8,15,28,49,-21,20
Sydney FC,9099,1,20,5,3,65,23,42,65
N'castle Jet,9099,2,15,5,8,57,39,18,50
Melbourne C,9099,3,15,4,10,45,33,12,49
Melbourne V,9099,4,13,6,10,46,39,7,45
Adelaide Utd,9099,5,11,6,11,37,40,-3,39
Brisbane,9099,6,10,5,13,33,42,-9,35
Western Sydn,9099,7,8,9,10,38,47,-9,33
Perth Glory,9099,8,10,2,15,37,50,-13,32
Wellington P,9099,9,5,6,16,31,55,-24,21
CC Mariners,9099,10,4,8,15,28,49,-21,20
Sydney FC,9100,1,20,5,3,64,22,42,65
N'castle Jet,9100,2,16,5,7,61,39,22,53
Melbourne C,9100,3,14,4,11,45,37,8,46
Melbourne V,9100,4,13,6,10,45,38,7,45
Adelaide Utd,9100,5,11,6,11,37,40,-3,39
Brisbane,9100,6,10,5,13,33,42,-9,35
Western Sydn,9100,7,8,9,10,38,47,-9,33
Perth Glory,9100,8,10,2,15,37,50,-13,32
Wellington P,9100,9,5,6,16,31,55,-24,21
CC Mariners,9100,10,4,8,15,28,49,-21,20
Sydney FC,9101,1,21,4,3,66,22,44,67
N'castle Jet,9101,2,15,5,8,57,40,17,50
Melbourne C,9101,3,15,4,10,46,33,13,49
Melbourne V,9101,4,13,5,11,45,40,5,44
Adelaide Utd,9101,5,11,6,11,37,40,-3,39
Brisbane,9101,6,10,5,13,33,42,-9,35
Western Sydn,9101,7,8,9,10,38,47,-9,33
Perth Glory,9101,8,10,2,15,37,50,-13,32
Wellington P,9101,9,5,6,16,31,55,-24,21
CC Mariners,9101,10,4,8,15,28,49,-21,20
Sydney FC,9102,1,21,4,3,68,23,45,67
N'castle Jet,9102,2,16,5,7,60,37,23,53
Melbourne C,9102,3,14,4,11,43,36,7,46
Melbourne V,9102,4,13,5,11,46,42,4,44
Adelaide Utd,9102,5,11,6,11,37,40,-3,39
Brisbane,9102,6,10,5,13,33,42,-9,35
Western Sydn,9102,7,8,9,10,38,47,-9,33
Perth Glory,9102,8,10,2,15,37,50,-13,32
Wellington P,9102,9,5,6,16,31,55,-24,21
CC Mariners,9102,10,4,8,15,28,49,-21,20
Sydney FC,9103,1,21,4,3,65,22,43,67
N'castle Jet,9103,2,15,5,8,59,40,19,50
Melbourne C,9103,3,15,4,10,46,35,11,49
Melbourne V,9103,4,13,5,11,45,39,6,44
Adelaide Utd,9103,5,11,6,11,37,40,-3,39
Brisbane,9103,6,10,5,13,33,42,-9,35
Western Sydn,9103,7,8,9,10,38,47,-9,33
Perth Glory,9103,8,10,2,15,37,50,-13,32
Wellington P,9103,9,5,6,16,31,55,-24,21
CC Mariners,9103,10,4,8,15,28,49,-21,20
Sydney FC,9104,1,20,5,3,64,22,42,65
N'castle Jet,9104,2,15,6,7,58,38,20,51
Melbourne C,9104,3,14,5,10,44,34,10,47
Melbourne V,9104,4,13,6,10,45,38,7,45
Adelaide Utd,9104,5,11,6,11,37,40,-3,39
Brisbane,9104,6,10,5,13,33,42,-9,35
Western Sydn,9104,7,8,9,10,38,47,-9,33
Perth Glory,9104,8,10,2,15,37,50,-13,32
Wellington P,9104,9,5,6,16,31,55,-24,21
CC Mariners,9104,10,4,8,15,28,49,-21,20
Sydney FC,9105,1,21,4,3,68,24,44,67
N'castle Jet,9105,2,16,5,7,61,40,21,53
Melbourne C,9105,3,14,4,11,46,37,9,46
Melbourne V,9105,4,13,5,11,47,42,5,44
Adelaide Utd,9105,5,11,6,11,37,40,-3,39
Brisbane,9105,6,10,5,13,33,42,-9,35
Western Sydn,9105,7,8,9,10,38,47,-9,33
Perth Glory,9105,8,10,2,15,37,50,-13,32
Wellington P,9105,9,5,6,16,31,55,-24,21
CC Mariners,9105,10,4,8,15,28,49,-21,20
Sydney FC,9106,1,21,4,3,65,22,43,67
N'castle Jet,9106,2,15,5,8,60,41,19,50
Melbourne C,9106,3,15,4,10,47,36,11,49
Melbourne V,9106,4,13,5,11,45,39,6,44
Adelaide Utd,9106,5,11,6,11,37,40,-3,39
Brisbane,9106,6,10,5,13,33,42,-9,35
Western Sydn,9106,7,8,9,10,38,47,-9,33
Perth Glory,9106,8,10,2,15,37,50,-13,32
Wellington P,9106,9,5,6,16,31,55,-24,21
CC Mariners,9106,10,4,8,15,28,49,-21,20
Sydney FC,9107,1,21,4,3,68,23,45,67
N'castle Jet,9107,2,15,5,8,57,39,18,50
Melbourne C,9107,3,15,4,10,45,33,12,49
Melbourne V,9107,4,13,5,11,46,42,4,44
Adelaide Utd,9107,5,11,6,11,37,40,-3,39
Brisbane,9107,6,10,5,13,33,42,-9,35
Western Sydn,9107,7,8,9,10,38,47,-9,33
Perth Glory,9107,8,10,2,15,37,50,-13,32
Wellington P,9107,9,5,6,16,31,55,-24,21
CC Mariners,9107,10,4,8,15,28,49,-21,20
Sydney FC,9108,1,21,4,3,68,24,44,67
N'castle Jet,9108,2,15,5,8,57,38,19,50
Melbourne C,9108,3,15,4,10,44,33,11,49
Melbourne V,9108,4,13,5,11,47,42,5,44
Adelaide Utd,9108,5,11,6,11,37,40,-3,39
Brisbane,9108,6,10,5,13,33,42,-9,35
Western Sydn,9108,7,8,9,10,38,47,-9,33
Perth Glory,9108,8,10,2,15,37,50,-13,32
Wellington P,9108,9,5,6,16,31,55,-24,21
CC Mariners,9108,10,4,8,15,28,49,-21,20
Sydney FC,9109,1,20,5,3,65,23,42,65
N'castle Jet,9109,2,15,6,7,60,40,20,51
Melbourne C,9109,3,14,5,10,46,36,10,47
Melbourne V,9109,4,13,6,10,46,39,7,45
Adelaide Utd,9109,5,11,6,11,37,40,-3,39
Brisbane,9109,6,10,5,13,33,42,-9,35
Western Sydn,9109,7,8,9,10,38,47,-9,33
Perth Glory,9109,8,10,2,15,37,50,-13,32
Wellington P,9109,9,5,6,16,31,55,-24,21
CC Mariners,9109,10,4,8,15,28,49,-21,20
Sydney FC,9110,1,20,5,3,64,22,42,65
N'castle Jet,9110,2,15,6,7,58,38,20,51
Melbourne C,9110,3,14,5,10,44,34,10,47
Melbourne V,9110,4,13,6,10,45,38,7,45
Adelaide Utd,9110,5,11,6,11,37,40,-3,39
Brisbane,9110,6,10,5,13,33,42,-9,35
Western Sydn,9110,7,8,9,10,38,47,-9,33
Perth Glory,9110,8,10,2,15,37,50,-13,32
Wellington P,9110,9,5,6,16,31,55,-24,21
CC Mariners,9110,10,4,8,15,28,49,-21,20
Sydney FC,9111,1,20,4,4,65,26,39,64
N'castle Jet,9111,2,15,6,7,61,41,20,51
Melbourne V,9111,3,14,5,10,49,39,10,47
Melbourne C,9111,4,14,5,10,47,37,10,47
Adelaide Utd,9111,5,11,6,11,37,40,-3,39
Brisbane,9111,6,10,5,13,33,42,-9,35
Western Sydn,9111,7,8,9,10,38,47,-9,33
Perth Glory,9111,8,10,2,15,37,50,-13,32
Wellington P,9111,9,5,6,16,31,55,-24,21
CC Mariners,9111,10,4,8,15,28,49,-21,20
Sydney FC,9112,1,21,4,3,67,22,45,67
N'castle Jet,9112,2,16,5,7,59,38,21,53
Melbourne C,9112,3,14,4,11,44,35,9,46
Melbourne V,9112,4,13,5,11,45,41,4,44
Adelaide Utd,9112,5,11,6,11,37,40,-3,39
Brisbane,9112,6,10,5,13,33,42,-9,35
Western Sydn,9112,7,8,9,10,38,47,-9,33
Perth Glory,9112,8,10,2,15,37,50,-13,32
Wellington P,9112,9,5,6,16,31,55,-24,21
CC Mariners,9112,10,4,8,15,28,49,-21,20
Sydney FC,9113,1,20,5,3,64,22,42,65
N'castle Jet,9113,2,15,6,7,58,38,20,51
Melbourne C,9113,3,14,5,10,44,34,10,47
Melbourne V,9113,4,13,6,10,45,38,7,45
Adelaide Utd,9113,5,11,6,11,37,40,-3,39
Brisbane,9113,6,10,5,13,33,42,-9,35
Western Sydn,9113,7,8,9,10,38,47,-9,33
Perth Glory,9113,8,10,2,15,37,50,-13,32
Wellington P,9113,9,5,6,16,31,55,-24,21
CC Mariners,9113,10,4,8,15,28,49,-21,20
Sydney FC,9114,1,21,4,3,67,24,43,67
N'castle Jet,9114,2,15,6,7,58,38,20,51
Melbourne C,9114,3,14,5,10,44,34,10,47
Melbourne V,9114,4,13,5,11,47,41,6,44
Adelaide Utd,9114,5,11,6,11,37,40,-3,39
Brisbane,9114,6,10,5,13,33,42,-9,35
Western Sydn,9114,7,8,9,10,38,47,-9,33
Perth Glory,9114,8,10,2,15,37,50,-13,32
Wellington P,9114,9,5,6,16,31,55,-24,21
CC Mariners,9114,10,4,8,15,28,49,-21,20
Sydney FC,9115,1,21,4,3,66,23,43,67
N'castle Jet,9115,2,16,5,7,59,38,21,53
Melbourne C,9115,3,14,4,11,44,35,9,46
Melbourne V,9115,4,13,5,11,46,40,6,44
Adelaide Utd,9115,5,11,6,11,37,40,-3,39
Brisbane,9115,6,10,5,13,33,42,-9,35
Western Sydn,9115,7,8,9,10,38,47,-9,33
Perth Glory,9115,8,10,2,15,37,50,-13,32
Wellington P,9115,9,5,6,16,31,55,-24,21
CC Mariners,9115,10,4,8,15,28,49,-21,20
Sydney FC,9116,1,21,4,3,66,23,43,67
N'castle Jet,9116,2,15,5,8,57,38,19,50
Melbourne C,9116,3,15,4,10,44,33,11,49
Melbourne V,9116,4,13,5,11,46,40,6,44
Adelaide Utd,9116,5,11,6,11,37,40,-3,39
Brisbane,9116,6,10,5,13,33,42,-9,35
Western Sydn,9116,7,8,9,10,38,47,-9,33
Perth Glory,9116,8,10,2,15,37,50,-13,32
Wellington P,9116,9,5,6,16,31,55,-24,21
CC Mariners,9116,10,4,8,15,28,49,-21,20
Sydney FC,9117,1,21,4,3,68,22,46,67
N'castle Jet,9117,2,15,6,7,58,38,20,51
Melbourne C,9117,3,14,5,10,44,34,10,47
Melbourne V,9117,4,13,5,11,45,42,3,44
Adelaide Utd,9117,5,11,6,11,37,40,-3,39
Brisbane,9117,6,10,5,13,33,42,-9,35
Western Sydn,9117,7,8,9,10,38,47,-9,33
Perth Glory,9117,8,10,2,15,37,50,-13,32
Wellington P,9117,9,5,6,16,31,55,-24,21
CC Mariners,9117,10,4,8,15,28,49,-21,20
Sydney FC,9118,1,20,4,4,64,24,40,64
N'castle Jet,9118,2,16,5,7,59,37,22,53
Melbourne V,9118,3,14,5,10,47,38,9,47
Melbourne C,9118,4,14,4,11,43,35,8,46
Adelaide Utd,9118,5,11,6,11,37,40,-3,39
Brisbane,9118,6,10,5,13,33,42,-9,35
Western Sydn,9118,7,8,9,10,38,47,-9,33
Perth Glory,9118,8,10,2,15,37,50,-13,32
Wellington P,9118,9,5,6,16,31,55,-24,21
CC Mariners,9118,10,4,8,15,28,49,-21,20
Sydney FC,9119,1,20,4,4,64,24,40,64
N'castle Jet,9119,2,15,6,7,57,37,20,51
Melbourne C,9119,3,14,5,10,43,33,10,47
Melbourne V,9119,4,14,5,10,47,38,9,47
Adelaide Utd,9119,5,11,6,11,37,40,-3,39
Brisbane,9119,6,10,5,13,33,42,-9,35
Western Sydn,9119,7,8,9,10,38,47,-9,33
Perth Glory,9119,8,10,2,15,37,50,-13,32
Wellington P,9119,9,5,6,16,31,55,-24,21
CC Mariners,9119,10,4,8,15,28,49,-21,20
Sydney FC,9120,1,20,5,3,65,23,42,65
N'castle Jet,9120,2,15,6,7,59,39,20,51
Melbourne C,9120,3,14,5,10,45,35,10,47
Melbourne V,9120,4,13,6,10,46,39,7,45
Adelaide Utd,9120,5,11,6,11,37,40,-3,39
Brisbane,9120,6,10,5,13,33,42,-9,35
Western Sydn,9120,7,8,9,10,38,47,-9,33
Perth Glory,9120,8,10,2,15,37,50,-13,32
Wellington P,9120,9,5,6,16,31,55,-24,21
CC Mariners,9120,10,4,8,15,28,49,-21,20
Sydney FC,9121,1,21,4,3,69,22,47,67
N'castle Jet,9121,2,16,5,7,60,38,22,53
Melbourne C,9121,3,14,4,11,44,36,8,46
Melbourne V,9121,4,13,5,11,45,43,2,44
Adelaide Utd,9121,5,11,6,11,37,40,-3,39
Brisbane,9121,6,10,5,13,33,42,-9,35
Western Sydn,9121,7,8,9,10,38,47,-9,33
Perth Glory,9121,8,10,2,15,37,50,-13,32
Wellington P,9121,9,5,6,16,31,55,-24,21
CC Mariners,9121,10,4,8,15,28,49,-21,20
Sydney FC,9122,1,20,5,3,64,22,42,65
N'castle Jet,9122,2,16,5,7,59,37,22,53
Melbourne C,9122,3,14,4,11,43,35,8,46
Melbourne V,9122,4,13,6,10,45,38,7,45
Adelaide Utd,9122,5,11,6,11,37,40,-3,39
Brisbane,9122,6,10,5,13,33,42,-9,35
Western Sydn,9122,7,8,9,10,38,47,-9,33
Perth Glory,9122,8,10,2,15,37,50,-13,32
Wellington P,9122,9,5,6,16,31,55,-24,21
CC Mariners,9122,10,4,8,15,28,49,-21,20
Sydney FC,9123,1,21,4,3,69,22,47,67
N'castle Jet,9123,2,16,5,7,58,37,21,53
Melbourne C,9123,3,14,4,11,43,34,9,46
Melbourne V,9123,4,13,5,11,45,43,2,44
Adelaide Utd,9123,5,11,6,11,37,40,-3,39
Brisbane,9123,6,10,5,13,33,42,-9,35
Western Sydn,9123,7,8,9,10,38,47,-9,33
Perth Glory,9123,8,10,2,15,37,50,-13,32
Wellington P,9123,9,5,6,16,31,55,-24,21
CC Mariners,9123,10,4,8,15,28,49,-21,20
Sydney FC,9124,1,21,4,3,67,23,44,67
N'castle Jet,9124,2,16,5,7,60,39,21,53
Melbourne C,9124,3,14,4,11,45,36,9,46
Melbourne V,9124,4,13,5,11,46,41,5,44
Adelaide Utd,9124,5,11,6,11,37,40,-3,39
Brisbane,9124,6,10,5,13,33,42,-9,35
Western Sydn,9124,7,8,9,10,38,47,-9,33
Perth Glory,9124,8,10,2,15,37,50,-13,32
Wellington P,9124,9,5,6,16,31,55,-24,21
CC Mariners,9124,10,4,8,15,28,49,-21,20
Sydney FC,9125,1,21,4,3,66,22,44,67
N'castle Jet,9125,2,15,5,8,58,40,18,50
Melbourne C,9125,3,15,4,10,46,34,12,49
Melbourne V,9125,4,13,5,11,45,40,5,44
Adelaide Utd,9125,5,11,6,11,37,40,-3,39
Brisbane,9125,6,10,5,13,33,42,-9,35
Western Sydn,9125,7,8,9,10,38,47,-9,33
Perth Glory,9125,8,10,2,15,37,50,-13,32
Wellington P,9125,9,5,6,16,31,55,-24,21
CC Mariners,9125,10,4,8,15,28,49,-21,20
Sydney FC,9126,1,20,5,3,64,22,42,65
N'castle Jet,9126,2,15,6,7,58,38,20,51
Melbourne C,9126,3,14,5,10,44,34,10,47
Melbourne V,9126,4,13,6,10,45,38,7,45
Adelaide Utd,9126,5,11,6,11,37,40,-3,39
Brisbane,9126,6,10,5,13,33,42,-9,35
Western Sydn,9126,7,8,9,10,38,47,-9,33
Perth Glory,9126,8,10,2,15,37,50,-13,32
Wellington P,9126,9,5,6,16,31,55,-24,21
CC Mariners,9126,10,4,8,15,28,49,-21,20
Sydney FC,9127,1,20,4,4,66,25,41,64
N'castle Jet,9127,2,15,5,8,59,40,19,50
Melbourne C,9127,3,15,4,10,46,35,11,49
Melbourne V,9127,4,14,5,10,48,40,8,47
Adelaide Utd,9127,5,11,6,11,37,40,-3,39
Brisbane,9127,6,10,5,13,33,42,-9,35
Western Sydn,9127,7,8,9,10,38,47,-9,33
Perth Glory,9127,8,10,2,15,37,50,-13,32
Wellington P,9127,9,5,6,16,31,55,-24,21
CC Mariners,9127,10,4,8,15,28,49,-21,20
Sydney FC,9128,1,21,4,3,66,22,44,67
N'castle Jet,9128,2,16,5,7,61,37,24,53
Melbourne C,9128,3,14,4,11,43,37,6,46
Melbourne V,9128,4,13,5,11,45,40,5,44
Adelaide Utd,9128,5,11,6,11,37,40,-3,39
Brisbane,9128,6,10,5,13,33,42,-9,35
Western Sydn,9128,7,8,9,10,38,47,-9,33
Perth Glory,9128,8,10,2,15,37,50,-13,32
Wellington P,9128,9,5,6,16,31,55,-24,21
CC Mariners,9128,10,4,8,15,28,49,-21,20
Sydney FC,9129,1,21,4,3,66,22,44,67
N'castle Jet,9129,2,15,5,8,58,41,17,50
Melbourne C,9129,3,15,4,10,47,34,13,49
Melbourne V,9129,4,13,5,11,45,40,5,44
Adelaide Utd,9129,5,11,6,11,37,40,-3,39
Brisbane,9129,6,10,5,13,33,42,-9,35
Western Sydn,9129,7,8,9,10,38,47,-9,33
Perth Glory,9129,8,10,2,15,37,50,-13,32
Wellington P,9129,9,5,6,16,31,55,-24,21
CC Mariners,9129,10,4,8,15,28,49,-21,20
Sydney FC,9130,1,20,5,3,66,24,42,65
N'castle Jet,9130,2,16,5,7,62,37,25,53
Melbourne C,9130,3,14,4,11,43,38,5,46
Melbourne V,9130,4,13,6,10,47,40,7,45
Adelaide Utd,9130,5,11,6,11,37,40,-3,39
Brisbane,9130,6,10,5,13,33,42,-9,35
Western Sydn,9130,7,8,9,10,38,47,-9,33
Perth Glory,9130,8,10,2,15,37,50,-13,32
Wellington P,9130,9,5,6,16,31,55,-24,21
CC Mariners,9130,10,4,8,15,28,49,-21,20
Sydney FC,9131,1,20,4,4,64,23,41,64
N'castle Jet,9131,2,15,5,8,57,38,19,50
Melbourne C,9131,3,15,4,10,44,33,11,49
Melbourne V,9131,4,14,5,10,46,38,8,47
Adelaide Utd,9131,5,11,6,11,37,40,-3,39
Brisbane,9131,6,10,5,13,33,42,-9,35
Western Sydn,9131,7,8,9,10,38,47,-9,33
Perth Glory,9131,8,10,2,15,37,50,-13,32
Wellington P,9131,9,5,6,16,31,55,-24,21
CC Mariners,9131,10,4,8,15,28,49,-21,20
Sydney FC,9132,1,21,4,3,65,22,43,67
N'castle Jet,9132,2,16,5,7,58,37,21,53
Melbourne C,9132,3,14,4,11,43,34,9,46
Melbourne V,9132,4,13,5,11,45,39,6,44
Adelaide Utd,9132,5,11,6,11,37,40,-3,39
Brisbane,9132,6,10,5,13,33,42,-9,35
Western Sydn,9132,7,8,9,10,38,47,-9,33
Perth Glory,9132,8,10,2,15,37,50,-13,32
Wellington P,9132,9,5,6,16,31,55,-24,21
CC Mariners,9132,10,4,8,15,28,49,-21,20
Sydney FC,9133,1,21,4,3,66,23,43,67
N'castle Jet,9133,2,16,5,7,59,38,21,53
Melbourne C,9133,3,14,4,11,44,35,9,46
Melbourne V,9133,4,13,5,11,46,40,6,44
Adelaide Utd,9133,5,11,6,11,37,40,-3,39
Brisbane,9133,6,10,5,13,33,42,-9,35
Western Sydn,9133,7,8,9,10,38,47,-9,33
Perth Glory,9133,8,10,2,15,37,50,-13,32
Wellington P,9133,9,5,6,16,31,55,-24,21
CC Mariners,9133,10,4,8,15,28,49,-21,20
Sydney FC,9134,1,21,4,3,66,22,44,67
N'castle Jet,9134,2,16,5,7,59,37,22,53
Melbourne C,9134,3,14,4,11,43,35,8,46
Melbourne V,9134,4,13,5,11,45,40,5,44
Adelaide Utd,9134,5,11,6,11,37,40,-3,39
Brisbane,9134,6,10,5,13,33,42,-9,35
Western Sydn,9134,7,8,9,10,38,47,-9,33
Perth Glory,9134,8,10,2,15,37,50,-13,32
Wellington P,9134,9,5,6,16,31,55,-24,21
CC Mariners,9134,10,4,8,15,28,49,-21,20
Sydney FC,9135,1,20,4,4,64,25,39,64
N'castle Jet,9135,2,16,5,7,59,38,21,53
Melbourne V,9135,3,14,5,10,48,38,10,47
Melbourne C,9135,4,14,4,11,44,35,9,46
Adelaide Utd,9135,5,11,6,11,37,40,-3,39
Brisbane,9135,6,10,5,13,33,42,-9,35
Western Sydn,9135,7,8,9,10,38,47,-9,33
Perth Glory,9135,8,10,2,15,37,50,-13,32
Wellington P,9135,9,5,6,16,31,55,-24,21
CC Mariners,9135,10,4,8,15,28,49,-21,20
Sydney FC,9136,1,21,4,3,66,22,44,67
N'castle Jet,9136,2,16,5,7,58,37,21,53
Melbourne C,9136,3,14,4,11,43,34,9,46
Melbourne V,9136,4,13,5,11,45,40,5,44
Adelaide Utd,9136,5,11,6,11,37,40,-3,39
Brisbane,9136,6,10,5,13,33,42,-9,35
Western Sydn,9136,7,8,9,10,38,47,-9,33
Perth Glory,9136,8,10,2,15,37,50,-13,32
Wellington P,9136,9,5,6,16,31,55,-24,21
CC Mariners,9136,10,4,8,15,28,49,-21,20
Sydney FC,9137,1,21,4,3,66,23,43,67
N'castle Jet,9137,2,15,5,8,59,42,17,50
Melbourne C,9137,3,15,4,10,48,35,13,49
Melbourne V,9137,4,13,5,11,46,40,6,44
Adelaide Utd,9137,5,11,6,11,37,40,-3,39
Brisbane,9137,6,10,5,13,33,42,-9,35
Western Sydn,9137,7,8,9,10,38,47,-9,33
Perth Glory,9137,8,10,2,15,37,50,-13,32
Wellington P,9137,9,5,6,16,31,55,-24,21
CC Mariners,9137,10,4,8,15,28,49,-21,20
Sydney FC,9138,1,20,4,4,65,25,40,64
N'castle Jet,9138,2,16,5,7,60,38,22,53
Melbourne V,9138,3,14,5,10,48,39,9,47
Melbourne C,9138,4,14,4,11,44,36,8,46
Adelaide Utd,9138,5,11,6,11,37,40,-3,39
Brisbane,9138,6,10,5,13,33,42,-9,35
Western Sydn,9138,7,8,9,10,38,47,-9,33
Perth Glory,9138,8,10,2,15,37,50,-13,32
Wellington P,9138,9,5,6,16,31,55,-24,21
CC Mariners,9138,10,4,8,15,28,49,-21,20
Sydney FC,9139,1,20,5,3,65,23,42,65
N'castle Jet,9139,2,15,5,8,58,39,19,50
Melbourne C,9139,3,15,4,10,45,34,11,49
Melbourne V,9139,4,13,6,10,46,39,7,45
Adelaide Utd,9139,5,11,6,11,37,40,-3,39
Brisbane,9139,6,10,5,13,33,42,-9,35
Western Sydn,9139,7,8,9,10,38,47,-9,33
Perth Glory,9139,8,10,2,15,37,50,-13,32
Wellington P,9139,9,5,6,16,31,55,-24,21
CC Mariners,9139,10,4,8,15,28,49,-21,20
Sydney FC,9140,1,21,4,3,67,24,43,67
N'castle Jet,9140,2,15,6,7,58,38,20,51
Melbourne C,9140,3,14,5,10,44,34,10,47
Melbourne V,9140,4,13,5,11,47,41,6,44
Adelaide Utd,9140,5,11,6,11,37,40,-3,39
Brisbane,9140,6,10,5,13,33,42,-9,35
Western Sydn,9140,7,8,9,10,38,47,-9,33
Perth Glory,9140,8,10,2,15,37,50,-13,32
Wellington P,9140,9,5,6,16,31,55,-24,21
CC Mariners,9140,10,4,8,15,28,49,-21,20
Sydney FC,9141,1,21,4,3,71,22,49,67
N'castle Jet,9141,2,16,5,7,61,38,23,53
Melbourne C,9141,3,14,4,11,44,37,7,46
Melbourne V,9141,4,13,5,11,45,45,0,44
Adelaide Utd,9141,5,11,6,11,37,40,-3,39
Brisbane,9141,6,10,5,13,33,42,-9,35
Western Sydn,9141,7,8,9,10,38,47,-9,33
Perth Glory,9141,8,10,2,15,37,50,-13,32
Wellington P,9141,9,5,6,16,31,55,-24,21
CC Mariners,9141,10,4,8,15,28,49,-21,20
Sydney FC,9142,1,20,5,3,66,24,42,65
N'castle Jet,9142,2,16,5,7,59,37,22,53
Melbourne C,9142,3,14,4,11,43,35,8,46
Melbourne V,9142,4,13,6,10,47,40,7,45
Adelaide Utd,9142,5,11,6,11,37,40,-3,39
Brisbane,9142,6,10,5,13,33,42,-9,35
Western Sydn,9142,7,8,9,10,38,47,-9,33
Perth Glory,9142,8,10,2,15,37,50,-13,32
Wellington P,9142,9,5,6,16,31,55,-24,21
CC Mariners,9142,10,4,8,15,28,49,-21,20
Sydney FC,9143,1,21,4,3,67,24,43,67
N'castle Jet,9143,2,16,5,7,61,38,23,53
Melbourne C,9143,3,14,4,11,44,37,7,46
Melbourne V,9143,4,13,5,11,47,41,6,44
Adelaide Utd,9143,5,11,6,11,37,40,-3,39
Brisbane,9143,6,10,5,13,33,42,-9,35
Western Sydn,9143,7,8,9,10,38,47,-9,33
Perth Glory,9143,8,10,2,15,37,50,-13,32
Wellington P,9143,9,5,6,16,31,55,-24,21
CC Mariners,9143,10,4,8,15,28,49,-21,20
Sydney FC,9144,1,21,4,3,66,22,44,67
N'castle Jet,9144,2,16,5,7,62,39,23,53
Melbourne C,9144,3,14,4,11,45,38,7,46
Melbourne V,9144,4,13,5,11,45,40,5,44
Adelaide Utd,9144,5,11,6,11,37,40,-3,39
Brisbane,9144,6,10,5,13,33,42,-9,35
Western Sydn,9144,7,8,9,10,38,47,-9,33
Perth Glory,9144,8,10,2,15,37,50,-13,32
Wellington P,9144,9,5,6,16,31,55,-24,21
CC Mariners,9144,10,4,8,15,28,49,-21,20
Sydney FC,9145,1,21,4,3,65,22,43,67
N'castle Jet,9145,2,15,6,7,61,41,20,51
Melbourne C,9145,3,14,5,10,47,37,10,47
Melbourne V,9145,4,13,5,11,45,39,6,44
Adelaide Utd,9145,5,11,6,11,37,40,-3,39
Brisbane,9145,6,10,5,13,33,42,-9,35
Western Sydn,9145,7,8,9,10,38,47,-9,33
Perth Glory,9145,8,10,2,15,37,50,-13,32
Wellington P,9145,9,5,6,16,31,55,-24,21
CC Mariners,9145,10,4,8,15,28,49,-21,20
Sydney FC,9146,1,21,4,3,68,23,45,67
N'castle Jet,9146,2,16,5,7,58,37,21,53
Melbourne C,9146,3,14,4,11,43,34,9,46
Melbourne V,9146,4,13,5,11,46,42,4,44
Adelaide Utd,9146,5,11,6,11,37,40,-3,39
Brisbane,9146,6,10,5,13,33,42,-9,35
Western Sydn,9146,7,8,9,10,38,47,-9,33
Perth Glory,9146,8,10,2,15,37,50,-13,32
Wellington P,9146,9,5,6,16,31,55,-24,21
CC Mariners,9146,10,4,8,15,28,49,-21,20
Sydney FC,9147,1,20,4,4,64,24,40,64
N'castle Jet,9147,2,16,5,7,60,38,22,53
Melbourne V,9147,3,14,5,10,47,38,9,47
Melbourne C,9147,4,14,4,11,44,36,8,46
Adelaide Utd,9147,5,11,6,11,37,40,-3,39
Brisbane,9147,6,10,5,13,33,42,-9,35
Western Sydn,9147,7,8,9,10,38,47,-9,33
Perth Glory,9147,8,10,2,15,37,50,-13,32
Wellington P,9147,9,5,6,16,31,55,-24,21
CC Mariners,9147,10,4,8,15,28,49,-21,20
Sydney FC,9148,1,21,4,3,65,22,43,67
N'castle Jet,9148,2,15,5,8,58,39,19,50
Melbourne C,9148,3,15,4,10,45,34,11,49
Melbourne V,9148,4,13,5,11,45,39,6,44
Adelaide Utd,9148,5,11,6,11,37,40,-3,39
Brisbane,9148,6,10,5,13,33,42,-9,35
Western Sydn,9148,7,8,9,10,38,47,-9,33
Perth Glory,9148,8,10,2,15,37,50,-13,32
Wellington P,9148,9,5,6,16,31,55,-24,21
CC Mariners,9148,10,4,8,15,28,49,-21,20
Sydney FC,9149,1,20,4,4,64,24,40,64
N'castle Jet,9149,2,15,6,7,58,38,20,51
Melbourne C,9149,3,14,5,10,44,34,10,47
Melbourne V,9149,4,14,5,10,47,38,9,47
Adelaide Utd,9149,5,11,6,11,37,40,-3,39
Brisbane,9149,6,10,5,13,33,42,-9,35
Western Sydn,9149,7,8,9,10,38,47,-9,33
Perth Glory,9149,8,10,2,15,37,50,-13,32
Wellington P,9149,9,5,6,16,31,55,-24,21
CC Mariners,9149,10,4,8,15,28,49,-21,20
Sydney FC,9150,1,20,4,4,65,24,41,64
N'castle Jet,9150,2,16,5,7,59,38,21,53
Melbourne V,9150,3,14,5,10,47,39,8,47
Melbourne C,9150,4,14,4,11,44,35,9,46
Adelaide Utd,9150,5,11,6,11,37,40,-3,39
Brisbane,9150,6,10,5,13,33,42,-9,35
Western Sydn,9150,7,8,9,10,38,47,-9,33
Perth Glory,9150,8,10,2,15,37,50,-13,32
Wellington P,9150,9,5,6,16,31,55,-24,21
CC Mariners,9150,10,4,8,15,28,49,-21,20
Sydney FC,9151,1,21,4,3,66,23,43,67
N'castle Jet,9151,2,16,5,7,59,38,21,53
Melbourne C,9151,3,14,4,11,44,35,9,46
Melbourne V,9151,4,13,5,11,46,40,6,44
Adelaide Utd,9151,5,11,6,11,37,40,-3,39
Brisbane,9151,6,10,5,13,33,42,-9,35
Western Sydn,9151,7,8,9,10,38,47,-9,33
Perth Glory,9151,8,10,2,15,37,50,-13,32
Wellington P,9151,9,5,6,16,31,55,-24,21
CC Mariners,9151,10,4,8,15,28,49,-21,20
Sydney FC,9152,1,21,4,3,67,23,44,67
N'castle Jet,9152,2,15,5,8,58,40,18,50
Melbourne C,9152,3,15,4,10,46,34,12,49
Melbourne V,9152,4,13,5,11,46,41,5,44
Adelaide Utd,9152,5,11,6,11,37,40,-3,39
Brisbane,9152,6,10,5,13,33,42,-9,35
Western Sydn,9152,7,8,9,10,38,47,-9,33
Perth Glory,9152,8,10,2,15,37,50,-13,32
Wellington P,9152,9,5,6,16,31,55,-24,21
CC Mariners,9152,10,4,8,15,28,49,-21,20
Sydney FC,9153,1,21,4,3,68,23,45,67
N'castle Jet,9153,2,16,5,7,59,38,21,53
Melbourne C,9153,3,14,4,11,44,35,9,46
Melbourne V,9153,4,13,5,11,46,42,4,44
Adelaide Utd,9153,5,11,6,11,37,40,-3,39
Brisbane,9153,6,10,5,13,33,42,-9,35
Western Sydn,9153,7,8,9,10,38,47,-9,33
Perth Glory,9153,8,10,2,15,37,50,-13,32
Wellington P,9153,9,5,6,16,31,55,-24,21
CC Mariners,9153,10,4,8,15,28,49,-21,20
Sydney FC,9154,1,20,5,3,64,22,42,65
N'castle Jet,9154,2,16,5,7,60,37,23,53
Melbourne C,9154,3,14,4,11,43,36,7,46
Melbourne V,9154,4,13,6,10,45,38,7,45
Adelaide Utd,9154,5,11,6,11,37,40,-3,39
Brisbane,9154,6,10,5,13,33,42,-9,35
Western Sydn,9154,7,8,9,10,38,47,-9,33
Perth Glory,9154,8,10,2,15,37,50,-13,32
Wellington P,9154,9,5,6,16,31,55,-24,21
CC Mariners,9154,10,4,8,15,28,49,-21,20
Sydney FC,9155,1,20,4,4,65,25,40,64
N'castle Jet,9155,2,16,5,7,60,38,22,53
Melbourne V,9155,3,14,5,10,48,39,9,47
Melbourne C,9155,4,14,4,11,44,36,8,46
Adelaide Utd,9155,5,11,6,11,37,40,-3,39
Brisbane,9155,6,10,5,13,33,42,-9,35
Western Sydn,9155,7,8,9,10,38,47,-9,33
Perth Glory,9155,8,10,2,15,37,50,-13,32
Wellington P,9155,9,5,6,16,31,55,-24,21
CC Mariners,9155,10,4,8,15,28,49,-21,20
Sydney FC,9156,1,20,5,3,66,24,42,65
N'castle Jet,9156,2,15,6,7,57,37,20,51
Melbourne C,9156,3,14,5,10,43,33,10,47
Melbourne V,9156,4,13,6,10,47,40,7,45
Adelaide Utd,9156,5,11,6,11,37,40,-3,39
Brisbane,9156,6,10,5,13,33,42,-9,35
Western Sydn,9156,7,8,9,10,38,47,-9,33
Perth Glory,9156,8,10,2,15,37,50,-13,32
Wellington P,9156,9,5,6,16,31,55,-24,21
CC Mariners,9156,10,4,8,15,28,49,-21,20
Sydney FC,9157,1,21,4,3,67,22,45,67
N'castle Jet,9157,2,15,5,8,58,39,19,50
Melbourne C,9157,3,15,4,10,45,34,11,49
Melbourne V,9157,4,13,5,11,45,41,4,44
Adelaide Utd,9157,5,11,6,11,37,40,-3,39
Brisbane,9157,6,10,5,13,33,42,-9,35
Western Sydn,9157,7,8,9,10,38,47,-9,33
Perth Glory,9157,8,10,2,15,37,50,-13,32
Wellington P,9157,9,5,6,16,31,55,-24,21
CC Mariners,9157,10,4,8,15,28,49,-21,20
Sydney FC,9158,1,20,5,3,66,24,42,65
N'castle Jet,9158,2,15,6,7,57,37,20,51
Melbourne C,9158,3,14,5,10,43,33,10,47
Melbourne V,9158,4,13,6,10,47,40,7,45
Adelaide Utd,9158,5,11,6,11,37,40,-3,39
Brisbane,9158,6,10,5,13,33,42,-9,35
Western Sydn,9158,7,8,9,10,38,47,-9,33
Perth Glory,9158,8,10,2,15,37,50,-13,32
Wellington P,9158,9,5,6,16,31,55,-24,21
CC Mariners,9158,10,4,8,15,28,49,-21,20
Sydney FC,9159,1,21,4,3,66,22,44,67
N'castle Jet,9159,2,16,5,7,61,37,24,53
Melbourne C,9159,3,14,4,11,43,37,6,46
Melbourne V,9159,4,13,5,11,45,40,5,44
Adelaide Utd,9159,5,11,6,11,37,40,-3,39
Brisbane,9159,6,10,5,13,33,42,-9,35
Western Sydn,9159,7,8,9,10,38,47,-9,33
Perth Glory,9159,8,10,2,15,37,50,-13,32
Wellington P,9159,9,5,6,16,31,55,-24,21
CC Mariners,9159,10,4,8,15,28,49,-21,20
Sydney FC,9160,1,20,4,4,64,24,40,64
N'castle Jet,9160,2,16,5,7,60,37,23,53
Melbourne V,9160,3,14,5,10,47,38,9,47
Melbourne C,9160,4,14,4,11,43,36,7,46
Adelaide Utd,9160,5,11,6,11,37,40,-3,39
Brisbane,9160,6,10,5,13,33,42,-9,35
Western Sydn,9160,7,8,9,10,38,47,-9,33
Perth Glory,9160,8,10,2,15,37,50,-13,32
Wellington P,9160,9,5,6,16,31,55,-24,21
CC Mariners,9160,10,4,8,15,28,49,-21,20
Sydney FC,9161,1,20,4,4,64,23,41,64
N'castle Jet,9161,2,15,6,7,58,38,20,51
Melbourne C,9161,3,14,5,10,44,34,10,47
Melbourne V,9161,4,14,5,10,46,38,8,47
Adelaide Utd,9161,5,11,6,11,37,40,-3,39
Brisbane,9161,6,10,5,13,33,42,-9,35
Western Sydn,9161,7,8,9,10,38,47,-9,33
Perth Glory,9161,8,10,2,15,37,50,-13,32
Wellington P,9161,9,5,6,16,31,55,-24,21
CC Mariners,9161,10,4,8,15,28,49,-21,20
Sydney FC,9162,1,21,4,3,68,22,46,67
N'castle Jet,9162,2,15,6,7,58,38,20,51
Melbourne C,9162,3,14,5,10,44,34,10,47
Melbourne V,9162,4,13,5,11,45,42,3,44
Adelaide Utd,9162,5,11,6,11,37,40,-3,39
Brisbane,9162,6,10,5,13,33,42,-9,35
Western Sydn,9162,7,8,9,10,38,47,-9,33
Perth Glory,9162,8,10,2,15,37,50,-13,32
Wellington P,9162,9,5,6,16,31,55,-24,21
CC Mariners,9162,10,4,8,15,28,49,-21,20
Sydney FC,9163,1,21,4,3,69,22,47,67
N'castle Jet,9163,2,15,5,8,58,40,18,50
Melbourne C,9163,3,15,4,10,46,34,12,49
Melbourne V,9163,4,13,5,11,45,43,2,44
Adelaide Utd,9163,5,11,6,11,37,40,-3,39
Brisbane,9163,6,10,5,13,33,42,-9,35
Western Sydn,9163,7,8,9,10,38,47,-9,33
Perth Glory,9163,8,10,2,15,37,50,-13,32
Wellington P,9163,9,5,6,16,31,55,-24,21
CC Mariners,9163,10,4,8,15,28,49,-21,20
Sydney FC,9164,1,20,4,4,65,24,41,64
N'castle Jet,9164,2,15,6,7,58,38,20,51
Melbourne C,9164,3,14,5,10,44,34,10,47
Melbourne V,9164,4,14,5,10,47,39,8,47
Adelaide Utd,9164,5,11,6,11,37,40,-3,39
Brisbane,9164,6,10,5,13,33,42,-9,35
Western Sydn,9164,7,8,9,10,38,47,-9,33
Perth Glory,9164,8,10,2,15,37,50,-13,32
Wellington P,9164,9,5,6,16,31,55,-24,21
CC Mariners,9164,10,4,8,15,28,49,-21,20
Sydney FC,9165,1,21,4,3,68,23,45,67
N'castle Jet,9165,2,16,5,7,60,38,22,53
Melbourne C,9165,3,14,4,11,44,36,8,46
Melbourne V,9165,4,13,5,11,46,42,4,44
Adelaide Utd,9165,5,11,6,11,37,40,-3,39
Brisbane,9165,6,10,5,13,33,42,-9,35
Western Sydn,9165,7,8,9,10,38,47,-9,33
Perth Glory,9165,8,10,2,15,37,50,-13,32
Wellington P,9165,9,5,6,16,31,55,-24,21
CC Mariners,9165,10,4,8,15,28,49,-21,20
Sydney FC,9166,1,20,5,3,66,24,42,65
N'castle Jet,9166,2,16,5,7,59,37,22,53
Melbourne C,9166,3,14,4,11,43,35,8,46
Melbourne V,9166,4,13,6,10,47,40,7,45
Adelaide Utd,9166,5,11,6,11,37,40,-3,39
Brisbane,9166,6,10,5,13,33,42,-9,35
Western Sydn,9166,7,8,9,10,38,47,-9,33
Perth Glory,9166,8,10,2,15,37,50,-13,32
Wellington P,9166,9,5,6,16,31,55,-24,21
CC Mariners,9166,10,4,8,15,28,49,-21,20
Sydney FC,9167,1,21,4,3,65,22,43,67
N'castle Jet,9167,2,16,5,7,60,39,21,53
Melbourne C,9167,3,14,4,11,45,36,9,46
Melbourne V,9167,4,13,5,11,45,39,6,44
Adelaide Utd,9167,5,11,6,11,37,40,-3,39
Brisbane,9167,6,10,5,13,33,42,-9,35
Western Sydn,9167,7,8,9,10,38,47,-9,33
Perth Glory,9167,8,10,2,15,37,50,-13,32
Wellington P,9167,9,5,6,16,31,55,-24,21
CC Mariners,9167,10,4,8,15,28,49,-21,20
Sydney FC,9168,1,21,4,3,66,22,44,67
N'castle Jet,9168,2,16,5,7,61,37,24,53
Melbourne C,9168,3,14,4,11,43,37,6,46
Melbourne V,9168,4,13,5,11,45,40,5,44
Adelaide Utd,9168,5,11,6,11,37,40,-3,39
Brisbane,9168,6,10,5,13,33,42,-9,35
Western Sydn,9168,7,8,9,10,38,47,-9,33
Perth Glory,9168,8,10,2,15,37,50,-13,32
Wellington P,9168,9,5,6,16,31,55,-24,21
CC Mariners,9168,10,4,8,15,28,49,-21,20
Sydney FC,9169,1,21,4,3,68,23,45,67
N'castle Jet,9169,2,15,5,8,58,39,19,50
Melbourne C,9169,3,15,4,10,45,34,11,49
Melbourne V,9169,4,13,5,11,46,42,4,44
Adelaide Utd,9169,5,11,6,11,37,40,-3,39
Brisbane,9169,6,10,5,13,33,42,-9,35
Western Sydn,9169,7,8,9,10,38,47,-9,33
Perth Glory,9169,8,10,2,15,37,50,-13,32
Wellington P,9169,9,5,6,16,31,55,-24,21
CC Mariners,9169,10,4,8,15,28,49,-21,20
Sydney FC,9170,1,20,5,3,65,23,42,65
N'castle Jet,9170,2,16,5,7,60,37,23,53
Melbourne C,9170,3,14,4,11,43,36,7,46
Melbourne V,9170,4,13,6,10,46,39,7,45
Adelaide Utd,9170,5,11,6,11,37,40,-3,39
Brisbane,9170,6,10,5,13,33,42,-9,35
Western Sydn,9170,7,8,9,10,38,47,-9,33
Perth Glory,9170,8,10,2,15,37,50,-13,32
Wellington P,9170,9,5,6,16,31,55,-24,21
CC Mariners,9170,10,4,8,15,28,49,-21,20
Sydney FC,9171,1,20,5,3,65,23,42,65
N'castle Jet,9171,2,16,5,7,59,37,22,53
Melbourne C,9171,3,14,4,11,43,35,8,46
Melbourne V,9171,4,13,6,10,46,39,7,45
Adelaide Utd,9171,5,11,6,11,37,40,-3,39
Brisbane,9171,6,10,5,13,33,42,-9,35
Western Sydn,9171,7,8,9,10,38,47,-9,33
Perth Glory,9171,8,10,2,15,37,50,-13,32
Wellington P,9171,9,5,6,16,31,55,-24,21
CC Mariners,9171,10,4,8,15,28,49,-21,20
Sydney FC,9172,1,21,4,3,65,22,43,67
N'castle Jet,9172,2,15,6,7,58,38,20,51
Melbourne C,9172,3,14,5,10,44,34,10,47
Melbourne V,9172,4,13,5,11,45,39,6,44
Adelaide Utd,9172,5,11,6,11,37,40,-3,39
Brisbane,9172,6,10,5,13,33,42,-9,35
Western Sydn,9172,7,8,9,10,38,47,-9,33
Perth Glory,9172,8,10,2,15,37,50,-13,32
Wellington P,9172,9,5,6,16,31,55,-24,21
CC Mariners,9172,10,4,8,15,28,49,-21,20
Sydney FC,9173,1,21,4,3,66,23,43,67
N'castle Jet,9173,2,15,5,8,58,40,18,50
Melbourne C,9173,3,15,4,10,46,34,12,49
Melbourne V,9173,4,13,5,11,46,40,6,44
Adelaide Utd,9173,5,11,6,11,37,40,-3,39
Brisbane,9173,6,10,5,13,33,42,-9,35
Western Sydn,9173,7,8,9,10,38,47,-9,33
Perth Glory,9173,8,10,2,15,37,50,-13,32
Wellington P,9173,9,5,6,16,31,55,-24,21
CC Mariners,9173,10,4,8,15,28,49,-21,20
Sydney FC,9174,1,21,4,3,67,23,44,67
N'castle Jet,9174,2,16,5,7,59,37,22,53
Melbourne C,9174,3,14,4,11,43,35,8,46
Melbourne V,9174,4,13,5,11,46,41,5,44
Adelaide Utd,9174,5,11,6,11,37,40,-3,39
Brisbane,9174,6,10,5,13,33,42,-9,35
Western Sydn,9174,7,8,9,10,38,47,-9,33
Perth Glory,9174,8,10,2,15,37,50,-13,32
Wellington P,9174,9,5,6,16,31,55,-24,21
CC Mariners,9174,10,4,8,15,28,49,-21,20
Sydney FC,9175,1,20,5,3,66,24,42,65
N'castle Jet,9175,2,16,5,7,61,37,24,53
Melbourne C,9175,3,14,4,11,43,37,6,46
Melbourne V,9175,4,13,6,10,47,40,7,45
Adelaide Utd,9175,5,11,6,11,37,40,-3,39
Brisbane,9175,6,10,5,13,33,42,-9,35
Western Sydn,9175,7,8,9,10,38,47,-9,33
Perth Glory,9175,8,10,2,15,37,50,-13,32
Wellington P,9175,9,5,6,16,31,55,-24,21
CC Mariners,9175,10,4,8,15,28,49,-21,20
Sydney FC,9176,1,20,5,3,65,23,42,65
N'castle Jet,9176,2,16,5,7,60,37,23,53
Melbourne C,9176,3,14,4,11,43,36,7,46
Melbourne V,9176,4,13,6,10,46,39,7,45
Adelaide Utd,9176,5,11,6,11,37,40,-3,39
Brisbane,9176,6,10,5,13,33,42,-9,35
Western Sydn,9176,7,8,9,10,38,47,-9,33
Perth Glory,9176,8,10,2,15,37,50,-13,32
Wellington P,9176,9,5,6,16,31,55,-24,21
CC Mariners,9176,10,4,8,15,28,49,-21,20
Sydney FC,9177,1,20,5,3,64,22,42,65
N'castle Jet,9177,2,16,5,7,60,38,22,53
Melbourne C,9177,3,14,4,11,44,36,8,46
Melbourne V,9177,4,13,6,10,45,38,7,45
Adelaide Utd,9177,5,11,6,11,37,40,-3,39
Brisbane,9177,6,10,5,13,33,42,-9,35
Western Sydn,9177,7,8,9,10,38,47,-9,33
Perth Glory,9177,8,10,2,15,37,50,-13,32
Wellington P,9177,9,5,6,16,31,55,-24,21
CC Mariners,9177,10,4,8,15,28,49,-21,20
Sydney FC,9178,1,20,4,4,66,25,41,64
N'castle Jet,9178,2,15,5,8,58,39,19,50
Melbourne C,9178,3,15,4,10,45,34,11,49
Melbourne V,9178,4,14,5,10,48,40,8,47
Adelaide Utd,9178,5,11,6,11,37,40,-3,39
Brisbane,9178,6,10,5,13,33,42,-9,35
Western Sydn,9178,7,8,9,10,38,47,-9,33
Perth Glory,9178,8,10,2,15,37,50,-13,32
Wellington P,9178,9,5,6,16,31,55,-24,21
CC Mariners,9178,10,4,8,15,28,49,-21,20
Sydney FC,9179,1,20,5,3,66,24,42,65
N'castle Jet,9179,2,16,5,7,58,37,21,53
Melbourne C,9179,3,14,4,11,43,34,9,46
Melbourne V,9179,4,13,6,10,47,40,7,45
Adelaide Utd,9179,5,11,6,11,37,40,-3,39
Brisbane,9179,6,10,5,13,33,42,-9,35
Western Sydn,9179,7,8,9,10,38,47,-9,33
Perth Glory,9179,8,10,2,15,37,50,-13,32
Wellington P,9179,9,5,6,16,31,55,-24,21
CC Mariners,9179,10,4,8,15,28,49,-21,20
Sydney FC,9180,1,21,4,3,65,22,43,67
N'castle Jet,9180,2,16,5,7,60,38,22,53
Melbourne C,9180,3,14,4,11,44,36,8,46
Melbourne V,9180,4,13,5,11,45,39,6,44
Adelaide Utd,9180,5,11,6,11,37,40,-3,39
Brisbane,9180,6,10,5,13,33,42,-9,35
Western Sydn,9180,7,8,9,10,38,47,-9,33
Perth Glory,9180,8,10,2,15,37,50,-13,32
Wellington P,9180,9,5,6,16,31,55,-24,21
CC Mariners,9180,10,4,8,15,28,49,-21,20
Sydney FC,9181,1,21,4,3,65,22,43,67
N'castle Jet,9181,2,15,6,7,59,39,20,51
Melbourne C,9181,3,14,5,10,45,35,10,47
Melbourne V,9181,4,13,5,11,45,39,6,44
Adelaide Utd,9181,5,11,6,11,37,40,-3,39
Brisbane,9181,6,10,5,13,33,42,-9,35
Western Sydn,9181,7,8,9,10,38,47,-9,33
Perth Glory,9181,8,10,2,15,37,50,-13,32
Wellington P,9181,9,5,6,16,31,55,-24,21
CC Mariners,9181,10,4,8,15,28,49,-21,20
Sydney FC,9182,1,21,4,3,66,23,43,67
N'castle Jet,9182,2,15,5,8,58,39,19,50
Melbourne C,9182,3,15,4,10,45,34,11,49
Melbourne V,9182,4,13,5,11,46,40,6,44
Adelaide Utd,9182,5,11,6,11,37,40,-3,39
Brisbane,9182,6,10,5,13,33,42,-9,35
Western Sydn,9182,7,8,9,10,38,47,-9,33
Perth Glory,9182,8,10,2,15,37,50,-13,32
Wellington P,9182,9,5,6,16,31,55,-24,21
CC Mariners,9182,10,4,8,15,28,49,-21,20
Sydney FC,9183,1,21,4,3,66,22,44,67
N'castle Jet,9183,2,16,5,7,61,39,22,53
Melbourne C,9183,3,14,4,11,45,37,8,46
Melbourne V,9183,4,13,5,11,45,40,5,44
Adelaide Utd,9183,5,11,6,11,37,40,-3,39
Brisbane,9183,6,10,5,13,33,42,-9,35
Western Sydn,9183,7,8,9,10,38,47,-9,33
Perth Glory,9183,8,10,2,15,37,50,-13,32
Wellington P,9183,9,5,6,16,31,55,-24,21
CC Mariners,9183,10,4,8,15,28,49,-21,20
Sydney FC,9184,1,21,4,3,69,23,46,67
N'castle Jet,9184,2,16,5,7,59,37,22,53
Melbourne C,9184,3,14,4,11,43,35,8,46
Melbourne V,9184,4,13,5,11,46,43,3,44
Adelaide Utd,9184,5,11,6,11,37,40,-3,39
Brisbane,9184,6,10,5,13,33,42,-9,35
Western Sydn,9184,7,8,9,10,38,47,-9,33
Perth Glory,9184,8,10,2,15,37,50,-13,32
Wellington P,9184,9,5,6,16,31,55,-24,21
CC Mariners,9184,10,4,8,15,28,49,-21,20
Sydney FC,9185,1,21,4,3,67,24,43,67
N'castle Jet,9185,2,15,6,7,57,37,20,51
Melbourne C,9185,3,14,5,10,43,33,10,47
Melbourne V,9185,4,13,5,11,47,41,6,44
Adelaide Utd,9185,5,11,6,11,37,40,-3,39
Brisbane,9185,6,10,5,13,33,42,-9,35
Western Sydn,9185,7,8,9,10,38,47,-9,33
Perth Glory,9185,8,10,2,15,37,50,-13,32
Wellington P,9185,9,5,6,16,31,55,-24,21
CC Mariners,9185,10,4,8,15,28,49,-21,20
Sydney FC,9186,1,20,5,3,65,23,42,65
N'castle Jet,9186,2,15,6,7,58,38,20,51
Melbourne C,9186,3,14,5,10,44,34,10,47
Melbourne V,9186,4,13,6,10,46,39,7,45
Adelaide Utd,9186,5,11,6,11,37,40,-3,39
Brisbane,9186,6,10,5,13,33,42,-9,35
Western Sydn,9186,7,8,9,10,38,47,-9,33
Perth Glory,9186,8,10,2,15,37,50,-13,32
Wellington P,9186,9,5,6,16,31,55,-24,21
CC Mariners,9186,10,4,8,15,28,49,-21,20
Sydney FC,9187,1,20,4,4,65,24,41,64
N'castle Jet,9187,2,15,5,8,57,40,17,50
Melbourne C,9187,3,15,4,10,46,33,13,49
Melbourne V,9187,4,14,5,10,47,39,8,47
Adelaide Utd,9187,5,11,6,11,37,40,-3,39
Brisbane,9187,6,10,5,13,33,42,-9,35
Western Sydn,9187,7,8,9,10,38,47,-9,33
Perth Glory,9187,8,10,2,15,37,50,-13,32
Wellington P,9187,9,5,6,16,31,55,-24,21
CC Mariners,9187,10,4,8,15,28,49,-21,20
Sydney FC,9188,1,21,4,3,68,24,44,67
N'castle Jet,9188,2,15,6,7,60,40,20,51
Melbourne C,9188,3,14,5,10,46,36,10,47
Melbourne V,9188,4,13,5,11,47,42,5,44
Adelaide Utd,9188,5,11,6,11,37,40,-3,39
Brisbane,9188,6,10,5,13,33,42,-9,35
Western Sydn,9188,7,8,9,10,38,47,-9,33
Perth Glory,9188,8,10,2,15,37,50,-13,32
Wellington P,9188,9,5,6,16,31,55,-24,21
CC Mariners,9188,10,4,8,15,28,49,-21,20
Sydney FC,9189,1,21,4,3,68,24,44,67
N'castle Jet,9189,2,15,6,7,57,37,20,51
Melbourne C,9189,3,14,5,10,43,33,10,47
Melbourne V,9189,4,13,5,11,47,42,5,44
Adelaide Utd,9189,5,11,6,11,37,40,-3,39
Brisbane,9189,6,10,5,13,33,42,-9,35
Western Sydn,9189,7,8,9,10,38,47,-9,33
Perth Glory,9189,8,10,2,15,37,50,-13,32
Wellington P,9189,9,5,6,16,31,55,-24,21
CC Mariners,9189,10,4,8,15,28,49,-21,20
Sydney FC,9190,1,21,4,3,67,23,44,67
N'castle Jet,9190,2,15,5,8,58,40,18,50
Melbourne C,9190,3,15,4,10,46,34,12,49
Melbourne V,9190,4,13,5,11,46,41,5,44
Adelaide Utd,9190,5,11,6,11,37,40,-3,39
Brisbane,9190,6,10,5,13,33,42,-9,35
Western Sydn,9190,7,8,9,10,38,47,-9,33
Perth Glory,9190,8,10,2,15,37,50,-13,32
Wellington P,9190,9,5,6,16,31,55,-24,21
CC Mariners,9190,10,4,8,15,28,49,-21,20
Sydney FC,9191,1,21,4,3,67,23,44,67
N'castle Jet,9191,2,15,5,8,59,40,19,50
Melbourne C,9191,3,15,4,10,46,35,11,49
Melbourne V,9191,4,13,5,11,46,41,5,44
Adelaide Utd,9191,5,11,6,11,37,40,-3,39
Brisbane,9191,6,10,5,13,33,42,-9,35
Western Sydn,9191,7,8,9,10,38,47,-9,33
Perth Glory,9191,8,10,2,15,37,50,-13,32
Wellington P,9191,9,5,6,16,31,55,-24,21
CC Mariners,9191,10,4,8,15,28,49,-21,20
Sydney FC,9192,1,20,5,3,65,23,42,65
N'castle Jet,9192,2,15,6,7,58,38,20,51
Melbourne C,9192,3,14,5,10,44,34,10,47
Melbourne V,9192,4,13,6,10,46,39,7,45
Adelaide Utd,9192,5,11,6,11,37,40,-3,39
Brisbane,9192,6,10,5,13,33,42,-9,35
Western Sydn,9192,7,8,9,10,38,47,-9,33
Perth Glory,9192,8,10,2,15,37,50,-13,32
Wellington P,9192,9,5,6,16,31,55,-24,21
CC Mariners,9192,10,4,8,15,28,49,-21,20
Sydney FC,9193,1,21,4,3,65,22,43,67
N'castle Jet,9193,2,16,5,7,59,38,21,53
Melbourne C,9193,3,14,4,11,44,35,9,46
Melbourne V,9193,4,13,5,11,45,39,6,44
Adelaide Utd,9193,5,11,6,11,37,40,-3,39
Brisbane,9193,6,10,5,13,33,42,-9,35
Western Sydn,9193,7,8,9,10,38,47,-9,33
Perth Glory,9193,8,10,2,15,37,50,-13,32
Wellington P,9193,9,5,6,16,31,55,-24,21
CC Mariners,9193,10,4,8,15,28,49,-21,20
Sydney FC,9194,1,21,4,3,66,22,44,67
N'castle Jet,9194,2,15,5,8,58,40,18,50
Melbourne C,9194,3,15,4,10,46,34,12,49
Melbourne V,9194,4,13,5,11,45,40,5,44
Adelaide Utd,9194,5,11,6,11,37,40,-3,39
Brisbane,9194,6,10,5,13,33,42,-9,35
Western Sydn,9194,7,8,9,10,38,47,-9,33
Perth Glory,9194,8,10,2,15,37,50,-13,32
Wellington P,9194,9,5,6,16,31,55,-24,21
CC Mariners,9194,10,4,8,15,28,49,-21,20
Sydney FC,9195,1,21,4,3,67,22,45,67
N'castle Jet,9195,2,16,5,7,60,38,22,53
Melbourne C,9195,3,14,4,11,44,36,8,46
Melbourne V,9195,4,13,5,11,45,41,4,44
Adelaide Utd,9195,5,11,6,11,37,40,-3,39
Brisbane,9195,6,10,5,13,33,42,-9,35
Western Sydn,9195,7,8,9,10,38,47,-9,33
Perth Glory,9195,8,10,2,15,37,50,-13,32
Wellington P,9195,9,5,6,16,31,55,-24,21
CC Mariners,9195,10,4,8,15,28,49,-21,20
Sydney FC,9196,1,20,4,4,64,23,41,64
N'castle Jet,9196,2,16,5,7,61,37,24,53
Melbourne V,9196,3,14,5,10,46,38,8,47
Melbourne C,9196,4,14,4,11,43,37,6,46
Adelaide Utd,9196,5,11,6,11,37,40,-3,39
Brisbane,9196,6,10,5,13,33,42,-9,35
Western Sydn,9196,7,8,9,10,38,47,-9,33
Perth Glory,9196,8,10,2,15,37,50,-13,32
Wellington P,9196,9,5,6,16,31,55,-24,21
CC Mariners,9196,10,4,8,15,28,49,-21,20
Sydney FC,9197,1,20,4,4,65,25,40,64
N'castle Jet,9197,2,15,6,7,59,39,20,51
Melbourne C,9197,3,14,5,10,45,35,10,47
Melbourne V,9197,4,14,5,10,48,39,9,47
Adelaide Utd,9197,5,11,6,11,37,40,-3,39
Brisbane,9197,6,10,5,13,33,42,-9,35
Western Sydn,9197,7,8,9,10,38,47,-9,33
Perth Glory,9197,8,10,2,15,37,50,-13,32
Wellington P,9197,9,5,6,16,31,55,-24,21
CC Mariners,9197,10,4,8,15,28,49,-21,20
Sydney FC,9198,1,20,4,4,66,25,41,64
N'castle Jet,9198,2,16,5,7,60,38,22,53
Melbourne V,9198,3,14,5,10,48,40,8,47
Melbourne C,9198,4,14,4,11,44,36,8,46
Adelaide Utd,9198,5,11,6,11,37,40,-3,39
Brisbane,9198,6,10,5,13,33,42,-9,35
Western Sydn,9198,7,8,9,10,38,47,-9,33
Perth Glory,9198,8,10,2,15,37,50,-13,32
Wellington P,9198,9,5,6,16,31,55,-24,21
CC Mariners,9198,10,4,8,15,28,49,-21,20
Sydney FC,9199,1,20,5,3,65,23,42,65
N'castle Jet,9199,2,16,5,7,61,38,23,53
Melbourne C,9199,3,14,4,11,44,37,7,46
Melbourne V,9199,4,13,6,10,46,39,7,45
Adelaide Utd,9199,5,11,6,11,37,40,-3,39
Brisbane,9199,6,10,5,13,33,42,-9,35
Western Sydn,9199,7,8,9,10,38,47,-9,33
Perth Glory,9199,8,10,2,15,37,50,-13,32
Wellington P,9199,9,5,6,16,31,55,-24,21
CC Mariners,9199,10,4,8,15,28,49,-21,20
Sydney FC,9200,1,21,4,3,66,22,44,67
N'castle Jet,9200,2,15,5,8,57,38,19,50
Melbourne C,9200,3,15,4,10,44,33,11,49
Melbourne V,9200,4,13,5,11,45,40,5,44
Adelaide Utd,9200,5,11,6,11,37,40,-3,39
Brisbane,9200,6,10,5,13,33,42,-9,35
Western Sydn,9200,7,8,9,10,38,47,-9,33
Perth Glory,9200,8,10,2,15,37,50,-13,32
Wellington P,9200,9,5,6,16,31,55,-24,21
CC Mariners,9200,10,4,8,15,28,49,-21,20
Sydney FC,9201,1,21,4,3,65,22,43,67
N'castle Jet,9201,2,16,5,7,60,38,22,53
Melbourne C,9201,3,14,4,11,44,36,8,46
Melbourne V,9201,4,13,5,11,45,39,6,44
Adelaide Utd,9201,5,11,6,11,37,40,-3,39
Brisbane,9201,6,10,5,13,33,42,-9,35
Western Sydn,9201,7,8,9,10,38,47,-9,33
Perth Glory,9201,8,10,2,15,37,50,-13,32
Wellington P,9201,9,5,6,16,31,55,-24,21
CC Mariners,9201,10,4,8,15,28,49,-21,20
Sydney FC,9202,1,21,4,3,65,22,43,67
N'castle Jet,9202,2,16,5,7,59,37,22,53
Melbourne C,9202,3,14,4,11,43,35,8,46
Melbourne V,9202,4,13,5,11,45,39,6,44
Adelaide Utd,9202,5,11,6,11,37,40,-3,39
Brisbane,9202,6,10,5,13,33,42,-9,35
Western Sydn,9202,7,8,9,10,38,47,-9,33
Perth Glory,9202,8,10,2,15,37,50,-13,32
Wellington P,9202,9,5,6,16,31,55,-24,21
CC Mariners,9202,10,4,8,15,28,49,-21,20
Sydney FC,9203,1,20,5,3,65,23,42,65
N'castle Jet,9203,2,15,5,8,57,38,19,50
Melbourne C,9203,3,15,4,10,44,33,11,49
Melbourne V,9203,4,13,6,10,46,39,7,45
Adelaide Utd,9203,5,11,6,11,37,40,-3,39
Brisbane,9203,6,10,5,13,33,42,-9,35
Western Sydn,9203,7,8,9,10,38,47,-9,33
Perth Glory,9203,8,10,2,15,37,50,-13,32
Wellington P,9203,9,5,6,16,31,55,-24,21
CC Mariners,9203,10,4,8,15,28,49,-21,20
Sydney FC,9204,1,20,5,3,65,23,42,65
N'castle Jet,9204,2,15,5,8,57,38,19,50
Melbourne C,9204,3,15,4,10,44,33,11,49
Melbourne V,9204,4,13,6,10,46,39,7,45
Adelaide Utd,9204,5,11,6,11,37,40,-3,39
Brisbane,9204,6,10,5,13,33,42,-9,35
Western Sydn,9204,7,8,9,10,38,47,-9,33
Perth Glory,9204,8,10,2,15,37,50,-13,32
Wellington P,9204,9,5,6,16,31,55,-24,21
CC Mariners,9204,10,4,8,15,28,49,-21,20
Sydney FC,9205,1,20,5,3,64,22,42,65
N'castle Jet,9205,2,15,5,8,58,39,19,50
Melbourne C,9205,3,15,4,10,45,34,11,49
Melbourne V,9205,4,13,6,10,45,38,7,45
Adelaide Utd,9205,5,11,6,11,37,40,-3,39
Brisbane,9205,6,10,5,13,33,42,-9,35
Western Sydn,9205,7,8,9,10,38,47,-9,33
Perth Glory,9205,8,10,2,15,37,50,-13,32
Wellington P,9205,9,5,6,16,31,55,-24,21
CC Mariners,9205,10,4,8,15,28,49,-21,20
Sydney FC,9206,1,21,4,3,66,23,43,67
N'castle Jet,9206,2,16,5,7,60,39,21,53
Melbourne C,9206,3,14,4,11,45,36,9,46
Melbourne V,9206,4,13,5,11,46,40,6,44
Adelaide Utd,9206,5,11,6,11,37,40,-3,39
Brisbane,9206,6,10,5,13,33,42,-9,35
Western Sydn,9206,7,8,9,10,38,47,-9,33
Perth Glory,9206,8,10,2,15,37,50,-13,32
Wellington P,9206,9,5,6,16,31,55,-24,21
CC Mariners,9206,10,4,8,15,28,49,-21,20
Sydney FC,9207,1,21,4,3,66,22,44,67
N'castle Jet,9207,2,16,5,7,59,37,22,53
Melbourne C,9207,3,14,4,11,43,35,8,46
Melbourne V,9207,4,13,5,11,45,40,5,44
Adelaide Utd,9207,5,11,6,11,37,40,-3,39
Brisbane,9207,6,10,5,13,33,42,-9,35
Western Sydn,9207,7,8,9,10,38,47,-9,33
Perth Glory,9207,8,10,2,15,37,50,-13,32
Wellington P,9207,9,5,6,16,31,55,-24,21
CC Mariners,9207,10,4,8,15,28,49,-21,20
Sydney FC,9208,1,21,4,3,66,23,43,67
N'castle Jet,9208,2,15,6,7,57,37,20,51
Melbourne C,9208,3,14,5,10,43,33,10,47
Melbourne V,9208,4,13,5,11,46,40,6,44
Adelaide Utd,9208,5,11,6,11,37,40,-3,39
Brisbane,9208,6,10,5,13,33,42,-9,35
Western Sydn,9208,7,8,9,10,38,47,-9,33
Perth Glory,9208,8,10,2,15,37,50,-13,32
Wellington P,9208,9,5,6,16,31,55,-24,21
CC Mariners,9208,10,4,8,15,28,49,-21,20
Sydney FC,9209,1,21,4,3,68,22,46,67
N'castle Jet,9209,2,15,5,8,59,41,18,50
Melbourne C,9209,3,15,4,10,47,35,12,49
Melbourne V,9209,4,13,5,11,45,42,3,44
Adelaide Utd,9209,5,11,6,11,37,40,-3,39
Brisbane,9209,6,10,5,13,33,42,-9,35
Western Sydn,9209,7,8,9,10,38,47,-9,33
Perth Glory,9209,8,10,2,15,37,50,-13,32
Wellington P,9209,9,5,6,16,31,55,-24,21
CC Mariners,9209,10,4,8,15,28,49,-21,20
Sydney FC,9210,1,21,4,3,67,22,45,67
N'castle Jet,9210,2,16,5,7,61,38,23,53
Melbourne C,9210,3,14,4,11,44,37,7,46
Melbourne V,9210,4,13,5,11,45,41,4,44
Adelaide Utd,9210,5,11,6,11,37,40,-3,39
Brisbane,9210,6,10,5,13,33,42,-9,35
Western Sydn,9210,7,8,9,10,38,47,-9,33
Perth Glory,9210,8,10,2,15,37,50,-13,32
Wellington P,9210,9,5,6,16,31,55,-24,21
CC Mariners,9210,10,4,8,15,28,49,-21,20
Sydney FC,9211,1,21,4,3,68,22,46,67
N'castle Jet,9211,2,15,6,7,58,38,20,51
Melbourne C,9211,3,14,5,10,44,34,10,47
Melbourne V,9211,4,13,5,11,45,42,3,44
Adelaide Utd,9211,5,11,6,11,37,40,-3,39
Brisbane,9211,6,10,5,13,33,42,-9,35
Western Sydn,9211,7,8,9,10,38,47,-9,33
Perth Glory,9211,8,10,2,15,37,50,-13,32
Wellington P,9211,9,5,6,16,31,55,-24,21
CC Mariners,9211,10,4,8,15,28,49,-21,20
Sydney FC,9212,1,20,4,4,64,24,40,64
N'castle Jet,9212,2,16,5,7,60,38,22,53
Melbourne V,9212,3,14,5,10,47,38,9,47
Melbourne C,9212,4,14,4,11,44,36,8,46
Adelaide Utd,9212,5,11,6,11,37,40,-3,39
Brisbane,9212,6,10,5,13,33,42,-9,35
Western Sydn,9212,7,8,9,10,38,47,-9,33
Perth Glory,9212,8,10,2,15,37,50,-13,32
Wellington P,9212,9,5,6,16,31,55,-24,21
CC Mariners,9212,10,4,8,15,28,49,-21,20
Sydney FC,9213,1,21,4,3,67,24,43,67
N'castle Jet,9213,2,15,5,8,58,40,18,50
Melbourne C,9213,3,15,4,10,46,34,12,49
Melbourne V,9213,4,13,5,11,47,41,6,44
Adelaide Utd,9213,5,11,6,11,37,40,-3,39
Brisbane,9213,6,10,5,13,33,42,-9,35
Western Sydn,9213,7,8,9,10,38,47,-9,33
Perth Glory,9213,8,10,2,15,37,50,-13,32
Wellington P,9213,9,5,6,16,31,55,-24,21
CC Mariners,9213,10,4,8,15,28,49,-21,20
Sydney FC,9214,1,21,4,3,65,22,43,67
N'castle Jet,9214,2,16,5,7,58,37,21,53
Melbourne C,9214,3,14,4,11,43,34,9,46
Melbourne V,9214,4,13,5,11,45,39,6,44
Adelaide Utd,9214,5,11,6,11,37,40,-3,39
Brisbane,9214,6,10,5,13,33,42,-9,35
Western Sydn,9214,7,8,9,10,38,47,-9,33
Perth Glory,9214,8,10,2,15,37,50,-13,32
Wellington P,9214,9,5,6,16,31,55,-24,21
CC Mariners,9214,10,4,8,15,28,49,-21,20
Sydney FC,9215,1,20,4,4,64,23,41,64
N'castle Jet,9215,2,15,5,8,58,40,18,50
Melbourne C,9215,3,15,4,10,46,34,12,49
Melbourne V,9215,4,14,5,10,46,38,8,47
Adelaide Utd,9215,5,11,6,11,37,40,-3,39
Brisbane,9215,6,10,5,13,33,42,-9,35
Western Sydn,9215,7,8,9,10,38,47,-9,33
Perth Glory,9215,8,10,2,15,37,50,-13,32
Wellington P,9215,9,5,6,16,31,55,-24,21
CC Mariners,9215,10,4,8,15,28,49,-21,20
Sydney FC,9216,1,20,5,3,64,22,42,65
N'castle Jet,9216,2,15,5,8,59,40,19,50
Melbourne C,9216,3,15,4,10,46,35,11,49
Melbourne V,9216,4,13,6,10,45,38,7,45
Adelaide Utd,9216,5,11,6,11,37,40,-3,39
Brisbane,9216,6,10,5,13,33,42,-9,35
Western Sydn,9216,7,8,9,10,38,47,-9,33
Perth Glory,9216,8,10,2,15,37,50,-13,32
Wellington P,9216,9,5,6,16,31,55,-24,21
CC Mariners,9216,10,4,8,15,28,49,-21,20
Sydney FC,9217,1,21,4,3,65,22,43,67
N'castle Jet,9217,2,16,5,7,60,39,21,53
Melbourne C,9217,3,14,4,11,45,36,9,46
Melbourne V,9217,4,13,5,11,45,39,6,44
Adelaide Utd,9217,5,11,6,11,37,40,-3,39
Brisbane,9217,6,10,5,13,33,42,-9,35
Western Sydn,9217,7,8,9,10,38,47,-9,33
Perth Glory,9217,8,10,2,15,37,50,-13,32
Wellington P,9217,9,5,6,16,31,55,-24,21
CC Mariners,9217,10,4,8,15,28,49,-21,20
Sydney FC,9218,1,21,4,3,67,22,45,67
N'castle Jet,9218,2,15,5,8,58,39,19,50
Melbourne C,9218,3,15,4,10,45,34,11,49
Melbourne V,9218,4,13,5,11,45,41,4,44
Adelaide Utd,9218,5,11,6,11,37,40,-3,39
Brisbane,9218,6,10,5,13,33,42,-9,35
Western Sydn,9218,7,8,9,10,38,47,-9,33
Perth Glory,9218,8,10,2,15,37,50,-13,32
Wellington P,9218,9,5,6,16,31,55,-24,21
CC Mariners,9218,10,4,8,15,28,49,-21,20
Sydney FC,9219,1,20,5,3,66,24,42,65
N'castle Jet,9219,2,15,5,8,57,40,17,50
Melbourne C,9219,3,15,4,10,46,33,13,49
Melbourne V,9219,4,13,6,10,47,40,7,45
Adelaide Utd,9219,5,11,6,11,37,40,-3,39
Brisbane,9219,6,10,5,13,33,42,-9,35
Western Sydn,9219,7,8,9,10,38,47,-9,33
Perth Glory,9219,8,10,2,15,37,50,-13,32
Wellington P,9219,9,5,6,16,31,55,-24,21
CC Mariners,9219,10,4,8,15,28,49,-21,20
Sydney FC,9220,1,20,5,3,68,26,42,65
N'castle Jet,9220,2,16,5,7,58,37,21,53
Melbourne C,9220,3,14,4,11,43,34,9,46
Melbourne V,9220,4,13,6,10,49,42,7,45
Adelaide Utd,9220,5,11,6,11,37,40,-3,39
Brisbane,9220,6,10,5,13,33,42,-9,35
Western Sydn,9220,7,8,9,10,38,47,-9,33
Perth Glory,9220,8,10,2,15,37,50,-13,32
Wellington P,9220,9,5,6,16,31,55,-24,21
CC Mariners,9220,10,4,8,15,28,49,-21,20
Sydney FC,9221,1,20,5,3,65,23,42,65
N'castle Jet,9221,2,16,5,7,59,37,22,53
Melbourne C,9221,3,14,4,11,43,35,8,46
Melbourne V,9221,4,13,6,10,46,39,7,45
Adelaide Utd,9221,5,11,6,11,37,40,-3,39
Brisbane,9221,6,10,5,13,33,42,-9,35
Western Sydn,9221,7,8,9,10,38,47,-9,33
Perth Glory,9221,8,10,2,15,37,50,-13,32
Wellington P,9221,9,5,6,16,31,55,-24,21
CC Mariners,9221,10,4,8,15,28,49,-21,20
Sydney FC,9222,1,21,4,3,65,22,43,67
N'castle Jet,9222,2,15,6,7,58,38,20,51
Melbourne C,9222,3,14,5,10,44,34,10,47
Melbourne V,9222,4,13,5,11,45,39,6,44
Adelaide Utd,9222,5,11,6,11,37,40,-3,39
Brisbane,9222,6,10,5,13,33,42,-9,35
Western Sydn,9222,7,8,9,10,38,47,-9,33
Perth Glory,9222,8,10,2,15,37,50,-13,32
Wellington P,9222,9,5,6,16,31,55,-24,21
CC Mariners,9222,10,4,8,15,28,49,-21,20
Sydney FC,9223,1,21,4,3,69,22,47,67
N'castle Jet,9223,2,15,6,7,59,39,20,51
Melbourne C,9223,3,14,5,10,45,35,10,47
Melbourne V,9223,4,13,5,11,45,43,2,44
Adelaide Utd,9223,5,11,6,11,37,40,-3,39
Brisbane,9223,6,10,5,13,33,42,-9,35
Western Sydn,9223,7,8,9,10,38,47,-9,33
Perth Glory,9223,8,10,2,15,37,50,-13,32
Wellington P,9223,9,5,6,16,31,55,-24,21
CC Mariners,9223,10,4,8,15,28,49,-21,20
Sydney FC,9224,1,21,4,3,71,23,48,67
N'castle Jet,9224,2,16,5,7,59,37,22,53
Melbourne C,9224,3,14,4,11,43,35,8,46
Melbourne V,9224,4,13,5,11,46,45,1,44
Adelaide Utd,9224,5,11,6,11,37,40,-3,39
Brisbane,9224,6,10,5,13,33,42,-9,35
Western Sydn,9224,7,8,9,10,38,47,-9,33
Perth Glory,9224,8,10,2,15,37,50,-13,32
Wellington P,9224,9,5,6,16,31,55,-24,21
CC Mariners,9224,10,4,8,15,28,49,-21,20
Sydney FC,9225,1,21,4,3,68,23,45,67
N'castle Jet,9225,2,16,5,7,60,37,23,53
Melbourne C,9225,3,14,4,11,43,36,7,46
Melbourne V,9225,4,13,5,11,46,42,4,44
Adelaide Utd,9225,5,11,6,11,37,40,-3,39
Brisbane,9225,6,10,5,13,33,42,-9,35
Western Sydn,9225,7,8,9,10,38,47,-9,33
Perth Glory,9225,8,10,2,15,37,50,-13,32
Wellington P,9225,9,5,6,16,31,55,-24,21
CC Mariners,9225,10,4,8,15,28,49,-21,20
Sydney FC,9226,1,21,4,3,66,22,44,67
N'castle Jet,9226,2,16,5,7,58,37,21,53
Melbourne C,9226,3,14,4,11,43,34,9,46
Melbourne V,9226,4,13,5,11,45,40,5,44
Adelaide Utd,9226,5,11,6,11,37,40,-3,39
Brisbane,9226,6,10,5,13,33,42,-9,35
Western Sydn,9226,7,8,9,10,38,47,-9,33
Perth Glory,9226,8,10,2,15,37,50,-13,32
Wellington P,9226,9,5,6,16,31,55,-24,21
CC Mariners,9226,10,4,8,15,28,49,-21,20
Sydney FC,9227,1,20,5,3,64,22,42,65
N'castle Jet,9227,2,15,5,8,58,39,19,50
Melbourne C,9227,3,15,4,10,45,34,11,49
Melbourne V,9227,4,13,6,10,45,38,7,45
Adelaide Utd,9227,5,11,6,11,37,40,-3,39
Brisbane,9227,6,10,5,13,33,42,-9,35
Western Sydn,9227,7,8,9,10,38,47,-9,33
Perth Glory,9227,8,10,2,15,37,50,-13,32
Wellington P,9227,9,5,6,16,31,55,-24,21
CC Mariners,9227,10,4,8,15,28,49,-21,20
Sydney FC,9228,1,21,4,3,67,23,44,67
N'castle Jet,9228,2,15,6,7,58,38,20,51
Melbourne C,9228,3,14,5,10,44,34,10,47
Melbourne V,9228,4,13,5,11,46,41,5,44
Adelaide Utd,9228,5,11,6,11,37,40,-3,39
Brisbane,9228,6,10,5,13,33,42,-9,35
Western Sydn,9228,7,8,9,10,38,47,-9,33
Perth Glory,9228,8,10,2,15,37,50,-13,32
Wellington P,9228,9,5,6,16,31,55,-24,21
CC Mariners,9228,10,4,8,15,28,49,-21,20
Sydney FC,9229,1,21,4,3,66,23,43,67
N'castle Jet,9229,2,16,5,7,58,37,21,53
Melbourne C,9229,3,14,4,11,43,34,9,46
Melbourne V,9229,4,13,5,11,46,40,6,44
Adelaide Utd,9229,5,11,6,11,37,40,-3,39
Brisbane,9229,6,10,5,13,33,42,-9,35
Western Sydn,9229,7,8,9,10,38,47,-9,33
Perth Glory,9229,8,10,2,15,37,50,-13,32
Wellington P,9229,9,5,6,16,31,55,-24,21
CC Mariners,9229,10,4,8,15,28,49,-21,20
Sydney FC,9230,1,21,4,3,69,23,46,67
N'castle Jet,9230,2,15,6,7,58,38,20,51
Melbourne C,9230,3,14,5,10,44,34,10,47
Melbourne V,9230,4,13,5,11,46,43,3,44
Adelaide Utd,9230,5,11,6,11,37,40,-3,39
Brisbane,9230,6,10,5,13,33,42,-9,35
Western Sydn,9230,7,8,9,10,38,47,-9,33
Perth Glory,9230,8,10,2,15,37,50,-13,32
Wellington P,9230,9,5,6,16,31,55,-24,21
CC Mariners,9230,10,4,8,15,28,49,-21,20
Sydney FC,9231,1,21,4,3,68,25,43,67
N'castle Jet,9231,2,15,6,7,57,37,20,51
Melbourne C,9231,3,14,5,10,43,33,10,47
Melbourne V,9231,4,13,5,11,48,42,6,44
Adelaide Utd,9231,5,11,6,11,37,40,-3,39
Brisbane,9231,6,10,5,13,33,42,-9,35
Western Sydn,9231,7,8,9,10,38,47,-9,33
Perth Glory,9231,8,10,2,15,37,50,-13,32
Wellington P,9231,9,5,6,16,31,55,-24,21
CC Mariners,9231,10,4,8,15,28,49,-21,20
Sydney FC,9232,1,20,5,3,64,22,42,65
N'castle Jet,9232,2,15,5,8,58,39,19,50
Melbourne C,9232,3,15,4,10,45,34,11,49
Melbourne V,9232,4,13,6,10,45,38,7,45
Adelaide Utd,9232,5,11,6,11,37,40,-3,39
Brisbane,9232,6,10,5,13,33,42,-9,35
Western Sydn,9232,7,8,9,10,38,47,-9,33
Perth Glory,9232,8,10,2,15,37,50,-13,32
Wellington P,9232,9,5,6,16,31,55,-24,21
CC Mariners,9232,10,4,8,15,28,49,-21,20
Sydney FC,9233,1,20,4,4,64,24,40,64
N'castle Jet,9233,2,16,5,7,61,38,23,53
Melbourne V,9233,3,14,5,10,47,38,9,47
Melbourne C,9233,4,14,4,11,44,37,7,46
Adelaide Utd,9233,5,11,6,11,37,40,-3,39
Brisbane,9233,6,10,5,13,33,42,-9,35
Western Sydn,9233,7,8,9,10,38,47,-9,33
Perth Glory,9233,8,10,2,15,37,50,-13,32
Wellington P,9233,9,5,6,16,31,55,-24,21
CC Mariners,9233,10,4,8,15,28,49,-21,20
Sydney FC,9234,1,21,4,3,65,22,43,67
N'castle Jet,9234,2,16,5,7,60,38,22,53
Melbourne C,9234,3,14,4,11,44,36,8,46
Melbourne V,9234,4,13,5,11,45,39,6,44
Adelaide Utd,9234,5,11,6,11,37,40,-3,39
Brisbane,9234,6,10,5,13,33,42,-9,35
Western Sydn,9234,7,8,9,10,38,47,-9,33
Perth Glory,9234,8,10,2,15,37,50,-13,32
Wellington P,9234,9,5,6,16,31,55,-24,21
CC Mariners,9234,10,4,8,15,28,49,-21,20
Sydney FC,9235,1,21,4,3,68,22,46,67
N'castle Jet,9235,2,16,5,7,60,39,21,53
Melbourne C,9235,3,14,4,11,45,36,9,46
Melbourne V,9235,4,13,5,11,45,42,3,44
Adelaide Utd,9235,5,11,6,11,37,40,-3,39
Brisbane,9235,6,10,5,13,33,42,-9,35
Western Sydn,9235,7,8,9,10,38,47,-9,33
Perth Glory,9235,8,10,2,15,37,50,-13,32
Wellington P,9235,9,5,6,16,31,55,-24,21
CC Mariners,9235,10,4,8,15,28,49,-21,20
Sydney FC,9236,1,20,5,3,66,24,42,65
N'castle Jet,9236,2,15,5,8,57,38,19,50
Melbourne C,9236,3,15,4,10,44,33,11,49
Melbourne V,9236,4,13,6,10,47,40,7,45
Adelaide Utd,9236,5,11,6,11,37,40,-3,39
Brisbane,9236,6,10,5,13,33,42,-9,35
Western Sydn,9236,7,8,9,10,38,47,-9,33
Perth Glory,9236,8,10,2,15,37,50,-13,32
Wellington P,9236,9,5,6,16,31,55,-24,21
CC Mariners,9236,10,4,8,15,28,49,-21,20
Sydney FC,9237,1,21,4,3,65,22,43,67
N'castle Jet,9237,2,15,6,7,58,38,20,51
Melbourne C,9237,3,14,5,10,44,34,10,47
Melbourne V,9237,4,13,5,11,45,39,6,44
Adelaide Utd,9237,5,11,6,11,37,40,-3,39
Brisbane,9237,6,10,5,13,33,42,-9,35
Western Sydn,9237,7,8,9,10,38,47,-9,33
Perth Glory,9237,8,10,2,15,37,50,-13,32
Wellington P,9237,9,5,6,16,31,55,-24,21
CC Mariners,9237,10,4,8,15,28,49,-21,20
Sydney FC,9238,1,20,5,3,65,23,42,65
N'castle Jet,9238,2,15,6,7,57,37,20,51
Melbourne C,9238,3,14,5,10,43,33,10,47
Melbourne V,9238,4,13,6,10,46,39,7,45
Adelaide Utd,9238,5,11,6,11,37,40,-3,39
Brisbane,9238,6,10,5,13,33,42,-9,35
Western Sydn,9238,7,8,9,10,38,47,-9,33
Perth Glory,9238,8,10,2,15,37,50,-13,32
Wellington P,9238,9,5,6,16,31,55,-24,21
CC Mariners,9238,10,4,8,15,28,49,-21,20
Sydney FC,9239,1,21,4,3,67,23,44,67
N'castle Jet,9239,2,16,5,7,58,37,21,53
Melbourne C,9239,3,14,4,11,43,34,9,46
Melbourne V,9239,4,13,5,11,46,41,5,44
Adelaide Utd,9239,5,11,6,11,37,40,-3,39
Brisbane,9239,6,10,5,13,33,42,-9,35
Western Sydn,9239,7,8,9,10,38,47,-9,33
Perth Glory,9239,8,10,2,15,37,50,-13,32
Wellington P,9239,9,5,6,16,31,55,-24,21
CC Mariners,9239,10,4,8,15,28,49,-21,20
Sydney FC,9240,1,20,4,4,64,25,39,64
N'castle Jet,9240,2,16,5,7,59,38,21,53
Melbourne V,9240,3,14,5,10,48,38,10,47
Melbourne C,9240,4,14,4,11,44,35,9,46
Adelaide Utd,9240,5,11,6,11,37,40,-3,39
Brisbane,9240,6,10,5,13,33,42,-9,35
Western Sydn,9240,7,8,9,10,38,47,-9,33
Perth Glory,9240,8,10,2,15,37,50,-13,32
Wellington P,9240,9,5,6,16,31,55,-24,21
CC Mariners,9240,10,4,8,15,28,49,-21,20
Sydney FC,9241,1,21,4,3,66,23,43,67
N'castle Jet,9241,2,15,6,7,58,38,20,51
Melbourne C,9241,3,14,5,10,44,34,10,47
Melbourne V,9241,4,13,5,11,46,40,6,44
Adelaide Utd,9241,5,11,6,11,37,40,-3,39
Brisbane,9241,6,10,5,13,33,42,-9,35
Western Sydn,9241,7,8,9,10,38,47,-9,33
Perth Glory,9241,8,10,2,15,37,50,-13,32
Wellington P,9241,9,5,6,16,31,55,-24,21
CC Mariners,9241,10,4,8,15,28,49,-21,20
Sydney FC,9242,1,20,5,3,66,24,42,65
N'castle Jet,9242,2,15,6,7,59,39,20,51
Melbourne C,9242,3,14,5,10,45,35,10,47
Melbourne V,9242,4,13,6,10,47,40,7,45
Adelaide Utd,9242,5,11,6,11,37,40,-3,39
Brisbane,9242,6,10,5,13,33,42,-9,35
Western Sydn,9242,7,8,9,10,38,47,-9,33
Perth Glory,9242,8,10,2,15,37,50,-13,32
Wellington P,9242,9,5,6,16,31,55,-24,21
CC Mariners,9242,10,4,8,15,28,49,-21,20
Sydney FC,9243,1,20,5,3,65,23,42,65
N'castle Jet,9243,2,16,5,7,59,38,21,53
Melbourne C,9243,3,14,4,11,44,35,9,46
Melbourne V,9243,4,13,6,10,46,39,7,45
Adelaide Utd,9243,5,11,6,11,37,40,-3,39
Brisbane,9243,6,10,5,13,33,42,-9,35
Western Sydn,9243,7,8,9,10,38,47,-9,33
Perth Glory,9243,8,10,2,15,37,50,-13,32
Wellington P,9243,9,5,6,16,31,55,-24,21
CC Mariners,9243,10,4,8,15,28,49,-21,20
Sydney FC,9244,1,21,4,3,66,23,43,67
N'castle Jet,9244,2,15,5,8,58,40,18,50
Melbourne C,9244,3,15,4,10,46,34,12,49
Melbourne V,9244,4,13,5,11,46,40,6,44
Adelaide Utd,9244,5,11,6,11,37,40,-3,39
Brisbane,9244,6,10,5,13,33,42,-9,35
Western Sydn,9244,7,8,9,10,38,47,-9,33
Perth Glory,9244,8,10,2,15,37,50,-13,32
Wellington P,9244,9,5,6,16,31,55,-24,21
CC Mariners,9244,10,4,8,15,28,49,-21,20
Sydney FC,9245,1,21,4,3,67,22,45,67
N'castle Jet,9245,2,16,5,7,59,37,22,53
Melbourne C,9245,3,14,4,11,43,35,8,46
Melbourne V,9245,4,13,5,11,45,41,4,44
Adelaide Utd,9245,5,11,6,11,37,40,-3,39
Brisbane,9245,6,10,5,13,33,42,-9,35
Western Sydn,9245,7,8,9,10,38,47,-9,33
Perth Glory,9245,8,10,2,15,37,50,-13,32
Wellington P,9245,9,5,6,16,31,55,-24,21
CC Mariners,9245,10,4,8,15,28,49,-21,20
Sydney FC,9246,1,21,4,3,67,23,44,67
N'castle Jet,9246,2,15,6,7,57,37,20,51
Melbourne C,9246,3,14,5,10,43,33,10,47
Melbourne V,9246,4,13,5,11,46,41,5,44
Adelaide Utd,9246,5,11,6,11,37,40,-3,39
Brisbane,9246,6,10,5,13,33,42,-9,35
Western Sydn,9246,7,8,9,10,38,47,-9,33
Perth Glory,9246,8,10,2,15,37,50,-13,32
Wellington P,9246,9,5,6,16,31,55,-24,21
CC Mariners,9246,10,4,8,15,28,49,-21,20
Sydney FC,9247,1,20,5,3,67,25,42,65
N'castle Jet,9247,2,15,5,8,58,39,19,50
Melbourne C,9247,3,15,4,10,45,34,11,49
Melbourne V,9247,4,13,6,10,48,41,7,45
Adelaide Utd,9247,5,11,6,11,37,40,-3,39
Brisbane,9247,6,10,5,13,33,42,-9,35
Western Sydn,9247,7,8,9,10,38,47,-9,33
Perth Glory,9247,8,10,2,15,37,50,-13,32
Wellington P,9247,9,5,6,16,31,55,-24,21
CC Mariners,9247,10,4,8,15,28,49,-21,20
Sydney FC,9248,1,21,4,3,67,22,45,67
N'castle Jet,9248,2,15,5,8,57,39,18,50
Melbourne C,9248,3,15,4,10,45,33,12,49
Melbourne V,9248,4,13,5,11,45,41,4,44
Adelaide Utd,9248,5,11,6,11,37,40,-3,39
Brisbane,9248,6,10,5,13,33,42,-9,35
Western Sydn,9248,7,8,9,10,38,47,-9,33
Perth Glory,9248,8,10,2,15,37,50,-13,32
Wellington P,9248,9,5,6,16,31,55,-24,21
CC Mariners,9248,10,4,8,15,28,49,-21,20
Sydney FC,9249,1,21,4,3,68,23,45,67
N'castle Jet,9249,2,16,5,7,58,37,21,53
Melbourne C,9249,3,14,4,11,43,34,9,46
Melbourne V,9249,4,13,5,11,46,42,4,44
Adelaide Utd,9249,5,11,6,11,37,40,-3,39
Brisbane,9249,6,10,5,13,33,42,-9,35
Western Sydn,9249,7,8,9,10,38,47,-9,33
Perth Glory,9249,8,10,2,15,37,50,-13,32
Wellington P,9249,9,5,6,16,31,55,-24,21
CC Mariners,9249,10,4,8,15,28,49,-21,20
Sydney FC,9250,1,20,5,3,65,23,42,65
N'castle Jet,9250,2,16,5,7,61,39,22,53
Melbourne C,9250,3,14,4,11,45,37,8,46
Melbourne V,9250,4,13,6,10,46,39,7,45
Adelaide Utd,9250,5,11,6,11,37,40,-3,39
Brisbane,9250,6,10,5,13,33,42,-9,35
Western Sydn,9250,7,8,9,10,38,47,-9,33
Perth Glory,9250,8,10,2,15,37,50,-13,32
Wellington P,9250,9,5,6,16,31,55,-24,21
CC Mariners,9250,10,4,8,15,28,49,-21,20
Sydney FC,9251,1,21,4,3,66,23,43,67
N'castle Jet,9251,2,16,5,7,59,37,22,53
Melbourne C,9251,3,14,4,11,43,35,8,46
Melbourne V,9251,4,13,5,11,46,40,6,44
Adelaide Utd,9251,5,11,6,11,37,40,-3,39
Brisbane,9251,6,10,5,13,33,42,-9,35
Western Sydn,9251,7,8,9,10,38,47,-9,33
Perth Glory,9251,8,10,2,15,37,50,-13,32
Wellington P,9251,9,5,6,16,31,55,-24,21
CC Mariners,9251,10,4,8,15,28,49,-21,20
Sydney FC,9252,1,21,4,3,67,24,43,67
N'castle Jet,9252,2,15,6,7,59,39,20,51
Melbourne C,9252,3,14,5,10,45,35,10,47
Melbourne V,9252,4,13,5,11,47,41,6,44
Adelaide Utd,9252,5,11,6,11,37,40,-3,39
Brisbane,9252,6,10,5,13,33,42,-9,35
Western Sydn,9252,7,8,9,10,38,47,-9,33
Perth Glory,9252,8,10,2,15,37,50,-13,32
Wellington P,9252,9,5,6,16,31,55,-24,21
CC Mariners,9252,10,4,8,15,28,49,-21,20
Sydney FC,9253,1,20,5,3,65,23,42,65
N'castle Jet,9253,2,15,6,7,58,38,20,51
Melbourne C,9253,3,14,5,10,44,34,10,47
Melbourne V,9253,4,13,6,10,46,39,7,45
Adelaide Utd,9253,5,11,6,11,37,40,-3,39
Brisbane,9253,6,10,5,13,33,42,-9,35
Western Sydn,9253,7,8,9,10,38,47,-9,33
Perth Glory,9253,8,10,2,15,37,50,-13,32
Wellington P,9253,9,5,6,16,31,55,-24,21
CC Mariners,9253,10,4,8,15,28,49,-21,20
Sydney FC,9254,1,20,4,4,68,27,41,64
N'castle Jet,9254,2,15,6,7,58,38,20,51
Melbourne C,9254,3,14,5,10,44,34,10,47
Melbourne V,9254,4,14,5,10,50,42,8,47
Adelaide Utd,9254,5,11,6,11,37,40,-3,39
Brisbane,9254,6,10,5,13,33,42,-9,35
Western Sydn,9254,7,8,9,10,38,47,-9,33
Perth Glory,9254,8,10,2,15,37,50,-13,32
Wellington P,9254,9,5,6,16,31,55,-24,21
CC Mariners,9254,10,4,8,15,28,49,-21,20
Sydney FC,9255,1,20,4,4,64,25,39,64
N'castle Jet,9255,2,15,6,7,60,40,20,51
Melbourne V,9255,3,14,5,10,48,38,10,47
Melbourne C,9255,4,14,5,10,46,36,10,47
Adelaide Utd,9255,5,11,6,11,37,40,-3,39
Brisbane,9255,6,10,5,13,33,42,-9,35
Western Sydn,9255,7,8,9,10,38,47,-9,33
Perth Glory,9255,8,10,2,15,37,50,-13,32
Wellington P,9255,9,5,6,16,31,55,-24,21
CC Mariners,9255,10,4,8,15,28,49,-21,20
Sydney FC,9256,1,21,4,3,66,23,43,67
N'castle Jet,9256,2,15,6,7,59,39,20,51
Melbourne C,9256,3,14,5,10,45,35,10,47
Melbourne V,9256,4,13,5,11,46,40,6,44
Adelaide Utd,9256,5,11,6,11,37,40,-3,39
Brisbane,9256,6,10,5,13,33,42,-9,35
Western Sydn,9256,7,8,9,10,38,47,-9,33
Perth Glory,9256,8,10,2,15,37,50,-13,32
Wellington P,9256,9,5,6,16,31,55,-24,21
CC Mariners,9256,10,4,8,15,28,49,-21,20
Sydney FC,9257,1,21,4,3,66,23,43,67
N'castle Jet,9257,2,15,5,8,58,39,19,50
Melbourne C,9257,3,15,4,10,45,34,11,49
Melbourne V,9257,4,13,5,11,46,40,6,44
Adelaide Utd,9257,5,11,6,11,37,40,-3,39
Brisbane,9257,6,10,5,13,33,42,-9,35
Western Sydn,9257,7,8,9,10,38,47,-9,33
Perth Glory,9257,8,10,2,15,37,50,-13,32
Wellington P,9257,9,5,6,16,31,55,-24,21
CC Mariners,9257,10,4,8,15,28,49,-21,20
Sydney FC,9258,1,21,4,3,67,22,45,67
N'castle Jet,9258,2,15,6,7,60,40,20,51
Melbourne C,9258,3,14,5,10,46,36,10,47
Melbourne V,9258,4,13,5,11,45,41,4,44
Adelaide Utd,9258,5,11,6,11,37,40,-3,39
Brisbane,9258,6,10,5,13,33,42,-9,35
Western Sydn,9258,7,8,9,10,38,47,-9,33
Perth Glory,9258,8,10,2,15,37,50,-13,32
Wellington P,9258,9,5,6,16,31,55,-24,21
CC Mariners,9258,10,4,8,15,28,49,-21,20
Sydney FC,9259,1,20,4,4,64,23,41,64
N'castle Jet,9259,2,15,5,8,57,38,19,50
Melbourne C,9259,3,15,4,10,44,33,11,49
Melbourne V,9259,4,14,5,10,46,38,8,47
Adelaide Utd,9259,5,11,6,11,37,40,-3,39
Brisbane,9259,6,10,5,13,33,42,-9,35
Western Sydn,9259,7,8,9,10,38,47,-9,33
Perth Glory,9259,8,10,2,15,37,50,-13,32
Wellington P,9259,9,5,6,16,31,55,-24,21
CC Mariners,9259,10,4,8,15,28,49,-21,20
Sydney FC,9260,1,20,4,4,65,25,40,64
N'castle Jet,9260,2,15,5,8,58,39,19,50
Melbourne C,9260,3,15,4,10,45,34,11,49
Melbourne V,9260,4,14,5,10,48,39,9,47
Adelaide Utd,9260,5,11,6,11,37,40,-3,39
Brisbane,9260,6,10,5,13,33,42,-9,35
Western Sydn,9260,7,8,9,10,38,47,-9,33
Perth Glory,9260,8,10,2,15,37,50,-13,32
Wellington P,9260,9,5,6,16,31,55,-24,21
CC Mariners,9260,10,4,8,15,28,49,-21,20
Sydney FC,9261,1,20,5,3,66,24,42,65
N'castle Jet,9261,2,16,5,7,60,38,22,53
Melbourne C,9261,3,14,4,11,44,36,8,46
Melbourne V,9261,4,13,6,10,47,40,7,45
Adelaide Utd,9261,5,11,6,11,37,40,-3,39
Brisbane,9261,6,10,5,13,33,42,-9,35
Western Sydn,9261,7,8,9,10,38,47,-9,33
Perth Glory,9261,8,10,2,15,37,50,-13,32
Wellington P,9261,9,5,6,16,31,55,-24,21
CC Mariners,9261,10,4,8,15,28,49,-21,20
Sydney FC,9262,1,21,4,3,66,23,43,67
N'castle Jet,9262,2,15,6,7,59,39,20,51
Melbourne C,9262,3,14,5,10,45,35,10,47
Melbourne V,9262,4,13,5,11,46,40,6,44
Adelaide Utd,9262,5,11,6,11,37,40,-3,39
Brisbane,9262,6,10,5,13,33,42,-9,35
Western Sydn,9262,7,8,9,10,38,47,-9,33
Perth Glory,9262,8,10,2,15,37,50,-13,32
Wellington P,9262,9,5,6,16,31,55,-24,21
CC Mariners,9262,10,4,8,15,28,49,-21,20
Sydney FC,9263,1,21,4,3,66,23,43,67
N'castle Jet,9263,2,16,5,7,58,37,21,53
Melbourne C,9263,3,14,4,11,43,34,9,46
Melbourne V,9263,4,13,5,11,46,40,6,44
Adelaide Utd,9263,5,11,6,11,37,40,-3,39
Brisbane,9263,6,10,5,13,33,42,-9,35
Western Sydn,9263,7,8,9,10,38,47,-9,33
Perth Glory,9263,8,10,2,15,37,50,-13,32
Wellington P,9263,9,5,6,16,31,55,-24,21
CC Mariners,9263,10,4,8,15,28,49,-21,20
Sydney FC,9264,1,20,4,4,66,25,41,64
N'castle Jet,9264,2,15,5,8,58,39,19,50
Melbourne C,9264,3,15,4,10,45,34,11,49
Melbourne V,9264,4,14,5,10,48,40,8,47
Adelaide Utd,9264,5,11,6,11,37,40,-3,39
Brisbane,9264,6,10,5,13,33,42,-9,35
Western Sydn,9264,7,8,9,10,38,47,-9,33
Perth Glory,9264,8,10,2,15,37,50,-13,32
Wellington P,9264,9,5,6,16,31,55,-24,21
CC Mariners,9264,10,4,8,15,28,49,-21,20
Sydney FC,9265,1,21,4,3,66,23,43,67
N'castle Jet,9265,2,16,5,7,61,38,23,53
Melbourne C,9265,3,14,4,11,44,37,7,46
Melbourne V,9265,4,13,5,11,46,40,6,44
Adelaide Utd,9265,5,11,6,11,37,40,-3,39
Brisbane,9265,6,10,5,13,33,42,-9,35
Western Sydn,9265,7,8,9,10,38,47,-9,33
Perth Glory,9265,8,10,2,15,37,50,-13,32
Wellington P,9265,9,5,6,16,31,55,-24,21
CC Mariners,9265,10,4,8,15,28,49,-21,20
Sydney FC,9266,1,20,5,3,67,25,42,65
N'castle Jet,9266,2,15,5,8,57,39,18,50
Melbourne C,9266,3,15,4,10,45,33,12,49
Melbourne V,9266,4,13,6,10,48,41,7,45
Adelaide Utd,9266,5,11,6,11,37,40,-3,39
Brisbane,9266,6,10,5,13,33,42,-9,35
Western Sydn,9266,7,8,9,10,38,47,-9,33
Perth Glory,9266,8,10,2,15,37,50,-13,32
Wellington P,9266,9,5,6,16,31,55,-24,21
CC Mariners,9266,10,4,8,15,28,49,-21,20
Sydney FC,9267,1,20,4,4,65,25,40,64
N'castle Jet,9267,2,15,6,7,58,38,20,51
Melbourne C,9267,3,14,5,10,44,34,10,47
Melbourne V,9267,4,14,5,10,48,39,9,47
Adelaide Utd,9267,5,11,6,11,37,40,-3,39
Brisbane,9267,6,10,5,13,33,42,-9,35
Western Sydn,9267,7,8,9,10,38,47,-9,33
Perth Glory,9267,8,10,2,15,37,50,-13,32
Wellington P,9267,9,5,6,16,31,55,-24,21
CC Mariners,9267,10,4,8,15,28,49,-21,20
Sydney FC,9268,1,21,4,3,68,22,46,67
N'castle Jet,9268,2,16,5,7,59,38,21,53
Melbourne C,9268,3,14,4,11,44,35,9,46
Melbourne V,9268,4,13,5,11,45,42,3,44
Adelaide Utd,9268,5,11,6,11,37,40,-3,39
Brisbane,9268,6,10,5,13,33,42,-9,35
Western Sydn,9268,7,8,9,10,38,47,-9,33
Perth Glory,9268,8,10,2,15,37,50,-13,32
Wellington P,9268,9,5,6,16,31,55,-24,21
CC Mariners,9268,10,4,8,15,28,49,-21,20
Sydney FC,9269,1,20,4,4,64,23,41,64
N'castle Jet,9269,2,15,6,7,59,39,20,51
Melbourne C,9269,3,14,5,10,45,35,10,47
Melbourne V,9269,4,14,5,10,46,38,8,47
Adelaide Utd,9269,5,11,6,11,37,40,-3,39
Brisbane,9269,6,10,5,13,33,42,-9,35
Western Sydn,9269,7,8,9,10,38,47,-9,33
Perth Glory,9269,8,10,2,15,37,50,-13,32
Wellington P,9269,9,5,6,16,31,55,-24,21
CC Mariners,9269,10,4,8,15,28,49,-21,20
Sydney FC,9270,1,21,4,3,65,22,43,67
N'castle Jet,9270,2,16,5,7,58,37,21,53
Melbourne C,9270,3,14,4,11,43,34,9,46
Melbourne V,9270,4,13,5,11,45,39,6,44
Adelaide Utd,9270,5,11,6,11,37,40,-3,39
Brisbane,9270,6,10,5,13,33,42,-9,35
Western Sydn,9270,7,8,9,10,38,47,-9,33
Perth Glory,9270,8,10,2,15,37,50,-13,32
Wellington P,9270,9,5,6,16,31,55,-24,21
CC Mariners,9270,10,4,8,15,28,49,-21,20
Sydney FC,9271,1,21,4,3,67,24,43,67
N'castle Jet,9271,2,16,5,7,58,37,21,53
Melbourne C,9271,3,14,4,11,43,34,9,46
Melbourne V,9271,4,13,5,11,47,41,6,44
Adelaide Utd,9271,5,11,6,11,37,40,-3,39
Brisbane,9271,6,10,5,13,33,42,-9,35
Western Sydn,9271,7,8,9,10,38,47,-9,33
Perth Glory,9271,8,10,2,15,37,50,-13,32
Wellington P,9271,9,5,6,16,31,55,-24,21
CC Mariners,9271,10,4,8,15,28,49,-21,20
Sydney FC,9272,1,21,4,3,67,23,44,67
N'castle Jet,9272,2,15,5,8,57,39,18,50
Melbourne C,9272,3,15,4,10,45,33,12,49
Melbourne V,9272,4,13,5,11,46,41,5,44
Adelaide Utd,9272,5,11,6,11,37,40,-3,39
Brisbane,9272,6,10,5,13,33,42,-9,35
Western Sydn,9272,7,8,9,10,38,47,-9,33
Perth Glory,9272,8,10,2,15,37,50,-13,32
Wellington P,9272,9,5,6,16,31,55,-24,21
CC Mariners,9272,10,4,8,15,28,49,-21,20
Sydney FC,9273,1,21,4,3,65,22,43,67
N'castle Jet,9273,2,16,5,7,59,37,22,53
Melbourne C,9273,3,14,4,11,43,35,8,46
Melbourne V,9273,4,13,5,11,45,39,6,44
Adelaide Utd,9273,5,11,6,11,37,40,-3,39
Brisbane,9273,6,10,5,13,33,42,-9,35
Western Sydn,9273,7,8,9,10,38,47,-9,33
Perth Glory,9273,8,10,2,15,37,50,-13,32
Wellington P,9273,9,5,6,16,31,55,-24,21
CC Mariners,9273,10,4,8,15,28,49,-21,20
Sydney FC,9274,1,21,4,3,67,23,44,67
N'castle Jet,9274,2,16,5,7,58,37,21,53
Melbourne C,9274,3,14,4,11,43,34,9,46
Melbourne V,9274,4,13,5,11,46,41,5,44
Adelaide Utd,9274,5,11,6,11,37,40,-3,39
Brisbane,9274,6,10,5,13,33,42,-9,35
Western Sydn,9274,7,8,9,10,38,47,-9,33
Perth Glory,9274,8,10,2,15,37,50,-13,32
Wellington P,9274,9,5,6,16,31,55,-24,21
CC Mariners,9274,10,4,8,15,28,49,-21,20
Sydney FC,9275,1,21,4,3,67,23,44,67
N'castle Jet,9275,2,15,5,8,57,39,18,50
Melbourne C,9275,3,15,4,10,45,33,12,49
Melbourne V,9275,4,13,5,11,46,41,5,44
Adelaide Utd,9275,5,11,6,11,37,40,-3,39
Brisbane,9275,6,10,5,13,33,42,-9,35
Western Sydn,9275,7,8,9,10,38,47,-9,33
Perth Glory,9275,8,10,2,15,37,50,-13,32
Wellington P,9275,9,5,6,16,31,55,-24,21
CC Mariners,9275,10,4,8,15,28,49,-21,20
Sydney FC,9276,1,20,4,4,64,24,40,64
N'castle Jet,9276,2,15,5,8,57,39,18,50
Melbourne C,9276,3,15,4,10,45,33,12,49
Melbourne V,9276,4,14,5,10,47,38,9,47
Adelaide Utd,9276,5,11,6,11,37,40,-3,39
Brisbane,9276,6,10,5,13,33,42,-9,35
Western Sydn,9276,7,8,9,10,38,47,-9,33
Perth Glory,9276,8,10,2,15,37,50,-13,32
Wellington P,9276,9,5,6,16,31,55,-24,21
CC Mariners,9276,10,4,8,15,28,49,-21,20
Sydney FC,9277,1,21,4,3,65,22,43,67
N'castle Jet,9277,2,16,5,7,59,37,22,53
Melbourne C,9277,3,14,4,11,43,35,8,46
Melbourne V,9277,4,13,5,11,45,39,6,44
Adelaide Utd,9277,5,11,6,11,37,40,-3,39
Brisbane,9277,6,10,5,13,33,42,-9,35
Western Sydn,9277,7,8,9,10,38,47,-9,33
Perth Glory,9277,8,10,2,15,37,50,-13,32
Wellington P,9277,9,5,6,16,31,55,-24,21
CC Mariners,9277,10,4,8,15,28,49,-21,20
Sydney FC,9278,1,20,4,4,64,23,41,64
N'castle Jet,9278,2,15,6,7,60,40,20,51
Melbourne C,9278,3,14,5,10,46,36,10,47
Melbourne V,9278,4,14,5,10,46,38,8,47
Adelaide Utd,9278,5,11,6,11,37,40,-3,39
Brisbane,9278,6,10,5,13,33,42,-9,35
Western Sydn,9278,7,8,9,10,38,47,-9,33
Perth Glory,9278,8,10,2,15,37,50,-13,32
Wellington P,9278,9,5,6,16,31,55,-24,21
CC Mariners,9278,10,4,8,15,28,49,-21,20
Sydney FC,9279,1,20,5,3,64,22,42,65
N'castle Jet,9279,2,15,5,8,57,41,16,50
Melbourne C,9279,3,15,4,10,47,33,14,49
Melbourne V,9279,4,13,6,10,45,38,7,45
Adelaide Utd,9279,5,11,6,11,37,40,-3,39
Brisbane,9279,6,10,5,13,33,42,-9,35
Western Sydn,9279,7,8,9,10,38,47,-9,33
Perth Glory,9279,8,10,2,15,37,50,-13,32
Wellington P,9279,9,5,6,16,31,55,-24,21
CC Mariners,9279,10,4,8,15,28,49,-21,20
Sydney FC,9280,1,20,4,4,65,25,40,64
N'castle Jet,9280,2,16,5,7,60,37,23,53
Melbourne V,9280,3,14,5,10,48,39,9,47
Melbourne C,9280,4,14,4,11,43,36,7,46
Adelaide Utd,9280,5,11,6,11,37,40,-3,39
Brisbane,9280,6,10,5,13,33,42,-9,35
Western Sydn,9280,7,8,9,10,38,47,-9,33
Perth Glory,9280,8,10,2,15,37,50,-13,32
Wellington P,9280,9,5,6,16,31,55,-24,21
CC Mariners,9280,10,4,8,15,28,49,-21,20
Sydney FC,9281,1,21,4,3,66,23,43,67
N'castle Jet,9281,2,15,6,7,58,38,20,51
Melbourne C,9281,3,14,5,10,44,34,10,47
Melbourne V,9281,4,13,5,11,46,40,6,44
Adelaide Utd,9281,5,11,6,11,37,40,-3,39
Brisbane,9281,6,10,5,13,33,42,-9,35
Western Sydn,9281,7,8,9,10,38,47,-9,33
Perth Glory,9281,8,10,2,15,37,50,-13,32
Wellington P,9281,9,5,6,16,31,55,-24,21
CC Mariners,9281,10,4,8,15,28,49,-21,20
Sydney FC,9282,1,21,4,3,65,22,43,67
N'castle Jet,9282,2,15,6,7,58,38,20,51
Melbourne C,9282,3,14,5,10,44,34,10,47
Melbourne V,9282,4,13,5,11,45,39,6,44
Adelaide Utd,9282,5,11,6,11,37,40,-3,39
Brisbane,9282,6,10,5,13,33,42,-9,35
Western Sydn,9282,7,8,9,10,38,47,-9,33
Perth Glory,9282,8,10,2,15,37,50,-13,32
Wellington P,9282,9,5,6,16,31,55,-24,21
CC Mariners,9282,10,4,8,15,28,49,-21,20
Sydney FC,9283,1,20,5,3,65,23,42,65
N'castle Jet,9283,2,16,5,7,58,37,21,53
Melbourne C,9283,3,14,4,11,43,34,9,46
Melbourne V,9283,4,13,6,10,46,39,7,45
Adelaide Utd,9283,5,11,6,11,37,40,-3,39
Brisbane,9283,6,10,5,13,33,42,-9,35
Western Sydn,9283,7,8,9,10,38,47,-9,33
Perth Glory,9283,8,10,2,15,37,50,-13,32
Wellington P,9283,9,5,6,16,31,55,-24,21
CC Mariners,9283,10,4,8,15,28,49,-21,20
Sydney FC,9284,1,20,5,3,65,23,42,65
N'castle Jet,9284,2,16,5,7,61,39,22,53
Melbourne C,9284,3,14,4,11,45,37,8,46
Melbourne V,9284,4,13,6,10,46,39,7,45
Adelaide Utd,9284,5,11,6,11,37,40,-3,39
Brisbane,9284,6,10,5,13,33,42,-9,35
Western Sydn,9284,7,8,9,10,38,47,-9,33
Perth Glory,9284,8,10,2,15,37,50,-13,32
Wellington P,9284,9,5,6,16,31,55,-24,21
CC Mariners,9284,10,4,8,15,28,49,-21,20
Sydney FC,9285,1,21,4,3,70,23,47,67
N'castle Jet,9285,2,16,5,7,61,37,24,53
Melbourne C,9285,3,14,4,11,43,37,6,46
Melbourne V,9285,4,13,5,11,46,44,2,44
Adelaide Utd,9285,5,11,6,11,37,40,-3,39
Brisbane,9285,6,10,5,13,33,42,-9,35
Western Sydn,9285,7,8,9,10,38,47,-9,33
Perth Glory,9285,8,10,2,15,37,50,-13,32
Wellington P,9285,9,5,6,16,31,55,-24,21
CC Mariners,9285,10,4,8,15,28,49,-21,20
Sydney FC,9286,1,21,4,3,67,22,45,67
N'castle Jet,9286,2,15,5,8,57,39,18,50
Melbourne C,9286,3,15,4,10,45,33,12,49
Melbourne V,9286,4,13,5,11,45,41,4,44
Adelaide Utd,9286,5,11,6,11,37,40,-3,39
Brisbane,9286,6,10,5,13,33,42,-9,35
Western Sydn,9286,7,8,9,10,38,47,-9,33
Perth Glory,9286,8,10,2,15,37,50,-13,32
Wellington P,9286,9,5,6,16,31,55,-24,21
CC Mariners,9286,10,4,8,15,28,49,-21,20
Sydney FC,9287,1,21,4,3,67,24,43,67
N'castle Jet,9287,2,16,5,7,60,37,23,53
Melbourne C,9287,3,14,4,11,43,36,7,46
Melbourne V,9287,4,13,5,11,47,41,6,44
Adelaide Utd,9287,5,11,6,11,37,40,-3,39
Brisbane,9287,6,10,5,13,33,42,-9,35
Western Sydn,9287,7,8,9,10,38,47,-9,33
Perth Glory,9287,8,10,2,15,37,50,-13,32
Wellington P,9287,9,5,6,16,31,55,-24,21
CC Mariners,9287,10,4,8,15,28,49,-21,20
Sydney FC,9288,1,21,4,3,69,24,45,67
N'castle Jet,9288,2,15,5,8,57,38,19,50
Melbourne C,9288,3,15,4,10,44,33,11,49
Melbourne V,9288,4,13,5,11,47,43,4,44
Adelaide Utd,9288,5,11,6,11,37,40,-3,39
Brisbane,9288,6,10,5,13,33,42,-9,35
Western Sydn,9288,7,8,9,10,38,47,-9,33
Perth Glory,9288,8,10,2,15,37,50,-13,32
Wellington P,9288,9,5,6,16,31,55,-24,21
CC Mariners,9288,10,4,8,15,28,49,-21,20
Sydney FC,9289,1,21,4,3,66,23,43,67
N'castle Jet,9289,2,15,5,8,58,39,19,50
Melbourne C,9289,3,15,4,10,45,34,11,49
Melbourne V,9289,4,13,5,11,46,40,6,44
Adelaide Utd,9289,5,11,6,11,37,40,-3,39
Brisbane,9289,6,10,5,13,33,42,-9,35
Western Sydn,9289,7,8,9,10,38,47,-9,33
Perth Glory,9289,8,10,2,15,37,50,-13,32
Wellington P,9289,9,5,6,16,31,55,-24,21
CC Mariners,9289,10,4,8,15,28,49,-21,20
Sydney FC,9290,1,21,4,3,67,22,45,67
N'castle Jet,9290,2,16,5,7,61,39,22,53
Melbourne C,9290,3,14,4,11,45,37,8,46
Melbourne V,9290,4,13,5,11,45,41,4,44
Adelaide Utd,9290,5,11,6,11,37,40,-3,39
Brisbane,9290,6,10,5,13,33,42,-9,35
Western Sydn,9290,7,8,9,10,38,47,-9,33
Perth Glory,9290,8,10,2,15,37,50,-13,32
Wellington P,9290,9,5,6,16,31,55,-24,21
CC Mariners,9290,10,4,8,15,28,49,-21,20
Sydney FC,9291,1,21,4,3,67,24,43,67
N'castle Jet,9291,2,15,5,8,57,38,19,50
Melbourne C,9291,3,15,4,10,44,33,11,49
Melbourne V,9291,4,13,5,11,47,41,6,44
Adelaide Utd,9291,5,11,6,11,37,40,-3,39
Brisbane,9291,6,10,5,13,33,42,-9,35
Western Sydn,9291,7,8,9,10,38,47,-9,33
Perth Glory,9291,8,10,2,15,37,50,-13,32
Wellington P,9291,9,5,6,16,31,55,-24,21
CC Mariners,9291,10,4,8,15,28,49,-21,20
Sydney FC,9292,1,21,4,3,66,23,43,67
N'castle Jet,9292,2,16,5,7,59,38,21,53
Melbourne C,9292,3,14,4,11,44,35,9,46
Melbourne V,9292,4,13,5,11,46,40,6,44
Adelaide Utd,9292,5,11,6,11,37,40,-3,39
Brisbane,9292,6,10,5,13,33,42,-9,35
Western Sydn,9292,7,8,9,10,38,47,-9,33
Perth Glory,9292,8,10,2,15,37,50,-13,32
Wellington P,9292,9,5,6,16,31,55,-24,21
CC Mariners,9292,10,4,8,15,28,49,-21,20
Sydney FC,9293,1,20,5,3,65,23,42,65
N'castle Jet,9293,2,16,5,7,59,37,22,53
Melbourne C,9293,3,14,4,11,43,35,8,46
Melbourne V,9293,4,13,6,10,46,39,7,45
Adelaide Utd,9293,5,11,6,11,37,40,-3,39
Brisbane,9293,6,10,5,13,33,42,-9,35
Western Sydn,9293,7,8,9,10,38,47,-9,33
Perth Glory,9293,8,10,2,15,37,50,-13,32
Wellington P,9293,9,5,6,16,31,55,-24,21
CC Mariners,9293,10,4,8,15,28,49,-21,20
Sydney FC,9294,1,21,4,3,66,23,43,67
N'castle Jet,9294,2,15,6,7,57,37,20,51
Melbourne C,9294,3,14,5,10,43,33,10,47
Melbourne V,9294,4,13,5,11,46,40,6,44
Adelaide Utd,9294,5,11,6,11,37,40,-3,39
Brisbane,9294,6,10,5,13,33,42,-9,35
Western Sydn,9294,7,8,9,10,38,47,-9,33
Perth Glory,9294,8,10,2,15,37,50,-13,32
Wellington P,9294,9,5,6,16,31,55,-24,21
CC Mariners,9294,10,4,8,15,28,49,-21,20
Sydney FC,9295,1,21,4,3,66,22,44,67
N'castle Jet,9295,2,16,5,7,61,39,22,53
Melbourne C,9295,3,14,4,11,45,37,8,46
Melbourne V,9295,4,13,5,11,45,40,5,44
Adelaide Utd,9295,5,11,6,11,37,40,-3,39
Brisbane,9295,6,10,5,13,33,42,-9,35
Western Sydn,9295,7,8,9,10,38,47,-9,33
Perth Glory,9295,8,10,2,15,37,50,-13,32
Wellington P,9295,9,5,6,16,31,55,-24,21
CC Mariners,9295,10,4,8,15,28,49,-21,20
Sydney FC,9296,1,21,4,3,67,23,44,67
N'castle Jet,9296,2,16,5,7,58,37,21,53
Melbourne C,9296,3,14,4,11,43,34,9,46
Melbourne V,9296,4,13,5,11,46,41,5,44
Adelaide Utd,9296,5,11,6,11,37,40,-3,39
Brisbane,9296,6,10,5,13,33,42,-9,35
Western Sydn,9296,7,8,9,10,38,47,-9,33
Perth Glory,9296,8,10,2,15,37,50,-13,32
Wellington P,9296,9,5,6,16,31,55,-24,21
CC Mariners,9296,10,4,8,15,28,49,-21,20
Sydney FC,9297,1,20,5,3,64,22,42,65
N'castle Jet,9297,2,15,5,8,57,38,19,50
Melbourne C,9297,3,15,4,10,44,33,11,49
Melbourne V,9297,4,13,6,10,45,38,7,45
Adelaide Utd,9297,5,11,6,11,37,40,-3,39
Brisbane,9297,6,10,5,13,33,42,-9,35
Western Sydn,9297,7,8,9,10,38,47,-9,33
Perth Glory,9297,8,10,2,15,37,50,-13,32
Wellington P,9297,9,5,6,16,31,55,-24,21
CC Mariners,9297,10,4,8,15,28,49,-21,20
Sydney FC,9298,1,21,4,3,67,23,44,67
N'castle Jet,9298,2,15,5,8,59,40,19,50
Melbourne C,9298,3,15,4,10,46,35,11,49
Melbourne V,9298,4,13,5,11,46,41,5,44
Adelaide Utd,9298,5,11,6,11,37,40,-3,39
Brisbane,9298,6,10,5,13,33,42,-9,35
Western Sydn,9298,7,8,9,10,38,47,-9,33
Perth Glory,9298,8,10,2,15,37,50,-13,32
Wellington P,9298,9,5,6,16,31,55,-24,21
CC Mariners,9298,10,4,8,15,28,49,-21,20
Sydney FC,9299,1,21,4,3,66,22,44,67
N'castle Jet,9299,2,16,5,7,60,38,22,53
Melbourne C,9299,3,14,4,11,44,36,8,46
Melbourne V,9299,4,13,5,11,45,40,5,44
Adelaide Utd,9299,5,11,6,11,37,40,-3,39
Brisbane,9299,6,10,5,13,33,42,-9,35
Western Sydn,9299,7,8,9,10,38,47,-9,33
Perth Glory,9299,8,10,2,15,37,50,-13,32
Wellington P,9299,9,5,6,16,31,55,-24,21
CC Mariners,9299,10,4,8,15,28,49,-21,20
Sydney FC,9300,1,20,5,3,66,24,42,65
N'castle Jet,9300,2,15,6,7,59,39,20,51
Melbourne C,9300,3,14,5,10,45,35,10,47
Melbourne V,9300,4,13,6,10,47,40,7,45
Adelaide Utd,9300,5,11,6,11,37,40,-3,39
Brisbane,9300,6,10,5,13,33,42,-9,35
Western Sydn,9300,7,8,9,10,38,47,-9,33
Perth Glory,9300,8,10,2,15,37,50,-13,32
Wellington P,9300,9,5,6,16,31,55,-24,21
CC Mariners,9300,10,4,8,15,28,49,-21,20
Sydney FC,9301,1,20,5,3,64,22,42,65
N'castle Jet,9301,2,16,5,7,58,37,21,53
Melbourne C,9301,3,14,4,11,43,34,9,46
Melbourne V,9301,4,13,6,10,45,38,7,45
Adelaide Utd,9301,5,11,6,11,37,40,-3,39
Brisbane,9301,6,10,5,13,33,42,-9,35
Western Sydn,9301,7,8,9,10,38,47,-9,33
Perth Glory,9301,8,10,2,15,37,50,-13,32
Wellington P,9301,9,5,6,16,31,55,-24,21
CC Mariners,9301,10,4,8,15,28,49,-21,20
Sydney FC,9302,1,20,4,4,64,23,41,64
N'castle Jet,9302,2,16,5,7,59,38,21,53
Melbourne V,9302,3,14,5,10,46,38,8,47
Melbourne C,9302,4,14,4,11,44,35,9,46
Adelaide Utd,9302,5,11,6,11,37,40,-3,39
Brisbane,9302,6,10,5,13,33,42,-9,35
Western Sydn,9302,7,8,9,10,38,47,-9,33
Perth Glory,9302,8,10,2,15,37,50,-13,32
Wellington P,9302,9,5,6,16,31,55,-24,21
CC Mariners,9302,10,4,8,15,28,49,-21,20
Sydney FC,9303,1,21,4,3,67,24,43,67
N'castle Jet,9303,2,15,5,8,58,40,18,50
Melbourne C,9303,3,15,4,10,46,34,12,49
Melbourne V,9303,4,13,5,11,47,41,6,44
Adelaide Utd,9303,5,11,6,11,37,40,-3,39
Brisbane,9303,6,10,5,13,33,42,-9,35
Western Sydn,9303,7,8,9,10,38,47,-9,33
Perth Glory,9303,8,10,2,15,37,50,-13,32
Wellington P,9303,9,5,6,16,31,55,-24,21
CC Mariners,9303,10,4,8,15,28,49,-21,20
Sydney FC,9304,1,20,4,4,64,23,41,64
N'castle Jet,9304,2,16,5,7,58,37,21,53
Melbourne V,9304,3,14,5,10,46,38,8,47
Melbourne C,9304,4,14,4,11,43,34,9,46
Adelaide Utd,9304,5,11,6,11,37,40,-3,39
Brisbane,9304,6,10,5,13,33,42,-9,35
Western Sydn,9304,7,8,9,10,38,47,-9,33
Perth Glory,9304,8,10,2,15,37,50,-13,32
Wellington P,9304,9,5,6,16,31,55,-24,21
CC Mariners,9304,10,4,8,15,28,49,-21,20
Sydney FC,9305,1,21,4,3,66,23,43,67
N'castle Jet,9305,2,16,5,7,60,37,23,53
Melbourne C,9305,3,14,4,11,43,36,7,46
Melbourne V,9305,4,13,5,11,46,40,6,44
Adelaide Utd,9305,5,11,6,11,37,40,-3,39
Brisbane,9305,6,10,5,13,33,42,-9,35
Western Sydn,9305,7,8,9,10,38,47,-9,33
Perth Glory,9305,8,10,2,15,37,50,-13,32
Wellington P,9305,9,5,6,16,31,55,-24,21
CC Mariners,9305,10,4,8,15,28,49,-21,20
Sydney FC,9306,1,21,4,3,67,22,45,67
N'castle Jet,9306,2,16,5,7,59,38,21,53
Melbourne C,9306,3,14,4,11,44,35,9,46
Melbourne V,9306,4,13,5,11,45,41,4,44
Adelaide Utd,9306,5,11,6,11,37,40,-3,39
Brisbane,9306,6,10,5,13,33,42,-9,35
Western Sydn,9306,7,8,9,10,38,47,-9,33
Perth Glory,9306,8,10,2,15,37,50,-13,32
Wellington P,9306,9,5,6,16,31,55,-24,21
CC Mariners,9306,10,4,8,15,28,49,-21,20
Sydney FC,9307,1,20,5,3,66,24,42,65
N'castle Jet,9307,2,16,5,7,61,39,22,53
Melbourne C,9307,3,14,4,11,45,37,8,46
Melbourne V,9307,4,13,6,10,47,40,7,45
Adelaide Utd,9307,5,11,6,11,37,40,-3,39
Brisbane,9307,6,10,5,13,33,42,-9,35
Western Sydn,9307,7,8,9,10,38,47,-9,33
Perth Glory,9307,8,10,2,15,37,50,-13,32
Wellington P,9307,9,5,6,16,31,55,-24,21
CC Mariners,9307,10,4,8,15,28,49,-21,20
Sydney FC,9308,1,20,5,3,65,23,42,65
N'castle Jet,9308,2,15,6,7,58,38,20,51
Melbourne C,9308,3,14,5,10,44,34,10,47
Melbourne V,9308,4,13,6,10,46,39,7,45
Adelaide Utd,9308,5,11,6,11,37,40,-3,39
Brisbane,9308,6,10,5,13,33,42,-9,35
Western Sydn,9308,7,8,9,10,38,47,-9,33
Perth Glory,9308,8,10,2,15,37,50,-13,32
Wellington P,9308,9,5,6,16,31,55,-24,21
CC Mariners,9308,10,4,8,15,28,49,-21,20
Sydney FC,9309,1,21,4,3,66,22,44,67
N'castle Jet,9309,2,15,5,8,57,38,19,50
Melbourne C,9309,3,15,4,10,44,33,11,49
Melbourne V,9309,4,13,5,11,45,40,5,44
Adelaide Utd,9309,5,11,6,11,37,40,-3,39
Brisbane,9309,6,10,5,13,33,42,-9,35
Western Sydn,9309,7,8,9,10,38,47,-9,33
Perth Glory,9309,8,10,2,15,37,50,-13,32
Wellington P,9309,9,5,6,16,31,55,-24,21
CC Mariners,9309,10,4,8,15,28,49,-21,20
Sydney FC,9310,1,20,4,4,64,24,40,64
N'castle Jet,9310,2,16,5,7,60,38,22,53
Melbourne V,9310,3,14,5,10,47,38,9,47
Melbourne C,9310,4,14,4,11,44,36,8,46
Adelaide Utd,9310,5,11,6,11,37,40,-3,39
Brisbane,9310,6,10,5,13,33,42,-9,35
Western Sydn,9310,7,8,9,10,38,47,-9,33
Perth Glory,9310,8,10,2,15,37,50,-13,32
Wellington P,9310,9,5,6,16,31,55,-24,21
CC Mariners,9310,10,4,8,15,28,49,-21,20
Sydney FC,9311,1,21,4,3,67,24,43,67
N'castle Jet,9311,2,16,5,7,59,37,22,53
Melbourne C,9311,3,14,4,11,43,35,8,46
Melbourne V,9311,4,13,5,11,47,41,6,44
Adelaide Utd,9311,5,11,6,11,37,40,-3,39
Brisbane,9311,6,10,5,13,33,42,-9,35
Western Sydn,9311,7,8,9,10,38,47,-9,33
Perth Glory,9311,8,10,2,15,37,50,-13,32
Wellington P,9311,9,5,6,16,31,55,-24,21
CC Mariners,9311,10,4,8,15,28,49,-21,20
Sydney FC,9312,1,21,4,3,67,23,44,67
N'castle Jet,9312,2,15,5,8,58,40,18,50
Melbourne C,9312,3,15,4,10,46,34,12,49
Melbourne V,9312,4,13,5,11,46,41,5,44
Adelaide Utd,9312,5,11,6,11,37,40,-3,39
Brisbane,9312,6,10,5,13,33,42,-9,35
Western Sydn,9312,7,8,9,10,38,47,-9,33
Perth Glory,9312,8,10,2,15,37,50,-13,32
Wellington P,9312,9,5,6,16,31,55,-24,21
CC Mariners,9312,10,4,8,15,28,49,-21,20
Sydney FC,9313,1,21,4,3,65,22,43,67
N'castle Jet,9313,2,16,5,7,60,39,21,53
Melbourne C,9313,3,14,4,11,45,36,9,46
Melbourne V,9313,4,13,5,11,45,39,6,44
Adelaide Utd,9313,5,11,6,11,37,40,-3,39
Brisbane,9313,6,10,5,13,33,42,-9,35
Western Sydn,9313,7,8,9,10,38,47,-9,33
Perth Glory,9313,8,10,2,15,37,50,-13,32
Wellington P,9313,9,5,6,16,31,55,-24,21
CC Mariners,9313,10,4,8,15,28,49,-21,20
Sydney FC,9314,1,20,5,3,64,22,42,65
N'castle Jet,9314,2,16,5,7,59,38,21,53
Melbourne C,9314,3,14,4,11,44,35,9,46
Melbourne V,9314,4,13,6,10,45,38,7,45
Adelaide Utd,9314,5,11,6,11,37,40,-3,39
Brisbane,9314,6,10,5,13,33,42,-9,35
Western Sydn,9314,7,8,9,10,38,47,-9,33
Perth Glory,9314,8,10,2,15,37,50,-13,32
Wellington P,9314,9,5,6,16,31,55,-24,21
CC Mariners,9314,10,4,8,15,28,49,-21,20
Sydney FC,9315,1,20,5,3,65,23,42,65
N'castle Jet,9315,2,16,5,7,59,38,21,53
Melbourne C,9315,3,14,4,11,44,35,9,46
Melbourne V,9315,4,13,6,10,46,39,7,45
Adelaide Utd,9315,5,11,6,11,37,40,-3,39
Brisbane,9315,6,10,5,13,33,42,-9,35
Western Sydn,9315,7,8,9,10,38,47,-9,33
Perth Glory,9315,8,10,2,15,37,50,-13,32
Wellington P,9315,9,5,6,16,31,55,-24,21
CC Mariners,9315,10,4,8,15,28,49,-21,20
Sydney FC,9316,1,20,4,4,64,23,41,64
N'castle Jet,9316,2,16,5,7,60,37,23,53
Melbourne V,9316,3,14,5,10,46,38,8,47
Melbourne C,9316,4,14,4,11,43,36,7,46
Adelaide Utd,9316,5,11,6,11,37,40,-3,39
Brisbane,9316,6,10,5,13,33,42,-9,35
Western Sydn,9316,7,8,9,10,38,47,-9,33
Perth Glory,9316,8,10,2,15,37,50,-13,32
Wellington P,9316,9,5,6,16,31,55,-24,21
CC Mariners,9316,10,4,8,15,28,49,-21,20
Sydney FC,9317,1,21,4,3,67,22,45,67
N'castle Jet,9317,2,16,5,7,59,37,22,53
Melbourne C,9317,3,14,4,11,43,35,8,46
Melbourne V,9317,4,13,5,11,45,41,4,44
Adelaide Utd,9317,5,11,6,11,37,40,-3,39
Brisbane,9317,6,10,5,13,33,42,-9,35
Western Sydn,9317,7,8,9,10,38,47,-9,33
Perth Glory,9317,8,10,2,15,37,50,-13,32
Wellington P,9317,9,5,6,16,31,55,-24,21
CC Mariners,9317,10,4,8,15,28,49,-21,20
Sydney FC,9318,1,21,4,3,66,22,44,67
N'castle Jet,9318,2,15,6,7,59,39,20,51
Melbourne C,9318,3,14,5,10,45,35,10,47
Melbourne V,9318,4,13,5,11,45,40,5,44
Adelaide Utd,9318,5,11,6,11,37,40,-3,39
Brisbane,9318,6,10,5,13,33,42,-9,35
Western Sydn,9318,7,8,9,10,38,47,-9,33
Perth Glory,9318,8,10,2,15,37,50,-13,32
Wellington P,9318,9,5,6,16,31,55,-24,21
CC Mariners,9318,10,4,8,15,28,49,-21,20
Sydney FC,9319,1,20,4,4,65,25,40,64
N'castle Jet,9319,2,15,5,8,60,41,19,50
Melbourne C,9319,3,15,4,10,47,36,11,49
Melbourne V,9319,4,14,5,10,48,39,9,47
Adelaide Utd,9319,5,11,6,11,37,40,-3,39
Brisbane,9319,6,10,5,13,33,42,-9,35
Western Sydn,9319,7,8,9,10,38,47,-9,33
Perth Glory,9319,8,10,2,15,37,50,-13,32
Wellington P,9319,9,5,6,16,31,55,-24,21
CC Mariners,9319,10,4,8,15,28,49,-21,20
Sydney FC,9320,1,20,4,4,64,23,41,64
N'castle Jet,9320,2,16,5,7,63,40,23,53
Melbourne V,9320,3,14,5,10,46,38,8,47
Melbourne C,9320,4,14,4,11,46,39,7,46
Adelaide Utd,9320,5,11,6,11,37,40,-3,39
Brisbane,9320,6,10,5,13,33,42,-9,35
Western Sydn,9320,7,8,9,10,38,47,-9,33
Perth Glory,9320,8,10,2,15,37,50,-13,32
Wellington P,9320,9,5,6,16,31,55,-24,21
CC Mariners,9320,10,4,8,15,28,49,-21,20
Sydney FC,9321,1,20,4,4,65,24,41,64
N'castle Jet,9321,2,16,5,7,60,38,22,53
Melbourne V,9321,3,14,5,10,47,39,8,47
Melbourne C,9321,4,14,4,11,44,36,8,46
Adelaide Utd,9321,5,11,6,11,37,40,-3,39
Brisbane,9321,6,10,5,13,33,42,-9,35
Western Sydn,9321,7,8,9,10,38,47,-9,33
Perth Glory,9321,8,10,2,15,37,50,-13,32
Wellington P,9321,9,5,6,16,31,55,-24,21
CC Mariners,9321,10,4,8,15,28,49,-21,20
Sydney FC,9322,1,20,5,3,65,23,42,65
N'castle Jet,9322,2,16,5,7,61,37,24,53
Melbourne C,9322,3,14,4,11,43,37,6,46
Melbourne V,9322,4,13,6,10,46,39,7,45
Adelaide Utd,9322,5,11,6,11,37,40,-3,39
Brisbane,9322,6,10,5,13,33,42,-9,35
Western Sydn,9322,7,8,9,10,38,47,-9,33
Perth Glory,9322,8,10,2,15,37,50,-13,32
Wellington P,9322,9,5,6,16,31,55,-24,21
CC Mariners,9322,10,4,8,15,28,49,-21,20
Sydney FC,9323,1,21,4,3,65,22,43,67
N'castle Jet,9323,2,15,6,7,58,38,20,51
Melbourne C,9323,3,14,5,10,44,34,10,47
Melbourne V,9323,4,13,5,11,45,39,6,44
Adelaide Utd,9323,5,11,6,11,37,40,-3,39
Brisbane,9323,6,10,5,13,33,42,-9,35
Western Sydn,9323,7,8,9,10,38,47,-9,33
Perth Glory,9323,8,10,2,15,37,50,-13,32
Wellington P,9323,9,5,6,16,31,55,-24,21
CC Mariners,9323,10,4,8,15,28,49,-21,20
Sydney FC,9324,1,21,4,3,66,22,44,67
N'castle Jet,9324,2,15,5,8,57,38,19,50
Melbourne C,9324,3,15,4,10,44,33,11,49
Melbourne V,9324,4,13,5,11,45,40,5,44
Adelaide Utd,9324,5,11,6,11,37,40,-3,39
Brisbane,9324,6,10,5,13,33,42,-9,35
Western Sydn,9324,7,8,9,10,38,47,-9,33
Perth Glory,9324,8,10,2,15,37,50,-13,32
Wellington P,9324,9,5,6,16,31,55,-24,21
CC Mariners,9324,10,4,8,15,28,49,-21,20
Sydney FC,9325,1,21,4,3,67,22,45,67
N'castle Jet,9325,2,16,5,7,60,37,23,53
Melbourne C,9325,3,14,4,11,43,36,7,46
Melbourne V,9325,4,13,5,11,45,41,4,44
Adelaide Utd,9325,5,11,6,11,37,40,-3,39
Brisbane,9325,6,10,5,13,33,42,-9,35
Western Sydn,9325,7,8,9,10,38,47,-9,33
Perth Glory,9325,8,10,2,15,37,50,-13,32
Wellington P,9325,9,5,6,16,31,55,-24,21
CC Mariners,9325,10,4,8,15,28,49,-21,20
Sydney FC,9326,1,20,4,4,64,23,41,64
N'castle Jet,9326,2,16,5,7,59,38,21,53
Melbourne V,9326,3,14,5,10,46,38,8,47
Melbourne C,9326,4,14,4,11,44,35,9,46
Adelaide Utd,9326,5,11,6,11,37,40,-3,39
Brisbane,9326,6,10,5,13,33,42,-9,35
Western Sydn,9326,7,8,9,10,38,47,-9,33
Perth Glory,9326,8,10,2,15,37,50,-13,32
Wellington P,9326,9,5,6,16,31,55,-24,21
CC Mariners,9326,10,4,8,15,28,49,-21,20
Sydney FC,9327,1,21,4,3,68,22,46,67
N'castle Jet,9327,2,16,5,7,59,38,21,53
Melbourne C,9327,3,14,4,11,44,35,9,46
Melbourne V,9327,4,13,5,11,45,42,3,44
Adelaide Utd,9327,5,11,6,11,37,40,-3,39
Brisbane,9327,6,10,5,13,33,42,-9,35
Western Sydn,9327,7,8,9,10,38,47,-9,33
Perth Glory,9327,8,10,2,15,37,50,-13,32
Wellington P,9327,9,5,6,16,31,55,-24,21
CC Mariners,9327,10,4,8,15,28,49,-21,20
Sydney FC,9328,1,20,5,3,65,23,42,65
N'castle Jet,9328,2,16,5,7,60,39,21,53
Melbourne C,9328,3,14,4,11,45,36,9,46
Melbourne V,9328,4,13,6,10,46,39,7,45
Adelaide Utd,9328,5,11,6,11,37,40,-3,39
Brisbane,9328,6,10,5,13,33,42,-9,35
Western Sydn,9328,7,8,9,10,38,47,-9,33
Perth Glory,9328,8,10,2,15,37,50,-13,32
Wellington P,9328,9,5,6,16,31,55,-24,21
CC Mariners,9328,10,4,8,15,28,49,-21,20
Sydney FC,9329,1,20,5,3,65,23,42,65
N'castle Jet,9329,2,16,5,7,59,37,22,53
Melbourne C,9329,3,14,4,11,43,35,8,46
Melbourne V,9329,4,13,6,10,46,39,7,45
Adelaide Utd,9329,5,11,6,11,37,40,-3,39
Brisbane,9329,6,10,5,13,33,42,-9,35
Western Sydn,9329,7,8,9,10,38,47,-9,33
Perth Glory,9329,8,10,2,15,37,50,-13,32
Wellington P,9329,9,5,6,16,31,55,-24,21
CC Mariners,9329,10,4,8,15,28,49,-21,20
Sydney FC,9330,1,21,4,3,67,22,45,67
N'castle Jet,9330,2,15,6,7,60,40,20,51
Melbourne C,9330,3,14,5,10,46,36,10,47
Melbourne V,9330,4,13,5,11,45,41,4,44
Adelaide Utd,9330,5,11,6,11,37,40,-3,39
Brisbane,9330,6,10,5,13,33,42,-9,35
Western Sydn,9330,7,8,9,10,38,47,-9,33
Perth Glory,9330,8,10,2,15,37,50,-13,32
Wellington P,9330,9,5,6,16,31,55,-24,21
CC Mariners,9330,10,4,8,15,28,49,-21,20
Sydney FC,9331,1,20,5,3,65,23,42,65
N'castle Jet,9331,2,16,5,7,59,38,21,53
Melbourne C,9331,3,14,4,11,44,35,9,46
Melbourne V,9331,4,13,6,10,46,39,7,45
Adelaide Utd,9331,5,11,6,11,37,40,-3,39
Brisbane,9331,6,10,5,13,33,42,-9,35
Western Sydn,9331,7,8,9,10,38,47,-9,33
Perth Glory,9331,8,10,2,15,37,50,-13,32
Wellington P,9331,9,5,6,16,31,55,-24,21
CC Mariners,9331,10,4,8,15,28,49,-21,20
Sydney FC,9332,1,21,4,3,67,22,45,67
N'castle Jet,9332,2,16,5,7,61,39,22,53
Melbourne C,9332,3,14,4,11,45,37,8,46
Melbourne V,9332,4,13,5,11,45,41,4,44
Adelaide Utd,9332,5,11,6,11,37,40,-3,39
Brisbane,9332,6,10,5,13,33,42,-9,35
Western Sydn,9332,7,8,9,10,38,47,-9,33
Perth Glory,9332,8,10,2,15,37,50,-13,32
Wellington P,9332,9,5,6,16,31,55,-24,21
CC Mariners,9332,10,4,8,15,28,49,-21,20
Sydney FC,9333,1,21,4,3,67,23,44,67
N'castle Jet,9333,2,16,5,7,59,38,21,53
Melbourne C,9333,3,14,4,11,44,35,9,46
Melbourne V,9333,4,13,5,11,46,41,5,44
Adelaide Utd,9333,5,11,6,11,37,40,-3,39
Brisbane,9333,6,10,5,13,33,42,-9,35
Western Sydn,9333,7,8,9,10,38,47,-9,33
Perth Glory,9333,8,10,2,15,37,50,-13,32
Wellington P,9333,9,5,6,16,31,55,-24,21
CC Mariners,9333,10,4,8,15,28,49,-21,20
Sydney FC,9334,1,20,4,4,64,24,40,64
N'castle Jet,9334,2,15,6,7,58,38,20,51
Melbourne C,9334,3,14,5,10,44,34,10,47
Melbourne V,9334,4,14,5,10,47,38,9,47
Adelaide Utd,9334,5,11,6,11,37,40,-3,39
Brisbane,9334,6,10,5,13,33,42,-9,35
Western Sydn,9334,7,8,9,10,38,47,-9,33
Perth Glory,9334,8,10,2,15,37,50,-13,32
Wellington P,9334,9,5,6,16,31,55,-24,21
CC Mariners,9334,10,4,8,15,28,49,-21,20
Sydney FC,9335,1,21,4,3,66,23,43,67
N'castle Jet,9335,2,16,5,7,60,39,21,53
Melbourne C,9335,3,14,4,11,45,36,9,46
Melbourne V,9335,4,13,5,11,46,40,6,44
Adelaide Utd,9335,5,11,6,11,37,40,-3,39
Brisbane,9335,6,10,5,13,33,42,-9,35
Western Sydn,9335,7,8,9,10,38,47,-9,33
Perth Glory,9335,8,10,2,15,37,50,-13,32
Wellington P,9335,9,5,6,16,31,55,-24,21
CC Mariners,9335,10,4,8,15,28,49,-21,20
Sydney FC,9336,1,21,4,3,70,22,48,67
N'castle Jet,9336,2,16,5,7,63,37,26,53
Melbourne C,9336,3,14,4,11,43,39,4,46
Melbourne V,9336,4,13,5,11,45,44,1,44
Adelaide Utd,9336,5,11,6,11,37,40,-3,39
Brisbane,9336,6,10,5,13,33,42,-9,35
Western Sydn,9336,7,8,9,10,38,47,-9,33
Perth Glory,9336,8,10,2,15,37,50,-13,32
Wellington P,9336,9,5,6,16,31,55,-24,21
CC Mariners,9336,10,4,8,15,28,49,-21,20
Sydney FC,9337,1,20,5,3,64,22,42,65
N'castle Jet,9337,2,15,5,8,58,39,19,50
Melbourne C,9337,3,15,4,10,45,34,11,49
Melbourne V,9337,4,13,6,10,45,38,7,45
Adelaide Utd,9337,5,11,6,11,37,40,-3,39
Brisbane,9337,6,10,5,13,33,42,-9,35
Western Sydn,9337,7,8,9,10,38,47,-9,33
Perth Glory,9337,8,10,2,15,37,50,-13,32
Wellington P,9337,9,5,6,16,31,55,-24,21
CC Mariners,9337,10,4,8,15,28,49,-21,20
Sydney FC,9338,1,20,5,3,67,25,42,65
N'castle Jet,9338,2,16,5,7,60,37,23,53
Melbourne C,9338,3,14,4,11,43,36,7,46
Melbourne V,9338,4,13,6,10,48,41,7,45
Adelaide Utd,9338,5,11,6,11,37,40,-3,39
Brisbane,9338,6,10,5,13,33,42,-9,35
Western Sydn,9338,7,8,9,10,38,47,-9,33
Perth Glory,9338,8,10,2,15,37,50,-13,32
Wellington P,9338,9,5,6,16,31,55,-24,21
CC Mariners,9338,10,4,8,15,28,49,-21,20
Sydney FC,9339,1,21,4,3,66,23,43,67
N'castle Jet,9339,2,16,5,7,62,38,24,53
Melbourne C,9339,3,14,4,11,44,38,6,46
Melbourne V,9339,4,13,5,11,46,40,6,44
Adelaide Utd,9339,5,11,6,11,37,40,-3,39
Brisbane,9339,6,10,5,13,33,42,-9,35
Western Sydn,9339,7,8,9,10,38,47,-9,33
Perth Glory,9339,8,10,2,15,37,50,-13,32
Wellington P,9339,9,5,6,16,31,55,-24,21
CC Mariners,9339,10,4,8,15,28,49,-21,20
Sydney FC,9340,1,20,5,3,66,24,42,65
N'castle Jet,9340,2,16,5,7,58,37,21,53
Melbourne C,9340,3,14,4,11,43,34,9,46
Melbourne V,9340,4,13,6,10,47,40,7,45
Adelaide Utd,9340,5,11,6,11,37,40,-3,39
Brisbane,9340,6,10,5,13,33,42,-9,35
Western Sydn,9340,7,8,9,10,38,47,-9,33
Perth Glory,9340,8,10,2,15,37,50,-13,32
Wellington P,9340,9,5,6,16,31,55,-24,21
CC Mariners,9340,10,4,8,15,28,49,-21,20
Sydney FC,9341,1,21,4,3,66,23,43,67
N'castle Jet,9341,2,16,5,7,60,37,23,53
Melbourne C,9341,3,14,4,11,43,36,7,46
Melbourne V,9341,4,13,5,11,46,40,6,44
Adelaide Utd,9341,5,11,6,11,37,40,-3,39
Brisbane,9341,6,10,5,13,33,42,-9,35
Western Sydn,9341,7,8,9,10,38,47,-9,33
Perth Glory,9341,8,10,2,15,37,50,-13,32
Wellington P,9341,9,5,6,16,31,55,-24,21
CC Mariners,9341,10,4,8,15,28,49,-21,20
Sydney FC,9342,1,20,5,3,64,22,42,65
N'castle Jet,9342,2,15,5,8,57,38,19,50
Melbourne C,9342,3,15,4,10,44,33,11,49
Melbourne V,9342,4,13,6,10,45,38,7,45
Adelaide Utd,9342,5,11,6,11,37,40,-3,39
Brisbane,9342,6,10,5,13,33,42,-9,35
Western Sydn,9342,7,8,9,10,38,47,-9,33
Perth Glory,9342,8,10,2,15,37,50,-13,32
Wellington P,9342,9,5,6,16,31,55,-24,21
CC Mariners,9342,10,4,8,15,28,49,-21,20
Sydney FC,9343,1,21,4,3,65,22,43,67
N'castle Jet,9343,2,16,5,7,62,37,25,53
Melbourne C,9343,3,14,4,11,43,38,5,46
Melbourne V,9343,4,13,5,11,45,39,6,44
Adelaide Utd,9343,5,11,6,11,37,40,-3,39
Brisbane,9343,6,10,5,13,33,42,-9,35
Western Sydn,9343,7,8,9,10,38,47,-9,33
Perth Glory,9343,8,10,2,15,37,50,-13,32
Wellington P,9343,9,5,6,16,31,55,-24,21
CC Mariners,9343,10,4,8,15,28,49,-21,20
Sydney FC,9344,1,21,4,3,66,22,44,67
N'castle Jet,9344,2,16,5,7,60,38,22,53
Melbourne C,9344,3,14,4,11,44,36,8,46
Melbourne V,9344,4,13,5,11,45,40,5,44
Adelaide Utd,9344,5,11,6,11,37,40,-3,39
Brisbane,9344,6,10,5,13,33,42,-9,35
Western Sydn,9344,7,8,9,10,38,47,-9,33
Perth Glory,9344,8,10,2,15,37,50,-13,32
Wellington P,9344,9,5,6,16,31,55,-24,21
CC Mariners,9344,10,4,8,15,28,49,-21,20
Sydney FC,9345,1,20,5,3,65,23,42,65
N'castle Jet,9345,2,15,5,8,58,41,17,50
Melbourne C,9345,3,15,4,10,47,34,13,49
Melbourne V,9345,4,13,6,10,46,39,7,45
Adelaide Utd,9345,5,11,6,11,37,40,-3,39
Brisbane,9345,6,10,5,13,33,42,-9,35
Western Sydn,9345,7,8,9,10,38,47,-9,33
Perth Glory,9345,8,10,2,15,37,50,-13,32
Wellington P,9345,9,5,6,16,31,55,-24,21
CC Mariners,9345,10,4,8,15,28,49,-21,20
Sydney FC,9346,1,21,4,3,67,22,45,67
N'castle Jet,9346,2,16,5,7,58,37,21,53
Melbourne C,9346,3,14,4,11,43,34,9,46
Melbourne V,9346,4,13,5,11,45,41,4,44
Adelaide Utd,9346,5,11,6,11,37,40,-3,39
Brisbane,9346,6,10,5,13,33,42,-9,35
Western Sydn,9346,7,8,9,10,38,47,-9,33
Perth Glory,9346,8,10,2,15,37,50,-13,32
Wellington P,9346,9,5,6,16,31,55,-24,21
CC Mariners,9346,10,4,8,15,28,49,-21,20
Sydney FC,9347,1,20,5,3,65,23,42,65
N'castle Jet,9347,2,15,6,7,58,38,20,51
Melbourne C,9347,3,14,5,10,44,34,10,47
Melbourne V,9347,4,13,6,10,46,39,7,45
Adelaide Utd,9347,5,11,6,11,37,40,-3,39
Brisbane,9347,6,10,5,13,33,42,-9,35
Western Sydn,9347,7,8,9,10,38,47,-9,33
Perth Glory,9347,8,10,2,15,37,50,-13,32
Wellington P,9347,9,5,6,16,31,55,-24,21
CC Mariners,9347,10,4,8,15,28,49,-21,20
Sydney FC,9348,1,20,4,4,65,24,41,64
N'castle Jet,9348,2,15,6,7,59,39,20,51
Melbourne C,9348,3,14,5,10,45,35,10,47
Melbourne V,9348,4,14,5,10,47,39,8,47
Adelaide Utd,9348,5,11,6,11,37,40,-3,39
Brisbane,9348,6,10,5,13,33,42,-9,35
Western Sydn,9348,7,8,9,10,38,47,-9,33
Perth Glory,9348,8,10,2,15,37,50,-13,32
Wellington P,9348,9,5,6,16,31,55,-24,21
CC Mariners,9348,10,4,8,15,28,49,-21,20
Sydney FC,9349,1,21,4,3,67,23,44,67
N'castle Jet,9349,2,15,5,8,57,39,18,50
Melbourne C,9349,3,15,4,10,45,33,12,49
Melbourne V,9349,4,13,5,11,46,41,5,44
Adelaide Utd,9349,5,11,6,11,37,40,-3,39
Brisbane,9349,6,10,5,13,33,42,-9,35
Western Sydn,9349,7,8,9,10,38,47,-9,33
Perth Glory,9349,8,10,2,15,37,50,-13,32
Wellington P,9349,9,5,6,16,31,55,-24,21
CC Mariners,9349,10,4,8,15,28,49,-21,20
Sydney FC,9350,1,20,5,3,65,23,42,65
N'castle Jet,9350,2,16,5,7,61,38,23,53
Melbourne C,9350,3,14,4,11,44,37,7,46
Melbourne V,9350,4,13,6,10,46,39,7,45
Adelaide Utd,9350,5,11,6,11,37,40,-3,39
Brisbane,9350,6,10,5,13,33,42,-9,35
Western Sydn,9350,7,8,9,10,38,47,-9,33
Perth Glory,9350,8,10,2,15,37,50,-13,32
Wellington P,9350,9,5,6,16,31,55,-24,21
CC Mariners,9350,10,4,8,15,28,49,-21,20
Sydney FC,9351,1,20,4,4,66,25,41,64
N'castle Jet,9351,2,15,5,8,58,39,19,50
Melbourne C,9351,3,15,4,10,45,34,11,49
Melbourne V,9351,4,14,5,10,48,40,8,47
Adelaide Utd,9351,5,11,6,11,37,40,-3,39
Brisbane,9351,6,10,5,13,33,42,-9,35
Western Sydn,9351,7,8,9,10,38,47,-9,33
Perth Glory,9351,8,10,2,15,37,50,-13,32
Wellington P,9351,9,5,6,16,31,55,-24,21
CC Mariners,9351,10,4,8,15,28,49,-21,20
Sydney FC,9352,1,21,4,3,65,22,43,67
N'castle Jet,9352,2,15,5,8,59,42,17,50
Melbourne C,9352,3,15,4,10,48,35,13,49
Melbourne V,9352,4,13,5,11,45,39,6,44
Adelaide Utd,9352,5,11,6,11,37,40,-3,39
Brisbane,9352,6,10,5,13,33,42,-9,35
Western Sydn,9352,7,8,9,10,38,47,-9,33
Perth Glory,9352,8,10,2,15,37,50,-13,32
Wellington P,9352,9,5,6,16,31,55,-24,21
CC Mariners,9352,10,4,8,15,28,49,-21,20
Sydney FC,9353,1,20,5,3,65,23,42,65
N'castle Jet,9353,2,15,6,7,59,39,20,51
Melbourne C,9353,3,14,5,10,45,35,10,47
Melbourne V,9353,4,13,6,10,46,39,7,45
Adelaide Utd,9353,5,11,6,11,37,40,-3,39
Brisbane,9353,6,10,5,13,33,42,-9,35
Western Sydn,9353,7,8,9,10,38,47,-9,33
Perth Glory,9353,8,10,2,15,37,50,-13,32
Wellington P,9353,9,5,6,16,31,55,-24,21
CC Mariners,9353,10,4,8,15,28,49,-21,20
Sydney FC,9354,1,20,5,3,66,24,42,65
N'castle Jet,9354,2,15,6,7,58,38,20,51
Melbourne C,9354,3,14,5,10,44,34,10,47
Melbourne V,9354,4,13,6,10,47,40,7,45
Adelaide Utd,9354,5,11,6,11,37,40,-3,39
Brisbane,9354,6,10,5,13,33,42,-9,35
Western Sydn,9354,7,8,9,10,38,47,-9,33
Perth Glory,9354,8,10,2,15,37,50,-13,32
Wellington P,9354,9,5,6,16,31,55,-24,21
CC Mariners,9354,10,4,8,15,28,49,-21,20
Sydney FC,9355,1,21,4,3,67,22,45,67
N'castle Jet,9355,2,16,5,7,60,37,23,53
Melbourne C,9355,3,14,4,11,43,36,7,46
Melbourne V,9355,4,13,5,11,45,41,4,44
Adelaide Utd,9355,5,11,6,11,37,40,-3,39
Brisbane,9355,6,10,5,13,33,42,-9,35
Western Sydn,9355,7,8,9,10,38,47,-9,33
Perth Glory,9355,8,10,2,15,37,50,-13,32
Wellington P,9355,9,5,6,16,31,55,-24,21
CC Mariners,9355,10,4,8,15,28,49,-21,20
Sydney FC,9356,1,20,5,3,65,23,42,65
N'castle Jet,9356,2,15,6,7,60,40,20,51
Melbourne C,9356,3,14,5,10,46,36,10,47
Melbourne V,9356,4,13,6,10,46,39,7,45
Adelaide Utd,9356,5,11,6,11,37,40,-3,39
Brisbane,9356,6,10,5,13,33,42,-9,35
Western Sydn,9356,7,8,9,10,38,47,-9,33
Perth Glory,9356,8,10,2,15,37,50,-13,32
Wellington P,9356,9,5,6,16,31,55,-24,21
CC Mariners,9356,10,4,8,15,28,49,-21,20
Sydney FC,9357,1,21,4,3,65,22,43,67
N'castle Jet,9357,2,15,5,8,57,39,18,50
Melbourne C,9357,3,15,4,10,45,33,12,49
Melbourne V,9357,4,13,5,11,45,39,6,44
Adelaide Utd,9357,5,11,6,11,37,40,-3,39
Brisbane,9357,6,10,5,13,33,42,-9,35
Western Sydn,9357,7,8,9,10,38,47,-9,33
Perth Glory,9357,8,10,2,15,37,50,-13,32
Wellington P,9357,9,5,6,16,31,55,-24,21
CC Mariners,9357,10,4,8,15,28,49,-21,20
Sydney FC,9358,1,21,4,3,68,23,45,67
N'castle Jet,9358,2,15,5,8,57,38,19,50
Melbourne C,9358,3,15,4,10,44,33,11,49
Melbourne V,9358,4,13,5,11,46,42,4,44
Adelaide Utd,9358,5,11,6,11,37,40,-3,39
Brisbane,9358,6,10,5,13,33,42,-9,35
Western Sydn,9358,7,8,9,10,38,47,-9,33
Perth Glory,9358,8,10,2,15,37,50,-13,32
Wellington P,9358,9,5,6,16,31,55,-24,21
CC Mariners,9358,10,4,8,15,28,49,-21,20
Sydney FC,9359,1,21,4,3,66,22,44,67
N'castle Jet,9359,2,16,5,7,58,37,21,53
Melbourne C,9359,3,14,4,11,43,34,9,46
Melbourne V,9359,4,13,5,11,45,40,5,44
Adelaide Utd,9359,5,11,6,11,37,40,-3,39
Brisbane,9359,6,10,5,13,33,42,-9,35
Western Sydn,9359,7,8,9,10,38,47,-9,33
Perth Glory,9359,8,10,2,15,37,50,-13,32
Wellington P,9359,9,5,6,16,31,55,-24,21
CC Mariners,9359,10,4,8,15,28,49,-21,20
Sydney FC,9360,1,20,4,4,65,24,41,64
N'castle Jet,9360,2,16,5,7,60,37,23,53
Melbourne V,9360,3,14,5,10,47,39,8,47
Melbourne C,9360,4,14,4,11,43,36,7,46
Adelaide Utd,9360,5,11,6,11,37,40,-3,39
Brisbane,9360,6,10,5,13,33,42,-9,35
Western Sydn,9360,7,8,9,10,38,47,-9,33
Perth Glory,9360,8,10,2,15,37,50,-13,32
Wellington P,9360,9,5,6,16,31,55,-24,21
CC Mariners,9360,10,4,8,15,28,49,-21,20
Sydney FC,9361,1,21,4,3,65,22,43,67
N'castle Jet,9361,2,16,5,7,59,37,22,53
Melbourne C,9361,3,14,4,11,43,35,8,46
Melbourne V,9361,4,13,5,11,45,39,6,44
Adelaide Utd,9361,5,11,6,11,37,40,-3,39
Brisbane,9361,6,10,5,13,33,42,-9,35
Western Sydn,9361,7,8,9,10,38,47,-9,33
Perth Glory,9361,8,10,2,15,37,50,-13,32
Wellington P,9361,9,5,6,16,31,55,-24,21
CC Mariners,9361,10,4,8,15,28,49,-21,20
Sydney FC,9362,1,20,4,4,66,25,41,64
N'castle Jet,9362,2,16,5,7,59,38,21,53
Melbourne V,9362,3,14,5,10,48,40,8,47
Melbourne C,9362,4,14,4,11,44,35,9,46
Adelaide Utd,9362,5,11,6,11,37,40,-3,39
Brisbane,9362,6,10,5,13,33,42,-9,35
Western Sydn,9362,7,8,9,10,38,47,-9,33
Perth Glory,9362,8,10,2,15,37,50,-13,32
Wellington P,9362,9,5,6,16,31,55,-24,21
CC Mariners,9362,10,4,8,15,28,49,-21,20
Sydney FC,9363,1,21,4,3,67,23,44,67
N'castle Jet,9363,2,15,5,8,59,40,19,50
Melbourne C,9363,3,15,4,10,46,35,11,49
Melbourne V,9363,4,13,5,11,46,41,5,44
Adelaide Utd,9363,5,11,6,11,37,40,-3,39
Brisbane,9363,6,10,5,13,33,42,-9,35
Western Sydn,9363,7,8,9,10,38,47,-9,33
Perth Glory,9363,8,10,2,15,37,50,-13,32
Wellington P,9363,9,5,6,16,31,55,-24,21
CC Mariners,9363,10,4,8,15,28,49,-21,20
Sydney FC,9364,1,20,5,3,65,23,42,65
N'castle Jet,9364,2,16,5,7,60,38,22,53
Melbourne C,9364,3,14,4,11,44,36,8,46
Melbourne V,9364,4,13,6,10,46,39,7,45
Adelaide Utd,9364,5,11,6,11,37,40,-3,39
Brisbane,9364,6,10,5,13,33,42,-9,35
Western Sydn,9364,7,8,9,10,38,47,-9,33
Perth Glory,9364,8,10,2,15,37,50,-13,32
Wellington P,9364,9,5,6,16,31,55,-24,21
CC Mariners,9364,10,4,8,15,28,49,-21,20
Sydney FC,9365,1,21,4,3,66,22,44,67
N'castle Jet,9365,2,16,5,7,64,37,27,53
Melbourne C,9365,3,14,4,11,43,40,3,46
Melbourne V,9365,4,13,5,11,45,40,5,44
Adelaide Utd,9365,5,11,6,11,37,40,-3,39
Brisbane,9365,6,10,5,13,33,42,-9,35
Western Sydn,9365,7,8,9,10,38,47,-9,33
Perth Glory,9365,8,10,2,15,37,50,-13,32
Wellington P,9365,9,5,6,16,31,55,-24,21
CC Mariners,9365,10,4,8,15,28,49,-21,20
Sydney FC,9366,1,21,4,3,67,22,45,67
N'castle Jet,9366,2,15,6,7,58,38,20,51
Melbourne C,9366,3,14,5,10,44,34,10,47
Melbourne V,9366,4,13,5,11,45,41,4,44
Adelaide Utd,9366,5,11,6,11,37,40,-3,39
Brisbane,9366,6,10,5,13,33,42,-9,35
Western Sydn,9366,7,8,9,10,38,47,-9,33
Perth Glory,9366,8,10,2,15,37,50,-13,32
Wellington P,9366,9,5,6,16,31,55,-24,21
CC Mariners,9366,10,4,8,15,28,49,-21,20
Sydney FC,9367,1,21,4,3,67,22,45,67
N'castle Jet,9367,2,15,6,7,58,38,20,51
Melbourne C,9367,3,14,5,10,44,34,10,47
Melbourne V,9367,4,13,5,11,45,41,4,44
Adelaide Utd,9367,5,11,6,11,37,40,-3,39
Brisbane,9367,6,10,5,13,33,42,-9,35
Western Sydn,9367,7,8,9,10,38,47,-9,33
Perth Glory,9367,8,10,2,15,37,50,-13,32
Wellington P,9367,9,5,6,16,31,55,-24,21
CC Mariners,9367,10,4,8,15,28,49,-21,20
Sydney FC,9368,1,21,4,3,66,23,43,67
N'castle Jet,9368,2,15,6,7,58,38,20,51
Melbourne C,9368,3,14,5,10,44,34,10,47
Melbourne V,9368,4,13,5,11,46,40,6,44
Adelaide Utd,9368,5,11,6,11,37,40,-3,39
Brisbane,9368,6,10,5,13,33,42,-9,35
Western Sydn,9368,7,8,9,10,38,47,-9,33
Perth Glory,9368,8,10,2,15,37,50,-13,32
Wellington P,9368,9,5,6,16,31,55,-24,21
CC Mariners,9368,10,4,8,15,28,49,-21,20
Sydney FC,9369,1,21,4,3,65,22,43,67
N'castle Jet,9369,2,16,5,7,59,38,21,53
Melbourne C,9369,3,14,4,11,44,35,9,46
Melbourne V,9369,4,13,5,11,45,39,6,44
Adelaide Utd,9369,5,11,6,11,37,40,-3,39
Brisbane,9369,6,10,5,13,33,42,-9,35
Western Sydn,9369,7,8,9,10,38,47,-9,33
Perth Glory,9369,8,10,2,15,37,50,-13,32
Wellington P,9369,9,5,6,16,31,55,-24,21
CC Mariners,9369,10,4,8,15,28,49,-21,20
Sydney FC,9370,1,21,4,3,68,22,46,67
N'castle Jet,9370,2,15,5,8,59,41,18,50
Melbourne C,9370,3,15,4,10,47,35,12,49
Melbourne V,9370,4,13,5,11,45,42,3,44
Adelaide Utd,9370,5,11,6,11,37,40,-3,39
Brisbane,9370,6,10,5,13,33,42,-9,35
Western Sydn,9370,7,8,9,10,38,47,-9,33
Perth Glory,9370,8,10,2,15,37,50,-13,32
Wellington P,9370,9,5,6,16,31,55,-24,21
CC Mariners,9370,10,4,8,15,28,49,-21,20
Sydney FC,9371,1,21,4,3,66,23,43,67
N'castle Jet,9371,2,16,5,7,58,37,21,53
Melbourne C,9371,3,14,4,11,43,34,9,46
Melbourne V,9371,4,13,5,11,46,40,6,44
Adelaide Utd,9371,5,11,6,11,37,40,-3,39
Brisbane,9371,6,10,5,13,33,42,-9,35
Western Sydn,9371,7,8,9,10,38,47,-9,33
Perth Glory,9371,8,10,2,15,37,50,-13,32
Wellington P,9371,9,5,6,16,31,55,-24,21
CC Mariners,9371,10,4,8,15,28,49,-21,20
Sydney FC,9372,1,20,5,3,65,23,42,65
N'castle Jet,9372,2,15,5,8,58,39,19,50
Melbourne C,9372,3,15,4,10,45,34,11,49
Melbourne V,9372,4,13,6,10,46,39,7,45
Adelaide Utd,9372,5,11,6,11,37,40,-3,39
Brisbane,9372,6,10,5,13,33,42,-9,35
Western Sydn,9372,7,8,9,10,38,47,-9,33
Perth Glory,9372,8,10,2,15,37,50,-13,32
Wellington P,9372,9,5,6,16,31,55,-24,21
CC Mariners,9372,10,4,8,15,28,49,-21,20
Sydney FC,9373,1,20,5,3,66,24,42,65
N'castle Jet,9373,2,15,6,7,58,38,20,51
Melbourne C,9373,3,14,5,10,44,34,10,47
Melbourne V,9373,4,13,6,10,47,40,7,45
Adelaide Utd,9373,5,11,6,11,37,40,-3,39
Brisbane,9373,6,10,5,13,33,42,-9,35
Western Sydn,9373,7,8,9,10,38,47,-9,33
Perth Glory,9373,8,10,2,15,37,50,-13,32
Wellington P,9373,9,5,6,16,31,55,-24,21
CC Mariners,9373,10,4,8,15,28,49,-21,20
Sydney FC,9374,1,21,4,3,67,22,45,67
N'castle Jet,9374,2,15,5,8,57,38,19,50
Melbourne C,9374,3,15,4,10,44,33,11,49
Melbourne V,9374,4,13,5,11,45,41,4,44
Adelaide Utd,9374,5,11,6,11,37,40,-3,39
Brisbane,9374,6,10,5,13,33,42,-9,35
Western Sydn,9374,7,8,9,10,38,47,-9,33
Perth Glory,9374,8,10,2,15,37,50,-13,32
Wellington P,9374,9,5,6,16,31,55,-24,21
CC Mariners,9374,10,4,8,15,28,49,-21,20
Sydney FC,9375,1,21,4,3,68,23,45,67
N'castle Jet,9375,2,15,5,8,57,38,19,50
Melbourne C,9375,3,15,4,10,44,33,11,49
Melbourne V,9375,4,13,5,11,46,42,4,44
Adelaide Utd,9375,5,11,6,11,37,40,-3,39
Brisbane,9375,6,10,5,13,33,42,-9,35
Western Sydn,9375,7,8,9,10,38,47,-9,33
Perth Glory,9375,8,10,2,15,37,50,-13,32
Wellington P,9375,9,5,6,16,31,55,-24,21
CC Mariners,9375,10,4,8,15,28,49,-21,20
Sydney FC,9376,1,20,5,3,65,23,42,65
N'castle Jet,9376,2,16,5,7,61,37,24,53
Melbourne C,9376,3,14,4,11,43,37,6,46
Melbourne V,9376,4,13,6,10,46,39,7,45
Adelaide Utd,9376,5,11,6,11,37,40,-3,39
Brisbane,9376,6,10,5,13,33,42,-9,35
Western Sydn,9376,7,8,9,10,38,47,-9,33
Perth Glory,9376,8,10,2,15,37,50,-13,32
Wellington P,9376,9,5,6,16,31,55,-24,21
CC Mariners,9376,10,4,8,15,28,49,-21,20
Sydney FC,9377,1,21,4,3,66,23,43,67
N'castle Jet,9377,2,15,6,7,58,38,20,51
Melbourne C,9377,3,14,5,10,44,34,10,47
Melbourne V,9377,4,13,5,11,46,40,6,44
Adelaide Utd,9377,5,11,6,11,37,40,-3,39
Brisbane,9377,6,10,5,13,33,42,-9,35
Western Sydn,9377,7,8,9,10,38,47,-9,33
Perth Glory,9377,8,10,2,15,37,50,-13,32
Wellington P,9377,9,5,6,16,31,55,-24,21
CC Mariners,9377,10,4,8,15,28,49,-21,20
Sydney FC,9378,1,20,4,4,64,23,41,64
N'castle Jet,9378,2,15,6,7,59,39,20,51
Melbourne C,9378,3,14,5,10,45,35,10,47
Melbourne V,9378,4,14,5,10,46,38,8,47
Adelaide Utd,9378,5,11,6,11,37,40,-3,39
Brisbane,9378,6,10,5,13,33,42,-9,35
Western Sydn,9378,7,8,9,10,38,47,-9,33
Perth Glory,9378,8,10,2,15,37,50,-13,32
Wellington P,9378,9,5,6,16,31,55,-24,21
CC Mariners,9378,10,4,8,15,28,49,-21,20
Sydney FC,9379,1,21,4,3,67,22,45,67
N'castle Jet,9379,2,15,5,8,58,39,19,50
Melbourne C,9379,3,15,4,10,45,34,11,49
Melbourne V,9379,4,13,5,11,45,41,4,44
Adelaide Utd,9379,5,11,6,11,37,40,-3,39
Brisbane,9379,6,10,5,13,33,42,-9,35
Western Sydn,9379,7,8,9,10,38,47,-9,33
Perth Glory,9379,8,10,2,15,37,50,-13,32
Wellington P,9379,9,5,6,16,31,55,-24,21
CC Mariners,9379,10,4,8,15,28,49,-21,20
Sydney FC,9380,1,20,5,3,65,23,42,65
N'castle Jet,9380,2,16,5,7,59,38,21,53
Melbourne C,9380,3,14,4,11,44,35,9,46
Melbourne V,9380,4,13,6,10,46,39,7,45
Adelaide Utd,9380,5,11,6,11,37,40,-3,39
Brisbane,9380,6,10,5,13,33,42,-9,35
Western Sydn,9380,7,8,9,10,38,47,-9,33
Perth Glory,9380,8,10,2,15,37,50,-13,32
Wellington P,9380,9,5,6,16,31,55,-24,21
CC Mariners,9380,10,4,8,15,28,49,-21,20
Sydney FC,9381,1,21,4,3,68,22,46,67
N'castle Jet,9381,2,16,5,7,58,37,21,53
Melbourne C,9381,3,14,4,11,43,34,9,46
Melbourne V,9381,4,13,5,11,45,42,3,44
Adelaide Utd,9381,5,11,6,11,37,40,-3,39
Brisbane,9381,6,10,5,13,33,42,-9,35
Western Sydn,9381,7,8,9,10,38,47,-9,33
Perth Glory,9381,8,10,2,15,37,50,-13,32
Wellington P,9381,9,5,6,16,31,55,-24,21
CC Mariners,9381,10,4,8,15,28,49,-21,20
Sydney FC,9382,1,20,4,4,64,24,40,64
N'castle Jet,9382,2,16,5,7,58,37,21,53
Melbourne V,9382,3,14,5,10,47,38,9,47
Melbourne C,9382,4,14,4,11,43,34,9,46
Adelaide Utd,9382,5,11,6,11,37,40,-3,39
Brisbane,9382,6,10,5,13,33,42,-9,35
Western Sydn,9382,7,8,9,10,38,47,-9,33
Perth Glory,9382,8,10,2,15,37,50,-13,32
Wellington P,9382,9,5,6,16,31,55,-24,21
CC Mariners,9382,10,4,8,15,28,49,-21,20
Sydney FC,9383,1,21,4,3,66,22,44,67
N'castle Jet,9383,2,16,5,7,60,38,22,53
Melbourne C,9383,3,14,4,11,44,36,8,46
Melbourne V,9383,4,13,5,11,45,40,5,44
Adelaide Utd,9383,5,11,6,11,37,40,-3,39
Brisbane,9383,6,10,5,13,33,42,-9,35
Western Sydn,9383,7,8,9,10,38,47,-9,33
Perth Glory,9383,8,10,2,15,37,50,-13,32
Wellington P,9383,9,5,6,16,31,55,-24,21
CC Mariners,9383,10,4,8,15,28,49,-21,20
Sydney FC,9384,1,20,5,3,65,23,42,65
N'castle Jet,9384,2,15,5,8,57,39,18,50
Melbourne C,9384,3,15,4,10,45,33,12,49
Melbourne V,9384,4,13,6,10,46,39,7,45
Adelaide Utd,9384,5,11,6,11,37,40,-3,39
Brisbane,9384,6,10,5,13,33,42,-9,35
Western Sydn,9384,7,8,9,10,38,47,-9,33
Perth Glory,9384,8,10,2,15,37,50,-13,32
Wellington P,9384,9,5,6,16,31,55,-24,21
CC Mariners,9384,10,4,8,15,28,49,-21,20
Sydney FC,9385,1,21,4,3,68,24,44,67
N'castle Jet,9385,2,15,6,7,60,40,20,51
Melbourne C,9385,3,14,5,10,46,36,10,47
Melbourne V,9385,4,13,5,11,47,42,5,44
Adelaide Utd,9385,5,11,6,11,37,40,-3,39
Brisbane,9385,6,10,5,13,33,42,-9,35
Western Sydn,9385,7,8,9,10,38,47,-9,33
Perth Glory,9385,8,10,2,15,37,50,-13,32
Wellington P,9385,9,5,6,16,31,55,-24,21
CC Mariners,9385,10,4,8,15,28,49,-21,20
Sydney FC,9386,1,21,4,3,68,22,46,67
N'castle Jet,9386,2,16,5,7,60,37,23,53
Melbourne C,9386,3,14,4,11,43,36,7,46
Melbourne V,9386,4,13,5,11,45,42,3,44
Adelaide Utd,9386,5,11,6,11,37,40,-3,39
Brisbane,9386,6,10,5,13,33,42,-9,35
Western Sydn,9386,7,8,9,10,38,47,-9,33
Perth Glory,9386,8,10,2,15,37,50,-13,32
Wellington P,9386,9,5,6,16,31,55,-24,21
CC Mariners,9386,10,4,8,15,28,49,-21,20
Sydney FC,9387,1,21,4,3,67,22,45,67
N'castle Jet,9387,2,16,5,7,59,38,21,53
Melbourne C,9387,3,14,4,11,44,35,9,46
Melbourne V,9387,4,13,5,11,45,41,4,44
Adelaide Utd,9387,5,11,6,11,37,40,-3,39
Brisbane,9387,6,10,5,13,33,42,-9,35
Western Sydn,9387,7,8,9,10,38,47,-9,33
Perth Glory,9387,8,10,2,15,37,50,-13,32
Wellington P,9387,9,5,6,16,31,55,-24,21
CC Mariners,9387,10,4,8,15,28,49,-21,20
Sydney FC,9388,1,20,5,3,65,23,42,65
N'castle Jet,9388,2,15,5,8,57,38,19,50
Melbourne C,9388,3,15,4,10,44,33,11,49
Melbourne V,9388,4,13,6,10,46,39,7,45
Adelaide Utd,9388,5,11,6,11,37,40,-3,39
Brisbane,9388,6,10,5,13,33,42,-9,35
Western Sydn,9388,7,8,9,10,38,47,-9,33
Perth Glory,9388,8,10,2,15,37,50,-13,32
Wellington P,9388,9,5,6,16,31,55,-24,21
CC Mariners,9388,10,4,8,15,28,49,-21,20
Sydney FC,9389,1,21,4,3,68,23,45,67
N'castle Jet,9389,2,15,5,8,58,39,19,50
Melbourne C,9389,3,15,4,10,45,34,11,49
Melbourne V,9389,4,13,5,11,46,42,4,44
Adelaide Utd,9389,5,11,6,11,37,40,-3,39
Brisbane,9389,6,10,5,13,33,42,-9,35
Western Sydn,9389,7,8,9,10,38,47,-9,33
Perth Glory,9389,8,10,2,15,37,50,-13,32
Wellington P,9389,9,5,6,16,31,55,-24,21
CC Mariners,9389,10,4,8,15,28,49,-21,20
Sydney FC,9390,1,21,4,3,65,22,43,67
N'castle Jet,9390,2,15,5,8,58,39,19,50
Melbourne C,9390,3,15,4,10,45,34,11,49
Melbourne V,9390,4,13,5,11,45,39,6,44
Adelaide Utd,9390,5,11,6,11,37,40,-3,39
Brisbane,9390,6,10,5,13,33,42,-9,35
Western Sydn,9390,7,8,9,10,38,47,-9,33
Perth Glory,9390,8,10,2,15,37,50,-13,32
Wellington P,9390,9,5,6,16,31,55,-24,21
CC Mariners,9390,10,4,8,15,28,49,-21,20
Sydney FC,9391,1,20,5,3,65,23,42,65
N'castle Jet,9391,2,16,5,7,60,38,22,53
Melbourne C,9391,3,14,4,11,44,36,8,46
Melbourne V,9391,4,13,6,10,46,39,7,45
Adelaide Utd,9391,5,11,6,11,37,40,-3,39
Brisbane,9391,6,10,5,13,33,42,-9,35
Western Sydn,9391,7,8,9,10,38,47,-9,33
Perth Glory,9391,8,10,2,15,37,50,-13,32
Wellington P,9391,9,5,6,16,31,55,-24,21
CC Mariners,9391,10,4,8,15,28,49,-21,20
Sydney FC,9392,1,21,4,3,68,22,46,67
N'castle Jet,9392,2,16,5,7,59,38,21,53
Melbourne C,9392,3,14,4,11,44,35,9,46
Melbourne V,9392,4,13,5,11,45,42,3,44
Adelaide Utd,9392,5,11,6,11,37,40,-3,39
Brisbane,9392,6,10,5,13,33,42,-9,35
Western Sydn,9392,7,8,9,10,38,47,-9,33
Perth Glory,9392,8,10,2,15,37,50,-13,32
Wellington P,9392,9,5,6,16,31,55,-24,21
CC Mariners,9392,10,4,8,15,28,49,-21,20
Sydney FC,9393,1,21,4,3,67,22,45,67
N'castle Jet,9393,2,16,5,7,59,38,21,53
Melbourne C,9393,3,14,4,11,44,35,9,46
Melbourne V,9393,4,13,5,11,45,41,4,44
Adelaide Utd,9393,5,11,6,11,37,40,-3,39
Brisbane,9393,6,10,5,13,33,42,-9,35
Western Sydn,9393,7,8,9,10,38,47,-9,33
Perth Glory,9393,8,10,2,15,37,50,-13,32
Wellington P,9393,9,5,6,16,31,55,-24,21
CC Mariners,9393,10,4,8,15,28,49,-21,20
Sydney FC,9394,1,20,4,4,64,24,40,64
N'castle Jet,9394,2,15,6,7,57,37,20,51
Melbourne C,9394,3,14,5,10,43,33,10,47
Melbourne V,9394,4,14,5,10,47,38,9,47
Adelaide Utd,9394,5,11,6,11,37,40,-3,39
Brisbane,9394,6,10,5,13,33,42,-9,35
Western Sydn,9394,7,8,9,10,38,47,-9,33
Perth Glory,9394,8,10,2,15,37,50,-13,32
Wellington P,9394,9,5,6,16,31,55,-24,21
CC Mariners,9394,10,4,8,15,28,49,-21,20
Sydney FC,9395,1,20,4,4,65,24,41,64
N'castle Jet,9395,2,16,5,7,59,37,22,53
Melbourne V,9395,3,14,5,10,47,39,8,47
Melbourne C,9395,4,14,4,11,43,35,8,46
Adelaide Utd,9395,5,11,6,11,37,40,-3,39
Brisbane,9395,6,10,5,13,33,42,-9,35
Western Sydn,9395,7,8,9,10,38,47,-9,33
Perth Glory,9395,8,10,2,15,37,50,-13,32
Wellington P,9395,9,5,6,16,31,55,-24,21
CC Mariners,9395,10,4,8,15,28,49,-21,20
Sydney FC,9396,1,21,4,3,66,23,43,67
N'castle Jet,9396,2,15,5,8,57,39,18,50
Melbourne C,9396,3,15,4,10,45,33,12,49
Melbourne V,9396,4,13,5,11,46,40,6,44
Adelaide Utd,9396,5,11,6,11,37,40,-3,39
Brisbane,9396,6,10,5,13,33,42,-9,35
Western Sydn,9396,7,8,9,10,38,47,-9,33
Perth Glory,9396,8,10,2,15,37,50,-13,32
Wellington P,9396,9,5,6,16,31,55,-24,21
CC Mariners,9396,10,4,8,15,28,49,-21,20
Sydney FC,9397,1,20,4,4,65,24,41,64
N'castle Jet,9397,2,16,5,7,60,37,23,53
Melbourne V,9397,3,14,5,10,47,39,8,47
Melbourne C,9397,4,14,4,11,43,36,7,46
Adelaide Utd,9397,5,11,6,11,37,40,-3,39
Brisbane,9397,6,10,5,13,33,42,-9,35
Western Sydn,9397,7,8,9,10,38,47,-9,33
Perth Glory,9397,8,10,2,15,37,50,-13,32
Wellington P,9397,9,5,6,16,31,55,-24,21
CC Mariners,9397,10,4,8,15,28,49,-21,20
Sydney FC,9398,1,20,5,3,64,22,42,65
N'castle Jet,9398,2,15,5,8,58,39,19,50
Melbourne C,9398,3,15,4,10,45,34,11,49
Melbourne V,9398,4,13,6,10,45,38,7,45
Adelaide Utd,9398,5,11,6,11,37,40,-3,39
Brisbane,9398,6,10,5,13,33,42,-9,35
Western Sydn,9398,7,8,9,10,38,47,-9,33
Perth Glory,9398,8,10,2,15,37,50,-13,32
Wellington P,9398,9,5,6,16,31,55,-24,21
CC Mariners,9398,10,4,8,15,28,49,-21,20
Sydney FC,9399,1,21,4,3,67,22,45,67
N'castle Jet,9399,2,16,5,7,60,39,21,53
Melbourne C,9399,3,14,4,11,45,36,9,46
Melbourne V,9399,4,13,5,11,45,41,4,44
Adelaide Utd,9399,5,11,6,11,37,40,-3,39
Brisbane,9399,6,10,5,13,33,42,-9,35
Western Sydn,9399,7,8,9,10,38,47,-9,33
Perth Glory,9399,8,10,2,15,37,50,-13,32
Wellington P,9399,9,5,6,16,31,55,-24,21
CC Mariners,9399,10,4,8,15,28,49,-21,20
Sydney FC,9400,1,21,4,3,66,23,43,67
N'castle Jet,9400,2,16,5,7,59,38,21,53
Melbourne C,9400,3,14,4,11,44,35,9,46
Melbourne V,9400,4,13,5,11,46,40,6,44
Adelaide Utd,9400,5,11,6,11,37,40,-3,39
Brisbane,9400,6,10,5,13,33,42,-9,35
Western Sydn,9400,7,8,9,10,38,47,-9,33
Perth Glory,9400,8,10,2,15,37,50,-13,32
Wellington P,9400,9,5,6,16,31,55,-24,21
CC Mariners,9400,10,4,8,15,28,49,-21,20
Sydney FC,9401,1,20,5,3,65,23,42,65
N'castle Jet,9401,2,16,5,7,60,38,22,53
Melbourne C,9401,3,14,4,11,44,36,8,46
Melbourne V,9401,4,13,6,10,46,39,7,45
Adelaide Utd,9401,5,11,6,11,37,40,-3,39
Brisbane,9401,6,10,5,13,33,42,-9,35
Western Sydn,9401,7,8,9,10,38,47,-9,33
Perth Glory,9401,8,10,2,15,37,50,-13,32
Wellington P,9401,9,5,6,16,31,55,-24,21
CC Mariners,9401,10,4,8,15,28,49,-21,20
Sydney FC,9402,1,21,4,3,65,22,43,67
N'castle Jet,9402,2,16,5,7,60,37,23,53
Melbourne C,9402,3,14,4,11,43,36,7,46
Melbourne V,9402,4,13,5,11,45,39,6,44
Adelaide Utd,9402,5,11,6,11,37,40,-3,39
Brisbane,9402,6,10,5,13,33,42,-9,35
Western Sydn,9402,7,8,9,10,38,47,-9,33
Perth Glory,9402,8,10,2,15,37,50,-13,32
Wellington P,9402,9,5,6,16,31,55,-24,21
CC Mariners,9402,10,4,8,15,28,49,-21,20
Sydney FC,9403,1,21,4,3,73,23,50,67
N'castle Jet,9403,2,16,5,7,62,37,25,53
Melbourne C,9403,3,14,4,11,43,38,5,46
Melbourne V,9403,4,13,5,11,46,47,-1,44
Adelaide Utd,9403,5,11,6,11,37,40,-3,39
Brisbane,9403,6,10,5,13,33,42,-9,35
Western Sydn,9403,7,8,9,10,38,47,-9,33
Perth Glory,9403,8,10,2,15,37,50,-13,32
Wellington P,9403,9,5,6,16,31,55,-24,21
CC Mariners,9403,10,4,8,15,28,49,-21,20
Sydney FC,9404,1,20,4,4,65,24,41,64
N'castle Jet,9404,2,16,5,7,59,38,21,53
Melbourne V,9404,3,14,5,10,47,39,8,47
Melbourne C,9404,4,14,4,11,44,35,9,46
Adelaide Utd,9404,5,11,6,11,37,40,-3,39
Brisbane,9404,6,10,5,13,33,42,-9,35
Western Sydn,9404,7,8,9,10,38,47,-9,33
Perth Glory,9404,8,10,2,15,37,50,-13,32
Wellington P,9404,9,5,6,16,31,55,-24,21
CC Mariners,9404,10,4,8,15,28,49,-21,20
Sydney FC,9405,1,20,4,4,64,23,41,64
N'castle Jet,9405,2,16,5,7,58,37,21,53
Melbourne V,9405,3,14,5,10,46,38,8,47
Melbourne C,9405,4,14,4,11,43,34,9,46
Adelaide Utd,9405,5,11,6,11,37,40,-3,39
Brisbane,9405,6,10,5,13,33,42,-9,35
Western Sydn,9405,7,8,9,10,38,47,-9,33
Perth Glory,9405,8,10,2,15,37,50,-13,32
Wellington P,9405,9,5,6,16,31,55,-24,21
CC Mariners,9405,10,4,8,15,28,49,-21,20
Sydney FC,9406,1,21,4,3,67,23,44,67
N'castle Jet,9406,2,16,5,7,61,38,23,53
Melbourne C,9406,3,14,4,11,44,37,7,46
Melbourne V,9406,4,13,5,11,46,41,5,44
Adelaide Utd,9406,5,11,6,11,37,40,-3,39
Brisbane,9406,6,10,5,13,33,42,-9,35
Western Sydn,9406,7,8,9,10,38,47,-9,33
Perth Glory,9406,8,10,2,15,37,50,-13,32
Wellington P,9406,9,5,6,16,31,55,-24,21
CC Mariners,9406,10,4,8,15,28,49,-21,20
Sydney FC,9407,1,21,4,3,66,23,43,67
N'castle Jet,9407,2,16,5,7,59,37,22,53
Melbourne C,9407,3,14,4,11,43,35,8,46
Melbourne V,9407,4,13,5,11,46,40,6,44
Adelaide Utd,9407,5,11,6,11,37,40,-3,39
Brisbane,9407,6,10,5,13,33,42,-9,35
Western Sydn,9407,7,8,9,10,38,47,-9,33
Perth Glory,9407,8,10,2,15,37,50,-13,32
Wellington P,9407,9,5,6,16,31,55,-24,21
CC Mariners,9407,10,4,8,15,28,49,-21,20
Sydney FC,9408,1,21,4,3,68,25,43,67
N'castle Jet,9408,2,15,6,7,59,39,20,51
Melbourne C,9408,3,14,5,10,45,35,10,47
Melbourne V,9408,4,13,5,11,48,42,6,44
Adelaide Utd,9408,5,11,6,11,37,40,-3,39
Brisbane,9408,6,10,5,13,33,42,-9,35
Western Sydn,9408,7,8,9,10,38,47,-9,33
Perth Glory,9408,8,10,2,15,37,50,-13,32
Wellington P,9408,9,5,6,16,31,55,-24,21
CC Mariners,9408,10,4,8,15,28,49,-21,20
Sydney FC,9409,1,21,4,3,67,22,45,67
N'castle Jet,9409,2,16,5,7,64,38,26,53
Melbourne C,9409,3,14,4,11,44,40,4,46
Melbourne V,9409,4,13,5,11,45,41,4,44
Adelaide Utd,9409,5,11,6,11,37,40,-3,39
Brisbane,9409,6,10,5,13,33,42,-9,35
Western Sydn,9409,7,8,9,10,38,47,-9,33
Perth Glory,9409,8,10,2,15,37,50,-13,32
Wellington P,9409,9,5,6,16,31,55,-24,21
CC Mariners,9409,10,4,8,15,28,49,-21,20
Sydney FC,9410,1,21,4,3,68,22,46,67
N'castle Jet,9410,2,15,6,7,57,37,20,51
Melbourne C,9410,3,14,5,10,43,33,10,47
Melbourne V,9410,4,13,5,11,45,42,3,44
Adelaide Utd,9410,5,11,6,11,37,40,-3,39
Brisbane,9410,6,10,5,13,33,42,-9,35
Western Sydn,9410,7,8,9,10,38,47,-9,33
Perth Glory,9410,8,10,2,15,37,50,-13,32
Wellington P,9410,9,5,6,16,31,55,-24,21
CC Mariners,9410,10,4,8,15,28,49,-21,20
Sydney FC,9411,1,21,4,3,66,23,43,67
N'castle Jet,9411,2,15,6,7,58,38,20,51
Melbourne C,9411,3,14,5,10,44,34,10,47
Melbourne V,9411,4,13,5,11,46,40,6,44
Adelaide Utd,9411,5,11,6,11,37,40,-3,39
Brisbane,9411,6,10,5,13,33,42,-9,35
Western Sydn,9411,7,8,9,10,38,47,-9,33
Perth Glory,9411,8,10,2,15,37,50,-13,32
Wellington P,9411,9,5,6,16,31,55,-24,21
CC Mariners,9411,10,4,8,15,28,49,-21,20
Sydney FC,9412,1,21,4,3,66,22,44,67
N'castle Jet,9412,2,15,6,7,57,37,20,51
Melbourne C,9412,3,14,5,10,43,33,10,47
Melbourne V,9412,4,13,5,11,45,40,5,44
Adelaide Utd,9412,5,11,6,11,37,40,-3,39
Brisbane,9412,6,10,5,13,33,42,-9,35
Western Sydn,9412,7,8,9,10,38,47,-9,33
Perth Glory,9412,8,10,2,15,37,50,-13,32
Wellington P,9412,9,5,6,16,31,55,-24,21
CC Mariners,9412,10,4,8,15,28,49,-21,20
Sydney FC,9413,1,20,5,3,64,22,42,65
N'castle Jet,9413,2,15,5,8,58,41,17,50
Melbourne C,9413,3,15,4,10,47,34,13,49
Melbourne V,9413,4,13,6,10,45,38,7,45
Adelaide Utd,9413,5,11,6,11,37,40,-3,39
Brisbane,9413,6,10,5,13,33,42,-9,35
Western Sydn,9413,7,8,9,10,38,47,-9,33
Perth Glory,9413,8,10,2,15,37,50,-13,32
Wellington P,9413,9,5,6,16,31,55,-24,21
CC Mariners,9413,10,4,8,15,28,49,-21,20
Sydney FC,9414,1,21,4,3,67,22,45,67
N'castle Jet,9414,2,15,6,7,57,37,20,51
Melbourne C,9414,3,14,5,10,43,33,10,47
Melbourne V,9414,4,13,5,11,45,41,4,44
Adelaide Utd,9414,5,11,6,11,37,40,-3,39
Brisbane,9414,6,10,5,13,33,42,-9,35
Western Sydn,9414,7,8,9,10,38,47,-9,33
Perth Glory,9414,8,10,2,15,37,50,-13,32
Wellington P,9414,9,5,6,16,31,55,-24,21
CC Mariners,9414,10,4,8,15,28,49,-21,20
Sydney FC,9415,1,20,4,4,64,23,41,64
N'castle Jet,9415,2,15,6,7,58,38,20,51
Melbourne C,9415,3,14,5,10,44,34,10,47
Melbourne V,9415,4,14,5,10,46,38,8,47
Adelaide Utd,9415,5,11,6,11,37,40,-3,39
Brisbane,9415,6,10,5,13,33,42,-9,35
Western Sydn,9415,7,8,9,10,38,47,-9,33
Perth Glory,9415,8,10,2,15,37,50,-13,32
Wellington P,9415,9,5,6,16,31,55,-24,21
CC Mariners,9415,10,4,8,15,28,49,-21,20
Sydney FC,9416,1,21,4,3,65,22,43,67
N'castle Jet,9416,2,16,5,7,60,37,23,53
Melbourne C,9416,3,14,4,11,43,36,7,46
Melbourne V,9416,4,13,5,11,45,39,6,44
Adelaide Utd,9416,5,11,6,11,37,40,-3,39
Brisbane,9416,6,10,5,13,33,42,-9,35
Western Sydn,9416,7,8,9,10,38,47,-9,33
Perth Glory,9416,8,10,2,15,37,50,-13,32
Wellington P,9416,9,5,6,16,31,55,-24,21
CC Mariners,9416,10,4,8,15,28,49,-21,20
Sydney FC,9417,1,20,5,3,64,22,42,65
N'castle Jet,9417,2,15,5,8,61,42,19,50
Melbourne C,9417,3,15,4,10,48,37,11,49
Melbourne V,9417,4,13,6,10,45,38,7,45
Adelaide Utd,9417,5,11,6,11,37,40,-3,39
Brisbane,9417,6,10,5,13,33,42,-9,35
Western Sydn,9417,7,8,9,10,38,47,-9,33
Perth Glory,9417,8,10,2,15,37,50,-13,32
Wellington P,9417,9,5,6,16,31,55,-24,21
CC Mariners,9417,10,4,8,15,28,49,-21,20
Sydney FC,9418,1,21,4,3,65,22,43,67
N'castle Jet,9418,2,16,5,7,59,38,21,53
Melbourne C,9418,3,14,4,11,44,35,9,46
Melbourne V,9418,4,13,5,11,45,39,6,44
Adelaide Utd,9418,5,11,6,11,37,40,-3,39
Brisbane,9418,6,10,5,13,33,42,-9,35
Western Sydn,9418,7,8,9,10,38,47,-9,33
Perth Glory,9418,8,10,2,15,37,50,-13,32
Wellington P,9418,9,5,6,16,31,55,-24,21
CC Mariners,9418,10,4,8,15,28,49,-21,20
Sydney FC,9419,1,20,4,4,65,25,40,64
N'castle Jet,9419,2,15,6,7,58,38,20,51
Melbourne C,9419,3,14,5,10,44,34,10,47
Melbourne V,9419,4,14,5,10,48,39,9,47
Adelaide Utd,9419,5,11,6,11,37,40,-3,39
Brisbane,9419,6,10,5,13,33,42,-9,35
Western Sydn,9419,7,8,9,10,38,47,-9,33
Perth Glory,9419,8,10,2,15,37,50,-13,32
Wellington P,9419,9,5,6,16,31,55,-24,21
CC Mariners,9419,10,4,8,15,28,49,-21,20
Sydney FC,9420,1,21,4,3,66,22,44,67
N'castle Jet,9420,2,15,6,7,58,38,20,51
Melbourne C,9420,3,14,5,10,44,34,10,47
Melbourne V,9420,4,13,5,11,45,40,5,44
Adelaide Utd,9420,5,11,6,11,37,40,-3,39
Brisbane,9420,6,10,5,13,33,42,-9,35
Western Sydn,9420,7,8,9,10,38,47,-9,33
Perth Glory,9420,8,10,2,15,37,50,-13,32
Wellington P,9420,9,5,6,16,31,55,-24,21
CC Mariners,9420,10,4,8,15,28,49,-21,20
Sydney FC,9421,1,20,5,3,65,23,42,65
N'castle Jet,9421,2,16,5,7,58,37,21,53
Melbourne C,9421,3,14,4,11,43,34,9,46
Melbourne V,9421,4,13,6,10,46,39,7,45
Adelaide Utd,9421,5,11,6,11,37,40,-3,39
Brisbane,9421,6,10,5,13,33,42,-9,35
Western Sydn,9421,7,8,9,10,38,47,-9,33
Perth Glory,9421,8,10,2,15,37,50,-13,32
Wellington P,9421,9,5,6,16,31,55,-24,21
CC Mariners,9421,10,4,8,15,28,49,-21,20
Sydney FC,9422,1,21,4,3,73,22,51,67
N'castle Jet,9422,2,15,5,8,58,39,19,50
Melbourne C,9422,3,15,4,10,45,34,11,49
Melbourne V,9422,4,13,5,11,45,47,-2,44
Adelaide Utd,9422,5,11,6,11,37,40,-3,39
Brisbane,9422,6,10,5,13,33,42,-9,35
Western Sydn,9422,7,8,9,10,38,47,-9,33
Perth Glory,9422,8,10,2,15,37,50,-13,32
Wellington P,9422,9,5,6,16,31,55,-24,21
CC Mariners,9422,10,4,8,15,28,49,-21,20
Sydney FC,9423,1,20,4,4,65,24,41,64
N'castle Jet,9423,2,15,5,8,57,38,19,50
Melbourne C,9423,3,15,4,10,44,33,11,49
Melbourne V,9423,4,14,5,10,47,39,8,47
Adelaide Utd,9423,5,11,6,11,37,40,-3,39
Brisbane,9423,6,10,5,13,33,42,-9,35
Western Sydn,9423,7,8,9,10,38,47,-9,33
Perth Glory,9423,8,10,2,15,37,50,-13,32
Wellington P,9423,9,5,6,16,31,55,-24,21
CC Mariners,9423,10,4,8,15,28,49,-21,20
Sydney FC,9424,1,21,4,3,65,22,43,67
N'castle Jet,9424,2,16,5,7,63,39,24,53
Melbourne C,9424,3,14,4,11,45,39,6,46
Melbourne V,9424,4,13,5,11,45,39,6,44
Adelaide Utd,9424,5,11,6,11,37,40,-3,39
Brisbane,9424,6,10,5,13,33,42,-9,35
Western Sydn,9424,7,8,9,10,38,47,-9,33
Perth Glory,9424,8,10,2,15,37,50,-13,32
Wellington P,9424,9,5,6,16,31,55,-24,21
CC Mariners,9424,10,4,8,15,28,49,-21,20
Sydney FC,9425,1,21,4,3,66,23,43,67
N'castle Jet,9425,2,16,5,7,59,38,21,53
Melbourne C,9425,3,14,4,11,44,35,9,46
Melbourne V,9425,4,13,5,11,46,40,6,44
Adelaide Utd,9425,5,11,6,11,37,40,-3,39
Brisbane,9425,6,10,5,13,33,42,-9,35
Western Sydn,9425,7,8,9,10,38,47,-9,33
Perth Glory,9425,8,10,2,15,37,50,-13,32
Wellington P,9425,9,5,6,16,31,55,-24,21
CC Mariners,9425,10,4,8,15,28,49,-21,20
Sydney FC,9426,1,20,5,3,64,22,42,65
N'castle Jet,9426,2,16,5,7,58,37,21,53
Melbourne C,9426,3,14,4,11,43,34,9,46
Melbourne V,9426,4,13,6,10,45,38,7,45
Adelaide Utd,9426,5,11,6,11,37,40,-3,39
Brisbane,9426,6,10,5,13,33,42,-9,35
Western Sydn,9426,7,8,9,10,38,47,-9,33
Perth Glory,9426,8,10,2,15,37,50,-13,32
Wellington P,9426,9,5,6,16,31,55,-24,21
CC Mariners,9426,10,4,8,15,28,49,-21,20
Sydney FC,9427,1,20,4,4,65,24,41,64
N'castle Jet,9427,2,15,5,8,57,39,18,50
Melbourne C,9427,3,15,4,10,45,33,12,49
Melbourne V,9427,4,14,5,10,47,39,8,47
Adelaide Utd,9427,5,11,6,11,37,40,-3,39
Brisbane,9427,6,10,5,13,33,42,-9,35
Western Sydn,9427,7,8,9,10,38,47,-9,33
Perth Glory,9427,8,10,2,15,37,50,-13,32
Wellington P,9427,9,5,6,16,31,55,-24,21
CC Mariners,9427,10,4,8,15,28,49,-21,20
Sydney FC,9428,1,21,4,3,68,23,45,67
N'castle Jet,9428,2,16,5,7,59,38,21,53
Melbourne C,9428,3,14,4,11,44,35,9,46
Melbourne V,9428,4,13,5,11,46,42,4,44
Adelaide Utd,9428,5,11,6,11,37,40,-3,39
Brisbane,9428,6,10,5,13,33,42,-9,35
Western Sydn,9428,7,8,9,10,38,47,-9,33
Perth Glory,9428,8,10,2,15,37,50,-13,32
Wellington P,9428,9,5,6,16,31,55,-24,21
CC Mariners,9428,10,4,8,15,28,49,-21,20
Sydney FC,9429,1,21,4,3,65,22,43,67
N'castle Jet,9429,2,16,5,7,59,38,21,53
Melbourne C,9429,3,14,4,11,44,35,9,46
Melbourne V,9429,4,13,5,11,45,39,6,44
Adelaide Utd,9429,5,11,6,11,37,40,-3,39
Brisbane,9429,6,10,5,13,33,42,-9,35
Western Sydn,9429,7,8,9,10,38,47,-9,33
Perth Glory,9429,8,10,2,15,37,50,-13,32
Wellington P,9429,9,5,6,16,31,55,-24,21
CC Mariners,9429,10,4,8,15,28,49,-21,20
Sydney FC,9430,1,21,4,3,66,22,44,67
N'castle Jet,9430,2,16,5,7,59,37,22,53
Melbourne C,9430,3,14,4,11,43,35,8,46
Melbourne V,9430,4,13,5,11,45,40,5,44
Adelaide Utd,9430,5,11,6,11,37,40,-3,39
Brisbane,9430,6,10,5,13,33,42,-9,35
Western Sydn,9430,7,8,9,10,38,47,-9,33
Perth Glory,9430,8,10,2,15,37,50,-13,32
Wellington P,9430,9,5,6,16,31,55,-24,21
CC Mariners,9430,10,4,8,15,28,49,-21,20
Sydney FC,9431,1,21,4,3,67,23,44,67
N'castle Jet,9431,2,16,5,7,63,38,25,53
Melbourne C,9431,3,14,4,11,44,39,5,46
Melbourne V,9431,4,13,5,11,46,41,5,44
Adelaide Utd,9431,5,11,6,11,37,40,-3,39
Brisbane,9431,6,10,5,13,33,42,-9,35
Western Sydn,9431,7,8,9,10,38,47,-9,33
Perth Glory,9431,8,10,2,15,37,50,-13,32
Wellington P,9431,9,5,6,16,31,55,-24,21
CC Mariners,9431,10,4,8,15,28,49,-21,20
Sydney FC,9432,1,20,4,4,65,24,41,64
N'castle Jet,9432,2,15,6,7,58,38,20,51
Melbourne C,9432,3,14,5,10,44,34,10,47
Melbourne V,9432,4,14,5,10,47,39,8,47
Adelaide Utd,9432,5,11,6,11,37,40,-3,39
Brisbane,9432,6,10,5,13,33,42,-9,35
Western Sydn,9432,7,8,9,10,38,47,-9,33
Perth Glory,9432,8,10,2,15,37,50,-13,32
Wellington P,9432,9,5,6,16,31,55,-24,21
CC Mariners,9432,10,4,8,15,28,49,-21,20
Sydney FC,9433,1,21,4,3,66,23,43,67
N'castle Jet,9433,2,15,5,8,59,40,19,50
Melbourne C,9433,3,15,4,10,46,35,11,49
Melbourne V,9433,4,13,5,11,46,40,6,44
Adelaide Utd,9433,5,11,6,11,37,40,-3,39
Brisbane,9433,6,10,5,13,33,42,-9,35
Western Sydn,9433,7,8,9,10,38,47,-9,33
Perth Glory,9433,8,10,2,15,37,50,-13,32
Wellington P,9433,9,5,6,16,31,55,-24,21
CC Mariners,9433,10,4,8,15,28,49,-21,20
Sydney FC,9434,1,20,5,3,65,23,42,65
N'castle Jet,9434,2,16,5,7,60,39,21,53
Melbourne C,9434,3,14,4,11,45,36,9,46
Melbourne V,9434,4,13,6,10,46,39,7,45
Adelaide Utd,9434,5,11,6,11,37,40,-3,39
Brisbane,9434,6,10,5,13,33,42,-9,35
Western Sydn,9434,7,8,9,10,38,47,-9,33
Perth Glory,9434,8,10,2,15,37,50,-13,32
Wellington P,9434,9,5,6,16,31,55,-24,21
CC Mariners,9434,10,4,8,15,28,49,-21,20
Sydney FC,9435,1,21,4,3,67,22,45,67
N'castle Jet,9435,2,16,5,7,59,38,21,53
Melbourne C,9435,3,14,4,11,44,35,9,46
Melbourne V,9435,4,13,5,11,45,41,4,44
Adelaide Utd,9435,5,11,6,11,37,40,-3,39
Brisbane,9435,6,10,5,13,33,42,-9,35
Western Sydn,9435,7,8,9,10,38,47,-9,33
Perth Glory,9435,8,10,2,15,37,50,-13,32
Wellington P,9435,9,5,6,16,31,55,-24,21
CC Mariners,9435,10,4,8,15,28,49,-21,20
Sydney FC,9436,1,21,4,3,67,23,44,67
N'castle Jet,9436,2,16,5,7,58,37,21,53
Melbourne C,9436,3,14,4,11,43,34,9,46
Melbourne V,9436,4,13,5,11,46,41,5,44
Adelaide Utd,9436,5,11,6,11,37,40,-3,39
Brisbane,9436,6,10,5,13,33,42,-9,35
Western Sydn,9436,7,8,9,10,38,47,-9,33
Perth Glory,9436,8,10,2,15,37,50,-13,32
Wellington P,9436,9,5,6,16,31,55,-24,21
CC Mariners,9436,10,4,8,15,28,49,-21,20
Sydney FC,9437,1,21,4,3,66,22,44,67
N'castle Jet,9437,2,16,5,7,59,37,22,53
Melbourne C,9437,3,14,4,11,43,35,8,46
Melbourne V,9437,4,13,5,11,45,40,5,44
Adelaide Utd,9437,5,11,6,11,37,40,-3,39
Brisbane,9437,6,10,5,13,33,42,-9,35
Western Sydn,9437,7,8,9,10,38,47,-9,33
Perth Glory,9437,8,10,2,15,37,50,-13,32
Wellington P,9437,9,5,6,16,31,55,-24,21
CC Mariners,9437,10,4,8,15,28,49,-21,20
Sydney FC,9438,1,20,5,3,64,22,42,65
N'castle Jet,9438,2,16,5,7,60,37,23,53
Melbourne C,9438,3,14,4,11,43,36,7,46
Melbourne V,9438,4,13,6,10,45,38,7,45
Adelaide Utd,9438,5,11,6,11,37,40,-3,39
Brisbane,9438,6,10,5,13,33,42,-9,35
Western Sydn,9438,7,8,9,10,38,47,-9,33
Perth Glory,9438,8,10,2,15,37,50,-13,32
Wellington P,9438,9,5,6,16,31,55,-24,21
CC Mariners,9438,10,4,8,15,28,49,-21,20
Sydney FC,9439,1,20,5,3,67,25,42,65
N'castle Jet,9439,2,15,5,8,58,39,19,50
Melbourne C,9439,3,15,4,10,45,34,11,49
Melbourne V,9439,4,13,6,10,48,41,7,45
Adelaide Utd,9439,5,11,6,11,37,40,-3,39
Brisbane,9439,6,10,5,13,33,42,-9,35
Western Sydn,9439,7,8,9,10,38,47,-9,33
Perth Glory,9439,8,10,2,15,37,50,-13,32
Wellington P,9439,9,5,6,16,31,55,-24,21
CC Mariners,9439,10,4,8,15,28,49,-21,20
Sydney FC,9440,1,21,4,3,70,27,43,67
N'castle Jet,9440,2,16,5,7,59,38,21,53
Melbourne C,9440,3,14,4,11,44,35,9,46
Melbourne V,9440,4,13,5,11,50,44,6,44
Adelaide Utd,9440,5,11,6,11,37,40,-3,39
Brisbane,9440,6,10,5,13,33,42,-9,35
Western Sydn,9440,7,8,9,10,38,47,-9,33
Perth Glory,9440,8,10,2,15,37,50,-13,32
Wellington P,9440,9,5,6,16,31,55,-24,21
CC Mariners,9440,10,4,8,15,28,49,-21,20
Sydney FC,9441,1,20,4,4,64,24,40,64
N'castle Jet,9441,2,15,6,7,59,39,20,51
Melbourne C,9441,3,14,5,10,45,35,10,47
Melbourne V,9441,4,14,5,10,47,38,9,47
Adelaide Utd,9441,5,11,6,11,37,40,-3,39
Brisbane,9441,6,10,5,13,33,42,-9,35
Western Sydn,9441,7,8,9,10,38,47,-9,33
Perth Glory,9441,8,10,2,15,37,50,-13,32
Wellington P,9441,9,5,6,16,31,55,-24,21
CC Mariners,9441,10,4,8,15,28,49,-21,20
Sydney FC,9442,1,21,4,3,68,23,45,67
N'castle Jet,9442,2,16,5,7,61,37,24,53
Melbourne C,9442,3,14,4,11,43,37,6,46
Melbourne V,9442,4,13,5,11,46,42,4,44
Adelaide Utd,9442,5,11,6,11,37,40,-3,39
Brisbane,9442,6,10,5,13,33,42,-9,35
Western Sydn,9442,7,8,9,10,38,47,-9,33
Perth Glory,9442,8,10,2,15,37,50,-13,32
Wellington P,9442,9,5,6,16,31,55,-24,21
CC Mariners,9442,10,4,8,15,28,49,-21,20
Sydney FC,9443,1,20,5,3,66,24,42,65
N'castle Jet,9443,2,15,5,8,57,38,19,50
Melbourne C,9443,3,15,4,10,44,33,11,49
Melbourne V,9443,4,13,6,10,47,40,7,45
Adelaide Utd,9443,5,11,6,11,37,40,-3,39
Brisbane,9443,6,10,5,13,33,42,-9,35
Western Sydn,9443,7,8,9,10,38,47,-9,33
Perth Glory,9443,8,10,2,15,37,50,-13,32
Wellington P,9443,9,5,6,16,31,55,-24,21
CC Mariners,9443,10,4,8,15,28,49,-21,20
Sydney FC,9444,1,21,4,3,67,23,44,67
N'castle Jet,9444,2,15,5,8,58,39,19,50
Melbourne C,9444,3,15,4,10,45,34,11,49
Melbourne V,9444,4,13,5,11,46,41,5,44
Adelaide Utd,9444,5,11,6,11,37,40,-3,39
Brisbane,9444,6,10,5,13,33,42,-9,35
Western Sydn,9444,7,8,9,10,38,47,-9,33
Perth Glory,9444,8,10,2,15,37,50,-13,32
Wellington P,9444,9,5,6,16,31,55,-24,21
CC Mariners,9444,10,4,8,15,28,49,-21,20
Sydney FC,9445,1,21,4,3,65,22,43,67
N'castle Jet,9445,2,16,5,7,61,38,23,53
Melbourne C,9445,3,14,4,11,44,37,7,46
Melbourne V,9445,4,13,5,11,45,39,6,44
Adelaide Utd,9445,5,11,6,11,37,40,-3,39
Brisbane,9445,6,10,5,13,33,42,-9,35
Western Sydn,9445,7,8,9,10,38,47,-9,33
Perth Glory,9445,8,10,2,15,37,50,-13,32
Wellington P,9445,9,5,6,16,31,55,-24,21
CC Mariners,9445,10,4,8,15,28,49,-21,20
Sydney FC,9446,1,21,4,3,67,22,45,67
N'castle Jet,9446,2,15,6,7,59,39,20,51
Melbourne C,9446,3,14,5,10,45,35,10,47
Melbourne V,9446,4,13,5,11,45,41,4,44
Adelaide Utd,9446,5,11,6,11,37,40,-3,39
Brisbane,9446,6,10,5,13,33,42,-9,35
Western Sydn,9446,7,8,9,10,38,47,-9,33
Perth Glory,9446,8,10,2,15,37,50,-13,32
Wellington P,9446,9,5,6,16,31,55,-24,21
CC Mariners,9446,10,4,8,15,28,49,-21,20
Sydney FC,9447,1,21,4,3,67,22,45,67
N'castle Jet,9447,2,15,6,7,59,39,20,51
Melbourne C,9447,3,14,5,10,45,35,10,47
Melbourne V,9447,4,13,5,11,45,41,4,44
Adelaide Utd,9447,5,11,6,11,37,40,-3,39
Brisbane,9447,6,10,5,13,33,42,-9,35
Western Sydn,9447,7,8,9,10,38,47,-9,33
Perth Glory,9447,8,10,2,15,37,50,-13,32
Wellington P,9447,9,5,6,16,31,55,-24,21
CC Mariners,9447,10,4,8,15,28,49,-21,20
Sydney FC,9448,1,21,4,3,67,23,44,67
N'castle Jet,9448,2,15,5,8,58,39,19,50
Melbourne C,9448,3,15,4,10,45,34,11,49
Melbourne V,9448,4,13,5,11,46,41,5,44
Adelaide Utd,9448,5,11,6,11,37,40,-3,39
Brisbane,9448,6,10,5,13,33,42,-9,35
Western Sydn,9448,7,8,9,10,38,47,-9,33
Perth Glory,9448,8,10,2,15,37,50,-13,32
Wellington P,9448,9,5,6,16,31,55,-24,21
CC Mariners,9448,10,4,8,15,28,49,-21,20
Sydney FC,9449,1,20,5,3,65,23,42,65
N'castle Jet,9449,2,15,6,7,58,38,20,51
Melbourne C,9449,3,14,5,10,44,34,10,47
Melbourne V,9449,4,13,6,10,46,39,7,45
Adelaide Utd,9449,5,11,6,11,37,40,-3,39
Brisbane,9449,6,10,5,13,33,42,-9,35
Western Sydn,9449,7,8,9,10,38,47,-9,33
Perth Glory,9449,8,10,2,15,37,50,-13,32
Wellington P,9449,9,5,6,16,31,55,-24,21
CC Mariners,9449,10,4,8,15,28,49,-21,20
Sydney FC,9450,1,20,5,3,66,24,42,65
N'castle Jet,9450,2,16,5,7,58,37,21,53
Melbourne C,9450,3,14,4,11,43,34,9,46
Melbourne V,9450,4,13,6,10,47,40,7,45
Adelaide Utd,9450,5,11,6,11,37,40,-3,39
Brisbane,9450,6,10,5,13,33,42,-9,35
Western Sydn,9450,7,8,9,10,38,47,-9,33
Perth Glory,9450,8,10,2,15,37,50,-13,32
Wellington P,9450,9,5,6,16,31,55,-24,21
CC Mariners,9450,10,4,8,15,28,49,-21,20
Sydney FC,9451,1,21,4,3,68,24,44,67
N'castle Jet,9451,2,15,6,7,60,40,20,51
Melbourne C,9451,3,14,5,10,46,36,10,47
Melbourne V,9451,4,13,5,11,47,42,5,44
Adelaide Utd,9451,5,11,6,11,37,40,-3,39
Brisbane,9451,6,10,5,13,33,42,-9,35
Western Sydn,9451,7,8,9,10,38,47,-9,33
Perth Glory,9451,8,10,2,15,37,50,-13,32
Wellington P,9451,9,5,6,16,31,55,-24,21
CC Mariners,9451,10,4,8,15,28,49,-21,20
Sydney FC,9452,1,20,5,3,65,23,42,65
N'castle Jet,9452,2,15,5,8,57,38,19,50
Melbourne C,9452,3,15,4,10,44,33,11,49
Melbourne V,9452,4,13,6,10,46,39,7,45
Adelaide Utd,9452,5,11,6,11,37,40,-3,39
Brisbane,9452,6,10,5,13,33,42,-9,35
Western Sydn,9452,7,8,9,10,38,47,-9,33
Perth Glory,9452,8,10,2,15,37,50,-13,32
Wellington P,9452,9,5,6,16,31,55,-24,21
CC Mariners,9452,10,4,8,15,28,49,-21,20
Sydney FC,9453,1,21,4,3,66,22,44,67
N'castle Jet,9453,2,15,5,8,57,38,19,50
Melbourne C,9453,3,15,4,10,44,33,11,49
Melbourne V,9453,4,13,5,11,45,40,5,44
Adelaide Utd,9453,5,11,6,11,37,40,-3,39
Brisbane,9453,6,10,5,13,33,42,-9,35
Western Sydn,9453,7,8,9,10,38,47,-9,33
Perth Glory,9453,8,10,2,15,37,50,-13,32
Wellington P,9453,9,5,6,16,31,55,-24,21
CC Mariners,9453,10,4,8,15,28,49,-21,20
Sydney FC,9454,1,20,5,3,66,24,42,65
N'castle Jet,9454,2,16,5,7,61,39,22,53
Melbourne C,9454,3,14,4,11,45,37,8,46
Melbourne V,9454,4,13,6,10,47,40,7,45
Adelaide Utd,9454,5,11,6,11,37,40,-3,39
Brisbane,9454,6,10,5,13,33,42,-9,35
Western Sydn,9454,7,8,9,10,38,47,-9,33
Perth Glory,9454,8,10,2,15,37,50,-13,32
Wellington P,9454,9,5,6,16,31,55,-24,21
CC Mariners,9454,10,4,8,15,28,49,-21,20
Sydney FC,9455,1,20,5,3,64,22,42,65
N'castle Jet,9455,2,16,5,7,58,37,21,53
Melbourne C,9455,3,14,4,11,43,34,9,46
Melbourne V,9455,4,13,6,10,45,38,7,45
Adelaide Utd,9455,5,11,6,11,37,40,-3,39
Brisbane,9455,6,10,5,13,33,42,-9,35
Western Sydn,9455,7,8,9,10,38,47,-9,33
Perth Glory,9455,8,10,2,15,37,50,-13,32
Wellington P,9455,9,5,6,16,31,55,-24,21
CC Mariners,9455,10,4,8,15,28,49,-21,20
Sydney FC,9456,1,20,5,3,65,23,42,65
N'castle Jet,9456,2,15,6,7,57,37,20,51
Melbourne C,9456,3,14,5,10,43,33,10,47
Melbourne V,9456,4,13,6,10,46,39,7,45
Adelaide Utd,9456,5,11,6,11,37,40,-3,39
Brisbane,9456,6,10,5,13,33,42,-9,35
Western Sydn,9456,7,8,9,10,38,47,-9,33
Perth Glory,9456,8,10,2,15,37,50,-13,32
Wellington P,9456,9,5,6,16,31,55,-24,21
CC Mariners,9456,10,4,8,15,28,49,-21,20
Sydney FC,9457,1,20,5,3,64,22,42,65
N'castle Jet,9457,2,15,6,7,58,38,20,51
Melbourne C,9457,3,14,5,10,44,34,10,47
Melbourne V,9457,4,13,6,10,45,38,7,45
Adelaide Utd,9457,5,11,6,11,37,40,-3,39
Brisbane,9457,6,10,5,13,33,42,-9,35
Western Sydn,9457,7,8,9,10,38,47,-9,33
Perth Glory,9457,8,10,2,15,37,50,-13,32
Wellington P,9457,9,5,6,16,31,55,-24,21
CC Mariners,9457,10,4,8,15,28,49,-21,20
Sydney FC,9458,1,20,5,3,65,23,42,65
N'castle Jet,9458,2,16,5,7,60,38,22,53
Melbourne C,9458,3,14,4,11,44,36,8,46
Melbourne V,9458,4,13,6,10,46,39,7,45
Adelaide Utd,9458,5,11,6,11,37,40,-3,39
Brisbane,9458,6,10,5,13,33,42,-9,35
Western Sydn,9458,7,8,9,10,38,47,-9,33
Perth Glory,9458,8,10,2,15,37,50,-13,32
Wellington P,9458,9,5,6,16,31,55,-24,21
CC Mariners,9458,10,4,8,15,28,49,-21,20
Sydney FC,9459,1,21,4,3,69,22,47,67
N'castle Jet,9459,2,15,5,8,57,38,19,50
Melbourne C,9459,3,15,4,10,44,33,11,49
Melbourne V,9459,4,13,5,11,45,43,2,44
Adelaide Utd,9459,5,11,6,11,37,40,-3,39
Brisbane,9459,6,10,5,13,33,42,-9,35
Western Sydn,9459,7,8,9,10,38,47,-9,33
Perth Glory,9459,8,10,2,15,37,50,-13,32
Wellington P,9459,9,5,6,16,31,55,-24,21
CC Mariners,9459,10,4,8,15,28,49,-21,20
Sydney FC,9460,1,20,4,4,66,25,41,64
N'castle Jet,9460,2,16,5,7,60,37,23,53
Melbourne V,9460,3,14,5,10,48,40,8,47
Melbourne C,9460,4,14,4,11,43,36,7,46
Adelaide Utd,9460,5,11,6,11,37,40,-3,39
Brisbane,9460,6,10,5,13,33,42,-9,35
Western Sydn,9460,7,8,9,10,38,47,-9,33
Perth Glory,9460,8,10,2,15,37,50,-13,32
Wellington P,9460,9,5,6,16,31,55,-24,21
CC Mariners,9460,10,4,8,15,28,49,-21,20
Sydney FC,9461,1,21,4,3,67,23,44,67
N'castle Jet,9461,2,15,5,8,58,39,19,50
Melbourne C,9461,3,15,4,10,45,34,11,49
Melbourne V,9461,4,13,5,11,46,41,5,44
Adelaide Utd,9461,5,11,6,11,37,40,-3,39
Brisbane,9461,6,10,5,13,33,42,-9,35
Western Sydn,9461,7,8,9,10,38,47,-9,33
Perth Glory,9461,8,10,2,15,37,50,-13,32
Wellington P,9461,9,5,6,16,31,55,-24,21
CC Mariners,9461,10,4,8,15,28,49,-21,20
Sydney FC,9462,1,21,4,3,65,22,43,67
N'castle Jet,9462,2,15,5,8,58,39,19,50
Melbourne C,9462,3,15,4,10,45,34,11,49
Melbourne V,9462,4,13,5,11,45,39,6,44
Adelaide Utd,9462,5,11,6,11,37,40,-3,39
Brisbane,9462,6,10,5,13,33,42,-9,35
Western Sydn,9462,7,8,9,10,38,47,-9,33
Perth Glory,9462,8,10,2,15,37,50,-13,32
Wellington P,9462,9,5,6,16,31,55,-24,21
CC Mariners,9462,10,4,8,15,28,49,-21,20
Sydney FC,9463,1,21,4,3,70,24,46,67
N'castle Jet,9463,2,16,5,7,60,39,21,53
Melbourne C,9463,3,14,4,11,45,36,9,46
Melbourne V,9463,4,13,5,11,47,44,3,44
Adelaide Utd,9463,5,11,6,11,37,40,-3,39
Brisbane,9463,6,10,5,13,33,42,-9,35
Western Sydn,9463,7,8,9,10,38,47,-9,33
Perth Glory,9463,8,10,2,15,37,50,-13,32
Wellington P,9463,9,5,6,16,31,55,-24,21
CC Mariners,9463,10,4,8,15,28,49,-21,20
Sydney FC,9464,1,21,4,3,65,22,43,67
N'castle Jet,9464,2,16,5,7,59,37,22,53
Melbourne C,9464,3,14,4,11,43,35,8,46
Melbourne V,9464,4,13,5,11,45,39,6,44
Adelaide Utd,9464,5,11,6,11,37,40,-3,39
Brisbane,9464,6,10,5,13,33,42,-9,35
Western Sydn,9464,7,8,9,10,38,47,-9,33
Perth Glory,9464,8,10,2,15,37,50,-13,32
Wellington P,9464,9,5,6,16,31,55,-24,21
CC Mariners,9464,10,4,8,15,28,49,-21,20
Sydney FC,9465,1,21,4,3,68,24,44,67
N'castle Jet,9465,2,16,5,7,61,39,22,53
Melbourne C,9465,3,14,4,11,45,37,8,46
Melbourne V,9465,4,13,5,11,47,42,5,44
Adelaide Utd,9465,5,11,6,11,37,40,-3,39
Brisbane,9465,6,10,5,13,33,42,-9,35
Western Sydn,9465,7,8,9,10,38,47,-9,33
Perth Glory,9465,8,10,2,15,37,50,-13,32
Wellington P,9465,9,5,6,16,31,55,-24,21
CC Mariners,9465,10,4,8,15,28,49,-21,20
Sydney FC,9466,1,20,4,4,64,24,40,64
N'castle Jet,9466,2,15,6,7,58,38,20,51
Melbourne C,9466,3,14,5,10,44,34,10,47
Melbourne V,9466,4,14,5,10,47,38,9,47
Adelaide Utd,9466,5,11,6,11,37,40,-3,39
Brisbane,9466,6,10,5,13,33,42,-9,35
Western Sydn,9466,7,8,9,10,38,47,-9,33
Perth Glory,9466,8,10,2,15,37,50,-13,32
Wellington P,9466,9,5,6,16,31,55,-24,21
CC Mariners,9466,10,4,8,15,28,49,-21,20
Sydney FC,9467,1,21,4,3,68,24,44,67
N'castle Jet,9467,2,15,5,8,57,39,18,50
Melbourne C,9467,3,15,4,10,45,33,12,49
Melbourne V,9467,4,13,5,11,47,42,5,44
Adelaide Utd,9467,5,11,6,11,37,40,-3,39
Brisbane,9467,6,10,5,13,33,42,-9,35
Western Sydn,9467,7,8,9,10,38,47,-9,33
Perth Glory,9467,8,10,2,15,37,50,-13,32
Wellington P,9467,9,5,6,16,31,55,-24,21
CC Mariners,9467,10,4,8,15,28,49,-21,20
Sydney FC,9468,1,21,4,3,66,23,43,67
N'castle Jet,9468,2,15,5,8,57,38,19,50
Melbourne C,9468,3,15,4,10,44,33,11,49
Melbourne V,9468,4,13,5,11,46,40,6,44
Adelaide Utd,9468,5,11,6,11,37,40,-3,39
Brisbane,9468,6,10,5,13,33,42,-9,35
Western Sydn,9468,7,8,9,10,38,47,-9,33
Perth Glory,9468,8,10,2,15,37,50,-13,32
Wellington P,9468,9,5,6,16,31,55,-24,21
CC Mariners,9468,10,4,8,15,28,49,-21,20
Sydney FC,9469,1,21,4,3,69,24,45,67
N'castle Jet,9469,2,16,5,7,60,38,22,53
Melbourne C,9469,3,14,4,11,44,36,8,46
Melbourne V,9469,4,13,5,11,47,43,4,44
Adelaide Utd,9469,5,11,6,11,37,40,-3,39
Brisbane,9469,6,10,5,13,33,42,-9,35
Western Sydn,9469,7,8,9,10,38,47,-9,33
Perth Glory,9469,8,10,2,15,37,50,-13,32
Wellington P,9469,9,5,6,16,31,55,-24,21
CC Mariners,9469,10,4,8,15,28,49,-21,20
Sydney FC,9470,1,20,5,3,65,23,42,65
N'castle Jet,9470,2,15,6,7,57,37,20,51
Melbourne C,9470,3,14,5,10,43,33,10,47
Melbourne V,9470,4,13,6,10,46,39,7,45
Adelaide Utd,9470,5,11,6,11,37,40,-3,39
Brisbane,9470,6,10,5,13,33,42,-9,35
Western Sydn,9470,7,8,9,10,38,47,-9,33
Perth Glory,9470,8,10,2,15,37,50,-13,32
Wellington P,9470,9,5,6,16,31,55,-24,21
CC Mariners,9470,10,4,8,15,28,49,-21,20
Sydney FC,9471,1,21,4,3,66,23,43,67
N'castle Jet,9471,2,16,5,7,59,37,22,53
Melbourne C,9471,3,14,4,11,43,35,8,46
Melbourne V,9471,4,13,5,11,46,40,6,44
Adelaide Utd,9471,5,11,6,11,37,40,-3,39
Brisbane,9471,6,10,5,13,33,42,-9,35
Western Sydn,9471,7,8,9,10,38,47,-9,33
Perth Glory,9471,8,10,2,15,37,50,-13,32
Wellington P,9471,9,5,6,16,31,55,-24,21
CC Mariners,9471,10,4,8,15,28,49,-21,20
Sydney FC,9472,1,21,4,3,67,22,45,67
N'castle Jet,9472,2,15,5,8,57,38,19,50
Melbourne C,9472,3,15,4,10,44,33,11,49
Melbourne V,9472,4,13,5,11,45,41,4,44
Adelaide Utd,9472,5,11,6,11,37,40,-3,39
Brisbane,9472,6,10,5,13,33,42,-9,35
Western Sydn,9472,7,8,9,10,38,47,-9,33
Perth Glory,9472,8,10,2,15,37,50,-13,32
Wellington P,9472,9,5,6,16,31,55,-24,21
CC Mariners,9472,10,4,8,15,28,49,-21,20
Sydney FC,9473,1,20,4,4,64,24,40,64
N'castle Jet,9473,2,15,5,8,57,38,19,50
Melbourne C,9473,3,15,4,10,44,33,11,49
Melbourne V,9473,4,14,5,10,47,38,9,47
Adelaide Utd,9473,5,11,6,11,37,40,-3,39
Brisbane,9473,6,10,5,13,33,42,-9,35
Western Sydn,9473,7,8,9,10,38,47,-9,33
Perth Glory,9473,8,10,2,15,37,50,-13,32
Wellington P,9473,9,5,6,16,31,55,-24,21
CC Mariners,9473,10,4,8,15,28,49,-21,20
Sydney FC,9474,1,20,5,3,66,24,42,65
N'castle Jet,9474,2,16,5,7,59,37,22,53
Melbourne C,9474,3,14,4,11,43,35,8,46
Melbourne V,9474,4,13,6,10,47,40,7,45
Adelaide Utd,9474,5,11,6,11,37,40,-3,39
Brisbane,9474,6,10,5,13,33,42,-9,35
Western Sydn,9474,7,8,9,10,38,47,-9,33
Perth Glory,9474,8,10,2,15,37,50,-13,32
Wellington P,9474,9,5,6,16,31,55,-24,21
CC Mariners,9474,10,4,8,15,28,49,-21,20
Sydney FC,9475,1,21,4,3,67,23,44,67
N'castle Jet,9475,2,16,5,7,58,37,21,53
Melbourne C,9475,3,14,4,11,43,34,9,46
Melbourne V,9475,4,13,5,11,46,41,5,44
Adelaide Utd,9475,5,11,6,11,37,40,-3,39
Brisbane,9475,6,10,5,13,33,42,-9,35
Western Sydn,9475,7,8,9,10,38,47,-9,33
Perth Glory,9475,8,10,2,15,37,50,-13,32
Wellington P,9475,9,5,6,16,31,55,-24,21
CC Mariners,9475,10,4,8,15,28,49,-21,20
Sydney FC,9476,1,20,5,3,65,23,42,65
N'castle Jet,9476,2,15,5,8,59,43,16,50
Melbourne C,9476,3,15,4,10,49,35,14,49
Melbourne V,9476,4,13,6,10,46,39,7,45
Adelaide Utd,9476,5,11,6,11,37,40,-3,39
Brisbane,9476,6,10,5,13,33,42,-9,35
Western Sydn,9476,7,8,9,10,38,47,-9,33
Perth Glory,9476,8,10,2,15,37,50,-13,32
Wellington P,9476,9,5,6,16,31,55,-24,21
CC Mariners,9476,10,4,8,15,28,49,-21,20
Sydney FC,9477,1,20,5,3,66,24,42,65
N'castle Jet,9477,2,15,5,8,58,39,19,50
Melbourne C,9477,3,15,4,10,45,34,11,49
Melbourne V,9477,4,13,6,10,47,40,7,45
Adelaide Utd,9477,5,11,6,11,37,40,-3,39
Brisbane,9477,6,10,5,13,33,42,-9,35
Western Sydn,9477,7,8,9,10,38,47,-9,33
Perth Glory,9477,8,10,2,15,37,50,-13,32
Wellington P,9477,9,5,6,16,31,55,-24,21
CC Mariners,9477,10,4,8,15,28,49,-21,20
Sydney FC,9478,1,21,4,3,69,22,47,67
N'castle Jet,9478,2,15,6,7,58,38,20,51
Melbourne C,9478,3,14,5,10,44,34,10,47
Melbourne V,9478,4,13,5,11,45,43,2,44
Adelaide Utd,9478,5,11,6,11,37,40,-3,39
Brisbane,9478,6,10,5,13,33,42,-9,35
Western Sydn,9478,7,8,9,10,38,47,-9,33
Perth Glory,9478,8,10,2,15,37,50,-13,32
Wellington P,9478,9,5,6,16,31,55,-24,21
CC Mariners,9478,10,4,8,15,28,49,-21,20
Sydney FC,9479,1,20,4,4,65,24,41,64
N'castle Jet,9479,2,16,5,7,59,38,21,53
Melbourne V,9479,3,14,5,10,47,39,8,47
Melbourne C,9479,4,14,4,11,44,35,9,46
Adelaide Utd,9479,5,11,6,11,37,40,-3,39
Brisbane,9479,6,10,5,13,33,42,-9,35
Western Sydn,9479,7,8,9,10,38,47,-9,33
Perth Glory,9479,8,10,2,15,37,50,-13,32
Wellington P,9479,9,5,6,16,31,55,-24,21
CC Mariners,9479,10,4,8,15,28,49,-21,20
Sydney FC,9480,1,21,4,3,66,22,44,67
N'castle Jet,9480,2,16,5,7,58,37,21,53
Melbourne C,9480,3,14,4,11,43,34,9,46
Melbourne V,9480,4,13,5,11,45,40,5,44
Adelaide Utd,9480,5,11,6,11,37,40,-3,39
Brisbane,9480,6,10,5,13,33,42,-9,35
Western Sydn,9480,7,8,9,10,38,47,-9,33
Perth Glory,9480,8,10,2,15,37,50,-13,32
Wellington P,9480,9,5,6,16,31,55,-24,21
CC Mariners,9480,10,4,8,15,28,49,-21,20
Sydney FC,9481,1,20,4,4,65,24,41,64
N'castle Jet,9481,2,16,5,7,59,38,21,53
Melbourne V,9481,3,14,5,10,47,39,8,47
Melbourne C,9481,4,14,4,11,44,35,9,46
Adelaide Utd,9481,5,11,6,11,37,40,-3,39
Brisbane,9481,6,10,5,13,33,42,-9,35
Western Sydn,9481,7,8,9,10,38,47,-9,33
Perth Glory,9481,8,10,2,15,37,50,-13,32
Wellington P,9481,9,5,6,16,31,55,-24,21
CC Mariners,9481,10,4,8,15,28,49,-21,20
Sydney FC,9482,1,21,4,3,67,23,44,67
N'castle Jet,9482,2,16,5,7,61,39,22,53
Melbourne C,9482,3,14,4,11,45,37,8,46
Melbourne V,9482,4,13,5,11,46,41,5,44
Adelaide Utd,9482,5,11,6,11,37,40,-3,39
Brisbane,9482,6,10,5,13,33,42,-9,35
Western Sydn,9482,7,8,9,10,38,47,-9,33
Perth Glory,9482,8,10,2,15,37,50,-13,32
Wellington P,9482,9,5,6,16,31,55,-24,21
CC Mariners,9482,10,4,8,15,28,49,-21,20
Sydney FC,9483,1,21,4,3,67,23,44,67
N'castle Jet,9483,2,15,5,8,58,39,19,50
Melbourne C,9483,3,15,4,10,45,34,11,49
Melbourne V,9483,4,13,5,11,46,41,5,44
Adelaide Utd,9483,5,11,6,11,37,40,-3,39
Brisbane,9483,6,10,5,13,33,42,-9,35
Western Sydn,9483,7,8,9,10,38,47,-9,33
Perth Glory,9483,8,10,2,15,37,50,-13,32
Wellington P,9483,9,5,6,16,31,55,-24,21
CC Mariners,9483,10,4,8,15,28,49,-21,20
Sydney FC,9484,1,20,5,3,64,22,42,65
N'castle Jet,9484,2,16,5,7,59,37,22,53
Melbourne C,9484,3,14,4,11,43,35,8,46
Melbourne V,9484,4,13,6,10,45,38,7,45
Adelaide Utd,9484,5,11,6,11,37,40,-3,39
Brisbane,9484,6,10,5,13,33,42,-9,35
Western Sydn,9484,7,8,9,10,38,47,-9,33
Perth Glory,9484,8,10,2,15,37,50,-13,32
Wellington P,9484,9,5,6,16,31,55,-24,21
CC Mariners,9484,10,4,8,15,28,49,-21,20
Sydney FC,9485,1,20,5,3,64,22,42,65
N'castle Jet,9485,2,16,5,7,59,38,21,53
Melbourne C,9485,3,14,4,11,44,35,9,46
Melbourne V,9485,4,13,6,10,45,38,7,45
Adelaide Utd,9485,5,11,6,11,37,40,-3,39
Brisbane,9485,6,10,5,13,33,42,-9,35
Western Sydn,9485,7,8,9,10,38,47,-9,33
Perth Glory,9485,8,10,2,15,37,50,-13,32
Wellington P,9485,9,5,6,16,31,55,-24,21
CC Mariners,9485,10,4,8,15,28,49,-21,20
Sydney FC,9486,1,20,4,4,64,26,38,64
N'castle Jet,9486,2,15,6,7,58,38,20,51
Melbourne V,9486,3,14,5,10,49,38,11,47
Melbourne C,9486,4,14,5,10,44,34,10,47
Adelaide Utd,9486,5,11,6,11,37,40,-3,39
Brisbane,9486,6,10,5,13,33,42,-9,35
Western Sydn,9486,7,8,9,10,38,47,-9,33
Perth Glory,9486,8,10,2,15,37,50,-13,32
Wellington P,9486,9,5,6,16,31,55,-24,21
CC Mariners,9486,10,4,8,15,28,49,-21,20
Sydney FC,9487,1,21,4,3,67,24,43,67
N'castle Jet,9487,2,15,6,7,57,37,20,51
Melbourne C,9487,3,14,5,10,43,33,10,47
Melbourne V,9487,4,13,5,11,47,41,6,44
Adelaide Utd,9487,5,11,6,11,37,40,-3,39
Brisbane,9487,6,10,5,13,33,42,-9,35
Western Sydn,9487,7,8,9,10,38,47,-9,33
Perth Glory,9487,8,10,2,15,37,50,-13,32
Wellington P,9487,9,5,6,16,31,55,-24,21
CC Mariners,9487,10,4,8,15,28,49,-21,20
Sydney FC,9488,1,20,5,3,64,22,42,65
N'castle Jet,9488,2,16,5,7,60,37,23,53
Melbourne C,9488,3,14,4,11,43,36,7,46
Melbourne V,9488,4,13,6,10,45,38,7,45
Adelaide Utd,9488,5,11,6,11,37,40,-3,39
Brisbane,9488,6,10,5,13,33,42,-9,35
Western Sydn,9488,7,8,9,10,38,47,-9,33
Perth Glory,9488,8,10,2,15,37,50,-13,32
Wellington P,9488,9,5,6,16,31,55,-24,21
CC Mariners,9488,10,4,8,15,28,49,-21,20
Sydney FC,9489,1,21,4,3,66,23,43,67
N'castle Jet,9489,2,15,5,8,58,39,19,50
Melbourne C,9489,3,15,4,10,45,34,11,49
Melbourne V,9489,4,13,5,11,46,40,6,44
Adelaide Utd,9489,5,11,6,11,37,40,-3,39
Brisbane,9489,6,10,5,13,33,42,-9,35
Western Sydn,9489,7,8,9,10,38,47,-9,33
Perth Glory,9489,8,10,2,15,37,50,-13,32
Wellington P,9489,9,5,6,16,31,55,-24,21
CC Mariners,9489,10,4,8,15,28,49,-21,20
Sydney FC,9490,1,21,4,3,68,23,45,67
N'castle Jet,9490,2,16,5,7,60,38,22,53
Melbourne C,9490,3,14,4,11,44,36,8,46
Melbourne V,9490,4,13,5,11,46,42,4,44
Adelaide Utd,9490,5,11,6,11,37,40,-3,39
Brisbane,9490,6,10,5,13,33,42,-9,35
Western Sydn,9490,7,8,9,10,38,47,-9,33
Perth Glory,9490,8,10,2,15,37,50,-13,32
Wellington P,9490,9,5,6,16,31,55,-24,21
CC Mariners,9490,10,4,8,15,28,49,-21,20
Sydney FC,9491,1,20,5,3,65,23,42,65
N'castle Jet,9491,2,15,6,7,58,38,20,51
Melbourne C,9491,3,14,5,10,44,34,10,47
Melbourne V,9491,4,13,6,10,46,39,7,45
Adelaide Utd,9491,5,11,6,11,37,40,-3,39
Brisbane,9491,6,10,5,13,33,42,-9,35
Western Sydn,9491,7,8,9,10,38,47,-9,33
Perth Glory,9491,8,10,2,15,37,50,-13,32
Wellington P,9491,9,5,6,16,31,55,-24,21
CC Mariners,9491,10,4,8,15,28,49,-21,20
Sydney FC,9492,1,20,5,3,65,23,42,65
N'castle Jet,9492,2,16,5,7,60,37,23,53
Melbourne C,9492,3,14,4,11,43,36,7,46
Melbourne V,9492,4,13,6,10,46,39,7,45
Adelaide Utd,9492,5,11,6,11,37,40,-3,39
Brisbane,9492,6,10,5,13,33,42,-9,35
Western Sydn,9492,7,8,9,10,38,47,-9,33
Perth Glory,9492,8,10,2,15,37,50,-13,32
Wellington P,9492,9,5,6,16,31,55,-24,21
CC Mariners,9492,10,4,8,15,28,49,-21,20
Sydney FC,9493,1,20,4,4,64,23,41,64
N'castle Jet,9493,2,15,5,8,59,41,18,50
Melbourne C,9493,3,15,4,10,47,35,12,49
Melbourne V,9493,4,14,5,10,46,38,8,47
Adelaide Utd,9493,5,11,6,11,37,40,-3,39
Brisbane,9493,6,10,5,13,33,42,-9,35
Western Sydn,9493,7,8,9,10,38,47,-9,33
Perth Glory,9493,8,10,2,15,37,50,-13,32
Wellington P,9493,9,5,6,16,31,55,-24,21
CC Mariners,9493,10,4,8,15,28,49,-21,20
Sydney FC,9494,1,20,5,3,64,22,42,65
N'castle Jet,9494,2,16,5,7,58,37,21,53
Melbourne C,9494,3,14,4,11,43,34,9,46
Melbourne V,9494,4,13,6,10,45,38,7,45
Adelaide Utd,9494,5,11,6,11,37,40,-3,39
Brisbane,9494,6,10,5,13,33,42,-9,35
Western Sydn,9494,7,8,9,10,38,47,-9,33
Perth Glory,9494,8,10,2,15,37,50,-13,32
Wellington P,9494,9,5,6,16,31,55,-24,21
CC Mariners,9494,10,4,8,15,28,49,-21,20
Sydney FC,9495,1,20,4,4,64,24,40,64
N'castle Jet,9495,2,16,5,7,60,38,22,53
Melbourne V,9495,3,14,5,10,47,38,9,47
Melbourne C,9495,4,14,4,11,44,36,8,46
Adelaide Utd,9495,5,11,6,11,37,40,-3,39
Brisbane,9495,6,10,5,13,33,42,-9,35
Western Sydn,9495,7,8,9,10,38,47,-9,33
Perth Glory,9495,8,10,2,15,37,50,-13,32
Wellington P,9495,9,5,6,16,31,55,-24,21
CC Mariners,9495,10,4,8,15,28,49,-21,20
Sydney FC,9496,1,20,5,3,66,24,42,65
N'castle Jet,9496,2,15,5,8,60,41,19,50
Melbourne C,9496,3,15,4,10,47,36,11,49
Melbourne V,9496,4,13,6,10,47,40,7,45
Adelaide Utd,9496,5,11,6,11,37,40,-3,39
Brisbane,9496,6,10,5,13,33,42,-9,35
Western Sydn,9496,7,8,9,10,38,47,-9,33
Perth Glory,9496,8,10,2,15,37,50,-13,32
Wellington P,9496,9,5,6,16,31,55,-24,21
CC Mariners,9496,10,4,8,15,28,49,-21,20
Sydney FC,9497,1,21,4,3,66,23,43,67
N'castle Jet,9497,2,16,5,7,60,37,23,53
Melbourne C,9497,3,14,4,11,43,36,7,46
Melbourne V,9497,4,13,5,11,46,40,6,44
Adelaide Utd,9497,5,11,6,11,37,40,-3,39
Brisbane,9497,6,10,5,13,33,42,-9,35
Western Sydn,9497,7,8,9,10,38,47,-9,33
Perth Glory,9497,8,10,2,15,37,50,-13,32
Wellington P,9497,9,5,6,16,31,55,-24,21
CC Mariners,9497,10,4,8,15,28,49,-21,20
Sydney FC,9498,1,21,4,3,66,23,43,67
N'castle Jet,9498,2,15,6,7,58,38,20,51
Melbourne C,9498,3,14,5,10,44,34,10,47
Melbourne V,9498,4,13,5,11,46,40,6,44
Adelaide Utd,9498,5,11,6,11,37,40,-3,39
Brisbane,9498,6,10,5,13,33,42,-9,35
Western Sydn,9498,7,8,9,10,38,47,-9,33
Perth Glory,9498,8,10,2,15,37,50,-13,32
Wellington P,9498,9,5,6,16,31,55,-24,21
CC Mariners,9498,10,4,8,15,28,49,-21,20
Sydney FC,9499,1,21,4,3,68,23,45,67
N'castle Jet,9499,2,16,5,7,60,37,23,53
Melbourne C,9499,3,14,4,11,43,36,7,46
Melbourne V,9499,4,13,5,11,46,42,4,44
Adelaide Utd,9499,5,11,6,11,37,40,-3,39
Brisbane,9499,6,10,5,13,33,42,-9,35
Western Sydn,9499,7,8,9,10,38,47,-9,33
Perth Glory,9499,8,10,2,15,37,50,-13,32
Wellington P,9499,9,5,6,16,31,55,-24,21
CC Mariners,9499,10,4,8,15,28,49,-21,20
Sydney FC,9500,1,20,5,3,66,24,42,65
N'castle Jet,9500,2,16,5,7,59,37,22,53
Melbourne C,9500,3,14,4,11,43,35,8,46
Melbourne V,9500,4,13,6,10,47,40,7,45
Adelaide Utd,9500,5,11,6,11,37,40,-3,39
Brisbane,9500,6,10,5,13,33,42,-9,35
Western Sydn,9500,7,8,9,10,38,47,-9,33
Perth Glory,9500,8,10,2,15,37,50,-13,32
Wellington P,9500,9,5,6,16,31,55,-24,21
CC Mariners,9500,10,4,8,15,28,49,-21,20
Sydney FC,9501,1,21,4,3,69,23,46,67
N'castle Jet,9501,2,16,5,7,58,37,21,53
Melbourne C,9501,3,14,4,11,43,34,9,46
Melbourne V,9501,4,13,5,11,46,43,3,44
Adelaide Utd,9501,5,11,6,11,37,40,-3,39
Brisbane,9501,6,10,5,13,33,42,-9,35
Western Sydn,9501,7,8,9,10,38,47,-9,33
Perth Glory,9501,8,10,2,15,37,50,-13,32
Wellington P,9501,9,5,6,16,31,55,-24,21
CC Mariners,9501,10,4,8,15,28,49,-21,20
Sydney FC,9502,1,21,4,3,66,23,43,67
N'castle Jet,9502,2,16,5,7,62,39,23,53
Melbourne C,9502,3,14,4,11,45,38,7,46
Melbourne V,9502,4,13,5,11,46,40,6,44
Adelaide Utd,9502,5,11,6,11,37,40,-3,39
Brisbane,9502,6,10,5,13,33,42,-9,35
Western Sydn,9502,7,8,9,10,38,47,-9,33
Perth Glory,9502,8,10,2,15,37,50,-13,32
Wellington P,9502,9,5,6,16,31,55,-24,21
CC Mariners,9502,10,4,8,15,28,49,-21,20
Sydney FC,9503,1,21,4,3,66,22,44,67
N'castle Jet,9503,2,16,5,7,59,37,22,53
Melbourne C,9503,3,14,4,11,43,35,8,46
Melbourne V,9503,4,13,5,11,45,40,5,44
Adelaide Utd,9503,5,11,6,11,37,40,-3,39
Brisbane,9503,6,10,5,13,33,42,-9,35
Western Sydn,9503,7,8,9,10,38,47,-9,33
Perth Glory,9503,8,10,2,15,37,50,-13,32
Wellington P,9503,9,5,6,16,31,55,-24,21
CC Mariners,9503,10,4,8,15,28,49,-21,20
Sydney FC,9504,1,21,4,3,71,23,48,67
N'castle Jet,9504,2,15,5,8,58,39,19,50
Melbourne C,9504,3,15,4,10,45,34,11,49
Melbourne V,9504,4,13,5,11,46,45,1,44
Adelaide Utd,9504,5,11,6,11,37,40,-3,39
Brisbane,9504,6,10,5,13,33,42,-9,35
Western Sydn,9504,7,8,9,10,38,47,-9,33
Perth Glory,9504,8,10,2,15,37,50,-13,32
Wellington P,9504,9,5,6,16,31,55,-24,21
CC Mariners,9504,10,4,8,15,28,49,-21,20
Sydney FC,9505,1,21,4,3,66,23,43,67
N'castle Jet,9505,2,15,6,7,57,37,20,51
Melbourne C,9505,3,14,5,10,43,33,10,47
Melbourne V,9505,4,13,5,11,46,40,6,44
Adelaide Utd,9505,5,11,6,11,37,40,-3,39
Brisbane,9505,6,10,5,13,33,42,-9,35
Western Sydn,9505,7,8,9,10,38,47,-9,33
Perth Glory,9505,8,10,2,15,37,50,-13,32
Wellington P,9505,9,5,6,16,31,55,-24,21
CC Mariners,9505,10,4,8,15,28,49,-21,20
Sydney FC,9506,1,21,4,3,66,23,43,67
N'castle Jet,9506,2,15,5,8,58,39,19,50
Melbourne C,9506,3,15,4,10,45,34,11,49
Melbourne V,9506,4,13,5,11,46,40,6,44
Adelaide Utd,9506,5,11,6,11,37,40,-3,39
Brisbane,9506,6,10,5,13,33,42,-9,35
Western Sydn,9506,7,8,9,10,38,47,-9,33
Perth Glory,9506,8,10,2,15,37,50,-13,32
Wellington P,9506,9,5,6,16,31,55,-24,21
CC Mariners,9506,10,4,8,15,28,49,-21,20
Sydney FC,9507,1,21,4,3,67,23,44,67
N'castle Jet,9507,2,16,5,7,62,38,24,53
Melbourne C,9507,3,14,4,11,44,38,6,46
Melbourne V,9507,4,13,5,11,46,41,5,44
Adelaide Utd,9507,5,11,6,11,37,40,-3,39
Brisbane,9507,6,10,5,13,33,42,-9,35
Western Sydn,9507,7,8,9,10,38,47,-9,33
Perth Glory,9507,8,10,2,15,37,50,-13,32
Wellington P,9507,9,5,6,16,31,55,-24,21
CC Mariners,9507,10,4,8,15,28,49,-21,20
Sydney FC,9508,1,21,4,3,66,22,44,67
N'castle Jet,9508,2,15,6,7,59,39,20,51
Melbourne C,9508,3,14,5,10,45,35,10,47
Melbourne V,9508,4,13,5,11,45,40,5,44
Adelaide Utd,9508,5,11,6,11,37,40,-3,39
Brisbane,9508,6,10,5,13,33,42,-9,35
Western Sydn,9508,7,8,9,10,38,47,-9,33
Perth Glory,9508,8,10,2,15,37,50,-13,32
Wellington P,9508,9,5,6,16,31,55,-24,21
CC Mariners,9508,10,4,8,15,28,49,-21,20
Sydney FC,9509,1,20,5,3,64,22,42,65
N'castle Jet,9509,2,15,6,7,58,38,20,51
Melbourne C,9509,3,14,5,10,44,34,10,47
Melbourne V,9509,4,13,6,10,45,38,7,45
Adelaide Utd,9509,5,11,6,11,37,40,-3,39
Brisbane,9509,6,10,5,13,33,42,-9,35
Western Sydn,9509,7,8,9,10,38,47,-9,33
Perth Glory,9509,8,10,2,15,37,50,-13,32
Wellington P,9509,9,5,6,16,31,55,-24,21
CC Mariners,9509,10,4,8,15,28,49,-21,20
Sydney FC,9510,1,21,4,3,66,23,43,67
N'castle Jet,9510,2,15,6,7,58,38,20,51
Melbourne C,9510,3,14,5,10,44,34,10,47
Melbourne V,9510,4,13,5,11,46,40,6,44
Adelaide Utd,9510,5,11,6,11,37,40,-3,39
Brisbane,9510,6,10,5,13,33,42,-9,35
Western Sydn,9510,7,8,9,10,38,47,-9,33
Perth Glory,9510,8,10,2,15,37,50,-13,32
Wellington P,9510,9,5,6,16,31,55,-24,21
CC Mariners,9510,10,4,8,15,28,49,-21,20
Sydney FC,9511,1,20,4,4,64,23,41,64
N'castle Jet,9511,2,16,5,7,63,38,25,53
Melbourne V,9511,3,14,5,10,46,38,8,47
Melbourne C,9511,4,14,4,11,44,39,5,46
Adelaide Utd,9511,5,11,6,11,37,40,-3,39
Brisbane,9511,6,10,5,13,33,42,-9,35
Western Sydn,9511,7,8,9,10,38,47,-9,33
Perth Glory,9511,8,10,2,15,37,50,-13,32
Wellington P,9511,9,5,6,16,31,55,-24,21
CC Mariners,9511,10,4,8,15,28,49,-21,20
Sydney FC,9512,1,20,4,4,64,24,40,64
N'castle Jet,9512,2,16,5,7,60,38,22,53
Melbourne V,9512,3,14,5,10,47,38,9,47
Melbourne C,9512,4,14,4,11,44,36,8,46
Adelaide Utd,9512,5,11,6,11,37,40,-3,39
Brisbane,9512,6,10,5,13,33,42,-9,35
Western Sydn,9512,7,8,9,10,38,47,-9,33
Perth Glory,9512,8,10,2,15,37,50,-13,32
Wellington P,9512,9,5,6,16,31,55,-24,21
CC Mariners,9512,10,4,8,15,28,49,-21,20
Sydney FC,9513,1,21,4,3,67,23,44,67
N'castle Jet,9513,2,16,5,7,60,39,21,53
Melbourne C,9513,3,14,4,11,45,36,9,46
Melbourne V,9513,4,13,5,11,46,41,5,44
Adelaide Utd,9513,5,11,6,11,37,40,-3,39
Brisbane,9513,6,10,5,13,33,42,-9,35
Western Sydn,9513,7,8,9,10,38,47,-9,33
Perth Glory,9513,8,10,2,15,37,50,-13,32
Wellington P,9513,9,5,6,16,31,55,-24,21
CC Mariners,9513,10,4,8,15,28,49,-21,20
Sydney FC,9514,1,21,4,3,67,23,44,67
N'castle Jet,9514,2,15,6,7,58,38,20,51
Melbourne C,9514,3,14,5,10,44,34,10,47
Melbourne V,9514,4,13,5,11,46,41,5,44
Adelaide Utd,9514,5,11,6,11,37,40,-3,39
Brisbane,9514,6,10,5,13,33,42,-9,35
Western Sydn,9514,7,8,9,10,38,47,-9,33
Perth Glory,9514,8,10,2,15,37,50,-13,32
Wellington P,9514,9,5,6,16,31,55,-24,21
CC Mariners,9514,10,4,8,15,28,49,-21,20
Sydney FC,9515,1,21,4,3,68,22,46,67
N'castle Jet,9515,2,16,5,7,59,38,21,53
Melbourne C,9515,3,14,4,11,44,35,9,46
Melbourne V,9515,4,13,5,11,45,42,3,44
Adelaide Utd,9515,5,11,6,11,37,40,-3,39
Brisbane,9515,6,10,5,13,33,42,-9,35
Western Sydn,9515,7,8,9,10,38,47,-9,33
Perth Glory,9515,8,10,2,15,37,50,-13,32
Wellington P,9515,9,5,6,16,31,55,-24,21
CC Mariners,9515,10,4,8,15,28,49,-21,20
Sydney FC,9516,1,21,4,3,66,22,44,67
N'castle Jet,9516,2,15,6,7,58,38,20,51
Melbourne C,9516,3,14,5,10,44,34,10,47
Melbourne V,9516,4,13,5,11,45,40,5,44
Adelaide Utd,9516,5,11,6,11,37,40,-3,39
Brisbane,9516,6,10,5,13,33,42,-9,35
Western Sydn,9516,7,8,9,10,38,47,-9,33
Perth Glory,9516,8,10,2,15,37,50,-13,32
Wellington P,9516,9,5,6,16,31,55,-24,21
CC Mariners,9516,10,4,8,15,28,49,-21,20
Sydney FC,9517,1,20,4,4,65,24,41,64
N'castle Jet,9517,2,16,5,7,59,38,21,53
Melbourne V,9517,3,14,5,10,47,39,8,47
Melbourne C,9517,4,14,4,11,44,35,9,46
Adelaide Utd,9517,5,11,6,11,37,40,-3,39
Brisbane,9517,6,10,5,13,33,42,-9,35
Western Sydn,9517,7,8,9,10,38,47,-9,33
Perth Glory,9517,8,10,2,15,37,50,-13,32
Wellington P,9517,9,5,6,16,31,55,-24,21
CC Mariners,9517,10,4,8,15,28,49,-21,20
Sydney FC,9518,1,21,4,3,67,24,43,67
N'castle Jet,9518,2,16,5,7,59,37,22,53
Melbourne C,9518,3,14,4,11,43,35,8,46
Melbourne V,9518,4,13,5,11,47,41,6,44
Adelaide Utd,9518,5,11,6,11,37,40,-3,39
Brisbane,9518,6,10,5,13,33,42,-9,35
Western Sydn,9518,7,8,9,10,38,47,-9,33
Perth Glory,9518,8,10,2,15,37,50,-13,32
Wellington P,9518,9,5,6,16,31,55,-24,21
CC Mariners,9518,10,4,8,15,28,49,-21,20
Sydney FC,9519,1,21,4,3,67,22,45,67
N'castle Jet,9519,2,16,5,7,59,37,22,53
Melbourne C,9519,3,14,4,11,43,35,8,46
Melbourne V,9519,4,13,5,11,45,41,4,44
Adelaide Utd,9519,5,11,6,11,37,40,-3,39
Brisbane,9519,6,10,5,13,33,42,-9,35
Western Sydn,9519,7,8,9,10,38,47,-9,33
Perth Glory,9519,8,10,2,15,37,50,-13,32
Wellington P,9519,9,5,6,16,31,55,-24,21
CC Mariners,9519,10,4,8,15,28,49,-21,20
Sydney FC,9520,1,20,4,4,66,25,41,64
N'castle Jet,9520,2,15,5,8,57,39,18,50
Melbourne C,9520,3,15,4,10,45,33,12,49
Melbourne V,9520,4,14,5,10,48,40,8,47
Adelaide Utd,9520,5,11,6,11,37,40,-3,39
Brisbane,9520,6,10,5,13,33,42,-9,35
Western Sydn,9520,7,8,9,10,38,47,-9,33
Perth Glory,9520,8,10,2,15,37,50,-13,32
Wellington P,9520,9,5,6,16,31,55,-24,21
CC Mariners,9520,10,4,8,15,28,49,-21,20
Sydney FC,9521,1,20,4,4,64,26,38,64
N'castle Jet,9521,2,15,5,8,58,39,19,50
Melbourne C,9521,3,15,4,10,45,34,11,49
Melbourne V,9521,4,14,5,10,49,38,11,47
Adelaide Utd,9521,5,11,6,11,37,40,-3,39
Brisbane,9521,6,10,5,13,33,42,-9,35
Western Sydn,9521,7,8,9,10,38,47,-9,33
Perth Glory,9521,8,10,2,15,37,50,-13,32
Wellington P,9521,9,5,6,16,31,55,-24,21
CC Mariners,9521,10,4,8,15,28,49,-21,20
Sydney FC,9522,1,21,4,3,68,22,46,67
N'castle Jet,9522,2,16,5,7,61,37,24,53
Melbourne C,9522,3,14,4,11,43,37,6,46
Melbourne V,9522,4,13,5,11,45,42,3,44
Adelaide Utd,9522,5,11,6,11,37,40,-3,39
Brisbane,9522,6,10,5,13,33,42,-9,35
Western Sydn,9522,7,8,9,10,38,47,-9,33
Perth Glory,9522,8,10,2,15,37,50,-13,32
Wellington P,9522,9,5,6,16,31,55,-24,21
CC Mariners,9522,10,4,8,15,28,49,-21,20
Sydney FC,9523,1,21,4,3,65,22,43,67
N'castle Jet,9523,2,16,5,7,62,38,24,53
Melbourne C,9523,3,14,4,11,44,38,6,46
Melbourne V,9523,4,13,5,11,45,39,6,44
Adelaide Utd,9523,5,11,6,11,37,40,-3,39
Brisbane,9523,6,10,5,13,33,42,-9,35
Western Sydn,9523,7,8,9,10,38,47,-9,33
Perth Glory,9523,8,10,2,15,37,50,-13,32
Wellington P,9523,9,5,6,16,31,55,-24,21
CC Mariners,9523,10,4,8,15,28,49,-21,20
Sydney FC,9524,1,21,4,3,66,23,43,67
N'castle Jet,9524,2,16,5,7,61,37,24,53
Melbourne C,9524,3,14,4,11,43,37,6,46
Melbourne V,9524,4,13,5,11,46,40,6,44
Adelaide Utd,9524,5,11,6,11,37,40,-3,39
Brisbane,9524,6,10,5,13,33,42,-9,35
Western Sydn,9524,7,8,9,10,38,47,-9,33
Perth Glory,9524,8,10,2,15,37,50,-13,32
Wellington P,9524,9,5,6,16,31,55,-24,21
CC Mariners,9524,10,4,8,15,28,49,-21,20
Sydney FC,9525,1,20,4,4,64,23,41,64
N'castle Jet,9525,2,15,6,7,59,39,20,51
Melbourne C,9525,3,14,5,10,45,35,10,47
Melbourne V,9525,4,14,5,10,46,38,8,47
Adelaide Utd,9525,5,11,6,11,37,40,-3,39
Brisbane,9525,6,10,5,13,33,42,-9,35
Western Sydn,9525,7,8,9,10,38,47,-9,33
Perth Glory,9525,8,10,2,15,37,50,-13,32
Wellington P,9525,9,5,6,16,31,55,-24,21
CC Mariners,9525,10,4,8,15,28,49,-21,20
Sydney FC,9526,1,21,4,3,65,22,43,67
N'castle Jet,9526,2,16,5,7,61,37,24,53
Melbourne C,9526,3,14,4,11,43,37,6,46
Melbourne V,9526,4,13,5,11,45,39,6,44
Adelaide Utd,9526,5,11,6,11,37,40,-3,39
Brisbane,9526,6,10,5,13,33,42,-9,35
Western Sydn,9526,7,8,9,10,38,47,-9,33
Perth Glory,9526,8,10,2,15,37,50,-13,32
Wellington P,9526,9,5,6,16,31,55,-24,21
CC Mariners,9526,10,4,8,15,28,49,-21,20
Sydney FC,9527,1,21,4,3,65,22,43,67
N'castle Jet,9527,2,15,6,7,58,38,20,51
Melbourne C,9527,3,14,5,10,44,34,10,47
Melbourne V,9527,4,13,5,11,45,39,6,44
Adelaide Utd,9527,5,11,6,11,37,40,-3,39
Brisbane,9527,6,10,5,13,33,42,-9,35
Western Sydn,9527,7,8,9,10,38,47,-9,33
Perth Glory,9527,8,10,2,15,37,50,-13,32
Wellington P,9527,9,5,6,16,31,55,-24,21
CC Mariners,9527,10,4,8,15,28,49,-21,20
Sydney FC,9528,1,20,5,3,67,25,42,65
N'castle Jet,9528,2,15,5,8,57,38,19,50
Melbourne C,9528,3,15,4,10,44,33,11,49
Melbourne V,9528,4,13,6,10,48,41,7,45
Adelaide Utd,9528,5,11,6,11,37,40,-3,39
Brisbane,9528,6,10,5,13,33,42,-9,35
Western Sydn,9528,7,8,9,10,38,47,-9,33
Perth Glory,9528,8,10,2,15,37,50,-13,32
Wellington P,9528,9,5,6,16,31,55,-24,21
CC Mariners,9528,10,4,8,15,28,49,-21,20
Sydney FC,9529,1,20,5,3,65,23,42,65
N'castle Jet,9529,2,15,6,7,59,39,20,51
Melbourne C,9529,3,14,5,10,45,35,10,47
Melbourne V,9529,4,13,6,10,46,39,7,45
Adelaide Utd,9529,5,11,6,11,37,40,-3,39
Brisbane,9529,6,10,5,13,33,42,-9,35
Western Sydn,9529,7,8,9,10,38,47,-9,33
Perth Glory,9529,8,10,2,15,37,50,-13,32
Wellington P,9529,9,5,6,16,31,55,-24,21
CC Mariners,9529,10,4,8,15,28,49,-21,20
Sydney FC,9530,1,20,5,3,65,23,42,65
N'castle Jet,9530,2,16,5,7,60,38,22,53
Melbourne C,9530,3,14,4,11,44,36,8,46
Melbourne V,9530,4,13,6,10,46,39,7,45
Adelaide Utd,9530,5,11,6,11,37,40,-3,39
Brisbane,9530,6,10,5,13,33,42,-9,35
Western Sydn,9530,7,8,9,10,38,47,-9,33
Perth Glory,9530,8,10,2,15,37,50,-13,32
Wellington P,9530,9,5,6,16,31,55,-24,21
CC Mariners,9530,10,4,8,15,28,49,-21,20
Sydney FC,9531,1,21,4,3,68,22,46,67
N'castle Jet,9531,2,16,5,7,59,38,21,53
Melbourne C,9531,3,14,4,11,44,35,9,46
Melbourne V,9531,4,13,5,11,45,42,3,44
Adelaide Utd,9531,5,11,6,11,37,40,-3,39
Brisbane,9531,6,10,5,13,33,42,-9,35
Western Sydn,9531,7,8,9,10,38,47,-9,33
Perth Glory,9531,8,10,2,15,37,50,-13,32
Wellington P,9531,9,5,6,16,31,55,-24,21
CC Mariners,9531,10,4,8,15,28,49,-21,20
Sydney FC,9532,1,21,4,3,69,22,47,67
N'castle Jet,9532,2,16,5,7,60,37,23,53
Melbourne C,9532,3,14,4,11,43,36,7,46
Melbourne V,9532,4,13,5,11,45,43,2,44
Adelaide Utd,9532,5,11,6,11,37,40,-3,39
Brisbane,9532,6,10,5,13,33,42,-9,35
Western Sydn,9532,7,8,9,10,38,47,-9,33
Perth Glory,9532,8,10,2,15,37,50,-13,32
Wellington P,9532,9,5,6,16,31,55,-24,21
CC Mariners,9532,10,4,8,15,28,49,-21,20
Sydney FC,9533,1,20,4,4,64,25,39,64
N'castle Jet,9533,2,15,5,8,58,41,17,50
Melbourne C,9533,3,15,4,10,47,34,13,49
Melbourne V,9533,4,14,5,10,48,38,10,47
Adelaide Utd,9533,5,11,6,11,37,40,-3,39
Brisbane,9533,6,10,5,13,33,42,-9,35
Western Sydn,9533,7,8,9,10,38,47,-9,33
Perth Glory,9533,8,10,2,15,37,50,-13,32
Wellington P,9533,9,5,6,16,31,55,-24,21
CC Mariners,9533,10,4,8,15,28,49,-21,20
Sydney FC,9534,1,21,4,3,66,22,44,67
N'castle Jet,9534,2,15,5,8,59,40,19,50
Melbourne C,9534,3,15,4,10,46,35,11,49
Melbourne V,9534,4,13,5,11,45,40,5,44
Adelaide Utd,9534,5,11,6,11,37,40,-3,39
Brisbane,9534,6,10,5,13,33,42,-9,35
Western Sydn,9534,7,8,9,10,38,47,-9,33
Perth Glory,9534,8,10,2,15,37,50,-13,32
Wellington P,9534,9,5,6,16,31,55,-24,21
CC Mariners,9534,10,4,8,15,28,49,-21,20
Sydney FC,9535,1,21,4,3,66,23,43,67
N'castle Jet,9535,2,16,5,7,60,37,23,53
Melbourne C,9535,3,14,4,11,43,36,7,46
Melbourne V,9535,4,13,5,11,46,40,6,44
Adelaide Utd,9535,5,11,6,11,37,40,-3,39
Brisbane,9535,6,10,5,13,33,42,-9,35
Western Sydn,9535,7,8,9,10,38,47,-9,33
Perth Glory,9535,8,10,2,15,37,50,-13,32
Wellington P,9535,9,5,6,16,31,55,-24,21
CC Mariners,9535,10,4,8,15,28,49,-21,20
Sydney FC,9536,1,21,4,3,66,22,44,67
N'castle Jet,9536,2,16,5,7,59,37,22,53
Melbourne C,9536,3,14,4,11,43,35,8,46
Melbourne V,9536,4,13,5,11,45,40,5,44
Adelaide Utd,9536,5,11,6,11,37,40,-3,39
Brisbane,9536,6,10,5,13,33,42,-9,35
Western Sydn,9536,7,8,9,10,38,47,-9,33
Perth Glory,9536,8,10,2,15,37,50,-13,32
Wellington P,9536,9,5,6,16,31,55,-24,21
CC Mariners,9536,10,4,8,15,28,49,-21,20
Sydney FC,9537,1,21,4,3,66,23,43,67
N'castle Jet,9537,2,15,6,7,58,38,20,51
Melbourne C,9537,3,14,5,10,44,34,10,47
Melbourne V,9537,4,13,5,11,46,40,6,44
Adelaide Utd,9537,5,11,6,11,37,40,-3,39
Brisbane,9537,6,10,5,13,33,42,-9,35
Western Sydn,9537,7,8,9,10,38,47,-9,33
Perth Glory,9537,8,10,2,15,37,50,-13,32
Wellington P,9537,9,5,6,16,31,55,-24,21
CC Mariners,9537,10,4,8,15,28,49,-21,20
Sydney FC,9538,1,21,4,3,67,23,44,67
N'castle Jet,9538,2,16,5,7,61,38,23,53
Melbourne C,9538,3,14,4,11,44,37,7,46
Melbourne V,9538,4,13,5,11,46,41,5,44
Adelaide Utd,9538,5,11,6,11,37,40,-3,39
Brisbane,9538,6,10,5,13,33,42,-9,35
Western Sydn,9538,7,8,9,10,38,47,-9,33
Perth Glory,9538,8,10,2,15,37,50,-13,32
Wellington P,9538,9,5,6,16,31,55,-24,21
CC Mariners,9538,10,4,8,15,28,49,-21,20
Sydney FC,9539,1,21,4,3,66,23,43,67
N'castle Jet,9539,2,16,5,7,59,38,21,53
Melbourne C,9539,3,14,4,11,44,35,9,46
Melbourne V,9539,4,13,5,11,46,40,6,44
Adelaide Utd,9539,5,11,6,11,37,40,-3,39
Brisbane,9539,6,10,5,13,33,42,-9,35
Western Sydn,9539,7,8,9,10,38,47,-9,33
Perth Glory,9539,8,10,2,15,37,50,-13,32
Wellington P,9539,9,5,6,16,31,55,-24,21
CC Mariners,9539,10,4,8,15,28,49,-21,20
Sydney FC,9540,1,20,4,4,64,23,41,64
N'castle Jet,9540,2,16,5,7,59,37,22,53
Melbourne V,9540,3,14,5,10,46,38,8,47
Melbourne C,9540,4,14,4,11,43,35,8,46
Adelaide Utd,9540,5,11,6,11,37,40,-3,39
Brisbane,9540,6,10,5,13,33,42,-9,35
Western Sydn,9540,7,8,9,10,38,47,-9,33
Perth Glory,9540,8,10,2,15,37,50,-13,32
Wellington P,9540,9,5,6,16,31,55,-24,21
CC Mariners,9540,10,4,8,15,28,49,-21,20
Sydney FC,9541,1,21,4,3,66,22,44,67
N'castle Jet,9541,2,15,5,8,58,39,19,50
Melbourne C,9541,3,15,4,10,45,34,11,49
Melbourne V,9541,4,13,5,11,45,40,5,44
Adelaide Utd,9541,5,11,6,11,37,40,-3,39
Brisbane,9541,6,10,5,13,33,42,-9,35
Western Sydn,9541,7,8,9,10,38,47,-9,33
Perth Glory,9541,8,10,2,15,37,50,-13,32
Wellington P,9541,9,5,6,16,31,55,-24,21
CC Mariners,9541,10,4,8,15,28,49,-21,20
Sydney FC,9542,1,21,4,3,65,22,43,67
N'castle Jet,9542,2,16,5,7,61,37,24,53
Melbourne C,9542,3,14,4,11,43,37,6,46
Melbourne V,9542,4,13,5,11,45,39,6,44
Adelaide Utd,9542,5,11,6,11,37,40,-3,39
Brisbane,9542,6,10,5,13,33,42,-9,35
Western Sydn,9542,7,8,9,10,38,47,-9,33
Perth Glory,9542,8,10,2,15,37,50,-13,32
Wellington P,9542,9,5,6,16,31,55,-24,21
CC Mariners,9542,10,4,8,15,28,49,-21,20
Sydney FC,9543,1,21,4,3,67,22,45,67
N'castle Jet,9543,2,16,5,7,59,38,21,53
Melbourne C,9543,3,14,4,11,44,35,9,46
Melbourne V,9543,4,13,5,11,45,41,4,44
Adelaide Utd,9543,5,11,6,11,37,40,-3,39
Brisbane,9543,6,10,5,13,33,42,-9,35
Western Sydn,9543,7,8,9,10,38,47,-9,33
Perth Glory,9543,8,10,2,15,37,50,-13,32
Wellington P,9543,9,5,6,16,31,55,-24,21
CC Mariners,9543,10,4,8,15,28,49,-21,20
Sydney FC,9544,1,20,4,4,65,26,39,64
N'castle Jet,9544,2,16,5,7,63,38,25,53
Melbourne V,9544,3,14,5,10,49,39,10,47
Melbourne C,9544,4,14,4,11,44,39,5,46
Adelaide Utd,9544,5,11,6,11,37,40,-3,39
Brisbane,9544,6,10,5,13,33,42,-9,35
Western Sydn,9544,7,8,9,10,38,47,-9,33
Perth Glory,9544,8,10,2,15,37,50,-13,32
Wellington P,9544,9,5,6,16,31,55,-24,21
CC Mariners,9544,10,4,8,15,28,49,-21,20
Sydney FC,9545,1,21,4,3,65,22,43,67
N'castle Jet,9545,2,16,5,7,59,38,21,53
Melbourne C,9545,3,14,4,11,44,35,9,46
Melbourne V,9545,4,13,5,11,45,39,6,44
Adelaide Utd,9545,5,11,6,11,37,40,-3,39
Brisbane,9545,6,10,5,13,33,42,-9,35
Western Sydn,9545,7,8,9,10,38,47,-9,33
Perth Glory,9545,8,10,2,15,37,50,-13,32
Wellington P,9545,9,5,6,16,31,55,-24,21
CC Mariners,9545,10,4,8,15,28,49,-21,20
Sydney FC,9546,1,21,4,3,69,22,47,67
N'castle Jet,9546,2,16,5,7,59,38,21,53
Melbourne C,9546,3,14,4,11,44,35,9,46
Melbourne V,9546,4,13,5,11,45,43,2,44
Adelaide Utd,9546,5,11,6,11,37,40,-3,39
Brisbane,9546,6,10,5,13,33,42,-9,35
Western Sydn,9546,7,8,9,10,38,47,-9,33
Perth Glory,9546,8,10,2,15,37,50,-13,32
Wellington P,9546,9,5,6,16,31,55,-24,21
CC Mariners,9546,10,4,8,15,28,49,-21,20
Sydney FC,9547,1,21,4,3,67,24,43,67
N'castle Jet,9547,2,16,5,7,58,37,21,53
Melbourne C,9547,3,14,4,11,43,34,9,46
Melbourne V,9547,4,13,5,11,47,41,6,44
Adelaide Utd,9547,5,11,6,11,37,40,-3,39
Brisbane,9547,6,10,5,13,33,42,-9,35
Western Sydn,9547,7,8,9,10,38,47,-9,33
Perth Glory,9547,8,10,2,15,37,50,-13,32
Wellington P,9547,9,5,6,16,31,55,-24,21
CC Mariners,9547,10,4,8,15,28,49,-21,20
Sydney FC,9548,1,21,4,3,67,22,45,67
N'castle Jet,9548,2,16,5,7,59,38,21,53
Melbourne C,9548,3,14,4,11,44,35,9,46
Melbourne V,9548,4,13,5,11,45,41,4,44
Adelaide Utd,9548,5,11,6,11,37,40,-3,39
Brisbane,9548,6,10,5,13,33,42,-9,35
Western Sydn,9548,7,8,9,10,38,47,-9,33
Perth Glory,9548,8,10,2,15,37,50,-13,32
Wellington P,9548,9,5,6,16,31,55,-24,21
CC Mariners,9548,10,4,8,15,28,49,-21,20
Sydney FC,9549,1,21,4,3,66,22,44,67
N'castle Jet,9549,2,16,5,7,59,37,22,53
Melbourne C,9549,3,14,4,11,43,35,8,46
Melbourne V,9549,4,13,5,11,45,40,5,44
Adelaide Utd,9549,5,11,6,11,37,40,-3,39
Brisbane,9549,6,10,5,13,33,42,-9,35
Western Sydn,9549,7,8,9,10,38,47,-9,33
Perth Glory,9549,8,10,2,15,37,50,-13,32
Wellington P,9549,9,5,6,16,31,55,-24,21
CC Mariners,9549,10,4,8,15,28,49,-21,20
Sydney FC,9550,1,20,5,3,65,23,42,65
N'castle Jet,9550,2,15,5,8,58,39,19,50
Melbourne C,9550,3,15,4,10,45,34,11,49
Melbourne V,9550,4,13,6,10,46,39,7,45
Adelaide Utd,9550,5,11,6,11,37,40,-3,39
Brisbane,9550,6,10,5,13,33,42,-9,35
Western Sydn,9550,7,8,9,10,38,47,-9,33
Perth Glory,9550,8,10,2,15,37,50,-13,32
Wellington P,9550,9,5,6,16,31,55,-24,21
CC Mariners,9550,10,4,8,15,28,49,-21,20
Sydney FC,9551,1,20,4,4,64,25,39,64
N'castle Jet,9551,2,16,5,7,58,37,21,53
Melbourne V,9551,3,14,5,10,48,38,10,47
Melbourne C,9551,4,14,4,11,43,34,9,46
Adelaide Utd,9551,5,11,6,11,37,40,-3,39
Brisbane,9551,6,10,5,13,33,42,-9,35
Western Sydn,9551,7,8,9,10,38,47,-9,33
Perth Glory,9551,8,10,2,15,37,50,-13,32
Wellington P,9551,9,5,6,16,31,55,-24,21
CC Mariners,9551,10,4,8,15,28,49,-21,20
Sydney FC,9552,1,21,4,3,67,22,45,67
N'castle Jet,9552,2,16,5,7,61,38,23,53
Melbourne C,9552,3,14,4,11,44,37,7,46
Melbourne V,9552,4,13,5,11,45,41,4,44
Adelaide Utd,9552,5,11,6,11,37,40,-3,39
Brisbane,9552,6,10,5,13,33,42,-9,35
Western Sydn,9552,7,8,9,10,38,47,-9,33
Perth Glory,9552,8,10,2,15,37,50,-13,32
Wellington P,9552,9,5,6,16,31,55,-24,21
CC Mariners,9552,10,4,8,15,28,49,-21,20
Sydney FC,9553,1,21,4,3,67,24,43,67
N'castle Jet,9553,2,15,6,7,59,39,20,51
Melbourne C,9553,3,14,5,10,45,35,10,47
Melbourne V,9553,4,13,5,11,47,41,6,44
Adelaide Utd,9553,5,11,6,11,37,40,-3,39
Brisbane,9553,6,10,5,13,33,42,-9,35
Western Sydn,9553,7,8,9,10,38,47,-9,33
Perth Glory,9553,8,10,2,15,37,50,-13,32
Wellington P,9553,9,5,6,16,31,55,-24,21
CC Mariners,9553,10,4,8,15,28,49,-21,20
Sydney FC,9554,1,21,4,3,67,22,45,67
N'castle Jet,9554,2,16,5,7,62,39,23,53
Melbourne C,9554,3,14,4,11,45,38,7,46
Melbourne V,9554,4,13,5,11,45,41,4,44
Adelaide Utd,9554,5,11,6,11,37,40,-3,39
Brisbane,9554,6,10,5,13,33,42,-9,35
Western Sydn,9554,7,8,9,10,38,47,-9,33
Perth Glory,9554,8,10,2,15,37,50,-13,32
Wellington P,9554,9,5,6,16,31,55,-24,21
CC Mariners,9554,10,4,8,15,28,49,-21,20
Sydney FC,9555,1,21,4,3,65,22,43,67
N'castle Jet,9555,2,16,5,7,59,38,21,53
Melbourne C,9555,3,14,4,11,44,35,9,46
Melbourne V,9555,4,13,5,11,45,39,6,44
Adelaide Utd,9555,5,11,6,11,37,40,-3,39
Brisbane,9555,6,10,5,13,33,42,-9,35
Western Sydn,9555,7,8,9,10,38,47,-9,33
Perth Glory,9555,8,10,2,15,37,50,-13,32
Wellington P,9555,9,5,6,16,31,55,-24,21
CC Mariners,9555,10,4,8,15,28,49,-21,20
Sydney FC,9556,1,21,4,3,65,22,43,67
N'castle Jet,9556,2,16,5,7,60,39,21,53
Melbourne C,9556,3,14,4,11,45,36,9,46
Melbourne V,9556,4,13,5,11,45,39,6,44
Adelaide Utd,9556,5,11,6,11,37,40,-3,39
Brisbane,9556,6,10,5,13,33,42,-9,35
Western Sydn,9556,7,8,9,10,38,47,-9,33
Perth Glory,9556,8,10,2,15,37,50,-13,32
Wellington P,9556,9,5,6,16,31,55,-24,21
CC Mariners,9556,10,4,8,15,28,49,-21,20
Sydney FC,9557,1,20,4,4,64,23,41,64
N'castle Jet,9557,2,15,6,7,59,39,20,51
Melbourne C,9557,3,14,5,10,45,35,10,47
Melbourne V,9557,4,14,5,10,46,38,8,47
Adelaide Utd,9557,5,11,6,11,37,40,-3,39
Brisbane,9557,6,10,5,13,33,42,-9,35
Western Sydn,9557,7,8,9,10,38,47,-9,33
Perth Glory,9557,8,10,2,15,37,50,-13,32
Wellington P,9557,9,5,6,16,31,55,-24,21
CC Mariners,9557,10,4,8,15,28,49,-21,20
Sydney FC,9558,1,21,4,3,67,23,44,67
N'castle Jet,9558,2,15,6,7,57,37,20,51
Melbourne C,9558,3,14,5,10,43,33,10,47
Melbourne V,9558,4,13,5,11,46,41,5,44
Adelaide Utd,9558,5,11,6,11,37,40,-3,39
Brisbane,9558,6,10,5,13,33,42,-9,35
Western Sydn,9558,7,8,9,10,38,47,-9,33
Perth Glory,9558,8,10,2,15,37,50,-13,32
Wellington P,9558,9,5,6,16,31,55,-24,21
CC Mariners,9558,10,4,8,15,28,49,-21,20
Sydney FC,9559,1,20,5,3,66,24,42,65
N'castle Jet,9559,2,15,6,7,57,37,20,51
Melbourne C,9559,3,14,5,10,43,33,10,47
Melbourne V,9559,4,13,6,10,47,40,7,45
Adelaide Utd,9559,5,11,6,11,37,40,-3,39
Brisbane,9559,6,10,5,13,33,42,-9,35
Western Sydn,9559,7,8,9,10,38,47,-9,33
Perth Glory,9559,8,10,2,15,37,50,-13,32
Wellington P,9559,9,5,6,16,31,55,-24,21
CC Mariners,9559,10,4,8,15,28,49,-21,20
Sydney FC,9560,1,20,5,3,67,25,42,65
N'castle Jet,9560,2,15,6,7,59,39,20,51
Melbourne C,9560,3,14,5,10,45,35,10,47
Melbourne V,9560,4,13,6,10,48,41,7,45
Adelaide Utd,9560,5,11,6,11,37,40,-3,39
Brisbane,9560,6,10,5,13,33,42,-9,35
Western Sydn,9560,7,8,9,10,38,47,-9,33
Perth Glory,9560,8,10,2,15,37,50,-13,32
Wellington P,9560,9,5,6,16,31,55,-24,21
CC Mariners,9560,10,4,8,15,28,49,-21,20
Sydney FC,9561,1,20,5,3,65,23,42,65
N'castle Jet,9561,2,16,5,7,58,37,21,53
Melbourne C,9561,3,14,4,11,43,34,9,46
Melbourne V,9561,4,13,6,10,46,39,7,45
Adelaide Utd,9561,5,11,6,11,37,40,-3,39
Brisbane,9561,6,10,5,13,33,42,-9,35
Western Sydn,9561,7,8,9,10,38,47,-9,33
Perth Glory,9561,8,10,2,15,37,50,-13,32
Wellington P,9561,9,5,6,16,31,55,-24,21
CC Mariners,9561,10,4,8,15,28,49,-21,20
Sydney FC,9562,1,20,5,3,66,24,42,65
N'castle Jet,9562,2,16,5,7,59,38,21,53
Melbourne C,9562,3,14,4,11,44,35,9,46
Melbourne V,9562,4,13,6,10,47,40,7,45
Adelaide Utd,9562,5,11,6,11,37,40,-3,39
Brisbane,9562,6,10,5,13,33,42,-9,35
Western Sydn,9562,7,8,9,10,38,47,-9,33
Perth Glory,9562,8,10,2,15,37,50,-13,32
Wellington P,9562,9,5,6,16,31,55,-24,21
CC Mariners,9562,10,4,8,15,28,49,-21,20
Sydney FC,9563,1,21,4,3,68,22,46,67
N'castle Jet,9563,2,16,5,7,59,37,22,53
Melbourne C,9563,3,14,4,11,43,35,8,46
Melbourne V,9563,4,13,5,11,45,42,3,44
Adelaide Utd,9563,5,11,6,11,37,40,-3,39
Brisbane,9563,6,10,5,13,33,42,-9,35
Western Sydn,9563,7,8,9,10,38,47,-9,33
Perth Glory,9563,8,10,2,15,37,50,-13,32
Wellington P,9563,9,5,6,16,31,55,-24,21
CC Mariners,9563,10,4,8,15,28,49,-21,20
Sydney FC,9564,1,20,4,4,65,24,41,64
N'castle Jet,9564,2,15,6,7,58,38,20,51
Melbourne C,9564,3,14,5,10,44,34,10,47
Melbourne V,9564,4,14,5,10,47,39,8,47
Adelaide Utd,9564,5,11,6,11,37,40,-3,39
Brisbane,9564,6,10,5,13,33,42,-9,35
Western Sydn,9564,7,8,9,10,38,47,-9,33
Perth Glory,9564,8,10,2,15,37,50,-13,32
Wellington P,9564,9,5,6,16,31,55,-24,21
CC Mariners,9564,10,4,8,15,28,49,-21,20
Sydney FC,9565,1,21,4,3,70,23,47,67
N'castle Jet,9565,2,15,5,8,57,39,18,50
Melbourne C,9565,3,15,4,10,45,33,12,49
Melbourne V,9565,4,13,5,11,46,44,2,44
Adelaide Utd,9565,5,11,6,11,37,40,-3,39
Brisbane,9565,6,10,5,13,33,42,-9,35
Western Sydn,9565,7,8,9,10,38,47,-9,33
Perth Glory,9565,8,10,2,15,37,50,-13,32
Wellington P,9565,9,5,6,16,31,55,-24,21
CC Mariners,9565,10,4,8,15,28,49,-21,20
Sydney FC,9566,1,21,4,3,70,24,46,67
N'castle Jet,9566,2,16,5,7,58,37,21,53
Melbourne C,9566,3,14,4,11,43,34,9,46
Melbourne V,9566,4,13,5,11,47,44,3,44
Adelaide Utd,9566,5,11,6,11,37,40,-3,39
Brisbane,9566,6,10,5,13,33,42,-9,35
Western Sydn,9566,7,8,9,10,38,47,-9,33
Perth Glory,9566,8,10,2,15,37,50,-13,32
Wellington P,9566,9,5,6,16,31,55,-24,21
CC Mariners,9566,10,4,8,15,28,49,-21,20
Sydney FC,9567,1,21,4,3,68,24,44,67
N'castle Jet,9567,2,16,5,7,60,37,23,53
Melbourne C,9567,3,14,4,11,43,36,7,46
Melbourne V,9567,4,13,5,11,47,42,5,44
Adelaide Utd,9567,5,11,6,11,37,40,-3,39
Brisbane,9567,6,10,5,13,33,42,-9,35
Western Sydn,9567,7,8,9,10,38,47,-9,33
Perth Glory,9567,8,10,2,15,37,50,-13,32
Wellington P,9567,9,5,6,16,31,55,-24,21
CC Mariners,9567,10,4,8,15,28,49,-21,20
Sydney FC,9568,1,21,4,3,65,22,43,67
N'castle Jet,9568,2,16,5,7,62,37,25,53
Melbourne C,9568,3,14,4,11,43,38,5,46
Melbourne V,9568,4,13,5,11,45,39,6,44
Adelaide Utd,9568,5,11,6,11,37,40,-3,39
Brisbane,9568,6,10,5,13,33,42,-9,35
Western Sydn,9568,7,8,9,10,38,47,-9,33
Perth Glory,9568,8,10,2,15,37,50,-13,32
Wellington P,9568,9,5,6,16,31,55,-24,21
CC Mariners,9568,10,4,8,15,28,49,-21,20
Sydney FC,9569,1,21,4,3,68,22,46,67
N'castle Jet,9569,2,15,6,7,59,39,20,51
Melbourne C,9569,3,14,5,10,45,35,10,47
Melbourne V,9569,4,13,5,11,45,42,3,44
Adelaide Utd,9569,5,11,6,11,37,40,-3,39
Brisbane,9569,6,10,5,13,33,42,-9,35
Western Sydn,9569,7,8,9,10,38,47,-9,33
Perth Glory,9569,8,10,2,15,37,50,-13,32
Wellington P,9569,9,5,6,16,31,55,-24,21
CC Mariners,9569,10,4,8,15,28,49,-21,20
Sydney FC,9570,1,20,5,3,65,23,42,65
N'castle Jet,9570,2,16,5,7,60,38,22,53
Melbourne C,9570,3,14,4,11,44,36,8,46
Melbourne V,9570,4,13,6,10,46,39,7,45
Adelaide Utd,9570,5,11,6,11,37,40,-3,39
Brisbane,9570,6,10,5,13,33,42,-9,35
Western Sydn,9570,7,8,9,10,38,47,-9,33
Perth Glory,9570,8,10,2,15,37,50,-13,32
Wellington P,9570,9,5,6,16,31,55,-24,21
CC Mariners,9570,10,4,8,15,28,49,-21,20
Sydney FC,9571,1,20,4,4,65,24,41,64
N'castle Jet,9571,2,15,6,7,58,38,20,51
Melbourne C,9571,3,14,5,10,44,34,10,47
Melbourne V,9571,4,14,5,10,47,39,8,47
Adelaide Utd,9571,5,11,6,11,37,40,-3,39
Brisbane,9571,6,10,5,13,33,42,-9,35
Western Sydn,9571,7,8,9,10,38,47,-9,33
Perth Glory,9571,8,10,2,15,37,50,-13,32
Wellington P,9571,9,5,6,16,31,55,-24,21
CC Mariners,9571,10,4,8,15,28,49,-21,20
Sydney FC,9572,1,21,4,3,66,22,44,67
N'castle Jet,9572,2,16,5,7,60,37,23,53
Melbourne C,9572,3,14,4,11,43,36,7,46
Melbourne V,9572,4,13,5,11,45,40,5,44
Adelaide Utd,9572,5,11,6,11,37,40,-3,39
Brisbane,9572,6,10,5,13,33,42,-9,35
Western Sydn,9572,7,8,9,10,38,47,-9,33
Perth Glory,9572,8,10,2,15,37,50,-13,32
Wellington P,9572,9,5,6,16,31,55,-24,21
CC Mariners,9572,10,4,8,15,28,49,-21,20
Sydney FC,9573,1,20,4,4,65,25,40,64
N'castle Jet,9573,2,15,6,7,57,37,20,51
Melbourne C,9573,3,14,5,10,43,33,10,47
Melbourne V,9573,4,14,5,10,48,39,9,47
Adelaide Utd,9573,5,11,6,11,37,40,-3,39
Brisbane,9573,6,10,5,13,33,42,-9,35
Western Sydn,9573,7,8,9,10,38,47,-9,33
Perth Glory,9573,8,10,2,15,37,50,-13,32
Wellington P,9573,9,5,6,16,31,55,-24,21
CC Mariners,9573,10,4,8,15,28,49,-21,20
Sydney FC,9574,1,20,5,3,65,23,42,65
N'castle Jet,9574,2,15,5,8,60,41,19,50
Melbourne C,9574,3,15,4,10,47,36,11,49
Melbourne V,9574,4,13,6,10,46,39,7,45
Adelaide Utd,9574,5,11,6,11,37,40,-3,39
Brisbane,9574,6,10,5,13,33,42,-9,35
Western Sydn,9574,7,8,9,10,38,47,-9,33
Perth Glory,9574,8,10,2,15,37,50,-13,32
Wellington P,9574,9,5,6,16,31,55,-24,21
CC Mariners,9574,10,4,8,15,28,49,-21,20
Sydney FC,9575,1,21,4,3,65,22,43,67
N'castle Jet,9575,2,15,6,7,59,39,20,51
Melbourne C,9575,3,14,5,10,45,35,10,47
Melbourne V,9575,4,13,5,11,45,39,6,44
Adelaide Utd,9575,5,11,6,11,37,40,-3,39
Brisbane,9575,6,10,5,13,33,42,-9,35
Western Sydn,9575,7,8,9,10,38,47,-9,33
Perth Glory,9575,8,10,2,15,37,50,-13,32
Wellington P,9575,9,5,6,16,31,55,-24,21
CC Mariners,9575,10,4,8,15,28,49,-21,20
Sydney FC,9576,1,20,4,4,64,26,38,64
N'castle Jet,9576,2,16,5,7,59,38,21,53
Melbourne V,9576,3,14,5,10,49,38,11,47
Melbourne C,9576,4,14,4,11,44,35,9,46
Adelaide Utd,9576,5,11,6,11,37,40,-3,39
Brisbane,9576,6,10,5,13,33,42,-9,35
Western Sydn,9576,7,8,9,10,38,47,-9,33
Perth Glory,9576,8,10,2,15,37,50,-13,32
Wellington P,9576,9,5,6,16,31,55,-24,21
CC Mariners,9576,10,4,8,15,28,49,-21,20
Sydney FC,9577,1,20,5,3,64,22,42,65
N'castle Jet,9577,2,16,5,7,58,37,21,53
Melbourne C,9577,3,14,4,11,43,34,9,46
Melbourne V,9577,4,13,6,10,45,38,7,45
Adelaide Utd,9577,5,11,6,11,37,40,-3,39
Brisbane,9577,6,10,5,13,33,42,-9,35
Western Sydn,9577,7,8,9,10,38,47,-9,33
Perth Glory,9577,8,10,2,15,37,50,-13,32
Wellington P,9577,9,5,6,16,31,55,-24,21
CC Mariners,9577,10,4,8,15,28,49,-21,20
Sydney FC,9578,1,21,4,3,66,22,44,67
N'castle Jet,9578,2,15,5,8,58,40,18,50
Melbourne C,9578,3,15,4,10,46,34,12,49
Melbourne V,9578,4,13,5,11,45,40,5,44
Adelaide Utd,9578,5,11,6,11,37,40,-3,39
Brisbane,9578,6,10,5,13,33,42,-9,35
Western Sydn,9578,7,8,9,10,38,47,-9,33
Perth Glory,9578,8,10,2,15,37,50,-13,32
Wellington P,9578,9,5,6,16,31,55,-24,21
CC Mariners,9578,10,4,8,15,28,49,-21,20
Sydney FC,9579,1,20,5,3,67,25,42,65
N'castle Jet,9579,2,16,5,7,60,38,22,53
Melbourne C,9579,3,14,4,11,44,36,8,46
Melbourne V,9579,4,13,6,10,48,41,7,45
Adelaide Utd,9579,5,11,6,11,37,40,-3,39
Brisbane,9579,6,10,5,13,33,42,-9,35
Western Sydn,9579,7,8,9,10,38,47,-9,33
Perth Glory,9579,8,10,2,15,37,50,-13,32
Wellington P,9579,9,5,6,16,31,55,-24,21
CC Mariners,9579,10,4,8,15,28,49,-21,20
Sydney FC,9580,1,21,4,3,68,23,45,67
N'castle Jet,9580,2,16,5,7,60,39,21,53
Melbourne C,9580,3,14,4,11,45,36,9,46
Melbourne V,9580,4,13,5,11,46,42,4,44
Adelaide Utd,9580,5,11,6,11,37,40,-3,39
Brisbane,9580,6,10,5,13,33,42,-9,35
Western Sydn,9580,7,8,9,10,38,47,-9,33
Perth Glory,9580,8,10,2,15,37,50,-13,32
Wellington P,9580,9,5,6,16,31,55,-24,21
CC Mariners,9580,10,4,8,15,28,49,-21,20
Sydney FC,9581,1,21,4,3,68,22,46,67
N'castle Jet,9581,2,15,5,8,57,40,17,50
Melbourne C,9581,3,15,4,10,46,33,13,49
Melbourne V,9581,4,13,5,11,45,42,3,44
Adelaide Utd,9581,5,11,6,11,37,40,-3,39
Brisbane,9581,6,10,5,13,33,42,-9,35
Western Sydn,9581,7,8,9,10,38,47,-9,33
Perth Glory,9581,8,10,2,15,37,50,-13,32
Wellington P,9581,9,5,6,16,31,55,-24,21
CC Mariners,9581,10,4,8,15,28,49,-21,20
Sydney FC,9582,1,21,4,3,68,24,44,67
N'castle Jet,9582,2,16,5,7,59,37,22,53
Melbourne C,9582,3,14,4,11,43,35,8,46
Melbourne V,9582,4,13,5,11,47,42,5,44
Adelaide Utd,9582,5,11,6,11,37,40,-3,39
Brisbane,9582,6,10,5,13,33,42,-9,35
Western Sydn,9582,7,8,9,10,38,47,-9,33
Perth Glory,9582,8,10,2,15,37,50,-13,32
Wellington P,9582,9,5,6,16,31,55,-24,21
CC Mariners,9582,10,4,8,15,28,49,-21,20
Sydney FC,9583,1,21,4,3,68,23,45,67
N'castle Jet,9583,2,16,5,7,61,37,24,53
Melbourne C,9583,3,14,4,11,43,37,6,46
Melbourne V,9583,4,13,5,11,46,42,4,44
Adelaide Utd,9583,5,11,6,11,37,40,-3,39
Brisbane,9583,6,10,5,13,33,42,-9,35
Western Sydn,9583,7,8,9,10,38,47,-9,33
Perth Glory,9583,8,10,2,15,37,50,-13,32
Wellington P,9583,9,5,6,16,31,55,-24,21
CC Mariners,9583,10,4,8,15,28,49,-21,20
Sydney FC,9584,1,20,5,3,66,24,42,65
N'castle Jet,9584,2,15,5,8,58,39,19,50
Melbourne C,9584,3,15,4,10,45,34,11,49
Melbourne V,9584,4,13,6,10,47,40,7,45
Adelaide Utd,9584,5,11,6,11,37,40,-3,39
Brisbane,9584,6,10,5,13,33,42,-9,35
Western Sydn,9584,7,8,9,10,38,47,-9,33
Perth Glory,9584,8,10,2,15,37,50,-13,32
Wellington P,9584,9,5,6,16,31,55,-24,21
CC Mariners,9584,10,4,8,15,28,49,-21,20
Sydney FC,9585,1,20,4,4,65,25,40,64
N'castle Jet,9585,2,16,5,7,60,38,22,53
Melbourne V,9585,3,14,5,10,48,39,9,47
Melbourne C,9585,4,14,4,11,44,36,8,46
Adelaide Utd,9585,5,11,6,11,37,40,-3,39
Brisbane,9585,6,10,5,13,33,42,-9,35
Western Sydn,9585,7,8,9,10,38,47,-9,33
Perth Glory,9585,8,10,2,15,37,50,-13,32
Wellington P,9585,9,5,6,16,31,55,-24,21
CC Mariners,9585,10,4,8,15,28,49,-21,20
Sydney FC,9586,1,21,4,3,68,22,46,67
N'castle Jet,9586,2,16,5,7,60,37,23,53
Melbourne C,9586,3,14,4,11,43,36,7,46
Melbourne V,9586,4,13,5,11,45,42,3,44
Adelaide Utd,9586,5,11,6,11,37,40,-3,39
Brisbane,9586,6,10,5,13,33,42,-9,35
Western Sydn,9586,7,8,9,10,38,47,-9,33
Perth Glory,9586,8,10,2,15,37,50,-13,32
Wellington P,9586,9,5,6,16,31,55,-24,21
CC Mariners,9586,10,4,8,15,28,49,-21,20
Sydney FC,9587,1,20,4,4,64,24,40,64
N'castle Jet,9587,2,16,5,7,60,37,23,53
Melbourne V,9587,3,14,5,10,47,38,9,47
Melbourne C,9587,4,14,4,11,43,36,7,46
Adelaide Utd,9587,5,11,6,11,37,40,-3,39
Brisbane,9587,6,10,5,13,33,42,-9,35
Western Sydn,9587,7,8,9,10,38,47,-9,33
Perth Glory,9587,8,10,2,15,37,50,-13,32
Wellington P,9587,9,5,6,16,31,55,-24,21
CC Mariners,9587,10,4,8,15,28,49,-21,20
Sydney FC,9588,1,21,4,3,66,22,44,67
N'castle Jet,9588,2,16,5,7,58,37,21,53
Melbourne C,9588,3,14,4,11,43,34,9,46
Melbourne V,9588,4,13,5,11,45,40,5,44
Adelaide Utd,9588,5,11,6,11,37,40,-3,39
Brisbane,9588,6,10,5,13,33,42,-9,35
Western Sydn,9588,7,8,9,10,38,47,-9,33
Perth Glory,9588,8,10,2,15,37,50,-13,32
Wellington P,9588,9,5,6,16,31,55,-24,21
CC Mariners,9588,10,4,8,15,28,49,-21,20
Sydney FC,9589,1,21,4,3,67,23,44,67
N'castle Jet,9589,2,15,6,7,59,39,20,51
Melbourne C,9589,3,14,5,10,45,35,10,47
Melbourne V,9589,4,13,5,11,46,41,5,44
Adelaide Utd,9589,5,11,6,11,37,40,-3,39
Brisbane,9589,6,10,5,13,33,42,-9,35
Western Sydn,9589,7,8,9,10,38,47,-9,33
Perth Glory,9589,8,10,2,15,37,50,-13,32
Wellington P,9589,9,5,6,16,31,55,-24,21
CC Mariners,9589,10,4,8,15,28,49,-21,20
Sydney FC,9590,1,21,4,3,67,22,45,67
N'castle Jet,9590,2,16,5,7,59,38,21,53
Melbourne C,9590,3,14,4,11,44,35,9,46
Melbourne V,9590,4,13,5,11,45,41,4,44
Adelaide Utd,9590,5,11,6,11,37,40,-3,39
Brisbane,9590,6,10,5,13,33,42,-9,35
Western Sydn,9590,7,8,9,10,38,47,-9,33
Perth Glory,9590,8,10,2,15,37,50,-13,32
Wellington P,9590,9,5,6,16,31,55,-24,21
CC Mariners,9590,10,4,8,15,28,49,-21,20
Sydney FC,9591,1,21,4,3,68,23,45,67
N'castle Jet,9591,2,15,6,7,59,39,20,51
Melbourne C,9591,3,14,5,10,45,35,10,47
Melbourne V,9591,4,13,5,11,46,42,4,44
Adelaide Utd,9591,5,11,6,11,37,40,-3,39
Brisbane,9591,6,10,5,13,33,42,-9,35
Western Sydn,9591,7,8,9,10,38,47,-9,33
Perth Glory,9591,8,10,2,15,37,50,-13,32
Wellington P,9591,9,5,6,16,31,55,-24,21
CC Mariners,9591,10,4,8,15,28,49,-21,20
Sydney FC,9592,1,21,4,3,68,22,46,67
N'castle Jet,9592,2,16,5,7,59,37,22,53
Melbourne C,9592,3,14,4,11,43,35,8,46
Melbourne V,9592,4,13,5,11,45,42,3,44
Adelaide Utd,9592,5,11,6,11,37,40,-3,39
Brisbane,9592,6,10,5,13,33,42,-9,35
Western Sydn,9592,7,8,9,10,38,47,-9,33
Perth Glory,9592,8,10,2,15,37,50,-13,32
Wellington P,9592,9,5,6,16,31,55,-24,21
CC Mariners,9592,10,4,8,15,28,49,-21,20
Sydney FC,9593,1,21,4,3,66,22,44,67
N'castle Jet,9593,2,15,6,7,57,37,20,51
Melbourne C,9593,3,14,5,10,43,33,10,47
Melbourne V,9593,4,13,5,11,45,40,5,44
Adelaide Utd,9593,5,11,6,11,37,40,-3,39
Brisbane,9593,6,10,5,13,33,42,-9,35
Western Sydn,9593,7,8,9,10,38,47,-9,33
Perth Glory,9593,8,10,2,15,37,50,-13,32
Wellington P,9593,9,5,6,16,31,55,-24,21
CC Mariners,9593,10,4,8,15,28,49,-21,20
Sydney FC,9594,1,21,4,3,70,24,46,67
N'castle Jet,9594,2,15,5,8,58,40,18,50
Melbourne C,9594,3,15,4,10,46,34,12,49
Melbourne V,9594,4,13,5,11,47,44,3,44
Adelaide Utd,9594,5,11,6,11,37,40,-3,39
Brisbane,9594,6,10,5,13,33,42,-9,35
Western Sydn,9594,7,8,9,10,38,47,-9,33
Perth Glory,9594,8,10,2,15,37,50,-13,32
Wellington P,9594,9,5,6,16,31,55,-24,21
CC Mariners,9594,10,4,8,15,28,49,-21,20
Sydney FC,9595,1,20,4,4,64,24,40,64
N'castle Jet,9595,2,16,5,7,58,37,21,53
Melbourne V,9595,3,14,5,10,47,38,9,47
Melbourne C,9595,4,14,4,11,43,34,9,46
Adelaide Utd,9595,5,11,6,11,37,40,-3,39
Brisbane,9595,6,10,5,13,33,42,-9,35
Western Sydn,9595,7,8,9,10,38,47,-9,33
Perth Glory,9595,8,10,2,15,37,50,-13,32
Wellington P,9595,9,5,6,16,31,55,-24,21
CC Mariners,9595,10,4,8,15,28,49,-21,20
Sydney FC,9596,1,21,4,3,67,22,45,67
N'castle Jet,9596,2,15,5,8,57,38,19,50
Melbourne C,9596,3,15,4,10,44,33,11,49
Melbourne V,9596,4,13,5,11,45,41,4,44
Adelaide Utd,9596,5,11,6,11,37,40,-3,39
Brisbane,9596,6,10,5,13,33,42,-9,35
Western Sydn,9596,7,8,9,10,38,47,-9,33
Perth Glory,9596,8,10,2,15,37,50,-13,32
Wellington P,9596,9,5,6,16,31,55,-24,21
CC Mariners,9596,10,4,8,15,28,49,-21,20
Sydney FC,9597,1,21,4,3,66,23,43,67
N'castle Jet,9597,2,15,5,8,58,40,18,50
Melbourne C,9597,3,15,4,10,46,34,12,49
Melbourne V,9597,4,13,5,11,46,40,6,44
Adelaide Utd,9597,5,11,6,11,37,40,-3,39
Brisbane,9597,6,10,5,13,33,42,-9,35
Western Sydn,9597,7,8,9,10,38,47,-9,33
Perth Glory,9597,8,10,2,15,37,50,-13,32
Wellington P,9597,9,5,6,16,31,55,-24,21
CC Mariners,9597,10,4,8,15,28,49,-21,20
Sydney FC,9598,1,20,5,3,65,23,42,65
N'castle Jet,9598,2,15,6,7,59,39,20,51
Melbourne C,9598,3,14,5,10,45,35,10,47
Melbourne V,9598,4,13,6,10,46,39,7,45
Adelaide Utd,9598,5,11,6,11,37,40,-3,39
Brisbane,9598,6,10,5,13,33,42,-9,35
Western Sydn,9598,7,8,9,10,38,47,-9,33
Perth Glory,9598,8,10,2,15,37,50,-13,32
Wellington P,9598,9,5,6,16,31,55,-24,21
CC Mariners,9598,10,4,8,15,28,49,-21,20
Sydney FC,9599,1,20,5,3,65,23,42,65
N'castle Jet,9599,2,15,6,7,59,39,20,51
Melbourne C,9599,3,14,5,10,45,35,10,47
Melbourne V,9599,4,13,6,10,46,39,7,45
Adelaide Utd,9599,5,11,6,11,37,40,-3,39
Brisbane,9599,6,10,5,13,33,42,-9,35
Western Sydn,9599,7,8,9,10,38,47,-9,33
Perth Glory,9599,8,10,2,15,37,50,-13,32
Wellington P,9599,9,5,6,16,31,55,-24,21
CC Mariners,9599,10,4,8,15,28,49,-21,20
Sydney FC,9600,1,20,4,4,64,25,39,64
N'castle Jet,9600,2,16,5,7,63,39,24,53
Melbourne V,9600,3,14,5,10,48,38,10,47
Melbourne C,9600,4,14,4,11,45,39,6,46
Adelaide Utd,9600,5,11,6,11,37,40,-3,39
Brisbane,9600,6,10,5,13,33,42,-9,35
Western Sydn,9600,7,8,9,10,38,47,-9,33
Perth Glory,9600,8,10,2,15,37,50,-13,32
Wellington P,9600,9,5,6,16,31,55,-24,21
CC Mariners,9600,10,4,8,15,28,49,-21,20
Sydney FC,9601,1,21,4,3,69,23,46,67
N'castle Jet,9601,2,16,5,7,59,38,21,53
Melbourne C,9601,3,14,4,11,44,35,9,46
Melbourne V,9601,4,13,5,11,46,43,3,44
Adelaide Utd,9601,5,11,6,11,37,40,-3,39
Brisbane,9601,6,10,5,13,33,42,-9,35
Western Sydn,9601,7,8,9,10,38,47,-9,33
Perth Glory,9601,8,10,2,15,37,50,-13,32
Wellington P,9601,9,5,6,16,31,55,-24,21
CC Mariners,9601,10,4,8,15,28,49,-21,20
Sydney FC,9602,1,21,4,3,68,22,46,67
N'castle Jet,9602,2,16,5,7,60,38,22,53
Melbourne C,9602,3,14,4,11,44,36,8,46
Melbourne V,9602,4,13,5,11,45,42,3,44
Adelaide Utd,9602,5,11,6,11,37,40,-3,39
Brisbane,9602,6,10,5,13,33,42,-9,35
Western Sydn,9602,7,8,9,10,38,47,-9,33
Perth Glory,9602,8,10,2,15,37,50,-13,32
Wellington P,9602,9,5,6,16,31,55,-24,21
CC Mariners,9602,10,4,8,15,28,49,-21,20
Sydney FC,9603,1,21,4,3,66,23,43,67
N'castle Jet,9603,2,16,5,7,58,37,21,53
Melbourne C,9603,3,14,4,11,43,34,9,46
Melbourne V,9603,4,13,5,11,46,40,6,44
Adelaide Utd,9603,5,11,6,11,37,40,-3,39
Brisbane,9603,6,10,5,13,33,42,-9,35
Western Sydn,9603,7,8,9,10,38,47,-9,33
Perth Glory,9603,8,10,2,15,37,50,-13,32
Wellington P,9603,9,5,6,16,31,55,-24,21
CC Mariners,9603,10,4,8,15,28,49,-21,20
Sydney FC,9604,1,21,4,3,70,26,44,67
N'castle Jet,9604,2,15,5,8,58,40,18,50
Melbourne C,9604,3,15,4,10,46,34,12,49
Melbourne V,9604,4,13,5,11,49,44,5,44
Adelaide Utd,9604,5,11,6,11,37,40,-3,39
Brisbane,9604,6,10,5,13,33,42,-9,35
Western Sydn,9604,7,8,9,10,38,47,-9,33
Perth Glory,9604,8,10,2,15,37,50,-13,32
Wellington P,9604,9,5,6,16,31,55,-24,21
CC Mariners,9604,10,4,8,15,28,49,-21,20
Sydney FC,9605,1,21,4,3,65,22,43,67
N'castle Jet,9605,2,16,5,7,58,37,21,53
Melbourne C,9605,3,14,4,11,43,34,9,46
Melbourne V,9605,4,13,5,11,45,39,6,44
Adelaide Utd,9605,5,11,6,11,37,40,-3,39
Brisbane,9605,6,10,5,13,33,42,-9,35
Western Sydn,9605,7,8,9,10,38,47,-9,33
Perth Glory,9605,8,10,2,15,37,50,-13,32
Wellington P,9605,9,5,6,16,31,55,-24,21
CC Mariners,9605,10,4,8,15,28,49,-21,20
Sydney FC,9606,1,21,4,3,67,23,44,67
N'castle Jet,9606,2,15,5,8,58,39,19,50
Melbourne C,9606,3,15,4,10,45,34,11,49
Melbourne V,9606,4,13,5,11,46,41,5,44
Adelaide Utd,9606,5,11,6,11,37,40,-3,39
Brisbane,9606,6,10,5,13,33,42,-9,35
Western Sydn,9606,7,8,9,10,38,47,-9,33
Perth Glory,9606,8,10,2,15,37,50,-13,32
Wellington P,9606,9,5,6,16,31,55,-24,21
CC Mariners,9606,10,4,8,15,28,49,-21,20
Sydney FC,9607,1,21,4,3,67,24,43,67
N'castle Jet,9607,2,16,5,7,59,38,21,53
Melbourne C,9607,3,14,4,11,44,35,9,46
Melbourne V,9607,4,13,5,11,47,41,6,44
Adelaide Utd,9607,5,11,6,11,37,40,-3,39
Brisbane,9607,6,10,5,13,33,42,-9,35
Western Sydn,9607,7,8,9,10,38,47,-9,33
Perth Glory,9607,8,10,2,15,37,50,-13,32
Wellington P,9607,9,5,6,16,31,55,-24,21
CC Mariners,9607,10,4,8,15,28,49,-21,20
Sydney FC,9608,1,20,5,3,65,23,42,65
N'castle Jet,9608,2,16,5,7,59,37,22,53
Melbourne C,9608,3,14,4,11,43,35,8,46
Melbourne V,9608,4,13,6,10,46,39,7,45
Adelaide Utd,9608,5,11,6,11,37,40,-3,39
Brisbane,9608,6,10,5,13,33,42,-9,35
Western Sydn,9608,7,8,9,10,38,47,-9,33
Perth Glory,9608,8,10,2,15,37,50,-13,32
Wellington P,9608,9,5,6,16,31,55,-24,21
CC Mariners,9608,10,4,8,15,28,49,-21,20
Sydney FC,9609,1,21,4,3,65,22,43,67
N'castle Jet,9609,2,16,5,7,61,38,23,53
Melbourne C,9609,3,14,4,11,44,37,7,46
Melbourne V,9609,4,13,5,11,45,39,6,44
Adelaide Utd,9609,5,11,6,11,37,40,-3,39
Brisbane,9609,6,10,5,13,33,42,-9,35
Western Sydn,9609,7,8,9,10,38,47,-9,33
Perth Glory,9609,8,10,2,15,37,50,-13,32
Wellington P,9609,9,5,6,16,31,55,-24,21
CC Mariners,9609,10,4,8,15,28,49,-21,20
Sydney FC,9610,1,21,4,3,67,23,44,67
N'castle Jet,9610,2,15,6,7,59,39,20,51
Melbourne C,9610,3,14,5,10,45,35,10,47
Melbourne V,9610,4,13,5,11,46,41,5,44
Adelaide Utd,9610,5,11,6,11,37,40,-3,39
Brisbane,9610,6,10,5,13,33,42,-9,35
Western Sydn,9610,7,8,9,10,38,47,-9,33
Perth Glory,9610,8,10,2,15,37,50,-13,32
Wellington P,9610,9,5,6,16,31,55,-24,21
CC Mariners,9610,10,4,8,15,28,49,-21,20
Sydney FC,9611,1,21,4,3,65,22,43,67
N'castle Jet,9611,2,16,5,7,59,37,22,53
Melbourne C,9611,3,14,4,11,43,35,8,46
Melbourne V,9611,4,13,5,11,45,39,6,44
Adelaide Utd,9611,5,11,6,11,37,40,-3,39
Brisbane,9611,6,10,5,13,33,42,-9,35
Western Sydn,9611,7,8,9,10,38,47,-9,33
Perth Glory,9611,8,10,2,15,37,50,-13,32
Wellington P,9611,9,5,6,16,31,55,-24,21
CC Mariners,9611,10,4,8,15,28,49,-21,20
Sydney FC,9612,1,21,4,3,67,23,44,67
N'castle Jet,9612,2,16,5,7,60,37,23,53
Melbourne C,9612,3,14,4,11,43,36,7,46
Melbourne V,9612,4,13,5,11,46,41,5,44
Adelaide Utd,9612,5,11,6,11,37,40,-3,39
Brisbane,9612,6,10,5,13,33,42,-9,35
Western Sydn,9612,7,8,9,10,38,47,-9,33
Perth Glory,9612,8,10,2,15,37,50,-13,32
Wellington P,9612,9,5,6,16,31,55,-24,21
CC Mariners,9612,10,4,8,15,28,49,-21,20
Sydney FC,9613,1,20,4,4,64,23,41,64
N'castle Jet,9613,2,16,5,7,59,37,22,53
Melbourne V,9613,3,14,5,10,46,38,8,47
Melbourne C,9613,4,14,4,11,43,35,8,46
Adelaide Utd,9613,5,11,6,11,37,40,-3,39
Brisbane,9613,6,10,5,13,33,42,-9,35
Western Sydn,9613,7,8,9,10,38,47,-9,33
Perth Glory,9613,8,10,2,15,37,50,-13,32
Wellington P,9613,9,5,6,16,31,55,-24,21
CC Mariners,9613,10,4,8,15,28,49,-21,20
Sydney FC,9614,1,21,4,3,67,23,44,67
N'castle Jet,9614,2,15,5,8,59,40,19,50
Melbourne C,9614,3,15,4,10,46,35,11,49
Melbourne V,9614,4,13,5,11,46,41,5,44
Adelaide Utd,9614,5,11,6,11,37,40,-3,39
Brisbane,9614,6,10,5,13,33,42,-9,35
Western Sydn,9614,7,8,9,10,38,47,-9,33
Perth Glory,9614,8,10,2,15,37,50,-13,32
Wellington P,9614,9,5,6,16,31,55,-24,21
CC Mariners,9614,10,4,8,15,28,49,-21,20
Sydney FC,9615,1,21,4,3,67,23,44,67
N'castle Jet,9615,2,16,5,7,58,37,21,53
Melbourne C,9615,3,14,4,11,43,34,9,46
Melbourne V,9615,4,13,5,11,46,41,5,44
Adelaide Utd,9615,5,11,6,11,37,40,-3,39
Brisbane,9615,6,10,5,13,33,42,-9,35
Western Sydn,9615,7,8,9,10,38,47,-9,33
Perth Glory,9615,8,10,2,15,37,50,-13,32
Wellington P,9615,9,5,6,16,31,55,-24,21
CC Mariners,9615,10,4,8,15,28,49,-21,20
Sydney FC,9616,1,20,5,3,65,23,42,65
N'castle Jet,9616,2,15,6,7,58,38,20,51
Melbourne C,9616,3,14,5,10,44,34,10,47
Melbourne V,9616,4,13,6,10,46,39,7,45
Adelaide Utd,9616,5,11,6,11,37,40,-3,39
Brisbane,9616,6,10,5,13,33,42,-9,35
Western Sydn,9616,7,8,9,10,38,47,-9,33
Perth Glory,9616,8,10,2,15,37,50,-13,32
Wellington P,9616,9,5,6,16,31,55,-24,21
CC Mariners,9616,10,4,8,15,28,49,-21,20
Sydney FC,9617,1,21,4,3,66,23,43,67
N'castle Jet,9617,2,15,5,8,59,40,19,50
Melbourne C,9617,3,15,4,10,46,35,11,49
Melbourne V,9617,4,13,5,11,46,40,6,44
Adelaide Utd,9617,5,11,6,11,37,40,-3,39
Brisbane,9617,6,10,5,13,33,42,-9,35
Western Sydn,9617,7,8,9,10,38,47,-9,33
Perth Glory,9617,8,10,2,15,37,50,-13,32
Wellington P,9617,9,5,6,16,31,55,-24,21
CC Mariners,9617,10,4,8,15,28,49,-21,20
Sydney FC,9618,1,21,4,3,68,22,46,67
N'castle Jet,9618,2,15,6,7,59,39,20,51
Melbourne C,9618,3,14,5,10,45,35,10,47
Melbourne V,9618,4,13,5,11,45,42,3,44
Adelaide Utd,9618,5,11,6,11,37,40,-3,39
Brisbane,9618,6,10,5,13,33,42,-9,35
Western Sydn,9618,7,8,9,10,38,47,-9,33
Perth Glory,9618,8,10,2,15,37,50,-13,32
Wellington P,9618,9,5,6,16,31,55,-24,21
CC Mariners,9618,10,4,8,15,28,49,-21,20
Sydney FC,9619,1,20,5,3,66,24,42,65
N'castle Jet,9619,2,15,5,8,58,40,18,50
Melbourne C,9619,3,15,4,10,46,34,12,49
Melbourne V,9619,4,13,6,10,47,40,7,45
Adelaide Utd,9619,5,11,6,11,37,40,-3,39
Brisbane,9619,6,10,5,13,33,42,-9,35
Western Sydn,9619,7,8,9,10,38,47,-9,33
Perth Glory,9619,8,10,2,15,37,50,-13,32
Wellington P,9619,9,5,6,16,31,55,-24,21
CC Mariners,9619,10,4,8,15,28,49,-21,20
Sydney FC,9620,1,20,4,4,65,25,40,64
N'castle Jet,9620,2,15,6,7,57,37,20,51
Melbourne C,9620,3,14,5,10,43,33,10,47
Melbourne V,9620,4,14,5,10,48,39,9,47
Adelaide Utd,9620,5,11,6,11,37,40,-3,39
Brisbane,9620,6,10,5,13,33,42,-9,35
Western Sydn,9620,7,8,9,10,38,47,-9,33
Perth Glory,9620,8,10,2,15,37,50,-13,32
Wellington P,9620,9,5,6,16,31,55,-24,21
CC Mariners,9620,10,4,8,15,28,49,-21,20
Sydney FC,9621,1,21,4,3,68,25,43,67
N'castle Jet,9621,2,16,5,7,60,39,21,53
Melbourne C,9621,3,14,4,11,45,36,9,46
Melbourne V,9621,4,13,5,11,48,42,6,44
Adelaide Utd,9621,5,11,6,11,37,40,-3,39
Brisbane,9621,6,10,5,13,33,42,-9,35
Western Sydn,9621,7,8,9,10,38,47,-9,33
Perth Glory,9621,8,10,2,15,37,50,-13,32
Wellington P,9621,9,5,6,16,31,55,-24,21
CC Mariners,9621,10,4,8,15,28,49,-21,20
Sydney FC,9622,1,21,4,3,66,22,44,67
N'castle Jet,9622,2,15,6,7,58,38,20,51
Melbourne C,9622,3,14,5,10,44,34,10,47
Melbourne V,9622,4,13,5,11,45,40,5,44
Adelaide Utd,9622,5,11,6,11,37,40,-3,39
Brisbane,9622,6,10,5,13,33,42,-9,35
Western Sydn,9622,7,8,9,10,38,47,-9,33
Perth Glory,9622,8,10,2,15,37,50,-13,32
Wellington P,9622,9,5,6,16,31,55,-24,21
CC Mariners,9622,10,4,8,15,28,49,-21,20
Sydney FC,9623,1,20,4,4,65,25,40,64
N'castle Jet,9623,2,15,6,7,57,37,20,51
Melbourne C,9623,3,14,5,10,43,33,10,47
Melbourne V,9623,4,14,5,10,48,39,9,47
Adelaide Utd,9623,5,11,6,11,37,40,-3,39
Brisbane,9623,6,10,5,13,33,42,-9,35
Western Sydn,9623,7,8,9,10,38,47,-9,33
Perth Glory,9623,8,10,2,15,37,50,-13,32
Wellington P,9623,9,5,6,16,31,55,-24,21
CC Mariners,9623,10,4,8,15,28,49,-21,20
Sydney FC,9624,1,20,4,4,64,23,41,64
N'castle Jet,9624,2,15,6,7,59,39,20,51
Melbourne C,9624,3,14,5,10,45,35,10,47
Melbourne V,9624,4,14,5,10,46,38,8,47
Adelaide Utd,9624,5,11,6,11,37,40,-3,39
Brisbane,9624,6,10,5,13,33,42,-9,35
Western Sydn,9624,7,8,9,10,38,47,-9,33
Perth Glory,9624,8,10,2,15,37,50,-13,32
Wellington P,9624,9,5,6,16,31,55,-24,21
CC Mariners,9624,10,4,8,15,28,49,-21,20
Sydney FC,9625,1,21,4,3,65,22,43,67
N'castle Jet,9625,2,15,5,8,57,38,19,50
Melbourne C,9625,3,15,4,10,44,33,11,49
Melbourne V,9625,4,13,5,11,45,39,6,44
Adelaide Utd,9625,5,11,6,11,37,40,-3,39
Brisbane,9625,6,10,5,13,33,42,-9,35
Western Sydn,9625,7,8,9,10,38,47,-9,33
Perth Glory,9625,8,10,2,15,37,50,-13,32
Wellington P,9625,9,5,6,16,31,55,-24,21
CC Mariners,9625,10,4,8,15,28,49,-21,20
Sydney FC,9626,1,21,4,3,65,22,43,67
N'castle Jet,9626,2,16,5,7,59,37,22,53
Melbourne C,9626,3,14,4,11,43,35,8,46
Melbourne V,9626,4,13,5,11,45,39,6,44
Adelaide Utd,9626,5,11,6,11,37,40,-3,39
Brisbane,9626,6,10,5,13,33,42,-9,35
Western Sydn,9626,7,8,9,10,38,47,-9,33
Perth Glory,9626,8,10,2,15,37,50,-13,32
Wellington P,9626,9,5,6,16,31,55,-24,21
CC Mariners,9626,10,4,8,15,28,49,-21,20
Sydney FC,9627,1,20,4,4,64,23,41,64
N'castle Jet,9627,2,16,5,7,60,38,22,53
Melbourne V,9627,3,14,5,10,46,38,8,47
Melbourne C,9627,4,14,4,11,44,36,8,46
Adelaide Utd,9627,5,11,6,11,37,40,-3,39
Brisbane,9627,6,10,5,13,33,42,-9,35
Western Sydn,9627,7,8,9,10,38,47,-9,33
Perth Glory,9627,8,10,2,15,37,50,-13,32
Wellington P,9627,9,5,6,16,31,55,-24,21
CC Mariners,9627,10,4,8,15,28,49,-21,20
Sydney FC,9628,1,20,5,3,65,23,42,65
N'castle Jet,9628,2,16,5,7,59,38,21,53
Melbourne C,9628,3,14,4,11,44,35,9,46
Melbourne V,9628,4,13,6,10,46,39,7,45
Adelaide Utd,9628,5,11,6,11,37,40,-3,39
Brisbane,9628,6,10,5,13,33,42,-9,35
Western Sydn,9628,7,8,9,10,38,47,-9,33
Perth Glory,9628,8,10,2,15,37,50,-13,32
Wellington P,9628,9,5,6,16,31,55,-24,21
CC Mariners,9628,10,4,8,15,28,49,-21,20
Sydney FC,9629,1,21,4,3,66,22,44,67
N'castle Jet,9629,2,15,6,7,59,39,20,51
Melbourne C,9629,3,14,5,10,45,35,10,47
Melbourne V,9629,4,13,5,11,45,40,5,44
Adelaide Utd,9629,5,11,6,11,37,40,-3,39
Brisbane,9629,6,10,5,13,33,42,-9,35
Western Sydn,9629,7,8,9,10,38,47,-9,33
Perth Glory,9629,8,10,2,15,37,50,-13,32
Wellington P,9629,9,5,6,16,31,55,-24,21
CC Mariners,9629,10,4,8,15,28,49,-21,20
Sydney FC,9630,1,21,4,3,68,22,46,67
N'castle Jet,9630,2,15,5,8,57,38,19,50
Melbourne C,9630,3,15,4,10,44,33,11,49
Melbourne V,9630,4,13,5,11,45,42,3,44
Adelaide Utd,9630,5,11,6,11,37,40,-3,39
Brisbane,9630,6,10,5,13,33,42,-9,35
Western Sydn,9630,7,8,9,10,38,47,-9,33
Perth Glory,9630,8,10,2,15,37,50,-13,32
Wellington P,9630,9,5,6,16,31,55,-24,21
CC Mariners,9630,10,4,8,15,28,49,-21,20
Sydney FC,9631,1,20,5,3,65,23,42,65
N'castle Jet,9631,2,15,5,8,57,38,19,50
Melbourne C,9631,3,15,4,10,44,33,11,49
Melbourne V,9631,4,13,6,10,46,39,7,45
Adelaide Utd,9631,5,11,6,11,37,40,-3,39
Brisbane,9631,6,10,5,13,33,42,-9,35
Western Sydn,9631,7,8,9,10,38,47,-9,33
Perth Glory,9631,8,10,2,15,37,50,-13,32
Wellington P,9631,9,5,6,16,31,55,-24,21
CC Mariners,9631,10,4,8,15,28,49,-21,20
Sydney FC,9632,1,20,5,3,64,22,42,65
N'castle Jet,9632,2,16,5,7,60,38,22,53
Melbourne C,9632,3,14,4,11,44,36,8,46
Melbourne V,9632,4,13,6,10,45,38,7,45
Adelaide Utd,9632,5,11,6,11,37,40,-3,39
Brisbane,9632,6,10,5,13,33,42,-9,35
Western Sydn,9632,7,8,9,10,38,47,-9,33
Perth Glory,9632,8,10,2,15,37,50,-13,32
Wellington P,9632,9,5,6,16,31,55,-24,21
CC Mariners,9632,10,4,8,15,28,49,-21,20
Sydney FC,9633,1,20,4,4,66,25,41,64
N'castle Jet,9633,2,15,6,7,58,38,20,51
Melbourne C,9633,3,14,5,10,44,34,10,47
Melbourne V,9633,4,14,5,10,48,40,8,47
Adelaide Utd,9633,5,11,6,11,37,40,-3,39
Brisbane,9633,6,10,5,13,33,42,-9,35
Western Sydn,9633,7,8,9,10,38,47,-9,33
Perth Glory,9633,8,10,2,15,37,50,-13,32
Wellington P,9633,9,5,6,16,31,55,-24,21
CC Mariners,9633,10,4,8,15,28,49,-21,20
Sydney FC,9634,1,20,5,3,65,23,42,65
N'castle Jet,9634,2,16,5,7,62,37,25,53
Melbourne C,9634,3,14,4,11,43,38,5,46
Melbourne V,9634,4,13,6,10,46,39,7,45
Adelaide Utd,9634,5,11,6,11,37,40,-3,39
Brisbane,9634,6,10,5,13,33,42,-9,35
Western Sydn,9634,7,8,9,10,38,47,-9,33
Perth Glory,9634,8,10,2,15,37,50,-13,32
Wellington P,9634,9,5,6,16,31,55,-24,21
CC Mariners,9634,10,4,8,15,28,49,-21,20
Sydney FC,9635,1,21,4,3,68,23,45,67
N'castle Jet,9635,2,16,5,7,60,37,23,53
Melbourne C,9635,3,14,4,11,43,36,7,46
Melbourne V,9635,4,13,5,11,46,42,4,44
Adelaide Utd,9635,5,11,6,11,37,40,-3,39
Brisbane,9635,6,10,5,13,33,42,-9,35
Western Sydn,9635,7,8,9,10,38,47,-9,33
Perth Glory,9635,8,10,2,15,37,50,-13,32
Wellington P,9635,9,5,6,16,31,55,-24,21
CC Mariners,9635,10,4,8,15,28,49,-21,20
Sydney FC,9636,1,21,4,3,66,22,44,67
N'castle Jet,9636,2,16,5,7,60,37,23,53
Melbourne C,9636,3,14,4,11,43,36,7,46
Melbourne V,9636,4,13,5,11,45,40,5,44
Adelaide Utd,9636,5,11,6,11,37,40,-3,39
Brisbane,9636,6,10,5,13,33,42,-9,35
Western Sydn,9636,7,8,9,10,38,47,-9,33
Perth Glory,9636,8,10,2,15,37,50,-13,32
Wellington P,9636,9,5,6,16,31,55,-24,21
CC Mariners,9636,10,4,8,15,28,49,-21,20
Sydney FC,9637,1,20,4,4,65,24,41,64
N'castle Jet,9637,2,16,5,7,59,38,21,53
Melbourne V,9637,3,14,5,10,47,39,8,47
Melbourne C,9637,4,14,4,11,44,35,9,46
Adelaide Utd,9637,5,11,6,11,37,40,-3,39
Brisbane,9637,6,10,5,13,33,42,-9,35
Western Sydn,9637,7,8,9,10,38,47,-9,33
Perth Glory,9637,8,10,2,15,37,50,-13,32
Wellington P,9637,9,5,6,16,31,55,-24,21
CC Mariners,9637,10,4,8,15,28,49,-21,20
Sydney FC,9638,1,21,4,3,68,22,46,67
N'castle Jet,9638,2,16,5,7,60,38,22,53
Melbourne C,9638,3,14,4,11,44,36,8,46
Melbourne V,9638,4,13,5,11,45,42,3,44
Adelaide Utd,9638,5,11,6,11,37,40,-3,39
Brisbane,9638,6,10,5,13,33,42,-9,35
Western Sydn,9638,7,8,9,10,38,47,-9,33
Perth Glory,9638,8,10,2,15,37,50,-13,32
Wellington P,9638,9,5,6,16,31,55,-24,21
CC Mariners,9638,10,4,8,15,28,49,-21,20
Sydney FC,9639,1,21,4,3,67,24,43,67
N'castle Jet,9639,2,16,5,7,59,37,22,53
Melbourne C,9639,3,14,4,11,43,35,8,46
Melbourne V,9639,4,13,5,11,47,41,6,44
Adelaide Utd,9639,5,11,6,11,37,40,-3,39
Brisbane,9639,6,10,5,13,33,42,-9,35
Western Sydn,9639,7,8,9,10,38,47,-9,33
Perth Glory,9639,8,10,2,15,37,50,-13,32
Wellington P,9639,9,5,6,16,31,55,-24,21
CC Mariners,9639,10,4,8,15,28,49,-21,20
Sydney FC,9640,1,21,4,3,66,22,44,67
N'castle Jet,9640,2,15,5,8,58,39,19,50
Melbourne C,9640,3,15,4,10,45,34,11,49
Melbourne V,9640,4,13,5,11,45,40,5,44
Adelaide Utd,9640,5,11,6,11,37,40,-3,39
Brisbane,9640,6,10,5,13,33,42,-9,35
Western Sydn,9640,7,8,9,10,38,47,-9,33
Perth Glory,9640,8,10,2,15,37,50,-13,32
Wellington P,9640,9,5,6,16,31,55,-24,21
CC Mariners,9640,10,4,8,15,28,49,-21,20
Sydney FC,9641,1,21,4,3,68,22,46,67
N'castle Jet,9641,2,16,5,7,60,37,23,53
Melbourne C,9641,3,14,4,11,43,36,7,46
Melbourne V,9641,4,13,5,11,45,42,3,44
Adelaide Utd,9641,5,11,6,11,37,40,-3,39
Brisbane,9641,6,10,5,13,33,42,-9,35
Western Sydn,9641,7,8,9,10,38,47,-9,33
Perth Glory,9641,8,10,2,15,37,50,-13,32
Wellington P,9641,9,5,6,16,31,55,-24,21
CC Mariners,9641,10,4,8,15,28,49,-21,20
Sydney FC,9642,1,21,4,3,67,24,43,67
N'castle Jet,9642,2,15,6,7,57,37,20,51
Melbourne C,9642,3,14,5,10,43,33,10,47
Melbourne V,9642,4,13,5,11,47,41,6,44
Adelaide Utd,9642,5,11,6,11,37,40,-3,39
Brisbane,9642,6,10,5,13,33,42,-9,35
Western Sydn,9642,7,8,9,10,38,47,-9,33
Perth Glory,9642,8,10,2,15,37,50,-13,32
Wellington P,9642,9,5,6,16,31,55,-24,21
CC Mariners,9642,10,4,8,15,28,49,-21,20
Sydney FC,9643,1,20,4,4,65,24,41,64
N'castle Jet,9643,2,16,5,7,61,38,23,53
Melbourne V,9643,3,14,5,10,47,39,8,47
Melbourne C,9643,4,14,4,11,44,37,7,46
Adelaide Utd,9643,5,11,6,11,37,40,-3,39
Brisbane,9643,6,10,5,13,33,42,-9,35
Western Sydn,9643,7,8,9,10,38,47,-9,33
Perth Glory,9643,8,10,2,15,37,50,-13,32
Wellington P,9643,9,5,6,16,31,55,-24,21
CC Mariners,9643,10,4,8,15,28,49,-21,20
Sydney FC,9644,1,21,4,3,67,23,44,67
N'castle Jet,9644,2,15,5,8,58,39,19,50
Melbourne C,9644,3,15,4,10,45,34,11,49
Melbourne V,9644,4,13,5,11,46,41,5,44
Adelaide Utd,9644,5,11,6,11,37,40,-3,39
Brisbane,9644,6,10,5,13,33,42,-9,35
Western Sydn,9644,7,8,9,10,38,47,-9,33
Perth Glory,9644,8,10,2,15,37,50,-13,32
Wellington P,9644,9,5,6,16,31,55,-24,21
CC Mariners,9644,10,4,8,15,28,49,-21,20
Sydney FC,9645,1,20,4,4,65,25,40,64
N'castle Jet,9645,2,16,5,7,62,38,24,53
Melbourne V,9645,3,14,5,10,48,39,9,47
Melbourne C,9645,4,14,4,11,44,38,6,46
Adelaide Utd,9645,5,11,6,11,37,40,-3,39
Brisbane,9645,6,10,5,13,33,42,-9,35
Western Sydn,9645,7,8,9,10,38,47,-9,33
Perth Glory,9645,8,10,2,15,37,50,-13,32
Wellington P,9645,9,5,6,16,31,55,-24,21
CC Mariners,9645,10,4,8,15,28,49,-21,20
Sydney FC,9646,1,20,5,3,65,23,42,65
N'castle Jet,9646,2,16,5,7,60,38,22,53
Melbourne C,9646,3,14,4,11,44,36,8,46
Melbourne V,9646,4,13,6,10,46,39,7,45
Adelaide Utd,9646,5,11,6,11,37,40,-3,39
Brisbane,9646,6,10,5,13,33,42,-9,35
Western Sydn,9646,7,8,9,10,38,47,-9,33
Perth Glory,9646,8,10,2,15,37,50,-13,32
Wellington P,9646,9,5,6,16,31,55,-24,21
CC Mariners,9646,10,4,8,15,28,49,-21,20
Sydney FC,9647,1,21,4,3,67,22,45,67
N'castle Jet,9647,2,15,5,8,59,41,18,50
Melbourne C,9647,3,15,4,10,47,35,12,49
Melbourne V,9647,4,13,5,11,45,41,4,44
Adelaide Utd,9647,5,11,6,11,37,40,-3,39
Brisbane,9647,6,10,5,13,33,42,-9,35
Western Sydn,9647,7,8,9,10,38,47,-9,33
Perth Glory,9647,8,10,2,15,37,50,-13,32
Wellington P,9647,9,5,6,16,31,55,-24,21
CC Mariners,9647,10,4,8,15,28,49,-21,20
Sydney FC,9648,1,20,4,4,64,23,41,64
N'castle Jet,9648,2,15,6,7,58,38,20,51
Melbourne C,9648,3,14,5,10,44,34,10,47
Melbourne V,9648,4,14,5,10,46,38,8,47
Adelaide Utd,9648,5,11,6,11,37,40,-3,39
Brisbane,9648,6,10,5,13,33,42,-9,35
Western Sydn,9648,7,8,9,10,38,47,-9,33
Perth Glory,9648,8,10,2,15,37,50,-13,32
Wellington P,9648,9,5,6,16,31,55,-24,21
CC Mariners,9648,10,4,8,15,28,49,-21,20
Sydney FC,9649,1,21,4,3,66,22,44,67
N'castle Jet,9649,2,15,5,8,58,39,19,50
Melbourne C,9649,3,15,4,10,45,34,11,49
Melbourne V,9649,4,13,5,11,45,40,5,44
Adelaide Utd,9649,5,11,6,11,37,40,-3,39
Brisbane,9649,6,10,5,13,33,42,-9,35
Western Sydn,9649,7,8,9,10,38,47,-9,33
Perth Glory,9649,8,10,2,15,37,50,-13,32
Wellington P,9649,9,5,6,16,31,55,-24,21
CC Mariners,9649,10,4,8,15,28,49,-21,20
Sydney FC,9650,1,21,4,3,65,22,43,67
N'castle Jet,9650,2,15,5,8,60,42,18,50
Melbourne C,9650,3,15,4,10,48,36,12,49
Melbourne V,9650,4,13,5,11,45,39,6,44
Adelaide Utd,9650,5,11,6,11,37,40,-3,39
Brisbane,9650,6,10,5,13,33,42,-9,35
Western Sydn,9650,7,8,9,10,38,47,-9,33
Perth Glory,9650,8,10,2,15,37,50,-13,32
Wellington P,9650,9,5,6,16,31,55,-24,21
CC Mariners,9650,10,4,8,15,28,49,-21,20
Sydney FC,9651,1,21,4,3,67,24,43,67
N'castle Jet,9651,2,15,6,7,58,38,20,51
Melbourne C,9651,3,14,5,10,44,34,10,47
Melbourne V,9651,4,13,5,11,47,41,6,44
Adelaide Utd,9651,5,11,6,11,37,40,-3,39
Brisbane,9651,6,10,5,13,33,42,-9,35
Western Sydn,9651,7,8,9,10,38,47,-9,33
Perth Glory,9651,8,10,2,15,37,50,-13,32
Wellington P,9651,9,5,6,16,31,55,-24,21
CC Mariners,9651,10,4,8,15,28,49,-21,20
Sydney FC,9652,1,21,4,3,68,22,46,67
N'castle Jet,9652,2,15,5,8,57,38,19,50
Melbourne C,9652,3,15,4,10,44,33,11,49
Melbourne V,9652,4,13,5,11,45,42,3,44
Adelaide Utd,9652,5,11,6,11,37,40,-3,39
Brisbane,9652,6,10,5,13,33,42,-9,35
Western Sydn,9652,7,8,9,10,38,47,-9,33
Perth Glory,9652,8,10,2,15,37,50,-13,32
Wellington P,9652,9,5,6,16,31,55,-24,21
CC Mariners,9652,10,4,8,15,28,49,-21,20
Sydney FC,9653,1,21,4,3,66,22,44,67
N'castle Jet,9653,2,16,5,7,60,39,21,53
Melbourne C,9653,3,14,4,11,45,36,9,46
Melbourne V,9653,4,13,5,11,45,40,5,44
Adelaide Utd,9653,5,11,6,11,37,40,-3,39
Brisbane,9653,6,10,5,13,33,42,-9,35
Western Sydn,9653,7,8,9,10,38,47,-9,33
Perth Glory,9653,8,10,2,15,37,50,-13,32
Wellington P,9653,9,5,6,16,31,55,-24,21
CC Mariners,9653,10,4,8,15,28,49,-21,20
Sydney FC,9654,1,21,4,3,67,23,44,67
N'castle Jet,9654,2,16,5,7,58,37,21,53
Melbourne C,9654,3,14,4,11,43,34,9,46
Melbourne V,9654,4,13,5,11,46,41,5,44
Adelaide Utd,9654,5,11,6,11,37,40,-3,39
Brisbane,9654,6,10,5,13,33,42,-9,35
Western Sydn,9654,7,8,9,10,38,47,-9,33
Perth Glory,9654,8,10,2,15,37,50,-13,32
Wellington P,9654,9,5,6,16,31,55,-24,21
CC Mariners,9654,10,4,8,15,28,49,-21,20
Sydney FC,9655,1,21,4,3,67,22,45,67
N'castle Jet,9655,2,15,6,7,57,37,20,51
Melbourne C,9655,3,14,5,10,43,33,10,47
Melbourne V,9655,4,13,5,11,45,41,4,44
Adelaide Utd,9655,5,11,6,11,37,40,-3,39
Brisbane,9655,6,10,5,13,33,42,-9,35
Western Sydn,9655,7,8,9,10,38,47,-9,33
Perth Glory,9655,8,10,2,15,37,50,-13,32
Wellington P,9655,9,5,6,16,31,55,-24,21
CC Mariners,9655,10,4,8,15,28,49,-21,20
Sydney FC,9656,1,21,4,3,68,25,43,67
N'castle Jet,9656,2,16,5,7,58,37,21,53
Melbourne C,9656,3,14,4,11,43,34,9,46
Melbourne V,9656,4,13,5,11,48,42,6,44
Adelaide Utd,9656,5,11,6,11,37,40,-3,39
Brisbane,9656,6,10,5,13,33,42,-9,35
Western Sydn,9656,7,8,9,10,38,47,-9,33
Perth Glory,9656,8,10,2,15,37,50,-13,32
Wellington P,9656,9,5,6,16,31,55,-24,21
CC Mariners,9656,10,4,8,15,28,49,-21,20
Sydney FC,9657,1,20,4,4,64,23,41,64
N'castle Jet,9657,2,16,5,7,59,38,21,53
Melbourne V,9657,3,14,5,10,46,38,8,47
Melbourne C,9657,4,14,4,11,44,35,9,46
Adelaide Utd,9657,5,11,6,11,37,40,-3,39
Brisbane,9657,6,10,5,13,33,42,-9,35
Western Sydn,9657,7,8,9,10,38,47,-9,33
Perth Glory,9657,8,10,2,15,37,50,-13,32
Wellington P,9657,9,5,6,16,31,55,-24,21
CC Mariners,9657,10,4,8,15,28,49,-21,20
Sydney FC,9658,1,20,4,4,64,23,41,64
N'castle Jet,9658,2,16,5,7,59,37,22,53
Melbourne V,9658,3,14,5,10,46,38,8,47
Melbourne C,9658,4,14,4,11,43,35,8,46
Adelaide Utd,9658,5,11,6,11,37,40,-3,39
Brisbane,9658,6,10,5,13,33,42,-9,35
Western Sydn,9658,7,8,9,10,38,47,-9,33
Perth Glory,9658,8,10,2,15,37,50,-13,32
Wellington P,9658,9,5,6,16,31,55,-24,21
CC Mariners,9658,10,4,8,15,28,49,-21,20
Sydney FC,9659,1,21,4,3,67,22,45,67
N'castle Jet,9659,2,16,5,7,59,38,21,53
Melbourne C,9659,3,14,4,11,44,35,9,46
Melbourne V,9659,4,13,5,11,45,41,4,44
Adelaide Utd,9659,5,11,6,11,37,40,-3,39
Brisbane,9659,6,10,5,13,33,42,-9,35
Western Sydn,9659,7,8,9,10,38,47,-9,33
Perth Glory,9659,8,10,2,15,37,50,-13,32
Wellington P,9659,9,5,6,16,31,55,-24,21
CC Mariners,9659,10,4,8,15,28,49,-21,20
Sydney FC,9660,1,21,4,3,66,22,44,67
N'castle Jet,9660,2,15,6,7,59,39,20,51
Melbourne C,9660,3,14,5,10,45,35,10,47
Melbourne V,9660,4,13,5,11,45,40,5,44
Adelaide Utd,9660,5,11,6,11,37,40,-3,39
Brisbane,9660,6,10,5,13,33,42,-9,35
Western Sydn,9660,7,8,9,10,38,47,-9,33
Perth Glory,9660,8,10,2,15,37,50,-13,32
Wellington P,9660,9,5,6,16,31,55,-24,21
CC Mariners,9660,10,4,8,15,28,49,-21,20
Sydney FC,9661,1,21,4,3,65,22,43,67
N'castle Jet,9661,2,15,5,8,58,39,19,50
Melbourne C,9661,3,15,4,10,45,34,11,49
Melbourne V,9661,4,13,5,11,45,39,6,44
Adelaide Utd,9661,5,11,6,11,37,40,-3,39
Brisbane,9661,6,10,5,13,33,42,-9,35
Western Sydn,9661,7,8,9,10,38,47,-9,33
Perth Glory,9661,8,10,2,15,37,50,-13,32
Wellington P,9661,9,5,6,16,31,55,-24,21
CC Mariners,9661,10,4,8,15,28,49,-21,20
Sydney FC,9662,1,20,4,4,65,25,40,64
N'castle Jet,9662,2,15,6,7,57,37,20,51
Melbourne C,9662,3,14,5,10,43,33,10,47
Melbourne V,9662,4,14,5,10,48,39,9,47
Adelaide Utd,9662,5,11,6,11,37,40,-3,39
Brisbane,9662,6,10,5,13,33,42,-9,35
Western Sydn,9662,7,8,9,10,38,47,-9,33
Perth Glory,9662,8,10,2,15,37,50,-13,32
Wellington P,9662,9,5,6,16,31,55,-24,21
CC Mariners,9662,10,4,8,15,28,49,-21,20
Sydney FC,9663,1,20,5,3,65,23,42,65
N'castle Jet,9663,2,16,5,7,59,37,22,53
Melbourne C,9663,3,14,4,11,43,35,8,46
Melbourne V,9663,4,13,6,10,46,39,7,45
Adelaide Utd,9663,5,11,6,11,37,40,-3,39
Brisbane,9663,6,10,5,13,33,42,-9,35
Western Sydn,9663,7,8,9,10,38,47,-9,33
Perth Glory,9663,8,10,2,15,37,50,-13,32
Wellington P,9663,9,5,6,16,31,55,-24,21
CC Mariners,9663,10,4,8,15,28,49,-21,20
Sydney FC,9664,1,20,5,3,65,23,42,65
N'castle Jet,9664,2,15,6,7,58,38,20,51
Melbourne C,9664,3,14,5,10,44,34,10,47
Melbourne V,9664,4,13,6,10,46,39,7,45
Adelaide Utd,9664,5,11,6,11,37,40,-3,39
Brisbane,9664,6,10,5,13,33,42,-9,35
Western Sydn,9664,7,8,9,10,38,47,-9,33
Perth Glory,9664,8,10,2,15,37,50,-13,32
Wellington P,9664,9,5,6,16,31,55,-24,21
CC Mariners,9664,10,4,8,15,28,49,-21,20
Sydney FC,9665,1,20,4,4,64,24,40,64
N'castle Jet,9665,2,15,5,8,58,39,19,50
Melbourne C,9665,3,15,4,10,45,34,11,49
Melbourne V,9665,4,14,5,10,47,38,9,47
Adelaide Utd,9665,5,11,6,11,37,40,-3,39
Brisbane,9665,6,10,5,13,33,42,-9,35
Western Sydn,9665,7,8,9,10,38,47,-9,33
Perth Glory,9665,8,10,2,15,37,50,-13,32
Wellington P,9665,9,5,6,16,31,55,-24,21
CC Mariners,9665,10,4,8,15,28,49,-21,20
Sydney FC,9666,1,20,5,3,64,22,42,65
N'castle Jet,9666,2,16,5,7,58,37,21,53
Melbourne C,9666,3,14,4,11,43,34,9,46
Melbourne V,9666,4,13,6,10,45,38,7,45
Adelaide Utd,9666,5,11,6,11,37,40,-3,39
Brisbane,9666,6,10,5,13,33,42,-9,35
Western Sydn,9666,7,8,9,10,38,47,-9,33
Perth Glory,9666,8,10,2,15,37,50,-13,32
Wellington P,9666,9,5,6,16,31,55,-24,21
CC Mariners,9666,10,4,8,15,28,49,-21,20
Sydney FC,9667,1,20,4,4,65,24,41,64
N'castle Jet,9667,2,16,5,7,60,38,22,53
Melbourne V,9667,3,14,5,10,47,39,8,47
Melbourne C,9667,4,14,4,11,44,36,8,46
Adelaide Utd,9667,5,11,6,11,37,40,-3,39
Brisbane,9667,6,10,5,13,33,42,-9,35
Western Sydn,9667,7,8,9,10,38,47,-9,33
Perth Glory,9667,8,10,2,15,37,50,-13,32
Wellington P,9667,9,5,6,16,31,55,-24,21
CC Mariners,9667,10,4,8,15,28,49,-21,20
Sydney FC,9668,1,20,4,4,65,24,41,64
N'castle Jet,9668,2,15,6,7,58,38,20,51
Melbourne C,9668,3,14,5,10,44,34,10,47
Melbourne V,9668,4,14,5,10,47,39,8,47
Adelaide Utd,9668,5,11,6,11,37,40,-3,39
Brisbane,9668,6,10,5,13,33,42,-9,35
Western Sydn,9668,7,8,9,10,38,47,-9,33
Perth Glory,9668,8,10,2,15,37,50,-13,32
Wellington P,9668,9,5,6,16,31,55,-24,21
CC Mariners,9668,10,4,8,15,28,49,-21,20
Sydney FC,9669,1,21,4,3,69,22,47,67
N'castle Jet,9669,2,15,5,8,57,38,19,50
Melbourne C,9669,3,15,4,10,44,33,11,49
Melbourne V,9669,4,13,5,11,45,43,2,44
Adelaide Utd,9669,5,11,6,11,37,40,-3,39
Brisbane,9669,6,10,5,13,33,42,-9,35
Western Sydn,9669,7,8,9,10,38,47,-9,33
Perth Glory,9669,8,10,2,15,37,50,-13,32
Wellington P,9669,9,5,6,16,31,55,-24,21
CC Mariners,9669,10,4,8,15,28,49,-21,20
Sydney FC,9670,1,20,5,3,65,23,42,65
N'castle Jet,9670,2,15,5,8,58,40,18,50
Melbourne C,9670,3,15,4,10,46,34,12,49
Melbourne V,9670,4,13,6,10,46,39,7,45
Adelaide Utd,9670,5,11,6,11,37,40,-3,39
Brisbane,9670,6,10,5,13,33,42,-9,35
Western Sydn,9670,7,8,9,10,38,47,-9,33
Perth Glory,9670,8,10,2,15,37,50,-13,32
Wellington P,9670,9,5,6,16,31,55,-24,21
CC Mariners,9670,10,4,8,15,28,49,-21,20
Sydney FC,9671,1,20,5,3,65,23,42,65
N'castle Jet,9671,2,16,5,7,60,38,22,53
Melbourne C,9671,3,14,4,11,44,36,8,46
Melbourne V,9671,4,13,6,10,46,39,7,45
Adelaide Utd,9671,5,11,6,11,37,40,-3,39
Brisbane,9671,6,10,5,13,33,42,-9,35
Western Sydn,9671,7,8,9,10,38,47,-9,33
Perth Glory,9671,8,10,2,15,37,50,-13,32
Wellington P,9671,9,5,6,16,31,55,-24,21
CC Mariners,9671,10,4,8,15,28,49,-21,20
Sydney FC,9672,1,20,4,4,64,23,41,64
N'castle Jet,9672,2,15,5,8,57,38,19,50
Melbourne C,9672,3,15,4,10,44,33,11,49
Melbourne V,9672,4,14,5,10,46,38,8,47
Adelaide Utd,9672,5,11,6,11,37,40,-3,39
Brisbane,9672,6,10,5,13,33,42,-9,35
Western Sydn,9672,7,8,9,10,38,47,-9,33
Perth Glory,9672,8,10,2,15,37,50,-13,32
Wellington P,9672,9,5,6,16,31,55,-24,21
CC Mariners,9672,10,4,8,15,28,49,-21,20
Sydney FC,9673,1,21,4,3,67,22,45,67
N'castle Jet,9673,2,16,5,7,60,37,23,53
Melbourne C,9673,3,14,4,11,43,36,7,46
Melbourne V,9673,4,13,5,11,45,41,4,44
Adelaide Utd,9673,5,11,6,11,37,40,-3,39
Brisbane,9673,6,10,5,13,33,42,-9,35
Western Sydn,9673,7,8,9,10,38,47,-9,33
Perth Glory,9673,8,10,2,15,37,50,-13,32
Wellington P,9673,9,5,6,16,31,55,-24,21
CC Mariners,9673,10,4,8,15,28,49,-21,20
Sydney FC,9674,1,21,4,3,66,22,44,67
N'castle Jet,9674,2,15,6,7,59,39,20,51
Melbourne C,9674,3,14,5,10,45,35,10,47
Melbourne V,9674,4,13,5,11,45,40,5,44
Adelaide Utd,9674,5,11,6,11,37,40,-3,39
Brisbane,9674,6,10,5,13,33,42,-9,35
Western Sydn,9674,7,8,9,10,38,47,-9,33
Perth Glory,9674,8,10,2,15,37,50,-13,32
Wellington P,9674,9,5,6,16,31,55,-24,21
CC Mariners,9674,10,4,8,15,28,49,-21,20
Sydney FC,9675,1,21,4,3,68,22,46,67
N'castle Jet,9675,2,16,5,7,58,37,21,53
Melbourne C,9675,3,14,4,11,43,34,9,46
Melbourne V,9675,4,13,5,11,45,42,3,44
Adelaide Utd,9675,5,11,6,11,37,40,-3,39
Brisbane,9675,6,10,5,13,33,42,-9,35
Western Sydn,9675,7,8,9,10,38,47,-9,33
Perth Glory,9675,8,10,2,15,37,50,-13,32
Wellington P,9675,9,5,6,16,31,55,-24,21
CC Mariners,9675,10,4,8,15,28,49,-21,20
Sydney FC,9676,1,21,4,3,68,23,45,67
N'castle Jet,9676,2,15,5,8,57,40,17,50
Melbourne C,9676,3,15,4,10,46,33,13,49
Melbourne V,9676,4,13,5,11,46,42,4,44
Adelaide Utd,9676,5,11,6,11,37,40,-3,39
Brisbane,9676,6,10,5,13,33,42,-9,35
Western Sydn,9676,7,8,9,10,38,47,-9,33
Perth Glory,9676,8,10,2,15,37,50,-13,32
Wellington P,9676,9,5,6,16,31,55,-24,21
CC Mariners,9676,10,4,8,15,28,49,-21,20
Sydney FC,9677,1,21,4,3,65,22,43,67
N'castle Jet,9677,2,15,6,7,57,37,20,51
Melbourne C,9677,3,14,5,10,43,33,10,47
Melbourne V,9677,4,13,5,11,45,39,6,44
Adelaide Utd,9677,5,11,6,11,37,40,-3,39
Brisbane,9677,6,10,5,13,33,42,-9,35
Western Sydn,9677,7,8,9,10,38,47,-9,33
Perth Glory,9677,8,10,2,15,37,50,-13,32
Wellington P,9677,9,5,6,16,31,55,-24,21
CC Mariners,9677,10,4,8,15,28,49,-21,20
Sydney FC,9678,1,21,4,3,68,23,45,67
N'castle Jet,9678,2,15,6,7,59,39,20,51
Melbourne C,9678,3,14,5,10,45,35,10,47
Melbourne V,9678,4,13,5,11,46,42,4,44
Adelaide Utd,9678,5,11,6,11,37,40,-3,39
Brisbane,9678,6,10,5,13,33,42,-9,35
Western Sydn,9678,7,8,9,10,38,47,-9,33
Perth Glory,9678,8,10,2,15,37,50,-13,32
Wellington P,9678,9,5,6,16,31,55,-24,21
CC Mariners,9678,10,4,8,15,28,49,-21,20
Sydney FC,9679,1,21,4,3,65,22,43,67
N'castle Jet,9679,2,15,6,7,58,38,20,51
Melbourne C,9679,3,14,5,10,44,34,10,47
Melbourne V,9679,4,13,5,11,45,39,6,44
Adelaide Utd,9679,5,11,6,11,37,40,-3,39
Brisbane,9679,6,10,5,13,33,42,-9,35
Western Sydn,9679,7,8,9,10,38,47,-9,33
Perth Glory,9679,8,10,2,15,37,50,-13,32
Wellington P,9679,9,5,6,16,31,55,-24,21
CC Mariners,9679,10,4,8,15,28,49,-21,20
Sydney FC,9680,1,20,4,4,64,23,41,64
N'castle Jet,9680,2,16,5,7,61,38,23,53
Melbourne V,9680,3,14,5,10,46,38,8,47
Melbourne C,9680,4,14,4,11,44,37,7,46
Adelaide Utd,9680,5,11,6,11,37,40,-3,39
Brisbane,9680,6,10,5,13,33,42,-9,35
Western Sydn,9680,7,8,9,10,38,47,-9,33
Perth Glory,9680,8,10,2,15,37,50,-13,32
Wellington P,9680,9,5,6,16,31,55,-24,21
CC Mariners,9680,10,4,8,15,28,49,-21,20
Sydney FC,9681,1,20,4,4,64,23,41,64
N'castle Jet,9681,2,16,5,7,59,37,22,53
Melbourne V,9681,3,14,5,10,46,38,8,47
Melbourne C,9681,4,14,4,11,43,35,8,46
Adelaide Utd,9681,5,11,6,11,37,40,-3,39
Brisbane,9681,6,10,5,13,33,42,-9,35
Western Sydn,9681,7,8,9,10,38,47,-9,33
Perth Glory,9681,8,10,2,15,37,50,-13,32
Wellington P,9681,9,5,6,16,31,55,-24,21
CC Mariners,9681,10,4,8,15,28,49,-21,20
Sydney FC,9682,1,20,5,3,66,24,42,65
N'castle Jet,9682,2,16,5,7,63,38,25,53
Melbourne C,9682,3,14,4,11,44,39,5,46
Melbourne V,9682,4,13,6,10,47,40,7,45
Adelaide Utd,9682,5,11,6,11,37,40,-3,39
Brisbane,9682,6,10,5,13,33,42,-9,35
Western Sydn,9682,7,8,9,10,38,47,-9,33
Perth Glory,9682,8,10,2,15,37,50,-13,32
Wellington P,9682,9,5,6,16,31,55,-24,21
CC Mariners,9682,10,4,8,15,28,49,-21,20
Sydney FC,9683,1,20,4,4,65,24,41,64
N'castle Jet,9683,2,16,5,7,59,37,22,53
Melbourne V,9683,3,14,5,10,47,39,8,47
Melbourne C,9683,4,14,4,11,43,35,8,46
Adelaide Utd,9683,5,11,6,11,37,40,-3,39
Brisbane,9683,6,10,5,13,33,42,-9,35
Western Sydn,9683,7,8,9,10,38,47,-9,33
Perth Glory,9683,8,10,2,15,37,50,-13,32
Wellington P,9683,9,5,6,16,31,55,-24,21
CC Mariners,9683,10,4,8,15,28,49,-21,20
Sydney FC,9684,1,21,4,3,67,23,44,67
N'castle Jet,9684,2,16,5,7,58,37,21,53
Melbourne C,9684,3,14,4,11,43,34,9,46
Melbourne V,9684,4,13,5,11,46,41,5,44
Adelaide Utd,9684,5,11,6,11,37,40,-3,39
Brisbane,9684,6,10,5,13,33,42,-9,35
Western Sydn,9684,7,8,9,10,38,47,-9,33
Perth Glory,9684,8,10,2,15,37,50,-13,32
Wellington P,9684,9,5,6,16,31,55,-24,21
CC Mariners,9684,10,4,8,15,28,49,-21,20
Sydney FC,9685,1,21,4,3,67,24,43,67
N'castle Jet,9685,2,16,5,7,62,39,23,53
Melbourne C,9685,3,14,4,11,45,38,7,46
Melbourne V,9685,4,13,5,11,47,41,6,44
Adelaide Utd,9685,5,11,6,11,37,40,-3,39
Brisbane,9685,6,10,5,13,33,42,-9,35
Western Sydn,9685,7,8,9,10,38,47,-9,33
Perth Glory,9685,8,10,2,15,37,50,-13,32
Wellington P,9685,9,5,6,16,31,55,-24,21
CC Mariners,9685,10,4,8,15,28,49,-21,20
Sydney FC,9686,1,21,4,3,66,23,43,67
N'castle Jet,9686,2,16,5,7,63,38,25,53
Melbourne C,9686,3,14,4,11,44,39,5,46
Melbourne V,9686,4,13,5,11,46,40,6,44
Adelaide Utd,9686,5,11,6,11,37,40,-3,39
Brisbane,9686,6,10,5,13,33,42,-9,35
Western Sydn,9686,7,8,9,10,38,47,-9,33
Perth Glory,9686,8,10,2,15,37,50,-13,32
Wellington P,9686,9,5,6,16,31,55,-24,21
CC Mariners,9686,10,4,8,15,28,49,-21,20
Sydney FC,9687,1,20,4,4,64,23,41,64
N'castle Jet,9687,2,16,5,7,64,37,27,53
Melbourne V,9687,3,14,5,10,46,38,8,47
Melbourne C,9687,4,14,4,11,43,40,3,46
Adelaide Utd,9687,5,11,6,11,37,40,-3,39
Brisbane,9687,6,10,5,13,33,42,-9,35
Western Sydn,9687,7,8,9,10,38,47,-9,33
Perth Glory,9687,8,10,2,15,37,50,-13,32
Wellington P,9687,9,5,6,16,31,55,-24,21
CC Mariners,9687,10,4,8,15,28,49,-21,20
Sydney FC,9688,1,20,5,3,65,23,42,65
N'castle Jet,9688,2,15,5,8,57,38,19,50
Melbourne C,9688,3,15,4,10,44,33,11,49
Melbourne V,9688,4,13,6,10,46,39,7,45
Adelaide Utd,9688,5,11,6,11,37,40,-3,39
Brisbane,9688,6,10,5,13,33,42,-9,35
Western Sydn,9688,7,8,9,10,38,47,-9,33
Perth Glory,9688,8,10,2,15,37,50,-13,32
Wellington P,9688,9,5,6,16,31,55,-24,21
CC Mariners,9688,10,4,8,15,28,49,-21,20
Sydney FC,9689,1,21,4,3,66,22,44,67
N'castle Jet,9689,2,16,5,7,59,37,22,53
Melbourne C,9689,3,14,4,11,43,35,8,46
Melbourne V,9689,4,13,5,11,45,40,5,44
Adelaide Utd,9689,5,11,6,11,37,40,-3,39
Brisbane,9689,6,10,5,13,33,42,-9,35
Western Sydn,9689,7,8,9,10,38,47,-9,33
Perth Glory,9689,8,10,2,15,37,50,-13,32
Wellington P,9689,9,5,6,16,31,55,-24,21
CC Mariners,9689,10,4,8,15,28,49,-21,20
Sydney FC,9690,1,20,4,4,64,23,41,64
N'castle Jet,9690,2,15,6,7,58,38,20,51
Melbourne C,9690,3,14,5,10,44,34,10,47
Melbourne V,9690,4,14,5,10,46,38,8,47
Adelaide Utd,9690,5,11,6,11,37,40,-3,39
Brisbane,9690,6,10,5,13,33,42,-9,35
Western Sydn,9690,7,8,9,10,38,47,-9,33
Perth Glory,9690,8,10,2,15,37,50,-13,32
Wellington P,9690,9,5,6,16,31,55,-24,21
CC Mariners,9690,10,4,8,15,28,49,-21,20
Sydney FC,9691,1,21,4,3,67,23,44,67
N'castle Jet,9691,2,16,5,7,59,37,22,53
Melbourne C,9691,3,14,4,11,43,35,8,46
Melbourne V,9691,4,13,5,11,46,41,5,44
Adelaide Utd,9691,5,11,6,11,37,40,-3,39
Brisbane,9691,6,10,5,13,33,42,-9,35
Western Sydn,9691,7,8,9,10,38,47,-9,33
Perth Glory,9691,8,10,2,15,37,50,-13,32
Wellington P,9691,9,5,6,16,31,55,-24,21
CC Mariners,9691,10,4,8,15,28,49,-21,20
Sydney FC,9692,1,20,5,3,65,23,42,65
N'castle Jet,9692,2,15,6,7,58,38,20,51
Melbourne C,9692,3,14,5,10,44,34,10,47
Melbourne V,9692,4,13,6,10,46,39,7,45
Adelaide Utd,9692,5,11,6,11,37,40,-3,39
Brisbane,9692,6,10,5,13,33,42,-9,35
Western Sydn,9692,7,8,9,10,38,47,-9,33
Perth Glory,9692,8,10,2,15,37,50,-13,32
Wellington P,9692,9,5,6,16,31,55,-24,21
CC Mariners,9692,10,4,8,15,28,49,-21,20
Sydney FC,9693,1,21,4,3,65,22,43,67
N'castle Jet,9693,2,16,5,7,62,37,25,53
Melbourne C,9693,3,14,4,11,43,38,5,46
Melbourne V,9693,4,13,5,11,45,39,6,44
Adelaide Utd,9693,5,11,6,11,37,40,-3,39
Brisbane,9693,6,10,5,13,33,42,-9,35
Western Sydn,9693,7,8,9,10,38,47,-9,33
Perth Glory,9693,8,10,2,15,37,50,-13,32
Wellington P,9693,9,5,6,16,31,55,-24,21
CC Mariners,9693,10,4,8,15,28,49,-21,20
Sydney FC,9694,1,20,5,3,66,24,42,65
N'castle Jet,9694,2,15,6,7,58,38,20,51
Melbourne C,9694,3,14,5,10,44,34,10,47
Melbourne V,9694,4,13,6,10,47,40,7,45
Adelaide Utd,9694,5,11,6,11,37,40,-3,39
Brisbane,9694,6,10,5,13,33,42,-9,35
Western Sydn,9694,7,8,9,10,38,47,-9,33
Perth Glory,9694,8,10,2,15,37,50,-13,32
Wellington P,9694,9,5,6,16,31,55,-24,21
CC Mariners,9694,10,4,8,15,28,49,-21,20
Sydney FC,9695,1,21,4,3,68,22,46,67
N'castle Jet,9695,2,15,6,7,59,39,20,51
Melbourne C,9695,3,14,5,10,45,35,10,47
Melbourne V,9695,4,13,5,11,45,42,3,44
Adelaide Utd,9695,5,11,6,11,37,40,-3,39
Brisbane,9695,6,10,5,13,33,42,-9,35
Western Sydn,9695,7,8,9,10,38,47,-9,33
Perth Glory,9695,8,10,2,15,37,50,-13,32
Wellington P,9695,9,5,6,16,31,55,-24,21
CC Mariners,9695,10,4,8,15,28,49,-21,20
Sydney FC,9696,1,21,4,3,67,22,45,67
N'castle Jet,9696,2,15,6,7,58,38,20,51
Melbourne C,9696,3,14,5,10,44,34,10,47
Melbourne V,9696,4,13,5,11,45,41,4,44
Adelaide Utd,9696,5,11,6,11,37,40,-3,39
Brisbane,9696,6,10,5,13,33,42,-9,35
Western Sydn,9696,7,8,9,10,38,47,-9,33
Perth Glory,9696,8,10,2,15,37,50,-13,32
Wellington P,9696,9,5,6,16,31,55,-24,21
CC Mariners,9696,10,4,8,15,28,49,-21,20
Sydney FC,9697,1,20,5,3,65,23,42,65
N'castle Jet,9697,2,16,5,7,60,39,21,53
Melbourne C,9697,3,14,4,11,45,36,9,46
Melbourne V,9697,4,13,6,10,46,39,7,45
Adelaide Utd,9697,5,11,6,11,37,40,-3,39
Brisbane,9697,6,10,5,13,33,42,-9,35
Western Sydn,9697,7,8,9,10,38,47,-9,33
Perth Glory,9697,8,10,2,15,37,50,-13,32
Wellington P,9697,9,5,6,16,31,55,-24,21
CC Mariners,9697,10,4,8,15,28,49,-21,20
Sydney FC,9698,1,21,4,3,68,24,44,67
N'castle Jet,9698,2,15,6,7,58,38,20,51
Melbourne C,9698,3,14,5,10,44,34,10,47
Melbourne V,9698,4,13,5,11,47,42,5,44
Adelaide Utd,9698,5,11,6,11,37,40,-3,39
Brisbane,9698,6,10,5,13,33,42,-9,35
Western Sydn,9698,7,8,9,10,38,47,-9,33
Perth Glory,9698,8,10,2,15,37,50,-13,32
Wellington P,9698,9,5,6,16,31,55,-24,21
CC Mariners,9698,10,4,8,15,28,49,-21,20
Sydney FC,9699,1,21,4,3,66,23,43,67
N'castle Jet,9699,2,15,6,7,57,37,20,51
Melbourne C,9699,3,14,5,10,43,33,10,47
Melbourne V,9699,4,13,5,11,46,40,6,44
Adelaide Utd,9699,5,11,6,11,37,40,-3,39
Brisbane,9699,6,10,5,13,33,42,-9,35
Western Sydn,9699,7,8,9,10,38,47,-9,33
Perth Glory,9699,8,10,2,15,37,50,-13,32
Wellington P,9699,9,5,6,16,31,55,-24,21
CC Mariners,9699,10,4,8,15,28,49,-21,20
Sydney FC,9700,1,20,5,3,64,22,42,65
N'castle Jet,9700,2,15,6,7,57,37,20,51
Melbourne C,9700,3,14,5,10,43,33,10,47
Melbourne V,9700,4,13,6,10,45,38,7,45
Adelaide Utd,9700,5,11,6,11,37,40,-3,39
Brisbane,9700,6,10,5,13,33,42,-9,35
Western Sydn,9700,7,8,9,10,38,47,-9,33
Perth Glory,9700,8,10,2,15,37,50,-13,32
Wellington P,9700,9,5,6,16,31,55,-24,21
CC Mariners,9700,10,4,8,15,28,49,-21,20
Sydney FC,9701,1,20,4,4,65,24,41,64
N'castle Jet,9701,2,16,5,7,60,38,22,53
Melbourne V,9701,3,14,5,10,47,39,8,47
Melbourne C,9701,4,14,4,11,44,36,8,46
Adelaide Utd,9701,5,11,6,11,37,40,-3,39
Brisbane,9701,6,10,5,13,33,42,-9,35
Western Sydn,9701,7,8,9,10,38,47,-9,33
Perth Glory,9701,8,10,2,15,37,50,-13,32
Wellington P,9701,9,5,6,16,31,55,-24,21
CC Mariners,9701,10,4,8,15,28,49,-21,20
Sydney FC,9702,1,20,4,4,64,24,40,64
N'castle Jet,9702,2,15,6,7,57,37,20,51
Melbourne C,9702,3,14,5,10,43,33,10,47
Melbourne V,9702,4,14,5,10,47,38,9,47
Adelaide Utd,9702,5,11,6,11,37,40,-3,39
Brisbane,9702,6,10,5,13,33,42,-9,35
Western Sydn,9702,7,8,9,10,38,47,-9,33
Perth Glory,9702,8,10,2,15,37,50,-13,32
Wellington P,9702,9,5,6,16,31,55,-24,21
CC Mariners,9702,10,4,8,15,28,49,-21,20
Sydney FC,9703,1,21,4,3,66,23,43,67
N'castle Jet,9703,2,15,6,7,59,39,20,51
Melbourne C,9703,3,14,5,10,45,35,10,47
Melbourne V,9703,4,13,5,11,46,40,6,44
Adelaide Utd,9703,5,11,6,11,37,40,-3,39
Brisbane,9703,6,10,5,13,33,42,-9,35
Western Sydn,9703,7,8,9,10,38,47,-9,33
Perth Glory,9703,8,10,2,15,37,50,-13,32
Wellington P,9703,9,5,6,16,31,55,-24,21
CC Mariners,9703,10,4,8,15,28,49,-21,20
Sydney FC,9704,1,21,4,3,69,23,46,67
N'castle Jet,9704,2,16,5,7,60,39,21,53
Melbourne C,9704,3,14,4,11,45,36,9,46
Melbourne V,9704,4,13,5,11,46,43,3,44
Adelaide Utd,9704,5,11,6,11,37,40,-3,39
Brisbane,9704,6,10,5,13,33,42,-9,35
Western Sydn,9704,7,8,9,10,38,47,-9,33
Perth Glory,9704,8,10,2,15,37,50,-13,32
Wellington P,9704,9,5,6,16,31,55,-24,21
CC Mariners,9704,10,4,8,15,28,49,-21,20
Sydney FC,9705,1,20,4,4,65,25,40,64
N'castle Jet,9705,2,15,6,7,59,39,20,51
Melbourne C,9705,3,14,5,10,45,35,10,47
Melbourne V,9705,4,14,5,10,48,39,9,47
Adelaide Utd,9705,5,11,6,11,37,40,-3,39
Brisbane,9705,6,10,5,13,33,42,-9,35
Western Sydn,9705,7,8,9,10,38,47,-9,33
Perth Glory,9705,8,10,2,15,37,50,-13,32
Wellington P,9705,9,5,6,16,31,55,-24,21
CC Mariners,9705,10,4,8,15,28,49,-21,20
Sydney FC,9706,1,21,4,3,69,22,47,67
N'castle Jet,9706,2,16,5,7,59,37,22,53
Melbourne C,9706,3,14,4,11,43,35,8,46
Melbourne V,9706,4,13,5,11,45,43,2,44
Adelaide Utd,9706,5,11,6,11,37,40,-3,39
Brisbane,9706,6,10,5,13,33,42,-9,35
Western Sydn,9706,7,8,9,10,38,47,-9,33
Perth Glory,9706,8,10,2,15,37,50,-13,32
Wellington P,9706,9,5,6,16,31,55,-24,21
CC Mariners,9706,10,4,8,15,28,49,-21,20
Sydney FC,9707,1,21,4,3,68,25,43,67
N'castle Jet,9707,2,16,5,7,58,37,21,53
Melbourne C,9707,3,14,4,11,43,34,9,46
Melbourne V,9707,4,13,5,11,48,42,6,44
Adelaide Utd,9707,5,11,6,11,37,40,-3,39
Brisbane,9707,6,10,5,13,33,42,-9,35
Western Sydn,9707,7,8,9,10,38,47,-9,33
Perth Glory,9707,8,10,2,15,37,50,-13,32
Wellington P,9707,9,5,6,16,31,55,-24,21
CC Mariners,9707,10,4,8,15,28,49,-21,20
Sydney FC,9708,1,21,4,3,67,23,44,67
N'castle Jet,9708,2,16,5,7,58,37,21,53
Melbourne C,9708,3,14,4,11,43,34,9,46
Melbourne V,9708,4,13,5,11,46,41,5,44
Adelaide Utd,9708,5,11,6,11,37,40,-3,39
Brisbane,9708,6,10,5,13,33,42,-9,35
Western Sydn,9708,7,8,9,10,38,47,-9,33
Perth Glory,9708,8,10,2,15,37,50,-13,32
Wellington P,9708,9,5,6,16,31,55,-24,21
CC Mariners,9708,10,4,8,15,28,49,-21,20
Sydney FC,9709,1,21,4,3,66,23,43,67
N'castle Jet,9709,2,15,5,8,57,39,18,50
Melbourne C,9709,3,15,4,10,45,33,12,49
Melbourne V,9709,4,13,5,11,46,40,6,44
Adelaide Utd,9709,5,11,6,11,37,40,-3,39
Brisbane,9709,6,10,5,13,33,42,-9,35
Western Sydn,9709,7,8,9,10,38,47,-9,33
Perth Glory,9709,8,10,2,15,37,50,-13,32
Wellington P,9709,9,5,6,16,31,55,-24,21
CC Mariners,9709,10,4,8,15,28,49,-21,20
Sydney FC,9710,1,20,4,4,65,24,41,64
N'castle Jet,9710,2,15,6,7,59,39,20,51
Melbourne C,9710,3,14,5,10,45,35,10,47
Melbourne V,9710,4,14,5,10,47,39,8,47
Adelaide Utd,9710,5,11,6,11,37,40,-3,39
Brisbane,9710,6,10,5,13,33,42,-9,35
Western Sydn,9710,7,8,9,10,38,47,-9,33
Perth Glory,9710,8,10,2,15,37,50,-13,32
Wellington P,9710,9,5,6,16,31,55,-24,21
CC Mariners,9710,10,4,8,15,28,49,-21,20
Sydney FC,9711,1,21,4,3,67,23,44,67
N'castle Jet,9711,2,16,5,7,60,39,21,53
Melbourne C,9711,3,14,4,11,45,36,9,46
Melbourne V,9711,4,13,5,11,46,41,5,44
Adelaide Utd,9711,5,11,6,11,37,40,-3,39
Brisbane,9711,6,10,5,13,33,42,-9,35
Western Sydn,9711,7,8,9,10,38,47,-9,33
Perth Glory,9711,8,10,2,15,37,50,-13,32
Wellington P,9711,9,5,6,16,31,55,-24,21
CC Mariners,9711,10,4,8,15,28,49,-21,20
Sydney FC,9712,1,21,4,3,66,23,43,67
N'castle Jet,9712,2,15,5,8,57,42,15,50
Melbourne C,9712,3,15,4,10,48,33,15,49
Melbourne V,9712,4,13,5,11,46,40,6,44
Adelaide Utd,9712,5,11,6,11,37,40,-3,39
Brisbane,9712,6,10,5,13,33,42,-9,35
Western Sydn,9712,7,8,9,10,38,47,-9,33
Perth Glory,9712,8,10,2,15,37,50,-13,32
Wellington P,9712,9,5,6,16,31,55,-24,21
CC Mariners,9712,10,4,8,15,28,49,-21,20
Sydney FC,9713,1,21,4,3,67,24,43,67
N'castle Jet,9713,2,15,5,8,57,38,19,50
Melbourne C,9713,3,15,4,10,44,33,11,49
Melbourne V,9713,4,13,5,11,47,41,6,44
Adelaide Utd,9713,5,11,6,11,37,40,-3,39
Brisbane,9713,6,10,5,13,33,42,-9,35
Western Sydn,9713,7,8,9,10,38,47,-9,33
Perth Glory,9713,8,10,2,15,37,50,-13,32
Wellington P,9713,9,5,6,16,31,55,-24,21
CC Mariners,9713,10,4,8,15,28,49,-21,20
Sydney FC,9714,1,21,4,3,65,22,43,67
N'castle Jet,9714,2,15,6,7,58,38,20,51
Melbourne C,9714,3,14,5,10,44,34,10,47
Melbourne V,9714,4,13,5,11,45,39,6,44
Adelaide Utd,9714,5,11,6,11,37,40,-3,39
Brisbane,9714,6,10,5,13,33,42,-9,35
Western Sydn,9714,7,8,9,10,38,47,-9,33
Perth Glory,9714,8,10,2,15,37,50,-13,32
Wellington P,9714,9,5,6,16,31,55,-24,21
CC Mariners,9714,10,4,8,15,28,49,-21,20
Sydney FC,9715,1,21,4,3,66,22,44,67
N'castle Jet,9715,2,16,5,7,60,39,21,53
Melbourne C,9715,3,14,4,11,45,36,9,46
Melbourne V,9715,4,13,5,11,45,40,5,44
Adelaide Utd,9715,5,11,6,11,37,40,-3,39
Brisbane,9715,6,10,5,13,33,42,-9,35
Western Sydn,9715,7,8,9,10,38,47,-9,33
Perth Glory,9715,8,10,2,15,37,50,-13,32
Wellington P,9715,9,5,6,16,31,55,-24,21
CC Mariners,9715,10,4,8,15,28,49,-21,20
Sydney FC,9716,1,21,4,3,66,22,44,67
N'castle Jet,9716,2,15,6,7,58,38,20,51
Melbourne C,9716,3,14,5,10,44,34,10,47
Melbourne V,9716,4,13,5,11,45,40,5,44
Adelaide Utd,9716,5,11,6,11,37,40,-3,39
Brisbane,9716,6,10,5,13,33,42,-9,35
Western Sydn,9716,7,8,9,10,38,47,-9,33
Perth Glory,9716,8,10,2,15,37,50,-13,32
Wellington P,9716,9,5,6,16,31,55,-24,21
CC Mariners,9716,10,4,8,15,28,49,-21,20
Sydney FC,9717,1,20,4,4,66,27,39,64
N'castle Jet,9717,2,15,5,8,59,40,19,50
Melbourne C,9717,3,15,4,10,46,35,11,49
Melbourne V,9717,4,14,5,10,50,40,10,47
Adelaide Utd,9717,5,11,6,11,37,40,-3,39
Brisbane,9717,6,10,5,13,33,42,-9,35
Western Sydn,9717,7,8,9,10,38,47,-9,33
Perth Glory,9717,8,10,2,15,37,50,-13,32
Wellington P,9717,9,5,6,16,31,55,-24,21
CC Mariners,9717,10,4,8,15,28,49,-21,20
Sydney FC,9718,1,20,5,3,66,24,42,65
N'castle Jet,9718,2,15,6,7,57,37,20,51
Melbourne C,9718,3,14,5,10,43,33,10,47
Melbourne V,9718,4,13,6,10,47,40,7,45
Adelaide Utd,9718,5,11,6,11,37,40,-3,39
Brisbane,9718,6,10,5,13,33,42,-9,35
Western Sydn,9718,7,8,9,10,38,47,-9,33
Perth Glory,9718,8,10,2,15,37,50,-13,32
Wellington P,9718,9,5,6,16,31,55,-24,21
CC Mariners,9718,10,4,8,15,28,49,-21,20
Sydney FC,9719,1,21,4,3,65,22,43,67
N'castle Jet,9719,2,16,5,7,58,37,21,53
Melbourne C,9719,3,14,4,11,43,34,9,46
Melbourne V,9719,4,13,5,11,45,39,6,44
Adelaide Utd,9719,5,11,6,11,37,40,-3,39
Brisbane,9719,6,10,5,13,33,42,-9,35
Western Sydn,9719,7,8,9,10,38,47,-9,33
Perth Glory,9719,8,10,2,15,37,50,-13,32
Wellington P,9719,9,5,6,16,31,55,-24,21
CC Mariners,9719,10,4,8,15,28,49,-21,20
Sydney FC,9720,1,20,5,3,65,23,42,65
N'castle Jet,9720,2,15,6,7,58,38,20,51
Melbourne C,9720,3,14,5,10,44,34,10,47
Melbourne V,9720,4,13,6,10,46,39,7,45
Adelaide Utd,9720,5,11,6,11,37,40,-3,39
Brisbane,9720,6,10,5,13,33,42,-9,35
Western Sydn,9720,7,8,9,10,38,47,-9,33
Perth Glory,9720,8,10,2,15,37,50,-13,32
Wellington P,9720,9,5,6,16,31,55,-24,21
CC Mariners,9720,10,4,8,15,28,49,-21,20
Sydney FC,9721,1,20,5,3,66,24,42,65
N'castle Jet,9721,2,16,5,7,61,37,24,53
Melbourne C,9721,3,14,4,11,43,37,6,46
Melbourne V,9721,4,13,6,10,47,40,7,45
Adelaide Utd,9721,5,11,6,11,37,40,-3,39
Brisbane,9721,6,10,5,13,33,42,-9,35
Western Sydn,9721,7,8,9,10,38,47,-9,33
Perth Glory,9721,8,10,2,15,37,50,-13,32
Wellington P,9721,9,5,6,16,31,55,-24,21
CC Mariners,9721,10,4,8,15,28,49,-21,20
Sydney FC,9722,1,20,4,4,65,24,41,64
N'castle Jet,9722,2,16,5,7,59,38,21,53
Melbourne V,9722,3,14,5,10,47,39,8,47
Melbourne C,9722,4,14,4,11,44,35,9,46
Adelaide Utd,9722,5,11,6,11,37,40,-3,39
Brisbane,9722,6,10,5,13,33,42,-9,35
Western Sydn,9722,7,8,9,10,38,47,-9,33
Perth Glory,9722,8,10,2,15,37,50,-13,32
Wellington P,9722,9,5,6,16,31,55,-24,21
CC Mariners,9722,10,4,8,15,28,49,-21,20
Sydney FC,9723,1,21,4,3,68,23,45,67
N'castle Jet,9723,2,16,5,7,60,38,22,53
Melbourne C,9723,3,14,4,11,44,36,8,46
Melbourne V,9723,4,13,5,11,46,42,4,44
Adelaide Utd,9723,5,11,6,11,37,40,-3,39
Brisbane,9723,6,10,5,13,33,42,-9,35
Western Sydn,9723,7,8,9,10,38,47,-9,33
Perth Glory,9723,8,10,2,15,37,50,-13,32
Wellington P,9723,9,5,6,16,31,55,-24,21
CC Mariners,9723,10,4,8,15,28,49,-21,20
Sydney FC,9724,1,21,4,3,68,23,45,67
N'castle Jet,9724,2,15,6,7,59,39,20,51
Melbourne C,9724,3,14,5,10,45,35,10,47
Melbourne V,9724,4,13,5,11,46,42,4,44
Adelaide Utd,9724,5,11,6,11,37,40,-3,39
Brisbane,9724,6,10,5,13,33,42,-9,35
Western Sydn,9724,7,8,9,10,38,47,-9,33
Perth Glory,9724,8,10,2,15,37,50,-13,32
Wellington P,9724,9,5,6,16,31,55,-24,21
CC Mariners,9724,10,4,8,15,28,49,-21,20
Sydney FC,9725,1,20,4,4,64,23,41,64
N'castle Jet,9725,2,16,5,7,60,38,22,53
Melbourne V,9725,3,14,5,10,46,38,8,47
Melbourne C,9725,4,14,4,11,44,36,8,46
Adelaide Utd,9725,5,11,6,11,37,40,-3,39
Brisbane,9725,6,10,5,13,33,42,-9,35
Western Sydn,9725,7,8,9,10,38,47,-9,33
Perth Glory,9725,8,10,2,15,37,50,-13,32
Wellington P,9725,9,5,6,16,31,55,-24,21
CC Mariners,9725,10,4,8,15,28,49,-21,20
Sydney FC,9726,1,20,4,4,65,24,41,64
N'castle Jet,9726,2,16,5,7,59,38,21,53
Melbourne V,9726,3,14,5,10,47,39,8,47
Melbourne C,9726,4,14,4,11,44,35,9,46
Adelaide Utd,9726,5,11,6,11,37,40,-3,39
Brisbane,9726,6,10,5,13,33,42,-9,35
Western Sydn,9726,7,8,9,10,38,47,-9,33
Perth Glory,9726,8,10,2,15,37,50,-13,32
Wellington P,9726,9,5,6,16,31,55,-24,21
CC Mariners,9726,10,4,8,15,28,49,-21,20
Sydney FC,9727,1,20,5,3,66,24,42,65
N'castle Jet,9727,2,15,6,7,61,41,20,51
Melbourne C,9727,3,14,5,10,47,37,10,47
Melbourne V,9727,4,13,6,10,47,40,7,45
Adelaide Utd,9727,5,11,6,11,37,40,-3,39
Brisbane,9727,6,10,5,13,33,42,-9,35
Western Sydn,9727,7,8,9,10,38,47,-9,33
Perth Glory,9727,8,10,2,15,37,50,-13,32
Wellington P,9727,9,5,6,16,31,55,-24,21
CC Mariners,9727,10,4,8,15,28,49,-21,20
Sydney FC,9728,1,21,4,3,67,22,45,67
N'castle Jet,9728,2,15,5,8,57,38,19,50
Melbourne C,9728,3,15,4,10,44,33,11,49
Melbourne V,9728,4,13,5,11,45,41,4,44
Adelaide Utd,9728,5,11,6,11,37,40,-3,39
Brisbane,9728,6,10,5,13,33,42,-9,35
Western Sydn,9728,7,8,9,10,38,47,-9,33
Perth Glory,9728,8,10,2,15,37,50,-13,32
Wellington P,9728,9,5,6,16,31,55,-24,21
CC Mariners,9728,10,4,8,15,28,49,-21,20
Sydney FC,9729,1,20,5,3,65,23,42,65
N'castle Jet,9729,2,16,5,7,60,37,23,53
Melbourne C,9729,3,14,4,11,43,36,7,46
Melbourne V,9729,4,13,6,10,46,39,7,45
Adelaide Utd,9729,5,11,6,11,37,40,-3,39
Brisbane,9729,6,10,5,13,33,42,-9,35
Western Sydn,9729,7,8,9,10,38,47,-9,33
Perth Glory,9729,8,10,2,15,37,50,-13,32
Wellington P,9729,9,5,6,16,31,55,-24,21
CC Mariners,9729,10,4,8,15,28,49,-21,20
Sydney FC,9730,1,20,4,4,64,23,41,64
N'castle Jet,9730,2,15,6,7,59,39,20,51
Melbourne C,9730,3,14,5,10,45,35,10,47
Melbourne V,9730,4,14,5,10,46,38,8,47
Adelaide Utd,9730,5,11,6,11,37,40,-3,39
Brisbane,9730,6,10,5,13,33,42,-9,35
Western Sydn,9730,7,8,9,10,38,47,-9,33
Perth Glory,9730,8,10,2,15,37,50,-13,32
Wellington P,9730,9,5,6,16,31,55,-24,21
CC Mariners,9730,10,4,8,15,28,49,-21,20
Sydney FC,9731,1,20,5,3,64,22,42,65
N'castle Jet,9731,2,15,5,8,57,38,19,50
Melbourne C,9731,3,15,4,10,44,33,11,49
Melbourne V,9731,4,13,6,10,45,38,7,45
Adelaide Utd,9731,5,11,6,11,37,40,-3,39
Brisbane,9731,6,10,5,13,33,42,-9,35
Western Sydn,9731,7,8,9,10,38,47,-9,33
Perth Glory,9731,8,10,2,15,37,50,-13,32
Wellington P,9731,9,5,6,16,31,55,-24,21
CC Mariners,9731,10,4,8,15,28,49,-21,20
Sydney FC,9732,1,21,4,3,66,22,44,67
N'castle Jet,9732,2,15,6,7,57,37,20,51
Melbourne C,9732,3,14,5,10,43,33,10,47
Melbourne V,9732,4,13,5,11,45,40,5,44
Adelaide Utd,9732,5,11,6,11,37,40,-3,39
Brisbane,9732,6,10,5,13,33,42,-9,35
Western Sydn,9732,7,8,9,10,38,47,-9,33
Perth Glory,9732,8,10,2,15,37,50,-13,32
Wellington P,9732,9,5,6,16,31,55,-24,21
CC Mariners,9732,10,4,8,15,28,49,-21,20
Sydney FC,9733,1,20,5,3,66,24,42,65
N'castle Jet,9733,2,16,5,7,59,37,22,53
Melbourne C,9733,3,14,4,11,43,35,8,46
Melbourne V,9733,4,13,6,10,47,40,7,45
Adelaide Utd,9733,5,11,6,11,37,40,-3,39
Brisbane,9733,6,10,5,13,33,42,-9,35
Western Sydn,9733,7,8,9,10,38,47,-9,33
Perth Glory,9733,8,10,2,15,37,50,-13,32
Wellington P,9733,9,5,6,16,31,55,-24,21
CC Mariners,9733,10,4,8,15,28,49,-21,20
Sydney FC,9734,1,21,4,3,66,23,43,67
N'castle Jet,9734,2,15,6,7,58,38,20,51
Melbourne C,9734,3,14,5,10,44,34,10,47
Melbourne V,9734,4,13,5,11,46,40,6,44
Adelaide Utd,9734,5,11,6,11,37,40,-3,39
Brisbane,9734,6,10,5,13,33,42,-9,35
Western Sydn,9734,7,8,9,10,38,47,-9,33
Perth Glory,9734,8,10,2,15,37,50,-13,32
Wellington P,9734,9,5,6,16,31,55,-24,21
CC Mariners,9734,10,4,8,15,28,49,-21,20
Sydney FC,9735,1,21,4,3,68,24,44,67
N'castle Jet,9735,2,16,5,7,59,38,21,53
Melbourne C,9735,3,14,4,11,44,35,9,46
Melbourne V,9735,4,13,5,11,47,42,5,44
Adelaide Utd,9735,5,11,6,11,37,40,-3,39
Brisbane,9735,6,10,5,13,33,42,-9,35
Western Sydn,9735,7,8,9,10,38,47,-9,33
Perth Glory,9735,8,10,2,15,37,50,-13,32
Wellington P,9735,9,5,6,16,31,55,-24,21
CC Mariners,9735,10,4,8,15,28,49,-21,20
Sydney FC,9736,1,20,5,3,66,24,42,65
N'castle Jet,9736,2,16,5,7,59,37,22,53
Melbourne C,9736,3,14,4,11,43,35,8,46
Melbourne V,9736,4,13,6,10,47,40,7,45
Adelaide Utd,9736,5,11,6,11,37,40,-3,39
Brisbane,9736,6,10,5,13,33,42,-9,35
Western Sydn,9736,7,8,9,10,38,47,-9,33
Perth Glory,9736,8,10,2,15,37,50,-13,32
Wellington P,9736,9,5,6,16,31,55,-24,21
CC Mariners,9736,10,4,8,15,28,49,-21,20
Sydney FC,9737,1,21,4,3,66,23,43,67
N'castle Jet,9737,2,16,5,7,58,37,21,53
Melbourne C,9737,3,14,4,11,43,34,9,46
Melbourne V,9737,4,13,5,11,46,40,6,44
Adelaide Utd,9737,5,11,6,11,37,40,-3,39
Brisbane,9737,6,10,5,13,33,42,-9,35
Western Sydn,9737,7,8,9,10,38,47,-9,33
Perth Glory,9737,8,10,2,15,37,50,-13,32
Wellington P,9737,9,5,6,16,31,55,-24,21
CC Mariners,9737,10,4,8,15,28,49,-21,20
Sydney FC,9738,1,21,4,3,67,24,43,67
N'castle Jet,9738,2,16,5,7,60,39,21,53
Melbourne C,9738,3,14,4,11,45,36,9,46
Melbourne V,9738,4,13,5,11,47,41,6,44
Adelaide Utd,9738,5,11,6,11,37,40,-3,39
Brisbane,9738,6,10,5,13,33,42,-9,35
Western Sydn,9738,7,8,9,10,38,47,-9,33
Perth Glory,9738,8,10,2,15,37,50,-13,32
Wellington P,9738,9,5,6,16,31,55,-24,21
CC Mariners,9738,10,4,8,15,28,49,-21,20
Sydney FC,9739,1,21,4,3,66,23,43,67
N'castle Jet,9739,2,15,5,8,58,39,19,50
Melbourne C,9739,3,15,4,10,45,34,11,49
Melbourne V,9739,4,13,5,11,46,40,6,44
Adelaide Utd,9739,5,11,6,11,37,40,-3,39
Brisbane,9739,6,10,5,13,33,42,-9,35
Western Sydn,9739,7,8,9,10,38,47,-9,33
Perth Glory,9739,8,10,2,15,37,50,-13,32
Wellington P,9739,9,5,6,16,31,55,-24,21
CC Mariners,9739,10,4,8,15,28,49,-21,20
Sydney FC,9740,1,21,4,3,67,23,44,67
N'castle Jet,9740,2,16,5,7,60,37,23,53
Melbourne C,9740,3,14,4,11,43,36,7,46
Melbourne V,9740,4,13,5,11,46,41,5,44
Adelaide Utd,9740,5,11,6,11,37,40,-3,39
Brisbane,9740,6,10,5,13,33,42,-9,35
Western Sydn,9740,7,8,9,10,38,47,-9,33
Perth Glory,9740,8,10,2,15,37,50,-13,32
Wellington P,9740,9,5,6,16,31,55,-24,21
CC Mariners,9740,10,4,8,15,28,49,-21,20
Sydney FC,9741,1,21,4,3,65,22,43,67
N'castle Jet,9741,2,16,5,7,59,38,21,53
Melbourne C,9741,3,14,4,11,44,35,9,46
Melbourne V,9741,4,13,5,11,45,39,6,44
Adelaide Utd,9741,5,11,6,11,37,40,-3,39
Brisbane,9741,6,10,5,13,33,42,-9,35
Western Sydn,9741,7,8,9,10,38,47,-9,33
Perth Glory,9741,8,10,2,15,37,50,-13,32
Wellington P,9741,9,5,6,16,31,55,-24,21
CC Mariners,9741,10,4,8,15,28,49,-21,20
Sydney FC,9742,1,21,4,3,68,23,45,67
N'castle Jet,9742,2,15,5,8,57,39,18,50
Melbourne C,9742,3,15,4,10,45,33,12,49
Melbourne V,9742,4,13,5,11,46,42,4,44
Adelaide Utd,9742,5,11,6,11,37,40,-3,39
Brisbane,9742,6,10,5,13,33,42,-9,35
Western Sydn,9742,7,8,9,10,38,47,-9,33
Perth Glory,9742,8,10,2,15,37,50,-13,32
Wellington P,9742,9,5,6,16,31,55,-24,21
CC Mariners,9742,10,4,8,15,28,49,-21,20
Sydney FC,9743,1,21,4,3,67,22,45,67
N'castle Jet,9743,2,16,5,7,59,37,22,53
Melbourne C,9743,3,14,4,11,43,35,8,46
Melbourne V,9743,4,13,5,11,45,41,4,44
Adelaide Utd,9743,5,11,6,11,37,40,-3,39
Brisbane,9743,6,10,5,13,33,42,-9,35
Western Sydn,9743,7,8,9,10,38,47,-9,33
Perth Glory,9743,8,10,2,15,37,50,-13,32
Wellington P,9743,9,5,6,16,31,55,-24,21
CC Mariners,9743,10,4,8,15,28,49,-21,20
Sydney FC,9744,1,21,4,3,66,23,43,67
N'castle Jet,9744,2,15,6,7,57,37,20,51
Melbourne C,9744,3,14,5,10,43,33,10,47
Melbourne V,9744,4,13,5,11,46,40,6,44
Adelaide Utd,9744,5,11,6,11,37,40,-3,39
Brisbane,9744,6,10,5,13,33,42,-9,35
Western Sydn,9744,7,8,9,10,38,47,-9,33
Perth Glory,9744,8,10,2,15,37,50,-13,32
Wellington P,9744,9,5,6,16,31,55,-24,21
CC Mariners,9744,10,4,8,15,28,49,-21,20
Sydney FC,9745,1,21,4,3,66,23,43,67
N'castle Jet,9745,2,16,5,7,58,37,21,53
Melbourne C,9745,3,14,4,11,43,34,9,46
Melbourne V,9745,4,13,5,11,46,40,6,44
Adelaide Utd,9745,5,11,6,11,37,40,-3,39
Brisbane,9745,6,10,5,13,33,42,-9,35
Western Sydn,9745,7,8,9,10,38,47,-9,33
Perth Glory,9745,8,10,2,15,37,50,-13,32
Wellington P,9745,9,5,6,16,31,55,-24,21
CC Mariners,9745,10,4,8,15,28,49,-21,20
Sydney FC,9746,1,21,4,3,65,22,43,67
N'castle Jet,9746,2,16,5,7,61,40,21,53
Melbourne C,9746,3,14,4,11,46,37,9,46
Melbourne V,9746,4,13,5,11,45,39,6,44
Adelaide Utd,9746,5,11,6,11,37,40,-3,39
Brisbane,9746,6,10,5,13,33,42,-9,35
Western Sydn,9746,7,8,9,10,38,47,-9,33
Perth Glory,9746,8,10,2,15,37,50,-13,32
Wellington P,9746,9,5,6,16,31,55,-24,21
CC Mariners,9746,10,4,8,15,28,49,-21,20
Sydney FC,9747,1,21,4,3,67,22,45,67
N'castle Jet,9747,2,16,5,7,60,39,21,53
Melbourne C,9747,3,14,4,11,45,36,9,46
Melbourne V,9747,4,13,5,11,45,41,4,44
Adelaide Utd,9747,5,11,6,11,37,40,-3,39
Brisbane,9747,6,10,5,13,33,42,-9,35
Western Sydn,9747,7,8,9,10,38,47,-9,33
Perth Glory,9747,8,10,2,15,37,50,-13,32
Wellington P,9747,9,5,6,16,31,55,-24,21
CC Mariners,9747,10,4,8,15,28,49,-21,20
Sydney FC,9748,1,21,4,3,68,23,45,67
N'castle Jet,9748,2,16,5,7,60,39,21,53
Melbourne C,9748,3,14,4,11,45,36,9,46
Melbourne V,9748,4,13,5,11,46,42,4,44
Adelaide Utd,9748,5,11,6,11,37,40,-3,39
Brisbane,9748,6,10,5,13,33,42,-9,35
Western Sydn,9748,7,8,9,10,38,47,-9,33
Perth Glory,9748,8,10,2,15,37,50,-13,32
Wellington P,9748,9,5,6,16,31,55,-24,21
CC Mariners,9748,10,4,8,15,28,49,-21,20
Sydney FC,9749,1,21,4,3,65,22,43,67
N'castle Jet,9749,2,16,5,7,60,38,22,53
Melbourne C,9749,3,14,4,11,44,36,8,46
Melbourne V,9749,4,13,5,11,45,39,6,44
Adelaide Utd,9749,5,11,6,11,37,40,-3,39
Brisbane,9749,6,10,5,13,33,42,-9,35
Western Sydn,9749,7,8,9,10,38,47,-9,33
Perth Glory,9749,8,10,2,15,37,50,-13,32
Wellington P,9749,9,5,6,16,31,55,-24,21
CC Mariners,9749,10,4,8,15,28,49,-21,20
Sydney FC,9750,1,21,4,3,67,24,43,67
N'castle Jet,9750,2,15,6,7,60,40,20,51
Melbourne C,9750,3,14,5,10,46,36,10,47
Melbourne V,9750,4,13,5,11,47,41,6,44
Adelaide Utd,9750,5,11,6,11,37,40,-3,39
Brisbane,9750,6,10,5,13,33,42,-9,35
Western Sydn,9750,7,8,9,10,38,47,-9,33
Perth Glory,9750,8,10,2,15,37,50,-13,32
Wellington P,9750,9,5,6,16,31,55,-24,21
CC Mariners,9750,10,4,8,15,28,49,-21,20
Sydney FC,9751,1,20,5,3,65,23,42,65
N'castle Jet,9751,2,15,6,7,57,37,20,51
Melbourne C,9751,3,14,5,10,43,33,10,47
Melbourne V,9751,4,13,6,10,46,39,7,45
Adelaide Utd,9751,5,11,6,11,37,40,-3,39
Brisbane,9751,6,10,5,13,33,42,-9,35
Western Sydn,9751,7,8,9,10,38,47,-9,33
Perth Glory,9751,8,10,2,15,37,50,-13,32
Wellington P,9751,9,5,6,16,31,55,-24,21
CC Mariners,9751,10,4,8,15,28,49,-21,20
Sydney FC,9752,1,21,4,3,66,23,43,67
N'castle Jet,9752,2,16,5,7,58,37,21,53
Melbourne C,9752,3,14,4,11,43,34,9,46
Melbourne V,9752,4,13,5,11,46,40,6,44
Adelaide Utd,9752,5,11,6,11,37,40,-3,39
Brisbane,9752,6,10,5,13,33,42,-9,35
Western Sydn,9752,7,8,9,10,38,47,-9,33
Perth Glory,9752,8,10,2,15,37,50,-13,32
Wellington P,9752,9,5,6,16,31,55,-24,21
CC Mariners,9752,10,4,8,15,28,49,-21,20
Sydney FC,9753,1,21,4,3,66,23,43,67
N'castle Jet,9753,2,16,5,7,60,38,22,53
Melbourne C,9753,3,14,4,11,44,36,8,46
Melbourne V,9753,4,13,5,11,46,40,6,44
Adelaide Utd,9753,5,11,6,11,37,40,-3,39
Brisbane,9753,6,10,5,13,33,42,-9,35
Western Sydn,9753,7,8,9,10,38,47,-9,33
Perth Glory,9753,8,10,2,15,37,50,-13,32
Wellington P,9753,9,5,6,16,31,55,-24,21
CC Mariners,9753,10,4,8,15,28,49,-21,20
Sydney FC,9754,1,21,4,3,65,22,43,67
N'castle Jet,9754,2,16,5,7,58,37,21,53
Melbourne C,9754,3,14,4,11,43,34,9,46
Melbourne V,9754,4,13,5,11,45,39,6,44
Adelaide Utd,9754,5,11,6,11,37,40,-3,39
Brisbane,9754,6,10,5,13,33,42,-9,35
Western Sydn,9754,7,8,9,10,38,47,-9,33
Perth Glory,9754,8,10,2,15,37,50,-13,32
Wellington P,9754,9,5,6,16,31,55,-24,21
CC Mariners,9754,10,4,8,15,28,49,-21,20
Sydney FC,9755,1,21,4,3,67,23,44,67
N'castle Jet,9755,2,16,5,7,60,39,21,53
Melbourne C,9755,3,14,4,11,45,36,9,46
Melbourne V,9755,4,13,5,11,46,41,5,44
Adelaide Utd,9755,5,11,6,11,37,40,-3,39
Brisbane,9755,6,10,5,13,33,42,-9,35
Western Sydn,9755,7,8,9,10,38,47,-9,33
Perth Glory,9755,8,10,2,15,37,50,-13,32
Wellington P,9755,9,5,6,16,31,55,-24,21
CC Mariners,9755,10,4,8,15,28,49,-21,20
Sydney FC,9756,1,20,5,3,65,23,42,65
N'castle Jet,9756,2,16,5,7,60,37,23,53
Melbourne C,9756,3,14,4,11,43,36,7,46
Melbourne V,9756,4,13,6,10,46,39,7,45
Adelaide Utd,9756,5,11,6,11,37,40,-3,39
Brisbane,9756,6,10,5,13,33,42,-9,35
Western Sydn,9756,7,8,9,10,38,47,-9,33
Perth Glory,9756,8,10,2,15,37,50,-13,32
Wellington P,9756,9,5,6,16,31,55,-24,21
CC Mariners,9756,10,4,8,15,28,49,-21,20
Sydney FC,9757,1,21,4,3,66,23,43,67
N'castle Jet,9757,2,15,5,8,58,40,18,50
Melbourne C,9757,3,15,4,10,46,34,12,49
Melbourne V,9757,4,13,5,11,46,40,6,44
Adelaide Utd,9757,5,11,6,11,37,40,-3,39
Brisbane,9757,6,10,5,13,33,42,-9,35
Western Sydn,9757,7,8,9,10,38,47,-9,33
Perth Glory,9757,8,10,2,15,37,50,-13,32
Wellington P,9757,9,5,6,16,31,55,-24,21
CC Mariners,9757,10,4,8,15,28,49,-21,20
Sydney FC,9758,1,20,4,4,64,23,41,64
N'castle Jet,9758,2,15,6,7,58,38,20,51
Melbourne C,9758,3,14,5,10,44,34,10,47
Melbourne V,9758,4,14,5,10,46,38,8,47
Adelaide Utd,9758,5,11,6,11,37,40,-3,39
Brisbane,9758,6,10,5,13,33,42,-9,35
Western Sydn,9758,7,8,9,10,38,47,-9,33
Perth Glory,9758,8,10,2,15,37,50,-13,32
Wellington P,9758,9,5,6,16,31,55,-24,21
CC Mariners,9758,10,4,8,15,28,49,-21,20
Sydney FC,9759,1,21,4,3,66,23,43,67
N'castle Jet,9759,2,16,5,7,58,37,21,53
Melbourne C,9759,3,14,4,11,43,34,9,46
Melbourne V,9759,4,13,5,11,46,40,6,44
Adelaide Utd,9759,5,11,6,11,37,40,-3,39
Brisbane,9759,6,10,5,13,33,42,-9,35
Western Sydn,9759,7,8,9,10,38,47,-9,33
Perth Glory,9759,8,10,2,15,37,50,-13,32
Wellington P,9759,9,5,6,16,31,55,-24,21
CC Mariners,9759,10,4,8,15,28,49,-21,20
Sydney FC,9760,1,21,4,3,67,23,44,67
N'castle Jet,9760,2,15,6,7,58,38,20,51
Melbourne C,9760,3,14,5,10,44,34,10,47
Melbourne V,9760,4,13,5,11,46,41,5,44
Adelaide Utd,9760,5,11,6,11,37,40,-3,39
Brisbane,9760,6,10,5,13,33,42,-9,35
Western Sydn,9760,7,8,9,10,38,47,-9,33
Perth Glory,9760,8,10,2,15,37,50,-13,32
Wellington P,9760,9,5,6,16,31,55,-24,21
CC Mariners,9760,10,4,8,15,28,49,-21,20
Sydney FC,9761,1,20,5,3,64,22,42,65
N'castle Jet,9761,2,16,5,7,59,37,22,53
Melbourne C,9761,3,14,4,11,43,35,8,46
Melbourne V,9761,4,13,6,10,45,38,7,45
Adelaide Utd,9761,5,11,6,11,37,40,-3,39
Brisbane,9761,6,10,5,13,33,42,-9,35
Western Sydn,9761,7,8,9,10,38,47,-9,33
Perth Glory,9761,8,10,2,15,37,50,-13,32
Wellington P,9761,9,5,6,16,31,55,-24,21
CC Mariners,9761,10,4,8,15,28,49,-21,20
Sydney FC,9762,1,20,4,4,64,25,39,64
N'castle Jet,9762,2,15,6,7,58,38,20,51
Melbourne V,9762,3,14,5,10,48,38,10,47
Melbourne C,9762,4,14,5,10,44,34,10,47
Adelaide Utd,9762,5,11,6,11,37,40,-3,39
Brisbane,9762,6,10,5,13,33,42,-9,35
Western Sydn,9762,7,8,9,10,38,47,-9,33
Perth Glory,9762,8,10,2,15,37,50,-13,32
Wellington P,9762,9,5,6,16,31,55,-24,21
CC Mariners,9762,10,4,8,15,28,49,-21,20
Sydney FC,9763,1,21,4,3,65,22,43,67
N'castle Jet,9763,2,15,6,7,59,39,20,51
Melbourne C,9763,3,14,5,10,45,35,10,47
Melbourne V,9763,4,13,5,11,45,39,6,44
Adelaide Utd,9763,5,11,6,11,37,40,-3,39
Brisbane,9763,6,10,5,13,33,42,-9,35
Western Sydn,9763,7,8,9,10,38,47,-9,33
Perth Glory,9763,8,10,2,15,37,50,-13,32
Wellington P,9763,9,5,6,16,31,55,-24,21
CC Mariners,9763,10,4,8,15,28,49,-21,20
Sydney FC,9764,1,21,4,3,65,22,43,67
N'castle Jet,9764,2,15,6,7,57,37,20,51
Melbourne C,9764,3,14,5,10,43,33,10,47
Melbourne V,9764,4,13,5,11,45,39,6,44
Adelaide Utd,9764,5,11,6,11,37,40,-3,39
Brisbane,9764,6,10,5,13,33,42,-9,35
Western Sydn,9764,7,8,9,10,38,47,-9,33
Perth Glory,9764,8,10,2,15,37,50,-13,32
Wellington P,9764,9,5,6,16,31,55,-24,21
CC Mariners,9764,10,4,8,15,28,49,-21,20
Sydney FC,9765,1,21,4,3,66,22,44,67
N'castle Jet,9765,2,15,5,8,57,38,19,50
Melbourne C,9765,3,15,4,10,44,33,11,49
Melbourne V,9765,4,13,5,11,45,40,5,44
Adelaide Utd,9765,5,11,6,11,37,40,-3,39
Brisbane,9765,6,10,5,13,33,42,-9,35
Western Sydn,9765,7,8,9,10,38,47,-9,33
Perth Glory,9765,8,10,2,15,37,50,-13,32
Wellington P,9765,9,5,6,16,31,55,-24,21
CC Mariners,9765,10,4,8,15,28,49,-21,20
Sydney FC,9766,1,21,4,3,66,22,44,67
N'castle Jet,9766,2,15,5,8,58,39,19,50
Melbourne C,9766,3,15,4,10,45,34,11,49
Melbourne V,9766,4,13,5,11,45,40,5,44
Adelaide Utd,9766,5,11,6,11,37,40,-3,39
Brisbane,9766,6,10,5,13,33,42,-9,35
Western Sydn,9766,7,8,9,10,38,47,-9,33
Perth Glory,9766,8,10,2,15,37,50,-13,32
Wellington P,9766,9,5,6,16,31,55,-24,21
CC Mariners,9766,10,4,8,15,28,49,-21,20
Sydney FC,9767,1,21,4,3,68,23,45,67
N'castle Jet,9767,2,15,6,7,57,37,20,51
Melbourne C,9767,3,14,5,10,43,33,10,47
Melbourne V,9767,4,13,5,11,46,42,4,44
Adelaide Utd,9767,5,11,6,11,37,40,-3,39
Brisbane,9767,6,10,5,13,33,42,-9,35
Western Sydn,9767,7,8,9,10,38,47,-9,33
Perth Glory,9767,8,10,2,15,37,50,-13,32
Wellington P,9767,9,5,6,16,31,55,-24,21
CC Mariners,9767,10,4,8,15,28,49,-21,20
Sydney FC,9768,1,20,4,4,64,25,39,64
N'castle Jet,9768,2,16,5,7,59,38,21,53
Melbourne V,9768,3,14,5,10,48,38,10,47
Melbourne C,9768,4,14,4,11,44,35,9,46
Adelaide Utd,9768,5,11,6,11,37,40,-3,39
Brisbane,9768,6,10,5,13,33,42,-9,35
Western Sydn,9768,7,8,9,10,38,47,-9,33
Perth Glory,9768,8,10,2,15,37,50,-13,32
Wellington P,9768,9,5,6,16,31,55,-24,21
CC Mariners,9768,10,4,8,15,28,49,-21,20
Sydney FC,9769,1,21,4,3,66,23,43,67
N'castle Jet,9769,2,16,5,7,61,40,21,53
Melbourne C,9769,3,14,4,11,46,37,9,46
Melbourne V,9769,4,13,5,11,46,40,6,44
Adelaide Utd,9769,5,11,6,11,37,40,-3,39
Brisbane,9769,6,10,5,13,33,42,-9,35
Western Sydn,9769,7,8,9,10,38,47,-9,33
Perth Glory,9769,8,10,2,15,37,50,-13,32
Wellington P,9769,9,5,6,16,31,55,-24,21
CC Mariners,9769,10,4,8,15,28,49,-21,20
Sydney FC,9770,1,21,4,3,65,22,43,67
N'castle Jet,9770,2,16,5,7,61,39,22,53
Melbourne C,9770,3,14,4,11,45,37,8,46
Melbourne V,9770,4,13,5,11,45,39,6,44
Adelaide Utd,9770,5,11,6,11,37,40,-3,39
Brisbane,9770,6,10,5,13,33,42,-9,35
Western Sydn,9770,7,8,9,10,38,47,-9,33
Perth Glory,9770,8,10,2,15,37,50,-13,32
Wellington P,9770,9,5,6,16,31,55,-24,21
CC Mariners,9770,10,4,8,15,28,49,-21,20
Sydney FC,9771,1,21,4,3,65,22,43,67
N'castle Jet,9771,2,16,5,7,59,37,22,53
Melbourne C,9771,3,14,4,11,43,35,8,46
Melbourne V,9771,4,13,5,11,45,39,6,44
Adelaide Utd,9771,5,11,6,11,37,40,-3,39
Brisbane,9771,6,10,5,13,33,42,-9,35
Western Sydn,9771,7,8,9,10,38,47,-9,33
Perth Glory,9771,8,10,2,15,37,50,-13,32
Wellington P,9771,9,5,6,16,31,55,-24,21
CC Mariners,9771,10,4,8,15,28,49,-21,20
Sydney FC,9772,1,21,4,3,66,22,44,67
N'castle Jet,9772,2,16,5,7,60,37,23,53
Melbourne C,9772,3,14,4,11,43,36,7,46
Melbourne V,9772,4,13,5,11,45,40,5,44
Adelaide Utd,9772,5,11,6,11,37,40,-3,39
Brisbane,9772,6,10,5,13,33,42,-9,35
Western Sydn,9772,7,8,9,10,38,47,-9,33
Perth Glory,9772,8,10,2,15,37,50,-13,32
Wellington P,9772,9,5,6,16,31,55,-24,21
CC Mariners,9772,10,4,8,15,28,49,-21,20
Sydney FC,9773,1,21,4,3,67,22,45,67
N'castle Jet,9773,2,15,6,7,57,37,20,51
Melbourne C,9773,3,14,5,10,43,33,10,47
Melbourne V,9773,4,13,5,11,45,41,4,44
Adelaide Utd,9773,5,11,6,11,37,40,-3,39
Brisbane,9773,6,10,5,13,33,42,-9,35
Western Sydn,9773,7,8,9,10,38,47,-9,33
Perth Glory,9773,8,10,2,15,37,50,-13,32
Wellington P,9773,9,5,6,16,31,55,-24,21
CC Mariners,9773,10,4,8,15,28,49,-21,20
Sydney FC,9774,1,21,4,3,65,22,43,67
N'castle Jet,9774,2,15,6,7,57,37,20,51
Melbourne C,9774,3,14,5,10,43,33,10,47
Melbourne V,9774,4,13,5,11,45,39,6,44
Adelaide Utd,9774,5,11,6,11,37,40,-3,39
Brisbane,9774,6,10,5,13,33,42,-9,35
Western Sydn,9774,7,8,9,10,38,47,-9,33
Perth Glory,9774,8,10,2,15,37,50,-13,32
Wellington P,9774,9,5,6,16,31,55,-24,21
CC Mariners,9774,10,4,8,15,28,49,-21,20
Sydney FC,9775,1,20,5,3,65,23,42,65
N'castle Jet,9775,2,16,5,7,60,37,23,53
Melbourne C,9775,3,14,4,11,43,36,7,46
Melbourne V,9775,4,13,6,10,46,39,7,45
Adelaide Utd,9775,5,11,6,11,37,40,-3,39
Brisbane,9775,6,10,5,13,33,42,-9,35
Western Sydn,9775,7,8,9,10,38,47,-9,33
Perth Glory,9775,8,10,2,15,37,50,-13,32
Wellington P,9775,9,5,6,16,31,55,-24,21
CC Mariners,9775,10,4,8,15,28,49,-21,20
Sydney FC,9776,1,20,4,4,64,23,41,64
N'castle Jet,9776,2,15,5,8,58,39,19,50
Melbourne C,9776,3,15,4,10,45,34,11,49
Melbourne V,9776,4,14,5,10,46,38,8,47
Adelaide Utd,9776,5,11,6,11,37,40,-3,39
Brisbane,9776,6,10,5,13,33,42,-9,35
Western Sydn,9776,7,8,9,10,38,47,-9,33
Perth Glory,9776,8,10,2,15,37,50,-13,32
Wellington P,9776,9,5,6,16,31,55,-24,21
CC Mariners,9776,10,4,8,15,28,49,-21,20
Sydney FC,9777,1,20,5,3,66,24,42,65
N'castle Jet,9777,2,16,5,7,59,37,22,53
Melbourne C,9777,3,14,4,11,43,35,8,46
Melbourne V,9777,4,13,6,10,47,40,7,45
Adelaide Utd,9777,5,11,6,11,37,40,-3,39
Brisbane,9777,6,10,5,13,33,42,-9,35
Western Sydn,9777,7,8,9,10,38,47,-9,33
Perth Glory,9777,8,10,2,15,37,50,-13,32
Wellington P,9777,9,5,6,16,31,55,-24,21
CC Mariners,9777,10,4,8,15,28,49,-21,20
Sydney FC,9778,1,21,4,3,66,23,43,67
N'castle Jet,9778,2,15,6,7,59,39,20,51
Melbourne C,9778,3,14,5,10,45,35,10,47
Melbourne V,9778,4,13,5,11,46,40,6,44
Adelaide Utd,9778,5,11,6,11,37,40,-3,39
Brisbane,9778,6,10,5,13,33,42,-9,35
Western Sydn,9778,7,8,9,10,38,47,-9,33
Perth Glory,9778,8,10,2,15,37,50,-13,32
Wellington P,9778,9,5,6,16,31,55,-24,21
CC Mariners,9778,10,4,8,15,28,49,-21,20
Sydney FC,9779,1,21,4,3,67,22,45,67
N'castle Jet,9779,2,16,5,7,60,38,22,53
Melbourne C,9779,3,14,4,11,44,36,8,46
Melbourne V,9779,4,13,5,11,45,41,4,44
Adelaide Utd,9779,5,11,6,11,37,40,-3,39
Brisbane,9779,6,10,5,13,33,42,-9,35
Western Sydn,9779,7,8,9,10,38,47,-9,33
Perth Glory,9779,8,10,2,15,37,50,-13,32
Wellington P,9779,9,5,6,16,31,55,-24,21
CC Mariners,9779,10,4,8,15,28,49,-21,20
Sydney FC,9780,1,21,4,3,65,22,43,67
N'castle Jet,9780,2,16,5,7,61,37,24,53
Melbourne C,9780,3,14,4,11,43,37,6,46
Melbourne V,9780,4,13,5,11,45,39,6,44
Adelaide Utd,9780,5,11,6,11,37,40,-3,39
Brisbane,9780,6,10,5,13,33,42,-9,35
Western Sydn,9780,7,8,9,10,38,47,-9,33
Perth Glory,9780,8,10,2,15,37,50,-13,32
Wellington P,9780,9,5,6,16,31,55,-24,21
CC Mariners,9780,10,4,8,15,28,49,-21,20
Sydney FC,9781,1,21,4,3,67,22,45,67
N'castle Jet,9781,2,16,5,7,61,37,24,53
Melbourne C,9781,3,14,4,11,43,37,6,46
Melbourne V,9781,4,13,5,11,45,41,4,44
Adelaide Utd,9781,5,11,6,11,37,40,-3,39
Brisbane,9781,6,10,5,13,33,42,-9,35
Western Sydn,9781,7,8,9,10,38,47,-9,33
Perth Glory,9781,8,10,2,15,37,50,-13,32
Wellington P,9781,9,5,6,16,31,55,-24,21
CC Mariners,9781,10,4,8,15,28,49,-21,20
Sydney FC,9782,1,21,4,3,68,22,46,67
N'castle Jet,9782,2,16,5,7,60,39,21,53
Melbourne C,9782,3,14,4,11,45,36,9,46
Melbourne V,9782,4,13,5,11,45,42,3,44
Adelaide Utd,9782,5,11,6,11,37,40,-3,39
Brisbane,9782,6,10,5,13,33,42,-9,35
Western Sydn,9782,7,8,9,10,38,47,-9,33
Perth Glory,9782,8,10,2,15,37,50,-13,32
Wellington P,9782,9,5,6,16,31,55,-24,21
CC Mariners,9782,10,4,8,15,28,49,-21,20
Sydney FC,9783,1,21,4,3,66,23,43,67
N'castle Jet,9783,2,16,5,7,59,38,21,53
Melbourne C,9783,3,14,4,11,44,35,9,46
Melbourne V,9783,4,13,5,11,46,40,6,44
Adelaide Utd,9783,5,11,6,11,37,40,-3,39
Brisbane,9783,6,10,5,13,33,42,-9,35
Western Sydn,9783,7,8,9,10,38,47,-9,33
Perth Glory,9783,8,10,2,15,37,50,-13,32
Wellington P,9783,9,5,6,16,31,55,-24,21
CC Mariners,9783,10,4,8,15,28,49,-21,20
Sydney FC,9784,1,21,4,3,65,22,43,67
N'castle Jet,9784,2,16,5,7,59,37,22,53
Melbourne C,9784,3,14,4,11,43,35,8,46
Melbourne V,9784,4,13,5,11,45,39,6,44
Adelaide Utd,9784,5,11,6,11,37,40,-3,39
Brisbane,9784,6,10,5,13,33,42,-9,35
Western Sydn,9784,7,8,9,10,38,47,-9,33
Perth Glory,9784,8,10,2,15,37,50,-13,32
Wellington P,9784,9,5,6,16,31,55,-24,21
CC Mariners,9784,10,4,8,15,28,49,-21,20
Sydney FC,9785,1,20,4,4,67,26,41,64
N'castle Jet,9785,2,16,5,7,58,37,21,53
Melbourne V,9785,3,14,5,10,49,41,8,47
Melbourne C,9785,4,14,4,11,43,34,9,46
Adelaide Utd,9785,5,11,6,11,37,40,-3,39
Brisbane,9785,6,10,5,13,33,42,-9,35
Western Sydn,9785,7,8,9,10,38,47,-9,33
Perth Glory,9785,8,10,2,15,37,50,-13,32
Wellington P,9785,9,5,6,16,31,55,-24,21
CC Mariners,9785,10,4,8,15,28,49,-21,20
Sydney FC,9786,1,21,4,3,65,22,43,67
N'castle Jet,9786,2,16,5,7,59,37,22,53
Melbourne C,9786,3,14,4,11,43,35,8,46
Melbourne V,9786,4,13,5,11,45,39,6,44
Adelaide Utd,9786,5,11,6,11,37,40,-3,39
Brisbane,9786,6,10,5,13,33,42,-9,35
Western Sydn,9786,7,8,9,10,38,47,-9,33
Perth Glory,9786,8,10,2,15,37,50,-13,32
Wellington P,9786,9,5,6,16,31,55,-24,21
CC Mariners,9786,10,4,8,15,28,49,-21,20
Sydney FC,9787,1,20,5,3,65,23,42,65
N'castle Jet,9787,2,16,5,7,58,37,21,53
Melbourne C,9787,3,14,4,11,43,34,9,46
Melbourne V,9787,4,13,6,10,46,39,7,45
Adelaide Utd,9787,5,11,6,11,37,40,-3,39
Brisbane,9787,6,10,5,13,33,42,-9,35
Western Sydn,9787,7,8,9,10,38,47,-9,33
Perth Glory,9787,8,10,2,15,37,50,-13,32
Wellington P,9787,9,5,6,16,31,55,-24,21
CC Mariners,9787,10,4,8,15,28,49,-21,20
Sydney FC,9788,1,21,4,3,66,23,43,67
N'castle Jet,9788,2,16,5,7,59,38,21,53
Melbourne C,9788,3,14,4,11,44,35,9,46
Melbourne V,9788,4,13,5,11,46,40,6,44
Adelaide Utd,9788,5,11,6,11,37,40,-3,39
Brisbane,9788,6,10,5,13,33,42,-9,35
Western Sydn,9788,7,8,9,10,38,47,-9,33
Perth Glory,9788,8,10,2,15,37,50,-13,32
Wellington P,9788,9,5,6,16,31,55,-24,21
CC Mariners,9788,10,4,8,15,28,49,-21,20
Sydney FC,9789,1,21,4,3,65,22,43,67
N'castle Jet,9789,2,16,5,7,60,38,22,53
Melbourne C,9789,3,14,4,11,44,36,8,46
Melbourne V,9789,4,13,5,11,45,39,6,44
Adelaide Utd,9789,5,11,6,11,37,40,-3,39
Brisbane,9789,6,10,5,13,33,42,-9,35
Western Sydn,9789,7,8,9,10,38,47,-9,33
Perth Glory,9789,8,10,2,15,37,50,-13,32
Wellington P,9789,9,5,6,16,31,55,-24,21
CC Mariners,9789,10,4,8,15,28,49,-21,20
Sydney FC,9790,1,21,4,3,66,22,44,67
N'castle Jet,9790,2,16,5,7,63,37,26,53
Melbourne C,9790,3,14,4,11,43,39,4,46
Melbourne V,9790,4,13,5,11,45,40,5,44
Adelaide Utd,9790,5,11,6,11,37,40,-3,39
Brisbane,9790,6,10,5,13,33,42,-9,35
Western Sydn,9790,7,8,9,10,38,47,-9,33
Perth Glory,9790,8,10,2,15,37,50,-13,32
Wellington P,9790,9,5,6,16,31,55,-24,21
CC Mariners,9790,10,4,8,15,28,49,-21,20
Sydney FC,9791,1,21,4,3,67,22,45,67
N'castle Jet,9791,2,16,5,7,58,37,21,53
Melbourne C,9791,3,14,4,11,43,34,9,46
Melbourne V,9791,4,13,5,11,45,41,4,44
Adelaide Utd,9791,5,11,6,11,37,40,-3,39
Brisbane,9791,6,10,5,13,33,42,-9,35
Western Sydn,9791,7,8,9,10,38,47,-9,33
Perth Glory,9791,8,10,2,15,37,50,-13,32
Wellington P,9791,9,5,6,16,31,55,-24,21
CC Mariners,9791,10,4,8,15,28,49,-21,20
Sydney FC,9792,1,21,4,3,66,22,44,67
N'castle Jet,9792,2,15,6,7,57,37,20,51
Melbourne C,9792,3,14,5,10,43,33,10,47
Melbourne V,9792,4,13,5,11,45,40,5,44
Adelaide Utd,9792,5,11,6,11,37,40,-3,39
Brisbane,9792,6,10,5,13,33,42,-9,35
Western Sydn,9792,7,8,9,10,38,47,-9,33
Perth Glory,9792,8,10,2,15,37,50,-13,32
Wellington P,9792,9,5,6,16,31,55,-24,21
CC Mariners,9792,10,4,8,15,28,49,-21,20
Sydney FC,9793,1,21,4,3,66,22,44,67
N'castle Jet,9793,2,15,5,8,57,38,19,50
Melbourne C,9793,3,15,4,10,44,33,11,49
Melbourne V,9793,4,13,5,11,45,40,5,44
Adelaide Utd,9793,5,11,6,11,37,40,-3,39
Brisbane,9793,6,10,5,13,33,42,-9,35
Western Sydn,9793,7,8,9,10,38,47,-9,33
Perth Glory,9793,8,10,2,15,37,50,-13,32
Wellington P,9793,9,5,6,16,31,55,-24,21
CC Mariners,9793,10,4,8,15,28,49,-21,20
Sydney FC,9794,1,21,4,3,68,23,45,67
N'castle Jet,9794,2,16,5,7,61,38,23,53
Melbourne C,9794,3,14,4,11,44,37,7,46
Melbourne V,9794,4,13,5,11,46,42,4,44
Adelaide Utd,9794,5,11,6,11,37,40,-3,39
Brisbane,9794,6,10,5,13,33,42,-9,35
Western Sydn,9794,7,8,9,10,38,47,-9,33
Perth Glory,9794,8,10,2,15,37,50,-13,32
Wellington P,9794,9,5,6,16,31,55,-24,21
CC Mariners,9794,10,4,8,15,28,49,-21,20
Sydney FC,9795,1,20,4,4,64,24,40,64
N'castle Jet,9795,2,16,5,7,59,38,21,53
Melbourne V,9795,3,14,5,10,47,38,9,47
Melbourne C,9795,4,14,4,11,44,35,9,46
Adelaide Utd,9795,5,11,6,11,37,40,-3,39
Brisbane,9795,6,10,5,13,33,42,-9,35
Western Sydn,9795,7,8,9,10,38,47,-9,33
Perth Glory,9795,8,10,2,15,37,50,-13,32
Wellington P,9795,9,5,6,16,31,55,-24,21
CC Mariners,9795,10,4,8,15,28,49,-21,20
Sydney FC,9796,1,20,4,4,65,24,41,64
N'castle Jet,9796,2,15,5,8,59,40,19,50
Melbourne C,9796,3,15,4,10,46,35,11,49
Melbourne V,9796,4,14,5,10,47,39,8,47
Adelaide Utd,9796,5,11,6,11,37,40,-3,39
Brisbane,9796,6,10,5,13,33,42,-9,35
Western Sydn,9796,7,8,9,10,38,47,-9,33
Perth Glory,9796,8,10,2,15,37,50,-13,32
Wellington P,9796,9,5,6,16,31,55,-24,21
CC Mariners,9796,10,4,8,15,28,49,-21,20
Sydney FC,9797,1,20,5,3,64,22,42,65
N'castle Jet,9797,2,16,5,7,60,37,23,53
Melbourne C,9797,3,14,4,11,43,36,7,46
Melbourne V,9797,4,13,6,10,45,38,7,45
Adelaide Utd,9797,5,11,6,11,37,40,-3,39
Brisbane,9797,6,10,5,13,33,42,-9,35
Western Sydn,9797,7,8,9,10,38,47,-9,33
Perth Glory,9797,8,10,2,15,37,50,-13,32
Wellington P,9797,9,5,6,16,31,55,-24,21
CC Mariners,9797,10,4,8,15,28,49,-21,20
Sydney FC,9798,1,21,4,3,66,23,43,67
N'castle Jet,9798,2,16,5,7,59,37,22,53
Melbourne C,9798,3,14,4,11,43,35,8,46
Melbourne V,9798,4,13,5,11,46,40,6,44
Adelaide Utd,9798,5,11,6,11,37,40,-3,39
Brisbane,9798,6,10,5,13,33,42,-9,35
Western Sydn,9798,7,8,9,10,38,47,-9,33
Perth Glory,9798,8,10,2,15,37,50,-13,32
Wellington P,9798,9,5,6,16,31,55,-24,21
CC Mariners,9798,10,4,8,15,28,49,-21,20
Sydney FC,9799,1,20,4,4,64,23,41,64
N'castle Jet,9799,2,15,5,8,57,38,19,50
Melbourne C,9799,3,15,4,10,44,33,11,49
Melbourne V,9799,4,14,5,10,46,38,8,47
Adelaide Utd,9799,5,11,6,11,37,40,-3,39
Brisbane,9799,6,10,5,13,33,42,-9,35
Western Sydn,9799,7,8,9,10,38,47,-9,33
Perth Glory,9799,8,10,2,15,37,50,-13,32
Wellington P,9799,9,5,6,16,31,55,-24,21
CC Mariners,9799,10,4,8,15,28,49,-21,20
Sydney FC,9800,1,21,4,3,67,22,45,67
N'castle Jet,9800,2,15,5,8,59,41,18,50
Melbourne C,9800,3,15,4,10,47,35,12,49
Melbourne V,9800,4,13,5,11,45,41,4,44
Adelaide Utd,9800,5,11,6,11,37,40,-3,39
Brisbane,9800,6,10,5,13,33,42,-9,35
Western Sydn,9800,7,8,9,10,38,47,-9,33
Perth Glory,9800,8,10,2,15,37,50,-13,32
Wellington P,9800,9,5,6,16,31,55,-24,21
CC Mariners,9800,10,4,8,15,28,49,-21,20
Sydney FC,9801,1,21,4,3,65,22,43,67
N'castle Jet,9801,2,16,5,7,60,37,23,53
Melbourne C,9801,3,14,4,11,43,36,7,46
Melbourne V,9801,4,13,5,11,45,39,6,44
Adelaide Utd,9801,5,11,6,11,37,40,-3,39
Brisbane,9801,6,10,5,13,33,42,-9,35
Western Sydn,9801,7,8,9,10,38,47,-9,33
Perth Glory,9801,8,10,2,15,37,50,-13,32
Wellington P,9801,9,5,6,16,31,55,-24,21
CC Mariners,9801,10,4,8,15,28,49,-21,20
Sydney FC,9802,1,21,4,3,65,22,43,67
N'castle Jet,9802,2,16,5,7,60,37,23,53
Melbourne C,9802,3,14,4,11,43,36,7,46
Melbourne V,9802,4,13,5,11,45,39,6,44
Adelaide Utd,9802,5,11,6,11,37,40,-3,39
Brisbane,9802,6,10,5,13,33,42,-9,35
Western Sydn,9802,7,8,9,10,38,47,-9,33
Perth Glory,9802,8,10,2,15,37,50,-13,32
Wellington P,9802,9,5,6,16,31,55,-24,21
CC Mariners,9802,10,4,8,15,28,49,-21,20
Sydney FC,9803,1,21,4,3,69,24,45,67
N'castle Jet,9803,2,15,5,8,57,38,19,50
Melbourne C,9803,3,15,4,10,44,33,11,49
Melbourne V,9803,4,13,5,11,47,43,4,44
Adelaide Utd,9803,5,11,6,11,37,40,-3,39
Brisbane,9803,6,10,5,13,33,42,-9,35
Western Sydn,9803,7,8,9,10,38,47,-9,33
Perth Glory,9803,8,10,2,15,37,50,-13,32
Wellington P,9803,9,5,6,16,31,55,-24,21
CC Mariners,9803,10,4,8,15,28,49,-21,20
Sydney FC,9804,1,21,4,3,66,22,44,67
N'castle Jet,9804,2,15,6,7,58,38,20,51
Melbourne C,9804,3,14,5,10,44,34,10,47
Melbourne V,9804,4,13,5,11,45,40,5,44
Adelaide Utd,9804,5,11,6,11,37,40,-3,39
Brisbane,9804,6,10,5,13,33,42,-9,35
Western Sydn,9804,7,8,9,10,38,47,-9,33
Perth Glory,9804,8,10,2,15,37,50,-13,32
Wellington P,9804,9,5,6,16,31,55,-24,21
CC Mariners,9804,10,4,8,15,28,49,-21,20
Sydney FC,9805,1,21,4,3,68,23,45,67
N'castle Jet,9805,2,15,6,7,58,38,20,51
Melbourne C,9805,3,14,5,10,44,34,10,47
Melbourne V,9805,4,13,5,11,46,42,4,44
Adelaide Utd,9805,5,11,6,11,37,40,-3,39
Brisbane,9805,6,10,5,13,33,42,-9,35
Western Sydn,9805,7,8,9,10,38,47,-9,33
Perth Glory,9805,8,10,2,15,37,50,-13,32
Wellington P,9805,9,5,6,16,31,55,-24,21
CC Mariners,9805,10,4,8,15,28,49,-21,20
Sydney FC,9806,1,21,4,3,68,25,43,67
N'castle Jet,9806,2,15,6,7,57,37,20,51
Melbourne C,9806,3,14,5,10,43,33,10,47
Melbourne V,9806,4,13,5,11,48,42,6,44
Adelaide Utd,9806,5,11,6,11,37,40,-3,39
Brisbane,9806,6,10,5,13,33,42,-9,35
Western Sydn,9806,7,8,9,10,38,47,-9,33
Perth Glory,9806,8,10,2,15,37,50,-13,32
Wellington P,9806,9,5,6,16,31,55,-24,21
CC Mariners,9806,10,4,8,15,28,49,-21,20
Sydney FC,9807,1,20,5,3,64,22,42,65
N'castle Jet,9807,2,15,5,8,58,40,18,50
Melbourne C,9807,3,15,4,10,46,34,12,49
Melbourne V,9807,4,13,6,10,45,38,7,45
Adelaide Utd,9807,5,11,6,11,37,40,-3,39
Brisbane,9807,6,10,5,13,33,42,-9,35
Western Sydn,9807,7,8,9,10,38,47,-9,33
Perth Glory,9807,8,10,2,15,37,50,-13,32
Wellington P,9807,9,5,6,16,31,55,-24,21
CC Mariners,9807,10,4,8,15,28,49,-21,20
Sydney FC,9808,1,20,4,4,65,24,41,64
N'castle Jet,9808,2,16,5,7,58,37,21,53
Melbourne V,9808,3,14,5,10,47,39,8,47
Melbourne C,9808,4,14,4,11,43,34,9,46
Adelaide Utd,9808,5,11,6,11,37,40,-3,39
Brisbane,9808,6,10,5,13,33,42,-9,35
Western Sydn,9808,7,8,9,10,38,47,-9,33
Perth Glory,9808,8,10,2,15,37,50,-13,32
Wellington P,9808,9,5,6,16,31,55,-24,21
CC Mariners,9808,10,4,8,15,28,49,-21,20
Sydney FC,9809,1,20,4,4,64,24,40,64
N'castle Jet,9809,2,16,5,7,59,38,21,53
Melbourne V,9809,3,14,5,10,47,38,9,47
Melbourne C,9809,4,14,4,11,44,35,9,46
Adelaide Utd,9809,5,11,6,11,37,40,-3,39
Brisbane,9809,6,10,5,13,33,42,-9,35
Western Sydn,9809,7,8,9,10,38,47,-9,33
Perth Glory,9809,8,10,2,15,37,50,-13,32
Wellington P,9809,9,5,6,16,31,55,-24,21
CC Mariners,9809,10,4,8,15,28,49,-21,20
Sydney FC,9810,1,21,4,3,67,23,44,67
N'castle Jet,9810,2,16,5,7,60,37,23,53
Melbourne C,9810,3,14,4,11,43,36,7,46
Melbourne V,9810,4,13,5,11,46,41,5,44
Adelaide Utd,9810,5,11,6,11,37,40,-3,39
Brisbane,9810,6,10,5,13,33,42,-9,35
Western Sydn,9810,7,8,9,10,38,47,-9,33
Perth Glory,9810,8,10,2,15,37,50,-13,32
Wellington P,9810,9,5,6,16,31,55,-24,21
CC Mariners,9810,10,4,8,15,28,49,-21,20
Sydney FC,9811,1,20,5,3,65,23,42,65
N'castle Jet,9811,2,15,6,7,58,38,20,51
Melbourne C,9811,3,14,5,10,44,34,10,47
Melbourne V,9811,4,13,6,10,46,39,7,45
Adelaide Utd,9811,5,11,6,11,37,40,-3,39
Brisbane,9811,6,10,5,13,33,42,-9,35
Western Sydn,9811,7,8,9,10,38,47,-9,33
Perth Glory,9811,8,10,2,15,37,50,-13,32
Wellington P,9811,9,5,6,16,31,55,-24,21
CC Mariners,9811,10,4,8,15,28,49,-21,20
Sydney FC,9812,1,20,5,3,65,23,42,65
N'castle Jet,9812,2,15,6,7,58,38,20,51
Melbourne C,9812,3,14,5,10,44,34,10,47
Melbourne V,9812,4,13,6,10,46,39,7,45
Adelaide Utd,9812,5,11,6,11,37,40,-3,39
Brisbane,9812,6,10,5,13,33,42,-9,35
Western Sydn,9812,7,8,9,10,38,47,-9,33
Perth Glory,9812,8,10,2,15,37,50,-13,32
Wellington P,9812,9,5,6,16,31,55,-24,21
CC Mariners,9812,10,4,8,15,28,49,-21,20
Sydney FC,9813,1,21,4,3,68,24,44,67
N'castle Jet,9813,2,16,5,7,59,37,22,53
Melbourne C,9813,3,14,4,11,43,35,8,46
Melbourne V,9813,4,13,5,11,47,42,5,44
Adelaide Utd,9813,5,11,6,11,37,40,-3,39
Brisbane,9813,6,10,5,13,33,42,-9,35
Western Sydn,9813,7,8,9,10,38,47,-9,33
Perth Glory,9813,8,10,2,15,37,50,-13,32
Wellington P,9813,9,5,6,16,31,55,-24,21
CC Mariners,9813,10,4,8,15,28,49,-21,20
Sydney FC,9814,1,21,4,3,66,23,43,67
N'castle Jet,9814,2,15,5,8,58,40,18,50
Melbourne C,9814,3,15,4,10,46,34,12,49
Melbourne V,9814,4,13,5,11,46,40,6,44
Adelaide Utd,9814,5,11,6,11,37,40,-3,39
Brisbane,9814,6,10,5,13,33,42,-9,35
Western Sydn,9814,7,8,9,10,38,47,-9,33
Perth Glory,9814,8,10,2,15,37,50,-13,32
Wellington P,9814,9,5,6,16,31,55,-24,21
CC Mariners,9814,10,4,8,15,28,49,-21,20
Sydney FC,9815,1,20,4,4,65,24,41,64
N'castle Jet,9815,2,16,5,7,58,37,21,53
Melbourne V,9815,3,14,5,10,47,39,8,47
Melbourne C,9815,4,14,4,11,43,34,9,46
Adelaide Utd,9815,5,11,6,11,37,40,-3,39
Brisbane,9815,6,10,5,13,33,42,-9,35
Western Sydn,9815,7,8,9,10,38,47,-9,33
Perth Glory,9815,8,10,2,15,37,50,-13,32
Wellington P,9815,9,5,6,16,31,55,-24,21
CC Mariners,9815,10,4,8,15,28,49,-21,20
Sydney FC,9816,1,21,4,3,68,22,46,67
N'castle Jet,9816,2,15,6,7,59,39,20,51
Melbourne C,9816,3,14,5,10,45,35,10,47
Melbourne V,9816,4,13,5,11,45,42,3,44
Adelaide Utd,9816,5,11,6,11,37,40,-3,39
Brisbane,9816,6,10,5,13,33,42,-9,35
Western Sydn,9816,7,8,9,10,38,47,-9,33
Perth Glory,9816,8,10,2,15,37,50,-13,32
Wellington P,9816,9,5,6,16,31,55,-24,21
CC Mariners,9816,10,4,8,15,28,49,-21,20
Sydney FC,9817,1,21,4,3,68,22,46,67
N'castle Jet,9817,2,16,5,7,59,37,22,53
Melbourne C,9817,3,14,4,11,43,35,8,46
Melbourne V,9817,4,13,5,11,45,42,3,44
Adelaide Utd,9817,5,11,6,11,37,40,-3,39
Brisbane,9817,6,10,5,13,33,42,-9,35
Western Sydn,9817,7,8,9,10,38,47,-9,33
Perth Glory,9817,8,10,2,15,37,50,-13,32
Wellington P,9817,9,5,6,16,31,55,-24,21
CC Mariners,9817,10,4,8,15,28,49,-21,20
Sydney FC,9818,1,20,5,3,65,23,42,65
N'castle Jet,9818,2,15,6,7,59,39,20,51
Melbourne C,9818,3,14,5,10,45,35,10,47
Melbourne V,9818,4,13,6,10,46,39,7,45
Adelaide Utd,9818,5,11,6,11,37,40,-3,39
Brisbane,9818,6,10,5,13,33,42,-9,35
Western Sydn,9818,7,8,9,10,38,47,-9,33
Perth Glory,9818,8,10,2,15,37,50,-13,32
Wellington P,9818,9,5,6,16,31,55,-24,21
CC Mariners,9818,10,4,8,15,28,49,-21,20
Sydney FC,9819,1,20,5,3,65,23,42,65
N'castle Jet,9819,2,15,6,7,58,38,20,51
Melbourne C,9819,3,14,5,10,44,34,10,47
Melbourne V,9819,4,13,6,10,46,39,7,45
Adelaide Utd,9819,5,11,6,11,37,40,-3,39
Brisbane,9819,6,10,5,13,33,42,-9,35
Western Sydn,9819,7,8,9,10,38,47,-9,33
Perth Glory,9819,8,10,2,15,37,50,-13,32
Wellington P,9819,9,5,6,16,31,55,-24,21
CC Mariners,9819,10,4,8,15,28,49,-21,20
Sydney FC,9820,1,20,4,4,65,24,41,64
N'castle Jet,9820,2,15,6,7,57,37,20,51
Melbourne C,9820,3,14,5,10,43,33,10,47
Melbourne V,9820,4,14,5,10,47,39,8,47
Adelaide Utd,9820,5,11,6,11,37,40,-3,39
Brisbane,9820,6,10,5,13,33,42,-9,35
Western Sydn,9820,7,8,9,10,38,47,-9,33
Perth Glory,9820,8,10,2,15,37,50,-13,32
Wellington P,9820,9,5,6,16,31,55,-24,21
CC Mariners,9820,10,4,8,15,28,49,-21,20
Sydney FC,9821,1,20,5,3,65,23,42,65
N'castle Jet,9821,2,16,5,7,60,37,23,53
Melbourne C,9821,3,14,4,11,43,36,7,46
Melbourne V,9821,4,13,6,10,46,39,7,45
Adelaide Utd,9821,5,11,6,11,37,40,-3,39
Brisbane,9821,6,10,5,13,33,42,-9,35
Western Sydn,9821,7,8,9,10,38,47,-9,33
Perth Glory,9821,8,10,2,15,37,50,-13,32
Wellington P,9821,9,5,6,16,31,55,-24,21
CC Mariners,9821,10,4,8,15,28,49,-21,20
Sydney FC,9822,1,20,5,3,65,23,42,65
N'castle Jet,9822,2,15,6,7,58,38,20,51
Melbourne C,9822,3,14,5,10,44,34,10,47
Melbourne V,9822,4,13,6,10,46,39,7,45
Adelaide Utd,9822,5,11,6,11,37,40,-3,39
Brisbane,9822,6,10,5,13,33,42,-9,35
Western Sydn,9822,7,8,9,10,38,47,-9,33
Perth Glory,9822,8,10,2,15,37,50,-13,32
Wellington P,9822,9,5,6,16,31,55,-24,21
CC Mariners,9822,10,4,8,15,28,49,-21,20
Sydney FC,9823,1,20,4,4,65,25,40,64
N'castle Jet,9823,2,16,5,7,62,39,23,53
Melbourne V,9823,3,14,5,10,48,39,9,47
Melbourne C,9823,4,14,4,11,45,38,7,46
Adelaide Utd,9823,5,11,6,11,37,40,-3,39
Brisbane,9823,6,10,5,13,33,42,-9,35
Western Sydn,9823,7,8,9,10,38,47,-9,33
Perth Glory,9823,8,10,2,15,37,50,-13,32
Wellington P,9823,9,5,6,16,31,55,-24,21
CC Mariners,9823,10,4,8,15,28,49,-21,20
Sydney FC,9824,1,21,4,3,67,23,44,67
N'castle Jet,9824,2,16,5,7,60,38,22,53
Melbourne C,9824,3,14,4,11,44,36,8,46
Melbourne V,9824,4,13,5,11,46,41,5,44
Adelaide Utd,9824,5,11,6,11,37,40,-3,39
Brisbane,9824,6,10,5,13,33,42,-9,35
Western Sydn,9824,7,8,9,10,38,47,-9,33
Perth Glory,9824,8,10,2,15,37,50,-13,32
Wellington P,9824,9,5,6,16,31,55,-24,21
CC Mariners,9824,10,4,8,15,28,49,-21,20
Sydney FC,9825,1,20,5,3,65,23,42,65
N'castle Jet,9825,2,15,6,7,59,39,20,51
Melbourne C,9825,3,14,5,10,45,35,10,47
Melbourne V,9825,4,13,6,10,46,39,7,45
Adelaide Utd,9825,5,11,6,11,37,40,-3,39
Brisbane,9825,6,10,5,13,33,42,-9,35
Western Sydn,9825,7,8,9,10,38,47,-9,33
Perth Glory,9825,8,10,2,15,37,50,-13,32
Wellington P,9825,9,5,6,16,31,55,-24,21
CC Mariners,9825,10,4,8,15,28,49,-21,20
Sydney FC,9826,1,21,4,3,66,23,43,67
N'castle Jet,9826,2,16,5,7,59,38,21,53
Melbourne C,9826,3,14,4,11,44,35,9,46
Melbourne V,9826,4,13,5,11,46,40,6,44
Adelaide Utd,9826,5,11,6,11,37,40,-3,39
Brisbane,9826,6,10,5,13,33,42,-9,35
Western Sydn,9826,7,8,9,10,38,47,-9,33
Perth Glory,9826,8,10,2,15,37,50,-13,32
Wellington P,9826,9,5,6,16,31,55,-24,21
CC Mariners,9826,10,4,8,15,28,49,-21,20
Sydney FC,9827,1,20,4,4,65,24,41,64
N'castle Jet,9827,2,16,5,7,60,37,23,53
Melbourne V,9827,3,14,5,10,47,39,8,47
Melbourne C,9827,4,14,4,11,43,36,7,46
Adelaide Utd,9827,5,11,6,11,37,40,-3,39
Brisbane,9827,6,10,5,13,33,42,-9,35
Western Sydn,9827,7,8,9,10,38,47,-9,33
Perth Glory,9827,8,10,2,15,37,50,-13,32
Wellington P,9827,9,5,6,16,31,55,-24,21
CC Mariners,9827,10,4,8,15,28,49,-21,20
Sydney FC,9828,1,20,4,4,65,24,41,64
N'castle Jet,9828,2,15,6,7,58,38,20,51
Melbourne C,9828,3,14,5,10,44,34,10,47
Melbourne V,9828,4,14,5,10,47,39,8,47
Adelaide Utd,9828,5,11,6,11,37,40,-3,39
Brisbane,9828,6,10,5,13,33,42,-9,35
Western Sydn,9828,7,8,9,10,38,47,-9,33
Perth Glory,9828,8,10,2,15,37,50,-13,32
Wellington P,9828,9,5,6,16,31,55,-24,21
CC Mariners,9828,10,4,8,15,28,49,-21,20
Sydney FC,9829,1,21,4,3,67,22,45,67
N'castle Jet,9829,2,16,5,7,60,38,22,53
Melbourne C,9829,3,14,4,11,44,36,8,46
Melbourne V,9829,4,13,5,11,45,41,4,44
Adelaide Utd,9829,5,11,6,11,37,40,-3,39
Brisbane,9829,6,10,5,13,33,42,-9,35
Western Sydn,9829,7,8,9,10,38,47,-9,33
Perth Glory,9829,8,10,2,15,37,50,-13,32
Wellington P,9829,9,5,6,16,31,55,-24,21
CC Mariners,9829,10,4,8,15,28,49,-21,20
Sydney FC,9830,1,20,4,4,65,25,40,64
N'castle Jet,9830,2,16,5,7,60,38,22,53
Melbourne V,9830,3,14,5,10,48,39,9,47
Melbourne C,9830,4,14,4,11,44,36,8,46
Adelaide Utd,9830,5,11,6,11,37,40,-3,39
Brisbane,9830,6,10,5,13,33,42,-9,35
Western Sydn,9830,7,8,9,10,38,47,-9,33
Perth Glory,9830,8,10,2,15,37,50,-13,32
Wellington P,9830,9,5,6,16,31,55,-24,21
CC Mariners,9830,10,4,8,15,28,49,-21,20
Sydney FC,9831,1,21,4,3,67,22,45,67
N'castle Jet,9831,2,15,5,8,58,39,19,50
Melbourne C,9831,3,15,4,10,45,34,11,49
Melbourne V,9831,4,13,5,11,45,41,4,44
Adelaide Utd,9831,5,11,6,11,37,40,-3,39
Brisbane,9831,6,10,5,13,33,42,-9,35
Western Sydn,9831,7,8,9,10,38,47,-9,33
Perth Glory,9831,8,10,2,15,37,50,-13,32
Wellington P,9831,9,5,6,16,31,55,-24,21
CC Mariners,9831,10,4,8,15,28,49,-21,20
Sydney FC,9832,1,21,4,3,66,23,43,67
N'castle Jet,9832,2,16,5,7,60,37,23,53
Melbourne C,9832,3,14,4,11,43,36,7,46
Melbourne V,9832,4,13,5,11,46,40,6,44
Adelaide Utd,9832,5,11,6,11,37,40,-3,39
Brisbane,9832,6,10,5,13,33,42,-9,35
Western Sydn,9832,7,8,9,10,38,47,-9,33
Perth Glory,9832,8,10,2,15,37,50,-13,32
Wellington P,9832,9,5,6,16,31,55,-24,21
CC Mariners,9832,10,4,8,15,28,49,-21,20
Sydney FC,9833,1,21,4,3,66,23,43,67
N'castle Jet,9833,2,16,5,7,60,37,23,53
Melbourne C,9833,3,14,4,11,43,36,7,46
Melbourne V,9833,4,13,5,11,46,40,6,44
Adelaide Utd,9833,5,11,6,11,37,40,-3,39
Brisbane,9833,6,10,5,13,33,42,-9,35
Western Sydn,9833,7,8,9,10,38,47,-9,33
Perth Glory,9833,8,10,2,15,37,50,-13,32
Wellington P,9833,9,5,6,16,31,55,-24,21
CC Mariners,9833,10,4,8,15,28,49,-21,20
Sydney FC,9834,1,21,4,3,66,23,43,67
N'castle Jet,9834,2,16,5,7,59,38,21,53
Melbourne C,9834,3,14,4,11,44,35,9,46
Melbourne V,9834,4,13,5,11,46,40,6,44
Adelaide Utd,9834,5,11,6,11,37,40,-3,39
Brisbane,9834,6,10,5,13,33,42,-9,35
Western Sydn,9834,7,8,9,10,38,47,-9,33
Perth Glory,9834,8,10,2,15,37,50,-13,32
Wellington P,9834,9,5,6,16,31,55,-24,21
CC Mariners,9834,10,4,8,15,28,49,-21,20
Sydney FC,9835,1,21,4,3,69,24,45,67
N'castle Jet,9835,2,15,6,7,59,39,20,51
Melbourne C,9835,3,14,5,10,45,35,10,47
Melbourne V,9835,4,13,5,11,47,43,4,44
Adelaide Utd,9835,5,11,6,11,37,40,-3,39
Brisbane,9835,6,10,5,13,33,42,-9,35
Western Sydn,9835,7,8,9,10,38,47,-9,33
Perth Glory,9835,8,10,2,15,37,50,-13,32
Wellington P,9835,9,5,6,16,31,55,-24,21
CC Mariners,9835,10,4,8,15,28,49,-21,20
Sydney FC,9836,1,20,5,3,65,23,42,65
N'castle Jet,9836,2,15,6,7,59,39,20,51
Melbourne C,9836,3,14,5,10,45,35,10,47
Melbourne V,9836,4,13,6,10,46,39,7,45
Adelaide Utd,9836,5,11,6,11,37,40,-3,39
Brisbane,9836,6,10,5,13,33,42,-9,35
Western Sydn,9836,7,8,9,10,38,47,-9,33
Perth Glory,9836,8,10,2,15,37,50,-13,32
Wellington P,9836,9,5,6,16,31,55,-24,21
CC Mariners,9836,10,4,8,15,28,49,-21,20
Sydney FC,9837,1,20,5,3,67,25,42,65
N'castle Jet,9837,2,15,5,8,58,39,19,50
Melbourne C,9837,3,15,4,10,45,34,11,49
Melbourne V,9837,4,13,6,10,48,41,7,45
Adelaide Utd,9837,5,11,6,11,37,40,-3,39
Brisbane,9837,6,10,5,13,33,42,-9,35
Western Sydn,9837,7,8,9,10,38,47,-9,33
Perth Glory,9837,8,10,2,15,37,50,-13,32
Wellington P,9837,9,5,6,16,31,55,-24,21
CC Mariners,9837,10,4,8,15,28,49,-21,20
Sydney FC,9838,1,20,4,4,65,24,41,64
N'castle Jet,9838,2,15,5,8,58,39,19,50
Melbourne C,9838,3,15,4,10,45,34,11,49
Melbourne V,9838,4,14,5,10,47,39,8,47
Adelaide Utd,9838,5,11,6,11,37,40,-3,39
Brisbane,9838,6,10,5,13,33,42,-9,35
Western Sydn,9838,7,8,9,10,38,47,-9,33
Perth Glory,9838,8,10,2,15,37,50,-13,32
Wellington P,9838,9,5,6,16,31,55,-24,21
CC Mariners,9838,10,4,8,15,28,49,-21,20
Sydney FC,9839,1,21,4,3,65,22,43,67
N'castle Jet,9839,2,16,5,7,61,38,23,53
Melbourne C,9839,3,14,4,11,44,37,7,46
Melbourne V,9839,4,13,5,11,45,39,6,44
Adelaide Utd,9839,5,11,6,11,37,40,-3,39
Brisbane,9839,6,10,5,13,33,42,-9,35
Western Sydn,9839,7,8,9,10,38,47,-9,33
Perth Glory,9839,8,10,2,15,37,50,-13,32
Wellington P,9839,9,5,6,16,31,55,-24,21
CC Mariners,9839,10,4,8,15,28,49,-21,20
Sydney FC,9840,1,21,4,3,69,23,46,67
N'castle Jet,9840,2,15,6,7,58,38,20,51
Melbourne C,9840,3,14,5,10,44,34,10,47
Melbourne V,9840,4,13,5,11,46,43,3,44
Adelaide Utd,9840,5,11,6,11,37,40,-3,39
Brisbane,9840,6,10,5,13,33,42,-9,35
Western Sydn,9840,7,8,9,10,38,47,-9,33
Perth Glory,9840,8,10,2,15,37,50,-13,32
Wellington P,9840,9,5,6,16,31,55,-24,21
CC Mariners,9840,10,4,8,15,28,49,-21,20
Sydney FC,9841,1,21,4,3,69,23,46,67
N'castle Jet,9841,2,15,5,8,57,38,19,50
Melbourne C,9841,3,15,4,10,44,33,11,49
Melbourne V,9841,4,13,5,11,46,43,3,44
Adelaide Utd,9841,5,11,6,11,37,40,-3,39
Brisbane,9841,6,10,5,13,33,42,-9,35
Western Sydn,9841,7,8,9,10,38,47,-9,33
Perth Glory,9841,8,10,2,15,37,50,-13,32
Wellington P,9841,9,5,6,16,31,55,-24,21
CC Mariners,9841,10,4,8,15,28,49,-21,20
Sydney FC,9842,1,20,4,4,65,24,41,64
N'castle Jet,9842,2,15,5,8,57,38,19,50
Melbourne C,9842,3,15,4,10,44,33,11,49
Melbourne V,9842,4,14,5,10,47,39,8,47
Adelaide Utd,9842,5,11,6,11,37,40,-3,39
Brisbane,9842,6,10,5,13,33,42,-9,35
Western Sydn,9842,7,8,9,10,38,47,-9,33
Perth Glory,9842,8,10,2,15,37,50,-13,32
Wellington P,9842,9,5,6,16,31,55,-24,21
CC Mariners,9842,10,4,8,15,28,49,-21,20
Sydney FC,9843,1,21,4,3,68,25,43,67
N'castle Jet,9843,2,16,5,7,59,38,21,53
Melbourne C,9843,3,14,4,11,44,35,9,46
Melbourne V,9843,4,13,5,11,48,42,6,44
Adelaide Utd,9843,5,11,6,11,37,40,-3,39
Brisbane,9843,6,10,5,13,33,42,-9,35
Western Sydn,9843,7,8,9,10,38,47,-9,33
Perth Glory,9843,8,10,2,15,37,50,-13,32
Wellington P,9843,9,5,6,16,31,55,-24,21
CC Mariners,9843,10,4,8,15,28,49,-21,20
Sydney FC,9844,1,20,4,4,64,24,40,64
N'castle Jet,9844,2,15,5,8,57,39,18,50
Melbourne C,9844,3,15,4,10,45,33,12,49
Melbourne V,9844,4,14,5,10,47,38,9,47
Adelaide Utd,9844,5,11,6,11,37,40,-3,39
Brisbane,9844,6,10,5,13,33,42,-9,35
Western Sydn,9844,7,8,9,10,38,47,-9,33
Perth Glory,9844,8,10,2,15,37,50,-13,32
Wellington P,9844,9,5,6,16,31,55,-24,21
CC Mariners,9844,10,4,8,15,28,49,-21,20
Sydney FC,9845,1,21,4,3,71,22,49,67
N'castle Jet,9845,2,15,5,8,57,40,17,50
Melbourne C,9845,3,15,4,10,46,33,13,49
Melbourne V,9845,4,13,5,11,45,45,0,44
Adelaide Utd,9845,5,11,6,11,37,40,-3,39
Brisbane,9845,6,10,5,13,33,42,-9,35
Western Sydn,9845,7,8,9,10,38,47,-9,33
Perth Glory,9845,8,10,2,15,37,50,-13,32
Wellington P,9845,9,5,6,16,31,55,-24,21
CC Mariners,9845,10,4,8,15,28,49,-21,20
Sydney FC,9846,1,21,4,3,67,23,44,67
N'castle Jet,9846,2,16,5,7,60,37,23,53
Melbourne C,9846,3,14,4,11,43,36,7,46
Melbourne V,9846,4,13,5,11,46,41,5,44
Adelaide Utd,9846,5,11,6,11,37,40,-3,39
Brisbane,9846,6,10,5,13,33,42,-9,35
Western Sydn,9846,7,8,9,10,38,47,-9,33
Perth Glory,9846,8,10,2,15,37,50,-13,32
Wellington P,9846,9,5,6,16,31,55,-24,21
CC Mariners,9846,10,4,8,15,28,49,-21,20
Sydney FC,9847,1,21,4,3,65,22,43,67
N'castle Jet,9847,2,15,6,7,57,37,20,51
Melbourne C,9847,3,14,5,10,43,33,10,47
Melbourne V,9847,4,13,5,11,45,39,6,44
Adelaide Utd,9847,5,11,6,11,37,40,-3,39
Brisbane,9847,6,10,5,13,33,42,-9,35
Western Sydn,9847,7,8,9,10,38,47,-9,33
Perth Glory,9847,8,10,2,15,37,50,-13,32
Wellington P,9847,9,5,6,16,31,55,-24,21
CC Mariners,9847,10,4,8,15,28,49,-21,20
Sydney FC,9848,1,20,5,3,65,23,42,65
N'castle Jet,9848,2,16,5,7,59,38,21,53
Melbourne C,9848,3,14,4,11,44,35,9,46
Melbourne V,9848,4,13,6,10,46,39,7,45
Adelaide Utd,9848,5,11,6,11,37,40,-3,39
Brisbane,9848,6,10,5,13,33,42,-9,35
Western Sydn,9848,7,8,9,10,38,47,-9,33
Perth Glory,9848,8,10,2,15,37,50,-13,32
Wellington P,9848,9,5,6,16,31,55,-24,21
CC Mariners,9848,10,4,8,15,28,49,-21,20
Sydney FC,9849,1,21,4,3,66,23,43,67
N'castle Jet,9849,2,16,5,7,58,37,21,53
Melbourne C,9849,3,14,4,11,43,34,9,46
Melbourne V,9849,4,13,5,11,46,40,6,44
Adelaide Utd,9849,5,11,6,11,37,40,-3,39
Brisbane,9849,6,10,5,13,33,42,-9,35
Western Sydn,9849,7,8,9,10,38,47,-9,33
Perth Glory,9849,8,10,2,15,37,50,-13,32
Wellington P,9849,9,5,6,16,31,55,-24,21
CC Mariners,9849,10,4,8,15,28,49,-21,20
Sydney FC,9850,1,21,4,3,67,24,43,67
N'castle Jet,9850,2,15,5,8,57,39,18,50
Melbourne C,9850,3,15,4,10,45,33,12,49
Melbourne V,9850,4,13,5,11,47,41,6,44
Adelaide Utd,9850,5,11,6,11,37,40,-3,39
Brisbane,9850,6,10,5,13,33,42,-9,35
Western Sydn,9850,7,8,9,10,38,47,-9,33
Perth Glory,9850,8,10,2,15,37,50,-13,32
Wellington P,9850,9,5,6,16,31,55,-24,21
CC Mariners,9850,10,4,8,15,28,49,-21,20
Sydney FC,9851,1,21,4,3,68,25,43,67
N'castle Jet,9851,2,15,5,8,58,39,19,50
Melbourne C,9851,3,15,4,10,45,34,11,49
Melbourne V,9851,4,13,5,11,48,42,6,44
Adelaide Utd,9851,5,11,6,11,37,40,-3,39
Brisbane,9851,6,10,5,13,33,42,-9,35
Western Sydn,9851,7,8,9,10,38,47,-9,33
Perth Glory,9851,8,10,2,15,37,50,-13,32
Wellington P,9851,9,5,6,16,31,55,-24,21
CC Mariners,9851,10,4,8,15,28,49,-21,20
Sydney FC,9852,1,21,4,3,68,22,46,67
N'castle Jet,9852,2,15,6,7,58,38,20,51
Melbourne C,9852,3,14,5,10,44,34,10,47
Melbourne V,9852,4,13,5,11,45,42,3,44
Adelaide Utd,9852,5,11,6,11,37,40,-3,39
Brisbane,9852,6,10,5,13,33,42,-9,35
Western Sydn,9852,7,8,9,10,38,47,-9,33
Perth Glory,9852,8,10,2,15,37,50,-13,32
Wellington P,9852,9,5,6,16,31,55,-24,21
CC Mariners,9852,10,4,8,15,28,49,-21,20
Sydney FC,9853,1,21,4,3,68,23,45,67
N'castle Jet,9853,2,16,5,7,59,38,21,53
Melbourne C,9853,3,14,4,11,44,35,9,46
Melbourne V,9853,4,13,5,11,46,42,4,44
Adelaide Utd,9853,5,11,6,11,37,40,-3,39
Brisbane,9853,6,10,5,13,33,42,-9,35
Western Sydn,9853,7,8,9,10,38,47,-9,33
Perth Glory,9853,8,10,2,15,37,50,-13,32
Wellington P,9853,9,5,6,16,31,55,-24,21
CC Mariners,9853,10,4,8,15,28,49,-21,20
Sydney FC,9854,1,21,4,3,66,23,43,67
N'castle Jet,9854,2,16,5,7,60,39,21,53
Melbourne C,9854,3,14,4,11,45,36,9,46
Melbourne V,9854,4,13,5,11,46,40,6,44
Adelaide Utd,9854,5,11,6,11,37,40,-3,39
Brisbane,9854,6,10,5,13,33,42,-9,35
Western Sydn,9854,7,8,9,10,38,47,-9,33
Perth Glory,9854,8,10,2,15,37,50,-13,32
Wellington P,9854,9,5,6,16,31,55,-24,21
CC Mariners,9854,10,4,8,15,28,49,-21,20
Sydney FC,9855,1,20,5,3,65,23,42,65
N'castle Jet,9855,2,15,5,8,58,41,17,50
Melbourne C,9855,3,15,4,10,47,34,13,49
Melbourne V,9855,4,13,6,10,46,39,7,45
Adelaide Utd,9855,5,11,6,11,37,40,-3,39
Brisbane,9855,6,10,5,13,33,42,-9,35
Western Sydn,9855,7,8,9,10,38,47,-9,33
Perth Glory,9855,8,10,2,15,37,50,-13,32
Wellington P,9855,9,5,6,16,31,55,-24,21
CC Mariners,9855,10,4,8,15,28,49,-21,20
Sydney FC,9856,1,21,4,3,66,22,44,67
N'castle Jet,9856,2,16,5,7,58,37,21,53
Melbourne C,9856,3,14,4,11,43,34,9,46
Melbourne V,9856,4,13,5,11,45,40,5,44
Adelaide Utd,9856,5,11,6,11,37,40,-3,39
Brisbane,9856,6,10,5,13,33,42,-9,35
Western Sydn,9856,7,8,9,10,38,47,-9,33
Perth Glory,9856,8,10,2,15,37,50,-13,32
Wellington P,9856,9,5,6,16,31,55,-24,21
CC Mariners,9856,10,4,8,15,28,49,-21,20
Sydney FC,9857,1,20,4,4,66,25,41,64
N'castle Jet,9857,2,15,6,7,58,38,20,51
Melbourne C,9857,3,14,5,10,44,34,10,47
Melbourne V,9857,4,14,5,10,48,40,8,47
Adelaide Utd,9857,5,11,6,11,37,40,-3,39
Brisbane,9857,6,10,5,13,33,42,-9,35
Western Sydn,9857,7,8,9,10,38,47,-9,33
Perth Glory,9857,8,10,2,15,37,50,-13,32
Wellington P,9857,9,5,6,16,31,55,-24,21
CC Mariners,9857,10,4,8,15,28,49,-21,20
Sydney FC,9858,1,20,4,4,64,23,41,64
N'castle Jet,9858,2,15,5,8,57,38,19,50
Melbourne C,9858,3,15,4,10,44,33,11,49
Melbourne V,9858,4,14,5,10,46,38,8,47
Adelaide Utd,9858,5,11,6,11,37,40,-3,39
Brisbane,9858,6,10,5,13,33,42,-9,35
Western Sydn,9858,7,8,9,10,38,47,-9,33
Perth Glory,9858,8,10,2,15,37,50,-13,32
Wellington P,9858,9,5,6,16,31,55,-24,21
CC Mariners,9858,10,4,8,15,28,49,-21,20
Sydney FC,9859,1,21,4,3,66,22,44,67
N'castle Jet,9859,2,16,5,7,60,37,23,53
Melbourne C,9859,3,14,4,11,43,36,7,46
Melbourne V,9859,4,13,5,11,45,40,5,44
Adelaide Utd,9859,5,11,6,11,37,40,-3,39
Brisbane,9859,6,10,5,13,33,42,-9,35
Western Sydn,9859,7,8,9,10,38,47,-9,33
Perth Glory,9859,8,10,2,15,37,50,-13,32
Wellington P,9859,9,5,6,16,31,55,-24,21
CC Mariners,9859,10,4,8,15,28,49,-21,20
Sydney FC,9860,1,21,4,3,67,23,44,67
N'castle Jet,9860,2,16,5,7,60,39,21,53
Melbourne C,9860,3,14,4,11,45,36,9,46
Melbourne V,9860,4,13,5,11,46,41,5,44
Adelaide Utd,9860,5,11,6,11,37,40,-3,39
Brisbane,9860,6,10,5,13,33,42,-9,35
Western Sydn,9860,7,8,9,10,38,47,-9,33
Perth Glory,9860,8,10,2,15,37,50,-13,32
Wellington P,9860,9,5,6,16,31,55,-24,21
CC Mariners,9860,10,4,8,15,28,49,-21,20
Sydney FC,9861,1,21,4,3,66,22,44,67
N'castle Jet,9861,2,15,6,7,59,39,20,51
Melbourne C,9861,3,14,5,10,45,35,10,47
Melbourne V,9861,4,13,5,11,45,40,5,44
Adelaide Utd,9861,5,11,6,11,37,40,-3,39
Brisbane,9861,6,10,5,13,33,42,-9,35
Western Sydn,9861,7,8,9,10,38,47,-9,33
Perth Glory,9861,8,10,2,15,37,50,-13,32
Wellington P,9861,9,5,6,16,31,55,-24,21
CC Mariners,9861,10,4,8,15,28,49,-21,20
Sydney FC,9862,1,20,5,3,64,22,42,65
N'castle Jet,9862,2,15,5,8,58,40,18,50
Melbourne C,9862,3,15,4,10,46,34,12,49
Melbourne V,9862,4,13,6,10,45,38,7,45
Adelaide Utd,9862,5,11,6,11,37,40,-3,39
Brisbane,9862,6,10,5,13,33,42,-9,35
Western Sydn,9862,7,8,9,10,38,47,-9,33
Perth Glory,9862,8,10,2,15,37,50,-13,32
Wellington P,9862,9,5,6,16,31,55,-24,21
CC Mariners,9862,10,4,8,15,28,49,-21,20
Sydney FC,9863,1,21,4,3,65,22,43,67
N'castle Jet,9863,2,15,6,7,57,37,20,51
Melbourne C,9863,3,14,5,10,43,33,10,47
Melbourne V,9863,4,13,5,11,45,39,6,44
Adelaide Utd,9863,5,11,6,11,37,40,-3,39
Brisbane,9863,6,10,5,13,33,42,-9,35
Western Sydn,9863,7,8,9,10,38,47,-9,33
Perth Glory,9863,8,10,2,15,37,50,-13,32
Wellington P,9863,9,5,6,16,31,55,-24,21
CC Mariners,9863,10,4,8,15,28,49,-21,20
Sydney FC,9864,1,20,4,4,65,24,41,64
N'castle Jet,9864,2,16,5,7,59,38,21,53
Melbourne V,9864,3,14,5,10,47,39,8,47
Melbourne C,9864,4,14,4,11,44,35,9,46
Adelaide Utd,9864,5,11,6,11,37,40,-3,39
Brisbane,9864,6,10,5,13,33,42,-9,35
Western Sydn,9864,7,8,9,10,38,47,-9,33
Perth Glory,9864,8,10,2,15,37,50,-13,32
Wellington P,9864,9,5,6,16,31,55,-24,21
CC Mariners,9864,10,4,8,15,28,49,-21,20
Sydney FC,9865,1,21,4,3,67,24,43,67
N'castle Jet,9865,2,16,5,7,60,38,22,53
Melbourne C,9865,3,14,4,11,44,36,8,46
Melbourne V,9865,4,13,5,11,47,41,6,44
Adelaide Utd,9865,5,11,6,11,37,40,-3,39
Brisbane,9865,6,10,5,13,33,42,-9,35
Western Sydn,9865,7,8,9,10,38,47,-9,33
Perth Glory,9865,8,10,2,15,37,50,-13,32
Wellington P,9865,9,5,6,16,31,55,-24,21
CC Mariners,9865,10,4,8,15,28,49,-21,20
Sydney FC,9866,1,20,5,3,65,23,42,65
N'castle Jet,9866,2,16,5,7,59,37,22,53
Melbourne C,9866,3,14,4,11,43,35,8,46
Melbourne V,9866,4,13,6,10,46,39,7,45
Adelaide Utd,9866,5,11,6,11,37,40,-3,39
Brisbane,9866,6,10,5,13,33,42,-9,35
Western Sydn,9866,7,8,9,10,38,47,-9,33
Perth Glory,9866,8,10,2,15,37,50,-13,32
Wellington P,9866,9,5,6,16,31,55,-24,21
CC Mariners,9866,10,4,8,15,28,49,-21,20
Sydney FC,9867,1,21,4,3,67,24,43,67
N'castle Jet,9867,2,15,5,8,59,40,19,50
Melbourne C,9867,3,15,4,10,46,35,11,49
Melbourne V,9867,4,13,5,11,47,41,6,44
Adelaide Utd,9867,5,11,6,11,37,40,-3,39
Brisbane,9867,6,10,5,13,33,42,-9,35
Western Sydn,9867,7,8,9,10,38,47,-9,33
Perth Glory,9867,8,10,2,15,37,50,-13,32
Wellington P,9867,9,5,6,16,31,55,-24,21
CC Mariners,9867,10,4,8,15,28,49,-21,20
Sydney FC,9868,1,21,4,3,67,23,44,67
N'castle Jet,9868,2,15,6,7,58,38,20,51
Melbourne C,9868,3,14,5,10,44,34,10,47
Melbourne V,9868,4,13,5,11,46,41,5,44
Adelaide Utd,9868,5,11,6,11,37,40,-3,39
Brisbane,9868,6,10,5,13,33,42,-9,35
Western Sydn,9868,7,8,9,10,38,47,-9,33
Perth Glory,9868,8,10,2,15,37,50,-13,32
Wellington P,9868,9,5,6,16,31,55,-24,21
CC Mariners,9868,10,4,8,15,28,49,-21,20
Sydney FC,9869,1,21,4,3,65,22,43,67
N'castle Jet,9869,2,15,5,8,57,38,19,50
Melbourne C,9869,3,15,4,10,44,33,11,49
Melbourne V,9869,4,13,5,11,45,39,6,44
Adelaide Utd,9869,5,11,6,11,37,40,-3,39
Brisbane,9869,6,10,5,13,33,42,-9,35
Western Sydn,9869,7,8,9,10,38,47,-9,33
Perth Glory,9869,8,10,2,15,37,50,-13,32
Wellington P,9869,9,5,6,16,31,55,-24,21
CC Mariners,9869,10,4,8,15,28,49,-21,20
Sydney FC,9870,1,20,4,4,65,25,40,64
N'castle Jet,9870,2,15,5,8,58,39,19,50
Melbourne C,9870,3,15,4,10,45,34,11,49
Melbourne V,9870,4,14,5,10,48,39,9,47
Adelaide Utd,9870,5,11,6,11,37,40,-3,39
Brisbane,9870,6,10,5,13,33,42,-9,35
Western Sydn,9870,7,8,9,10,38,47,-9,33
Perth Glory,9870,8,10,2,15,37,50,-13,32
Wellington P,9870,9,5,6,16,31,55,-24,21
CC Mariners,9870,10,4,8,15,28,49,-21,20
Sydney FC,9871,1,21,4,3,68,22,46,67
N'castle Jet,9871,2,16,5,7,58,37,21,53
Melbourne C,9871,3,14,4,11,43,34,9,46
Melbourne V,9871,4,13,5,11,45,42,3,44
Adelaide Utd,9871,5,11,6,11,37,40,-3,39
Brisbane,9871,6,10,5,13,33,42,-9,35
Western Sydn,9871,7,8,9,10,38,47,-9,33
Perth Glory,9871,8,10,2,15,37,50,-13,32
Wellington P,9871,9,5,6,16,31,55,-24,21
CC Mariners,9871,10,4,8,15,28,49,-21,20
Sydney FC,9872,1,21,4,3,66,23,43,67
N'castle Jet,9872,2,15,5,8,57,41,16,50
Melbourne C,9872,3,15,4,10,47,33,14,49
Melbourne V,9872,4,13,5,11,46,40,6,44
Adelaide Utd,9872,5,11,6,11,37,40,-3,39
Brisbane,9872,6,10,5,13,33,42,-9,35
Western Sydn,9872,7,8,9,10,38,47,-9,33
Perth Glory,9872,8,10,2,15,37,50,-13,32
Wellington P,9872,9,5,6,16,31,55,-24,21
CC Mariners,9872,10,4,8,15,28,49,-21,20
Sydney FC,9873,1,20,5,3,64,22,42,65
N'castle Jet,9873,2,15,5,8,57,38,19,50
Melbourne C,9873,3,15,4,10,44,33,11,49
Melbourne V,9873,4,13,6,10,45,38,7,45
Adelaide Utd,9873,5,11,6,11,37,40,-3,39
Brisbane,9873,6,10,5,13,33,42,-9,35
Western Sydn,9873,7,8,9,10,38,47,-9,33
Perth Glory,9873,8,10,2,15,37,50,-13,32
Wellington P,9873,9,5,6,16,31,55,-24,21
CC Mariners,9873,10,4,8,15,28,49,-21,20
Sydney FC,9874,1,20,5,3,65,23,42,65
N'castle Jet,9874,2,16,5,7,59,38,21,53
Melbourne C,9874,3,14,4,11,44,35,9,46
Melbourne V,9874,4,13,6,10,46,39,7,45
Adelaide Utd,9874,5,11,6,11,37,40,-3,39
Brisbane,9874,6,10,5,13,33,42,-9,35
Western Sydn,9874,7,8,9,10,38,47,-9,33
Perth Glory,9874,8,10,2,15,37,50,-13,32
Wellington P,9874,9,5,6,16,31,55,-24,21
CC Mariners,9874,10,4,8,15,28,49,-21,20
Sydney FC,9875,1,21,4,3,68,22,46,67
N'castle Jet,9875,2,16,5,7,60,38,22,53
Melbourne C,9875,3,14,4,11,44,36,8,46
Melbourne V,9875,4,13,5,11,45,42,3,44
Adelaide Utd,9875,5,11,6,11,37,40,-3,39
Brisbane,9875,6,10,5,13,33,42,-9,35
Western Sydn,9875,7,8,9,10,38,47,-9,33
Perth Glory,9875,8,10,2,15,37,50,-13,32
Wellington P,9875,9,5,6,16,31,55,-24,21
CC Mariners,9875,10,4,8,15,28,49,-21,20
Sydney FC,9876,1,21,4,3,69,22,47,67
N'castle Jet,9876,2,15,5,8,57,38,19,50
Melbourne C,9876,3,15,4,10,44,33,11,49
Melbourne V,9876,4,13,5,11,45,43,2,44
Adelaide Utd,9876,5,11,6,11,37,40,-3,39
Brisbane,9876,6,10,5,13,33,42,-9,35
Western Sydn,9876,7,8,9,10,38,47,-9,33
Perth Glory,9876,8,10,2,15,37,50,-13,32
Wellington P,9876,9,5,6,16,31,55,-24,21
CC Mariners,9876,10,4,8,15,28,49,-21,20
Sydney FC,9877,1,20,5,3,66,24,42,65
N'castle Jet,9877,2,16,5,7,59,37,22,53
Melbourne C,9877,3,14,4,11,43,35,8,46
Melbourne V,9877,4,13,6,10,47,40,7,45
Adelaide Utd,9877,5,11,6,11,37,40,-3,39
Brisbane,9877,6,10,5,13,33,42,-9,35
Western Sydn,9877,7,8,9,10,38,47,-9,33
Perth Glory,9877,8,10,2,15,37,50,-13,32
Wellington P,9877,9,5,6,16,31,55,-24,21
CC Mariners,9877,10,4,8,15,28,49,-21,20
Sydney FC,9878,1,21,4,3,67,22,45,67
N'castle Jet,9878,2,16,5,7,59,38,21,53
Melbourne C,9878,3,14,4,11,44,35,9,46
Melbourne V,9878,4,13,5,11,45,41,4,44
Adelaide Utd,9878,5,11,6,11,37,40,-3,39
Brisbane,9878,6,10,5,13,33,42,-9,35
Western Sydn,9878,7,8,9,10,38,47,-9,33
Perth Glory,9878,8,10,2,15,37,50,-13,32
Wellington P,9878,9,5,6,16,31,55,-24,21
CC Mariners,9878,10,4,8,15,28,49,-21,20
Sydney FC,9879,1,21,4,3,67,24,43,67
N'castle Jet,9879,2,16,5,7,60,38,22,53
Melbourne C,9879,3,14,4,11,44,36,8,46
Melbourne V,9879,4,13,5,11,47,41,6,44
Adelaide Utd,9879,5,11,6,11,37,40,-3,39
Brisbane,9879,6,10,5,13,33,42,-9,35
Western Sydn,9879,7,8,9,10,38,47,-9,33
Perth Glory,9879,8,10,2,15,37,50,-13,32
Wellington P,9879,9,5,6,16,31,55,-24,21
CC Mariners,9879,10,4,8,15,28,49,-21,20
Sydney FC,9880,1,20,5,3,65,23,42,65
N'castle Jet,9880,2,15,5,8,57,41,16,50
Melbourne C,9880,3,15,4,10,47,33,14,49
Melbourne V,9880,4,13,6,10,46,39,7,45
Adelaide Utd,9880,5,11,6,11,37,40,-3,39
Brisbane,9880,6,10,5,13,33,42,-9,35
Western Sydn,9880,7,8,9,10,38,47,-9,33
Perth Glory,9880,8,10,2,15,37,50,-13,32
Wellington P,9880,9,5,6,16,31,55,-24,21
CC Mariners,9880,10,4,8,15,28,49,-21,20
Sydney FC,9881,1,21,4,3,67,23,44,67
N'castle Jet,9881,2,16,5,7,60,39,21,53
Melbourne C,9881,3,14,4,11,45,36,9,46
Melbourne V,9881,4,13,5,11,46,41,5,44
Adelaide Utd,9881,5,11,6,11,37,40,-3,39
Brisbane,9881,6,10,5,13,33,42,-9,35
Western Sydn,9881,7,8,9,10,38,47,-9,33
Perth Glory,9881,8,10,2,15,37,50,-13,32
Wellington P,9881,9,5,6,16,31,55,-24,21
CC Mariners,9881,10,4,8,15,28,49,-21,20
Sydney FC,9882,1,20,4,4,64,23,41,64
N'castle Jet,9882,2,15,6,7,57,37,20,51
Melbourne C,9882,3,14,5,10,43,33,10,47
Melbourne V,9882,4,14,5,10,46,38,8,47
Adelaide Utd,9882,5,11,6,11,37,40,-3,39
Brisbane,9882,6,10,5,13,33,42,-9,35
Western Sydn,9882,7,8,9,10,38,47,-9,33
Perth Glory,9882,8,10,2,15,37,50,-13,32
Wellington P,9882,9,5,6,16,31,55,-24,21
CC Mariners,9882,10,4,8,15,28,49,-21,20
Sydney FC,9883,1,20,4,4,64,24,40,64
N'castle Jet,9883,2,16,5,7,60,38,22,53
Melbourne V,9883,3,14,5,10,47,38,9,47
Melbourne C,9883,4,14,4,11,44,36,8,46
Adelaide Utd,9883,5,11,6,11,37,40,-3,39
Brisbane,9883,6,10,5,13,33,42,-9,35
Western Sydn,9883,7,8,9,10,38,47,-9,33
Perth Glory,9883,8,10,2,15,37,50,-13,32
Wellington P,9883,9,5,6,16,31,55,-24,21
CC Mariners,9883,10,4,8,15,28,49,-21,20
Sydney FC,9884,1,21,4,3,66,22,44,67
N'castle Jet,9884,2,15,5,8,58,39,19,50
Melbourne C,9884,3,15,4,10,45,34,11,49
Melbourne V,9884,4,13,5,11,45,40,5,44
Adelaide Utd,9884,5,11,6,11,37,40,-3,39
Brisbane,9884,6,10,5,13,33,42,-9,35
Western Sydn,9884,7,8,9,10,38,47,-9,33
Perth Glory,9884,8,10,2,15,37,50,-13,32
Wellington P,9884,9,5,6,16,31,55,-24,21
CC Mariners,9884,10,4,8,15,28,49,-21,20
Sydney FC,9885,1,20,4,4,65,24,41,64
N'castle Jet,9885,2,15,6,7,59,39,20,51
Melbourne C,9885,3,14,5,10,45,35,10,47
Melbourne V,9885,4,14,5,10,47,39,8,47
Adelaide Utd,9885,5,11,6,11,37,40,-3,39
Brisbane,9885,6,10,5,13,33,42,-9,35
Western Sydn,9885,7,8,9,10,38,47,-9,33
Perth Glory,9885,8,10,2,15,37,50,-13,32
Wellington P,9885,9,5,6,16,31,55,-24,21
CC Mariners,9885,10,4,8,15,28,49,-21,20
Sydney FC,9886,1,20,4,4,64,25,39,64
N'castle Jet,9886,2,16,5,7,60,37,23,53
Melbourne V,9886,3,14,5,10,48,38,10,47
Melbourne C,9886,4,14,4,11,43,36,7,46
Adelaide Utd,9886,5,11,6,11,37,40,-3,39
Brisbane,9886,6,10,5,13,33,42,-9,35
Western Sydn,9886,7,8,9,10,38,47,-9,33
Perth Glory,9886,8,10,2,15,37,50,-13,32
Wellington P,9886,9,5,6,16,31,55,-24,21
CC Mariners,9886,10,4,8,15,28,49,-21,20
Sydney FC,9887,1,20,5,3,65,23,42,65
N'castle Jet,9887,2,15,6,7,58,38,20,51
Melbourne C,9887,3,14,5,10,44,34,10,47
Melbourne V,9887,4,13,6,10,46,39,7,45
Adelaide Utd,9887,5,11,6,11,37,40,-3,39
Brisbane,9887,6,10,5,13,33,42,-9,35
Western Sydn,9887,7,8,9,10,38,47,-9,33
Perth Glory,9887,8,10,2,15,37,50,-13,32
Wellington P,9887,9,5,6,16,31,55,-24,21
CC Mariners,9887,10,4,8,15,28,49,-21,20
Sydney FC,9888,1,20,4,4,65,24,41,64
N'castle Jet,9888,2,15,6,7,59,39,20,51
Melbourne C,9888,3,14,5,10,45,35,10,47
Melbourne V,9888,4,14,5,10,47,39,8,47
Adelaide Utd,9888,5,11,6,11,37,40,-3,39
Brisbane,9888,6,10,5,13,33,42,-9,35
Western Sydn,9888,7,8,9,10,38,47,-9,33
Perth Glory,9888,8,10,2,15,37,50,-13,32
Wellington P,9888,9,5,6,16,31,55,-24,21
CC Mariners,9888,10,4,8,15,28,49,-21,20
Sydney FC,9889,1,20,5,3,65,23,42,65
N'castle Jet,9889,2,16,5,7,60,38,22,53
Melbourne C,9889,3,14,4,11,44,36,8,46
Melbourne V,9889,4,13,6,10,46,39,7,45
Adelaide Utd,9889,5,11,6,11,37,40,-3,39
Brisbane,9889,6,10,5,13,33,42,-9,35
Western Sydn,9889,7,8,9,10,38,47,-9,33
Perth Glory,9889,8,10,2,15,37,50,-13,32
Wellington P,9889,9,5,6,16,31,55,-24,21
CC Mariners,9889,10,4,8,15,28,49,-21,20
Sydney FC,9890,1,20,4,4,65,24,41,64
N'castle Jet,9890,2,16,5,7,58,37,21,53
Melbourne V,9890,3,14,5,10,47,39,8,47
Melbourne C,9890,4,14,4,11,43,34,9,46
Adelaide Utd,9890,5,11,6,11,37,40,-3,39
Brisbane,9890,6,10,5,13,33,42,-9,35
Western Sydn,9890,7,8,9,10,38,47,-9,33
Perth Glory,9890,8,10,2,15,37,50,-13,32
Wellington P,9890,9,5,6,16,31,55,-24,21
CC Mariners,9890,10,4,8,15,28,49,-21,20
Sydney FC,9891,1,20,4,4,65,24,41,64
N'castle Jet,9891,2,15,5,8,58,39,19,50
Melbourne C,9891,3,15,4,10,45,34,11,49
Melbourne V,9891,4,14,5,10,47,39,8,47
Adelaide Utd,9891,5,11,6,11,37,40,-3,39
Brisbane,9891,6,10,5,13,33,42,-9,35
Western Sydn,9891,7,8,9,10,38,47,-9,33
Perth Glory,9891,8,10,2,15,37,50,-13,32
Wellington P,9891,9,5,6,16,31,55,-24,21
CC Mariners,9891,10,4,8,15,28,49,-21,20
Sydney FC,9892,1,21,4,3,66,23,43,67
N'castle Jet,9892,2,16,5,7,62,39,23,53
Melbourne C,9892,3,14,4,11,45,38,7,46
Melbourne V,9892,4,13,5,11,46,40,6,44
Adelaide Utd,9892,5,11,6,11,37,40,-3,39
Brisbane,9892,6,10,5,13,33,42,-9,35
Western Sydn,9892,7,8,9,10,38,47,-9,33
Perth Glory,9892,8,10,2,15,37,50,-13,32
Wellington P,9892,9,5,6,16,31,55,-24,21
CC Mariners,9892,10,4,8,15,28,49,-21,20
Sydney FC,9893,1,20,4,4,64,23,41,64
N'castle Jet,9893,2,16,5,7,59,38,21,53
Melbourne V,9893,3,14,5,10,46,38,8,47
Melbourne C,9893,4,14,4,11,44,35,9,46
Adelaide Utd,9893,5,11,6,11,37,40,-3,39
Brisbane,9893,6,10,5,13,33,42,-9,35
Western Sydn,9893,7,8,9,10,38,47,-9,33
Perth Glory,9893,8,10,2,15,37,50,-13,32
Wellington P,9893,9,5,6,16,31,55,-24,21
CC Mariners,9893,10,4,8,15,28,49,-21,20
Sydney FC,9894,1,21,4,3,67,22,45,67
N'castle Jet,9894,2,15,5,8,57,38,19,50
Melbourne C,9894,3,15,4,10,44,33,11,49
Melbourne V,9894,4,13,5,11,45,41,4,44
Adelaide Utd,9894,5,11,6,11,37,40,-3,39
Brisbane,9894,6,10,5,13,33,42,-9,35
Western Sydn,9894,7,8,9,10,38,47,-9,33
Perth Glory,9894,8,10,2,15,37,50,-13,32
Wellington P,9894,9,5,6,16,31,55,-24,21
CC Mariners,9894,10,4,8,15,28,49,-21,20
Sydney FC,9895,1,20,4,4,64,25,39,64
N'castle Jet,9895,2,16,5,7,60,38,22,53
Melbourne V,9895,3,14,5,10,48,38,10,47
Melbourne C,9895,4,14,4,11,44,36,8,46
Adelaide Utd,9895,5,11,6,11,37,40,-3,39
Brisbane,9895,6,10,5,13,33,42,-9,35
Western Sydn,9895,7,8,9,10,38,47,-9,33
Perth Glory,9895,8,10,2,15,37,50,-13,32
Wellington P,9895,9,5,6,16,31,55,-24,21
CC Mariners,9895,10,4,8,15,28,49,-21,20
Sydney FC,9896,1,21,4,3,66,23,43,67
N'castle Jet,9896,2,15,5,8,59,40,19,50
Melbourne C,9896,3,15,4,10,46,35,11,49
Melbourne V,9896,4,13,5,11,46,40,6,44
Adelaide Utd,9896,5,11,6,11,37,40,-3,39
Brisbane,9896,6,10,5,13,33,42,-9,35
Western Sydn,9896,7,8,9,10,38,47,-9,33
Perth Glory,9896,8,10,2,15,37,50,-13,32
Wellington P,9896,9,5,6,16,31,55,-24,21
CC Mariners,9896,10,4,8,15,28,49,-21,20
Sydney FC,9897,1,20,5,3,64,22,42,65
N'castle Jet,9897,2,15,5,8,57,38,19,50
Melbourne C,9897,3,15,4,10,44,33,11,49
Melbourne V,9897,4,13,6,10,45,38,7,45
Adelaide Utd,9897,5,11,6,11,37,40,-3,39
Brisbane,9897,6,10,5,13,33,42,-9,35
Western Sydn,9897,7,8,9,10,38,47,-9,33
Perth Glory,9897,8,10,2,15,37,50,-13,32
Wellington P,9897,9,5,6,16,31,55,-24,21
CC Mariners,9897,10,4,8,15,28,49,-21,20
Sydney FC,9898,1,21,4,3,65,22,43,67
N'castle Jet,9898,2,16,5,7,62,37,25,53
Melbourne C,9898,3,14,4,11,43,38,5,46
Melbourne V,9898,4,13,5,11,45,39,6,44
Adelaide Utd,9898,5,11,6,11,37,40,-3,39
Brisbane,9898,6,10,5,13,33,42,-9,35
Western Sydn,9898,7,8,9,10,38,47,-9,33
Perth Glory,9898,8,10,2,15,37,50,-13,32
Wellington P,9898,9,5,6,16,31,55,-24,21
CC Mariners,9898,10,4,8,15,28,49,-21,20
Sydney FC,9899,1,21,4,3,67,22,45,67
N'castle Jet,9899,2,16,5,7,59,38,21,53
Melbourne C,9899,3,14,4,11,44,35,9,46
Melbourne V,9899,4,13,5,11,45,41,4,44
Adelaide Utd,9899,5,11,6,11,37,40,-3,39
Brisbane,9899,6,10,5,13,33,42,-9,35
Western Sydn,9899,7,8,9,10,38,47,-9,33
Perth Glory,9899,8,10,2,15,37,50,-13,32
Wellington P,9899,9,5,6,16,31,55,-24,21
CC Mariners,9899,10,4,8,15,28,49,-21,20
Sydney FC,9900,1,20,4,4,65,24,41,64
N'castle Jet,9900,2,15,6,7,59,39,20,51
Melbourne C,9900,3,14,5,10,45,35,10,47
Melbourne V,9900,4,14,5,10,47,39,8,47
Adelaide Utd,9900,5,11,6,11,37,40,-3,39
Brisbane,9900,6,10,5,13,33,42,-9,35
Western Sydn,9900,7,8,9,10,38,47,-9,33
Perth Glory,9900,8,10,2,15,37,50,-13,32
Wellington P,9900,9,5,6,16,31,55,-24,21
CC Mariners,9900,10,4,8,15,28,49,-21,20
Sydney FC,9901,1,21,4,3,65,22,43,67
N'castle Jet,9901,2,16,5,7,59,38,21,53
Melbourne C,9901,3,14,4,11,44,35,9,46
Melbourne V,9901,4,13,5,11,45,39,6,44
Adelaide Utd,9901,5,11,6,11,37,40,-3,39
Brisbane,9901,6,10,5,13,33,42,-9,35
Western Sydn,9901,7,8,9,10,38,47,-9,33
Perth Glory,9901,8,10,2,15,37,50,-13,32
Wellington P,9901,9,5,6,16,31,55,-24,21
CC Mariners,9901,10,4,8,15,28,49,-21,20
Sydney FC,9902,1,21,4,3,65,22,43,67
N'castle Jet,9902,2,16,5,7,61,39,22,53
Melbourne C,9902,3,14,4,11,45,37,8,46
Melbourne V,9902,4,13,5,11,45,39,6,44
Adelaide Utd,9902,5,11,6,11,37,40,-3,39
Brisbane,9902,6,10,5,13,33,42,-9,35
Western Sydn,9902,7,8,9,10,38,47,-9,33
Perth Glory,9902,8,10,2,15,37,50,-13,32
Wellington P,9902,9,5,6,16,31,55,-24,21
CC Mariners,9902,10,4,8,15,28,49,-21,20
Sydney FC,9903,1,20,5,3,66,24,42,65
N'castle Jet,9903,2,15,6,7,57,37,20,51
Melbourne C,9903,3,14,5,10,43,33,10,47
Melbourne V,9903,4,13,6,10,47,40,7,45
Adelaide Utd,9903,5,11,6,11,37,40,-3,39
Brisbane,9903,6,10,5,13,33,42,-9,35
Western Sydn,9903,7,8,9,10,38,47,-9,33
Perth Glory,9903,8,10,2,15,37,50,-13,32
Wellington P,9903,9,5,6,16,31,55,-24,21
CC Mariners,9903,10,4,8,15,28,49,-21,20
Sydney FC,9904,1,21,4,3,65,22,43,67
N'castle Jet,9904,2,15,6,7,59,39,20,51
Melbourne C,9904,3,14,5,10,45,35,10,47
Melbourne V,9904,4,13,5,11,45,39,6,44
Adelaide Utd,9904,5,11,6,11,37,40,-3,39
Brisbane,9904,6,10,5,13,33,42,-9,35
Western Sydn,9904,7,8,9,10,38,47,-9,33
Perth Glory,9904,8,10,2,15,37,50,-13,32
Wellington P,9904,9,5,6,16,31,55,-24,21
CC Mariners,9904,10,4,8,15,28,49,-21,20
Sydney FC,9905,1,21,4,3,66,23,43,67
N'castle Jet,9905,2,16,5,7,59,38,21,53
Melbourne C,9905,3,14,4,11,44,35,9,46
Melbourne V,9905,4,13,5,11,46,40,6,44
Adelaide Utd,9905,5,11,6,11,37,40,-3,39
Brisbane,9905,6,10,5,13,33,42,-9,35
Western Sydn,9905,7,8,9,10,38,47,-9,33
Perth Glory,9905,8,10,2,15,37,50,-13,32
Wellington P,9905,9,5,6,16,31,55,-24,21
CC Mariners,9905,10,4,8,15,28,49,-21,20
Sydney FC,9906,1,20,5,3,67,25,42,65
N'castle Jet,9906,2,16,5,7,59,38,21,53
Melbourne C,9906,3,14,4,11,44,35,9,46
Melbourne V,9906,4,13,6,10,48,41,7,45
Adelaide Utd,9906,5,11,6,11,37,40,-3,39
Brisbane,9906,6,10,5,13,33,42,-9,35
Western Sydn,9906,7,8,9,10,38,47,-9,33
Perth Glory,9906,8,10,2,15,37,50,-13,32
Wellington P,9906,9,5,6,16,31,55,-24,21
CC Mariners,9906,10,4,8,15,28,49,-21,20
Sydney FC,9907,1,21,4,3,67,22,45,67
N'castle Jet,9907,2,15,6,7,59,39,20,51
Melbourne C,9907,3,14,5,10,45,35,10,47
Melbourne V,9907,4,13,5,11,45,41,4,44
Adelaide Utd,9907,5,11,6,11,37,40,-3,39
Brisbane,9907,6,10,5,13,33,42,-9,35
Western Sydn,9907,7,8,9,10,38,47,-9,33
Perth Glory,9907,8,10,2,15,37,50,-13,32
Wellington P,9907,9,5,6,16,31,55,-24,21
CC Mariners,9907,10,4,8,15,28,49,-21,20
Sydney FC,9908,1,20,4,4,65,25,40,64
N'castle Jet,9908,2,15,6,7,57,37,20,51
Melbourne C,9908,3,14,5,10,43,33,10,47
Melbourne V,9908,4,14,5,10,48,39,9,47
Adelaide Utd,9908,5,11,6,11,37,40,-3,39
Brisbane,9908,6,10,5,13,33,42,-9,35
Western Sydn,9908,7,8,9,10,38,47,-9,33
Perth Glory,9908,8,10,2,15,37,50,-13,32
Wellington P,9908,9,5,6,16,31,55,-24,21
CC Mariners,9908,10,4,8,15,28,49,-21,20
Sydney FC,9909,1,21,4,3,67,22,45,67
N'castle Jet,9909,2,15,6,7,58,38,20,51
Melbourne C,9909,3,14,5,10,44,34,10,47
Melbourne V,9909,4,13,5,11,45,41,4,44
Adelaide Utd,9909,5,11,6,11,37,40,-3,39
Brisbane,9909,6,10,5,13,33,42,-9,35
Western Sydn,9909,7,8,9,10,38,47,-9,33
Perth Glory,9909,8,10,2,15,37,50,-13,32
Wellington P,9909,9,5,6,16,31,55,-24,21
CC Mariners,9909,10,4,8,15,28,49,-21,20
Sydney FC,9910,1,21,4,3,66,23,43,67
N'castle Jet,9910,2,15,6,7,58,38,20,51
Melbourne C,9910,3,14,5,10,44,34,10,47
Melbourne V,9910,4,13,5,11,46,40,6,44
Adelaide Utd,9910,5,11,6,11,37,40,-3,39
Brisbane,9910,6,10,5,13,33,42,-9,35
Western Sydn,9910,7,8,9,10,38,47,-9,33
Perth Glory,9910,8,10,2,15,37,50,-13,32
Wellington P,9910,9,5,6,16,31,55,-24,21
CC Mariners,9910,10,4,8,15,28,49,-21,20
Sydney FC,9911,1,20,5,3,65,23,42,65
N'castle Jet,9911,2,15,5,8,57,38,19,50
Melbourne C,9911,3,15,4,10,44,33,11,49
Melbourne V,9911,4,13,6,10,46,39,7,45
Adelaide Utd,9911,5,11,6,11,37,40,-3,39
Brisbane,9911,6,10,5,13,33,42,-9,35
Western Sydn,9911,7,8,9,10,38,47,-9,33
Perth Glory,9911,8,10,2,15,37,50,-13,32
Wellington P,9911,9,5,6,16,31,55,-24,21
CC Mariners,9911,10,4,8,15,28,49,-21,20
Sydney FC,9912,1,21,4,3,66,22,44,67
N'castle Jet,9912,2,16,5,7,61,39,22,53
Melbourne C,9912,3,14,4,11,45,37,8,46
Melbourne V,9912,4,13,5,11,45,40,5,44
Adelaide Utd,9912,5,11,6,11,37,40,-3,39
Brisbane,9912,6,10,5,13,33,42,-9,35
Western Sydn,9912,7,8,9,10,38,47,-9,33
Perth Glory,9912,8,10,2,15,37,50,-13,32
Wellington P,9912,9,5,6,16,31,55,-24,21
CC Mariners,9912,10,4,8,15,28,49,-21,20
Sydney FC,9913,1,21,4,3,65,22,43,67
N'castle Jet,9913,2,15,5,8,60,41,19,50
Melbourne C,9913,3,15,4,10,47,36,11,49
Melbourne V,9913,4,13,5,11,45,39,6,44
Adelaide Utd,9913,5,11,6,11,37,40,-3,39
Brisbane,9913,6,10,5,13,33,42,-9,35
Western Sydn,9913,7,8,9,10,38,47,-9,33
Perth Glory,9913,8,10,2,15,37,50,-13,32
Wellington P,9913,9,5,6,16,31,55,-24,21
CC Mariners,9913,10,4,8,15,28,49,-21,20
Sydney FC,9914,1,20,5,3,64,22,42,65
N'castle Jet,9914,2,16,5,7,61,38,23,53
Melbourne C,9914,3,14,4,11,44,37,7,46
Melbourne V,9914,4,13,6,10,45,38,7,45
Adelaide Utd,9914,5,11,6,11,37,40,-3,39
Brisbane,9914,6,10,5,13,33,42,-9,35
Western Sydn,9914,7,8,9,10,38,47,-9,33
Perth Glory,9914,8,10,2,15,37,50,-13,32
Wellington P,9914,9,5,6,16,31,55,-24,21
CC Mariners,9914,10,4,8,15,28,49,-21,20
Sydney FC,9915,1,20,5,3,66,24,42,65
N'castle Jet,9915,2,16,5,7,59,38,21,53
Melbourne C,9915,3,14,4,11,44,35,9,46
Melbourne V,9915,4,13,6,10,47,40,7,45
Adelaide Utd,9915,5,11,6,11,37,40,-3,39
Brisbane,9915,6,10,5,13,33,42,-9,35
Western Sydn,9915,7,8,9,10,38,47,-9,33
Perth Glory,9915,8,10,2,15,37,50,-13,32
Wellington P,9915,9,5,6,16,31,55,-24,21
CC Mariners,9915,10,4,8,15,28,49,-21,20
Sydney FC,9916,1,20,5,3,66,24,42,65
N'castle Jet,9916,2,16,5,7,59,37,22,53
Melbourne C,9916,3,14,4,11,43,35,8,46
Melbourne V,9916,4,13,6,10,47,40,7,45
Adelaide Utd,9916,5,11,6,11,37,40,-3,39
Brisbane,9916,6,10,5,13,33,42,-9,35
Western Sydn,9916,7,8,9,10,38,47,-9,33
Perth Glory,9916,8,10,2,15,37,50,-13,32
Wellington P,9916,9,5,6,16,31,55,-24,21
CC Mariners,9916,10,4,8,15,28,49,-21,20
Sydney FC,9917,1,20,5,3,65,23,42,65
N'castle Jet,9917,2,16,5,7,59,38,21,53
Melbourne C,9917,3,14,4,11,44,35,9,46
Melbourne V,9917,4,13,6,10,46,39,7,45
Adelaide Utd,9917,5,11,6,11,37,40,-3,39
Brisbane,9917,6,10,5,13,33,42,-9,35
Western Sydn,9917,7,8,9,10,38,47,-9,33
Perth Glory,9917,8,10,2,15,37,50,-13,32
Wellington P,9917,9,5,6,16,31,55,-24,21
CC Mariners,9917,10,4,8,15,28,49,-21,20
Sydney FC,9918,1,20,4,4,65,25,40,64
N'castle Jet,9918,2,15,5,8,57,38,19,50
Melbourne C,9918,3,15,4,10,44,33,11,49
Melbourne V,9918,4,14,5,10,48,39,9,47
Adelaide Utd,9918,5,11,6,11,37,40,-3,39
Brisbane,9918,6,10,5,13,33,42,-9,35
Western Sydn,9918,7,8,9,10,38,47,-9,33
Perth Glory,9918,8,10,2,15,37,50,-13,32
Wellington P,9918,9,5,6,16,31,55,-24,21
CC Mariners,9918,10,4,8,15,28,49,-21,20
Sydney FC,9919,1,21,4,3,68,23,45,67
N'castle Jet,9919,2,15,6,7,60,40,20,51
Melbourne C,9919,3,14,5,10,46,36,10,47
Melbourne V,9919,4,13,5,11,46,42,4,44
Adelaide Utd,9919,5,11,6,11,37,40,-3,39
Brisbane,9919,6,10,5,13,33,42,-9,35
Western Sydn,9919,7,8,9,10,38,47,-9,33
Perth Glory,9919,8,10,2,15,37,50,-13,32
Wellington P,9919,9,5,6,16,31,55,-24,21
CC Mariners,9919,10,4,8,15,28,49,-21,20
Sydney FC,9920,1,21,4,3,69,23,46,67
N'castle Jet,9920,2,15,6,7,58,38,20,51
Melbourne C,9920,3,14,5,10,44,34,10,47
Melbourne V,9920,4,13,5,11,46,43,3,44
Adelaide Utd,9920,5,11,6,11,37,40,-3,39
Brisbane,9920,6,10,5,13,33,42,-9,35
Western Sydn,9920,7,8,9,10,38,47,-9,33
Perth Glory,9920,8,10,2,15,37,50,-13,32
Wellington P,9920,9,5,6,16,31,55,-24,21
CC Mariners,9920,10,4,8,15,28,49,-21,20
Sydney FC,9921,1,20,5,3,66,24,42,65
N'castle Jet,9921,2,15,6,7,58,38,20,51
Melbourne C,9921,3,14,5,10,44,34,10,47
Melbourne V,9921,4,13,6,10,47,40,7,45
Adelaide Utd,9921,5,11,6,11,37,40,-3,39
Brisbane,9921,6,10,5,13,33,42,-9,35
Western Sydn,9921,7,8,9,10,38,47,-9,33
Perth Glory,9921,8,10,2,15,37,50,-13,32
Wellington P,9921,9,5,6,16,31,55,-24,21
CC Mariners,9921,10,4,8,15,28,49,-21,20
Sydney FC,9922,1,21,4,3,66,22,44,67
N'castle Jet,9922,2,16,5,7,58,37,21,53
Melbourne C,9922,3,14,4,11,43,34,9,46
Melbourne V,9922,4,13,5,11,45,40,5,44
Adelaide Utd,9922,5,11,6,11,37,40,-3,39
Brisbane,9922,6,10,5,13,33,42,-9,35
Western Sydn,9922,7,8,9,10,38,47,-9,33
Perth Glory,9922,8,10,2,15,37,50,-13,32
Wellington P,9922,9,5,6,16,31,55,-24,21
CC Mariners,9922,10,4,8,15,28,49,-21,20
Sydney FC,9923,1,21,4,3,68,25,43,67
N'castle Jet,9923,2,15,6,7,58,38,20,51
Melbourne C,9923,3,14,5,10,44,34,10,47
Melbourne V,9923,4,13,5,11,48,42,6,44
Adelaide Utd,9923,5,11,6,11,37,40,-3,39
Brisbane,9923,6,10,5,13,33,42,-9,35
Western Sydn,9923,7,8,9,10,38,47,-9,33
Perth Glory,9923,8,10,2,15,37,50,-13,32
Wellington P,9923,9,5,6,16,31,55,-24,21
CC Mariners,9923,10,4,8,15,28,49,-21,20
Sydney FC,9924,1,20,5,3,65,23,42,65
N'castle Jet,9924,2,15,6,7,58,38,20,51
Melbourne C,9924,3,14,5,10,44,34,10,47
Melbourne V,9924,4,13,6,10,46,39,7,45
Adelaide Utd,9924,5,11,6,11,37,40,-3,39
Brisbane,9924,6,10,5,13,33,42,-9,35
Western Sydn,9924,7,8,9,10,38,47,-9,33
Perth Glory,9924,8,10,2,15,37,50,-13,32
Wellington P,9924,9,5,6,16,31,55,-24,21
CC Mariners,9924,10,4,8,15,28,49,-21,20
Sydney FC,9925,1,20,4,4,64,24,40,64
N'castle Jet,9925,2,16,5,7,61,39,22,53
Melbourne V,9925,3,14,5,10,47,38,9,47
Melbourne C,9925,4,14,4,11,45,37,8,46
Adelaide Utd,9925,5,11,6,11,37,40,-3,39
Brisbane,9925,6,10,5,13,33,42,-9,35
Western Sydn,9925,7,8,9,10,38,47,-9,33
Perth Glory,9925,8,10,2,15,37,50,-13,32
Wellington P,9925,9,5,6,16,31,55,-24,21
CC Mariners,9925,10,4,8,15,28,49,-21,20
Sydney FC,9926,1,20,5,3,65,23,42,65
N'castle Jet,9926,2,16,5,7,58,37,21,53
Melbourne C,9926,3,14,4,11,43,34,9,46
Melbourne V,9926,4,13,6,10,46,39,7,45
Adelaide Utd,9926,5,11,6,11,37,40,-3,39
Brisbane,9926,6,10,5,13,33,42,-9,35
Western Sydn,9926,7,8,9,10,38,47,-9,33
Perth Glory,9926,8,10,2,15,37,50,-13,32
Wellington P,9926,9,5,6,16,31,55,-24,21
CC Mariners,9926,10,4,8,15,28,49,-21,20
Sydney FC,9927,1,21,4,3,65,22,43,67
N'castle Jet,9927,2,16,5,7,59,37,22,53
Melbourne C,9927,3,14,4,11,43,35,8,46
Melbourne V,9927,4,13,5,11,45,39,6,44
Adelaide Utd,9927,5,11,6,11,37,40,-3,39
Brisbane,9927,6,10,5,13,33,42,-9,35
Western Sydn,9927,7,8,9,10,38,47,-9,33
Perth Glory,9927,8,10,2,15,37,50,-13,32
Wellington P,9927,9,5,6,16,31,55,-24,21
CC Mariners,9927,10,4,8,15,28,49,-21,20
Sydney FC,9928,1,21,4,3,69,24,45,67
N'castle Jet,9928,2,16,5,7,59,38,21,53
Melbourne C,9928,3,14,4,11,44,35,9,46
Melbourne V,9928,4,13,5,11,47,43,4,44
Adelaide Utd,9928,5,11,6,11,37,40,-3,39
Brisbane,9928,6,10,5,13,33,42,-9,35
Western Sydn,9928,7,8,9,10,38,47,-9,33
Perth Glory,9928,8,10,2,15,37,50,-13,32
Wellington P,9928,9,5,6,16,31,55,-24,21
CC Mariners,9928,10,4,8,15,28,49,-21,20
Sydney FC,9929,1,20,4,4,64,24,40,64
N'castle Jet,9929,2,15,5,8,58,39,19,50
Melbourne C,9929,3,15,4,10,45,34,11,49
Melbourne V,9929,4,14,5,10,47,38,9,47
Adelaide Utd,9929,5,11,6,11,37,40,-3,39
Brisbane,9929,6,10,5,13,33,42,-9,35
Western Sydn,9929,7,8,9,10,38,47,-9,33
Perth Glory,9929,8,10,2,15,37,50,-13,32
Wellington P,9929,9,5,6,16,31,55,-24,21
CC Mariners,9929,10,4,8,15,28,49,-21,20
Sydney FC,9930,1,20,5,3,66,24,42,65
N'castle Jet,9930,2,16,5,7,59,37,22,53
Melbourne C,9930,3,14,4,11,43,35,8,46
Melbourne V,9930,4,13,6,10,47,40,7,45
Adelaide Utd,9930,5,11,6,11,37,40,-3,39
Brisbane,9930,6,10,5,13,33,42,-9,35
Western Sydn,9930,7,8,9,10,38,47,-9,33
Perth Glory,9930,8,10,2,15,37,50,-13,32
Wellington P,9930,9,5,6,16,31,55,-24,21
CC Mariners,9930,10,4,8,15,28,49,-21,20
Sydney FC,9931,1,21,4,3,66,22,44,67
N'castle Jet,9931,2,15,5,8,59,40,19,50
Melbourne C,9931,3,15,4,10,46,35,11,49
Melbourne V,9931,4,13,5,11,45,40,5,44
Adelaide Utd,9931,5,11,6,11,37,40,-3,39
Brisbane,9931,6,10,5,13,33,42,-9,35
Western Sydn,9931,7,8,9,10,38,47,-9,33
Perth Glory,9931,8,10,2,15,37,50,-13,32
Wellington P,9931,9,5,6,16,31,55,-24,21
CC Mariners,9931,10,4,8,15,28,49,-21,20
Sydney FC,9932,1,20,4,4,64,23,41,64
N'castle Jet,9932,2,15,6,7,58,38,20,51
Melbourne C,9932,3,14,5,10,44,34,10,47
Melbourne V,9932,4,14,5,10,46,38,8,47
Adelaide Utd,9932,5,11,6,11,37,40,-3,39
Brisbane,9932,6,10,5,13,33,42,-9,35
Western Sydn,9932,7,8,9,10,38,47,-9,33
Perth Glory,9932,8,10,2,15,37,50,-13,32
Wellington P,9932,9,5,6,16,31,55,-24,21
CC Mariners,9932,10,4,8,15,28,49,-21,20
Sydney FC,9933,1,21,4,3,67,23,44,67
N'castle Jet,9933,2,16,5,7,60,37,23,53
Melbourne C,9933,3,14,4,11,43,36,7,46
Melbourne V,9933,4,13,5,11,46,41,5,44
Adelaide Utd,9933,5,11,6,11,37,40,-3,39
Brisbane,9933,6,10,5,13,33,42,-9,35
Western Sydn,9933,7,8,9,10,38,47,-9,33
Perth Glory,9933,8,10,2,15,37,50,-13,32
Wellington P,9933,9,5,6,16,31,55,-24,21
CC Mariners,9933,10,4,8,15,28,49,-21,20
Sydney FC,9934,1,21,4,3,68,23,45,67
N'castle Jet,9934,2,15,5,8,58,39,19,50
Melbourne C,9934,3,15,4,10,45,34,11,49
Melbourne V,9934,4,13,5,11,46,42,4,44
Adelaide Utd,9934,5,11,6,11,37,40,-3,39
Brisbane,9934,6,10,5,13,33,42,-9,35
Western Sydn,9934,7,8,9,10,38,47,-9,33
Perth Glory,9934,8,10,2,15,37,50,-13,32
Wellington P,9934,9,5,6,16,31,55,-24,21
CC Mariners,9934,10,4,8,15,28,49,-21,20
Sydney FC,9935,1,21,4,3,67,23,44,67
N'castle Jet,9935,2,16,5,7,59,38,21,53
Melbourne C,9935,3,14,4,11,44,35,9,46
Melbourne V,9935,4,13,5,11,46,41,5,44
Adelaide Utd,9935,5,11,6,11,37,40,-3,39
Brisbane,9935,6,10,5,13,33,42,-9,35
Western Sydn,9935,7,8,9,10,38,47,-9,33
Perth Glory,9935,8,10,2,15,37,50,-13,32
Wellington P,9935,9,5,6,16,31,55,-24,21
CC Mariners,9935,10,4,8,15,28,49,-21,20
Sydney FC,9936,1,21,4,3,66,23,43,67
N'castle Jet,9936,2,15,5,8,57,38,19,50
Melbourne C,9936,3,15,4,10,44,33,11,49
Melbourne V,9936,4,13,5,11,46,40,6,44
Adelaide Utd,9936,5,11,6,11,37,40,-3,39
Brisbane,9936,6,10,5,13,33,42,-9,35
Western Sydn,9936,7,8,9,10,38,47,-9,33
Perth Glory,9936,8,10,2,15,37,50,-13,32
Wellington P,9936,9,5,6,16,31,55,-24,21
CC Mariners,9936,10,4,8,15,28,49,-21,20
Sydney FC,9937,1,21,4,3,67,24,43,67
N'castle Jet,9937,2,16,5,7,60,39,21,53
Melbourne C,9937,3,14,4,11,45,36,9,46
Melbourne V,9937,4,13,5,11,47,41,6,44
Adelaide Utd,9937,5,11,6,11,37,40,-3,39
Brisbane,9937,6,10,5,13,33,42,-9,35
Western Sydn,9937,7,8,9,10,38,47,-9,33
Perth Glory,9937,8,10,2,15,37,50,-13,32
Wellington P,9937,9,5,6,16,31,55,-24,21
CC Mariners,9937,10,4,8,15,28,49,-21,20
Sydney FC,9938,1,21,4,3,66,22,44,67
N'castle Jet,9938,2,15,6,7,59,39,20,51
Melbourne C,9938,3,14,5,10,45,35,10,47
Melbourne V,9938,4,13,5,11,45,40,5,44
Adelaide Utd,9938,5,11,6,11,37,40,-3,39
Brisbane,9938,6,10,5,13,33,42,-9,35
Western Sydn,9938,7,8,9,10,38,47,-9,33
Perth Glory,9938,8,10,2,15,37,50,-13,32
Wellington P,9938,9,5,6,16,31,55,-24,21
CC Mariners,9938,10,4,8,15,28,49,-21,20
Sydney FC,9939,1,20,4,4,66,25,41,64
N'castle Jet,9939,2,15,6,7,58,38,20,51
Melbourne C,9939,3,14,5,10,44,34,10,47
Melbourne V,9939,4,14,5,10,48,40,8,47
Adelaide Utd,9939,5,11,6,11,37,40,-3,39
Brisbane,9939,6,10,5,13,33,42,-9,35
Western Sydn,9939,7,8,9,10,38,47,-9,33
Perth Glory,9939,8,10,2,15,37,50,-13,32
Wellington P,9939,9,5,6,16,31,55,-24,21
CC Mariners,9939,10,4,8,15,28,49,-21,20
Sydney FC,9940,1,20,4,4,66,25,41,64
N'castle Jet,9940,2,16,5,7,60,37,23,53
Melbourne V,9940,3,14,5,10,48,40,8,47
Melbourne C,9940,4,14,4,11,43,36,7,46
Adelaide Utd,9940,5,11,6,11,37,40,-3,39
Brisbane,9940,6,10,5,13,33,42,-9,35
Western Sydn,9940,7,8,9,10,38,47,-9,33
Perth Glory,9940,8,10,2,15,37,50,-13,32
Wellington P,9940,9,5,6,16,31,55,-24,21
CC Mariners,9940,10,4,8,15,28,49,-21,20
Sydney FC,9941,1,21,4,3,68,24,44,67
N'castle Jet,9941,2,16,5,7,62,39,23,53
Melbourne C,9941,3,14,4,11,45,38,7,46
Melbourne V,9941,4,13,5,11,47,42,5,44
Adelaide Utd,9941,5,11,6,11,37,40,-3,39
Brisbane,9941,6,10,5,13,33,42,-9,35
Western Sydn,9941,7,8,9,10,38,47,-9,33
Perth Glory,9941,8,10,2,15,37,50,-13,32
Wellington P,9941,9,5,6,16,31,55,-24,21
CC Mariners,9941,10,4,8,15,28,49,-21,20
Sydney FC,9942,1,21,4,3,66,23,43,67
N'castle Jet,9942,2,16,5,7,59,38,21,53
Melbourne C,9942,3,14,4,11,44,35,9,46
Melbourne V,9942,4,13,5,11,46,40,6,44
Adelaide Utd,9942,5,11,6,11,37,40,-3,39
Brisbane,9942,6,10,5,13,33,42,-9,35
Western Sydn,9942,7,8,9,10,38,47,-9,33
Perth Glory,9942,8,10,2,15,37,50,-13,32
Wellington P,9942,9,5,6,16,31,55,-24,21
CC Mariners,9942,10,4,8,15,28,49,-21,20
Sydney FC,9943,1,21,4,3,69,23,46,67
N'castle Jet,9943,2,15,6,7,58,38,20,51
Melbourne C,9943,3,14,5,10,44,34,10,47
Melbourne V,9943,4,13,5,11,46,43,3,44
Adelaide Utd,9943,5,11,6,11,37,40,-3,39
Brisbane,9943,6,10,5,13,33,42,-9,35
Western Sydn,9943,7,8,9,10,38,47,-9,33
Perth Glory,9943,8,10,2,15,37,50,-13,32
Wellington P,9943,9,5,6,16,31,55,-24,21
CC Mariners,9943,10,4,8,15,28,49,-21,20
Sydney FC,9944,1,21,4,3,67,24,43,67
N'castle Jet,9944,2,16,5,7,60,39,21,53
Melbourne C,9944,3,14,4,11,45,36,9,46
Melbourne V,9944,4,13,5,11,47,41,6,44
Adelaide Utd,9944,5,11,6,11,37,40,-3,39
Brisbane,9944,6,10,5,13,33,42,-9,35
Western Sydn,9944,7,8,9,10,38,47,-9,33
Perth Glory,9944,8,10,2,15,37,50,-13,32
Wellington P,9944,9,5,6,16,31,55,-24,21
CC Mariners,9944,10,4,8,15,28,49,-21,20
Sydney FC,9945,1,21,4,3,67,24,43,67
N'castle Jet,9945,2,15,5,8,58,40,18,50
Melbourne C,9945,3,15,4,10,46,34,12,49
Melbourne V,9945,4,13,5,11,47,41,6,44
Adelaide Utd,9945,5,11,6,11,37,40,-3,39
Brisbane,9945,6,10,5,13,33,42,-9,35
Western Sydn,9945,7,8,9,10,38,47,-9,33
Perth Glory,9945,8,10,2,15,37,50,-13,32
Wellington P,9945,9,5,6,16,31,55,-24,21
CC Mariners,9945,10,4,8,15,28,49,-21,20
Sydney FC,9946,1,20,5,3,65,23,42,65
N'castle Jet,9946,2,15,5,8,58,39,19,50
Melbourne C,9946,3,15,4,10,45,34,11,49
Melbourne V,9946,4,13,6,10,46,39,7,45
Adelaide Utd,9946,5,11,6,11,37,40,-3,39
Brisbane,9946,6,10,5,13,33,42,-9,35
Western Sydn,9946,7,8,9,10,38,47,-9,33
Perth Glory,9946,8,10,2,15,37,50,-13,32
Wellington P,9946,9,5,6,16,31,55,-24,21
CC Mariners,9946,10,4,8,15,28,49,-21,20
Sydney FC,9947,1,20,5,3,66,24,42,65
N'castle Jet,9947,2,15,5,8,57,41,16,50
Melbourne C,9947,3,15,4,10,47,33,14,49
Melbourne V,9947,4,13,6,10,47,40,7,45
Adelaide Utd,9947,5,11,6,11,37,40,-3,39
Brisbane,9947,6,10,5,13,33,42,-9,35
Western Sydn,9947,7,8,9,10,38,47,-9,33
Perth Glory,9947,8,10,2,15,37,50,-13,32
Wellington P,9947,9,5,6,16,31,55,-24,21
CC Mariners,9947,10,4,8,15,28,49,-21,20
Sydney FC,9948,1,20,4,4,65,24,41,64
N'castle Jet,9948,2,15,6,7,58,38,20,51
Melbourne C,9948,3,14,5,10,44,34,10,47
Melbourne V,9948,4,14,5,10,47,39,8,47
Adelaide Utd,9948,5,11,6,11,37,40,-3,39
Brisbane,9948,6,10,5,13,33,42,-9,35
Western Sydn,9948,7,8,9,10,38,47,-9,33
Perth Glory,9948,8,10,2,15,37,50,-13,32
Wellington P,9948,9,5,6,16,31,55,-24,21
CC Mariners,9948,10,4,8,15,28,49,-21,20
Sydney FC,9949,1,20,5,3,65,23,42,65
N'castle Jet,9949,2,16,5,7,59,37,22,53
Melbourne C,9949,3,14,4,11,43,35,8,46
Melbourne V,9949,4,13,6,10,46,39,7,45
Adelaide Utd,9949,5,11,6,11,37,40,-3,39
Brisbane,9949,6,10,5,13,33,42,-9,35
Western Sydn,9949,7,8,9,10,38,47,-9,33
Perth Glory,9949,8,10,2,15,37,50,-13,32
Wellington P,9949,9,5,6,16,31,55,-24,21
CC Mariners,9949,10,4,8,15,28,49,-21,20
Sydney FC,9950,1,21,4,3,65,22,43,67
N'castle Jet,9950,2,16,5,7,58,37,21,53
Melbourne C,9950,3,14,4,11,43,34,9,46
Melbourne V,9950,4,13,5,11,45,39,6,44
Adelaide Utd,9950,5,11,6,11,37,40,-3,39
Brisbane,9950,6,10,5,13,33,42,-9,35
Western Sydn,9950,7,8,9,10,38,47,-9,33
Perth Glory,9950,8,10,2,15,37,50,-13,32
Wellington P,9950,9,5,6,16,31,55,-24,21
CC Mariners,9950,10,4,8,15,28,49,-21,20
Sydney FC,9951,1,21,4,3,71,23,48,67
N'castle Jet,9951,2,16,5,7,60,38,22,53
Melbourne C,9951,3,14,4,11,44,36,8,46
Melbourne V,9951,4,13,5,11,46,45,1,44
Adelaide Utd,9951,5,11,6,11,37,40,-3,39
Brisbane,9951,6,10,5,13,33,42,-9,35
Western Sydn,9951,7,8,9,10,38,47,-9,33
Perth Glory,9951,8,10,2,15,37,50,-13,32
Wellington P,9951,9,5,6,16,31,55,-24,21
CC Mariners,9951,10,4,8,15,28,49,-21,20
Sydney FC,9952,1,21,4,3,66,22,44,67
N'castle Jet,9952,2,15,6,7,59,39,20,51
Melbourne C,9952,3,14,5,10,45,35,10,47
Melbourne V,9952,4,13,5,11,45,40,5,44
Adelaide Utd,9952,5,11,6,11,37,40,-3,39
Brisbane,9952,6,10,5,13,33,42,-9,35
Western Sydn,9952,7,8,9,10,38,47,-9,33
Perth Glory,9952,8,10,2,15,37,50,-13,32
Wellington P,9952,9,5,6,16,31,55,-24,21
CC Mariners,9952,10,4,8,15,28,49,-21,20
Sydney FC,9953,1,21,4,3,66,22,44,67
N'castle Jet,9953,2,15,6,7,59,39,20,51
Melbourne C,9953,3,14,5,10,45,35,10,47
Melbourne V,9953,4,13,5,11,45,40,5,44
Adelaide Utd,9953,5,11,6,11,37,40,-3,39
Brisbane,9953,6,10,5,13,33,42,-9,35
Western Sydn,9953,7,8,9,10,38,47,-9,33
Perth Glory,9953,8,10,2,15,37,50,-13,32
Wellington P,9953,9,5,6,16,31,55,-24,21
CC Mariners,9953,10,4,8,15,28,49,-21,20
Sydney FC,9954,1,21,4,3,65,22,43,67
N'castle Jet,9954,2,16,5,7,60,37,23,53
Melbourne C,9954,3,14,4,11,43,36,7,46
Melbourne V,9954,4,13,5,11,45,39,6,44
Adelaide Utd,9954,5,11,6,11,37,40,-3,39
Brisbane,9954,6,10,5,13,33,42,-9,35
Western Sydn,9954,7,8,9,10,38,47,-9,33
Perth Glory,9954,8,10,2,15,37,50,-13,32
Wellington P,9954,9,5,6,16,31,55,-24,21
CC Mariners,9954,10,4,8,15,28,49,-21,20
Sydney FC,9955,1,20,4,4,65,24,41,64
N'castle Jet,9955,2,16,5,7,59,37,22,53
Melbourne V,9955,3,14,5,10,47,39,8,47
Melbourne C,9955,4,14,4,11,43,35,8,46
Adelaide Utd,9955,5,11,6,11,37,40,-3,39
Brisbane,9955,6,10,5,13,33,42,-9,35
Western Sydn,9955,7,8,9,10,38,47,-9,33
Perth Glory,9955,8,10,2,15,37,50,-13,32
Wellington P,9955,9,5,6,16,31,55,-24,21
CC Mariners,9955,10,4,8,15,28,49,-21,20
Sydney FC,9956,1,21,4,3,66,23,43,67
N'castle Jet,9956,2,16,5,7,58,37,21,53
Melbourne C,9956,3,14,4,11,43,34,9,46
Melbourne V,9956,4,13,5,11,46,40,6,44
Adelaide Utd,9956,5,11,6,11,37,40,-3,39
Brisbane,9956,6,10,5,13,33,42,-9,35
Western Sydn,9956,7,8,9,10,38,47,-9,33
Perth Glory,9956,8,10,2,15,37,50,-13,32
Wellington P,9956,9,5,6,16,31,55,-24,21
CC Mariners,9956,10,4,8,15,28,49,-21,20
Sydney FC,9957,1,21,4,3,66,22,44,67
N'castle Jet,9957,2,16,5,7,59,38,21,53
Melbourne C,9957,3,14,4,11,44,35,9,46
Melbourne V,9957,4,13,5,11,45,40,5,44
Adelaide Utd,9957,5,11,6,11,37,40,-3,39
Brisbane,9957,6,10,5,13,33,42,-9,35
Western Sydn,9957,7,8,9,10,38,47,-9,33
Perth Glory,9957,8,10,2,15,37,50,-13,32
Wellington P,9957,9,5,6,16,31,55,-24,21
CC Mariners,9957,10,4,8,15,28,49,-21,20
Sydney FC,9958,1,21,4,3,68,23,45,67
N'castle Jet,9958,2,15,5,8,57,38,19,50
Melbourne C,9958,3,15,4,10,44,33,11,49
Melbourne V,9958,4,13,5,11,46,42,4,44
Adelaide Utd,9958,5,11,6,11,37,40,-3,39
Brisbane,9958,6,10,5,13,33,42,-9,35
Western Sydn,9958,7,8,9,10,38,47,-9,33
Perth Glory,9958,8,10,2,15,37,50,-13,32
Wellington P,9958,9,5,6,16,31,55,-24,21
CC Mariners,9958,10,4,8,15,28,49,-21,20
Sydney FC,9959,1,21,4,3,67,24,43,67
N'castle Jet,9959,2,15,5,8,57,38,19,50
Melbourne C,9959,3,15,4,10,44,33,11,49
Melbourne V,9959,4,13,5,11,47,41,6,44
Adelaide Utd,9959,5,11,6,11,37,40,-3,39
Brisbane,9959,6,10,5,13,33,42,-9,35
Western Sydn,9959,7,8,9,10,38,47,-9,33
Perth Glory,9959,8,10,2,15,37,50,-13,32
Wellington P,9959,9,5,6,16,31,55,-24,21
CC Mariners,9959,10,4,8,15,28,49,-21,20
Sydney FC,9960,1,21,4,3,67,23,44,67
N'castle Jet,9960,2,15,6,7,57,37,20,51
Melbourne C,9960,3,14,5,10,43,33,10,47
Melbourne V,9960,4,13,5,11,46,41,5,44
Adelaide Utd,9960,5,11,6,11,37,40,-3,39
Brisbane,9960,6,10,5,13,33,42,-9,35
Western Sydn,9960,7,8,9,10,38,47,-9,33
Perth Glory,9960,8,10,2,15,37,50,-13,32
Wellington P,9960,9,5,6,16,31,55,-24,21
CC Mariners,9960,10,4,8,15,28,49,-21,20
Sydney FC,9961,1,21,4,3,67,23,44,67
N'castle Jet,9961,2,16,5,7,59,38,21,53
Melbourne C,9961,3,14,4,11,44,35,9,46
Melbourne V,9961,4,13,5,11,46,41,5,44
Adelaide Utd,9961,5,11,6,11,37,40,-3,39
Brisbane,9961,6,10,5,13,33,42,-9,35
Western Sydn,9961,7,8,9,10,38,47,-9,33
Perth Glory,9961,8,10,2,15,37,50,-13,32
Wellington P,9961,9,5,6,16,31,55,-24,21
CC Mariners,9961,10,4,8,15,28,49,-21,20
Sydney FC,9962,1,21,4,3,68,24,44,67
N'castle Jet,9962,2,16,5,7,59,38,21,53
Melbourne C,9962,3,14,4,11,44,35,9,46
Melbourne V,9962,4,13,5,11,47,42,5,44
Adelaide Utd,9962,5,11,6,11,37,40,-3,39
Brisbane,9962,6,10,5,13,33,42,-9,35
Western Sydn,9962,7,8,9,10,38,47,-9,33
Perth Glory,9962,8,10,2,15,37,50,-13,32
Wellington P,9962,9,5,6,16,31,55,-24,21
CC Mariners,9962,10,4,8,15,28,49,-21,20
Sydney FC,9963,1,20,4,4,64,23,41,64
N'castle Jet,9963,2,16,5,7,58,37,21,53
Melbourne V,9963,3,14,5,10,46,38,8,47
Melbourne C,9963,4,14,4,11,43,34,9,46
Adelaide Utd,9963,5,11,6,11,37,40,-3,39
Brisbane,9963,6,10,5,13,33,42,-9,35
Western Sydn,9963,7,8,9,10,38,47,-9,33
Perth Glory,9963,8,10,2,15,37,50,-13,32
Wellington P,9963,9,5,6,16,31,55,-24,21
CC Mariners,9963,10,4,8,15,28,49,-21,20
Sydney FC,9964,1,21,4,3,66,22,44,67
N'castle Jet,9964,2,15,6,7,60,40,20,51
Melbourne C,9964,3,14,5,10,46,36,10,47
Melbourne V,9964,4,13,5,11,45,40,5,44
Adelaide Utd,9964,5,11,6,11,37,40,-3,39
Brisbane,9964,6,10,5,13,33,42,-9,35
Western Sydn,9964,7,8,9,10,38,47,-9,33
Perth Glory,9964,8,10,2,15,37,50,-13,32
Wellington P,9964,9,5,6,16,31,55,-24,21
CC Mariners,9964,10,4,8,15,28,49,-21,20
Sydney FC,9965,1,21,4,3,67,23,44,67
N'castle Jet,9965,2,15,5,8,57,41,16,50
Melbourne C,9965,3,15,4,10,47,33,14,49
Melbourne V,9965,4,13,5,11,46,41,5,44
Adelaide Utd,9965,5,11,6,11,37,40,-3,39
Brisbane,9965,6,10,5,13,33,42,-9,35
Western Sydn,9965,7,8,9,10,38,47,-9,33
Perth Glory,9965,8,10,2,15,37,50,-13,32
Wellington P,9965,9,5,6,16,31,55,-24,21
CC Mariners,9965,10,4,8,15,28,49,-21,20
Sydney FC,9966,1,21,4,3,67,24,43,67
N'castle Jet,9966,2,16,5,7,58,37,21,53
Melbourne C,9966,3,14,4,11,43,34,9,46
Melbourne V,9966,4,13,5,11,47,41,6,44
Adelaide Utd,9966,5,11,6,11,37,40,-3,39
Brisbane,9966,6,10,5,13,33,42,-9,35
Western Sydn,9966,7,8,9,10,38,47,-9,33
Perth Glory,9966,8,10,2,15,37,50,-13,32
Wellington P,9966,9,5,6,16,31,55,-24,21
CC Mariners,9966,10,4,8,15,28,49,-21,20
Sydney FC,9967,1,21,4,3,66,23,43,67
N'castle Jet,9967,2,16,5,7,61,38,23,53
Melbourne C,9967,3,14,4,11,44,37,7,46
Melbourne V,9967,4,13,5,11,46,40,6,44
Adelaide Utd,9967,5,11,6,11,37,40,-3,39
Brisbane,9967,6,10,5,13,33,42,-9,35
Western Sydn,9967,7,8,9,10,38,47,-9,33
Perth Glory,9967,8,10,2,15,37,50,-13,32
Wellington P,9967,9,5,6,16,31,55,-24,21
CC Mariners,9967,10,4,8,15,28,49,-21,20
Sydney FC,9968,1,21,4,3,67,23,44,67
N'castle Jet,9968,2,15,6,7,59,39,20,51
Melbourne C,9968,3,14,5,10,45,35,10,47
Melbourne V,9968,4,13,5,11,46,41,5,44
Adelaide Utd,9968,5,11,6,11,37,40,-3,39
Brisbane,9968,6,10,5,13,33,42,-9,35
Western Sydn,9968,7,8,9,10,38,47,-9,33
Perth Glory,9968,8,10,2,15,37,50,-13,32
Wellington P,9968,9,5,6,16,31,55,-24,21
CC Mariners,9968,10,4,8,15,28,49,-21,20
Sydney FC,9969,1,20,5,3,67,25,42,65
N'castle Jet,9969,2,16,5,7,58,37,21,53
Melbourne C,9969,3,14,4,11,43,34,9,46
Melbourne V,9969,4,13,6,10,48,41,7,45
Adelaide Utd,9969,5,11,6,11,37,40,-3,39
Brisbane,9969,6,10,5,13,33,42,-9,35
Western Sydn,9969,7,8,9,10,38,47,-9,33
Perth Glory,9969,8,10,2,15,37,50,-13,32
Wellington P,9969,9,5,6,16,31,55,-24,21
CC Mariners,9969,10,4,8,15,28,49,-21,20
Sydney FC,9970,1,21,4,3,68,22,46,67
N'castle Jet,9970,2,15,5,8,57,40,17,50
Melbourne C,9970,3,15,4,10,46,33,13,49
Melbourne V,9970,4,13,5,11,45,42,3,44
Adelaide Utd,9970,5,11,6,11,37,40,-3,39
Brisbane,9970,6,10,5,13,33,42,-9,35
Western Sydn,9970,7,8,9,10,38,47,-9,33
Perth Glory,9970,8,10,2,15,37,50,-13,32
Wellington P,9970,9,5,6,16,31,55,-24,21
CC Mariners,9970,10,4,8,15,28,49,-21,20
Sydney FC,9971,1,21,4,3,65,22,43,67
N'castle Jet,9971,2,16,5,7,59,38,21,53
Melbourne C,9971,3,14,4,11,44,35,9,46
Melbourne V,9971,4,13,5,11,45,39,6,44
Adelaide Utd,9971,5,11,6,11,37,40,-3,39
Brisbane,9971,6,10,5,13,33,42,-9,35
Western Sydn,9971,7,8,9,10,38,47,-9,33
Perth Glory,9971,8,10,2,15,37,50,-13,32
Wellington P,9971,9,5,6,16,31,55,-24,21
CC Mariners,9971,10,4,8,15,28,49,-21,20
Sydney FC,9972,1,20,5,3,65,23,42,65
N'castle Jet,9972,2,15,5,8,57,38,19,50
Melbourne C,9972,3,15,4,10,44,33,11,49
Melbourne V,9972,4,13,6,10,46,39,7,45
Adelaide Utd,9972,5,11,6,11,37,40,-3,39
Brisbane,9972,6,10,5,13,33,42,-9,35
Western Sydn,9972,7,8,9,10,38,47,-9,33
Perth Glory,9972,8,10,2,15,37,50,-13,32
Wellington P,9972,9,5,6,16,31,55,-24,21
CC Mariners,9972,10,4,8,15,28,49,-21,20
Sydney FC,9973,1,20,5,3,65,23,42,65
N'castle Jet,9973,2,16,5,7,60,39,21,53
Melbourne C,9973,3,14,4,11,45,36,9,46
Melbourne V,9973,4,13,6,10,46,39,7,45
Adelaide Utd,9973,5,11,6,11,37,40,-3,39
Brisbane,9973,6,10,5,13,33,42,-9,35
Western Sydn,9973,7,8,9,10,38,47,-9,33
Perth Glory,9973,8,10,2,15,37,50,-13,32
Wellington P,9973,9,5,6,16,31,55,-24,21
CC Mariners,9973,10,4,8,15,28,49,-21,20
Sydney FC,9974,1,20,4,4,64,23,41,64
N'castle Jet,9974,2,15,5,8,59,40,19,50
Melbourne C,9974,3,15,4,10,46,35,11,49
Melbourne V,9974,4,14,5,10,46,38,8,47
Adelaide Utd,9974,5,11,6,11,37,40,-3,39
Brisbane,9974,6,10,5,13,33,42,-9,35
Western Sydn,9974,7,8,9,10,38,47,-9,33
Perth Glory,9974,8,10,2,15,37,50,-13,32
Wellington P,9974,9,5,6,16,31,55,-24,21
CC Mariners,9974,10,4,8,15,28,49,-21,20
Sydney FC,9975,1,20,5,3,64,22,42,65
N'castle Jet,9975,2,16,5,7,59,38,21,53
Melbourne C,9975,3,14,4,11,44,35,9,46
Melbourne V,9975,4,13,6,10,45,38,7,45
Adelaide Utd,9975,5,11,6,11,37,40,-3,39
Brisbane,9975,6,10,5,13,33,42,-9,35
Western Sydn,9975,7,8,9,10,38,47,-9,33
Perth Glory,9975,8,10,2,15,37,50,-13,32
Wellington P,9975,9,5,6,16,31,55,-24,21
CC Mariners,9975,10,4,8,15,28,49,-21,20
Sydney FC,9976,1,21,4,3,70,23,47,67
N'castle Jet,9976,2,15,5,8,59,41,18,50
Melbourne C,9976,3,15,4,10,47,35,12,49
Melbourne V,9976,4,13,5,11,46,44,2,44
Adelaide Utd,9976,5,11,6,11,37,40,-3,39
Brisbane,9976,6,10,5,13,33,42,-9,35
Western Sydn,9976,7,8,9,10,38,47,-9,33
Perth Glory,9976,8,10,2,15,37,50,-13,32
Wellington P,9976,9,5,6,16,31,55,-24,21
CC Mariners,9976,10,4,8,15,28,49,-21,20
Sydney FC,9977,1,20,4,4,64,23,41,64
N'castle Jet,9977,2,15,6,7,57,37,20,51
Melbourne C,9977,3,14,5,10,43,33,10,47
Melbourne V,9977,4,14,5,10,46,38,8,47
Adelaide Utd,9977,5,11,6,11,37,40,-3,39
Brisbane,9977,6,10,5,13,33,42,-9,35
Western Sydn,9977,7,8,9,10,38,47,-9,33
Perth Glory,9977,8,10,2,15,37,50,-13,32
Wellington P,9977,9,5,6,16,31,55,-24,21
CC Mariners,9977,10,4,8,15,28,49,-21,20
Sydney FC,9978,1,21,4,3,67,22,45,67
N'castle Jet,9978,2,16,5,7,61,38,23,53
Melbourne C,9978,3,14,4,11,44,37,7,46
Melbourne V,9978,4,13,5,11,45,41,4,44
Adelaide Utd,9978,5,11,6,11,37,40,-3,39
Brisbane,9978,6,10,5,13,33,42,-9,35
Western Sydn,9978,7,8,9,10,38,47,-9,33
Perth Glory,9978,8,10,2,15,37,50,-13,32
Wellington P,9978,9,5,6,16,31,55,-24,21
CC Mariners,9978,10,4,8,15,28,49,-21,20
Sydney FC,9979,1,20,4,4,64,25,39,64
N'castle Jet,9979,2,16,5,7,59,38,21,53
Melbourne V,9979,3,14,5,10,48,38,10,47
Melbourne C,9979,4,14,4,11,44,35,9,46
Adelaide Utd,9979,5,11,6,11,37,40,-3,39
Brisbane,9979,6,10,5,13,33,42,-9,35
Western Sydn,9979,7,8,9,10,38,47,-9,33
Perth Glory,9979,8,10,2,15,37,50,-13,32
Wellington P,9979,9,5,6,16,31,55,-24,21
CC Mariners,9979,10,4,8,15,28,49,-21,20
Sydney FC,9980,1,20,4,4,66,25,41,64
N'castle Jet,9980,2,16,5,7,58,37,21,53
Melbourne V,9980,3,14,5,10,48,40,8,47
Melbourne C,9980,4,14,4,11,43,34,9,46
Adelaide Utd,9980,5,11,6,11,37,40,-3,39
Brisbane,9980,6,10,5,13,33,42,-9,35
Western Sydn,9980,7,8,9,10,38,47,-9,33
Perth Glory,9980,8,10,2,15,37,50,-13,32
Wellington P,9980,9,5,6,16,31,55,-24,21
CC Mariners,9980,10,4,8,15,28,49,-21,20
Sydney FC,9981,1,20,5,3,65,23,42,65
N'castle Jet,9981,2,15,5,8,57,39,18,50
Melbourne C,9981,3,15,4,10,45,33,12,49
Melbourne V,9981,4,13,6,10,46,39,7,45
Adelaide Utd,9981,5,11,6,11,37,40,-3,39
Brisbane,9981,6,10,5,13,33,42,-9,35
Western Sydn,9981,7,8,9,10,38,47,-9,33
Perth Glory,9981,8,10,2,15,37,50,-13,32
Wellington P,9981,9,5,6,16,31,55,-24,21
CC Mariners,9981,10,4,8,15,28,49,-21,20
Sydney FC,9982,1,21,4,3,67,22,45,67
N'castle Jet,9982,2,15,5,8,57,42,15,50
Melbourne C,9982,3,15,4,10,48,33,15,49
Melbourne V,9982,4,13,5,11,45,41,4,44
Adelaide Utd,9982,5,11,6,11,37,40,-3,39
Brisbane,9982,6,10,5,13,33,42,-9,35
Western Sydn,9982,7,8,9,10,38,47,-9,33
Perth Glory,9982,8,10,2,15,37,50,-13,32
Wellington P,9982,9,5,6,16,31,55,-24,21
CC Mariners,9982,10,4,8,15,28,49,-21,20
Sydney FC,9983,1,20,4,4,64,24,40,64
N'castle Jet,9983,2,16,5,7,61,38,23,53
Melbourne V,9983,3,14,5,10,47,38,9,47
Melbourne C,9983,4,14,4,11,44,37,7,46
Adelaide Utd,9983,5,11,6,11,37,40,-3,39
Brisbane,9983,6,10,5,13,33,42,-9,35
Western Sydn,9983,7,8,9,10,38,47,-9,33
Perth Glory,9983,8,10,2,15,37,50,-13,32
Wellington P,9983,9,5,6,16,31,55,-24,21
CC Mariners,9983,10,4,8,15,28,49,-21,20
Sydney FC,9984,1,20,5,3,65,23,42,65
N'castle Jet,9984,2,15,6,7,59,39,20,51
Melbourne C,9984,3,14,5,10,45,35,10,47
Melbourne V,9984,4,13,6,10,46,39,7,45
Adelaide Utd,9984,5,11,6,11,37,40,-3,39
Brisbane,9984,6,10,5,13,33,42,-9,35
Western Sydn,9984,7,8,9,10,38,47,-9,33
Perth Glory,9984,8,10,2,15,37,50,-13,32
Wellington P,9984,9,5,6,16,31,55,-24,21
CC Mariners,9984,10,4,8,15,28,49,-21,20
Sydney FC,9985,1,20,5,3,66,24,42,65
N'castle Jet,9985,2,16,5,7,58,37,21,53
Melbourne C,9985,3,14,4,11,43,34,9,46
Melbourne V,9985,4,13,6,10,47,40,7,45
Adelaide Utd,9985,5,11,6,11,37,40,-3,39
Brisbane,9985,6,10,5,13,33,42,-9,35
Western Sydn,9985,7,8,9,10,38,47,-9,33
Perth Glory,9985,8,10,2,15,37,50,-13,32
Wellington P,9985,9,5,6,16,31,55,-24,21
CC Mariners,9985,10,4,8,15,28,49,-21,20
Sydney FC,9986,1,20,5,3,64,22,42,65
N'castle Jet,9986,2,16,5,7,58,37,21,53
Melbourne C,9986,3,14,4,11,43,34,9,46
Melbourne V,9986,4,13,6,10,45,38,7,45
Adelaide Utd,9986,5,11,6,11,37,40,-3,39
Brisbane,9986,6,10,5,13,33,42,-9,35
Western Sydn,9986,7,8,9,10,38,47,-9,33
Perth Glory,9986,8,10,2,15,37,50,-13,32
Wellington P,9986,9,5,6,16,31,55,-24,21
CC Mariners,9986,10,4,8,15,28,49,-21,20
Sydney FC,9987,1,21,4,3,66,23,43,67
N'castle Jet,9987,2,15,6,7,57,37,20,51
Melbourne C,9987,3,14,5,10,43,33,10,47
Melbourne V,9987,4,13,5,11,46,40,6,44
Adelaide Utd,9987,5,11,6,11,37,40,-3,39
Brisbane,9987,6,10,5,13,33,42,-9,35
Western Sydn,9987,7,8,9,10,38,47,-9,33
Perth Glory,9987,8,10,2,15,37,50,-13,32
Wellington P,9987,9,5,6,16,31,55,-24,21
CC Mariners,9987,10,4,8,15,28,49,-21,20
Sydney FC,9988,1,20,5,3,65,23,42,65
N'castle Jet,9988,2,16,5,7,58,37,21,53
Melbourne C,9988,3,14,4,11,43,34,9,46
Melbourne V,9988,4,13,6,10,46,39,7,45
Adelaide Utd,9988,5,11,6,11,37,40,-3,39
Brisbane,9988,6,10,5,13,33,42,-9,35
Western Sydn,9988,7,8,9,10,38,47,-9,33
Perth Glory,9988,8,10,2,15,37,50,-13,32
Wellington P,9988,9,5,6,16,31,55,-24,21
CC Mariners,9988,10,4,8,15,28,49,-21,20
Sydney FC,9989,1,21,4,3,66,22,44,67
N'castle Jet,9989,2,16,5,7,59,38,21,53
Melbourne C,9989,3,14,4,11,44,35,9,46
Melbourne V,9989,4,13,5,11,45,40,5,44
Adelaide Utd,9989,5,11,6,11,37,40,-3,39
Brisbane,9989,6,10,5,13,33,42,-9,35
Western Sydn,9989,7,8,9,10,38,47,-9,33
Perth Glory,9989,8,10,2,15,37,50,-13,32
Wellington P,9989,9,5,6,16,31,55,-24,21
CC Mariners,9989,10,4,8,15,28,49,-21,20
Sydney FC,9990,1,20,4,4,65,24,41,64
N'castle Jet,9990,2,15,5,8,57,39,18,50
Melbourne C,9990,3,15,4,10,45,33,12,49
Melbourne V,9990,4,14,5,10,47,39,8,47
Adelaide Utd,9990,5,11,6,11,37,40,-3,39
Brisbane,9990,6,10,5,13,33,42,-9,35
Western Sydn,9990,7,8,9,10,38,47,-9,33
Perth Glory,9990,8,10,2,15,37,50,-13,32
Wellington P,9990,9,5,6,16,31,55,-24,21
CC Mariners,9990,10,4,8,15,28,49,-21,20
Sydney FC,9991,1,20,5,3,65,23,42,65
N'castle Jet,9991,2,16,5,7,58,37,21,53
Melbourne C,9991,3,14,4,11,43,34,9,46
Melbourne V,9991,4,13,6,10,46,39,7,45
Adelaide Utd,9991,5,11,6,11,37,40,-3,39
Brisbane,9991,6,10,5,13,33,42,-9,35
Western Sydn,9991,7,8,9,10,38,47,-9,33
Perth Glory,9991,8,10,2,15,37,50,-13,32
Wellington P,9991,9,5,6,16,31,55,-24,21
CC Mariners,9991,10,4,8,15,28,49,-21,20
Sydney FC,9992,1,21,4,3,69,24,45,67
N'castle Jet,9992,2,16,5,7,60,39,21,53
Melbourne C,9992,3,14,4,11,45,36,9,46
Melbourne V,9992,4,13,5,11,47,43,4,44
Adelaide Utd,9992,5,11,6,11,37,40,-3,39
Brisbane,9992,6,10,5,13,33,42,-9,35
Western Sydn,9992,7,8,9,10,38,47,-9,33
Perth Glory,9992,8,10,2,15,37,50,-13,32
Wellington P,9992,9,5,6,16,31,55,-24,21
CC Mariners,9992,10,4,8,15,28,49,-21,20
Sydney FC,9993,1,20,4,4,64,23,41,64
N'castle Jet,9993,2,15,6,7,58,38,20,51
Melbourne C,9993,3,14,5,10,44,34,10,47
Melbourne V,9993,4,14,5,10,46,38,8,47
Adelaide Utd,9993,5,11,6,11,37,40,-3,39
Brisbane,9993,6,10,5,13,33,42,-9,35
Western Sydn,9993,7,8,9,10,38,47,-9,33
Perth Glory,9993,8,10,2,15,37,50,-13,32
Wellington P,9993,9,5,6,16,31,55,-24,21
CC Mariners,9993,10,4,8,15,28,49,-21,20
Sydney FC,9994,1,21,4,3,65,22,43,67
N'castle Jet,9994,2,16,5,7,58,37,21,53
Melbourne C,9994,3,14,4,11,43,34,9,46
Melbourne V,9994,4,13,5,11,45,39,6,44
Adelaide Utd,9994,5,11,6,11,37,40,-3,39
Brisbane,9994,6,10,5,13,33,42,-9,35
Western Sydn,9994,7,8,9,10,38,47,-9,33
Perth Glory,9994,8,10,2,15,37,50,-13,32
Wellington P,9994,9,5,6,16,31,55,-24,21
CC Mariners,9994,10,4,8,15,28,49,-21,20
Sydney FC,9995,1,21,4,3,66,22,44,67
N'castle Jet,9995,2,16,5,7,58,37,21,53
Melbourne C,9995,3,14,4,11,43,34,9,46
Melbourne V,9995,4,13,5,11,45,40,5,44
Adelaide Utd,9995,5,11,6,11,37,40,-3,39
Brisbane,9995,6,10,5,13,33,42,-9,35
Western Sydn,9995,7,8,9,10,38,47,-9,33
Perth Glory,9995,8,10,2,15,37,50,-13,32
Wellington P,9995,9,5,6,16,31,55,-24,21
CC Mariners,9995,10,4,8,15,28,49,-21,20
Sydney FC,9996,1,21,4,3,66,23,43,67
N'castle Jet,9996,2,16,5,7,60,38,22,53
Melbourne C,9996,3,14,4,11,44,36,8,46
Melbourne V,9996,4,13,5,11,46,40,6,44
Adelaide Utd,9996,5,11,6,11,37,40,-3,39
Brisbane,9996,6,10,5,13,33,42,-9,35
Western Sydn,9996,7,8,9,10,38,47,-9,33
Perth Glory,9996,8,10,2,15,37,50,-13,32
Wellington P,9996,9,5,6,16,31,55,-24,21
CC Mariners,9996,10,4,8,15,28,49,-21,20
Sydney FC,9997,1,20,4,4,64,24,40,64
N'castle Jet,9997,2,16,5,7,58,37,21,53
Melbourne V,9997,3,14,5,10,47,38,9,47
Melbourne C,9997,4,14,4,11,43,34,9,46
Adelaide Utd,9997,5,11,6,11,37,40,-3,39
Brisbane,9997,6,10,5,13,33,42,-9,35
Western Sydn,9997,7,8,9,10,38,47,-9,33
Perth Glory,9997,8,10,2,15,37,50,-13,32
Wellington P,9997,9,5,6,16,31,55,-24,21
CC Mariners,9997,10,4,8,15,28,49,-21,20
Sydney FC,9998,1,21,4,3,67,23,44,67
N'castle Jet,9998,2,15,6,7,58,38,20,51
Melbourne C,9998,3,14,5,10,44,34,10,47
Melbourne V,9998,4,13,5,11,46,41,5,44
Adelaide Utd,9998,5,11,6,11,37,40,-3,39
Brisbane,9998,6,10,5,13,33,42,-9,35
Western Sydn,9998,7,8,9,10,38,47,-9,33
Perth Glory,9998,8,10,2,15,37,50,-13,32
Wellington P,9998,9,5,6,16,31,55,-24,21
CC Mariners,9998,10,4,8,15,28,49,-21,20
Sydney FC,9999,1,21,4,3,66,22,44,67
N'castle Jet,9999,2,16,5,7,59,37,22,53
Melbourne C,9999,3,14,4,11,43,35,8,46
Melbourne V,9999,4,13,5,11,45,40,5,44
Adelaide Utd,9999,5,11,6,11,37,40,-3,39
Brisbane,9999,6,10,5,13,33,42,-9,35
Western Sydn,9999,7,8,9,10,38,47,-9,33
Perth Glory,9999,8,10,2,15,37,50,-13,32
Wellington P,9999,9,5,6,16,31,55,-24,21
CC Mariners,9999,10,4,8,15,28,49,-21,20
