team,n,rank,w,d,l,gf,ga,gd,pts
FC Salzburg,0,1,15,6,3,44,19,25,51
SK Sturm Gra,0,2,13,3,8,32,27,5,42
Rapid Vienna,0,3,9,10,5,37,27,10,37
LASK Linz,0,4,9,6,9,28,28,0,33
Vienna,0,5,7,5,12,25,40,-15,26
Mattersburg,0,6,6,5,13,31,43,-12,23
SC Rheindorf,0,7,5,5,14,18,31,-13,20
FC Salzburg,1,1,14,6,4,45,20,25,48
SK Sturm Gra,1,2,12,4,8,30,29,1,40
Rapid Vienna,1,3,7,9,8,34,34,0,30
LASK Linz,1,4,8,6,10,26,29,-3,30
Mattersburg,1,5,7,7,10,31,37,-6,28
SC Rheindorf,1,6,7,6,11,22,26,-4,27
Vienna,1,7,7,6,11,26,39,-13,27
FC Salzburg,2,1,14,7,3,47,21,26,49
SK Sturm Gra,2,2,13,4,7,37,29,8,43
Rapid Vienna,2,3,8,10,6,34,28,6,34
LASK Linz,2,4,8,7,9,27,31,-4,31
Vienna,2,5,7,6,11,27,39,-12,27
SC Rheindorf,2,6,6,6,12,19,28,-9,24
Mattersburg,2,7,5,6,13,31,46,-15,21
FC Salzburg,3,1,14,6,4,44,18,26,48
Rapid Vienna,3,2,10,10,4,38,25,13,40
SK Sturm Gra,3,3,12,4,8,31,29,2,40
Vienna,3,4,8,5,11,28,39,-11,29
LASK Linz,3,5,7,7,10,25,29,-4,28
Mattersburg,3,6,6,6,12,29,43,-14,24
SC Rheindorf,3,7,5,6,13,18,30,-12,21
FC Salzburg,4,1,15,6,3,46,20,26,51
SK Sturm Gra,4,2,12,4,8,32,31,1,40
Rapid Vienna,4,3,9,10,5,41,29,12,37
LASK Linz,4,4,9,6,9,28,29,-1,33
Vienna,4,5,7,5,12,27,41,-14,26
Mattersburg,4,6,6,6,12,33,42,-9,24
SC Rheindorf,4,7,4,7,13,16,31,-15,19
FC Salzburg,5,1,14,7,3,47,18,29,49
SK Sturm Gra,5,2,13,4,7,34,28,6,43
Rapid Vienna,5,3,7,12,5,32,26,6,33
LASK Linz,5,4,9,5,10,27,28,-1,32
SC Rheindorf,5,5,6,7,11,19,26,-7,25
Mattersburg,5,6,6,6,12,31,45,-14,24
Vienna,5,7,6,5,13,25,44,-19,23
SK Sturm Gra,6,1,15,3,6,34,26,8,48
FC Salzburg,6,2,13,7,4,45,21,24,46
Rapid Vienna,6,3,8,9,7,37,33,4,33
LASK Linz,6,4,8,6,10,28,29,-1,30
Mattersburg,6,5,8,5,11,32,40,-8,29
Vienna,6,6,6,6,12,25,40,-15,24
SC Rheindorf,6,7,5,6,13,20,32,-12,21
FC Salzburg,7,1,14,7,3,44,21,23,49
SK Sturm Gra,7,2,11,5,8,30,28,2,38
Rapid Vienna,7,3,8,10,6,35,27,8,34
LASK Linz,7,4,9,5,10,29,31,-2,32
Vienna,7,5,7,6,11,29,42,-13,27
SC Rheindorf,7,6,6,7,11,19,27,-8,25
Mattersburg,7,7,6,6,12,33,43,-10,24
FC Salzburg,8,1,14,7,3,45,19,26,49
SK Sturm Gra,8,2,12,4,8,32,28,4,40
Rapid Vienna,8,3,8,11,5,34,26,8,35
LASK Linz,8,4,8,5,11,27,35,-8,29
Vienna,8,5,8,5,11,27,37,-10,29
Mattersburg,8,6,7,5,12,35,41,-6,26
SC Rheindorf,8,7,5,7,12,19,33,-14,22
FC Salzburg,9,1,14,7,3,43,17,26,49
SK Sturm Gra,9,2,13,5,6,32,25,7,44
Rapid Vienna,9,3,9,10,5,37,27,10,37
LASK Linz,9,4,8,6,10,27,31,-4,30
Vienna,9,5,7,5,12,24,39,-15,26
SC Rheindorf,9,6,5,7,12,19,27,-8,22
Mattersburg,9,7,5,6,13,29,45,-16,21
FC Salzburg,10,1,13,9,2,41,17,24,48
SK Sturm Gra,10,2,12,5,7,30,28,2,41
Rapid Vienna,10,3,8,11,5,34,26,8,35
LASK Linz,10,4,8,6,10,29,29,0,30
Vienna,10,5,7,6,11,27,39,-12,27
Mattersburg,10,6,5,8,11,32,44,-12,23
SC Rheindorf,10,7,5,7,12,18,28,-10,22
FC Salzburg,11,1,15,7,2,48,18,30,52
SK Sturm Gra,11,2,13,5,6,33,26,7,44
LASK Linz,11,3,9,6,9,26,28,-2,33
Rapid Vienna,11,4,7,10,7,31,30,1,31
Mattersburg,11,5,7,6,11,35,41,-6,27
Vienna,11,6,6,5,13,25,43,-18,23
SC Rheindorf,11,7,4,7,13,16,28,-12,19
FC Salzburg,12,1,15,7,2,52,20,32,52
Rapid Vienna,12,2,10,10,4,39,26,13,40
SK Sturm Gra,12,3,12,3,9,34,31,3,39
Mattersburg,12,4,7,5,12,36,41,-5,26
LASK Linz,12,5,7,5,12,25,35,-10,26
Vienna,12,6,7,5,12,26,44,-18,26
SC Rheindorf,12,7,6,5,13,19,34,-15,23
FC Salzburg,13,1,14,8,2,48,22,26,50
SK Sturm Gra,13,2,13,4,7,33,29,4,43
Rapid Vienna,13,3,8,10,6,36,29,7,34
LASK Linz,13,4,8,6,10,25,28,-3,30
Mattersburg,13,5,6,7,11,32,42,-10,25
SC Rheindorf,13,6,5,8,11,19,27,-8,23
Vienna,13,7,6,5,13,24,40,-16,23
FC Salzburg,14,1,12,8,4,42,21,21,44
Rapid Vienna,14,2,11,9,4,39,25,14,42
SK Sturm Gra,14,3,13,3,8,32,29,3,42
LASK Linz,14,4,8,6,10,27,31,-4,30
Vienna,14,5,6,7,11,25,39,-14,25
SC Rheindorf,14,6,6,6,12,21,28,-7,24
Mattersburg,14,7,5,7,12,29,42,-13,22
FC Salzburg,15,1,14,7,3,44,17,27,49
SK Sturm Gra,15,2,13,4,7,34,30,4,43
Rapid Vienna,15,3,10,9,5,35,24,11,39
LASK Linz,15,4,8,6,10,25,27,-2,30
Vienna,15,5,7,6,11,26,39,-13,27
SC Rheindorf,15,6,5,7,12,20,30,-10,22
Mattersburg,15,7,5,5,14,28,45,-17,20
FC Salzburg,16,1,14,7,3,44,17,27,49
SK Sturm Gra,16,2,12,5,7,32,28,4,41
Rapid Vienna,16,3,8,10,6,35,29,6,34
LASK Linz,16,4,8,7,9,28,28,0,31
Vienna,16,5,8,5,11,27,37,-10,29
Mattersburg,16,6,6,6,12,30,46,-16,24
SC Rheindorf,16,7,5,6,13,19,30,-11,21
FC Salzburg,17,1,16,6,2,45,17,28,54
SK Sturm Gra,17,2,12,3,9,31,29,2,39
Rapid Vienna,17,3,8,10,6,34,29,5,34
LASK Linz,17,4,9,5,10,29,29,0,32
Vienna,17,5,7,5,12,26,38,-12,26
SC Rheindorf,17,6,6,7,11,19,26,-7,25
Mattersburg,17,7,5,6,13,28,44,-16,21
FC Salzburg,18,1,12,8,4,41,21,20,44
SK Sturm Gra,18,2,12,5,7,37,32,5,41
Rapid Vienna,18,3,10,9,5,35,24,11,39
SC Rheindorf,18,4,7,6,11,23,29,-6,27
Mattersburg,18,5,7,6,11,33,41,-8,27
LASK Linz,18,6,7,5,12,27,35,-8,26
Vienna,18,7,6,7,11,27,41,-14,25
FC Salzburg,19,1,14,7,3,47,22,25,49
SK Sturm Gra,19,2,14,3,7,38,30,8,45
Rapid Vienna,19,3,9,9,6,37,29,8,36
LASK Linz,19,4,10,5,9,30,29,1,35
Vienna,19,5,7,6,11,25,38,-13,27
Mattersburg,19,6,6,5,13,29,43,-14,23
SC Rheindorf,19,7,4,5,15,19,34,-15,17
FC Salzburg,20,1,13,8,3,41,18,23,47
SK Sturm Gra,20,2,11,5,8,31,29,2,38
Rapid Vienna,20,3,8,11,5,33,25,8,35
LASK Linz,20,4,8,7,9,26,27,-1,31
Vienna,20,5,8,5,11,29,39,-10,29
SC Rheindorf,20,6,7,6,11,23,29,-6,27
Mattersburg,20,7,5,6,13,30,46,-16,21
FC Salzburg,21,1,14,7,3,44,19,25,49
SK Sturm Gra,21,2,12,4,8,31,28,3,40
Rapid Vienna,21,3,7,11,6,35,30,5,32
LASK Linz,21,4,7,8,9,26,28,-2,29
Mattersburg,21,5,7,6,11,32,42,-10,27
SC Rheindorf,21,6,7,5,12,22,30,-8,26
Vienna,21,7,7,5,12,26,39,-13,26
FC Salzburg,22,1,15,7,2,46,16,30,52
SK Sturm Gra,22,2,12,5,7,31,28,3,41
LASK Linz,22,3,9,7,8,28,27,1,34
Rapid Vienna,22,4,7,11,6,37,31,6,32
Vienna,22,5,6,7,11,25,39,-14,25
Mattersburg,22,6,6,6,12,30,43,-13,24
SC Rheindorf,22,7,5,5,14,18,31,-13,20
FC Salzburg,23,1,14,8,2,43,17,26,50
SK Sturm Gra,23,2,14,4,6,39,27,12,46
LASK Linz,23,3,9,5,10,28,32,-4,32
Rapid Vienna,23,4,7,10,7,35,31,4,31
SC Rheindorf,23,5,6,6,12,24,34,-10,24
Vienna,23,6,6,6,12,26,41,-15,24
Mattersburg,23,7,6,5,13,31,44,-13,23
FC Salzburg,24,1,14,7,3,46,20,26,49
SK Sturm Gra,24,2,12,5,7,30,29,1,41
LASK Linz,24,3,9,7,8,26,24,2,34
Rapid Vienna,24,4,7,12,5,32,25,7,33
Mattersburg,24,5,7,5,12,33,40,-7,26
SC Rheindorf,24,6,6,5,13,17,28,-11,23
Vienna,24,7,6,5,13,26,44,-18,23
FC Salzburg,25,1,15,7,2,50,17,33,52
SK Sturm Gra,25,2,13,4,7,33,28,5,43
Rapid Vienna,25,3,8,10,6,38,28,10,34
Mattersburg,25,4,7,5,12,35,45,-10,26
LASK Linz,25,5,7,5,12,28,38,-10,26
Vienna,25,6,7,5,12,24,41,-17,26
SC Rheindorf,25,7,6,6,12,19,30,-11,24
FC Salzburg,26,1,13,8,3,42,19,23,47
SK Sturm Gra,26,2,13,4,7,35,28,7,43
Rapid Vienna,26,3,8,9,7,34,30,4,33
LASK Linz,26,4,9,5,10,25,27,-2,32
Mattersburg,26,5,8,6,10,33,38,-5,30
Vienna,26,6,6,7,11,25,39,-14,25
SC Rheindorf,26,7,5,5,14,16,29,-13,20
FC Salzburg,27,1,13,8,3,43,18,25,47
SK Sturm Gra,27,2,13,4,7,37,33,4,43
Rapid Vienna,27,3,9,10,5,38,29,9,37
LASK Linz,27,4,8,5,11,27,31,-4,29
Mattersburg,27,5,8,5,11,30,38,-8,29
Vienna,27,6,6,6,12,23,39,-16,24
SC Rheindorf,27,7,5,6,13,21,31,-10,21
FC Salzburg,28,1,15,7,2,43,16,27,52
SK Sturm Gra,28,2,12,4,8,29,26,3,40
Rapid Vienna,28,3,8,11,5,32,25,7,35
LASK Linz,28,4,8,6,10,26,27,-1,30
Mattersburg,28,5,8,5,11,32,39,-7,29
Vienna,28,6,6,5,13,23,40,-17,23
SC Rheindorf,28,7,4,8,12,16,28,-12,20
FC Salzburg,29,1,12,10,2,41,18,23,46
SK Sturm Gra,29,2,13,5,6,31,24,7,44
Rapid Vienna,29,3,8,12,4,34,25,9,36
LASK Linz,29,4,8,6,10,27,30,-3,30
Vienna,29,5,7,6,11,25,38,-13,27
Mattersburg,29,6,6,7,11,30,40,-10,25
SC Rheindorf,29,7,4,6,14,19,32,-13,18
FC Salzburg,30,1,14,8,2,45,18,27,50
SK Sturm Gra,30,2,12,5,7,32,28,4,41
LASK Linz,30,3,10,5,9,31,27,4,35
Rapid Vienna,30,4,7,12,5,33,28,5,33
Vienna,30,5,7,5,12,26,40,-14,26
SC Rheindorf,30,6,5,7,12,18,29,-11,22
Mattersburg,30,7,5,6,13,27,42,-15,21
FC Salzburg,31,1,15,6,3,45,19,26,51
SK Sturm Gra,31,2,14,3,7,35,26,9,45
Rapid Vienna,31,3,8,9,7,35,30,5,33
LASK Linz,31,4,8,7,9,28,29,-1,31
Vienna,31,5,7,5,12,26,39,-13,26
Mattersburg,31,6,6,6,12,29,43,-14,24
SC Rheindorf,31,7,5,6,13,20,32,-12,21
FC Salzburg,32,1,13,8,3,41,19,22,47
SK Sturm Gra,32,2,12,5,7,31,28,3,41
Rapid Vienna,32,3,9,9,6,40,28,12,36
LASK Linz,32,4,8,7,9,27,28,-1,31
Vienna,32,5,7,5,12,25,38,-13,26
Mattersburg,32,6,6,7,11,30,40,-10,25
SC Rheindorf,32,7,6,5,13,18,31,-13,23
FC Salzburg,33,1,14,8,2,44,18,26,50
SK Sturm Gra,33,2,11,4,9,33,33,0,37
Rapid Vienna,33,3,8,11,5,38,29,9,35
LASK Linz,33,4,9,6,9,29,30,-1,33
Mattersburg,33,5,7,6,11,35,44,-9,27
Vienna,33,6,6,7,11,28,42,-14,25
SC Rheindorf,33,7,4,8,12,19,30,-11,20
FC Salzburg,34,1,15,6,3,45,17,28,51
Rapid Vienna,34,2,10,10,4,38,26,12,40
SK Sturm Gra,34,3,12,3,9,31,30,1,39
LASK Linz,34,4,8,6,10,30,32,-2,30
Mattersburg,34,5,6,7,11,30,40,-10,25
Vienna,34,6,6,6,12,24,41,-17,24
SC Rheindorf,34,7,5,6,13,18,30,-12,21
FC Salzburg,35,1,14,7,3,44,20,24,49
SK Sturm Gra,35,2,13,5,6,35,29,6,44
Rapid Vienna,35,3,9,10,5,36,27,9,37
LASK Linz,35,4,9,6,9,28,27,1,33
Vienna,35,5,6,7,11,26,40,-14,25
Mattersburg,35,6,6,6,12,33,44,-11,24
SC Rheindorf,35,7,4,5,15,17,32,-15,17
FC Salzburg,36,1,15,7,2,49,18,31,52
SK Sturm Gra,36,2,13,3,8,36,29,7,42
Rapid Vienna,36,3,9,11,4,39,28,11,38
LASK Linz,36,4,8,6,10,25,31,-6,30
Mattersburg,36,5,6,6,12,27,42,-15,24
Vienna,36,6,6,5,13,23,40,-17,23
SC Rheindorf,36,7,5,6,13,19,30,-11,21
FC Salzburg,37,1,14,7,3,47,20,27,49
SK Sturm Gra,37,2,12,3,9,32,30,2,39
Rapid Vienna,37,3,9,10,5,37,27,10,37
LASK Linz,37,4,9,5,10,29,33,-4,32
Vienna,37,5,8,5,11,28,39,-11,29
Mattersburg,37,6,7,5,12,35,44,-9,26
SC Rheindorf,37,7,5,5,14,20,35,-15,20
FC Salzburg,38,1,14,7,3,45,18,27,49
SK Sturm Gra,38,2,13,3,8,33,28,5,42
Rapid Vienna,38,3,10,10,4,37,26,11,40
LASK Linz,38,4,8,5,11,28,31,-3,29
Mattersburg,38,5,6,6,12,31,44,-13,24
Vienna,38,6,6,6,12,25,41,-16,24
SC Rheindorf,38,7,6,5,13,20,31,-11,23
FC Salzburg,39,1,15,7,2,42,15,27,52
SK Sturm Gra,39,2,12,5,7,34,30,4,41
Rapid Vienna,39,3,8,10,6,35,28,7,34
LASK Linz,39,4,8,5,11,29,33,-4,29
Mattersburg,39,5,7,6,11,35,41,-6,27
Vienna,39,6,6,6,12,24,41,-17,24
SC Rheindorf,39,7,5,7,12,19,30,-11,22
FC Salzburg,40,1,15,7,2,48,19,29,52
SK Sturm Gra,40,2,12,4,8,35,33,2,40
Rapid Vienna,40,3,8,10,6,36,30,6,34
LASK Linz,40,4,8,6,10,27,31,-4,30
Vienna,40,5,7,5,12,27,39,-12,26
SC Rheindorf,40,6,6,6,12,19,27,-8,24
Mattersburg,40,7,6,6,12,30,43,-13,24
FC Salzburg,41,1,14,7,3,43,19,24,49
SK Sturm Gra,41,2,12,5,7,34,31,3,41
Rapid Vienna,41,3,9,9,6,36,28,8,36
LASK Linz,41,4,8,6,10,27,31,-4,30
Vienna,41,5,8,5,11,29,39,-10,29
Mattersburg,41,6,7,6,11,32,40,-8,27
SC Rheindorf,41,7,4,6,14,16,29,-13,18
FC Salzburg,42,1,15,7,2,46,19,27,52
SK Sturm Gra,42,2,11,5,8,31,30,1,38
Rapid Vienna,42,3,8,10,6,35,26,9,34
LASK Linz,42,4,9,6,9,29,28,1,33
SC Rheindorf,42,5,7,5,12,22,30,-8,26
Vienna,42,6,7,5,12,28,43,-15,26
Mattersburg,42,7,5,6,13,31,46,-15,21
FC Salzburg,43,1,13,9,2,42,16,26,48
SK Sturm Gra,43,2,12,5,7,33,27,6,41
Rapid Vienna,43,3,8,10,6,34,30,4,34
LASK Linz,43,4,8,6,10,27,28,-1,30
Mattersburg,43,5,7,6,11,30,39,-9,27
Vienna,43,6,7,5,12,25,40,-15,26
SC Rheindorf,43,7,6,5,13,18,29,-11,23
FC Salzburg,44,1,15,6,3,53,21,32,51
SK Sturm Gra,44,2,12,5,7,33,30,3,41
Rapid Vienna,44,3,9,11,4,37,25,12,38
LASK Linz,44,4,7,5,12,26,33,-7,26
Mattersburg,44,5,7,5,12,35,47,-12,26
Vienna,44,6,7,5,12,29,44,-15,26
SC Rheindorf,44,7,5,7,12,20,33,-13,22
FC Salzburg,45,1,14,8,2,46,18,28,50
SK Sturm Gra,45,2,12,4,8,30,29,1,40
Rapid Vienna,45,3,8,10,6,34,28,6,34
LASK Linz,45,4,8,6,10,28,30,-2,30
Vienna,45,5,7,6,11,28,41,-13,27
Mattersburg,45,6,7,5,12,33,44,-11,26
SC Rheindorf,45,7,5,7,12,20,29,-9,22
FC Salzburg,46,1,14,7,3,46,20,26,49
SK Sturm Gra,46,2,13,4,7,34,29,5,43
Rapid Vienna,46,3,8,10,6,36,28,8,34
LASK Linz,46,4,9,6,9,29,28,1,33
Vienna,46,5,7,5,12,29,39,-10,26
Mattersburg,46,6,7,5,12,30,46,-16,26
SC Rheindorf,46,7,5,5,14,16,30,-14,20
FC Salzburg,47,1,14,8,2,46,17,29,50
SK Sturm Gra,47,2,12,4,8,29,26,3,40
Rapid Vienna,47,3,8,11,5,34,26,8,35
LASK Linz,47,4,9,6,9,27,28,-1,33
Vienna,47,5,7,5,12,25,42,-17,26
SC Rheindorf,47,6,5,7,12,20,29,-9,22
Mattersburg,47,7,5,7,12,27,40,-13,22
FC Salzburg,48,1,16,6,2,45,17,28,54
SK Sturm Gra,48,2,13,3,8,33,28,5,42
Rapid Vienna,48,3,7,9,8,32,30,2,30
LASK Linz,48,4,8,6,10,28,31,-3,30
Mattersburg,48,5,7,6,11,33,41,-8,27
SC Rheindorf,48,6,7,5,12,23,30,-7,26
Vienna,48,7,6,5,13,24,41,-17,23
FC Salzburg,49,1,16,6,2,45,17,28,54
SK Sturm Gra,49,2,11,5,8,33,32,1,38
LASK Linz,49,3,10,5,9,33,28,5,35
Rapid Vienna,49,4,7,10,7,34,32,2,31
Mattersburg,49,5,7,6,11,30,40,-10,27
Vienna,49,6,6,5,13,23,39,-16,23
SC Rheindorf,49,7,5,7,12,21,31,-10,22
FC Salzburg,50,1,15,7,2,45,17,28,52
SK Sturm Gra,50,2,12,3,9,31,34,-3,39
Rapid Vienna,50,3,9,10,5,38,30,8,37
LASK Linz,50,4,9,6,9,30,27,3,33
Vienna,50,5,7,5,12,26,40,-14,26
Mattersburg,50,6,6,6,12,30,43,-13,24
SC Rheindorf,50,7,5,5,14,20,29,-9,20
FC Salzburg,51,1,14,7,3,44,20,24,49
SK Sturm Gra,51,2,12,4,8,34,30,4,40
Rapid Vienna,51,3,8,12,4,34,25,9,36
Vienna,51,4,8,5,11,26,38,-12,29
LASK Linz,51,5,7,6,11,25,32,-7,27
SC Rheindorf,51,6,6,7,11,20,26,-6,25
Mattersburg,51,7,5,7,12,30,42,-12,22
FC Salzburg,52,1,15,6,3,43,17,26,51
SK Sturm Gra,52,2,14,4,6,36,27,9,46
Rapid Vienna,52,3,8,9,7,33,28,5,33
LASK Linz,52,4,8,7,9,27,29,-2,31
Vienna,52,5,7,5,12,25,38,-13,26
SC Rheindorf,52,6,6,5,13,20,30,-10,23
Mattersburg,52,7,5,6,13,27,42,-15,21
FC Salzburg,53,1,14,7,3,43,19,24,49
SK Sturm Gra,53,2,11,4,9,33,34,-1,37
Rapid Vienna,53,3,8,9,7,37,32,5,33
LASK Linz,53,4,9,6,9,32,30,2,33
Mattersburg,53,5,8,5,11,37,42,-5,29
SC Rheindorf,53,6,7,5,12,23,32,-9,26
Vienna,53,7,6,6,12,25,41,-16,24
FC Salzburg,54,1,14,8,2,44,16,28,50
SK Sturm Gra,54,2,13,4,7,34,25,9,43
Rapid Vienna,54,3,8,10,6,32,26,6,34
LASK Linz,54,4,8,5,11,27,31,-4,29
SC Rheindorf,54,5,7,5,12,20,30,-10,26
Vienna,54,6,7,5,12,27,41,-14,26
Mattersburg,54,7,6,5,13,30,45,-15,23
FC Salzburg,55,1,15,7,2,51,17,34,52
SK Sturm Gra,55,2,12,4,8,38,37,1,40
Rapid Vienna,55,3,9,11,4,39,27,12,38
LASK Linz,55,4,9,5,10,29,29,0,32
SC Rheindorf,55,5,6,5,13,20,34,-14,23
Mattersburg,55,6,6,5,13,29,44,-15,23
Vienna,55,7,6,5,13,24,42,-18,23
FC Salzburg,56,1,14,6,4,44,23,21,48
SK Sturm Gra,56,2,13,5,6,35,28,7,44
Rapid Vienna,56,3,8,10,6,36,27,9,34
Mattersburg,56,4,8,5,11,34,42,-8,29
LASK Linz,56,5,7,7,10,29,33,-4,28
Vienna,56,6,7,5,12,26,39,-13,26
SC Rheindorf,56,7,5,6,13,20,32,-12,21
FC Salzburg,57,1,15,7,2,47,17,30,52
SK Sturm Gra,57,2,12,4,8,32,29,3,40
LASK Linz,57,3,9,6,9,28,30,-2,33
Rapid Vienna,57,4,7,10,7,32,31,1,31
Vienna,57,5,7,5,12,27,42,-15,26
Mattersburg,57,6,6,7,11,33,44,-11,25
SC Rheindorf,57,7,6,5,13,24,30,-6,23
FC Salzburg,58,1,14,8,2,45,18,27,50
SK Sturm Gra,58,2,14,4,6,37,28,9,46
Rapid Vienna,58,3,8,10,6,35,29,6,34
LASK Linz,58,4,9,5,10,27,29,-2,32
Mattersburg,58,5,8,5,11,31,41,-10,29
Vienna,58,6,6,5,13,24,40,-16,23
SC Rheindorf,58,7,4,5,15,18,32,-14,17
FC Salzburg,59,1,16,6,2,48,16,32,54
SK Sturm Gra,59,2,14,3,7,36,31,5,45
Rapid Vienna,59,3,7,11,6,33,28,5,32
LASK Linz,59,4,8,7,9,29,30,-1,31
Vienna,59,5,7,5,12,24,39,-15,26
Mattersburg,59,6,6,5,13,32,44,-12,23
SC Rheindorf,59,7,4,7,13,19,33,-14,19
FC Salzburg,60,1,13,9,2,45,20,25,48
SK Sturm Gra,60,2,13,3,8,35,33,2,42
Rapid Vienna,60,3,7,12,5,38,31,7,33
LASK Linz,60,4,9,6,9,27,28,-1,33
SC Rheindorf,60,5,6,6,12,23,29,-6,24
Mattersburg,60,6,6,6,12,29,40,-11,24
Vienna,60,7,6,6,12,25,41,-16,24
FC Salzburg,61,1,15,7,2,48,16,32,52
SK Sturm Gra,61,2,12,5,7,32,30,2,41
LASK Linz,61,3,10,5,9,30,28,2,35
Rapid Vienna,61,4,7,11,6,33,29,4,32
Mattersburg,61,5,7,6,11,35,42,-7,27
Vienna,61,6,6,5,13,27,46,-19,23
SC Rheindorf,61,7,4,7,13,21,35,-14,19
FC Salzburg,62,1,14,7,3,43,20,23,49
SK Sturm Gra,62,2,14,4,6,38,27,11,46
Rapid Vienna,62,3,7,10,7,33,29,4,31
LASK Linz,62,4,8,7,9,30,31,-1,31
Mattersburg,62,5,7,6,11,33,41,-8,27
Vienna,62,6,7,5,12,28,40,-12,26
SC Rheindorf,62,7,4,7,13,18,35,-17,19
FC Salzburg,63,1,14,8,2,44,17,27,50
SK Sturm Gra,63,2,12,4,8,31,30,1,40
LASK Linz,63,3,10,5,9,33,29,4,35
Rapid Vienna,63,4,8,10,6,35,28,7,34
Mattersburg,63,5,7,6,11,35,42,-7,27
Vienna,63,6,6,6,12,25,41,-16,24
SC Rheindorf,63,7,5,5,14,18,34,-16,20
FC Salzburg,64,1,15,6,3,49,18,31,51
SK Sturm Gra,64,2,14,3,7,33,26,7,45
LASK Linz,64,3,10,5,9,28,28,0,35
Rapid Vienna,64,4,7,10,7,32,29,3,31
Mattersburg,64,5,8,5,11,37,44,-7,29
Vienna,64,6,6,5,13,26,44,-18,23
SC Rheindorf,64,7,4,6,14,16,32,-16,18
FC Salzburg,65,1,15,7,2,49,17,32,52
Rapid Vienna,65,2,9,10,5,34,27,7,37
SK Sturm Gra,65,3,11,4,9,28,28,0,37
LASK Linz,65,4,8,5,11,26,32,-6,29
Vienna,65,5,7,5,12,25,42,-17,26
Mattersburg,65,6,6,7,11,37,45,-8,25
SC Rheindorf,65,7,6,6,12,22,30,-8,24
FC Salzburg,66,1,14,7,3,46,20,26,49
SK Sturm Gra,66,2,13,4,7,35,29,6,43
Rapid Vienna,66,3,10,9,5,37,28,9,39
Vienna,66,4,8,5,11,25,37,-12,29
LASK Linz,66,5,7,7,10,26,29,-3,28
SC Rheindorf,66,6,5,6,13,18,29,-11,21
Mattersburg,66,7,5,6,13,27,42,-15,21
FC Salzburg,67,1,14,6,4,43,18,25,48
SK Sturm Gra,67,2,12,4,8,32,30,2,40
LASK Linz,67,3,10,6,8,27,25,2,36
Rapid Vienna,67,4,8,9,7,34,29,5,33
Vienna,67,5,7,6,11,26,38,-12,27
Mattersburg,67,6,6,8,10,29,38,-9,26
SC Rheindorf,67,7,4,7,13,16,29,-13,19
FC Salzburg,68,1,15,6,3,44,17,27,51
Rapid Vienna,68,2,11,9,4,41,24,17,42
SK Sturm Gra,68,3,12,3,9,30,33,-3,39
LASK Linz,68,4,8,5,11,27,31,-4,29
SC Rheindorf,68,5,7,5,12,22,29,-7,26
Vienna,68,6,7,5,12,29,42,-13,26
Mattersburg,68,7,5,5,14,31,48,-17,20
FC Salzburg,69,1,13,7,4,42,20,22,46
SK Sturm Gra,69,2,13,5,6,35,28,7,44
Rapid Vienna,69,3,8,10,6,36,28,8,34
LASK Linz,69,4,7,7,10,26,33,-7,28
Mattersburg,69,5,7,7,10,31,39,-8,28
SC Rheindorf,69,6,6,6,12,21,28,-7,24
Vienna,69,7,6,6,12,26,41,-15,24
FC Salzburg,70,1,15,6,3,49,23,26,51
Rapid Vienna,70,2,9,10,5,38,30,8,37
SK Sturm Gra,70,3,11,4,9,32,32,0,37
LASK Linz,70,4,8,7,9,26,27,-1,31
SC Rheindorf,70,5,8,5,11,25,29,-4,29
Mattersburg,70,6,6,5,13,31,43,-12,23
Vienna,70,7,6,5,13,26,43,-17,23
FC Salzburg,71,1,15,6,3,49,21,28,51
SK Sturm Gra,71,2,11,5,8,34,33,1,38
Rapid Vienna,71,3,9,10,5,40,32,8,37
Vienna,71,4,8,5,11,26,38,-12,29
LASK Linz,71,5,7,6,11,28,32,-4,27
SC Rheindorf,71,6,7,5,12,24,31,-7,26
Mattersburg,71,7,6,5,13,30,44,-14,23
FC Salzburg,72,1,14,7,3,42,17,25,49
Rapid Vienna,72,2,10,9,5,38,25,13,39
SK Sturm Gra,72,3,12,3,9,33,32,1,39
LASK Linz,72,4,8,5,11,25,31,-6,29
SC Rheindorf,72,5,7,5,12,21,29,-8,26
Vienna,72,6,6,7,11,25,39,-14,25
Mattersburg,72,7,6,6,12,32,43,-11,24
FC Salzburg,73,1,14,7,3,45,18,27,49
Rapid Vienna,73,2,10,10,4,40,28,12,40
SK Sturm Gra,73,3,11,3,10,32,36,-4,36
LASK Linz,73,4,8,7,9,26,28,-2,31
Mattersburg,73,5,6,7,11,29,40,-11,25
SC Rheindorf,73,6,6,6,12,23,30,-7,24
Vienna,73,7,6,6,12,26,41,-15,24
FC Salzburg,74,1,15,7,2,46,18,28,52
SK Sturm Gra,74,2,12,4,8,33,30,3,40
Rapid Vienna,74,3,8,11,5,33,24,9,35
LASK Linz,74,4,7,8,9,25,29,-4,29
Mattersburg,74,5,6,7,11,32,42,-10,25
SC Rheindorf,74,6,5,8,11,18,27,-9,23
Vienna,74,7,6,5,13,25,42,-17,23
FC Salzburg,75,1,16,6,2,48,19,29,54
SK Sturm Gra,75,2,12,5,7,35,30,5,41
Rapid Vienna,75,3,8,10,6,34,27,7,34
LASK Linz,75,4,8,6,10,27,31,-4,30
Vienna,75,5,7,5,12,27,42,-15,26
Mattersburg,75,6,6,6,12,33,44,-11,24
SC Rheindorf,75,7,5,6,13,16,27,-11,21
FC Salzburg,76,1,15,7,2,51,18,33,52
SK Sturm Gra,76,2,12,5,7,32,30,2,41
Rapid Vienna,76,3,7,12,5,35,30,5,33
LASK Linz,76,4,8,5,11,28,32,-4,29
Vienna,76,5,7,5,12,26,44,-18,26
SC Rheindorf,76,6,6,7,11,20,27,-7,25
Mattersburg,76,7,6,5,13,32,43,-11,23
FC Salzburg,77,1,16,6,2,51,18,33,54
SK Sturm Gra,77,2,13,3,8,34,31,3,42
Rapid Vienna,77,3,9,10,5,39,27,12,37
LASK Linz,77,4,9,6,9,29,29,0,33
Mattersburg,77,5,7,5,12,33,43,-10,26
Vienna,77,6,6,5,13,25,44,-19,23
SC Rheindorf,77,7,4,5,15,16,35,-19,17
FC Salzburg,78,1,15,6,3,45,17,28,51
SK Sturm Gra,78,2,13,4,7,35,28,7,43
Rapid Vienna,78,3,9,10,5,33,24,9,37
LASK Linz,78,4,9,5,10,27,29,-2,32
Mattersburg,78,5,6,6,12,31,42,-11,24
Vienna,78,6,6,6,12,24,40,-16,24
SC Rheindorf,78,7,5,5,14,17,32,-15,20
FC Salzburg,79,1,14,7,3,43,19,24,49
SK Sturm Gra,79,2,12,4,8,34,30,4,40
Rapid Vienna,79,3,10,9,5,39,29,10,39
LASK Linz,79,4,9,5,10,30,30,0,32
Mattersburg,79,5,7,6,11,31,40,-9,27
Vienna,79,6,6,6,12,24,39,-15,24
SC Rheindorf,79,7,4,7,13,17,31,-14,19
FC Salzburg,80,1,14,8,2,48,19,29,50
SK Sturm Gra,80,2,12,4,8,34,34,0,40
Rapid Vienna,80,3,8,12,4,37,26,11,36
LASK Linz,80,4,7,7,10,28,31,-3,28
Vienna,80,5,7,6,11,29,41,-12,27
SC Rheindorf,80,6,5,8,11,22,30,-8,23
Mattersburg,80,7,6,5,13,31,48,-17,23
FC Salzburg,81,1,16,6,2,47,18,29,54
SK Sturm Gra,81,2,11,6,7,35,32,3,39
Rapid Vienna,81,3,9,10,5,39,28,11,37
LASK Linz,81,4,7,7,10,25,28,-3,28
Mattersburg,81,5,6,7,11,32,43,-11,25
Vienna,81,6,6,5,13,25,42,-17,23
SC Rheindorf,81,7,5,7,12,20,32,-12,22
FC Salzburg,82,1,14,6,4,42,19,23,48
Rapid Vienna,82,2,10,9,5,37,28,9,39
SK Sturm Gra,82,3,12,3,9,33,31,2,39
LASK Linz,82,4,10,5,9,30,27,3,35
Vienna,82,5,8,5,11,29,37,-8,29
SC Rheindorf,82,6,5,6,13,17,28,-11,21
Mattersburg,82,7,5,6,13,26,44,-18,21
FC Salzburg,83,1,14,7,3,52,20,32,49
SK Sturm Gra,83,2,13,4,7,33,28,5,43
Rapid Vienna,83,3,9,10,5,37,27,10,37
LASK Linz,83,4,8,7,9,29,30,-1,31
Mattersburg,83,5,7,6,11,36,47,-11,27
Vienna,83,6,6,5,13,25,47,-22,23
SC Rheindorf,83,7,5,5,14,19,32,-13,20
FC Salzburg,84,1,13,6,5,46,25,21,45
Rapid Vienna,84,2,11,9,4,40,27,13,42
SK Sturm Gra,84,3,11,4,9,30,31,-1,37
LASK Linz,84,4,9,5,10,31,29,2,32
Vienna,84,5,8,5,11,32,39,-7,29
Mattersburg,84,6,7,6,11,32,45,-13,27
SC Rheindorf,84,7,4,7,13,19,34,-15,19
FC Salzburg,85,1,15,7,2,50,18,32,52
SK Sturm Gra,85,2,12,6,6,32,27,5,42
Rapid Vienna,85,3,9,10,5,37,27,10,37
LASK Linz,85,4,7,7,10,27,30,-3,28
Vienna,85,5,7,5,12,27,42,-15,26
SC Rheindorf,85,6,5,7,12,19,29,-10,22
Mattersburg,85,7,5,6,13,28,47,-19,21
FC Salzburg,86,1,15,7,2,52,18,34,52
Rapid Vienna,86,2,9,11,4,38,28,10,38
SK Sturm Gra,86,3,11,5,8,29,29,0,38
LASK Linz,86,4,7,7,10,27,30,-3,28
Mattersburg,86,5,7,6,11,31,44,-13,27
SC Rheindorf,86,6,6,5,13,23,32,-9,23
Vienna,86,7,6,5,13,24,43,-19,23
FC Salzburg,87,1,15,6,3,54,18,36,51
Rapid Vienna,87,2,10,10,4,36,24,12,40
SK Sturm Gra,87,3,11,6,7,30,31,-1,39
LASK Linz,87,4,8,7,9,27,28,-1,31
Vienna,87,5,6,5,13,23,40,-17,23
Mattersburg,87,6,6,5,13,29,48,-19,23
SC Rheindorf,87,7,5,7,12,21,31,-10,22
FC Salzburg,88,1,14,8,2,47,18,29,50
SK Sturm Gra,88,2,12,6,6,36,29,7,42
Rapid Vienna,88,3,8,11,5,37,33,4,35
LASK Linz,88,4,7,6,11,26,33,-7,27
Vienna,88,5,7,5,12,26,39,-13,26
Mattersburg,88,6,6,7,11,31,41,-10,25
SC Rheindorf,88,7,5,7,12,21,31,-10,22
FC Salzburg,89,1,14,7,3,47,18,29,49
SK Sturm Gra,89,2,13,4,7,33,31,2,43
Rapid Vienna,89,3,8,10,6,38,31,7,34
LASK Linz,89,4,7,7,10,26,30,-4,28
Vienna,89,5,7,6,11,25,38,-13,27
SC Rheindorf,89,6,6,6,12,19,28,-9,24
Mattersburg,89,7,6,6,12,29,41,-12,24
FC Salzburg,90,1,14,8,2,46,18,28,50
SK Sturm Gra,90,2,12,4,8,34,31,3,40
Rapid Vienna,90,3,7,11,6,36,31,5,32
LASK Linz,90,4,8,7,9,28,29,-1,31
Mattersburg,90,5,7,6,11,30,39,-9,27
SC Rheindorf,90,6,7,5,12,20,28,-8,26
Vienna,90,7,6,5,13,25,43,-18,23
FC Salzburg,91,1,13,8,3,41,17,24,47
Rapid Vienna,91,2,11,9,4,40,25,15,42
SK Sturm Gra,91,3,11,4,9,32,37,-5,37
LASK Linz,91,4,8,5,11,29,32,-3,29
Mattersburg,91,5,7,6,11,32,40,-8,27
Vienna,91,6,6,7,11,23,37,-14,25
SC Rheindorf,91,7,6,5,13,24,33,-9,23
FC Salzburg,92,1,13,8,3,42,19,23,47
SK Sturm Gra,92,2,12,5,7,29,26,3,41
Rapid Vienna,92,3,10,10,4,42,26,16,40
LASK Linz,92,4,8,5,11,29,35,-6,29
SC Rheindorf,92,5,6,6,12,20,28,-8,24
Mattersburg,92,6,6,6,12,31,42,-11,24
Vienna,92,7,6,6,12,24,41,-17,24
FC Salzburg,93,1,14,7,3,43,17,26,49
SK Sturm Gra,93,2,13,4,7,36,30,6,43
Rapid Vienna,93,3,9,10,5,37,29,8,37
LASK Linz,93,4,8,7,9,27,28,-1,31
Vienna,93,5,7,5,12,26,40,-14,26
SC Rheindorf,93,6,5,7,12,22,32,-10,22
Mattersburg,93,7,5,6,13,29,44,-15,21
FC Salzburg,94,1,14,8,2,49,24,25,50
SK Sturm Gra,94,2,14,3,7,34,27,7,45
Rapid Vienna,94,3,8,9,7,33,28,5,33
LASK Linz,94,4,8,6,10,29,31,-2,30
Mattersburg,94,5,6,7,11,33,42,-9,25
Vienna,94,6,6,6,12,27,43,-16,24
SC Rheindorf,94,7,5,7,12,20,30,-10,22
FC Salzburg,95,1,15,7,2,43,16,27,52
SK Sturm Gra,95,2,13,3,8,34,28,6,42
Rapid Vienna,95,3,9,9,6,37,31,6,36
Vienna,95,4,7,6,11,25,37,-12,27
SC Rheindorf,95,5,7,5,12,23,28,-5,26
LASK Linz,95,6,7,5,12,26,36,-10,26
Mattersburg,95,7,6,5,13,30,42,-12,23
FC Salzburg,96,1,16,6,2,46,19,27,54
SK Sturm Gra,96,2,12,3,9,33,29,4,39
Rapid Vienna,96,3,8,10,6,35,28,7,34
LASK Linz,96,4,8,7,9,26,29,-3,31
Mattersburg,96,5,6,7,11,31,40,-9,25
SC Rheindorf,96,6,5,8,11,19,28,-9,23
Vienna,96,7,6,5,13,23,40,-17,23
FC Salzburg,97,1,14,6,4,45,19,26,48
SK Sturm Gra,97,2,14,3,7,34,28,6,45
LASK Linz,97,3,10,5,9,34,30,4,35
Rapid Vienna,97,4,8,9,7,36,33,3,33
Vienna,97,5,7,5,12,25,40,-15,26
SC Rheindorf,97,6,6,5,13,21,32,-11,23
Mattersburg,97,7,6,5,13,32,45,-13,23
FC Salzburg,98,1,14,6,4,48,22,26,48
SK Sturm Gra,98,2,13,4,7,33,30,3,43
Rapid Vienna,98,3,7,11,6,36,32,4,32
Mattersburg,98,4,9,5,10,34,38,-4,32
LASK Linz,98,5,8,6,10,26,28,-2,30
Vienna,98,6,7,5,12,26,40,-14,26
SC Rheindorf,98,7,5,5,14,18,31,-13,20
FC Salzburg,99,1,15,6,3,45,19,26,51
SK Sturm Gra,99,2,12,5,7,33,29,4,41
Rapid Vienna,99,3,8,10,6,33,27,6,34
LASK Linz,99,4,8,6,10,29,31,-2,30
Vienna,99,5,7,6,11,27,40,-13,27
SC Rheindorf,99,6,6,6,12,21,28,-7,24
Mattersburg,99,7,5,7,12,30,44,-14,22
FC Salzburg,100,1,14,8,2,45,17,28,50
SK Sturm Gra,100,2,12,5,7,32,27,5,41
Rapid Vienna,100,3,8,10,6,32,27,5,34
LASK Linz,100,4,7,6,11,24,29,-5,27
SC Rheindorf,100,5,7,6,11,21,27,-6,27
Vienna,100,6,7,6,11,27,40,-13,27
Mattersburg,100,7,6,5,13,29,43,-14,23
FC Salzburg,101,1,15,7,2,45,17,28,52
SK Sturm Gra,101,2,13,5,6,34,27,7,44
Rapid Vienna,101,3,7,11,6,32,27,5,32
LASK Linz,101,4,7,7,10,27,33,-6,28
Mattersburg,101,5,7,5,12,32,41,-9,26
Vienna,101,6,7,5,12,26,39,-13,26
SC Rheindorf,101,7,5,6,13,18,30,-12,21
FC Salzburg,102,1,14,7,3,47,20,27,49
SK Sturm Gra,102,2,14,3,7,34,30,4,45
Rapid Vienna,102,3,9,9,6,35,28,7,36
LASK Linz,102,4,9,6,9,32,29,3,33
Vienna,102,5,6,7,11,24,38,-14,25
Mattersburg,102,6,5,7,12,28,42,-14,22
SC Rheindorf,102,7,4,7,13,16,29,-13,19
FC Salzburg,103,1,15,6,3,49,22,27,51
SK Sturm Gra,103,2,14,3,7,35,30,5,45
Rapid Vienna,103,3,9,10,5,38,26,12,37
LASK Linz,103,4,9,5,10,31,34,-3,32
Mattersburg,103,5,7,5,12,35,44,-9,26
Vienna,103,6,6,5,13,23,40,-17,23
SC Rheindorf,103,7,4,6,14,19,34,-15,18
FC Salzburg,104,1,15,6,3,48,18,30,51
SK Sturm Gra,104,2,14,4,6,37,25,12,46
Rapid Vienna,104,3,9,9,6,38,32,6,36
Mattersburg,104,4,7,6,11,32,42,-10,27
LASK Linz,104,5,7,5,12,24,30,-6,26
Vienna,104,6,6,6,12,24,41,-17,24
SC Rheindorf,104,7,5,6,13,18,33,-15,21
FC Salzburg,105,1,15,6,3,44,19,25,51
SK Sturm Gra,105,2,14,3,7,37,27,10,45
LASK Linz,105,3,10,5,9,28,30,-2,35
Rapid Vienna,105,4,8,9,7,38,29,9,33
Mattersburg,105,5,7,6,11,32,41,-9,27
Vienna,105,6,6,5,13,23,40,-17,23
SC Rheindorf,105,7,4,6,14,15,31,-16,18
FC Salzburg,106,1,15,6,3,48,19,29,51
SK Sturm Gra,106,2,13,4,7,34,32,2,43
Rapid Vienna,106,3,8,9,7,38,33,5,33
LASK Linz,106,4,9,5,10,31,31,0,32
Vienna,106,5,7,5,12,27,42,-15,26
SC Rheindorf,106,6,6,6,12,20,29,-9,24
Mattersburg,106,7,6,5,13,32,44,-12,23
FC Salzburg,107,1,15,7,2,47,21,26,52
SK Sturm Gra,107,2,14,3,7,39,29,10,45
Rapid Vienna,107,3,8,9,7,36,30,6,33
LASK Linz,107,4,9,6,9,28,29,-1,33
Vienna,107,5,7,6,11,27,40,-13,27
Mattersburg,107,6,5,6,13,29,43,-14,21
SC Rheindorf,107,7,5,5,14,19,33,-14,20
FC Salzburg,108,1,16,6,2,48,16,32,54
SK Sturm Gra,108,2,12,4,8,31,28,3,40
Rapid Vienna,108,3,8,10,6,33,28,5,34
LASK Linz,108,4,7,6,11,30,35,-5,27
SC Rheindorf,108,5,7,5,12,20,32,-12,26
Vienna,108,6,7,5,12,26,41,-15,26
Mattersburg,108,7,6,6,12,36,44,-8,24
FC Salzburg,109,1,14,7,3,42,18,24,49
SK Sturm Gra,109,2,12,4,8,31,28,3,40
Rapid Vienna,109,3,9,11,4,38,25,13,38
LASK Linz,109,4,8,7,9,25,27,-2,31
Vienna,109,5,7,5,12,26,40,-14,26
SC Rheindorf,109,6,6,6,12,20,31,-11,24
Mattersburg,109,7,5,6,13,30,43,-13,21
FC Salzburg,110,1,14,8,2,47,19,28,50
SK Sturm Gra,110,2,13,3,8,30,28,2,42
Rapid Vienna,110,3,8,10,6,37,27,10,34
LASK Linz,110,4,9,6,9,29,29,0,33
Vienna,110,5,7,6,11,26,39,-13,27
SC Rheindorf,110,6,5,7,12,18,31,-13,22
Mattersburg,110,7,5,6,13,28,42,-14,21
FC Salzburg,111,1,12,9,3,41,19,22,45
SK Sturm Gra,111,2,12,5,7,31,28,3,41
Rapid Vienna,111,3,10,9,5,36,26,10,39
LASK Linz,111,4,8,7,9,29,29,0,31
Vienna,111,5,6,7,11,24,38,-14,25
Mattersburg,111,6,5,9,10,28,38,-10,24
SC Rheindorf,111,7,4,8,12,17,28,-11,20
FC Salzburg,112,1,15,7,2,47,17,30,52
SK Sturm Gra,112,2,12,6,6,33,28,5,42
Rapid Vienna,112,3,8,10,6,37,30,7,34
LASK Linz,112,4,8,5,11,32,34,-2,29
Vienna,112,5,7,5,12,27,40,-13,26
SC Rheindorf,112,6,6,6,12,20,31,-11,24
Mattersburg,112,7,6,5,13,29,45,-16,23
FC Salzburg,113,1,14,6,4,45,19,26,48
SK Sturm Gra,113,2,13,4,7,35,27,8,43
Rapid Vienna,113,3,8,9,7,35,31,4,33
LASK Linz,113,4,8,6,10,26,29,-3,30
Vienna,113,5,8,5,11,25,37,-12,29
SC Rheindorf,113,6,6,6,12,18,29,-11,24
Mattersburg,113,7,6,6,12,29,41,-12,24
FC Salzburg,114,1,14,7,3,45,20,25,49
SK Sturm Gra,114,2,11,5,8,30,30,0,38
Rapid Vienna,114,3,7,12,5,33,26,7,33
LASK Linz,114,4,7,8,9,26,28,-2,29
Vienna,114,5,8,5,11,28,40,-12,29
SC Rheindorf,114,6,7,5,12,24,31,-7,26
Mattersburg,114,7,6,6,12,36,47,-11,24
FC Salzburg,115,1,13,8,3,42,19,23,47
SK Sturm Gra,115,2,13,3,8,32,27,5,42
Rapid Vienna,115,3,8,10,6,36,29,7,34
LASK Linz,115,4,9,5,10,28,30,-2,32
Vienna,115,5,8,5,11,27,38,-11,29
Mattersburg,115,6,6,6,12,31,42,-11,24
SC Rheindorf,115,7,6,5,13,18,29,-11,23
FC Salzburg,116,1,15,6,3,48,21,27,51
SK Sturm Gra,116,2,12,4,8,33,29,4,40
Rapid Vienna,116,3,9,10,5,35,25,10,37
LASK Linz,116,4,8,7,9,27,27,0,31
SC Rheindorf,116,5,6,7,11,19,26,-7,25
Mattersburg,116,6,6,5,13,33,48,-15,23
Vienna,116,7,6,5,13,24,43,-19,23
FC Salzburg,117,1,13,8,3,43,20,23,47
SK Sturm Gra,117,2,13,4,7,35,30,5,43
Rapid Vienna,117,3,10,9,5,38,26,12,39
LASK Linz,117,4,9,5,10,30,34,-4,32
Vienna,117,5,7,6,11,26,39,-13,27
Mattersburg,117,6,6,5,13,31,40,-9,23
SC Rheindorf,117,7,5,5,14,17,31,-14,20
FC Salzburg,118,1,16,6,2,47,15,32,54
SK Sturm Gra,118,2,12,4,8,31,28,3,40
LASK Linz,118,3,10,6,8,28,26,2,36
Rapid Vienna,118,4,7,10,7,32,30,2,31
Vienna,118,5,7,5,12,26,38,-12,26
SC Rheindorf,118,6,5,7,12,18,28,-10,22
Mattersburg,118,7,5,6,13,29,46,-17,21
FC Salzburg,119,1,15,6,3,48,21,27,51
SK Sturm Gra,119,2,13,4,7,35,30,5,43
Rapid Vienna,119,3,8,9,7,35,29,6,33
LASK Linz,119,4,8,6,10,26,30,-4,30
Mattersburg,119,5,7,6,11,30,39,-9,27
SC Rheindorf,119,6,6,6,12,19,27,-8,24
Vienna,119,7,6,5,13,23,40,-17,23
FC Salzburg,120,1,14,6,4,44,20,24,48
SK Sturm Gra,120,2,14,3,7,35,27,8,45
Rapid Vienna,120,3,9,10,5,36,27,9,37
LASK Linz,120,4,8,7,9,28,30,-2,31
Vienna,120,5,7,5,12,24,39,-15,26
Mattersburg,120,6,5,7,12,29,42,-13,22
SC Rheindorf,120,7,5,6,13,18,29,-11,21
FC Salzburg,121,1,15,6,3,46,19,27,51
SK Sturm Gra,121,2,12,5,7,32,29,3,41
Rapid Vienna,121,3,8,9,7,34,30,4,33
LASK Linz,121,4,8,7,9,28,30,-2,31
Mattersburg,121,5,6,7,11,32,42,-10,25
SC Rheindorf,121,6,6,6,12,20,27,-7,24
Vienna,121,7,6,6,12,28,43,-15,24
FC Salzburg,122,1,16,6,2,50,19,31,54
SK Sturm Gra,122,2,13,4,7,34,28,6,43
LASK Linz,122,3,9,6,9,28,28,0,33
Rapid Vienna,122,4,7,11,6,34,29,5,32
Vienna,122,5,7,5,12,25,40,-15,26
Mattersburg,122,6,6,5,13,30,45,-15,23
SC Rheindorf,122,7,4,7,13,19,31,-12,19
FC Salzburg,123,1,16,6,2,47,16,31,54
SK Sturm Gra,123,2,13,4,7,33,28,5,43
Rapid Vienna,123,3,7,10,7,34,30,4,31
LASK Linz,123,4,8,6,10,26,29,-3,30
Vienna,123,5,7,5,12,25,40,-15,26
Mattersburg,123,6,6,6,12,30,40,-10,24
SC Rheindorf,123,7,5,7,12,18,30,-12,22
FC Salzburg,124,1,15,7,2,46,17,29,52
SK Sturm Gra,124,2,12,4,8,36,32,4,40
Rapid Vienna,124,3,7,11,6,33,30,3,32
LASK Linz,124,4,8,6,10,28,30,-2,30
SC Rheindorf,124,5,6,7,11,21,29,-8,25
Mattersburg,124,6,5,9,10,31,41,-10,24
Vienna,124,7,6,6,12,25,41,-16,24
FC Salzburg,125,1,14,8,2,43,15,28,50
SK Sturm Gra,125,2,13,3,8,32,29,3,42
Rapid Vienna,125,3,8,11,5,34,27,7,35
LASK Linz,125,4,8,6,10,28,31,-3,30
Vienna,125,5,7,6,11,28,37,-9,27
Mattersburg,125,6,6,6,12,30,46,-16,24
SC Rheindorf,125,7,5,6,13,19,29,-10,21
FC Salzburg,126,1,14,7,3,43,18,25,49
SK Sturm Gra,126,2,13,3,8,33,30,3,42
Rapid Vienna,126,3,9,10,5,37,28,9,37
LASK Linz,126,4,9,6,9,27,27,0,33
Vienna,126,5,6,7,11,25,39,-14,25
Mattersburg,126,6,6,6,12,33,44,-11,24
SC Rheindorf,126,7,5,5,14,20,32,-12,20
FC Salzburg,127,1,15,6,3,46,18,28,51
SK Sturm Gra,127,2,12,4,8,32,30,2,40
Rapid Vienna,127,3,9,10,5,37,27,10,37
LASK Linz,127,4,8,7,9,29,30,-1,31
Vienna,127,5,7,5,12,27,40,-13,26
Mattersburg,127,6,6,5,13,33,48,-15,23
SC Rheindorf,127,7,5,7,12,18,29,-11,22
FC Salzburg,128,1,13,8,3,40,17,23,47
SK Sturm Gra,128,2,11,5,8,28,27,1,38
Rapid Vienna,128,3,9,10,5,34,24,10,37
LASK Linz,128,4,10,6,8,29,25,4,36
Mattersburg,128,5,7,5,12,31,41,-10,26
Vienna,128,6,6,6,12,25,40,-15,24
SC Rheindorf,128,7,4,8,12,16,29,-13,20
FC Salzburg,129,1,13,7,4,42,19,23,46
SK Sturm Gra,129,2,14,3,7,35,28,7,45
Rapid Vienna,129,3,9,10,5,35,26,9,37
LASK Linz,129,4,9,5,10,27,29,-2,32
Vienna,129,5,8,5,11,26,38,-12,29
Mattersburg,129,6,6,5,13,30,43,-13,23
SC Rheindorf,129,7,5,5,14,21,33,-12,20
FC Salzburg,130,1,15,6,3,46,20,26,51
SK Sturm Gra,130,2,13,4,7,34,28,6,43
LASK Linz,130,3,10,5,9,30,26,4,35
Rapid Vienna,130,4,8,9,7,33,33,0,33
SC Rheindorf,130,5,6,6,12,21,26,-5,24
Mattersburg,130,6,6,5,13,30,44,-14,23
Vienna,130,7,6,5,13,25,42,-17,23
FC Salzburg,131,1,14,7,3,45,21,24,49
Rapid Vienna,131,2,10,10,4,41,27,14,40
SK Sturm Gra,131,3,12,4,8,34,30,4,40
LASK Linz,131,4,9,6,9,30,29,1,33
Mattersburg,131,5,7,5,12,32,41,-9,26
Vienna,131,6,6,5,13,24,42,-18,23
SC Rheindorf,131,7,5,5,14,17,33,-16,20
FC Salzburg,132,1,15,7,2,46,17,29,52
SK Sturm Gra,132,2,11,4,9,29,32,-3,37
Rapid Vienna,132,3,9,9,6,37,28,9,36
LASK Linz,132,4,10,5,9,29,26,3,35
Mattersburg,132,5,6,7,11,31,42,-11,25
Vienna,132,6,6,6,12,23,38,-15,24
SC Rheindorf,132,7,5,6,13,17,29,-12,21
FC Salzburg,133,1,14,6,4,45,20,25,48
SK Sturm Gra,133,2,14,3,7,34,28,6,45
Rapid Vienna,133,3,9,10,5,38,29,9,37
LASK Linz,133,4,8,5,11,25,31,-6,29
Mattersburg,133,5,7,5,12,29,39,-10,26
Vienna,133,6,7,5,12,24,38,-14,26
SC Rheindorf,133,7,5,6,13,18,28,-10,21
FC Salzburg,134,1,16,6,2,48,17,31,54
SK Sturm Gra,134,2,13,3,8,30,27,3,42
Rapid Vienna,134,3,8,9,7,33,28,5,33
LASK Linz,134,4,8,5,11,27,29,-2,29
Mattersburg,134,5,6,7,11,28,41,-13,25
SC Rheindorf,134,6,6,6,12,18,27,-9,24
Vienna,134,7,6,6,12,24,39,-15,24
FC Salzburg,135,1,14,7,3,45,18,27,49
SK Sturm Gra,135,2,13,4,7,34,28,6,43
Rapid Vienna,135,3,9,10,5,37,27,10,37
LASK Linz,135,4,8,7,9,28,30,-2,31
Mattersburg,135,5,7,5,12,31,41,-10,26
Vienna,135,6,6,5,13,23,41,-18,23
SC Rheindorf,135,7,5,6,13,17,30,-13,21
FC Salzburg,136,1,15,6,3,44,17,27,51
SK Sturm Gra,136,2,12,3,9,35,34,1,39
Rapid Vienna,136,3,9,10,5,40,28,12,37
LASK Linz,136,4,8,6,10,30,34,-4,30
Vienna,136,5,7,6,11,27,40,-13,27
SC Rheindorf,136,6,7,5,12,23,31,-8,26
Mattersburg,136,7,5,6,13,31,46,-15,21
FC Salzburg,137,1,14,7,3,44,19,25,49
SK Sturm Gra,137,2,12,4,8,31,28,3,40
Rapid Vienna,137,3,7,12,5,32,26,6,33
LASK Linz,137,4,8,6,10,25,29,-4,30
Mattersburg,137,5,8,5,11,32,39,-7,29
SC Rheindorf,137,6,6,6,12,20,28,-8,24
Vienna,137,7,6,6,12,24,39,-15,24
FC Salzburg,138,1,14,8,2,46,17,29,50
SK Sturm Gra,138,2,12,5,7,30,27,3,41
Rapid Vienna,138,3,9,9,6,35,30,5,36
LASK Linz,138,4,7,7,10,27,30,-3,28
Mattersburg,138,5,6,8,10,33,40,-7,26
Vienna,138,6,6,6,12,24,40,-16,24
SC Rheindorf,138,7,6,5,13,20,31,-11,23
FC Salzburg,139,1,15,7,2,46,16,30,52
SK Sturm Gra,139,2,12,5,7,29,27,2,41
Rapid Vienna,139,3,7,12,5,33,29,4,33
LASK Linz,139,4,9,5,10,30,29,1,32
Vienna,139,5,7,5,12,29,40,-11,26
Mattersburg,139,6,6,5,13,32,46,-14,23
SC Rheindorf,139,7,5,7,12,18,30,-12,22
FC Salzburg,140,1,14,8,2,45,20,25,50
SK Sturm Gra,140,2,13,4,7,34,28,6,43
Rapid Vienna,140,3,7,12,5,32,26,6,33
LASK Linz,140,4,9,5,10,29,30,-1,32
SC Rheindorf,140,5,6,6,12,17,26,-9,24
Mattersburg,140,6,6,6,12,33,43,-10,24
Vienna,140,7,6,5,13,26,43,-17,23
FC Salzburg,141,1,15,6,3,47,20,27,51
SK Sturm Gra,141,2,13,4,7,33,26,7,43
Rapid Vienna,141,3,7,11,6,33,31,2,32
LASK Linz,141,4,8,8,8,26,25,1,32
Vienna,141,5,7,5,12,28,41,-13,26
Mattersburg,141,6,6,5,13,31,45,-14,23
SC Rheindorf,141,7,5,7,12,20,30,-10,22
FC Salzburg,142,1,15,7,2,48,18,30,52
SK Sturm Gra,142,2,13,3,8,32,31,1,42
LASK Linz,142,3,10,6,8,31,27,4,36
Rapid Vienna,142,4,7,9,8,33,33,0,30
Mattersburg,142,5,6,8,10,34,41,-7,26
Vienna,142,6,6,5,13,23,41,-18,23
SC Rheindorf,142,7,5,6,13,18,28,-10,21
FC Salzburg,143,1,16,6,2,51,16,35,54
SK Sturm Gra,143,2,13,3,8,34,29,5,42
Rapid Vienna,143,3,9,9,6,35,30,5,36
LASK Linz,143,4,9,5,10,29,31,-2,32
Mattersburg,143,5,7,5,12,32,45,-13,26
Vienna,143,6,6,5,13,24,41,-17,23
SC Rheindorf,143,7,5,5,14,16,29,-13,20
FC Salzburg,144,1,16,6,2,49,19,30,54
SK Sturm Gra,144,2,13,4,7,34,27,7,43
Rapid Vienna,144,3,8,9,7,36,29,7,33
LASK Linz,144,4,9,5,10,32,34,-2,32
Vienna,144,5,7,5,12,29,43,-14,26
Mattersburg,144,6,6,5,13,30,47,-17,23
SC Rheindorf,144,7,5,6,13,18,29,-11,21
FC Salzburg,145,1,14,7,3,45,18,27,49
SK Sturm Gra,145,2,12,4,8,31,31,0,40
Rapid Vienna,145,3,9,9,6,38,30,8,36
LASK Linz,145,4,10,5,9,34,28,6,35
Mattersburg,145,5,8,5,11,34,44,-10,29
Vienna,145,6,6,5,13,24,40,-16,23
SC Rheindorf,145,7,5,5,14,19,34,-15,20
FC Salzburg,146,1,15,7,2,45,17,28,52
SK Sturm Gra,146,2,13,5,6,33,26,7,44
Rapid Vienna,146,3,8,10,6,36,27,9,34
Mattersburg,146,4,8,5,11,34,39,-5,29
LASK Linz,146,5,7,6,11,24,32,-8,27
Vienna,146,6,6,5,13,24,43,-19,23
SC Rheindorf,146,7,5,6,13,16,28,-12,21
FC Salzburg,147,1,14,8,2,43,17,26,50
SK Sturm Gra,147,2,12,5,7,30,26,4,41
Rapid Vienna,147,3,8,10,6,36,29,7,34
LASK Linz,147,4,8,5,11,27,30,-3,29
Mattersburg,147,5,8,5,11,33,40,-7,29
Vienna,147,6,6,6,12,24,40,-16,24
SC Rheindorf,147,7,6,5,13,18,29,-11,23
FC Salzburg,148,1,14,7,3,41,18,23,49
SK Sturm Gra,148,2,13,5,6,34,25,9,44
Rapid Vienna,148,3,9,10,5,37,26,11,37
LASK Linz,148,4,9,5,10,27,32,-5,32
Mattersburg,148,5,7,5,12,34,41,-7,26
Vienna,148,6,7,5,12,26,39,-13,26
SC Rheindorf,148,7,4,5,15,18,36,-18,17
FC Salzburg,149,1,14,8,2,42,16,26,50
SK Sturm Gra,149,2,12,5,7,32,25,7,41
Rapid Vienna,149,3,8,11,5,34,26,8,35
LASK Linz,149,4,7,6,11,24,33,-9,27
Vienna,149,5,7,6,11,29,40,-11,27
Mattersburg,149,6,6,6,12,32,44,-12,24
SC Rheindorf,149,7,5,8,11,18,27,-9,23
FC Salzburg,150,1,14,7,3,46,19,27,49
SK Sturm Gra,150,2,11,4,9,28,31,-3,37
Rapid Vienna,150,3,8,11,5,35,27,8,35
LASK Linz,150,4,9,7,8,30,28,2,34
Vienna,150,5,6,7,11,26,40,-14,25
Mattersburg,150,6,6,6,12,36,45,-9,24
SC Rheindorf,150,7,6,6,12,21,32,-11,24
FC Salzburg,151,1,14,7,3,41,16,25,49
SK Sturm Gra,151,2,11,5,8,29,28,1,38
Rapid Vienna,151,3,8,10,6,35,28,7,34
LASK Linz,151,4,9,6,9,28,32,-4,33
Mattersburg,151,5,8,5,11,35,40,-5,29
Vienna,151,6,6,6,12,25,40,-15,24
SC Rheindorf,151,7,6,5,13,19,28,-9,23
FC Salzburg,152,1,15,7,2,48,18,30,52
Rapid Vienna,152,2,10,9,5,40,28,12,39
SK Sturm Gra,152,3,11,5,8,31,30,1,38
LASK Linz,152,4,9,6,9,27,28,-1,33
Vienna,152,5,6,6,12,24,39,-15,24
Mattersburg,152,6,6,5,13,31,49,-18,23
SC Rheindorf,152,7,5,6,13,21,30,-9,21
FC Salzburg,153,1,14,8,2,43,17,26,50
Rapid Vienna,153,2,10,10,4,39,25,14,40
SK Sturm Gra,153,3,12,4,8,33,30,3,40
Mattersburg,153,4,8,5,11,34,41,-7,29
LASK Linz,153,5,7,5,12,25,34,-9,26
SC Rheindorf,153,6,6,5,13,20,31,-11,23
Vienna,153,7,6,5,13,23,39,-16,23
SK Sturm Gra,154,1,14,4,6,35,27,8,46
FC Salzburg,154,2,13,6,5,41,19,22,45
Rapid Vienna,154,3,9,10,5,36,31,5,37
LASK Linz,154,4,9,5,10,31,31,0,32
Vienna,154,5,8,5,11,26,38,-12,29
Mattersburg,154,6,7,5,12,34,42,-8,26
SC Rheindorf,154,7,4,5,15,16,31,-15,17
FC Salzburg,155,1,14,6,4,43,18,25,48
SK Sturm Gra,155,2,14,3,7,34,28,6,45
Rapid Vienna,155,3,7,10,7,33,30,3,31
LASK Linz,155,4,8,6,10,24,28,-4,30
Vienna,155,5,8,5,11,26,38,-12,29
Mattersburg,155,6,7,5,12,31,39,-8,26
SC Rheindorf,155,7,6,5,13,19,29,-10,23
FC Salzburg,156,1,14,6,4,43,19,24,48
SK Sturm Gra,156,2,13,4,7,33,27,6,43
Rapid Vienna,156,3,9,11,4,38,26,12,38
LASK Linz,156,4,8,6,10,27,30,-3,30
Mattersburg,156,5,7,5,12,32,41,-9,26
SC Rheindorf,156,6,6,5,13,19,32,-13,23
Vienna,156,7,6,5,13,25,42,-17,23
FC Salzburg,157,1,14,6,4,44,18,26,48
SK Sturm Gra,157,2,15,3,6,41,24,17,48
Rapid Vienna,157,3,8,10,6,35,30,5,34
Mattersburg,157,4,7,6,11,34,44,-10,27
Vienna,157,5,7,6,11,26,39,-13,27
LASK Linz,157,6,7,5,12,25,37,-12,26
SC Rheindorf,157,7,5,6,13,18,31,-13,21
FC Salzburg,158,1,14,7,3,42,16,26,49
SK Sturm Gra,158,2,11,6,7,32,31,1,39
Rapid Vienna,158,3,8,10,6,33,26,7,34
LASK Linz,158,4,8,7,9,28,29,-1,31
Mattersburg,158,5,7,7,10,32,39,-7,28
Vienna,158,6,7,5,12,25,40,-15,26
SC Rheindorf,158,7,4,8,12,18,29,-11,20
FC Salzburg,159,1,14,6,4,41,19,22,48
SK Sturm Gra,159,2,13,3,8,33,27,6,42
Rapid Vienna,159,3,10,10,4,38,27,11,40
LASK Linz,159,4,7,8,9,28,31,-3,29
Vienna,159,5,7,5,12,26,40,-14,26
SC Rheindorf,159,6,5,7,12,19,29,-10,22
Mattersburg,159,7,5,7,12,30,42,-12,22
FC Salzburg,160,1,15,7,2,45,16,29,52
SK Sturm Gra,160,2,13,3,8,38,32,6,42
LASK Linz,160,3,9,7,8,30,27,3,34
Rapid Vienna,160,4,7,11,6,37,32,5,32
Vienna,160,5,7,5,12,24,39,-15,26
Mattersburg,160,6,6,6,12,29,41,-12,24
SC Rheindorf,160,7,5,5,14,19,35,-16,20
FC Salzburg,161,1,14,8,2,45,17,28,50
SK Sturm Gra,161,2,13,3,8,34,28,6,42
LASK Linz,161,3,9,6,9,27,28,-1,33
Rapid Vienna,161,4,7,10,7,34,32,2,31
Vienna,161,5,7,5,12,24,39,-15,26
SC Rheindorf,161,6,6,7,11,21,29,-8,25
Mattersburg,161,7,5,7,12,31,43,-12,22
SK Sturm Gra,162,1,14,3,7,35,28,7,45
FC Salzburg,162,2,12,7,5,41,21,20,43
Rapid Vienna,162,3,8,11,5,36,28,8,35
LASK Linz,162,4,8,6,10,30,31,-1,30
Vienna,162,5,8,5,11,28,40,-12,29
Mattersburg,162,6,7,6,11,34,42,-8,27
SC Rheindorf,162,7,5,6,13,18,32,-14,21
FC Salzburg,163,1,14,8,2,46,20,26,50
SK Sturm Gra,163,2,12,3,9,34,32,2,39
Rapid Vienna,163,3,8,12,4,37,28,9,36
LASK Linz,163,4,8,6,10,27,31,-4,30
Vienna,163,5,7,6,11,28,41,-13,27
SC Rheindorf,163,6,6,6,12,20,27,-7,24
Mattersburg,163,7,6,5,13,31,44,-13,23
FC Salzburg,164,1,14,6,4,43,20,23,48
SK Sturm Gra,164,2,13,4,7,36,28,8,43
Rapid Vienna,164,3,8,9,7,33,30,3,33
Mattersburg,164,4,8,6,10,32,38,-6,30
LASK Linz,164,5,8,5,11,25,29,-4,29
SC Rheindorf,164,6,6,6,12,22,31,-9,24
Vienna,164,7,6,6,12,25,40,-15,24
FC Salzburg,165,1,15,6,3,48,18,30,51
SK Sturm Gra,165,2,12,4,8,33,32,1,40
Rapid Vienna,165,3,8,12,4,34,25,9,36
LASK Linz,165,4,7,6,11,24,29,-5,27
Vienna,165,5,7,5,12,27,41,-14,26
SC Rheindorf,165,6,6,7,11,21,29,-8,25
Mattersburg,165,7,6,6,12,30,43,-13,24
FC Salzburg,166,1,16,6,2,47,16,31,54
SK Sturm Gra,166,2,12,3,9,33,30,3,39
Rapid Vienna,166,3,9,10,5,40,30,10,37
Mattersburg,166,4,8,5,11,33,43,-10,29
LASK Linz,166,5,7,7,10,29,33,-4,28
Vienna,166,6,6,5,13,26,43,-17,23
SC Rheindorf,166,7,5,6,13,20,33,-13,21
FC Salzburg,167,1,14,7,3,44,18,26,49
SK Sturm Gra,167,2,12,4,8,32,28,4,40
Rapid Vienna,167,3,8,10,6,37,31,6,34
LASK Linz,167,4,9,5,10,27,30,-3,32
Mattersburg,167,5,8,5,11,31,40,-9,29
Vienna,167,6,6,6,12,23,38,-15,24
SC Rheindorf,167,7,6,5,13,20,29,-9,23
FC Salzburg,168,1,13,8,3,44,20,24,47
SK Sturm Gra,168,2,12,6,6,33,27,6,42
Rapid Vienna,168,3,7,12,5,36,29,7,33
LASK Linz,168,4,9,5,10,31,33,-2,32
Vienna,168,5,8,5,11,29,39,-10,29
Mattersburg,168,6,7,5,12,33,46,-13,26
SC Rheindorf,168,7,4,7,13,18,30,-12,19
FC Salzburg,169,1,14,7,3,48,18,30,49
SK Sturm Gra,169,2,12,4,8,33,30,3,40
Rapid Vienna,169,3,8,11,5,39,31,8,35
LASK Linz,169,4,9,6,9,30,28,2,33
Mattersburg,169,5,8,5,11,32,42,-10,29
Vienna,169,6,7,5,12,24,38,-14,26
SC Rheindorf,169,7,4,6,14,16,35,-19,18
FC Salzburg,170,1,13,7,4,43,18,25,46
SK Sturm Gra,170,2,14,3,7,37,32,5,45
Rapid Vienna,170,3,9,10,5,34,25,9,37
Mattersburg,170,4,8,6,10,32,37,-5,30
LASK Linz,170,5,7,6,11,26,32,-6,27
Vienna,170,6,7,5,12,25,38,-13,26
SC Rheindorf,170,7,5,5,14,17,32,-15,20
FC Salzburg,171,1,15,6,3,43,18,25,51
SK Sturm Gra,171,2,14,3,7,34,28,6,45
Rapid Vienna,171,3,9,9,6,36,25,11,36
LASK Linz,171,4,8,6,10,26,29,-3,30
Mattersburg,171,5,7,6,11,30,39,-9,27
Vienna,171,6,6,5,13,24,40,-16,23
SC Rheindorf,171,7,5,5,14,16,30,-14,20
FC Salzburg,172,1,15,7,2,47,17,30,52
SK Sturm Gra,172,2,12,5,7,31,28,3,41
Rapid Vienna,172,3,7,11,6,35,30,5,32
LASK Linz,172,4,8,6,10,27,29,-2,30
Vienna,172,5,7,5,12,25,39,-14,26
SC Rheindorf,172,6,6,6,12,21,29,-8,24
Mattersburg,172,7,6,6,12,28,42,-14,24
FC Salzburg,173,1,15,6,3,44,16,28,51
SK Sturm Gra,173,2,11,5,8,30,29,1,38
Rapid Vienna,173,3,8,10,6,34,29,5,34
LASK Linz,173,4,9,7,8,33,31,2,34
Vienna,173,5,7,5,12,25,40,-15,26
Mattersburg,173,6,6,6,12,33,44,-11,24
SC Rheindorf,173,7,6,5,13,24,34,-10,23
FC Salzburg,174,1,14,6,4,42,19,23,48
SK Sturm Gra,174,2,12,4,8,33,30,3,40
Rapid Vienna,174,3,9,10,5,36,27,9,37
Vienna,174,4,8,5,11,26,38,-12,29
SC Rheindorf,174,5,7,6,11,21,28,-7,27
LASK Linz,174,6,7,5,12,24,30,-6,26
Mattersburg,174,7,6,6,12,30,40,-10,24
FC Salzburg,175,1,14,6,4,44,23,21,48
SK Sturm Gra,175,2,13,3,8,34,32,2,42
Rapid Vienna,175,3,8,10,6,36,29,7,34
LASK Linz,175,4,8,7,9,29,30,-1,31
Vienna,175,5,8,5,11,27,38,-11,29
SC Rheindorf,175,6,6,7,11,24,29,-5,25
Mattersburg,175,7,5,6,13,28,41,-13,21
FC Salzburg,176,1,14,6,4,44,20,24,48
SK Sturm Gra,176,2,13,3,8,35,31,4,42
Rapid Vienna,176,3,8,10,6,37,30,7,34
Mattersburg,176,4,8,6,10,36,39,-3,30
LASK Linz,176,5,7,7,10,26,31,-5,28
SC Rheindorf,176,6,6,7,11,25,33,-8,25
Vienna,176,7,6,5,13,24,43,-19,23
FC Salzburg,177,1,14,7,3,42,16,26,49
SK Sturm Gra,177,2,14,4,6,34,26,8,46
Rapid Vienna,177,3,8,10,6,35,29,6,34
LASK Linz,177,4,8,7,9,27,27,0,31
Vienna,177,5,6,6,12,25,40,-15,24
Mattersburg,177,6,5,8,11,30,43,-13,23
SC Rheindorf,177,7,5,6,13,20,32,-12,21
FC Salzburg,178,1,12,9,3,42,20,22,45
SK Sturm Gra,178,2,14,3,7,34,27,7,45
Rapid Vienna,178,3,8,11,5,37,29,8,35
LASK Linz,178,4,8,6,10,28,31,-3,30
Mattersburg,178,5,7,7,10,33,40,-7,28
Vienna,178,6,6,7,11,27,41,-14,25
SC Rheindorf,178,7,5,5,14,20,33,-13,20
SK Sturm Gra,179,1,15,3,6,35,25,10,48
FC Salzburg,179,2,13,6,5,42,20,22,45
Rapid Vienna,179,3,9,9,6,36,28,8,36
LASK Linz,179,4,8,5,11,24,31,-7,29
Vienna,179,5,7,5,12,26,43,-17,26
SC Rheindorf,179,6,6,6,12,22,29,-7,24
Mattersburg,179,7,6,6,12,32,41,-9,24
FC Salzburg,180,1,15,7,2,44,17,27,52
SK Sturm Gra,180,2,11,6,7,31,28,3,39
Rapid Vienna,180,3,9,10,5,34,26,8,37
LASK Linz,180,4,8,7,9,27,28,-1,31
Mattersburg,180,5,6,6,12,29,40,-11,24
Vienna,180,6,6,6,12,24,39,-15,24
SC Rheindorf,180,7,5,6,13,18,29,-11,21
FC Salzburg,181,1,13,7,4,44,21,23,46
SK Sturm Gra,181,2,12,4,8,33,30,3,40
Rapid Vienna,181,3,9,10,5,37,30,7,37
LASK Linz,181,4,8,6,10,30,30,0,30
Vienna,181,5,8,5,11,28,40,-12,29
Mattersburg,181,6,6,7,11,31,41,-10,25
SC Rheindorf,181,7,5,7,12,18,29,-11,22
FC Salzburg,182,1,16,6,2,44,15,29,54
SK Sturm Gra,182,2,12,5,7,35,29,6,41
Rapid Vienna,182,3,7,10,7,35,30,5,31
LASK Linz,182,4,8,6,10,29,34,-5,30
SC Rheindorf,182,5,6,7,11,20,28,-8,25
Mattersburg,182,6,6,6,12,30,42,-12,24
Vienna,182,7,6,6,12,25,40,-15,24
FC Salzburg,183,1,15,7,2,47,17,30,52
SK Sturm Gra,183,2,12,5,7,34,29,5,41
Rapid Vienna,183,3,8,11,5,37,29,8,35
LASK Linz,183,4,7,7,10,28,32,-4,28
SC Rheindorf,183,5,6,7,11,25,31,-6,25
Mattersburg,183,6,6,6,12,33,46,-13,24
Vienna,183,7,6,5,13,24,44,-20,23
FC Salzburg,184,1,15,7,2,45,17,28,52
SK Sturm Gra,184,2,12,4,8,30,29,1,40
Rapid Vienna,184,3,9,10,5,36,27,9,37
LASK Linz,184,4,8,6,10,28,30,-2,30
Mattersburg,184,5,7,5,12,30,38,-8,26
SC Rheindorf,184,6,6,5,13,20,31,-11,23
Vienna,184,7,6,5,13,24,41,-17,23
FC Salzburg,185,1,14,7,3,47,20,27,49
SK Sturm Gra,185,2,11,5,8,32,31,1,38
Rapid Vienna,185,3,9,10,5,34,26,8,37
LASK Linz,185,4,10,5,9,29,27,2,35
Vienna,185,5,7,6,11,28,41,-13,27
SC Rheindorf,185,6,5,7,12,19,27,-8,22
Mattersburg,185,7,5,6,13,28,45,-17,21
FC Salzburg,186,1,15,6,3,47,17,30,51
SK Sturm Gra,186,2,12,5,7,31,26,5,41
Rapid Vienna,186,3,9,10,5,36,25,11,37
LASK Linz,186,4,9,5,10,27,32,-5,32
Mattersburg,186,5,8,5,11,35,41,-6,29
Vienna,186,6,6,5,13,23,43,-20,23
SC Rheindorf,186,7,4,6,14,18,33,-15,18
SK Sturm Gra,187,1,14,3,7,35,31,4,45
FC Salzburg,187,2,12,7,5,41,21,20,43
Rapid Vienna,187,3,9,11,4,40,28,12,38
LASK Linz,187,4,7,6,11,28,32,-4,27
Mattersburg,187,5,7,6,11,32,43,-11,27
Vienna,187,6,6,7,11,26,40,-14,25
SC Rheindorf,187,7,6,6,12,25,32,-7,24
FC Salzburg,188,1,15,7,2,49,19,30,52
SK Sturm Gra,188,2,11,5,8,33,32,1,38
Rapid Vienna,188,3,7,11,6,34,30,4,32
LASK Linz,188,4,8,7,9,25,28,-3,31
Mattersburg,188,5,8,5,11,36,40,-4,29
SC Rheindorf,188,6,6,6,12,21,30,-9,24
Vienna,188,7,6,5,13,24,43,-19,23
FC Salzburg,189,1,15,6,3,46,21,25,51
SK Sturm Gra,189,2,12,4,8,30,28,2,40
Rapid Vienna,189,3,10,9,5,41,24,17,39
LASK Linz,189,4,8,7,9,26,29,-3,31
SC Rheindorf,189,5,6,6,12,21,31,-10,24
Mattersburg,189,6,6,5,13,32,46,-14,23
Vienna,189,7,6,5,13,25,42,-17,23
FC Salzburg,190,1,15,7,2,43,15,28,52
SK Sturm Gra,190,2,12,5,7,32,29,3,41
Rapid Vienna,190,3,8,11,5,33,25,8,35
LASK Linz,190,4,7,6,11,26,32,-6,27
Mattersburg,190,5,7,5,12,30,41,-11,26
Vienna,190,6,7,5,12,25,39,-14,26
SC Rheindorf,190,7,6,5,13,20,28,-8,23
FC Salzburg,191,1,16,6,2,49,16,33,54
SK Sturm Gra,191,2,12,4,8,35,34,1,40
Rapid Vienna,191,3,8,11,5,34,29,5,35
LASK Linz,191,4,8,7,9,33,32,1,31
Mattersburg,191,5,7,6,11,33,42,-9,27
Vienna,191,6,6,5,13,23,40,-17,23
SC Rheindorf,191,7,5,5,14,18,32,-14,20
FC Salzburg,192,1,13,8,3,46,22,24,47
SK Sturm Gra,192,2,12,6,6,37,31,6,42
LASK Linz,192,3,9,6,9,31,29,2,33
Rapid Vienna,192,4,7,11,6,37,34,3,32
Vienna,192,5,8,5,11,28,39,-11,29
SC Rheindorf,192,6,5,8,11,21,29,-8,23
Mattersburg,192,7,5,6,13,28,44,-16,21
FC Salzburg,193,1,14,8,2,42,16,26,50
SK Sturm Gra,193,2,12,4,8,31,27,4,40
Rapid Vienna,193,3,8,10,6,34,28,6,34
LASK Linz,193,4,9,5,10,28,30,-2,32
Vienna,193,5,7,6,11,27,38,-11,27
Mattersburg,193,6,7,5,12,29,40,-11,26
SC Rheindorf,193,7,5,6,13,19,31,-12,21
FC Salzburg,194,1,14,7,3,43,19,24,49
SK Sturm Gra,194,2,12,4,8,34,30,4,40
Rapid Vienna,194,3,8,10,6,34,28,6,34
LASK Linz,194,4,8,7,9,26,27,-1,31
Vienna,194,5,7,5,12,24,38,-14,26
Mattersburg,194,6,6,7,11,29,39,-10,25
SC Rheindorf,194,7,6,6,12,18,27,-9,24
FC Salzburg,195,1,15,6,3,47,19,28,51
SK Sturm Gra,195,2,11,5,8,29,28,1,38
Rapid Vienna,195,3,9,10,5,34,26,8,37
LASK Linz,195,4,7,7,10,26,29,-3,28
Mattersburg,195,5,7,7,10,33,40,-7,28
Vienna,195,6,6,6,12,23,40,-17,24
SC Rheindorf,195,7,5,7,12,19,29,-10,22
FC Salzburg,196,1,15,6,3,48,21,27,51
Rapid Vienna,196,2,10,9,5,39,28,11,39
SK Sturm Gra,196,3,12,3,9,32,32,0,39
LASK Linz,196,4,9,6,9,29,27,2,33
Mattersburg,196,5,7,6,11,33,45,-12,27
Vienna,196,6,6,5,13,24,40,-16,23
SC Rheindorf,196,7,5,5,14,20,32,-12,20
FC Salzburg,197,1,13,8,3,44,20,24,47
SK Sturm Gra,197,2,14,4,6,34,25,9,46
Rapid Vienna,197,3,8,11,5,35,27,8,35
LASK Linz,197,4,7,6,11,26,32,-6,27
Mattersburg,197,5,6,8,10,32,41,-9,26
Vienna,197,6,6,7,11,25,39,-14,25
SC Rheindorf,197,7,5,6,13,19,31,-12,21
FC Salzburg,198,1,13,8,3,43,20,23,47
SK Sturm Gra,198,2,12,5,7,32,28,4,41
Rapid Vienna,198,3,10,9,5,39,30,9,39
LASK Linz,198,4,8,7,9,28,29,-1,31
Vienna,198,5,7,5,12,27,40,-13,26
Mattersburg,198,6,6,7,11,33,44,-11,25
SC Rheindorf,198,7,5,5,14,24,35,-11,20
FC Salzburg,199,1,14,7,3,43,18,25,49
SK Sturm Gra,199,2,13,4,7,31,26,5,43
Rapid Vienna,199,3,10,9,5,37,26,11,39
LASK Linz,199,4,9,5,10,30,29,1,32
Vienna,199,5,6,6,12,24,39,-15,24
Mattersburg,199,6,5,7,12,28,43,-15,22
SC Rheindorf,199,7,5,6,13,20,32,-12,21
FC Salzburg,200,1,15,7,2,48,20,28,52
SK Sturm Gra,200,2,13,4,7,36,30,6,43
Rapid Vienna,200,3,8,10,6,39,32,7,34
LASK Linz,200,4,7,8,9,27,31,-4,29
Mattersburg,200,5,6,6,12,37,48,-11,24
Vienna,200,6,6,6,12,25,41,-16,24
SC Rheindorf,200,7,6,5,13,21,31,-10,23
FC Salzburg,201,1,13,8,3,42,19,23,47
Rapid Vienna,201,2,10,9,5,40,29,11,39
SK Sturm Gra,201,3,11,5,8,33,33,0,38
LASK Linz,201,4,8,7,9,29,28,1,31
Vienna,201,5,7,6,11,24,37,-13,27
Mattersburg,201,6,7,5,12,34,41,-7,26
SC Rheindorf,201,7,5,6,13,21,36,-15,21
FC Salzburg,202,1,16,6,2,47,15,32,54
SK Sturm Gra,202,2,12,4,8,32,29,3,40
LASK Linz,202,3,9,7,8,26,25,1,34
Rapid Vienna,202,4,7,9,8,32,29,3,30
Vienna,202,5,7,5,12,26,42,-16,26
SC Rheindorf,202,6,6,7,11,20,27,-7,25
Mattersburg,202,7,5,6,13,26,42,-16,21
FC Salzburg,203,1,13,8,3,46,20,26,47
SK Sturm Gra,203,2,12,5,7,34,33,1,41
Rapid Vienna,203,3,9,10,5,38,27,11,37
LASK Linz,203,4,9,6,9,34,31,3,33
Mattersburg,203,5,7,5,12,32,46,-14,26
Vienna,203,6,7,5,12,26,40,-14,26
SC Rheindorf,203,7,4,7,13,16,29,-13,19
FC Salzburg,204,1,14,7,3,43,18,25,49
SK Sturm Gra,204,2,12,5,7,31,26,5,41
Rapid Vienna,204,3,9,9,6,37,27,10,36
LASK Linz,204,4,10,5,9,27,27,0,35
Mattersburg,204,5,7,5,12,31,41,-10,26
Vienna,204,6,7,5,12,26,40,-14,26
SC Rheindorf,204,7,4,6,14,16,32,-16,18
FC Salzburg,205,1,13,7,4,43,18,25,46
SK Sturm Gra,205,2,12,3,9,30,29,1,39
Rapid Vienna,205,3,9,11,4,36,25,11,38
LASK Linz,205,4,9,6,9,28,28,0,33
Vienna,205,5,7,5,12,25,42,-17,26
SC Rheindorf,205,6,6,6,12,22,31,-9,24
Mattersburg,205,7,6,6,12,31,42,-11,24
FC Salzburg,206,1,14,7,3,44,19,25,49
Rapid Vienna,206,2,10,10,4,41,28,13,40
SK Sturm Gra,206,3,11,5,8,30,29,1,38
LASK Linz,206,4,9,6,9,27,28,-1,33
Vienna,206,5,6,6,12,25,40,-15,24
SC Rheindorf,206,6,5,7,12,19,30,-11,22
Mattersburg,206,7,5,7,12,29,41,-12,22
FC Salzburg,207,1,15,6,3,44,17,27,51
Rapid Vienna,207,2,9,10,5,37,28,9,37
SK Sturm Gra,207,3,11,4,9,29,31,-2,37
LASK Linz,207,4,8,7,9,26,27,-1,31
Mattersburg,207,5,7,6,11,37,42,-5,27
Vienna,207,6,7,5,12,25,39,-14,26
SC Rheindorf,207,7,5,6,13,22,36,-14,21
FC Salzburg,208,1,14,8,2,45,19,26,50
SK Sturm Gra,208,2,11,4,9,33,33,0,37
Rapid Vienna,208,3,8,11,5,35,28,7,35
LASK Linz,208,4,8,5,11,26,30,-4,29
SC Rheindorf,208,5,7,6,11,24,30,-6,27
Vienna,208,6,7,5,12,26,39,-13,26
Mattersburg,208,7,6,7,11,32,42,-10,25
FC Salzburg,209,1,15,7,2,49,20,29,52
LASK Linz,209,2,11,5,8,32,27,5,38
SK Sturm Gra,209,3,11,4,9,29,31,-2,37
Rapid Vienna,209,4,8,10,6,34,27,7,34
Mattersburg,209,5,7,6,11,34,42,-8,27
Vienna,209,6,6,5,13,24,42,-18,23
SC Rheindorf,209,7,4,7,13,18,31,-13,19
FC Salzburg,210,1,15,7,2,47,17,30,52
SK Sturm Gra,210,2,13,4,7,34,29,5,43
Rapid Vienna,210,3,10,9,5,35,28,7,39
LASK Linz,210,4,7,5,12,26,33,-7,26
Mattersburg,210,5,6,6,12,31,42,-11,24
Vienna,210,6,6,6,12,24,39,-15,24
SC Rheindorf,210,7,6,5,13,19,28,-9,23
FC Salzburg,211,1,14,7,3,42,19,23,49
SK Sturm Gra,211,2,11,4,9,31,31,0,37
Rapid Vienna,211,3,9,9,6,38,29,9,36
LASK Linz,211,4,10,5,9,32,29,3,35
Vienna,211,5,7,5,12,27,39,-12,26
Mattersburg,211,6,7,5,12,30,43,-13,26
SC Rheindorf,211,7,6,5,13,19,29,-10,23
FC Salzburg,212,1,16,6,2,47,17,30,54
Rapid Vienna,212,2,9,10,5,35,26,9,37
SK Sturm Gra,212,3,11,4,9,30,34,-4,37
LASK Linz,212,4,10,5,9,27,27,0,35
Vienna,212,5,7,5,12,28,40,-12,26
Mattersburg,212,6,6,5,13,30,42,-12,23
SC Rheindorf,212,7,5,5,14,20,31,-11,20
FC Salzburg,213,1,15,6,3,46,16,30,51
Rapid Vienna,213,2,11,9,4,37,25,12,42
SK Sturm Gra,213,3,12,3,9,31,32,-1,39
LASK Linz,213,4,8,5,11,27,31,-4,29
Mattersburg,213,5,6,6,12,33,46,-13,24
Vienna,213,6,6,6,12,25,40,-15,24
SC Rheindorf,213,7,6,5,13,20,29,-9,23
FC Salzburg,214,1,14,6,4,43,22,21,48
SK Sturm Gra,214,2,14,3,7,36,27,9,45
Rapid Vienna,214,3,9,9,6,35,27,8,36
LASK Linz,214,4,7,7,10,26,31,-5,28
SC Rheindorf,214,5,7,6,11,21,27,-6,27
Vienna,214,6,7,5,12,27,40,-13,26
Mattersburg,214,7,5,6,13,31,45,-14,21
FC Salzburg,215,1,14,6,4,43,18,25,48
Rapid Vienna,215,2,10,9,5,38,27,11,39
SK Sturm Gra,215,3,12,3,9,32,31,1,39
LASK Linz,215,4,11,5,8,34,27,7,38
Mattersburg,215,5,7,5,12,33,44,-11,26
Vienna,215,6,6,5,13,25,42,-17,23
SC Rheindorf,215,7,5,5,14,19,35,-16,20
FC Salzburg,216,1,15,7,2,43,16,27,52
SK Sturm Gra,216,2,13,3,8,33,28,5,42
Rapid Vienna,216,3,7,11,6,35,31,4,32
LASK Linz,216,4,7,7,10,27,32,-5,28
SC Rheindorf,216,5,7,6,11,23,28,-5,27
Vienna,216,6,7,6,11,26,39,-13,27
Mattersburg,216,7,5,6,13,28,41,-13,21
FC Salzburg,217,1,15,6,3,45,19,26,51
SK Sturm Gra,217,2,12,5,7,32,30,2,41
Rapid Vienna,217,3,8,10,6,36,28,8,34
LASK Linz,217,4,9,7,8,28,25,3,34
Vienna,217,5,7,5,12,27,39,-12,26
Mattersburg,217,6,6,6,12,29,40,-11,24
SC Rheindorf,217,7,5,5,14,18,34,-16,20
FC Salzburg,218,1,14,8,2,45,17,28,50
SK Sturm Gra,218,2,11,5,8,33,33,0,38
Rapid Vienna,218,3,8,12,4,36,26,10,36
LASK Linz,218,4,8,6,10,27,30,-3,30
SC Rheindorf,218,5,7,5,12,21,29,-8,26
Mattersburg,218,6,6,6,12,31,42,-11,24
Vienna,218,7,6,6,12,25,41,-16,24
FC Salzburg,219,1,16,6,2,47,16,31,54
SK Sturm Gra,219,2,13,3,8,36,30,6,42
Rapid Vienna,219,3,9,9,6,38,30,8,36
LASK Linz,219,4,8,6,10,30,33,-3,30
Vienna,219,5,7,5,12,25,40,-15,26
SC Rheindorf,219,6,6,6,12,21,30,-9,24
Mattersburg,219,7,5,5,14,27,45,-18,20
FC Salzburg,220,1,14,7,3,44,20,24,49
SK Sturm Gra,220,2,13,4,7,31,26,5,43
Rapid Vienna,220,3,8,10,6,33,27,6,34
LASK Linz,220,4,9,5,10,26,28,-2,32
Vienna,220,5,6,7,11,24,38,-14,25
Mattersburg,220,6,6,6,12,31,42,-11,24
SC Rheindorf,220,7,6,5,13,19,27,-8,23
FC Salzburg,221,1,15,6,3,46,20,26,51
SK Sturm Gra,221,2,12,3,9,34,31,3,39
Rapid Vienna,221,3,8,10,6,34,31,3,34
LASK Linz,221,4,9,5,10,32,30,2,32
Vienna,221,5,7,6,11,27,40,-13,27
SC Rheindorf,221,6,6,6,12,21,31,-10,24
Mattersburg,221,7,6,6,12,31,42,-11,24
FC Salzburg,222,1,16,6,2,52,17,35,54
SK Sturm Gra,222,2,12,4,8,33,30,3,40
LASK Linz,222,3,10,6,8,29,27,2,36
Rapid Vienna,222,4,8,10,6,38,32,6,34
Vienna,222,5,7,5,12,26,40,-14,26
Mattersburg,222,6,6,5,13,32,48,-16,23
SC Rheindorf,222,7,4,6,14,18,34,-16,18
FC Salzburg,223,1,14,7,3,44,18,26,49
SK Sturm Gra,223,2,11,5,8,33,33,0,38
LASK Linz,223,3,9,6,9,33,31,2,33
Rapid Vienna,223,4,7,11,6,34,31,3,32
Vienna,223,5,7,6,11,27,40,-13,27
Mattersburg,223,6,6,7,11,31,40,-9,25
SC Rheindorf,223,7,6,6,12,20,29,-9,24
FC Salzburg,224,1,16,6,2,45,17,28,54
Rapid Vienna,224,2,10,9,5,40,26,14,39
SK Sturm Gra,224,3,11,4,9,30,32,-2,37
LASK Linz,224,4,7,6,11,28,32,-4,27
Mattersburg,224,5,7,6,11,34,43,-9,27
SC Rheindorf,224,6,6,6,12,21,31,-10,24
Vienna,224,7,6,5,13,26,43,-17,23
FC Salzburg,225,1,15,7,2,48,19,29,52
SK Sturm Gra,225,2,12,5,7,29,26,3,41
Rapid Vienna,225,3,7,12,5,34,29,5,33
LASK Linz,225,4,9,6,9,28,28,0,33
Vienna,225,5,7,6,11,28,40,-12,27
SC Rheindorf,225,6,5,7,12,18,28,-10,22
Mattersburg,225,7,5,5,14,29,44,-15,20
FC Salzburg,226,1,15,6,3,45,18,27,51
SK Sturm Gra,226,2,14,4,6,35,26,9,46
Rapid Vienna,226,3,9,9,6,36,28,8,36
LASK Linz,226,4,7,6,11,26,32,-6,27
SC Rheindorf,226,5,6,6,12,18,27,-9,24
Mattersburg,226,6,6,6,12,30,41,-11,24
Vienna,226,7,6,5,13,24,42,-18,23
FC Salzburg,227,1,15,6,3,48,21,27,51
SK Sturm Gra,227,2,12,4,8,32,31,1,40
Rapid Vienna,227,3,9,10,5,35,26,9,37
LASK Linz,227,4,9,5,10,27,28,-1,32
Mattersburg,227,5,7,5,12,32,42,-10,26
Vienna,227,6,7,5,12,27,41,-14,26
SC Rheindorf,227,7,5,5,14,20,32,-12,20
FC Salzburg,228,1,16,6,2,43,15,28,54
SK Sturm Gra,228,2,13,3,8,33,29,4,42
Rapid Vienna,228,3,7,10,7,34,32,2,31
LASK Linz,228,4,8,6,10,27,27,0,30
SC Rheindorf,228,5,7,6,11,24,30,-6,27
Mattersburg,228,6,6,6,12,31,42,-11,24
Vienna,228,7,6,5,13,23,40,-17,23
FC Salzburg,229,1,15,6,3,44,19,25,51
SK Sturm Gra,229,2,12,3,9,33,33,0,39
Rapid Vienna,229,3,9,9,6,38,29,9,36
LASK Linz,229,4,8,6,10,28,32,-4,30
Mattersburg,229,5,7,6,11,34,42,-8,27
SC Rheindorf,229,6,6,6,12,26,33,-7,24
Vienna,229,7,6,6,12,24,39,-15,24
FC Salzburg,230,1,16,6,2,45,17,28,54
SK Sturm Gra,230,2,13,4,7,37,29,8,43
Rapid Vienna,230,3,7,10,7,34,32,2,31
LASK Linz,230,4,7,7,10,25,29,-4,28
Mattersburg,230,5,7,6,11,32,39,-7,27
SC Rheindorf,230,6,6,6,12,21,30,-9,24
Vienna,230,7,6,5,13,23,41,-18,23
FC Salzburg,231,1,15,6,3,46,19,27,51
SK Sturm Gra,231,2,12,4,8,32,29,3,40
LASK Linz,231,3,10,5,9,28,26,2,35
Rapid Vienna,231,4,8,9,7,35,30,5,33
Mattersburg,231,5,8,5,11,34,44,-10,29
Vienna,231,6,6,5,13,24,40,-16,23
SC Rheindorf,231,7,5,6,13,20,31,-11,21
FC Salzburg,232,1,15,7,2,44,15,29,52
SK Sturm Gra,232,2,12,5,7,33,29,4,41
Rapid Vienna,232,3,7,11,6,33,27,6,32
LASK Linz,232,4,7,8,9,25,27,-2,29
Mattersburg,232,5,7,6,11,32,41,-9,27
SC Rheindorf,232,6,6,6,12,19,30,-11,24
Vienna,232,7,6,5,13,25,42,-17,23
FC Salzburg,233,1,14,7,3,50,23,27,49
Rapid Vienna,233,2,10,10,4,39,28,11,40
SK Sturm Gra,233,3,11,3,10,30,33,-3,36
LASK Linz,233,4,10,5,9,32,29,3,35
Vienna,233,5,8,5,11,29,41,-12,29
Mattersburg,233,6,6,5,13,34,45,-11,23
SC Rheindorf,233,7,5,5,14,17,32,-15,20
FC Salzburg,234,1,15,7,2,48,17,31,52
SK Sturm Gra,234,2,13,3,8,30,30,0,42
Rapid Vienna,234,3,9,10,5,38,28,10,37
LASK Linz,234,4,9,5,10,29,29,0,32
Vienna,234,5,7,5,12,26,40,-14,26
Mattersburg,234,6,6,6,12,29,43,-14,24
SC Rheindorf,234,7,4,6,14,17,30,-13,18
FC Salzburg,235,1,15,6,3,46,21,25,51
SK Sturm Gra,235,2,13,3,8,35,28,7,42
Rapid Vienna,235,3,8,10,6,34,29,5,34
Mattersburg,235,4,7,6,11,35,40,-5,27
LASK Linz,235,5,7,6,11,31,39,-8,27
Vienna,235,6,7,6,11,26,39,-13,27
SC Rheindorf,235,7,5,7,12,20,31,-11,22
FC Salzburg,236,1,15,6,3,45,19,26,51
Rapid Vienna,236,2,9,11,4,33,23,10,38
SK Sturm Gra,236,3,11,5,8,30,28,2,38
LASK Linz,236,4,8,7,9,27,31,-4,31
Vienna,236,5,7,5,12,27,42,-15,26
Mattersburg,236,6,6,6,12,33,41,-8,24
SC Rheindorf,236,7,4,8,12,17,28,-11,20
FC Salzburg,237,1,13,9,2,42,18,24,48
SK Sturm Gra,237,2,13,4,7,32,26,6,43
Rapid Vienna,237,3,9,10,5,36,28,8,37
LASK Linz,237,4,8,6,10,26,29,-3,30
Vienna,237,5,7,6,11,27,40,-13,27
Mattersburg,237,6,5,7,12,34,46,-12,22
SC Rheindorf,237,7,5,6,13,21,31,-10,21
SK Sturm Gra,238,1,13,4,7,33,28,5,43
FC Salzburg,238,2,12,6,6,41,22,19,42
Rapid Vienna,238,3,11,9,4,38,24,14,42
Mattersburg,238,4,8,6,10,35,41,-6,30
LASK Linz,238,5,8,5,11,27,31,-4,29
Vienna,238,6,7,5,12,26,41,-15,26
SC Rheindorf,238,7,4,7,13,17,30,-13,19
FC Salzburg,239,1,15,7,2,44,16,28,52
SK Sturm Gra,239,2,12,4,8,31,28,3,40
Rapid Vienna,239,3,9,10,5,38,27,11,37
Vienna,239,4,7,6,11,25,38,-13,27
LASK Linz,239,5,7,5,12,26,34,-8,26
Mattersburg,239,6,7,5,12,32,43,-11,26
SC Rheindorf,239,7,5,7,12,20,30,-10,22
FC Salzburg,240,1,14,7,3,47,20,27,49
SK Sturm Gra,240,2,13,3,8,36,30,6,42
Rapid Vienna,240,3,9,10,5,35,27,8,37
LASK Linz,240,4,9,6,9,29,27,2,33
Mattersburg,240,5,6,7,11,31,42,-11,25
Vienna,240,6,6,5,13,23,41,-18,23
SC Rheindorf,240,7,5,6,13,17,31,-14,21
FC Salzburg,241,1,15,7,2,46,17,29,52
SK Sturm Gra,241,2,12,5,7,36,32,4,41
Rapid Vienna,241,3,7,11,6,34,30,4,32
LASK Linz,241,4,8,8,8,29,28,1,32
Vienna,241,5,7,5,12,29,40,-11,26
Mattersburg,241,6,5,7,12,31,48,-17,22
SC Rheindorf,241,7,4,9,11,21,31,-10,21
FC Salzburg,242,1,14,7,3,49,23,26,49
SK Sturm Gra,242,2,14,4,6,37,27,10,46
Rapid Vienna,242,3,8,10,6,37,31,6,34
LASK Linz,242,4,9,5,10,28,30,-2,32
Vienna,242,5,7,5,12,26,41,-15,26
SC Rheindorf,242,6,5,7,12,19,29,-10,22
Mattersburg,242,7,5,6,13,29,44,-15,21
FC Salzburg,243,1,15,7,2,45,18,27,52
SK Sturm Gra,243,2,12,5,7,34,28,6,41
Rapid Vienna,243,3,8,12,4,35,25,10,36
LASK Linz,243,4,8,6,10,26,30,-4,30
Mattersburg,243,5,7,5,12,33,42,-9,26
Vienna,243,6,6,5,13,24,41,-17,23
SC Rheindorf,243,7,4,8,12,17,30,-13,20
FC Salzburg,244,1,15,7,2,46,18,28,52
Rapid Vienna,244,2,10,9,5,37,25,12,39
SK Sturm Gra,244,3,12,3,9,32,33,-1,39
Vienna,244,4,7,6,11,27,40,-13,27
LASK Linz,244,5,7,5,12,24,30,-6,26
SC Rheindorf,244,6,7,5,12,19,28,-9,26
Mattersburg,244,7,6,5,13,30,41,-11,23
FC Salzburg,245,1,14,6,4,44,18,26,48
SK Sturm Gra,245,2,12,4,8,32,32,0,40
Rapid Vienna,245,3,8,10,6,34,26,8,34
Vienna,245,4,8,5,11,26,38,-12,29
SC Rheindorf,245,5,7,6,11,21,27,-6,27
Mattersburg,245,6,7,6,11,31,40,-9,27
LASK Linz,245,7,7,5,12,23,30,-7,26
FC Salzburg,246,1,14,6,4,45,21,24,48
SK Sturm Gra,246,2,14,3,7,36,28,8,45
Rapid Vienna,246,3,9,9,6,38,29,9,36
LASK Linz,246,4,10,5,9,28,28,0,35
Mattersburg,246,5,7,5,12,30,40,-10,26
Vienna,246,6,7,5,12,26,40,-14,26
SC Rheindorf,246,7,4,5,15,18,35,-17,17
FC Salzburg,247,1,16,6,2,46,16,30,54
SK Sturm Gra,247,2,11,4,9,31,33,-2,37
Rapid Vienna,247,3,8,11,5,34,26,8,35
LASK Linz,247,4,8,6,10,26,28,-2,30
Mattersburg,247,5,8,5,11,32,41,-9,29
SC Rheindorf,247,6,6,5,13,21,28,-7,23
Vienna,247,7,6,5,13,24,42,-18,23
FC Salzburg,248,1,15,6,3,45,16,29,51
Rapid Vienna,248,2,10,9,5,40,26,14,39
LASK Linz,248,3,10,6,8,31,28,3,36
SK Sturm Gra,248,4,11,3,10,30,35,-5,36
Mattersburg,248,5,6,7,11,31,41,-10,25
Vienna,248,6,6,6,12,25,42,-17,24
SC Rheindorf,248,7,5,5,14,19,33,-14,20
FC Salzburg,249,1,15,6,3,48,19,29,51
Rapid Vienna,249,2,10,10,4,41,27,14,40
SK Sturm Gra,249,3,11,5,8,33,31,2,38
LASK Linz,249,4,8,6,10,27,30,-3,30
Mattersburg,249,5,6,6,12,33,45,-12,24
Vienna,249,6,6,6,12,26,43,-17,24
SC Rheindorf,249,7,6,5,13,19,32,-13,23
FC Salzburg,250,1,14,8,2,45,18,27,50
SK Sturm Gra,250,2,13,4,7,34,29,5,43
Rapid Vienna,250,3,9,10,5,38,30,8,37
LASK Linz,250,4,7,6,11,25,31,-6,27
Vienna,250,5,7,5,12,26,40,-14,26
SC Rheindorf,250,6,6,6,12,21,28,-7,24
Mattersburg,250,7,5,7,12,29,42,-13,22
FC Salzburg,251,1,13,8,3,42,21,21,47
Rapid Vienna,251,2,11,9,4,41,24,17,42
SK Sturm Gra,251,3,12,3,9,31,31,0,39
LASK Linz,251,4,8,5,11,25,29,-4,29
Mattersburg,251,5,7,6,11,33,42,-9,27
Vienna,251,6,6,6,12,25,43,-18,24
SC Rheindorf,251,7,6,5,13,22,29,-7,23
FC Salzburg,252,1,16,6,2,49,16,33,54
SK Sturm Gra,252,2,11,4,9,31,33,-2,37
Rapid Vienna,252,3,8,10,6,34,29,5,34
LASK Linz,252,4,8,5,11,29,31,-2,29
SC Rheindorf,252,5,7,6,11,19,26,-7,27
Mattersburg,252,6,6,7,11,30,41,-11,25
Vienna,252,7,6,6,12,25,41,-16,24
FC Salzburg,253,1,16,6,2,52,19,33,54
SK Sturm Gra,253,2,12,4,8,37,31,6,40
LASK Linz,253,3,10,6,8,32,26,6,36
Rapid Vienna,253,4,7,9,8,33,36,-3,30
Vienna,253,5,7,5,12,27,44,-17,26
SC Rheindorf,253,6,5,8,11,21,30,-9,23
Mattersburg,253,7,5,6,13,28,44,-16,21
FC Salzburg,254,1,15,7,2,46,19,27,52
SK Sturm Gra,254,2,13,4,7,34,27,7,43
Rapid Vienna,254,3,9,9,6,34,25,9,36
LASK Linz,254,4,8,6,10,27,31,-4,30
Mattersburg,254,5,6,6,12,36,48,-12,24
Vienna,254,6,6,5,13,26,42,-16,23
SC Rheindorf,254,7,5,7,12,21,32,-11,22
FC Salzburg,255,1,14,6,4,47,17,30,48
Rapid Vienna,255,2,9,11,4,36,26,10,38
SK Sturm Gra,255,3,11,4,9,29,34,-5,37
Vienna,255,4,8,5,11,26,37,-11,29
LASK Linz,255,5,7,7,10,24,28,-4,28
SC Rheindorf,255,6,7,6,11,22,26,-4,27
Mattersburg,255,7,6,5,13,28,44,-16,23
FC Salzburg,256,1,14,8,2,44,18,26,50
SK Sturm Gra,256,2,13,5,6,31,25,6,44
Rapid Vienna,256,3,8,9,7,38,33,5,33
LASK Linz,256,4,8,7,9,29,30,-1,31
Mattersburg,256,5,6,8,10,31,39,-8,26
Vienna,256,6,6,6,12,24,39,-15,24
SC Rheindorf,256,7,4,7,13,16,29,-13,19
FC Salzburg,257,1,13,9,2,47,20,27,48
SK Sturm Gra,257,2,13,5,6,34,28,6,44
Rapid Vienna,257,3,9,10,5,37,27,10,37
LASK Linz,257,4,9,5,10,28,29,-1,32
Mattersburg,257,5,6,6,12,32,45,-13,24
Vienna,257,6,6,6,12,26,42,-16,24
SC Rheindorf,257,7,4,7,13,17,30,-13,19
FC Salzburg,258,1,16,6,2,45,16,29,54
SK Sturm Gra,258,2,12,3,9,30,29,1,39
Rapid Vienna,258,3,8,11,5,35,27,8,35
LASK Linz,258,4,8,6,10,25,29,-4,30
Mattersburg,258,5,7,6,11,31,39,-8,27
Vienna,258,6,6,6,12,23,39,-16,24
SC Rheindorf,258,7,5,6,13,20,30,-10,21
FC Salzburg,259,1,13,6,5,44,26,18,45
Rapid Vienna,259,2,11,9,4,38,24,14,42
SK Sturm Gra,259,3,12,4,8,34,30,4,40
Vienna,259,4,8,5,11,28,37,-9,29
Mattersburg,259,5,7,6,11,33,43,-10,27
LASK Linz,259,6,7,5,12,27,36,-9,26
SC Rheindorf,259,7,5,7,12,20,28,-8,22
FC Salzburg,260,1,14,7,3,45,22,23,49
SK Sturm Gra,260,2,13,3,8,32,29,3,42
Rapid Vienna,260,3,7,11,6,37,31,6,32
Vienna,260,4,8,5,11,28,37,-9,29
LASK Linz,260,5,7,7,10,26,29,-3,28
SC Rheindorf,260,6,7,6,11,22,29,-7,27
Mattersburg,260,7,6,5,13,30,43,-13,23
FC Salzburg,261,1,14,7,3,47,19,28,49
SK Sturm Gra,261,2,13,4,7,36,29,7,43
Rapid Vienna,261,3,10,9,5,36,28,8,39
Vienna,261,4,7,6,11,29,40,-11,27
LASK Linz,261,5,7,5,12,25,32,-7,26
Mattersburg,261,6,7,5,12,32,46,-14,26
SC Rheindorf,261,7,5,6,13,18,29,-11,21
FC Salzburg,262,1,16,6,2,48,17,31,54
SK Sturm Gra,262,2,12,4,8,33,32,1,40
Rapid Vienna,262,3,7,11,6,34,29,5,32
LASK Linz,262,4,8,6,10,29,30,-1,30
Mattersburg,262,5,6,7,11,30,41,-11,25
Vienna,262,6,6,6,12,24,40,-16,24
SC Rheindorf,262,7,5,8,11,19,28,-9,23
FC Salzburg,263,1,16,6,2,44,17,27,54
SK Sturm Gra,263,2,13,4,7,31,26,5,43
LASK Linz,263,3,9,5,10,27,30,-3,32
Rapid Vienna,263,4,7,9,8,34,31,3,30
Vienna,263,5,7,5,12,26,39,-13,26
SC Rheindorf,263,6,6,6,12,18,26,-8,24
Mattersburg,263,7,6,5,13,30,41,-11,23
FC Salzburg,264,1,13,9,2,46,18,28,48
Rapid Vienna,264,2,9,11,4,36,25,11,38
SK Sturm Gra,264,3,11,4,9,29,32,-3,37
LASK Linz,264,4,8,5,11,30,32,-2,29
SC Rheindorf,264,5,7,6,11,22,26,-4,27
Vienna,264,6,7,6,11,25,38,-13,27
Mattersburg,264,7,6,5,13,29,46,-17,23
FC Salzburg,265,1,15,7,2,43,16,27,52
SK Sturm Gra,265,2,12,5,7,30,25,5,41
Rapid Vienna,265,3,7,12,5,34,27,7,33
LASK Linz,265,4,9,6,9,30,30,0,33
SC Rheindorf,265,5,6,6,12,20,29,-9,24
Vienna,265,6,6,6,12,23,38,-15,24
Mattersburg,265,7,5,6,13,27,42,-15,21
FC Salzburg,266,1,15,7,2,51,18,33,52
SK Sturm Gra,266,2,11,4,9,30,31,-1,37
Rapid Vienna,266,3,8,9,7,33,31,2,33
LASK Linz,266,4,9,6,9,29,29,0,33
Vienna,266,5,7,6,11,27,39,-12,27
SC Rheindorf,266,6,6,7,11,23,28,-5,25
Mattersburg,266,7,6,5,13,30,47,-17,23
FC Salzburg,267,1,14,8,2,46,17,29,50
SK Sturm Gra,267,2,13,5,6,34,28,6,44
Rapid Vienna,267,3,7,11,6,33,27,6,32
LASK Linz,267,4,8,8,8,26,26,0,32
Vienna,267,5,7,5,12,27,42,-15,26
Mattersburg,267,6,6,6,12,29,42,-13,24
SC Rheindorf,267,7,4,7,13,17,30,-13,19
FC Salzburg,268,1,13,8,3,42,21,21,47
SK Sturm Gra,268,2,12,5,7,31,28,3,41
Rapid Vienna,268,3,9,10,5,38,29,9,37
LASK Linz,268,4,8,6,10,25,29,-4,30
Vienna,268,5,7,6,11,27,38,-11,27
Mattersburg,268,6,6,7,11,31,39,-8,25
SC Rheindorf,268,7,5,6,13,23,33,-10,21
FC Salzburg,269,1,14,6,4,42,19,23,48
SK Sturm Gra,269,2,11,5,8,31,29,2,38
Rapid Vienna,269,3,9,10,5,34,25,9,37
LASK Linz,269,4,8,6,10,27,29,-2,30
Vienna,269,5,8,5,11,29,39,-10,29
Mattersburg,269,6,6,6,12,29,42,-13,24
SC Rheindorf,269,7,5,8,11,18,27,-9,23
FC Salzburg,270,1,16,6,2,44,15,29,54
SK Sturm Gra,270,2,12,4,8,29,27,2,40
Rapid Vienna,270,3,8,10,6,33,29,4,34
LASK Linz,270,4,7,6,11,27,31,-4,27
Mattersburg,270,5,7,6,11,35,41,-6,27
SC Rheindorf,270,6,7,5,12,22,31,-9,26
Vienna,270,7,6,5,13,24,40,-16,23
FC Salzburg,271,1,15,6,3,43,16,27,51
SK Sturm Gra,271,2,13,3,8,31,27,4,42
Rapid Vienna,271,3,8,9,7,35,27,8,33
LASK Linz,271,4,8,6,10,25,29,-4,30
Vienna,271,5,7,5,12,26,40,-14,26
Mattersburg,271,6,6,7,11,31,42,-11,25
SC Rheindorf,271,7,6,6,12,20,30,-10,24
FC Salzburg,272,1,15,6,3,45,17,28,51
SK Sturm Gra,272,2,13,4,7,34,28,6,43
Rapid Vienna,272,3,9,10,5,37,26,11,37
LASK Linz,272,4,8,6,10,28,33,-5,30
Mattersburg,272,5,6,7,11,32,43,-11,25
Vienna,272,6,6,6,12,24,40,-16,24
SC Rheindorf,272,7,5,5,14,19,32,-13,20
FC Salzburg,273,1,13,7,4,42,18,24,46
SK Sturm Gra,273,2,13,3,8,32,28,4,42
Rapid Vienna,273,3,8,10,6,33,28,5,34
LASK Linz,273,4,8,8,8,26,26,0,32
Mattersburg,273,5,7,6,11,29,41,-12,27
SC Rheindorf,273,6,6,6,12,20,26,-6,24
Vienna,273,7,6,6,12,24,39,-15,24
FC Salzburg,274,1,15,6,3,48,20,28,51
SK Sturm Gra,274,2,13,4,7,33,28,5,43
Rapid Vienna,274,3,9,11,4,37,25,12,38
LASK Linz,274,4,7,6,11,25,31,-6,27
Vienna,274,5,7,5,12,26,42,-16,26
Mattersburg,274,6,6,6,12,34,43,-9,24
SC Rheindorf,274,7,5,6,13,17,31,-14,21
FC Salzburg,275,1,14,6,4,47,20,27,48
SK Sturm Gra,275,2,13,3,8,32,31,1,42
Rapid Vienna,275,3,10,10,4,38,26,12,40
Vienna,275,4,8,5,11,28,39,-11,29
LASK Linz,275,5,7,7,10,24,28,-4,28
SC Rheindorf,275,6,5,7,12,21,30,-9,22
Mattersburg,275,7,5,6,13,29,45,-16,21
FC Salzburg,276,1,14,7,3,43,17,26,49
SK Sturm Gra,276,2,12,4,8,30,27,3,40
Rapid Vienna,276,3,9,10,5,36,31,5,37
LASK Linz,276,4,9,5,10,35,33,2,32
Vienna,276,5,7,6,11,27,38,-11,27
Mattersburg,276,6,6,5,13,34,46,-12,23
SC Rheindorf,276,7,6,5,13,22,35,-13,23
FC Salzburg,277,1,15,7,2,45,16,29,52
SK Sturm Gra,277,2,12,5,7,32,30,2,41
Rapid Vienna,277,3,8,10,6,37,30,7,34
LASK Linz,277,4,9,5,10,27,28,-1,32
Vienna,277,5,6,7,11,26,40,-14,25
Mattersburg,277,6,6,6,12,32,41,-9,24
SC Rheindorf,277,7,5,6,13,17,31,-14,21
FC Salzburg,278,1,15,7,2,47,16,31,52
SK Sturm Gra,278,2,13,4,7,33,28,5,43
Rapid Vienna,278,3,8,10,6,34,29,5,34
LASK Linz,278,4,9,5,10,30,30,0,32
Vienna,278,5,7,5,12,26,39,-13,26
Mattersburg,278,6,6,5,13,28,44,-16,23
SC Rheindorf,278,7,5,6,13,19,31,-12,21
FC Salzburg,279,1,13,8,3,43,22,21,47
SK Sturm Gra,279,2,12,4,8,34,31,3,40
Rapid Vienna,279,3,9,10,5,38,27,11,37
LASK Linz,279,4,8,6,10,28,31,-3,30
Mattersburg,279,5,7,6,11,35,40,-5,27
Vienna,279,6,6,7,11,25,39,-14,25
SC Rheindorf,279,7,5,7,12,17,30,-13,22
FC Salzburg,280,1,13,9,2,44,18,26,48
SK Sturm Gra,280,2,13,5,6,35,26,9,44
Rapid Vienna,280,3,8,10,6,35,30,5,34
Mattersburg,280,4,8,6,10,39,40,-1,30
LASK Linz,280,5,8,6,10,28,32,-4,30
Vienna,280,6,6,5,13,24,42,-18,23
SC Rheindorf,280,7,5,5,14,17,34,-17,20
FC Salzburg,281,1,15,7,2,50,18,32,52
SK Sturm Gra,281,2,13,4,7,36,30,6,43
Rapid Vienna,281,3,8,10,6,34,32,2,34
Mattersburg,281,4,7,6,11,30,38,-8,27
LASK Linz,281,5,7,5,12,26,33,-7,26
Vienna,281,6,7,5,12,24,39,-15,26
SC Rheindorf,281,7,5,7,12,17,27,-10,22
FC Salzburg,282,1,16,6,2,51,15,36,54
SK Sturm Gra,282,2,12,3,9,30,33,-3,39
Rapid Vienna,282,3,9,9,6,36,28,8,36
LASK Linz,282,4,9,6,9,27,27,0,33
Mattersburg,282,5,6,7,11,30,42,-12,25
Vienna,282,6,6,6,12,24,40,-16,24
SC Rheindorf,282,7,5,5,14,20,33,-13,20
FC Salzburg,283,1,14,6,4,45,21,24,48
SK Sturm Gra,283,2,12,4,8,32,32,0,40
Rapid Vienna,283,3,10,9,5,39,25,14,39
LASK Linz,283,4,9,6,9,29,29,0,33
Mattersburg,283,5,7,6,11,37,44,-7,27
Vienna,283,6,7,5,12,25,41,-16,26
SC Rheindorf,283,7,4,6,14,18,33,-15,18
FC Salzburg,284,1,16,6,2,49,15,34,54
SK Sturm Gra,284,2,12,4,8,29,28,1,40
Rapid Vienna,284,3,9,9,6,38,26,12,36
LASK Linz,284,4,8,6,10,25,28,-3,30
Vienna,284,5,7,5,12,25,41,-16,26
Mattersburg,284,6,6,6,12,30,44,-14,24
SC Rheindorf,284,7,4,8,12,17,31,-14,20
FC Salzburg,285,1,15,6,3,48,22,26,51
SK Sturm Gra,285,2,12,4,8,33,31,2,40
Rapid Vienna,285,3,10,9,5,39,28,11,39
LASK Linz,285,4,10,5,9,33,29,4,35
Vienna,285,5,7,5,12,25,40,-15,26
Mattersburg,285,6,6,5,13,32,46,-14,23
SC Rheindorf,285,7,4,6,14,20,34,-14,18
FC Salzburg,286,1,12,8,4,41,21,20,44
SK Sturm Gra,286,2,12,5,7,31,25,6,41
Rapid Vienna,286,3,10,10,4,35,23,12,40
LASK Linz,286,4,9,5,10,29,29,0,32
Vienna,286,5,7,6,11,26,39,-13,27
SC Rheindorf,286,6,6,5,13,19,31,-12,23
Mattersburg,286,7,6,5,13,33,46,-13,23
FC Salzburg,287,1,13,8,3,44,20,24,47
SK Sturm Gra,287,2,13,5,6,34,27,7,44
Rapid Vienna,287,3,8,10,6,36,29,7,34
LASK Linz,287,4,8,7,9,27,28,-1,31
Vienna,287,5,7,6,11,29,39,-10,27
Mattersburg,287,6,7,5,12,33,47,-14,26
SC Rheindorf,287,7,5,5,14,18,31,-13,20
FC Salzburg,288,1,14,7,3,48,21,27,49
SK Sturm Gra,288,2,12,4,8,34,33,1,40
Rapid Vienna,288,3,8,10,6,37,30,7,34
LASK Linz,288,4,8,8,8,26,26,0,32
SC Rheindorf,288,5,7,5,12,24,31,-7,26
Vienna,288,6,6,7,11,27,41,-14,25
Mattersburg,288,7,5,7,12,28,42,-14,22
FC Salzburg,289,1,14,8,2,46,19,27,50
SK Sturm Gra,289,2,12,5,7,32,28,4,41
Rapid Vienna,289,3,9,11,4,39,28,11,38
LASK Linz,289,4,7,6,11,26,32,-6,27
Vienna,289,5,7,6,11,25,38,-13,27
Mattersburg,289,6,6,5,13,31,44,-13,23
SC Rheindorf,289,7,5,7,12,21,31,-10,22
FC Salzburg,290,1,15,7,2,50,18,32,52
SK Sturm Gra,290,2,12,3,9,32,31,1,39
Rapid Vienna,290,3,9,11,4,38,28,10,38
LASK Linz,290,4,8,5,11,26,29,-3,29
Mattersburg,290,5,7,6,11,29,40,-11,27
Vienna,290,6,6,5,13,24,43,-19,23
SC Rheindorf,290,7,5,7,12,19,29,-10,22
FC Salzburg,291,1,13,8,3,46,21,25,47
Rapid Vienna,291,2,9,11,4,39,29,10,38
SK Sturm Gra,291,3,11,4,9,31,33,-2,37
LASK Linz,291,4,8,6,10,29,32,-3,30
SC Rheindorf,291,5,7,6,11,29,31,-2,27
Vienna,291,6,7,5,12,25,39,-14,26
Mattersburg,291,7,6,6,12,31,45,-14,24
FC Salzburg,292,1,14,8,2,46,21,25,50
SK Sturm Gra,292,2,12,5,7,34,30,4,41
Rapid Vienna,292,3,10,10,4,40,28,12,40
LASK Linz,292,4,8,6,10,29,31,-2,30
Mattersburg,292,5,6,6,12,29,40,-11,24
Vienna,292,6,6,5,13,25,41,-16,23
SC Rheindorf,292,7,5,6,13,18,30,-12,21
FC Salzburg,293,1,14,6,4,48,22,26,48
SK Sturm Gra,293,2,12,3,9,32,35,-3,39
Rapid Vienna,293,3,9,9,6,39,31,8,36
LASK Linz,293,4,8,6,10,26,31,-5,30
Mattersburg,293,5,8,5,11,31,37,-6,29
Vienna,293,6,8,5,11,28,39,-11,29
SC Rheindorf,293,7,5,6,13,20,29,-9,21
FC Salzburg,294,1,15,7,2,45,16,29,52
SK Sturm Gra,294,2,11,4,9,31,30,1,37
Rapid Vienna,294,3,8,11,5,36,27,9,35
LASK Linz,294,4,8,6,10,25,28,-3,30
Mattersburg,294,5,7,7,10,34,42,-8,28
Vienna,294,6,6,6,12,25,42,-17,24
SC Rheindorf,294,7,6,5,13,21,32,-11,23
FC Salzburg,295,1,13,8,3,45,21,24,47
SK Sturm Gra,295,2,12,5,7,29,26,3,41
Rapid Vienna,295,3,8,11,5,36,28,8,35
LASK Linz,295,4,8,6,10,25,26,-1,30
Mattersburg,295,5,7,6,11,28,39,-11,27
Vienna,295,6,7,5,12,27,40,-13,26
SC Rheindorf,295,7,5,7,12,18,28,-10,22
FC Salzburg,296,1,13,6,5,44,23,21,45
SK Sturm Gra,296,2,13,4,7,33,26,7,43
Rapid Vienna,296,3,9,10,5,38,28,10,37
LASK Linz,296,4,8,5,11,25,30,-5,29
Vienna,296,5,8,5,11,28,38,-10,29
Mattersburg,296,6,7,5,12,31,41,-10,26
SC Rheindorf,296,7,6,5,13,19,32,-13,23
FC Salzburg,297,1,13,8,3,43,20,23,47
SK Sturm Gra,297,2,13,4,7,35,28,7,43
Rapid Vienna,297,3,9,9,6,35,27,8,36
LASK Linz,297,4,9,5,10,26,29,-3,32
Vienna,297,5,7,6,11,27,40,-13,27
Mattersburg,297,6,6,6,12,31,42,-11,24
SC Rheindorf,297,7,5,6,13,19,30,-11,21
FC Salzburg,298,1,14,7,3,43,21,22,49
Rapid Vienna,298,2,10,9,5,42,27,15,39
SK Sturm Gra,298,3,12,3,9,35,32,3,39
LASK Linz,298,4,9,5,10,27,30,-3,32
Mattersburg,298,5,7,6,11,34,40,-6,27
SC Rheindorf,298,6,6,5,13,21,35,-14,23
Vienna,298,7,6,5,13,26,43,-17,23
FC Salzburg,299,1,15,7,2,45,16,29,52
SK Sturm Gra,299,2,12,4,8,34,32,2,40
LASK Linz,299,3,9,5,10,28,27,1,32
Rapid Vienna,299,4,7,10,7,38,36,2,31
SC Rheindorf,299,5,7,6,11,25,30,-5,27
Vienna,299,6,7,5,12,26,41,-15,26
Mattersburg,299,7,6,5,13,30,44,-14,23
FC Salzburg,300,1,15,7,2,51,19,32,52
SK Sturm Gra,300,2,11,7,6,32,28,4,40
Rapid Vienna,300,3,8,10,6,35,29,6,34
LASK Linz,300,4,8,8,8,29,29,0,32
Vienna,300,5,6,6,12,23,41,-18,24
Mattersburg,300,6,5,8,11,30,43,-13,23
SC Rheindorf,300,7,4,8,12,19,30,-11,20
FC Salzburg,301,1,13,7,4,44,22,22,46
SK Sturm Gra,301,2,14,4,6,34,27,7,46
Rapid Vienna,301,3,9,10,5,39,28,11,37
LASK Linz,301,4,8,7,9,27,28,-1,31
Vienna,301,5,7,5,12,27,42,-15,26
Mattersburg,301,6,6,7,11,33,43,-10,25
SC Rheindorf,301,7,4,6,14,18,32,-14,18
FC Salzburg,302,1,15,7,2,48,19,29,52
SK Sturm Gra,302,2,12,4,8,32,30,2,40
Rapid Vienna,302,3,9,10,5,38,28,10,37
LASK Linz,302,4,8,5,11,24,27,-3,29
Mattersburg,302,5,7,5,12,33,42,-9,26
Vienna,302,6,7,5,12,27,42,-15,26
SC Rheindorf,302,7,5,6,13,17,31,-14,21
FC Salzburg,303,1,15,6,3,45,20,25,51
Rapid Vienna,303,2,11,9,4,44,25,19,42
SK Sturm Gra,303,3,13,3,8,35,31,4,42
LASK Linz,303,4,9,5,10,27,28,-1,32
Mattersburg,303,5,7,5,12,33,41,-8,26
Vienna,303,6,6,5,13,25,42,-17,23
SC Rheindorf,303,7,4,5,15,18,40,-22,17
FC Salzburg,304,1,13,7,4,44,20,24,46
SK Sturm Gra,304,2,12,5,7,34,29,5,41
LASK Linz,304,3,9,6,9,29,29,0,33
Rapid Vienna,304,4,7,11,6,34,31,3,32
Mattersburg,304,5,8,5,11,36,42,-6,29
Vienna,304,6,7,5,12,25,41,-16,26
SC Rheindorf,304,7,5,7,12,20,30,-10,22
FC Salzburg,305,1,16,6,2,46,17,29,54
SK Sturm Gra,305,2,12,5,7,34,27,7,41
Rapid Vienna,305,3,8,11,5,34,26,8,35
LASK Linz,305,4,8,8,8,28,27,1,32
Mattersburg,305,5,7,5,12,32,42,-10,26
Vienna,305,6,6,5,13,24,42,-18,23
SC Rheindorf,305,7,4,6,14,18,35,-17,18
FC Salzburg,306,1,15,7,2,47,19,28,52
SK Sturm Gra,306,2,12,4,8,34,33,1,40
Rapid Vienna,306,3,8,10,6,40,34,6,34
LASK Linz,306,4,9,6,9,29,28,1,33
Vienna,306,5,7,6,11,26,39,-13,27
Mattersburg,306,6,6,6,12,31,42,-11,24
SC Rheindorf,306,7,5,5,14,18,30,-12,20
FC Salzburg,307,1,15,6,3,45,19,26,51
SK Sturm Gra,307,2,12,3,9,32,30,2,39
Rapid Vienna,307,3,9,9,6,39,33,6,36
Mattersburg,307,4,7,6,11,32,42,-10,27
Vienna,307,5,7,6,11,27,39,-12,27
SC Rheindorf,307,6,7,5,12,26,30,-4,26
LASK Linz,307,7,7,5,12,26,34,-8,26
FC Salzburg,308,1,16,6,2,48,15,33,54
SK Sturm Gra,308,2,13,4,7,33,29,4,43
Rapid Vienna,308,3,8,10,6,33,28,5,34
LASK Linz,308,4,8,6,10,26,31,-5,30
Mattersburg,308,5,6,6,12,31,42,-11,24
Vienna,308,6,6,6,12,24,39,-15,24
SC Rheindorf,308,7,5,6,13,19,30,-11,21
FC Salzburg,309,1,16,6,2,47,16,31,54
SK Sturm Gra,309,2,13,4,7,33,31,2,43
Rapid Vienna,309,3,8,10,6,34,28,6,34
LASK Linz,309,4,9,7,8,30,26,4,34
Vienna,309,5,7,5,12,26,40,-14,26
SC Rheindorf,309,6,5,5,14,18,30,-12,20
Mattersburg,309,7,5,5,14,28,45,-17,20
FC Salzburg,310,1,14,8,2,45,17,28,50
SK Sturm Gra,310,2,13,4,7,32,29,3,43
Rapid Vienna,310,3,9,9,6,36,28,8,36
Mattersburg,310,4,8,6,10,32,37,-5,30
LASK Linz,310,5,7,5,12,24,32,-8,26
Vienna,310,6,6,6,12,24,39,-15,24
SC Rheindorf,310,7,5,6,13,18,29,-11,21
FC Salzburg,311,1,15,7,2,49,18,31,52
SK Sturm Gra,311,2,11,5,8,36,36,0,38
Rapid Vienna,311,3,9,10,5,37,29,8,37
LASK Linz,311,4,9,5,10,28,28,0,32
Mattersburg,311,5,7,5,12,30,41,-11,26
SC Rheindorf,311,6,6,5,13,21,30,-9,23
Vienna,311,7,6,5,13,23,42,-19,23
FC Salzburg,312,1,15,6,3,45,17,28,51
SK Sturm Gra,312,2,13,3,8,33,29,4,42
Rapid Vienna,312,3,9,10,5,37,27,10,37
LASK Linz,312,4,8,5,11,25,32,-7,29
Mattersburg,312,5,7,6,11,31,40,-9,27
Vienna,312,6,6,5,13,23,39,-16,23
SC Rheindorf,312,7,5,7,12,18,28,-10,22
FC Salzburg,313,1,14,7,3,44,18,26,49
SK Sturm Gra,313,2,13,4,7,35,29,6,43
Rapid Vienna,313,3,8,10,6,35,28,7,34
LASK Linz,313,4,8,6,10,26,27,-1,30
Mattersburg,313,5,7,6,11,31,43,-12,27
Vienna,313,6,6,6,12,24,39,-15,24
SC Rheindorf,313,7,6,5,13,21,32,-11,23
FC Salzburg,314,1,14,7,3,45,20,25,49
Rapid Vienna,314,2,10,10,4,40,24,16,40
SK Sturm Gra,314,3,12,3,9,30,31,-1,39
LASK Linz,314,4,8,6,10,25,27,-2,30
Vienna,314,5,7,6,11,26,38,-12,27
SC Rheindorf,314,6,7,5,12,20,28,-8,26
Mattersburg,314,7,5,5,14,29,47,-18,20
FC Salzburg,315,1,15,7,2,46,16,30,52
SK Sturm Gra,315,2,12,5,7,32,28,4,41
LASK Linz,315,3,10,6,8,35,27,8,36
Rapid Vienna,315,4,8,10,6,34,27,7,34
Vienna,315,5,7,5,12,25,42,-17,26
Mattersburg,315,6,6,6,12,30,42,-12,24
SC Rheindorf,315,7,4,5,15,17,37,-20,17
FC Salzburg,316,1,15,6,3,48,17,31,51
SK Sturm Gra,316,2,11,5,8,31,33,-2,38
Rapid Vienna,316,3,8,12,4,36,27,9,36
LASK Linz,316,4,8,8,8,30,29,1,32
Vienna,316,5,7,5,12,24,40,-16,26
SC Rheindorf,316,6,5,7,12,22,30,-8,22
Mattersburg,316,7,5,7,12,28,43,-15,22
FC Salzburg,317,1,13,7,4,43,23,20,46
SK Sturm Gra,317,2,14,3,7,33,26,7,45
Rapid Vienna,317,3,9,10,5,36,25,11,37
Vienna,317,4,8,5,11,26,37,-11,29
LASK Linz,317,5,7,7,10,25,30,-5,28
SC Rheindorf,317,6,5,7,12,17,27,-10,22
Mattersburg,317,7,5,7,12,30,42,-12,22
FC Salzburg,318,1,14,7,3,45,17,28,49
SK Sturm Gra,318,2,12,4,8,31,28,3,40
Rapid Vienna,318,3,9,9,6,34,27,7,36
LASK Linz,318,4,9,6,9,27,27,0,33
Vienna,318,5,7,5,12,27,43,-16,26
Mattersburg,318,6,6,6,12,32,44,-12,24
SC Rheindorf,318,7,6,5,13,20,30,-10,23
FC Salzburg,319,1,14,7,3,43,17,26,49
SK Sturm Gra,319,2,11,4,9,30,30,0,37
Rapid Vienna,319,3,8,11,5,35,27,8,35
LASK Linz,319,4,8,7,9,29,31,-2,31
SC Rheindorf,319,5,7,6,11,25,30,-5,27
Vienna,319,6,6,7,11,25,39,-14,25
Mattersburg,319,7,6,6,12,30,43,-13,24
FC Salzburg,320,1,14,7,3,45,17,28,49
SK Sturm Gra,320,2,13,5,6,32,24,8,44
Rapid Vienna,320,3,10,9,5,35,26,9,39
LASK Linz,320,4,8,5,11,27,29,-2,29
Mattersburg,320,5,6,7,11,27,40,-13,25
Vienna,320,6,6,6,12,24,40,-16,24
SC Rheindorf,320,7,4,7,13,15,29,-14,19
FC Salzburg,321,1,16,6,2,46,16,30,54
SK Sturm Gra,321,2,12,3,9,31,33,-2,39
Rapid Vienna,321,3,8,10,6,35,26,9,34
LASK Linz,321,4,8,7,9,26,28,-2,31
Vienna,321,5,7,5,12,27,40,-13,26
SC Rheindorf,321,6,6,7,11,24,32,-8,25
Mattersburg,321,7,5,6,13,30,44,-14,21
FC Salzburg,322,1,14,7,3,44,19,25,49
SK Sturm Gra,322,2,12,4,8,32,28,4,40
Rapid Vienna,322,3,9,11,4,35,25,10,38
LASK Linz,322,4,8,7,9,27,28,-1,31
Mattersburg,322,5,6,8,10,33,41,-8,26
Vienna,322,6,6,6,12,25,41,-16,24
SC Rheindorf,322,7,4,7,13,18,32,-14,19
FC Salzburg,323,1,15,6,3,48,23,25,51
SK Sturm Gra,323,2,12,4,8,31,29,2,40
LASK Linz,323,3,10,5,9,28,26,2,35
Rapid Vienna,323,4,8,10,6,37,29,8,34
Vienna,323,5,7,5,12,25,39,-14,26
SC Rheindorf,323,6,6,7,11,19,27,-8,25
Mattersburg,323,7,5,5,14,30,45,-15,20
FC Salzburg,324,1,13,8,3,40,17,23,47
SK Sturm Gra,324,2,13,5,6,33,27,6,44
Rapid Vienna,324,3,9,10,5,37,26,11,37
Mattersburg,324,4,8,5,11,31,39,-8,29
LASK Linz,324,5,7,6,11,25,30,-5,27
Vienna,324,6,6,6,12,24,39,-15,24
SC Rheindorf,324,7,5,6,13,20,32,-12,21
FC Salzburg,325,1,16,6,2,54,17,37,54
SK Sturm Gra,325,2,13,3,8,31,27,4,42
Rapid Vienna,325,3,8,10,6,34,28,6,34
LASK Linz,325,4,9,5,10,27,30,-3,32
Mattersburg,325,5,7,5,12,33,46,-13,26
Vienna,325,6,6,5,13,23,42,-19,23
SC Rheindorf,325,7,5,6,13,19,31,-12,21
FC Salzburg,326,1,13,7,4,43,20,23,46
SK Sturm Gra,326,2,13,3,8,34,29,5,42
Rapid Vienna,326,3,10,10,4,36,24,12,40
LASK Linz,326,4,9,6,9,28,30,-2,33
Vienna,326,5,7,6,11,28,39,-11,27
SC Rheindorf,326,6,6,5,13,21,31,-10,23
Mattersburg,326,7,5,5,14,27,44,-17,20
FC Salzburg,327,1,14,6,4,43,22,21,48
SK Sturm Gra,327,2,14,3,7,39,32,7,45
Rapid Vienna,327,3,8,9,7,41,33,8,33
LASK Linz,327,4,9,6,9,28,29,-1,33
SC Rheindorf,327,5,7,5,12,21,29,-8,26
Vienna,327,6,7,5,12,29,43,-14,26
Mattersburg,327,7,5,6,13,34,47,-13,21
FC Salzburg,328,1,13,9,2,44,18,26,48
SK Sturm Gra,328,2,11,5,8,30,29,1,38
Rapid Vienna,328,3,8,11,5,33,24,9,35
LASK Linz,328,4,7,8,9,26,28,-2,29
Mattersburg,328,5,7,7,10,31,39,-8,28
SC Rheindorf,328,6,6,7,11,19,27,-8,25
Vienna,328,7,6,5,13,24,42,-18,23
FC Salzburg,329,1,15,7,2,46,17,29,52
SK Sturm Gra,329,2,13,3,8,32,29,3,42
Rapid Vienna,329,3,9,10,5,37,27,10,37
LASK Linz,329,4,8,5,11,27,33,-6,29
Vienna,329,5,7,5,12,26,40,-14,26
Mattersburg,329,6,6,5,13,32,43,-11,23
SC Rheindorf,329,7,6,5,13,21,32,-11,23
FC Salzburg,330,1,14,7,3,44,21,23,49
SK Sturm Gra,330,2,13,5,6,34,27,7,44
Rapid Vienna,330,3,7,10,7,34,31,3,31
LASK Linz,330,4,7,8,9,30,32,-2,29
Vienna,330,5,7,6,11,27,37,-10,27
SC Rheindorf,330,6,6,6,12,22,28,-6,24
Mattersburg,330,7,6,6,12,30,45,-15,24
FC Salzburg,331,1,13,8,3,45,20,25,47
SK Sturm Gra,331,2,11,6,7,32,30,2,39
Rapid Vienna,331,3,7,12,5,35,29,6,33
LASK Linz,331,4,9,6,9,30,26,4,33
Vienna,331,5,8,5,11,28,40,-12,29
SC Rheindorf,331,6,6,6,12,19,27,-8,24
Mattersburg,331,7,6,5,13,28,45,-17,23
FC Salzburg,332,1,15,6,3,48,17,31,51
SK Sturm Gra,332,2,13,4,7,34,27,7,43
Rapid Vienna,332,3,8,10,6,35,30,5,34
LASK Linz,332,4,7,8,9,24,27,-3,29
Mattersburg,332,5,7,7,10,31,39,-8,28
Vienna,332,6,6,5,13,23,42,-19,23
SC Rheindorf,332,7,4,8,12,17,30,-13,20
FC Salzburg,333,1,14,8,2,46,18,28,50
SK Sturm Gra,333,2,13,4,7,34,29,5,43
Rapid Vienna,333,3,8,10,6,35,30,5,34
LASK Linz,333,4,7,7,10,26,30,-4,28
Mattersburg,333,5,7,7,10,36,44,-8,28
Vienna,333,6,6,6,12,27,42,-15,24
SC Rheindorf,333,7,5,6,13,20,31,-11,21
FC Salzburg,334,1,15,6,3,47,19,28,51
Rapid Vienna,334,2,10,10,4,41,29,12,40
SK Sturm Gra,334,3,12,4,8,34,32,2,40
LASK Linz,334,4,7,7,10,30,36,-6,28
Mattersburg,334,5,6,6,12,31,42,-11,24
SC Rheindorf,334,6,5,8,11,21,30,-9,23
Vienna,334,7,6,5,13,23,39,-16,23
FC Salzburg,335,1,14,7,3,42,19,23,49
SK Sturm Gra,335,2,14,3,7,34,26,8,45
Rapid Vienna,335,3,9,10,5,35,26,9,37
LASK Linz,335,4,9,5,10,27,27,0,32
Vienna,335,5,7,5,12,25,38,-13,26
SC Rheindorf,335,6,5,6,13,19,31,-12,21
Mattersburg,335,7,5,6,13,29,44,-15,21
FC Salzburg,336,1,14,8,2,44,17,27,50
SK Sturm Gra,336,2,12,4,8,31,27,4,40
LASK Linz,336,3,10,5,9,31,28,3,35
Rapid Vienna,336,4,8,10,6,34,27,7,34
SC Rheindorf,336,5,6,6,12,20,31,-11,24
Vienna,336,6,6,6,12,25,40,-15,24
Mattersburg,336,7,5,7,12,30,45,-15,22
FC Salzburg,337,1,13,9,2,44,19,25,48
SK Sturm Gra,337,2,12,5,7,32,25,7,41
LASK Linz,337,3,10,6,8,31,26,5,36
Rapid Vienna,337,4,7,12,5,34,29,5,33
Mattersburg,337,5,6,7,11,31,41,-10,25
Vienna,337,6,6,6,12,23,39,-16,24
SC Rheindorf,337,7,4,7,13,15,31,-16,19
FC Salzburg,338,1,13,9,2,44,18,26,48
SK Sturm Gra,338,2,12,6,6,36,31,5,42
Rapid Vienna,338,3,9,11,4,42,30,12,38
LASK Linz,338,4,9,6,9,28,30,-2,33
Mattersburg,338,5,7,6,11,32,41,-9,27
Vienna,338,6,6,5,13,26,44,-18,23
SC Rheindorf,338,7,4,5,15,20,34,-14,17
FC Salzburg,339,1,15,7,2,47,19,28,52
SK Sturm Gra,339,2,12,3,9,33,30,3,39
Rapid Vienna,339,3,9,9,6,39,31,8,36
LASK Linz,339,4,9,5,10,29,31,-2,32
Mattersburg,339,5,6,6,12,34,45,-11,24
SC Rheindorf,339,6,6,6,12,22,33,-11,24
Vienna,339,7,6,6,12,26,41,-15,24
FC Salzburg,340,1,15,7,2,45,18,27,52
SK Sturm Gra,340,2,14,4,6,37,27,10,46
Rapid Vienna,340,3,8,9,7,35,30,5,33
SC Rheindorf,340,4,7,5,12,25,28,-3,26
LASK Linz,340,5,7,5,12,23,35,-12,26
Vienna,340,6,7,5,12,25,40,-15,26
Mattersburg,340,7,6,5,13,31,43,-12,23
FC Salzburg,341,1,16,6,2,49,15,34,54
Rapid Vienna,341,2,10,9,5,36,27,9,39
SK Sturm Gra,341,3,11,3,10,30,33,-3,36
LASK Linz,341,4,8,7,9,29,30,-1,31
Vienna,341,5,7,5,12,26,38,-12,26
Mattersburg,341,6,6,6,12,29,45,-16,24
SC Rheindorf,341,7,5,6,13,18,29,-11,21
FC Salzburg,342,1,15,6,3,48,21,27,51
SK Sturm Gra,342,2,11,6,7,31,29,2,39
Rapid Vienna,342,3,8,11,5,34,25,9,35
LASK Linz,342,4,8,8,8,32,31,1,32
Vienna,342,5,7,5,12,27,42,-15,26
Mattersburg,342,6,6,7,11,32,42,-10,25
SC Rheindorf,342,7,4,7,13,18,32,-14,19
FC Salzburg,343,1,14,6,4,46,21,25,48
SK Sturm Gra,343,2,12,4,8,31,28,3,40
Rapid Vienna,343,3,9,10,5,36,26,10,37
Mattersburg,343,4,9,5,10,35,39,-4,32
LASK Linz,343,5,7,8,9,24,27,-3,29
Vienna,343,6,6,5,13,24,44,-20,23
SC Rheindorf,343,7,5,6,13,17,28,-11,21
FC Salzburg,344,1,15,7,2,46,18,28,52
SK Sturm Gra,344,2,12,4,8,33,32,1,40
LASK Linz,344,3,9,7,8,26,25,1,34
Rapid Vienna,344,4,7,11,6,34,28,6,32
Vienna,344,5,7,5,12,26,40,-14,26
SC Rheindorf,344,6,5,8,11,19,27,-8,23
Mattersburg,344,7,5,6,13,29,43,-14,21
FC Salzburg,345,1,14,8,2,47,20,27,50
SK Sturm Gra,345,2,12,4,8,35,34,1,40
Rapid Vienna,345,3,8,10,6,34,28,6,34
LASK Linz,345,4,8,7,9,29,30,-1,31
Mattersburg,345,5,6,8,10,34,42,-8,26
Vienna,345,6,6,7,11,27,41,-14,25
SC Rheindorf,345,7,5,6,13,21,32,-11,21
FC Salzburg,346,1,14,7,3,46,16,30,49
SK Sturm Gra,346,2,14,3,7,34,28,6,45
Rapid Vienna,346,3,8,10,6,32,26,6,34
LASK Linz,346,4,8,7,9,26,27,-1,31
Vienna,346,5,6,6,12,24,44,-20,24
Mattersburg,346,6,5,8,11,27,39,-12,23
SC Rheindorf,346,7,5,7,12,17,26,-9,22
FC Salzburg,347,1,14,7,3,45,18,27,49
SK Sturm Gra,347,2,14,3,7,36,30,6,45
LASK Linz,347,3,10,5,9,34,29,5,35
Rapid Vienna,347,4,7,10,7,32,32,0,31
Vienna,347,5,7,6,11,26,39,-13,27
Mattersburg,347,6,6,6,12,31,44,-13,24
SC Rheindorf,347,7,4,7,13,18,30,-12,19
FC Salzburg,348,1,14,7,3,45,19,26,49
SK Sturm Gra,348,2,11,6,7,30,28,2,39
Rapid Vienna,348,3,9,11,4,37,25,12,38
LASK Linz,348,4,8,6,10,27,30,-3,30
Mattersburg,348,5,7,5,12,33,45,-12,26
Vienna,348,6,7,5,12,28,41,-13,26
SC Rheindorf,348,7,5,6,13,19,31,-12,21
FC Salzburg,349,1,13,8,3,42,19,23,47
SK Sturm Gra,349,2,13,4,7,33,29,4,43
Rapid Vienna,349,3,9,10,5,36,27,9,37
LASK Linz,349,4,9,5,10,31,29,2,32
Vienna,349,5,7,5,12,25,39,-14,26
SC Rheindorf,349,6,6,5,13,21,32,-11,23
Mattersburg,349,7,6,5,13,30,43,-13,23
FC Salzburg,350,1,15,6,3,49,20,29,51
SK Sturm Gra,350,2,12,5,7,35,31,4,41
Rapid Vienna,350,3,7,11,6,35,31,4,32
LASK Linz,350,4,7,8,9,30,33,-3,29
Vienna,350,5,7,6,11,27,39,-12,27
SC Rheindorf,350,6,5,8,11,23,31,-8,23
Mattersburg,350,7,5,8,11,34,48,-14,23
FC Salzburg,351,1,13,8,3,43,22,21,47
SK Sturm Gra,351,2,12,5,7,30,28,2,41
Rapid Vienna,351,3,8,10,6,39,30,9,34
LASK Linz,351,4,9,5,10,28,30,-2,32
Vienna,351,5,8,5,11,29,39,-10,29
Mattersburg,351,6,6,6,12,29,40,-11,24
SC Rheindorf,351,7,6,5,13,21,30,-9,23
FC Salzburg,352,1,14,8,2,44,18,26,50
SK Sturm Gra,352,2,13,5,6,32,26,6,44
LASK Linz,352,3,9,5,10,29,29,0,32
Rapid Vienna,352,4,7,10,7,34,30,4,31
Mattersburg,352,5,7,6,11,31,40,-9,27
Vienna,352,6,7,5,12,25,39,-14,26
SC Rheindorf,352,7,5,5,14,19,32,-13,20
FC Salzburg,353,1,16,6,2,52,17,35,54
SK Sturm Gra,353,2,12,4,8,33,30,3,40
Rapid Vienna,353,3,8,10,6,35,31,4,34
LASK Linz,353,4,8,6,10,27,29,-2,30
Mattersburg,353,5,8,5,11,32,40,-8,29
Vienna,353,6,6,5,13,23,41,-18,23
SC Rheindorf,353,7,5,6,13,16,30,-14,21
FC Salzburg,354,1,16,6,2,47,15,32,54
SK Sturm Gra,354,2,11,5,8,31,30,1,38
Rapid Vienna,354,3,7,12,5,33,28,5,33
LASK Linz,354,4,9,6,9,28,29,-1,33
Vienna,354,5,7,5,12,26,41,-15,26
Mattersburg,354,6,6,5,13,31,45,-14,23
SC Rheindorf,354,7,5,7,12,21,29,-8,22
FC Salzburg,355,1,15,7,2,44,16,28,52
SK Sturm Gra,355,2,12,3,9,31,31,0,39
Rapid Vienna,355,3,9,11,4,34,23,11,38
LASK Linz,355,4,8,7,9,28,30,-2,31
Vienna,355,5,7,5,12,26,40,-14,26
Mattersburg,355,6,6,6,12,31,41,-10,24
SC Rheindorf,355,7,4,7,13,19,32,-13,19
FC Salzburg,356,1,16,6,2,50,17,33,54
SK Sturm Gra,356,2,11,4,9,30,29,1,37
Rapid Vienna,356,3,8,9,7,34,31,3,33
LASK Linz,356,4,8,6,10,24,28,-4,30
SC Rheindorf,356,5,8,5,11,20,26,-6,29
Mattersburg,356,6,6,6,12,32,43,-11,24
Vienna,356,7,6,6,12,25,41,-16,24
FC Salzburg,357,1,15,7,2,47,17,30,52
SK Sturm Gra,357,2,12,4,8,31,30,1,40
Rapid Vienna,357,3,7,10,7,34,35,-1,31
LASK Linz,357,4,8,6,10,32,32,0,30
Vienna,357,5,7,6,11,31,40,-9,27
Mattersburg,357,6,7,5,12,31,45,-14,26
SC Rheindorf,357,7,6,6,12,23,30,-7,24
FC Salzburg,358,1,15,7,2,50,19,31,52
SK Sturm Gra,358,2,12,5,7,31,28,3,41
Rapid Vienna,358,3,7,13,4,35,27,8,34
LASK Linz,358,4,7,6,11,24,29,-5,27
Mattersburg,358,5,7,5,12,34,45,-11,26
Vienna,358,6,7,5,12,25,39,-14,26
SC Rheindorf,358,7,5,7,12,18,30,-12,22
FC Salzburg,359,1,15,7,2,49,18,31,52
SK Sturm Gra,359,2,12,3,9,29,28,1,39
Rapid Vienna,359,3,9,10,5,34,25,9,37
LASK Linz,359,4,9,6,9,27,26,1,33
Vienna,359,5,7,5,12,26,40,-14,26
SC Rheindorf,359,6,6,6,12,17,26,-9,24
Mattersburg,359,7,5,5,14,27,46,-19,20
FC Salzburg,360,1,15,7,2,45,17,28,52
SK Sturm Gra,360,2,12,5,7,32,27,5,41
Rapid Vienna,360,3,8,11,5,37,30,7,35
LASK Linz,360,4,8,7,9,26,28,-2,31
Vienna,360,5,6,7,11,25,39,-14,25
SC Rheindorf,360,6,5,7,12,19,29,-10,22
Mattersburg,360,7,5,6,13,30,44,-14,21
FC Salzburg,361,1,15,6,3,44,16,28,51
SK Sturm Gra,361,2,12,4,8,33,29,4,40
Rapid Vienna,361,3,9,9,6,36,31,5,36
LASK Linz,361,4,9,5,10,28,28,0,32
Mattersburg,361,5,8,5,11,33,41,-8,29
Vienna,361,6,6,5,13,25,42,-17,23
SC Rheindorf,361,7,5,6,13,19,31,-12,21
FC Salzburg,362,1,15,6,3,48,17,31,51
Rapid Vienna,362,2,10,10,4,45,30,15,40
SK Sturm Gra,362,3,12,4,8,31,30,1,40
LASK Linz,362,4,8,5,11,28,31,-3,29
SC Rheindorf,362,5,6,6,12,22,34,-12,24
Vienna,362,6,6,6,12,24,41,-17,24
Mattersburg,362,7,5,7,12,29,44,-15,22
FC Salzburg,363,1,15,6,3,48,22,26,51
SK Sturm Gra,363,2,12,4,8,34,31,3,40
Rapid Vienna,363,3,9,10,5,36,28,8,37
LASK Linz,363,4,7,9,8,29,30,-1,30
Vienna,363,5,7,5,12,27,41,-14,26
Mattersburg,363,6,6,6,12,31,42,-11,24
SC Rheindorf,363,7,5,6,13,19,30,-11,21
FC Salzburg,364,1,15,7,2,48,18,30,52
SK Sturm Gra,364,2,11,5,8,29,27,2,38
Rapid Vienna,364,3,8,10,6,34,30,4,34
LASK Linz,364,4,9,6,9,27,27,0,33
Mattersburg,364,5,6,7,11,31,42,-11,25
Vienna,364,6,6,7,11,26,40,-14,25
SC Rheindorf,364,7,4,8,12,16,27,-11,20
FC Salzburg,365,1,13,8,3,43,20,23,47
SK Sturm Gra,365,2,12,5,7,31,28,3,41
LASK Linz,365,3,9,6,9,27,26,1,33
Rapid Vienna,365,4,7,10,7,33,29,4,31
Vienna,365,5,8,5,11,26,38,-12,29
SC Rheindorf,365,6,6,6,12,20,29,-9,24
Mattersburg,365,7,6,6,12,30,40,-10,24
FC Salzburg,366,1,15,7,2,44,18,26,52
SK Sturm Gra,366,2,11,4,9,30,31,-1,37
Rapid Vienna,366,3,8,9,7,36,29,7,33
LASK Linz,366,4,8,7,9,27,29,-2,31
Vienna,366,5,7,6,11,28,39,-11,27
Mattersburg,366,6,7,5,12,33,42,-9,26
SC Rheindorf,366,7,6,6,12,18,28,-10,24
FC Salzburg,367,1,13,8,3,43,20,23,47
SK Sturm Gra,367,2,12,5,7,30,29,1,41
LASK Linz,367,3,11,5,8,36,27,9,38
Rapid Vienna,367,4,7,12,5,33,27,6,33
Mattersburg,367,5,6,6,12,31,43,-12,24
Vienna,367,6,6,6,12,26,41,-15,24
SC Rheindorf,367,7,4,8,12,18,30,-12,20
FC Salzburg,368,1,13,7,4,41,19,22,46
Rapid Vienna,368,2,10,10,4,39,27,12,40
SK Sturm Gra,368,3,12,4,8,33,32,1,40
LASK Linz,368,4,8,6,10,31,32,-1,30
Vienna,368,5,7,5,12,25,38,-13,26
Mattersburg,368,6,6,7,11,31,41,-10,25
SC Rheindorf,368,7,5,7,12,18,29,-11,22
FC Salzburg,369,1,15,6,3,47,16,31,51
SK Sturm Gra,369,2,15,3,6,34,25,9,48
Rapid Vienna,369,3,8,9,7,34,31,3,33
LASK Linz,369,4,9,6,9,26,25,1,33
Mattersburg,369,5,6,6,12,30,42,-12,24
Vienna,369,6,6,6,12,25,42,-17,24
SC Rheindorf,369,7,4,6,14,18,33,-15,18
FC Salzburg,370,1,15,7,2,46,18,28,52
SK Sturm Gra,370,2,13,4,7,34,28,6,43
Rapid Vienna,370,3,9,9,6,35,28,7,36
LASK Linz,370,4,8,6,10,27,28,-1,30
Mattersburg,370,5,6,6,12,32,45,-13,24
SC Rheindorf,370,6,6,5,13,21,32,-11,23
Vienna,370,7,6,5,13,26,42,-16,23
FC Salzburg,371,1,15,6,3,45,17,28,51
SK Sturm Gra,371,2,13,3,8,34,29,5,42
Rapid Vienna,371,3,9,9,6,34,29,5,36
LASK Linz,371,4,8,7,9,28,29,-1,31
Mattersburg,371,5,6,7,11,32,42,-10,25
Vienna,371,6,6,6,12,25,42,-17,24
SC Rheindorf,371,7,5,6,13,19,29,-10,21
FC Salzburg,372,1,15,6,3,46,20,26,51
SK Sturm Gra,372,2,14,4,6,36,28,8,46
Rapid Vienna,372,3,8,10,6,39,31,8,34
LASK Linz,372,4,8,6,10,26,32,-6,30
Mattersburg,372,5,8,5,11,36,38,-2,29
Vienna,372,6,6,5,13,24,42,-18,23
SC Rheindorf,372,7,4,6,14,22,38,-16,18
FC Salzburg,373,1,15,7,2,50,18,32,52
SK Sturm Gra,373,2,13,3,8,34,30,4,42
LASK Linz,373,3,9,7,8,28,26,2,34
Rapid Vienna,373,4,7,12,5,35,28,7,33
Mattersburg,373,5,6,7,11,28,40,-12,25
Vienna,373,6,6,6,12,23,41,-18,24
SC Rheindorf,373,7,4,6,14,16,31,-15,18
SK Sturm Gra,374,1,14,4,6,33,24,9,46
FC Salzburg,374,2,13,6,5,40,19,21,45
Rapid Vienna,374,3,9,9,6,37,33,4,36
LASK Linz,374,4,9,5,10,33,30,3,32
Mattersburg,374,5,7,5,12,30,41,-11,26
SC Rheindorf,374,6,6,6,12,21,30,-9,24
Vienna,374,7,6,5,13,23,40,-17,23
FC Salzburg,375,1,16,6,2,47,18,29,54
SK Sturm Gra,375,2,13,4,7,32,27,5,43
Rapid Vienna,375,3,7,11,6,37,32,5,32
LASK Linz,375,4,7,9,8,31,32,-1,30
Vienna,375,5,7,5,12,29,42,-13,26
Mattersburg,375,6,6,6,12,33,46,-13,24
SC Rheindorf,375,7,4,7,13,18,30,-12,19
FC Salzburg,376,1,14,7,3,49,23,26,49
SK Sturm Gra,376,2,11,4,9,30,32,-2,37
LASK Linz,376,3,10,5,9,27,28,-1,35
Rapid Vienna,376,4,7,12,5,33,26,7,33
Mattersburg,376,5,7,5,12,32,42,-10,26
Vienna,376,6,7,5,12,27,40,-13,26
SC Rheindorf,376,7,6,6,12,20,27,-7,24
FC Salzburg,377,1,15,6,3,46,19,27,51
Rapid Vienna,377,2,10,10,4,44,27,17,40
SK Sturm Gra,377,3,12,3,9,34,33,1,39
LASK Linz,377,4,7,8,9,27,30,-3,29
Vienna,377,5,6,6,12,24,39,-15,24
Mattersburg,377,6,5,8,11,29,42,-13,23
SC Rheindorf,377,7,5,7,12,19,33,-14,22
FC Salzburg,378,1,15,6,3,45,19,26,51
SK Sturm Gra,378,2,13,4,7,36,30,6,43
Rapid Vienna,378,3,8,10,6,37,29,8,34
Vienna,378,4,8,5,11,28,39,-11,29
LASK Linz,378,5,7,7,10,26,31,-5,28
Mattersburg,378,6,7,5,12,31,41,-10,26
SC Rheindorf,378,7,4,7,13,19,33,-14,19
FC Salzburg,379,1,13,6,5,40,21,19,45
SK Sturm Gra,379,2,13,3,8,37,30,7,42
Rapid Vienna,379,3,9,10,5,37,27,10,37
LASK Linz,379,4,9,7,8,28,26,2,34
Mattersburg,379,5,7,6,11,32,38,-6,27
Vienna,379,6,7,5,12,25,40,-15,26
SC Rheindorf,379,7,5,5,14,17,34,-17,20
FC Salzburg,380,1,12,9,3,40,19,21,45
SK Sturm Gra,380,2,13,5,6,33,25,8,44
Rapid Vienna,380,3,8,10,6,39,29,10,34
LASK Linz,380,4,9,6,9,31,27,4,33
Mattersburg,380,5,7,6,11,31,43,-12,27
Vienna,380,6,7,5,12,25,38,-13,26
SC Rheindorf,380,7,5,5,14,19,37,-18,20
FC Salzburg,381,1,16,6,2,44,16,28,54
SK Sturm Gra,381,2,12,3,9,33,29,4,39
Rapid Vienna,381,3,8,10,6,34,30,4,34
LASK Linz,381,4,8,6,10,27,29,-2,30
Mattersburg,381,5,7,5,12,31,42,-11,26
Vienna,381,6,7,5,12,25,39,-14,26
SC Rheindorf,381,7,6,5,13,24,33,-9,23
FC Salzburg,382,1,12,8,4,41,21,20,44
SK Sturm Gra,382,2,12,4,8,30,27,3,40
Rapid Vienna,382,3,8,11,5,34,27,7,35
LASK Linz,382,4,9,6,9,27,25,2,33
Vienna,382,5,8,5,11,28,37,-9,29
SC Rheindorf,382,6,7,6,11,20,27,-7,27
Mattersburg,382,7,5,6,13,30,46,-16,21
FC Salzburg,383,1,14,7,3,47,19,28,49
SK Sturm Gra,383,2,14,3,7,37,31,6,45
Rapid Vienna,383,3,8,9,7,37,33,4,33
LASK Linz,383,4,8,7,9,28,28,0,31
Mattersburg,383,5,7,6,11,29,38,-9,27
Vienna,383,6,7,6,11,26,39,-13,27
SC Rheindorf,383,7,4,6,14,17,33,-16,18
FC Salzburg,384,1,13,9,2,44,19,25,48
SK Sturm Gra,384,2,12,4,8,29,27,2,40
Rapid Vienna,384,3,9,11,4,38,28,10,38
Mattersburg,384,4,8,6,10,36,39,-3,30
LASK Linz,384,5,8,6,10,28,31,-3,30
Vienna,384,6,6,6,12,24,41,-17,24
SC Rheindorf,384,7,4,6,14,17,31,-14,18
FC Salzburg,385,1,13,9,2,44,19,25,48
SK Sturm Gra,385,2,12,4,8,30,30,0,40
Rapid Vienna,385,3,8,11,5,34,25,9,35
Mattersburg,385,4,7,6,11,34,39,-5,27
SC Rheindorf,385,5,7,6,11,20,25,-5,27
LASK Linz,385,6,7,6,11,23,29,-6,27
Vienna,385,7,6,6,12,25,43,-18,24
SK Sturm Gra,386,1,13,5,6,34,26,8,44
FC Salzburg,386,2,12,7,5,39,20,19,43
Rapid Vienna,386,3,10,10,4,41,27,14,40
LASK Linz,386,4,8,6,10,26,30,-4,30
Mattersburg,386,5,7,7,10,31,39,-8,28
Vienna,386,6,7,5,12,25,39,-14,26
SC Rheindorf,386,7,4,6,14,19,34,-15,18
FC Salzburg,387,1,15,7,2,45,17,28,52
SK Sturm Gra,387,2,11,5,8,31,31,0,38
Rapid Vienna,387,3,7,12,5,34,27,7,33
LASK Linz,387,4,8,8,8,27,27,0,32
Mattersburg,387,5,6,7,11,30,40,-10,25
SC Rheindorf,387,6,5,8,11,19,27,-8,23
Vienna,387,7,6,5,13,24,41,-17,23
FC Salzburg,388,1,13,9,2,42,17,25,48
Rapid Vienna,388,2,10,10,4,36,24,12,40
SK Sturm Gra,388,3,11,5,8,30,29,1,38
LASK Linz,388,4,8,6,10,29,29,0,30
Mattersburg,388,5,6,7,11,30,42,-12,25
SC Rheindorf,388,6,6,6,12,20,29,-9,24
Vienna,388,7,6,5,13,25,42,-17,23
FC Salzburg,389,1,15,6,3,54,20,34,51
SK Sturm Gra,389,2,12,3,9,34,40,-6,39
LASK Linz,389,3,9,7,8,27,25,2,34
Rapid Vienna,389,4,7,10,7,37,34,3,31
Mattersburg,389,5,8,6,10,30,37,-7,30
Vienna,389,6,6,5,13,23,42,-19,23
SC Rheindorf,389,7,5,7,12,22,29,-7,22
FC Salzburg,390,1,14,8,2,46,19,27,50
SK Sturm Gra,390,2,13,5,6,33,27,6,44
LASK Linz,390,3,10,6,8,31,27,4,36
Rapid Vienna,390,4,7,10,7,33,29,4,31
Mattersburg,390,5,6,6,12,32,44,-12,24
Vienna,390,6,6,5,13,25,42,-17,23
SC Rheindorf,390,7,5,6,13,20,32,-12,21
FC Salzburg,391,1,14,6,4,41,17,24,48
SK Sturm Gra,391,2,14,4,6,34,26,8,46
Rapid Vienna,391,3,9,10,5,35,26,9,37
LASK Linz,391,4,9,6,9,27,27,0,33
Mattersburg,391,5,6,7,11,32,40,-8,25
Vienna,391,6,6,6,12,24,39,-15,24
SC Rheindorf,391,7,4,5,15,16,34,-18,17
FC Salzburg,392,1,14,8,2,46,18,28,50
SK Sturm Gra,392,2,12,4,8,33,29,4,40
Rapid Vienna,392,3,9,9,6,36,29,7,36
LASK Linz,392,4,10,5,9,30,29,1,35
Vienna,392,5,7,6,11,25,38,-13,27
Mattersburg,392,6,7,5,12,33,43,-10,26
SC Rheindorf,392,7,4,5,15,17,34,-17,17
FC Salzburg,393,1,15,7,2,45,16,29,52
SK Sturm Gra,393,2,13,4,7,33,28,5,43
LASK Linz,393,3,10,5,9,33,28,5,35
Rapid Vienna,393,4,7,10,7,32,30,2,31
Vienna,393,5,7,5,12,25,40,-15,26
Mattersburg,393,6,6,5,13,30,44,-14,23
SC Rheindorf,393,7,5,6,13,18,30,-12,21
FC Salzburg,394,1,15,7,2,54,19,35,52
SK Sturm Gra,394,2,14,3,7,34,30,4,45
Rapid Vienna,394,3,7,12,5,39,33,6,33
LASK Linz,394,4,7,7,10,28,31,-3,28
Vienna,394,5,7,5,12,27,41,-14,26
SC Rheindorf,394,6,5,7,12,23,33,-10,22
Mattersburg,394,7,5,7,12,30,48,-18,22
FC Salzburg,395,1,14,8,2,45,17,28,50
SK Sturm Gra,395,2,13,5,6,35,27,8,44
Rapid Vienna,395,3,8,11,5,36,28,8,35
LASK Linz,395,4,7,6,11,26,33,-7,27
Vienna,395,5,7,5,12,28,40,-12,26
SC Rheindorf,395,6,6,6,12,21,28,-7,24
Mattersburg,395,7,6,5,13,29,47,-18,23
FC Salzburg,396,1,16,6,2,45,18,27,54
SK Sturm Gra,396,2,12,4,8,33,30,3,40
Rapid Vienna,396,3,8,11,5,37,29,8,35
LASK Linz,396,4,8,7,9,27,28,-1,31
Mattersburg,396,5,6,7,11,30,40,-10,25
Vienna,396,6,6,6,12,24,39,-15,24
SC Rheindorf,396,7,4,7,13,18,30,-12,19
FC Salzburg,397,1,14,7,3,45,19,26,49
SK Sturm Gra,397,2,11,5,8,32,31,1,38
Rapid Vienna,397,3,8,11,5,35,27,8,35
LASK Linz,397,4,8,6,10,25,28,-3,30
Vienna,397,5,7,6,11,25,38,-13,27
SC Rheindorf,397,6,6,7,11,22,29,-7,25
Mattersburg,397,7,6,6,12,30,42,-12,24
FC Salzburg,398,1,15,7,2,43,15,28,52
SK Sturm Gra,398,2,12,3,9,31,30,1,39
LASK Linz,398,3,10,6,8,29,26,3,36
Rapid Vienna,398,4,7,12,5,33,26,7,33
Mattersburg,398,5,6,6,12,28,38,-10,24
Vienna,398,6,6,6,12,23,40,-17,24
SC Rheindorf,398,7,5,6,13,18,30,-12,21
FC Salzburg,399,1,15,6,3,46,20,26,51
SK Sturm Gra,399,2,12,5,7,33,29,4,41
Rapid Vienna,399,3,7,11,6,38,32,6,32
Vienna,399,4,8,5,11,26,38,-12,29
LASK Linz,399,5,7,7,10,26,29,-3,28
SC Rheindorf,399,6,6,7,11,20,28,-8,25
Mattersburg,399,7,5,7,12,28,41,-13,22
FC Salzburg,400,1,13,7,4,43,21,22,46
SK Sturm Gra,400,2,12,5,7,32,27,5,41
Rapid Vienna,400,3,9,11,4,38,28,10,38
Mattersburg,400,4,8,5,11,32,40,-8,29
LASK Linz,400,5,7,7,10,27,31,-4,28
Vienna,400,6,7,5,12,26,40,-14,26
SC Rheindorf,400,7,5,6,13,19,30,-11,21
FC Salzburg,401,1,16,6,2,46,18,28,54
SK Sturm Gra,401,2,14,3,7,37,27,10,45
Rapid Vienna,401,3,8,10,6,33,27,6,34
LASK Linz,401,4,8,7,9,26,26,0,31
Mattersburg,401,5,6,6,12,29,40,-11,24
Vienna,401,6,6,5,13,24,41,-17,23
SC Rheindorf,401,7,5,5,14,16,32,-16,20
FC Salzburg,402,1,14,7,3,45,20,25,49
SK Sturm Gra,402,2,12,5,7,33,31,2,41
LASK Linz,402,3,10,6,8,32,26,6,36
Rapid Vienna,402,4,8,11,5,35,27,8,35
Mattersburg,402,5,7,5,12,32,43,-11,26
Vienna,402,6,6,5,13,24,41,-17,23
SC Rheindorf,402,7,4,7,13,21,34,-13,19
FC Salzburg,403,1,14,7,3,45,19,26,49
SK Sturm Gra,403,2,14,4,6,36,27,9,46
Rapid Vienna,403,3,8,11,5,35,28,7,35
Mattersburg,403,4,8,5,11,34,42,-8,29
LASK Linz,403,5,7,7,10,26,30,-4,28
Vienna,403,6,6,5,13,24,41,-17,23
SC Rheindorf,403,7,5,5,14,20,33,-13,20
FC Salzburg,404,1,15,7,2,47,17,30,52
SK Sturm Gra,404,2,12,5,7,34,29,5,41
Rapid Vienna,404,3,8,11,5,35,27,8,35
LASK Linz,404,4,9,6,9,28,27,1,33
Vienna,404,5,7,5,12,27,40,-13,26
Mattersburg,404,6,5,6,13,28,47,-19,21
SC Rheindorf,404,7,4,8,12,18,30,-12,20
FC Salzburg,405,1,14,7,3,44,20,24,49
SK Sturm Gra,405,2,12,5,7,33,29,4,41
Rapid Vienna,405,3,8,11,5,36,30,6,35
LASK Linz,405,4,8,7,9,30,29,1,31
Vienna,405,5,6,6,12,26,41,-15,24
SC Rheindorf,405,6,5,8,11,23,30,-7,23
Mattersburg,405,7,5,8,11,30,43,-13,23
FC Salzburg,406,1,15,7,2,46,19,27,52
SK Sturm Gra,406,2,13,4,7,34,28,6,43
Rapid Vienna,406,3,8,10,6,33,29,4,34
LASK Linz,406,4,8,6,10,28,28,0,30
Mattersburg,406,5,6,6,12,29,42,-13,24
Vienna,406,6,6,6,12,25,40,-15,24
SC Rheindorf,406,7,5,7,12,17,26,-9,22
FC Salzburg,407,1,14,7,3,41,19,22,49
Rapid Vienna,407,2,10,10,4,37,25,12,40
SK Sturm Gra,407,3,12,3,9,30,31,-1,39
LASK Linz,407,4,9,5,10,30,29,1,32
Mattersburg,407,5,7,6,11,33,41,-8,27
Vienna,407,6,7,5,12,29,42,-13,26
SC Rheindorf,407,7,4,6,14,18,31,-13,18
FC Salzburg,408,1,15,7,2,46,17,29,52
SK Sturm Gra,408,2,12,5,7,33,29,4,41
Rapid Vienna,408,3,9,10,5,34,25,9,37
Mattersburg,408,4,8,5,11,38,43,-5,29
LASK Linz,408,5,7,5,12,25,32,-7,26
Vienna,408,6,6,6,12,25,43,-18,24
SC Rheindorf,408,7,5,6,13,18,30,-12,21
FC Salzburg,409,1,15,6,3,46,21,25,51
SK Sturm Gra,409,2,12,5,7,31,28,3,41
Rapid Vienna,409,3,10,10,4,36,24,12,40
LASK Linz,409,4,9,6,9,26,26,0,33
Mattersburg,409,5,6,6,12,32,43,-11,24
Vienna,409,6,6,5,13,25,41,-16,23
SC Rheindorf,409,7,4,6,14,18,31,-13,18
FC Salzburg,410,1,14,7,3,48,21,27,49
SK Sturm Gra,410,2,12,4,8,31,30,1,40
Rapid Vienna,410,3,9,10,5,35,26,9,37
LASK Linz,410,4,10,5,9,31,27,4,35
Vienna,410,5,6,7,11,25,39,-14,25
SC Rheindorf,410,6,6,5,13,20,31,-11,23
Mattersburg,410,7,5,6,13,28,44,-16,21
FC Salzburg,411,1,15,7,2,47,17,30,52
SK Sturm Gra,411,2,11,4,9,29,28,1,37
Rapid Vienna,411,3,8,11,5,33,28,5,35
LASK Linz,411,4,8,7,9,27,28,-1,31
SC Rheindorf,411,5,6,7,11,19,27,-8,25
Vienna,411,6,6,6,12,24,40,-16,24
Mattersburg,411,7,5,8,11,32,43,-11,23
FC Salzburg,412,1,14,7,3,43,18,25,49
SK Sturm Gra,412,2,12,6,6,31,26,5,42
LASK Linz,412,3,9,6,9,28,28,0,33
Rapid Vienna,412,4,7,10,7,34,31,3,31
Vienna,412,5,7,5,12,26,40,-14,26
SC Rheindorf,412,6,6,7,11,22,29,-7,25
Mattersburg,412,7,6,5,13,29,41,-12,23
FC Salzburg,413,1,16,6,2,49,20,29,54
SK Sturm Gra,413,2,11,4,9,30,30,0,37
Rapid Vienna,413,3,8,11,5,36,27,9,35
LASK Linz,413,4,8,6,10,27,31,-4,30
Mattersburg,413,5,7,6,11,36,43,-7,27
SC Rheindorf,413,6,5,8,11,22,31,-9,23
Vienna,413,7,6,5,13,25,43,-18,23
FC Salzburg,414,1,14,7,3,43,20,23,49
Rapid Vienna,414,2,10,10,4,39,26,13,40
SK Sturm Gra,414,3,11,4,9,31,32,-1,37
LASK Linz,414,4,8,6,10,25,28,-3,30
Mattersburg,414,5,8,5,11,34,38,-4,29
SC Rheindorf,414,6,6,5,13,20,30,-10,23
Vienna,414,7,6,5,13,24,42,-18,23
FC Salzburg,415,1,14,7,3,45,21,24,49
SK Sturm Gra,415,2,12,4,8,35,33,2,40
LASK Linz,415,3,10,5,9,30,28,2,35
Rapid Vienna,415,4,8,10,6,38,30,8,34
Mattersburg,415,5,7,7,10,32,40,-8,28
Vienna,415,6,6,6,12,24,39,-15,24
SC Rheindorf,415,7,4,7,13,19,32,-13,19
FC Salzburg,416,1,15,6,3,45,17,28,51
SK Sturm Gra,416,2,13,4,7,33,28,5,43
Rapid Vienna,416,3,9,11,4,39,25,14,38
LASK Linz,416,4,8,6,10,26,32,-6,30
Mattersburg,416,5,8,5,11,36,39,-3,29
Vienna,416,6,6,5,13,24,44,-20,23
SC Rheindorf,416,7,4,5,15,20,38,-18,17
FC Salzburg,417,1,15,6,3,43,18,25,51
SK Sturm Gra,417,2,12,3,9,32,30,2,39
LASK Linz,417,3,10,5,9,31,28,3,35
Rapid Vienna,417,4,8,10,6,35,29,6,34
Mattersburg,417,5,7,5,12,33,42,-9,26
Vienna,417,6,7,5,12,25,39,-14,26
SC Rheindorf,417,7,5,6,13,19,32,-13,21
FC Salzburg,418,1,13,7,4,42,21,21,46
SK Sturm Gra,418,2,12,5,7,30,26,4,41
Rapid Vienna,418,3,8,12,4,33,24,9,36
LASK Linz,418,4,8,6,10,27,29,-2,30
Vienna,418,5,8,5,11,27,38,-11,29
SC Rheindorf,418,6,6,7,11,19,27,-8,25
Mattersburg,418,7,5,6,13,31,44,-13,21
FC Salzburg,419,1,15,6,3,47,17,30,51
SK Sturm Gra,419,2,12,4,8,32,31,1,40
Rapid Vienna,419,3,8,11,5,34,27,7,35
LASK Linz,419,4,8,7,9,28,27,1,31
Vienna,419,5,7,5,12,24,40,-16,26
Mattersburg,419,6,6,6,12,30,43,-13,24
SC Rheindorf,419,7,5,7,12,19,29,-10,22
FC Salzburg,420,1,15,6,3,48,18,30,51
SK Sturm Gra,420,2,13,5,6,34,27,7,44
Rapid Vienna,420,3,9,9,6,39,29,10,36
LASK Linz,420,4,8,6,10,27,32,-5,30
Vienna,420,5,7,5,12,26,40,-14,26
SC Rheindorf,420,6,5,7,12,20,30,-10,22
Mattersburg,420,7,5,6,13,29,47,-18,21
FC Salzburg,421,1,15,6,3,46,16,30,51
SK Sturm Gra,421,2,12,5,7,34,27,7,41
Rapid Vienna,421,3,9,10,5,35,30,5,37
LASK Linz,421,4,7,7,10,26,31,-5,28
Mattersburg,421,5,7,5,12,33,45,-12,26
Vienna,421,6,7,5,12,26,41,-15,26
SC Rheindorf,421,7,5,6,13,20,30,-10,21
FC Salzburg,422,1,14,7,3,43,17,26,49
SK Sturm Gra,422,2,13,5,6,35,26,9,44
LASK Linz,422,3,9,6,9,27,27,0,33
Rapid Vienna,422,4,7,10,7,33,29,4,31
Vienna,422,5,7,6,11,28,41,-13,27
Mattersburg,422,6,5,7,12,31,47,-16,22
SC Rheindorf,422,7,4,9,11,19,29,-10,21
FC Salzburg,423,1,14,8,2,43,16,27,50
SK Sturm Gra,423,2,13,4,7,32,27,5,43
LASK Linz,423,3,10,6,8,32,26,6,36
Rapid Vienna,423,4,7,10,7,32,29,3,31
Vienna,423,5,7,5,12,27,40,-13,26
Mattersburg,423,6,5,7,12,29,44,-15,22
SC Rheindorf,423,7,5,6,13,17,30,-13,21
FC Salzburg,424,1,16,6,2,47,15,32,54
SK Sturm Gra,424,2,13,3,8,33,33,0,42
Rapid Vienna,424,3,8,11,5,35,25,10,35
LASK Linz,424,4,9,6,9,29,30,-1,33
Mattersburg,424,5,7,5,12,32,43,-11,26
Vienna,424,6,6,5,13,25,42,-17,23
SC Rheindorf,424,7,4,6,14,18,31,-13,18
FC Salzburg,425,1,13,7,4,42,21,21,46
SK Sturm Gra,425,2,12,5,7,32,28,4,41
Rapid Vienna,425,3,8,10,6,37,29,8,34
LASK Linz,425,4,9,5,10,27,28,-1,32
Vienna,425,5,8,5,11,30,39,-9,29
Mattersburg,425,6,6,6,12,30,44,-14,24
SC Rheindorf,425,7,5,8,11,21,30,-9,23
FC Salzburg,426,1,16,6,2,55,20,35,54
Rapid Vienna,426,2,10,9,5,37,29,8,39
SK Sturm Gra,426,3,11,4,9,32,32,0,37
LASK Linz,426,4,8,5,11,25,29,-4,29
Vienna,426,5,7,5,12,29,45,-16,26
SC Rheindorf,426,6,6,6,12,20,29,-9,24
Mattersburg,426,7,6,5,13,32,46,-14,23
FC Salzburg,427,1,14,8,2,46,18,28,50
SK Sturm Gra,427,2,12,4,8,31,28,3,40
Rapid Vienna,427,3,8,10,6,33,28,5,34
LASK Linz,427,4,8,7,9,27,28,-1,31
SC Rheindorf,427,5,7,5,12,21,27,-6,26
Mattersburg,427,6,6,6,12,30,43,-13,24
Vienna,427,7,6,6,12,24,40,-16,24
FC Salzburg,428,1,16,6,2,47,16,31,54
SK Sturm Gra,428,2,13,3,8,31,26,5,42
Rapid Vienna,428,3,8,9,7,35,30,5,33
LASK Linz,428,4,8,6,10,28,30,-2,30
SC Rheindorf,428,5,7,5,12,19,28,-9,26
Vienna,428,6,7,5,12,29,41,-12,26
Mattersburg,428,7,5,6,13,29,47,-18,21
FC Salzburg,429,1,15,6,3,53,19,34,51
SK Sturm Gra,429,2,13,3,8,32,31,1,42
Rapid Vienna,429,3,9,10,5,37,29,8,37
LASK Linz,429,4,8,5,11,26,28,-2,29
Vienna,429,5,7,5,12,25,42,-17,26
SC Rheindorf,429,6,6,6,12,22,31,-9,24
Mattersburg,429,7,6,5,13,30,45,-15,23
FC Salzburg,430,1,13,7,4,45,21,24,46
SK Sturm Gra,430,2,14,3,7,35,26,9,45
Rapid Vienna,430,3,8,9,7,35,29,6,33
LASK Linz,430,4,9,6,9,28,31,-3,33
Vienna,430,5,7,5,12,25,41,-16,26
SC Rheindorf,430,6,6,6,12,18,27,-9,24
Mattersburg,430,7,5,8,11,29,40,-11,23
FC Salzburg,431,1,16,6,2,48,19,29,54
SK Sturm Gra,431,2,11,5,8,31,30,1,38
LASK Linz,431,3,9,7,8,30,27,3,34
Rapid Vienna,431,4,7,11,6,34,31,3,32
Vienna,431,5,7,5,12,27,41,-14,26
Mattersburg,431,6,6,6,12,32,41,-9,24
SC Rheindorf,431,7,5,6,13,17,30,-13,21
FC Salzburg,432,1,14,6,4,45,18,27,48
Rapid Vienna,432,2,11,9,4,41,24,17,42
SK Sturm Gra,432,3,13,3,8,34,31,3,42
LASK Linz,432,4,7,6,11,26,31,-5,27
Vienna,432,5,7,6,11,25,38,-13,27
Mattersburg,432,6,6,6,12,30,45,-15,24
SC Rheindorf,432,7,5,6,13,19,33,-14,21
FC Salzburg,433,1,14,7,3,43,19,24,49
SK Sturm Gra,433,2,11,5,8,32,30,2,38
Rapid Vienna,433,3,7,12,5,34,27,7,33
LASK Linz,433,4,9,6,9,27,26,1,33
Vienna,433,5,8,5,11,27,37,-10,29
SC Rheindorf,433,6,6,6,12,19,30,-11,24
Mattersburg,433,7,6,5,13,30,43,-13,23
FC Salzburg,434,1,16,6,2,50,18,32,54
SK Sturm Gra,434,2,12,4,8,30,28,2,40
Rapid Vienna,434,3,8,10,6,35,29,6,34
LASK Linz,434,4,8,8,8,28,28,0,32
Mattersburg,434,5,6,6,12,29,43,-14,24
Vienna,434,6,6,6,12,25,42,-17,24
SC Rheindorf,434,7,5,6,13,20,29,-9,21
FC Salzburg,435,1,14,7,3,47,19,28,49
SK Sturm Gra,435,2,12,4,8,32,31,1,40
Rapid Vienna,435,3,9,10,5,36,28,8,37
LASK Linz,435,4,9,5,10,31,29,2,32
Vienna,435,5,7,6,11,26,39,-13,27
Mattersburg,435,6,6,6,12,29,45,-16,24
SC Rheindorf,435,7,5,6,13,18,28,-10,21
FC Salzburg,436,1,15,7,2,47,18,29,52
SK Sturm Gra,436,2,14,4,6,35,24,11,46
Rapid Vienna,436,3,8,9,7,34,33,1,33
LASK Linz,436,4,9,5,10,32,30,2,32
Vienna,436,5,7,5,12,27,40,-13,26
Mattersburg,436,6,6,5,13,29,45,-16,23
SC Rheindorf,436,7,5,5,14,16,30,-14,20
FC Salzburg,437,1,14,7,3,44,21,23,49
SK Sturm Gra,437,2,12,6,6,33,26,7,42
Rapid Vienna,437,3,9,11,4,36,24,12,38
LASK Linz,437,4,8,6,10,25,29,-4,30
SC Rheindorf,437,5,6,6,12,20,29,-9,24
Mattersburg,437,6,6,5,13,32,45,-13,23
Vienna,437,7,6,5,13,26,42,-16,23
FC Salzburg,438,1,15,6,3,49,19,30,51
SK Sturm Gra,438,2,12,4,8,37,35,2,40
Rapid Vienna,438,3,9,9,6,39,31,8,36
LASK Linz,438,4,8,5,11,29,37,-8,29
Vienna,438,5,8,5,11,27,38,-11,29
Mattersburg,438,6,7,5,12,35,43,-8,26
SC Rheindorf,438,7,5,6,13,18,31,-13,21
FC Salzburg,439,1,13,7,4,43,20,23,46
SK Sturm Gra,439,2,12,3,9,30,30,0,39
Rapid Vienna,439,3,9,9,6,34,27,7,36
Mattersburg,439,4,9,5,10,36,38,-2,32
LASK Linz,439,5,9,5,10,28,30,-2,32
Vienna,439,6,6,6,12,26,42,-16,24
SC Rheindorf,439,7,6,5,13,20,30,-10,23
FC Salzburg,440,1,14,7,3,43,19,24,49
SK Sturm Gra,440,2,12,5,7,31,27,4,41
Rapid Vienna,440,3,8,10,6,35,30,5,34
LASK Linz,440,4,9,6,9,27,26,1,33
Vienna,440,5,7,6,11,27,39,-12,27
Mattersburg,440,6,6,5,13,31,44,-13,23
SC Rheindorf,440,7,5,7,12,18,27,-9,22
FC Salzburg,441,1,14,7,3,44,18,26,49
Rapid Vienna,441,2,9,11,4,37,26,11,38
SK Sturm Gra,441,3,11,4,9,30,33,-3,37
Vienna,441,4,8,5,11,28,39,-11,29
LASK Linz,441,5,7,7,10,26,29,-3,28
Mattersburg,441,6,7,5,12,31,42,-11,26
SC Rheindorf,441,7,5,7,12,21,30,-9,22
FC Salzburg,442,1,13,8,3,44,19,25,47
SK Sturm Gra,442,2,12,5,7,33,30,3,41
Rapid Vienna,442,3,9,9,6,34,27,7,36
LASK Linz,442,4,10,5,9,29,26,3,35
Mattersburg,442,5,6,6,12,30,42,-12,24
Vienna,442,6,6,6,12,25,41,-16,24
SC Rheindorf,442,7,5,7,12,20,30,-10,22
FC Salzburg,443,1,15,6,3,48,18,30,51
SK Sturm Gra,443,2,14,4,6,36,28,8,46
Rapid Vienna,443,3,9,9,6,39,32,7,36
Mattersburg,443,4,8,5,11,36,39,-3,29
LASK Linz,443,5,7,5,12,25,33,-8,26
Vienna,443,6,6,5,13,23,43,-20,23
SC Rheindorf,443,7,5,6,13,18,32,-14,21
FC Salzburg,444,1,15,6,3,49,19,30,51
SK Sturm Gra,444,2,12,5,7,34,29,5,41
Rapid Vienna,444,3,9,11,4,40,29,11,38
LASK Linz,444,4,8,6,10,28,29,-1,30
Mattersburg,444,5,7,5,12,33,47,-14,26
Vienna,444,6,7,5,12,26,40,-14,26
SC Rheindorf,444,7,4,6,14,19,36,-17,18
FC Salzburg,445,1,14,7,3,45,20,25,49
SK Sturm Gra,445,2,14,3,7,34,27,7,45
LASK Linz,445,3,9,6,9,28,28,0,33
Rapid Vienna,445,4,7,10,7,32,28,4,31
SC Rheindorf,445,5,7,5,12,20,28,-8,26
Vienna,445,6,6,6,12,26,41,-15,24
Mattersburg,445,7,5,7,12,30,43,-13,22
FC Salzburg,446,1,14,6,4,45,19,26,48
SK Sturm Gra,446,2,12,3,9,33,34,-1,39
Rapid Vienna,446,3,8,10,6,33,27,6,34
LASK Linz,446,4,9,7,8,31,30,1,34
Vienna,446,5,8,5,11,27,39,-12,29
SC Rheindorf,446,6,5,8,11,22,28,-6,23
Mattersburg,446,7,5,7,12,31,45,-14,22
FC Salzburg,447,1,12,8,4,41,21,20,44
SK Sturm Gra,447,2,12,4,8,31,28,3,40
Rapid Vienna,447,3,10,9,5,40,31,9,39
LASK Linz,447,4,9,5,10,30,31,-1,32
Mattersburg,447,5,7,7,10,32,38,-6,28
Vienna,447,6,6,6,12,23,38,-15,24
SC Rheindorf,447,7,5,7,12,21,31,-10,22
FC Salzburg,448,1,14,7,3,46,19,27,49
Rapid Vienna,448,2,10,10,4,41,28,13,40
SK Sturm Gra,448,3,12,4,8,31,29,2,40
LASK Linz,448,4,7,7,10,28,31,-3,28
Vienna,448,5,7,6,11,27,38,-11,27
Mattersburg,448,6,6,5,13,29,48,-19,23
SC Rheindorf,448,7,5,7,12,21,30,-9,22
FC Salzburg,449,1,15,6,3,47,19,28,51
Rapid Vienna,449,2,10,10,4,39,24,15,40
SK Sturm Gra,449,3,11,3,10,29,30,-1,36
LASK Linz,449,4,9,7,8,27,24,3,34
Vienna,449,5,7,5,12,28,40,-12,26
SC Rheindorf,449,6,5,7,12,19,33,-14,22
Mattersburg,449,7,5,6,13,30,49,-19,21
FC Salzburg,450,1,13,7,4,44,19,25,46
SK Sturm Gra,450,2,13,4,7,34,31,3,43
Rapid Vienna,450,3,7,12,5,36,30,6,33
LASK Linz,450,4,8,7,9,28,28,0,31
Vienna,450,5,7,6,11,26,39,-13,27
SC Rheindorf,450,6,6,7,11,22,28,-6,25
Mattersburg,450,7,5,7,12,27,42,-15,22
FC Salzburg,451,1,15,7,2,47,18,29,52
SK Sturm Gra,451,2,11,6,7,31,30,1,39
Rapid Vienna,451,3,9,11,4,39,26,13,38
LASK Linz,451,4,8,7,9,27,28,-1,31
Vienna,451,5,6,6,12,25,40,-15,24
Mattersburg,451,6,5,8,11,30,42,-12,23
SC Rheindorf,451,7,4,7,13,17,32,-15,19
FC Salzburg,452,1,15,6,3,46,17,29,51
Rapid Vienna,452,2,10,10,4,38,25,13,40
SK Sturm Gra,452,3,12,4,8,30,29,1,40
LASK Linz,452,4,9,5,10,29,32,-3,32
Mattersburg,452,5,7,6,11,30,39,-9,27
Vienna,452,6,6,5,13,23,41,-18,23
SC Rheindorf,452,7,4,6,14,15,28,-13,18
FC Salzburg,453,1,15,7,2,48,16,32,52
SK Sturm Gra,453,2,12,5,7,36,29,7,41
Rapid Vienna,453,3,7,11,6,35,31,4,32
SC Rheindorf,453,4,7,6,11,22,28,-6,27
LASK Linz,453,5,7,6,11,27,34,-7,27
Mattersburg,453,6,6,7,11,34,47,-13,25
Vienna,453,7,6,6,12,26,43,-17,24
FC Salzburg,454,1,13,8,3,45,19,26,47
SK Sturm Gra,454,2,13,4,7,33,27,6,43
Rapid Vienna,454,3,9,9,6,35,29,6,36
LASK Linz,454,4,8,6,10,29,33,-4,30
Vienna,454,5,7,5,12,25,42,-17,26
SC Rheindorf,454,6,6,6,12,23,29,-6,24
Mattersburg,454,7,5,8,11,28,39,-11,23
FC Salzburg,455,1,15,6,3,47,19,28,51
SK Sturm Gra,455,2,12,3,9,31,30,1,39
Rapid Vienna,455,3,9,10,5,36,26,10,37
LASK Linz,455,4,7,7,10,26,31,-5,28
Vienna,455,5,7,6,11,26,39,-13,27
Mattersburg,455,6,6,7,11,35,41,-6,25
SC Rheindorf,455,7,6,5,13,18,33,-15,23
FC Salzburg,456,1,13,8,3,43,20,23,47
SK Sturm Gra,456,2,12,5,7,34,30,4,41
Rapid Vienna,456,3,8,12,4,36,27,9,36
LASK Linz,456,4,10,6,8,28,25,3,36
Vienna,456,5,7,5,12,25,39,-14,26
Mattersburg,456,6,5,7,12,30,43,-13,22
SC Rheindorf,456,7,4,7,13,20,32,-12,19
FC Salzburg,457,1,13,7,4,42,21,21,46
SK Sturm Gra,457,2,13,3,8,32,27,5,42
Rapid Vienna,457,3,8,9,7,34,29,5,33
LASK Linz,457,4,9,5,10,26,27,-1,32
Mattersburg,457,5,7,6,11,32,40,-8,27
SC Rheindorf,457,6,7,5,12,19,27,-8,26
Vienna,457,7,6,7,11,28,42,-14,25
FC Salzburg,458,1,14,7,3,44,18,26,49
SK Sturm Gra,458,2,12,4,8,34,31,3,40
LASK Linz,458,3,9,7,8,34,30,4,34
Rapid Vienna,458,4,7,10,7,33,31,2,31
Vienna,458,5,7,6,11,29,40,-11,27
Mattersburg,458,6,6,6,12,34,49,-15,24
SC Rheindorf,458,7,5,8,11,21,30,-9,23
FC Salzburg,459,1,13,8,3,41,19,22,47
SK Sturm Gra,459,2,13,4,7,33,27,6,43
Rapid Vienna,459,3,9,11,4,39,25,14,38
LASK Linz,459,4,8,7,9,26,28,-2,31
Vienna,459,5,7,6,11,25,38,-13,27
Mattersburg,459,6,6,6,12,33,41,-8,24
SC Rheindorf,459,7,4,6,14,17,36,-19,18
FC Salzburg,460,1,15,7,2,46,18,28,52
SK Sturm Gra,460,2,13,4,7,32,27,5,43
Rapid Vienna,460,3,8,11,5,36,27,9,35
LASK Linz,460,4,7,6,11,23,32,-9,27
Mattersburg,460,5,7,5,12,34,44,-10,26
Vienna,460,6,7,5,12,28,41,-13,26
SC Rheindorf,460,7,5,6,13,19,29,-10,21
FC Salzburg,461,1,14,7,3,46,21,25,49
Rapid Vienna,461,2,11,9,4,43,25,18,42
SK Sturm Gra,461,3,12,3,9,32,31,1,39
LASK Linz,461,4,9,5,10,28,31,-3,32
Vienna,461,5,7,6,11,31,43,-12,27
Mattersburg,461,6,7,5,12,35,47,-12,26
SC Rheindorf,461,7,4,5,15,16,33,-17,17
FC Salzburg,462,1,12,8,4,44,23,21,44
SK Sturm Gra,462,2,12,4,8,35,33,2,40
Rapid Vienna,462,3,8,10,6,35,32,3,34
LASK Linz,462,4,8,6,10,32,32,0,30
Vienna,462,5,8,5,11,27,39,-12,29
Mattersburg,462,6,7,6,11,32,40,-8,27
SC Rheindorf,462,7,7,5,12,22,28,-6,26
FC Salzburg,463,1,14,7,3,43,19,24,49
SK Sturm Gra,463,2,13,3,8,33,28,5,42
LASK Linz,463,3,9,6,9,26,26,0,33
Rapid Vienna,463,4,7,9,8,32,30,2,30
Vienna,463,5,7,6,11,28,41,-13,27
Mattersburg,463,6,6,8,10,34,43,-9,26
SC Rheindorf,463,7,5,7,12,22,31,-9,22
FC Salzburg,464,1,13,6,5,44,23,21,45
Rapid Vienna,464,2,10,9,5,36,28,8,39
SK Sturm Gra,464,3,11,4,9,32,32,0,37
LASK Linz,464,4,10,6,8,32,27,5,36
Vienna,464,5,8,5,11,30,39,-9,29
Mattersburg,464,6,6,6,12,31,44,-13,24
SC Rheindorf,464,7,5,6,13,17,29,-12,21
FC Salzburg,465,1,14,6,4,41,19,22,48
SK Sturm Gra,465,2,14,4,6,33,24,9,46
Rapid Vienna,465,3,8,10,6,34,27,7,34
LASK Linz,465,4,8,8,8,27,27,0,32
Mattersburg,465,5,7,5,12,34,43,-9,26
Vienna,465,6,6,5,13,24,43,-19,23
SC Rheindorf,465,7,5,6,13,19,29,-10,21
FC Salzburg,466,1,14,8,2,42,17,25,50
Rapid Vienna,466,2,10,10,4,38,24,14,40
SK Sturm Gra,466,3,12,4,8,31,28,3,40
LASK Linz,466,4,8,6,10,24,28,-4,30
Vienna,466,5,7,6,11,27,38,-11,27
Mattersburg,466,6,6,6,12,28,41,-13,24
SC Rheindorf,466,7,4,6,14,16,30,-14,18
FC Salzburg,467,1,14,6,4,44,22,22,48
SK Sturm Gra,467,2,13,4,7,35,30,5,43
Rapid Vienna,467,3,7,11,6,34,29,5,32
Mattersburg,467,4,8,6,10,36,39,-3,30
LASK Linz,467,5,7,7,10,27,31,-4,28
Vienna,467,6,7,6,11,26,37,-11,27
SC Rheindorf,467,7,5,6,13,20,34,-14,21
FC Salzburg,468,1,16,6,2,50,17,33,54
SK Sturm Gra,468,2,12,4,8,34,32,2,40
Rapid Vienna,468,3,8,11,5,37,31,6,35
LASK Linz,468,4,8,6,10,28,31,-3,30
Mattersburg,468,5,7,5,12,31,44,-13,26
Vienna,468,6,7,5,12,26,40,-14,26
SC Rheindorf,468,7,5,5,14,21,32,-11,20
FC Salzburg,469,1,16,6,2,49,17,32,54
SK Sturm Gra,469,2,12,4,8,31,27,4,40
Rapid Vienna,469,3,10,9,5,37,26,11,39
LASK Linz,469,4,8,6,10,26,28,-2,30
Mattersburg,469,5,6,6,12,28,45,-17,24
Vienna,469,6,6,5,13,25,41,-16,23
SC Rheindorf,469,7,5,6,13,18,30,-12,21
FC Salzburg,470,1,15,7,2,43,16,27,52
SK Sturm Gra,470,2,12,5,7,32,28,4,41
LASK Linz,470,3,9,7,8,32,28,4,34
Rapid Vienna,470,4,7,10,7,34,32,2,31
SC Rheindorf,470,5,6,7,11,22,29,-7,25
Vienna,470,6,6,6,12,25,40,-15,24
Mattersburg,470,7,5,6,13,31,46,-15,21
FC Salzburg,471,1,16,6,2,52,16,36,54
SK Sturm Gra,471,2,12,4,8,30,34,-4,40
LASK Linz,471,3,10,6,8,29,27,2,36
Rapid Vienna,471,4,8,9,7,35,30,5,33
Vienna,471,5,7,5,12,25,40,-15,26
SC Rheindorf,471,6,5,6,13,20,31,-11,21
Mattersburg,471,7,5,6,13,29,42,-13,21
FC Salzburg,472,1,13,7,4,44,19,25,46
SK Sturm Gra,472,2,12,6,6,34,28,6,42
Rapid Vienna,472,3,9,10,5,36,28,8,37
LASK Linz,472,4,7,7,10,23,27,-4,28
Mattersburg,472,5,7,6,11,28,37,-9,27
Vienna,472,6,7,5,12,24,41,-17,26
SC Rheindorf,472,7,5,7,12,20,29,-9,22
FC Salzburg,473,1,14,8,2,46,19,27,50
SK Sturm Gra,473,2,11,5,8,32,32,0,38
Rapid Vienna,473,3,7,12,5,38,33,5,33
LASK Linz,473,4,9,6,9,32,29,3,33
Mattersburg,473,5,8,5,11,33,41,-8,29
Vienna,473,6,6,6,12,27,42,-15,24
SC Rheindorf,473,7,4,8,12,19,31,-12,20
FC Salzburg,474,1,14,6,4,46,23,23,48
SK Sturm Gra,474,2,12,5,7,32,27,5,41
Rapid Vienna,474,3,9,10,5,37,29,8,37
SC Rheindorf,474,4,7,6,11,24,28,-4,27
Mattersburg,474,5,7,6,11,33,42,-9,27
LASK Linz,474,6,7,5,12,24,32,-8,26
Vienna,474,7,6,6,12,26,41,-15,24
FC Salzburg,475,1,15,6,3,45,17,28,51
SK Sturm Gra,475,2,13,3,8,30,26,4,42
LASK Linz,475,3,9,6,9,26,26,0,33
Rapid Vienna,475,4,7,9,8,32,29,3,30
Vienna,475,5,8,5,11,27,39,-12,29
Mattersburg,475,6,6,6,12,29,43,-14,24
SC Rheindorf,475,7,6,5,13,19,28,-9,23
FC Salzburg,476,1,16,6,2,43,16,27,54
SK Sturm Gra,476,2,12,4,8,32,29,3,40
Rapid Vienna,476,3,9,10,5,34,25,9,37
LASK Linz,476,4,9,6,9,27,27,0,33
Mattersburg,476,5,7,6,11,29,37,-8,27
Vienna,476,6,6,5,13,24,40,-16,23
SC Rheindorf,476,7,4,5,15,17,32,-15,17
FC Salzburg,477,1,15,7,2,43,16,27,52
SK Sturm Gra,477,2,13,3,8,30,27,3,42
Rapid Vienna,477,3,7,12,5,34,27,7,33
LASK Linz,477,4,8,6,10,27,28,-1,30
Vienna,477,5,7,5,12,28,39,-11,26
SC Rheindorf,477,6,6,6,12,22,30,-8,24
Mattersburg,477,7,6,5,13,28,45,-17,23
FC Salzburg,478,1,16,6,2,46,18,28,54
SK Sturm Gra,478,2,13,4,7,32,27,5,43
Rapid Vienna,478,3,8,9,7,34,28,6,33
LASK Linz,478,4,7,6,11,24,28,-4,27
Mattersburg,478,5,7,5,12,28,40,-12,26
Vienna,478,6,7,5,12,26,39,-13,26
SC Rheindorf,478,7,6,5,13,18,28,-10,23
FC Salzburg,479,1,13,8,3,44,19,25,47
SK Sturm Gra,479,2,12,6,6,34,29,5,42
Rapid Vienna,479,3,8,10,6,35,29,6,34
LASK Linz,479,4,8,7,9,31,31,0,31
Vienna,479,5,7,5,12,26,40,-14,26
Mattersburg,479,6,6,7,11,33,45,-12,25
SC Rheindorf,479,7,6,5,13,20,30,-10,23
FC Salzburg,480,1,13,8,3,45,21,24,47
SK Sturm Gra,480,2,13,3,8,33,31,2,42
Rapid Vienna,480,3,8,12,4,35,25,10,36
LASK Linz,480,4,8,6,10,28,32,-4,30
Vienna,480,5,7,5,12,27,44,-17,26
Mattersburg,480,6,6,7,11,36,42,-6,25
SC Rheindorf,480,7,5,7,12,20,29,-9,22
FC Salzburg,481,1,16,6,2,50,16,34,54
SK Sturm Gra,481,2,12,3,9,35,31,4,39
Rapid Vienna,481,3,9,9,6,34,26,8,36
LASK Linz,481,4,8,6,10,28,33,-5,30
SC Rheindorf,481,5,7,6,11,19,26,-7,27
Vienna,481,6,6,6,12,24,44,-20,24
Mattersburg,481,7,5,6,13,28,42,-14,21
FC Salzburg,482,1,14,6,4,49,22,27,48
SK Sturm Gra,482,2,12,3,9,34,34,0,39
Rapid Vienna,482,3,9,10,5,35,27,8,37
LASK Linz,482,4,8,6,10,26,29,-3,30
Mattersburg,482,5,7,6,11,31,42,-11,27
Vienna,482,6,7,5,12,25,39,-14,26
SC Rheindorf,482,7,6,6,12,21,28,-7,24
FC Salzburg,483,1,15,6,3,43,18,25,51
SK Sturm Gra,483,2,12,4,8,36,31,5,40
Rapid Vienna,483,3,8,10,6,36,28,8,34
Mattersburg,483,4,8,5,11,31,38,-7,29
SC Rheindorf,483,5,7,5,12,25,31,-6,26
LASK Linz,483,6,7,5,12,25,36,-11,26
Vienna,483,7,7,5,12,25,39,-14,26
FC Salzburg,484,1,14,6,4,42,21,21,48
SK Sturm Gra,484,2,15,3,6,33,25,8,48
Rapid Vienna,484,3,8,10,6,35,28,7,34
LASK Linz,484,4,9,5,10,27,27,0,32
Vienna,484,5,7,6,11,28,37,-9,27
Mattersburg,484,6,5,7,12,27,41,-14,22
SC Rheindorf,484,7,4,7,13,17,30,-13,19
FC Salzburg,485,1,15,6,3,45,18,27,51
SK Sturm Gra,485,2,11,3,10,29,32,-3,36
Rapid Vienna,485,3,8,10,6,33,27,6,34
LASK Linz,485,4,8,7,9,30,31,-1,31
SC Rheindorf,485,5,7,6,11,21,26,-5,27
Vienna,485,6,7,5,12,26,40,-14,26
Mattersburg,485,7,6,7,11,33,43,-10,25
FC Salzburg,486,1,15,6,3,44,18,26,51
SK Sturm Gra,486,2,14,4,6,33,25,8,46
LASK Linz,486,3,9,7,8,31,28,3,34
Rapid Vienna,486,4,7,10,7,33,30,3,31
Mattersburg,486,5,7,5,12,32,42,-10,26
Vienna,486,6,6,5,13,24,40,-16,23
SC Rheindorf,486,7,5,5,14,17,31,-14,20
FC Salzburg,487,1,15,7,2,45,17,28,52
SK Sturm Gra,487,2,14,3,7,37,28,9,45
Rapid Vienna,487,3,9,9,6,42,30,12,36
LASK Linz,487,4,7,6,11,26,30,-4,27
Mattersburg,487,5,6,7,11,33,43,-10,25
Vienna,487,6,6,7,11,27,41,-14,25
SC Rheindorf,487,7,5,5,14,16,37,-21,20
FC Salzburg,488,1,16,6,2,46,15,31,54
SK Sturm Gra,488,2,12,4,8,32,31,1,40
Rapid Vienna,488,3,8,10,6,36,29,7,34
LASK Linz,488,4,9,5,10,29,30,-1,32
Mattersburg,488,5,6,6,12,33,45,-12,24
Vienna,488,6,6,6,12,25,41,-16,24
SC Rheindorf,488,7,5,7,12,24,34,-10,22
FC Salzburg,489,1,14,6,4,46,20,26,48
SK Sturm Gra,489,2,13,4,7,33,29,4,43
Rapid Vienna,489,3,9,9,6,33,25,8,36
LASK Linz,489,4,8,6,10,26,29,-3,30
SC Rheindorf,489,5,7,5,12,22,31,-9,26
Vienna,489,6,7,5,12,29,41,-12,26
Mattersburg,489,7,6,5,13,31,45,-14,23
FC Salzburg,490,1,15,7,2,47,19,28,52
Rapid Vienna,490,2,9,11,4,36,24,12,38
SK Sturm Gra,490,3,11,5,8,33,31,2,38
LASK Linz,490,4,8,8,8,28,28,0,32
Mattersburg,490,5,6,7,11,34,44,-10,25
Vienna,490,6,6,5,13,24,42,-18,23
SC Rheindorf,490,7,4,7,13,19,33,-14,19
FC Salzburg,491,1,14,7,3,48,21,27,49
SK Sturm Gra,491,2,14,3,7,38,31,7,45
Rapid Vienna,491,3,9,9,6,38,30,8,36
LASK Linz,491,4,8,5,11,27,34,-7,29
Mattersburg,491,5,7,6,11,35,42,-7,27
Vienna,491,6,6,7,11,24,38,-14,25
SC Rheindorf,491,7,5,5,14,17,31,-14,20
FC Salzburg,492,1,14,7,3,43,19,24,49
SK Sturm Gra,492,2,11,5,8,30,28,2,38
Rapid Vienna,492,3,8,11,5,36,28,8,35
LASK Linz,492,4,8,7,9,29,29,0,31
Mattersburg,492,5,8,5,11,33,39,-6,29
Vienna,492,6,7,5,12,25,39,-14,26
SC Rheindorf,492,7,5,6,13,17,31,-14,21
FC Salzburg,493,1,14,8,2,47,16,31,50
SK Sturm Gra,493,2,11,4,9,32,37,-5,37
Rapid Vienna,493,3,8,11,5,35,27,8,35
LASK Linz,493,4,10,5,9,29,26,3,35
Mattersburg,493,5,7,7,10,33,41,-8,28
Vienna,493,6,6,6,12,25,42,-17,24
SC Rheindorf,493,7,4,7,13,21,33,-12,19
FC Salzburg,494,1,15,7,2,45,16,29,52
SK Sturm Gra,494,2,13,3,8,33,28,5,42
Rapid Vienna,494,3,9,10,5,38,29,9,37
LASK Linz,494,4,9,5,10,31,34,-3,32
Mattersburg,494,5,7,5,12,33,40,-7,26
Vienna,494,6,7,5,12,24,41,-17,26
SC Rheindorf,494,7,4,5,15,20,36,-16,17
FC Salzburg,495,1,14,7,3,46,18,28,49
SK Sturm Gra,495,2,14,3,7,35,28,7,45
Rapid Vienna,495,3,9,10,5,38,29,9,37
LASK Linz,495,4,7,6,11,25,30,-5,27
Vienna,495,5,7,5,12,24,41,-17,26
Mattersburg,495,6,6,6,12,29,40,-11,24
SC Rheindorf,495,7,6,5,13,21,32,-11,23
FC Salzburg,496,1,12,9,3,42,21,21,45
SK Sturm Gra,496,2,11,5,8,31,30,1,38
Rapid Vienna,496,3,8,11,5,35,26,9,35
LASK Linz,496,4,9,5,10,27,29,-2,32
Mattersburg,496,5,8,5,11,36,40,-4,29
SC Rheindorf,496,6,7,5,12,21,30,-9,26
Vienna,496,7,6,6,12,25,41,-16,24
FC Salzburg,497,1,13,9,2,42,17,25,48
SK Sturm Gra,497,2,13,4,7,34,27,7,43
Rapid Vienna,497,3,8,11,5,36,28,8,35
LASK Linz,497,4,8,6,10,25,29,-4,30
SC Rheindorf,497,5,7,5,12,22,29,-7,26
Vienna,497,6,6,6,12,25,40,-15,24
Mattersburg,497,7,6,5,13,31,45,-14,23
FC Salzburg,498,1,14,7,3,43,18,25,49
SK Sturm Gra,498,2,12,4,8,33,30,3,40
Rapid Vienna,498,3,8,11,5,36,29,7,35
LASK Linz,498,4,9,7,8,31,29,2,34
Mattersburg,498,5,7,6,11,34,41,-7,27
Vienna,498,6,7,5,12,25,42,-17,26
SC Rheindorf,498,7,4,6,14,18,31,-13,18
FC Salzburg,499,1,15,7,2,45,17,28,52
SK Sturm Gra,499,2,13,3,8,33,27,6,42
Rapid Vienna,499,3,8,9,7,33,30,3,33
LASK Linz,499,4,8,5,11,25,30,-5,29
Vienna,499,5,7,6,11,28,40,-12,27
SC Rheindorf,499,6,6,6,12,18,27,-9,24
Mattersburg,499,7,6,6,12,30,41,-11,24
FC Salzburg,500,1,15,6,3,48,18,30,51
SK Sturm Gra,500,2,12,4,8,33,29,4,40
Rapid Vienna,500,3,7,11,6,34,30,4,32
LASK Linz,500,4,8,6,10,28,31,-3,30
SC Rheindorf,500,5,7,5,12,21,29,-8,26
Mattersburg,500,6,7,5,12,30,43,-13,26
Vienna,500,7,7,5,12,25,39,-14,26
FC Salzburg,501,1,14,6,4,44,19,25,48
SK Sturm Gra,501,2,12,5,7,32,28,4,41
Rapid Vienna,501,3,8,10,6,35,30,5,34
LASK Linz,501,4,8,6,10,29,30,-1,30
Vienna,501,5,8,5,11,27,38,-11,29
Mattersburg,501,6,6,6,12,29,43,-14,24
SC Rheindorf,501,7,5,8,11,22,30,-8,23
SK Sturm Gra,502,1,14,4,6,37,28,9,46
FC Salzburg,502,2,12,8,4,43,22,21,44
Rapid Vienna,502,3,8,11,5,40,32,8,35
Vienna,502,4,8,5,11,27,39,-12,29
LASK Linz,502,5,7,6,11,26,33,-7,27
Mattersburg,502,6,6,7,11,33,43,-10,25
SC Rheindorf,502,7,5,7,12,20,29,-9,22
FC Salzburg,503,1,14,8,2,41,16,25,50
SK Sturm Gra,503,2,13,3,8,37,30,7,42
Rapid Vienna,503,3,10,10,4,36,25,11,40
LASK Linz,503,4,8,5,11,27,31,-4,29
Mattersburg,503,5,8,5,11,33,38,-5,29
Vienna,503,6,6,6,12,23,40,-17,24
SC Rheindorf,503,7,4,5,15,19,36,-17,17
FC Salzburg,504,1,14,7,3,46,21,25,49
SK Sturm Gra,504,2,13,4,7,34,30,4,43
Rapid Vienna,504,3,10,9,5,38,27,11,39
LASK Linz,504,4,8,6,10,28,31,-3,30
Mattersburg,504,5,6,7,11,33,41,-8,25
Vienna,504,6,6,6,12,24,41,-17,24
SC Rheindorf,504,7,4,7,13,19,31,-12,19
FC Salzburg,505,1,14,7,3,46,20,26,49
SK Sturm Gra,505,2,12,4,8,32,29,3,40
Rapid Vienna,505,3,9,10,5,35,26,9,37
LASK Linz,505,4,8,7,9,25,26,-1,31
Vienna,505,5,7,6,11,26,39,-13,27
Mattersburg,505,6,6,7,11,29,41,-12,25
SC Rheindorf,505,7,5,5,14,16,28,-12,20
FC Salzburg,506,1,16,6,2,49,18,31,54
SK Sturm Gra,506,2,12,4,8,29,28,1,40
Rapid Vienna,506,3,9,10,5,36,26,10,37
LASK Linz,506,4,8,6,10,26,29,-3,30
Vienna,506,5,7,5,12,26,40,-14,26
Mattersburg,506,6,6,6,12,31,44,-13,24
SC Rheindorf,506,7,5,5,14,17,29,-12,20
FC Salzburg,507,1,16,6,2,49,15,34,54
SK Sturm Gra,507,2,13,3,8,30,32,-2,42
Rapid Vienna,507,3,8,10,6,34,27,7,34
LASK Linz,507,4,7,6,11,25,29,-4,27
Mattersburg,507,5,7,5,12,31,40,-9,26
Vienna,507,6,7,5,12,25,41,-16,26
SC Rheindorf,507,7,5,7,12,18,28,-10,22
FC Salzburg,508,1,15,6,3,45,19,26,51
SK Sturm Gra,508,2,11,5,8,29,28,1,38
Rapid Vienna,508,3,9,10,5,34,26,8,37
LASK Linz,508,4,9,5,10,27,28,-1,32
Vienna,508,5,7,5,12,26,39,-13,26
Mattersburg,508,6,6,6,12,29,40,-11,24
SC Rheindorf,508,7,5,7,12,18,28,-10,22
FC Salzburg,509,1,16,6,2,46,18,28,54
SK Sturm Gra,509,2,13,4,7,35,29,6,43
Rapid Vienna,509,3,9,9,6,33,26,7,36
LASK Linz,509,4,8,6,10,27,29,-2,30
Vienna,509,5,7,5,12,25,38,-13,26
SC Rheindorf,509,6,6,5,13,18,28,-10,23
Mattersburg,509,7,5,5,14,29,45,-16,20
FC Salzburg,510,1,14,6,4,44,21,23,48
SK Sturm Gra,510,2,14,4,6,35,27,8,46
Rapid Vienna,510,3,9,9,6,36,28,8,36
LASK Linz,510,4,9,5,10,29,29,0,32
Vienna,510,5,7,5,12,25,39,-14,26
Mattersburg,510,6,6,5,13,32,42,-10,23
SC Rheindorf,510,7,5,6,13,17,32,-15,21
FC Salzburg,511,1,13,7,4,42,22,20,46
SK Sturm Gra,511,2,14,4,6,36,26,10,46
Rapid Vienna,511,3,10,9,5,36,27,9,39
LASK Linz,511,4,8,6,10,29,28,1,30
Vienna,511,5,6,7,11,28,42,-14,25
Mattersburg,511,6,5,7,12,30,45,-15,22
SC Rheindorf,511,7,4,8,12,18,29,-11,20
FC Salzburg,512,1,13,6,5,44,20,24,45
SK Sturm Gra,512,2,12,4,8,34,31,3,40
Rapid Vienna,512,3,9,10,5,38,28,10,37
LASK Linz,512,4,9,6,9,30,30,0,33
Vienna,512,5,8,5,11,26,38,-12,29
Mattersburg,512,6,6,6,12,30,44,-14,24
SC Rheindorf,512,7,6,5,13,21,32,-11,23
FC Salzburg,513,1,13,9,2,47,22,25,48
SK Sturm Gra,513,2,13,4,7,33,29,4,43
Rapid Vienna,513,3,7,11,6,35,29,6,32
LASK Linz,513,4,8,6,10,24,27,-3,30
Vienna,513,5,7,6,11,29,41,-12,27
Mattersburg,513,6,6,6,12,29,41,-12,24
SC Rheindorf,513,7,5,8,11,18,26,-8,23
FC Salzburg,514,1,14,8,2,44,17,27,50
SK Sturm Gra,514,2,12,5,7,35,31,4,41
Rapid Vienna,514,3,8,9,7,37,30,7,33
LASK Linz,514,4,9,6,9,29,31,-2,33
Vienna,514,5,7,5,12,24,39,-15,26
SC Rheindorf,514,6,6,6,12,21,30,-9,24
Mattersburg,514,7,5,7,12,29,41,-12,22
FC Salzburg,515,1,15,6,3,47,19,28,51
SK Sturm Gra,515,2,13,4,7,33,29,4,43
Rapid Vienna,515,3,8,9,7,34,27,7,33
LASK Linz,515,4,9,5,10,29,29,0,32
Vienna,515,5,7,5,12,27,40,-13,26
SC Rheindorf,515,6,6,6,12,21,32,-11,24
Mattersburg,515,7,6,5,13,31,46,-15,23
FC Salzburg,516,1,12,7,5,41,23,18,43
SK Sturm Gra,516,2,12,4,8,30,28,2,40
Rapid Vienna,516,3,8,10,6,38,31,7,34
LASK Linz,516,4,9,5,10,30,29,1,32
Mattersburg,516,5,8,5,11,34,42,-8,29
Vienna,516,6,8,5,11,26,38,-12,29
SC Rheindorf,516,7,6,6,12,20,28,-8,24
FC Salzburg,517,1,15,7,2,46,17,29,52
SK Sturm Gra,517,2,11,5,8,31,29,2,38
Rapid Vienna,517,3,9,10,5,35,26,9,37
LASK Linz,517,4,8,6,10,25,27,-2,30
SC Rheindorf,517,5,7,5,12,20,28,-8,26
Vienna,517,6,7,5,12,24,40,-16,26
Mattersburg,517,7,5,6,13,28,42,-14,21
FC Salzburg,518,1,16,6,2,49,18,31,54
SK Sturm Gra,518,2,13,4,7,33,28,5,43
Rapid Vienna,518,3,8,10,6,36,30,6,34
LASK Linz,518,4,8,6,10,26,27,-1,30
Mattersburg,518,5,7,5,12,32,41,-9,26
Vienna,518,6,6,5,13,25,45,-20,23
SC Rheindorf,518,7,5,6,13,18,30,-12,21
FC Salzburg,519,1,13,8,3,41,18,23,47
SK Sturm Gra,519,2,12,3,9,33,32,1,39
Rapid Vienna,519,3,8,12,4,34,25,9,36
LASK Linz,519,4,7,7,10,28,32,-4,28
Vienna,519,5,7,6,11,26,39,-13,27
Mattersburg,519,6,6,8,10,31,40,-9,26
SC Rheindorf,519,7,5,8,11,24,31,-7,23
FC Salzburg,520,1,16,6,2,44,16,28,54
SK Sturm Gra,520,2,12,5,7,32,26,6,41
Rapid Vienna,520,3,8,10,6,33,28,5,34
LASK Linz,520,4,9,7,8,27,24,3,34
Vienna,520,5,7,5,12,25,39,-14,26
Mattersburg,520,6,6,5,13,27,40,-13,23
SC Rheindorf,520,7,4,6,14,15,30,-15,18
FC Salzburg,521,1,13,9,2,45,18,27,48
SK Sturm Gra,521,2,12,5,7,32,29,3,41
Rapid Vienna,521,3,8,11,5,35,26,9,35
LASK Linz,521,4,9,5,10,27,28,-1,32
SC Rheindorf,521,5,7,5,12,20,27,-7,26
Mattersburg,521,6,6,6,12,30,41,-11,24
Vienna,521,7,6,5,13,23,43,-20,23
FC Salzburg,522,1,13,6,5,41,22,19,45
SK Sturm Gra,522,2,12,3,9,32,32,0,39
Rapid Vienna,522,3,8,11,5,36,27,9,35
LASK Linz,522,4,9,6,9,28,27,1,33
Mattersburg,522,5,7,6,11,33,42,-9,27
Vienna,522,6,7,6,11,30,41,-11,27
SC Rheindorf,522,7,6,6,12,18,27,-9,24
FC Salzburg,523,1,15,6,3,46,21,25,51
Rapid Vienna,523,2,9,11,4,40,27,13,38
SK Sturm Gra,523,3,11,4,9,31,32,-1,37
LASK Linz,523,4,8,6,10,28,31,-3,30
Mattersburg,523,5,7,6,11,31,40,-9,27
SC Rheindorf,523,6,6,6,12,22,30,-8,24
Vienna,523,7,6,5,13,24,41,-17,23
FC Salzburg,524,1,13,7,4,41,21,20,46
SK Sturm Gra,524,2,12,5,7,33,30,3,41
Rapid Vienna,524,3,10,9,5,39,27,12,39
LASK Linz,524,4,7,8,9,27,30,-3,29
Vienna,524,5,8,5,11,29,38,-9,29
Mattersburg,524,6,6,7,11,31,41,-10,25
SC Rheindorf,524,7,4,7,13,16,29,-13,19
FC Salzburg,525,1,15,7,2,46,18,28,52
SK Sturm Gra,525,2,13,4,7,31,27,4,43
Rapid Vienna,525,3,9,9,6,39,29,10,36
LASK Linz,525,4,9,6,9,26,26,0,33
Vienna,525,5,7,5,12,26,40,-14,26
Mattersburg,525,6,5,6,13,29,42,-13,21
SC Rheindorf,525,7,4,7,13,16,31,-15,19
FC Salzburg,526,1,13,6,5,42,21,21,45
SK Sturm Gra,526,2,13,4,7,33,29,4,43
Rapid Vienna,526,3,9,10,5,35,25,10,37
LASK Linz,526,4,7,7,10,24,30,-6,28
SC Rheindorf,526,5,7,6,11,24,27,-3,27
Mattersburg,526,6,7,6,11,32,41,-9,27
Vienna,526,7,6,5,13,25,42,-17,23
FC Salzburg,527,1,14,6,4,44,22,22,48
Rapid Vienna,527,2,11,9,4,42,23,19,42
SK Sturm Gra,527,3,12,4,8,31,30,1,40
LASK Linz,527,4,7,7,10,24,30,-6,28
Vienna,527,5,7,6,11,28,38,-10,27
Mattersburg,527,6,5,8,11,30,42,-12,23
SC Rheindorf,527,7,4,8,12,17,31,-14,20
FC Salzburg,528,1,14,6,4,43,19,24,48
SK Sturm Gra,528,2,12,3,9,36,34,2,39
Rapid Vienna,528,3,9,9,6,36,29,7,36
LASK Linz,528,4,9,6,9,29,29,0,33
Vienna,528,5,8,5,11,27,39,-12,29
Mattersburg,528,6,6,6,12,34,44,-10,24
SC Rheindorf,528,7,6,5,13,23,34,-11,23
FC Salzburg,529,1,15,6,3,49,19,30,51
SK Sturm Gra,529,2,12,5,7,36,32,4,41
Rapid Vienna,529,3,8,11,5,36,27,9,35
LASK Linz,529,4,8,6,10,27,32,-5,30
Mattersburg,529,5,6,7,11,29,41,-12,25
Vienna,529,6,6,6,12,23,39,-16,24
SC Rheindorf,529,7,5,7,12,18,28,-10,22
FC Salzburg,530,1,16,6,2,48,16,32,54
SK Sturm Gra,530,2,12,4,8,32,28,4,40
Rapid Vienna,530,3,10,9,5,37,26,11,39
LASK Linz,530,4,8,6,10,24,27,-3,30
Mattersburg,530,5,6,6,12,29,44,-15,24
Vienna,530,6,6,5,13,25,43,-18,23
SC Rheindorf,530,7,5,6,13,17,28,-11,21
FC Salzburg,531,1,15,6,3,48,19,29,51
SK Sturm Gra,531,2,12,5,7,35,33,2,41
Rapid Vienna,531,3,9,10,5,38,31,7,37
LASK Linz,531,4,9,6,9,29,27,2,33
Vienna,531,5,6,6,12,26,43,-17,24
SC Rheindorf,531,6,5,7,12,20,30,-10,22
Mattersburg,531,7,5,6,13,31,44,-13,21
FC Salzburg,532,1,14,7,3,46,20,26,49
SK Sturm Gra,532,2,12,4,8,33,32,1,40
Rapid Vienna,532,3,9,10,5,37,28,9,37
LASK Linz,532,4,8,7,9,28,28,0,31
Mattersburg,532,5,7,5,12,33,42,-9,26
Vienna,532,6,6,6,12,26,43,-17,24
SC Rheindorf,532,7,6,5,13,18,28,-10,23
FC Salzburg,533,1,15,6,3,46,18,28,51
SK Sturm Gra,533,2,13,4,7,36,31,5,43
Rapid Vienna,533,3,10,9,5,38,28,10,39
LASK Linz,533,4,8,5,11,26,29,-3,29
Vienna,533,5,6,6,12,23,39,-16,24
SC Rheindorf,533,6,5,7,12,16,26,-10,22
Mattersburg,533,7,5,7,12,26,40,-14,22
FC Salzburg,534,1,15,6,3,49,19,30,51
SK Sturm Gra,534,2,12,4,8,32,31,1,40
Rapid Vienna,534,3,9,10,5,38,28,10,37
LASK Linz,534,4,9,6,9,30,28,2,33
Mattersburg,534,5,6,7,11,30,41,-11,25
Vienna,534,6,6,6,12,24,42,-18,24
SC Rheindorf,534,7,5,5,14,18,32,-14,20
FC Salzburg,535,1,14,6,4,44,21,23,48
SK Sturm Gra,535,2,12,4,8,29,28,1,40
Rapid Vienna,535,3,10,9,5,37,25,12,39
LASK Linz,535,4,10,6,8,29,26,3,36
Vienna,535,5,6,6,12,26,42,-16,24
SC Rheindorf,535,6,6,5,13,21,30,-9,23
Mattersburg,535,7,5,6,13,33,47,-14,21
FC Salzburg,536,1,14,7,3,44,20,24,49
SK Sturm Gra,536,2,14,4,6,35,25,10,46
Rapid Vienna,536,3,8,10,6,38,30,8,34
LASK Linz,536,4,9,6,9,28,31,-3,33
Vienna,536,5,6,7,11,26,40,-14,25
SC Rheindorf,536,6,5,6,13,19,31,-12,21
Mattersburg,536,7,5,6,13,29,42,-13,21
FC Salzburg,537,1,15,7,2,52,18,34,52
SK Sturm Gra,537,2,13,4,7,36,31,5,43
Rapid Vienna,537,3,7,9,8,33,33,0,30
LASK Linz,537,4,8,5,11,30,35,-5,29
Mattersburg,537,5,8,5,11,34,45,-11,29
SC Rheindorf,537,6,6,6,12,23,30,-7,24
Vienna,537,7,6,6,12,25,41,-16,24
FC Salzburg,538,1,14,6,4,43,20,23,48
SK Sturm Gra,538,2,14,4,6,36,28,8,46
Rapid Vienna,538,3,7,11,6,34,29,5,32
LASK Linz,538,4,8,6,10,27,29,-2,30
Vienna,538,5,7,5,12,25,38,-13,26
SC Rheindorf,538,6,6,6,12,20,30,-10,24
Mattersburg,538,7,6,6,12,30,41,-11,24
FC Salzburg,539,1,13,8,3,46,23,23,47
SK Sturm Gra,539,2,12,5,7,36,31,5,41
Rapid Vienna,539,3,9,10,5,35,27,8,37
LASK Linz,539,4,9,5,10,27,28,-1,32
Vienna,539,5,7,6,11,26,38,-12,27
Mattersburg,539,6,6,7,11,32,41,-9,25
SC Rheindorf,539,7,5,5,14,17,31,-14,20
FC Salzburg,540,1,14,8,2,42,16,26,50
SK Sturm Gra,540,2,12,4,8,31,28,3,40
Rapid Vienna,540,3,10,9,5,38,27,11,39
LASK Linz,540,4,7,6,11,26,33,-7,27
Vienna,540,5,7,5,12,25,40,-15,26
Mattersburg,540,6,6,7,11,34,41,-7,25
SC Rheindorf,540,7,5,7,12,18,29,-11,22
FC Salzburg,541,1,14,6,4,45,22,23,48
SK Sturm Gra,541,2,14,3,7,35,27,8,45
Rapid Vienna,541,3,8,11,5,37,29,8,35
LASK Linz,541,4,8,7,9,29,30,-1,31
Vienna,541,5,8,5,11,28,39,-11,29
Mattersburg,541,6,6,5,13,32,47,-15,23
SC Rheindorf,541,7,4,7,13,20,32,-12,19
FC Salzburg,542,1,14,8,2,44,17,27,50
SK Sturm Gra,542,2,11,5,8,30,31,-1,38
Rapid Vienna,542,3,7,13,4,36,28,8,34
LASK Linz,542,4,9,6,9,31,30,1,33
Vienna,542,5,7,5,12,25,39,-14,26
SC Rheindorf,542,6,5,8,11,23,31,-8,23
Mattersburg,542,7,5,7,12,32,45,-13,22
FC Salzburg,543,1,14,7,3,44,20,24,49
SK Sturm Gra,543,2,12,4,8,31,29,2,40
Rapid Vienna,543,3,7,12,5,38,31,7,33
LASK Linz,543,4,9,5,10,31,33,-2,32
Vienna,543,5,8,5,11,29,40,-11,29
SC Rheindorf,543,6,6,6,12,22,31,-9,24
Mattersburg,543,7,6,5,13,33,44,-11,23
FC Salzburg,544,1,15,7,2,49,21,28,52
SK Sturm Gra,544,2,12,4,8,32,31,1,40
Rapid Vienna,544,3,8,10,6,38,32,6,34
LASK Linz,544,4,9,6,9,30,28,2,33
Mattersburg,544,5,6,7,11,33,41,-8,25
Vienna,544,6,6,6,12,25,40,-15,24
SC Rheindorf,544,7,5,6,13,19,33,-14,21
FC Salzburg,545,1,13,9,2,43,18,25,48
SK Sturm Gra,545,2,12,6,6,32,27,5,42
Rapid Vienna,545,3,7,11,6,33,28,5,32
LASK Linz,545,4,8,6,10,26,28,-2,30
Mattersburg,545,5,7,6,11,31,40,-9,27
Vienna,545,6,7,5,12,26,40,-14,26
SC Rheindorf,545,7,5,7,12,18,28,-10,22
FC Salzburg,546,1,13,7,4,43,21,22,46
SK Sturm Gra,546,2,14,3,7,32,26,6,45
Rapid Vienna,546,3,8,10,6,35,30,5,34
LASK Linz,546,4,8,7,9,28,28,0,31
Vienna,546,5,7,6,11,30,39,-9,27
SC Rheindorf,546,6,6,6,12,23,30,-7,24
Mattersburg,546,7,6,5,13,30,47,-17,23
FC Salzburg,547,1,12,9,3,40,18,22,45
SK Sturm Gra,547,2,13,5,6,32,25,7,44
Rapid Vienna,547,3,7,12,5,32,27,5,33
LASK Linz,547,4,8,5,11,28,30,-2,29
Mattersburg,547,5,7,7,10,33,40,-7,28
Vienna,547,6,7,5,12,25,40,-15,26
SC Rheindorf,547,7,5,7,12,19,29,-10,22
FC Salzburg,548,1,14,7,3,44,16,28,49
SK Sturm Gra,548,2,12,3,9,33,32,1,39
Rapid Vienna,548,3,8,9,7,34,31,3,33
LASK Linz,548,4,9,6,9,29,27,2,33
SC Rheindorf,548,5,7,6,11,22,28,-6,27
Vienna,548,6,7,6,11,25,37,-12,27
Mattersburg,548,7,5,7,12,27,43,-16,22
FC Salzburg,549,1,14,6,4,46,20,26,48
SK Sturm Gra,549,2,13,3,8,35,29,6,42
Rapid Vienna,549,3,9,10,5,34,26,8,37
LASK Linz,549,4,10,6,8,30,27,3,36
Vienna,549,5,8,5,11,30,39,-9,29
Mattersburg,549,6,5,6,13,28,48,-20,21
SC Rheindorf,549,7,4,6,14,18,32,-14,18
FC Salzburg,550,1,15,7,2,44,16,28,52
SK Sturm Gra,550,2,12,4,8,31,30,1,40
LASK Linz,550,3,10,6,8,28,26,2,36
Rapid Vienna,550,4,8,9,7,34,27,7,33
Vienna,550,5,7,6,11,27,40,-13,27
Mattersburg,550,6,6,5,13,31,43,-12,23
SC Rheindorf,550,7,5,5,14,20,33,-13,20
FC Salzburg,551,1,15,7,2,48,18,30,52
SK Sturm Gra,551,2,13,4,7,33,29,4,43
Rapid Vienna,551,3,8,9,7,34,31,3,33
LASK Linz,551,4,8,7,9,25,26,-1,31
Mattersburg,551,5,8,6,10,35,40,-5,30
Vienna,551,6,6,5,13,25,41,-16,23
SC Rheindorf,551,7,4,6,14,18,33,-15,18
FC Salzburg,552,1,12,8,4,42,23,19,44
SK Sturm Gra,552,2,13,5,6,34,26,8,44
Rapid Vienna,552,3,9,9,6,37,28,9,36
LASK Linz,552,4,9,6,9,29,28,1,33
Vienna,552,5,7,6,11,27,39,-12,27
Mattersburg,552,6,6,7,11,32,42,-10,25
SC Rheindorf,552,7,4,7,13,19,34,-15,19
FC Salzburg,553,1,15,6,3,47,18,29,51
SK Sturm Gra,553,2,12,5,7,32,32,0,41
Rapid Vienna,553,3,8,11,5,34,26,8,35
LASK Linz,553,4,8,7,9,27,28,-1,31
Vienna,553,5,8,5,11,30,37,-7,29
SC Rheindorf,553,6,5,7,12,17,27,-10,22
Mattersburg,553,7,5,5,14,28,47,-19,20
FC Salzburg,554,1,14,7,3,44,21,23,49
SK Sturm Gra,554,2,13,3,8,36,29,7,42
Rapid Vienna,554,3,8,11,5,32,25,7,35
LASK Linz,554,4,9,5,10,26,29,-3,32
Mattersburg,554,5,7,7,10,34,38,-4,28
Vienna,554,6,6,6,12,26,41,-15,24
SC Rheindorf,554,7,4,7,13,16,31,-15,19
FC Salzburg,555,1,15,7,2,52,18,34,52
Rapid Vienna,555,2,10,10,4,40,27,13,40
SK Sturm Gra,555,3,11,5,8,30,30,0,38
LASK Linz,555,4,7,6,11,26,31,-5,27
Mattersburg,555,5,7,6,11,35,43,-8,27
Vienna,555,6,6,5,13,24,46,-22,23
SC Rheindorf,555,7,5,7,12,18,30,-12,22
FC Salzburg,556,1,14,7,3,48,19,29,49
SK Sturm Gra,556,2,13,3,8,34,33,1,42
Rapid Vienna,556,3,7,10,7,37,35,2,31
LASK Linz,556,4,8,7,9,31,30,1,31
Mattersburg,556,5,6,8,10,30,39,-9,26
SC Rheindorf,556,6,6,7,11,20,28,-8,25
Vienna,556,7,6,6,12,25,41,-16,24
FC Salzburg,557,1,14,6,4,43,19,24,48
SK Sturm Gra,557,2,14,4,6,34,25,9,46
LASK Linz,557,3,10,5,9,28,27,1,35
Rapid Vienna,557,4,7,10,7,32,28,4,31
Mattersburg,557,5,7,5,12,31,41,-10,26
Vienna,557,6,7,5,12,26,40,-14,26
SC Rheindorf,557,7,4,7,13,16,30,-14,19
FC Salzburg,558,1,15,6,3,47,18,29,51
Rapid Vienna,558,2,9,10,5,40,29,11,37
SK Sturm Gra,558,3,11,4,9,30,33,-3,37
LASK Linz,558,4,8,7,9,29,31,-2,31
Mattersburg,558,5,7,6,11,32,41,-9,27
Vienna,558,6,7,6,11,25,37,-12,27
SC Rheindorf,558,7,4,7,13,18,32,-14,19
FC Salzburg,559,1,12,9,3,42,20,22,45
SK Sturm Gra,559,2,11,7,6,32,28,4,40
Rapid Vienna,559,3,8,11,5,35,28,7,35
LASK Linz,559,4,7,8,9,26,28,-2,29
Vienna,559,5,7,6,11,27,40,-13,27
Mattersburg,559,6,6,7,11,31,41,-10,25
SC Rheindorf,559,7,5,8,11,20,28,-8,23
FC Salzburg,560,1,16,6,2,49,18,31,54
SK Sturm Gra,560,2,13,3,8,34,31,3,42
Rapid Vienna,560,3,8,10,6,35,29,6,34
LASK Linz,560,4,9,6,9,31,30,1,33
Mattersburg,560,5,7,5,12,34,44,-10,26
Vienna,560,6,6,5,13,25,43,-18,23
SC Rheindorf,560,7,5,5,14,19,32,-13,20
FC Salzburg,561,1,15,7,2,43,16,27,52
SK Sturm Gra,561,2,12,5,7,33,28,5,41
Rapid Vienna,561,3,9,9,6,37,29,8,36
LASK Linz,561,4,8,7,9,28,30,-2,31
Vienna,561,5,6,6,12,25,40,-15,24
SC Rheindorf,561,6,5,7,12,17,27,-10,22
Mattersburg,561,7,5,7,12,30,43,-13,22
FC Salzburg,562,1,15,7,2,50,18,32,52
SK Sturm Gra,562,2,13,5,6,34,27,7,44
Rapid Vienna,562,3,8,10,6,35,31,4,34
LASK Linz,562,4,8,6,10,27,29,-2,30
Vienna,562,5,7,5,12,25,41,-16,26
Mattersburg,562,6,6,6,12,29,40,-11,24
SC Rheindorf,562,7,4,7,13,15,29,-14,19
FC Salzburg,563,1,13,8,3,42,19,23,47
SK Sturm Gra,563,2,12,6,6,33,28,5,42
Rapid Vienna,563,3,8,9,7,33,27,6,33
LASK Linz,563,4,8,7,9,25,26,-1,31
Mattersburg,563,5,7,7,10,31,38,-7,28
SC Rheindorf,563,6,6,6,12,18,28,-10,24
Vienna,563,7,6,5,13,23,39,-16,23
FC Salzburg,564,1,14,8,2,47,19,28,50
SK Sturm Gra,564,2,13,4,7,37,30,7,43
Rapid Vienna,564,3,9,11,4,38,25,13,38
LASK Linz,564,4,8,6,10,30,32,-2,30
Mattersburg,564,5,7,5,12,33,43,-10,26
Vienna,564,6,6,5,13,24,42,-18,23
SC Rheindorf,564,7,5,5,14,18,36,-18,20
FC Salzburg,565,1,14,7,3,46,18,28,49
SK Sturm Gra,565,2,13,3,8,33,28,5,42
Rapid Vienna,565,3,9,9,6,35,27,8,36
LASK Linz,565,4,9,6,9,27,29,-2,33
Vienna,565,5,7,6,11,27,39,-12,27
Mattersburg,565,6,5,7,12,28,45,-17,22
SC Rheindorf,565,7,5,6,13,19,29,-10,21
FC Salzburg,566,1,14,7,3,45,17,28,49
SK Sturm Gra,566,2,12,5,7,31,28,3,41
LASK Linz,566,3,9,7,8,29,27,2,34
Rapid Vienna,566,4,7,10,7,35,31,4,31
Vienna,566,5,7,5,12,25,38,-13,26
Mattersburg,566,6,7,5,12,28,43,-15,26
SC Rheindorf,566,7,6,5,13,19,28,-9,23
FC Salzburg,567,1,15,6,3,48,19,29,51
SK Sturm Gra,567,2,14,4,6,37,28,9,46
Rapid Vienna,567,3,8,10,6,33,26,7,34
LASK Linz,567,4,7,8,9,27,29,-2,29
Mattersburg,567,5,6,7,11,34,45,-11,25
Vienna,567,6,6,6,12,24,39,-15,24
SC Rheindorf,567,7,5,5,14,19,36,-17,20
FC Salzburg,568,1,13,8,3,43,19,24,47
SK Sturm Gra,568,2,14,4,6,33,26,7,46
Rapid Vienna,568,3,9,9,6,34,26,8,36
LASK Linz,568,4,8,7,9,27,28,-1,31
Vienna,568,5,7,6,11,26,39,-13,27
Mattersburg,568,6,5,7,12,27,40,-13,22
SC Rheindorf,568,7,4,7,13,19,31,-12,19
FC Salzburg,569,1,13,8,3,43,19,24,47
SK Sturm Gra,569,2,12,6,6,33,28,5,42
Rapid Vienna,569,3,8,12,4,38,27,11,36
LASK Linz,569,4,7,7,10,27,33,-6,28
Vienna,569,5,7,5,12,26,40,-14,26
Mattersburg,569,6,6,7,11,32,42,-10,25
SC Rheindorf,569,7,4,9,11,21,31,-10,21
FC Salzburg,570,1,14,7,3,44,19,25,49
SK Sturm Gra,570,2,13,4,7,32,26,6,43
Rapid Vienna,570,3,9,10,5,39,27,12,37
LASK Linz,570,4,9,6,9,27,28,-1,33
Mattersburg,570,5,6,6,12,29,40,-11,24
Vienna,570,6,6,6,12,25,41,-16,24
SC Rheindorf,570,7,4,7,13,18,33,-15,19
FC Salzburg,571,1,14,8,2,45,19,26,50
SK Sturm Gra,571,2,12,4,8,32,27,5,40
Rapid Vienna,571,3,8,10,6,36,29,7,34
LASK Linz,571,4,9,6,9,28,27,1,33
Vienna,571,5,6,7,11,25,39,-14,25
SC Rheindorf,571,6,6,6,12,20,31,-11,24
Mattersburg,571,7,5,7,12,30,44,-14,22
SK Sturm Gra,572,1,14,4,6,38,28,10,46
FC Salzburg,572,2,12,9,3,47,25,22,45
Rapid Vienna,572,3,7,12,5,34,30,4,33
LASK Linz,572,4,8,6,10,28,31,-3,30
Vienna,572,5,7,6,11,27,39,-12,27
Mattersburg,572,6,6,7,11,33,43,-10,25
SC Rheindorf,572,7,4,8,12,16,27,-11,20
FC Salzburg,573,1,14,6,4,44,20,24,48
SK Sturm Gra,573,2,11,5,8,31,30,1,38
Rapid Vienna,573,3,9,10,5,38,29,9,37
LASK Linz,573,4,9,7,8,29,27,2,34
Vienna,573,5,8,5,11,29,37,-8,29
Mattersburg,573,6,5,7,12,29,47,-18,22
SC Rheindorf,573,7,5,6,13,20,30,-10,21
FC Salzburg,574,1,14,7,3,46,21,25,49
SK Sturm Gra,574,2,12,5,7,33,28,5,41
Rapid Vienna,574,3,9,10,5,36,28,8,37
LASK Linz,574,4,9,7,8,28,27,1,34
Mattersburg,574,5,7,5,12,34,45,-11,26
Vienna,574,6,6,5,13,27,43,-16,23
SC Rheindorf,574,7,5,5,14,20,32,-12,20
FC Salzburg,575,1,15,6,3,46,19,27,51
SK Sturm Gra,575,2,14,3,7,37,28,9,45
Rapid Vienna,575,3,9,9,6,36,29,7,36
LASK Linz,575,4,9,5,10,29,32,-3,32
Mattersburg,575,5,6,6,12,31,43,-12,24
Vienna,575,6,6,6,12,26,41,-15,24
SC Rheindorf,575,7,5,5,14,20,33,-13,20
FC Salzburg,576,1,14,6,4,48,23,25,48
SK Sturm Gra,576,2,14,4,6,34,27,7,46
Rapid Vienna,576,3,8,10,6,33,27,6,34
LASK Linz,576,4,9,5,10,27,27,0,32
Vienna,576,5,8,5,11,29,40,-11,29
SC Rheindorf,576,6,5,6,13,18,29,-11,21
Mattersburg,576,7,5,6,13,32,48,-16,21
FC Salzburg,577,1,13,9,2,48,21,27,48
SK Sturm Gra,577,2,13,5,6,34,27,7,44
LASK Linz,577,3,8,8,8,30,30,0,32
Rapid Vienna,577,4,7,10,7,32,29,3,31
Vienna,577,5,7,6,11,27,40,-13,27
SC Rheindorf,577,6,6,6,12,21,29,-8,24
Mattersburg,577,7,5,6,13,30,46,-16,21
FC Salzburg,578,1,16,6,2,55,20,35,54
SK Sturm Gra,578,2,13,4,7,34,30,4,43
Rapid Vienna,578,3,8,10,6,38,31,7,34
LASK Linz,578,4,8,6,10,26,27,-1,30
SC Rheindorf,578,5,5,8,11,22,31,-9,23
Mattersburg,578,6,6,5,13,32,50,-18,23
Vienna,578,7,6,5,13,25,43,-18,23
FC Salzburg,579,1,14,7,3,48,22,26,49
SK Sturm Gra,579,2,14,3,7,40,28,12,45
Rapid Vienna,579,3,7,11,6,36,34,2,32
LASK Linz,579,4,8,6,10,30,33,-3,30
Mattersburg,579,5,8,6,10,32,39,-7,30
Vienna,579,6,6,5,13,24,42,-18,23
SC Rheindorf,579,7,4,8,12,16,28,-12,20
FC Salzburg,580,1,16,6,2,48,19,29,54
SK Sturm Gra,580,2,12,4,8,33,32,1,40
LASK Linz,580,3,10,6,8,34,26,8,36
Rapid Vienna,580,4,8,11,5,36,27,9,35
Vienna,580,5,7,5,12,24,40,-16,26
SC Rheindorf,580,6,5,5,14,21,34,-13,20
Mattersburg,580,7,5,5,14,29,47,-18,20
FC Salzburg,581,1,14,8,2,46,17,29,50
SK Sturm Gra,581,2,13,3,8,33,28,5,42
Rapid Vienna,581,3,8,9,7,34,32,2,33
LASK Linz,581,4,9,6,9,28,26,2,33
Vienna,581,5,7,6,11,25,37,-12,27
SC Rheindorf,581,6,5,7,12,17,28,-11,22
Mattersburg,581,7,5,7,12,29,44,-15,22
FC Salzburg,582,1,14,8,2,50,20,30,50
SK Sturm Gra,582,2,14,3,7,36,31,5,45
LASK Linz,582,3,9,6,9,29,29,0,33
Rapid Vienna,582,4,7,11,6,35,29,6,32
Mattersburg,582,5,6,6,12,31,45,-14,24
Vienna,582,6,6,6,12,26,42,-16,24
SC Rheindorf,582,7,4,8,12,17,28,-11,20
FC Salzburg,583,1,14,8,2,49,20,29,50
SK Sturm Gra,583,2,12,4,8,33,31,2,40
Rapid Vienna,583,3,8,11,5,36,28,8,35
SC Rheindorf,583,4,8,5,11,24,26,-2,29
LASK Linz,583,5,7,6,11,25,32,-7,27
Vienna,583,6,7,5,12,25,39,-14,26
Mattersburg,583,7,6,5,13,31,47,-16,23
FC Salzburg,584,1,13,8,3,41,19,22,47
SK Sturm Gra,584,2,13,3,8,38,30,8,42
LASK Linz,584,3,9,6,9,29,29,0,33
Rapid Vienna,584,4,7,11,6,32,29,3,32
SC Rheindorf,584,5,7,5,12,23,29,-6,26
Mattersburg,584,6,6,7,11,31,43,-12,25
Vienna,584,7,6,6,12,25,40,-15,24
FC Salzburg,585,1,15,6,3,47,19,28,51
SK Sturm Gra,585,2,12,3,9,33,33,0,39
LASK Linz,585,3,10,5,9,29,27,2,35
Rapid Vienna,585,4,8,10,6,34,28,6,34
Mattersburg,585,5,7,5,12,34,43,-9,26
Vienna,585,6,7,5,12,27,44,-17,26
SC Rheindorf,585,7,5,6,13,19,29,-10,21
FC Salzburg,586,1,13,6,5,40,20,20,45
SK Sturm Gra,586,2,13,3,8,33,27,6,42
Rapid Vienna,586,3,10,9,5,38,29,9,39
LASK Linz,586,4,8,7,9,30,31,-1,31
Vienna,586,5,7,6,11,26,39,-13,27
Mattersburg,586,6,6,7,11,32,42,-10,25
SC Rheindorf,586,7,5,6,13,19,30,-11,21
FC Salzburg,587,1,14,8,2,46,19,27,50
SK Sturm Gra,587,2,13,4,7,36,31,5,43
LASK Linz,587,3,9,6,9,30,31,-1,33
Rapid Vienna,587,4,7,9,8,32,31,1,30
Mattersburg,587,5,7,6,11,34,40,-6,27
Vienna,587,6,7,6,11,26,39,-13,27
SC Rheindorf,587,7,5,5,14,20,33,-13,20
FC Salzburg,588,1,15,7,2,47,18,29,52
SK Sturm Gra,588,2,12,3,9,33,31,2,39
LASK Linz,588,3,10,6,8,30,27,3,36
Rapid Vienna,588,4,8,9,7,38,31,7,33
SC Rheindorf,588,5,6,6,12,22,29,-7,24
Mattersburg,588,6,6,6,12,29,44,-15,24
Vienna,588,7,6,5,13,24,43,-19,23
FC Salzburg,589,1,15,6,3,42,16,26,51
SK Sturm Gra,589,2,12,4,8,32,30,2,40
LASK Linz,589,3,10,6,8,34,31,3,36
Rapid Vienna,589,4,8,10,6,35,28,7,34
SC Rheindorf,589,5,6,6,12,22,29,-7,24
Vienna,589,6,6,6,12,25,40,-15,24
Mattersburg,589,7,5,6,13,30,46,-16,21
FC Salzburg,590,1,15,6,3,45,19,26,51
Rapid Vienna,590,2,11,9,4,43,27,16,42
SK Sturm Gra,590,3,11,4,9,32,33,-1,37
LASK Linz,590,4,8,6,10,27,29,-2,30
Vienna,590,5,7,5,12,26,41,-15,26
SC Rheindorf,590,6,6,6,12,22,31,-9,24
Mattersburg,590,7,5,6,13,31,46,-15,21
FC Salzburg,591,1,15,6,3,46,20,26,51
SK Sturm Gra,591,2,13,4,7,33,28,5,43
Rapid Vienna,591,3,8,10,6,36,29,7,34
LASK Linz,591,4,8,7,9,28,30,-2,31
Vienna,591,5,7,5,12,29,44,-15,26
SC Rheindorf,591,6,6,6,12,20,27,-7,24
Mattersburg,591,7,5,6,13,32,46,-14,21
FC Salzburg,592,1,15,6,3,45,18,27,51
Rapid Vienna,592,2,9,11,4,35,25,10,38
SK Sturm Gra,592,3,11,4,9,30,32,-2,37
LASK Linz,592,4,9,7,8,28,26,2,34
Mattersburg,592,5,6,7,11,29,40,-11,25
Vienna,592,6,6,6,12,24,39,-15,24
SC Rheindorf,592,7,5,5,14,18,29,-11,20
FC Salzburg,593,1,16,6,2,47,16,31,54
SK Sturm Gra,593,2,14,3,7,38,29,9,45
Rapid Vienna,593,3,9,9,6,37,29,8,36
LASK Linz,593,4,7,5,12,24,31,-7,26
Mattersburg,593,5,7,5,12,33,41,-8,26
Vienna,593,6,7,5,12,25,39,-14,26
SC Rheindorf,593,7,5,5,14,20,39,-19,20
FC Salzburg,594,1,15,6,3,46,21,25,51
Rapid Vienna,594,2,10,9,5,37,27,10,39
SK Sturm Gra,594,3,11,4,9,32,32,0,37
LASK Linz,594,4,8,6,10,30,32,-2,30
Vienna,594,5,7,5,12,27,40,-13,26
SC Rheindorf,594,6,6,6,12,21,30,-9,24
Mattersburg,594,7,6,6,12,30,41,-11,24
FC Salzburg,595,1,15,6,3,43,18,25,51
SK Sturm Gra,595,2,13,4,7,32,27,5,43
Rapid Vienna,595,3,8,9,7,33,27,6,33
Mattersburg,595,4,7,6,11,35,42,-7,27
LASK Linz,595,5,7,5,12,25,34,-9,26
Vienna,595,6,7,5,12,26,39,-13,26
SC Rheindorf,595,7,6,7,11,23,30,-7,25
FC Salzburg,596,1,14,8,2,45,18,27,50
SK Sturm Gra,596,2,12,4,8,32,29,3,40
Rapid Vienna,596,3,7,11,6,32,29,3,32
LASK Linz,596,4,9,5,10,28,28,0,32
Vienna,596,5,7,6,11,26,38,-12,27
Mattersburg,596,6,6,6,12,28,41,-13,24
SC Rheindorf,596,7,5,8,11,18,26,-8,23
FC Salzburg,597,1,15,6,3,50,21,29,51
SK Sturm Gra,597,2,13,4,7,33,26,7,43
Rapid Vienna,597,3,9,9,6,36,29,7,36
LASK Linz,597,4,8,6,10,26,30,-4,30
Mattersburg,597,5,6,7,11,32,44,-12,25
Vienna,597,6,6,6,12,25,41,-16,24
SC Rheindorf,597,7,5,6,13,21,32,-11,21
FC Salzburg,598,1,15,7,2,43,15,28,52
SK Sturm Gra,598,2,12,4,8,31,29,2,40
Rapid Vienna,598,3,8,11,5,34,26,8,35
Mattersburg,598,4,8,5,11,32,40,-8,29
LASK Linz,598,5,7,6,11,25,31,-6,27
Vienna,598,6,6,6,12,23,40,-17,24
SC Rheindorf,598,7,6,5,13,23,30,-7,23
FC Salzburg,599,1,13,8,3,41,17,24,47
SK Sturm Gra,599,2,12,4,8,34,31,3,40
Rapid Vienna,599,3,10,9,5,38,28,10,39
LASK Linz,599,4,8,6,10,28,31,-3,30
Mattersburg,599,5,7,5,12,32,42,-10,26
SC Rheindorf,599,6,6,6,12,20,28,-8,24
Vienna,599,7,6,6,12,24,40,-16,24
FC Salzburg,600,1,15,6,3,44,17,27,51
SK Sturm Gra,600,2,13,4,7,35,30,5,43
Rapid Vienna,600,3,9,10,5,36,27,9,37
LASK Linz,600,4,8,6,10,28,30,-2,30
Vienna,600,5,7,5,12,25,39,-14,26
SC Rheindorf,600,6,6,6,12,20,29,-9,24
Mattersburg,600,7,5,5,14,27,43,-16,20
FC Salzburg,601,1,15,6,3,47,21,26,51
SK Sturm Gra,601,2,12,4,8,32,30,2,40
Rapid Vienna,601,3,8,10,6,36,29,7,34
LASK Linz,601,4,9,5,10,29,29,0,32
Vienna,601,5,7,5,12,27,42,-15,26
SC Rheindorf,601,6,6,7,11,19,27,-8,25
Mattersburg,601,7,6,5,13,31,43,-12,23
FC Salzburg,602,1,15,7,2,48,15,33,52
SK Sturm Gra,602,2,13,3,8,36,34,2,42
Rapid Vienna,602,3,9,11,4,40,26,14,38
LASK Linz,602,4,9,5,10,27,31,-4,32
Vienna,602,5,7,5,12,24,39,-15,26
Mattersburg,602,6,6,5,13,27,43,-16,23
SC Rheindorf,602,7,4,6,14,18,32,-14,18
FC Salzburg,603,1,13,8,3,43,21,22,47
SK Sturm Gra,603,2,12,5,7,31,29,2,41
Rapid Vienna,603,3,9,9,6,37,26,11,36
LASK Linz,603,4,10,6,8,28,24,4,36
Mattersburg,603,5,6,6,12,33,44,-11,24
Vienna,603,6,6,6,12,25,40,-15,24
SC Rheindorf,603,7,4,8,12,18,31,-13,20
FC Salzburg,604,1,13,7,4,43,21,22,46
SK Sturm Gra,604,2,12,5,7,38,30,8,41
Rapid Vienna,604,3,9,10,5,39,28,11,37
LASK Linz,604,4,9,5,10,30,33,-3,32
Vienna,604,5,7,6,11,26,39,-13,27
Mattersburg,604,6,6,6,12,32,44,-12,24
SC Rheindorf,604,7,6,5,13,20,33,-13,23
FC Salzburg,605,1,16,6,2,49,18,31,54
SK Sturm Gra,605,2,13,3,8,32,28,4,42
Rapid Vienna,605,3,9,9,6,34,25,9,36
LASK Linz,605,4,9,5,10,27,29,-2,32
Vienna,605,5,7,5,12,24,40,-16,26
SC Rheindorf,605,6,6,5,13,20,30,-10,23
Mattersburg,605,7,5,5,14,29,45,-16,20
FC Salzburg,606,1,15,7,2,48,17,31,52
SK Sturm Gra,606,2,12,4,8,30,30,0,40
Rapid Vienna,606,3,7,10,7,32,29,3,31
LASK Linz,606,4,8,5,11,26,28,-2,29
SC Rheindorf,606,5,8,5,11,22,26,-4,29
Mattersburg,606,6,7,5,12,30,43,-13,26
Vienna,606,7,6,6,12,25,40,-15,24
FC Salzburg,607,1,14,6,4,45,19,26,48
SK Sturm Gra,607,2,13,4,7,34,27,7,43
Rapid Vienna,607,3,9,10,5,39,30,9,37
Mattersburg,607,4,7,6,11,29,40,-11,27
Vienna,607,5,7,6,11,25,38,-13,27
LASK Linz,607,6,7,5,12,26,35,-9,26
SC Rheindorf,607,7,5,7,12,17,26,-9,22
FC Salzburg,608,1,14,7,3,47,19,28,49
SK Sturm Gra,608,2,13,4,7,34,32,2,43
Rapid Vienna,608,3,9,10,5,38,28,10,37
LASK Linz,608,4,8,6,10,30,31,-1,30
Vienna,608,5,7,5,12,27,40,-13,26
SC Rheindorf,608,6,6,6,12,20,30,-10,24
Mattersburg,608,7,5,6,13,27,43,-16,21
FC Salzburg,609,1,13,8,3,43,20,23,47
SK Sturm Gra,609,2,14,3,7,34,28,6,45
Rapid Vienna,609,3,9,10,5,36,26,10,37
LASK Linz,609,4,9,5,10,29,29,0,32
Mattersburg,609,5,7,7,10,33,41,-8,28
Vienna,609,6,6,5,13,24,42,-18,23
SC Rheindorf,609,7,4,6,14,16,29,-13,18
FC Salzburg,610,1,15,7,2,46,16,30,52
SK Sturm Gra,610,2,13,4,7,34,27,7,43
Rapid Vienna,610,3,9,9,6,35,31,4,36
LASK Linz,610,4,8,7,9,26,27,-1,31
Mattersburg,610,5,6,7,11,31,43,-12,25
Vienna,610,6,6,7,11,26,40,-14,25
SC Rheindorf,610,7,4,5,15,18,32,-14,17
FC Salzburg,611,1,15,6,3,50,18,32,51
SK Sturm Gra,611,2,13,4,7,35,29,6,43
Rapid Vienna,611,3,8,11,5,34,27,7,35
LASK Linz,611,4,8,6,10,26,31,-5,30
Mattersburg,611,5,7,5,12,32,41,-9,26
Vienna,611,6,6,5,13,25,45,-20,23
SC Rheindorf,611,7,5,7,12,18,29,-11,22
FC Salzburg,612,1,12,10,2,42,19,23,46
SK Sturm Gra,612,2,12,5,7,31,27,4,41
Rapid Vienna,612,3,7,11,6,33,29,4,32
LASK Linz,612,4,8,6,10,27,28,-1,30
Mattersburg,612,5,6,8,10,33,42,-9,26
SC Rheindorf,612,6,6,7,11,20,27,-7,25
Vienna,612,7,6,7,11,26,40,-14,25
FC Salzburg,613,1,13,7,4,45,21,24,46
SK Sturm Gra,613,2,13,4,7,35,29,6,43
LASK Linz,613,3,10,6,8,31,28,3,36
Rapid Vienna,613,4,8,10,6,34,29,5,34
Vienna,613,5,6,6,12,24,41,-17,24
Mattersburg,613,6,5,8,11,33,44,-11,23
SC Rheindorf,613,7,4,9,11,20,30,-10,21
FC Salzburg,614,1,15,7,2,48,17,31,52
SK Sturm Gra,614,2,11,7,6,34,30,4,40
Rapid Vienna,614,3,7,11,6,36,30,6,32
LASK Linz,614,4,8,6,10,31,34,-3,30
Mattersburg,614,5,6,7,11,30,42,-12,25
Vienna,614,6,6,6,12,23,41,-18,24
SC Rheindorf,614,7,5,8,11,20,28,-8,23
FC Salzburg,615,1,13,8,3,43,22,21,47
SK Sturm Gra,615,2,12,4,8,33,31,2,40
Rapid Vienna,615,3,9,10,5,38,26,12,37
LASK Linz,615,4,8,6,10,27,30,-3,30
Vienna,615,5,8,5,11,28,37,-9,29
SC Rheindorf,615,6,6,6,12,20,30,-10,24
Mattersburg,615,7,5,7,12,29,42,-13,22
FC Salzburg,616,1,14,7,3,48,20,28,49
SK Sturm Gra,616,2,13,4,7,37,32,5,43
Rapid Vienna,616,3,7,11,6,35,30,5,32
LASK Linz,616,4,8,6,10,26,28,-2,30
Mattersburg,616,5,7,5,12,31,43,-12,26
Vienna,616,6,7,5,12,27,43,-16,26
SC Rheindorf,616,7,6,6,12,21,29,-8,24
FC Salzburg,617,1,16,6,2,48,16,32,54
LASK Linz,617,2,11,5,8,31,26,5,38
SK Sturm Gra,617,3,11,4,9,31,31,0,37
Rapid Vienna,617,4,8,9,7,33,30,3,33
Vienna,617,5,7,5,12,28,39,-11,26
SC Rheindorf,617,6,6,6,12,19,28,-9,24
Mattersburg,617,7,5,5,14,28,48,-20,20
FC Salzburg,618,1,14,7,3,45,19,26,49
SK Sturm Gra,618,2,11,4,9,29,29,0,37
Rapid Vienna,618,3,8,12,4,35,25,10,36
LASK Linz,618,4,8,8,8,29,29,0,32
Vienna,618,5,7,6,11,27,39,-12,27
Mattersburg,618,6,5,8,11,29,42,-13,23
SC Rheindorf,618,7,5,7,12,19,30,-11,22
FC Salzburg,619,1,13,6,5,40,21,19,45
SK Sturm Gra,619,2,12,4,8,31,27,4,40
Rapid Vienna,619,3,10,9,5,35,24,11,39
Mattersburg,619,4,8,5,11,32,40,-8,29
LASK Linz,619,5,7,7,10,24,27,-3,28
Vienna,619,6,7,5,12,26,39,-13,26
SC Rheindorf,619,7,6,6,12,20,30,-10,24
FC Salzburg,620,1,13,8,3,44,19,25,47
Rapid Vienna,620,2,10,9,5,37,25,12,39
SK Sturm Gra,620,3,11,5,8,30,31,-1,38
LASK Linz,620,4,7,7,10,26,30,-4,28
Vienna,620,5,7,6,11,27,40,-13,27
Mattersburg,620,6,6,7,11,31,41,-10,25
SC Rheindorf,620,7,5,8,11,20,29,-9,23
FC Salzburg,621,1,14,7,3,45,18,27,49
SK Sturm Gra,621,2,13,4,7,34,29,5,43
Rapid Vienna,621,3,7,12,5,33,26,7,33
LASK Linz,621,4,9,5,10,29,32,-3,32
Vienna,621,5,7,5,12,26,40,-14,26
SC Rheindorf,621,6,6,6,12,20,29,-9,24
Mattersburg,621,7,6,5,13,31,44,-13,23
FC Salzburg,622,1,15,7,2,46,19,27,52
SK Sturm Gra,622,2,12,5,7,35,31,4,41
LASK Linz,622,3,8,8,8,30,30,0,32
Rapid Vienna,622,4,7,10,7,34,30,4,31
Mattersburg,622,5,7,6,11,35,41,-6,27
SC Rheindorf,622,6,6,5,13,21,32,-11,23
Vienna,622,7,6,5,13,25,43,-18,23
FC Salzburg,623,1,14,7,3,43,21,22,49
SK Sturm Gra,623,2,12,4,8,32,31,1,40
LASK Linz,623,3,10,6,8,32,28,4,36
Rapid Vienna,623,4,8,9,7,36,29,7,33
SC Rheindorf,623,5,6,6,12,20,26,-6,24
Mattersburg,623,6,6,6,12,30,42,-12,24
Vienna,623,7,6,6,12,26,42,-16,24
FC Salzburg,624,1,14,8,2,48,19,29,50
SK Sturm Gra,624,2,13,3,8,33,31,2,42
Rapid Vienna,624,3,9,10,5,41,28,13,37
LASK Linz,624,4,9,6,9,28,29,-1,33
Mattersburg,624,5,6,7,11,34,44,-10,25
Vienna,624,6,6,7,11,24,38,-14,25
SC Rheindorf,624,7,4,5,15,18,37,-19,17
FC Salzburg,625,1,15,6,3,49,19,30,51
SK Sturm Gra,625,2,13,4,7,35,29,6,43
Rapid Vienna,625,3,10,9,5,38,28,10,39
LASK Linz,625,4,7,7,10,25,28,-3,28
Vienna,625,5,7,5,12,27,41,-14,26
Mattersburg,625,6,6,5,13,29,46,-17,23
SC Rheindorf,625,7,5,6,13,20,32,-12,21
FC Salzburg,626,1,15,6,3,45,19,26,51
SK Sturm Gra,626,2,12,3,9,32,31,1,39
Rapid Vienna,626,3,9,10,5,34,25,9,37
LASK Linz,626,4,8,7,9,26,26,0,31
Mattersburg,626,5,8,5,11,34,40,-6,29
Vienna,626,6,7,5,12,26,41,-15,26
SC Rheindorf,626,7,4,6,14,17,32,-15,18
FC Salzburg,627,1,15,6,3,46,19,27,51
SK Sturm Gra,627,2,12,4,8,33,31,2,40
Rapid Vienna,627,3,7,10,7,33,32,1,31
LASK Linz,627,4,8,7,9,27,28,-1,31
Mattersburg,627,5,8,5,11,37,39,-2,29
Vienna,627,6,7,5,12,25,41,-16,26
SC Rheindorf,627,7,6,5,13,21,32,-11,23
FC Salzburg,628,1,14,7,3,56,20,36,49
SK Sturm Gra,628,2,13,3,8,35,33,2,42
Rapid Vienna,628,3,9,10,5,38,28,10,37
LASK Linz,628,4,7,8,9,26,32,-6,29
Vienna,628,5,7,5,12,24,45,-21,26
Mattersburg,628,6,5,8,11,28,39,-11,23
SC Rheindorf,628,7,5,7,12,17,27,-10,22
FC Salzburg,629,1,15,7,2,46,20,26,52
SK Sturm Gra,629,2,13,3,8,32,29,3,42
Rapid Vienna,629,3,8,10,6,37,28,9,34
LASK Linz,629,4,8,7,9,27,29,-2,31
Mattersburg,629,5,6,7,11,32,41,-9,25
Vienna,629,6,6,5,13,24,41,-17,23
SC Rheindorf,629,7,5,7,12,19,29,-10,22
FC Salzburg,630,1,13,6,5,41,20,21,45
SK Sturm Gra,630,2,13,4,7,34,29,5,43
Rapid Vienna,630,3,9,9,6,35,27,8,36
LASK Linz,630,4,9,6,9,27,26,1,33
Mattersburg,630,5,7,5,12,32,43,-11,26
Vienna,630,6,7,5,12,24,39,-15,26
SC Rheindorf,630,7,5,7,12,23,32,-9,22
FC Salzburg,631,1,15,7,2,51,19,32,52
SK Sturm Gra,631,2,12,5,7,31,29,2,41
Rapid Vienna,631,3,8,10,6,34,31,3,34
LASK Linz,631,4,8,5,11,25,27,-2,29
Mattersburg,631,5,7,5,12,32,44,-12,26
SC Rheindorf,631,6,6,6,12,21,29,-8,24
Vienna,631,7,6,6,12,24,39,-15,24
FC Salzburg,632,1,14,8,2,43,18,25,50
SK Sturm Gra,632,2,11,5,8,32,33,-1,38
Rapid Vienna,632,3,7,11,6,38,34,4,32
LASK Linz,632,4,8,7,9,26,27,-1,31
SC Rheindorf,632,5,6,7,11,24,27,-3,25
Mattersburg,632,6,6,7,11,29,39,-10,25
Vienna,632,7,6,7,11,23,37,-14,25
FC Salzburg,633,1,14,7,3,42,18,24,49
SK Sturm Gra,633,2,12,4,8,32,29,3,40
Rapid Vienna,633,3,10,9,5,41,27,14,39
LASK Linz,633,4,8,5,11,27,32,-5,29
Mattersburg,633,5,7,5,12,31,42,-11,26
SC Rheindorf,633,6,6,6,12,18,27,-9,24
Vienna,633,7,6,6,12,25,41,-16,24
FC Salzburg,634,1,15,6,3,47,19,28,51
SK Sturm Gra,634,2,14,3,7,35,27,8,45
LASK Linz,634,3,9,6,9,30,30,0,33
Rapid Vienna,634,4,7,10,7,33,31,2,31
Vienna,634,5,7,5,12,28,42,-14,26
Mattersburg,634,6,6,6,12,29,43,-14,24
SC Rheindorf,634,7,5,6,13,19,29,-10,21
FC Salzburg,635,1,12,9,3,41,19,22,45
SK Sturm Gra,635,2,12,4,8,32,30,2,40
Rapid Vienna,635,3,9,11,4,34,24,10,38
LASK Linz,635,4,7,7,10,24,30,-6,28
Mattersburg,635,5,7,6,11,31,38,-7,27
Vienna,635,6,7,6,11,26,39,-13,27
SC Rheindorf,635,7,6,5,13,20,28,-8,23
FC Salzburg,636,1,15,7,2,43,16,27,52
SK Sturm Gra,636,2,14,3,7,32,25,7,45
Rapid Vienna,636,3,9,10,5,35,25,10,37
LASK Linz,636,4,7,6,11,25,30,-5,27
Mattersburg,636,5,7,6,11,33,39,-6,27
Vienna,636,6,6,5,13,24,42,-18,23
SC Rheindorf,636,7,5,5,14,18,33,-15,20
FC Salzburg,637,1,14,8,2,45,19,26,50
SK Sturm Gra,637,2,12,5,7,32,28,4,41
Rapid Vienna,637,3,9,10,5,34,25,9,37
LASK Linz,637,4,7,7,10,27,30,-3,28
Mattersburg,637,5,7,6,11,34,43,-9,27
Vienna,637,6,6,6,12,25,40,-15,24
SC Rheindorf,637,7,5,6,13,16,28,-12,21
FC Salzburg,638,1,13,8,3,46,23,23,47
Rapid Vienna,638,2,11,9,4,41,27,14,42
SK Sturm Gra,638,3,11,4,9,34,37,-3,37
LASK Linz,638,4,10,5,9,33,28,5,35
Vienna,638,5,7,6,11,27,40,-13,27
SC Rheindorf,638,6,6,5,13,23,32,-9,23
Mattersburg,638,7,5,5,14,30,47,-17,20
FC Salzburg,639,1,15,7,2,46,16,30,52
SK Sturm Gra,639,2,12,5,7,31,28,3,41
Rapid Vienna,639,3,9,9,6,38,26,12,36
LASK Linz,639,4,8,7,9,26,26,0,31
Vienna,639,5,6,6,12,24,41,-17,24
Mattersburg,639,6,5,7,12,28,42,-14,22
SC Rheindorf,639,7,5,7,12,20,34,-14,22
FC Salzburg,640,1,14,7,3,43,17,26,49
SK Sturm Gra,640,2,12,4,8,32,31,1,40
Rapid Vienna,640,3,8,11,5,33,25,8,35
Mattersburg,640,4,8,6,10,37,40,-3,30
LASK Linz,640,5,7,6,11,27,34,-7,27
SC Rheindorf,640,6,6,6,12,21,29,-8,24
Vienna,640,7,6,6,12,24,41,-17,24
FC Salzburg,641,1,15,6,3,48,19,29,51
SK Sturm Gra,641,2,12,5,7,36,33,3,41
Rapid Vienna,641,3,9,11,4,36,26,10,38
LASK Linz,641,4,8,5,11,27,33,-6,29
Mattersburg,641,5,6,6,12,30,39,-9,24
SC Rheindorf,641,6,5,8,11,22,30,-8,23
Vienna,641,7,6,5,13,23,42,-19,23
FC Salzburg,642,1,14,7,3,44,21,23,49
SK Sturm Gra,642,2,12,6,6,34,27,7,42
Rapid Vienna,642,3,9,10,5,38,26,12,37
LASK Linz,642,4,9,6,9,31,31,0,33
Mattersburg,642,5,7,6,11,32,40,-8,27
Vienna,642,6,6,5,13,24,41,-17,23
SC Rheindorf,642,7,4,6,14,21,38,-17,18
FC Salzburg,643,1,15,7,2,45,15,30,52
SK Sturm Gra,643,2,13,3,8,31,26,5,42
Rapid Vienna,643,3,7,11,6,33,28,5,32
LASK Linz,643,4,8,6,10,28,31,-3,30
Vienna,643,5,7,5,12,27,41,-14,26
SC Rheindorf,643,6,6,7,11,20,27,-7,25
Mattersburg,643,7,6,5,13,30,46,-16,23
FC Salzburg,644,1,15,6,3,45,20,25,51
SK Sturm Gra,644,2,12,5,7,32,29,3,41
Rapid Vienna,644,3,8,10,6,35,28,7,34
LASK Linz,644,4,9,6,9,32,32,0,33
Vienna,644,5,6,6,12,24,39,-15,24
Mattersburg,644,6,5,8,11,32,43,-11,23
SC Rheindorf,644,7,5,7,12,21,30,-9,22
FC Salzburg,645,1,13,7,4,41,18,23,46
SK Sturm Gra,645,2,12,3,9,32,32,0,39
LASK Linz,645,3,10,5,9,30,29,1,35
Rapid Vienna,645,4,8,9,7,36,31,5,33
Mattersburg,645,5,7,6,11,29,38,-9,27
SC Rheindorf,645,6,7,5,12,23,29,-6,26
Vienna,645,7,7,5,12,24,38,-14,26
FC Salzburg,646,1,16,6,2,51,17,34,54
SK Sturm Gra,646,2,14,3,7,33,28,5,45
Rapid Vienna,646,3,7,11,6,33,28,5,32
LASK Linz,646,4,7,8,9,26,29,-3,29
Vienna,646,5,7,5,12,29,43,-14,26
SC Rheindorf,646,6,5,7,12,20,30,-10,22
Mattersburg,646,7,5,6,13,32,49,-17,21
FC Salzburg,647,1,14,7,3,43,19,24,49
SK Sturm Gra,647,2,11,5,8,34,33,1,38
Rapid Vienna,647,3,8,10,6,39,31,8,34
LASK Linz,647,4,9,7,8,31,27,4,34
Vienna,647,5,7,6,11,25,38,-13,27
Mattersburg,647,6,5,8,11,32,43,-11,23
SC Rheindorf,647,7,6,5,13,19,32,-13,23
FC Salzburg,648,1,13,9,2,46,22,24,48
SK Sturm Gra,648,2,12,3,9,32,33,-1,39
Rapid Vienna,648,3,9,11,4,38,26,12,38
LASK Linz,648,4,7,8,9,25,27,-2,29
Mattersburg,648,5,6,7,11,32,43,-11,25
SC Rheindorf,648,6,6,6,12,20,27,-7,24
Vienna,648,7,6,6,12,26,41,-15,24
FC Salzburg,649,1,14,7,3,47,22,25,49
SK Sturm Gra,649,2,13,3,8,36,32,4,42
Rapid Vienna,649,3,8,10,6,37,31,6,34
LASK Linz,649,4,8,6,10,24,28,-4,30
SC Rheindorf,649,5,8,5,11,23,25,-2,29
Vienna,649,6,7,5,12,25,39,-14,26
Mattersburg,649,7,5,6,13,27,42,-15,21
FC Salzburg,650,1,15,6,3,45,19,26,51
SK Sturm Gra,650,2,12,4,8,33,31,2,40
Rapid Vienna,650,3,9,9,6,37,31,6,36
LASK Linz,650,4,9,5,10,31,32,-1,32
Mattersburg,650,5,8,5,11,34,40,-6,29
Vienna,650,6,6,5,13,25,41,-16,23
SC Rheindorf,650,7,5,6,13,19,30,-11,21
FC Salzburg,651,1,16,6,2,46,16,30,54
SK Sturm Gra,651,2,13,4,7,33,28,5,43
Rapid Vienna,651,3,8,9,7,35,29,6,33
Mattersburg,651,4,8,5,11,34,39,-5,29
LASK Linz,651,5,7,6,11,25,31,-6,27
Vienna,651,6,6,5,13,23,41,-18,23
SC Rheindorf,651,7,5,7,12,19,31,-12,22
FC Salzburg,652,1,16,6,2,47,18,29,54
Rapid Vienna,652,2,10,9,5,37,26,11,39
SK Sturm Gra,652,3,12,3,9,34,32,2,39
LASK Linz,652,4,8,5,11,25,33,-8,29
Mattersburg,652,5,7,6,11,37,40,-3,27
Vienna,652,6,6,6,12,25,41,-16,24
SC Rheindorf,652,7,5,5,14,18,33,-15,20
FC Salzburg,653,1,15,6,3,47,18,29,51
SK Sturm Gra,653,2,11,5,8,30,31,-1,38
Rapid Vienna,653,3,9,10,5,36,26,10,37
LASK Linz,653,4,8,8,8,26,26,0,32
Vienna,653,5,7,5,12,26,40,-14,26
SC Rheindorf,653,6,6,6,12,19,27,-8,24
Mattersburg,653,7,5,6,13,30,46,-16,21
FC Salzburg,654,1,15,6,3,45,20,25,51
SK Sturm Gra,654,2,12,4,8,29,28,1,40
Rapid Vienna,654,3,9,9,6,38,27,11,36
LASK Linz,654,4,8,6,10,28,31,-3,30
Vienna,654,5,8,5,11,28,39,-11,29
SC Rheindorf,654,6,5,7,12,18,29,-11,22
Mattersburg,654,7,5,7,12,30,42,-12,22
FC Salzburg,655,1,13,9,2,43,18,25,48
SK Sturm Gra,655,2,12,5,7,31,28,3,41
Rapid Vienna,655,3,9,10,5,36,27,9,37
LASK Linz,655,4,8,6,10,29,35,-6,30
Mattersburg,655,5,7,6,11,33,41,-8,27
Vienna,655,6,6,6,12,25,40,-15,24
SC Rheindorf,655,7,5,6,13,21,29,-8,21
FC Salzburg,656,1,15,6,3,43,18,25,51
SK Sturm Gra,656,2,13,4,7,33,28,5,43
LASK Linz,656,3,9,7,8,27,26,1,34
Rapid Vienna,656,4,8,9,7,34,28,6,33
Vienna,656,5,7,5,12,25,38,-13,26
SC Rheindorf,656,6,6,6,12,23,30,-7,24
Mattersburg,656,7,5,5,14,29,46,-17,20
FC Salzburg,657,1,13,8,3,44,19,25,47
SK Sturm Gra,657,2,13,3,8,33,30,3,42
Rapid Vienna,657,3,7,10,7,33,32,1,31
Mattersburg,657,4,8,6,10,34,40,-6,30
LASK Linz,657,5,8,5,11,28,32,-4,29
SC Rheindorf,657,6,7,5,12,22,27,-5,26
Vienna,657,7,7,5,12,26,40,-14,26
FC Salzburg,658,1,15,6,3,47,19,28,51
SK Sturm Gra,658,2,13,3,8,33,31,2,42
Rapid Vienna,658,3,8,10,6,36,29,7,34
LASK Linz,658,4,8,6,10,27,31,-4,30
SC Rheindorf,658,5,6,7,11,20,27,-7,25
Mattersburg,658,6,6,6,12,30,41,-11,24
Vienna,658,7,6,6,12,25,40,-15,24
FC Salzburg,659,1,13,7,4,41,20,21,46
SK Sturm Gra,659,2,11,7,6,29,25,4,40
Rapid Vienna,659,3,8,10,6,33,28,5,34
Mattersburg,659,4,9,5,10,37,39,-2,32
LASK Linz,659,5,7,6,11,24,32,-8,27
Vienna,659,6,7,5,12,25,39,-14,26
SC Rheindorf,659,7,6,6,12,23,29,-6,24
FC Salzburg,660,1,14,7,3,43,18,25,49
SK Sturm Gra,660,2,12,4,8,37,31,6,40
Rapid Vienna,660,3,10,9,5,39,27,12,39
LASK Linz,660,4,9,5,10,30,33,-3,32
Mattersburg,660,5,7,6,11,35,43,-8,27
Vienna,660,6,7,5,12,28,41,-13,26
SC Rheindorf,660,7,4,6,14,17,36,-19,18
FC Salzburg,661,1,13,8,3,42,19,23,47
SK Sturm Gra,661,2,14,4,6,34,26,8,46
Rapid Vienna,661,3,8,11,5,38,29,9,35
LASK Linz,661,4,9,5,10,29,30,-1,32
Mattersburg,661,5,7,6,11,33,42,-9,27
Vienna,661,6,6,6,12,26,41,-15,24
SC Rheindorf,661,7,4,6,14,17,32,-15,18
FC Salzburg,662,1,14,6,4,46,20,26,48
SK Sturm Gra,662,2,13,3,8,37,34,3,42
Rapid Vienna,662,3,8,9,7,35,30,5,33
LASK Linz,662,4,9,6,9,31,29,2,33
Mattersburg,662,5,7,6,11,31,39,-8,27
SC Rheindorf,662,6,6,6,12,22,32,-10,24
Vienna,662,7,6,6,12,24,42,-18,24
FC Salzburg,663,1,15,6,3,47,18,29,51
SK Sturm Gra,663,2,11,4,9,28,28,0,37
Rapid Vienna,663,3,9,9,6,35,29,6,36
LASK Linz,663,4,8,7,9,28,30,-2,31
Mattersburg,663,5,7,6,11,34,44,-10,27
SC Rheindorf,663,6,6,7,11,22,27,-5,25
Vienna,663,7,6,5,13,24,42,-18,23
FC Salzburg,664,1,14,6,4,46,20,26,48
Rapid Vienna,664,2,10,9,5,37,26,11,39
SK Sturm Gra,664,3,12,3,9,29,32,-3,39
LASK Linz,664,4,9,6,9,28,26,2,33
Vienna,664,5,7,5,12,27,41,-14,26
SC Rheindorf,664,6,6,6,12,21,28,-7,24
Mattersburg,664,7,5,7,12,29,44,-15,22
FC Salzburg,665,1,13,8,3,43,20,23,47
SK Sturm Gra,665,2,13,4,7,31,27,4,43
Rapid Vienna,665,3,9,9,6,37,26,11,36
LASK Linz,665,4,8,7,9,27,27,0,31
Vienna,665,5,7,6,11,27,40,-13,27
SC Rheindorf,665,6,5,7,12,19,31,-12,22
Mattersburg,665,7,5,7,12,31,44,-13,22
FC Salzburg,666,1,15,6,3,49,17,32,51
SK Sturm Gra,666,2,12,4,8,30,29,1,40
Rapid Vienna,666,3,9,11,4,34,24,10,38
LASK Linz,666,4,8,7,9,30,31,-1,31
Mattersburg,666,5,6,7,11,32,46,-14,25
Vienna,666,6,6,6,12,26,42,-16,24
SC Rheindorf,666,7,5,5,14,17,29,-12,20
FC Salzburg,667,1,14,7,3,45,18,27,49
SK Sturm Gra,667,2,11,5,8,31,31,0,38
Rapid Vienna,667,3,9,10,5,36,27,9,37
LASK Linz,667,4,9,6,9,32,28,4,33
Mattersburg,667,5,7,6,11,30,43,-13,27
Vienna,667,6,6,7,11,24,38,-14,25
SC Rheindorf,667,7,4,7,13,18,31,-13,19
FC Salzburg,668,1,14,8,2,43,17,26,50
SK Sturm Gra,668,2,14,4,6,37,27,10,46
LASK Linz,668,3,9,6,9,28,31,-3,33
Rapid Vienna,668,4,7,11,6,35,29,6,32
Mattersburg,668,5,6,7,11,31,41,-10,25
Vienna,668,6,6,5,13,23,40,-17,23
SC Rheindorf,668,7,4,7,13,19,31,-12,19
FC Salzburg,669,1,15,6,3,49,18,31,51
SK Sturm Gra,669,2,13,4,7,33,30,3,43
Rapid Vienna,669,3,8,9,7,35,32,3,33
LASK Linz,669,4,8,8,8,26,25,1,32
Mattersburg,669,5,7,6,11,34,42,-8,27
Vienna,669,6,7,5,12,25,41,-16,26
SC Rheindorf,669,7,4,6,14,18,32,-14,18
FC Salzburg,670,1,14,7,3,44,19,25,49
SK Sturm Gra,670,2,14,3,7,36,27,9,45
Rapid Vienna,670,3,8,11,5,39,28,11,35
LASK Linz,670,4,9,7,8,31,29,2,34
Mattersburg,670,5,6,5,13,30,42,-12,23
Vienna,670,6,6,5,13,24,42,-18,23
SC Rheindorf,670,7,5,6,13,18,35,-17,21
FC Salzburg,671,1,14,7,3,44,20,24,49
Rapid Vienna,671,2,10,9,5,40,29,11,39
SK Sturm Gra,671,3,11,4,9,32,32,0,37
LASK Linz,671,4,9,6,9,32,32,0,33
Vienna,671,5,7,6,11,26,39,-13,27
Mattersburg,671,6,7,5,12,32,42,-10,26
SC Rheindorf,671,7,5,5,14,19,31,-12,20
FC Salzburg,672,1,14,6,4,41,19,22,48
Rapid Vienna,672,2,10,10,4,37,24,13,40
SK Sturm Gra,672,3,12,3,9,30,30,0,39
LASK Linz,672,4,8,6,10,25,30,-5,30
Vienna,672,5,8,5,11,29,38,-9,29
Mattersburg,672,6,7,5,12,32,40,-8,26
SC Rheindorf,672,7,5,5,14,18,31,-13,20
FC Salzburg,673,1,16,6,2,47,17,30,54
SK Sturm Gra,673,2,11,5,8,30,29,1,38
Rapid Vienna,673,3,7,11,6,34,29,5,32
LASK Linz,673,4,8,8,8,29,29,0,32
Vienna,673,5,7,5,12,26,41,-15,26
Mattersburg,673,6,6,6,12,33,42,-9,24
SC Rheindorf,673,7,5,7,12,20,32,-12,22
FC Salzburg,674,1,14,8,2,45,18,27,50
SK Sturm Gra,674,2,11,3,10,29,34,-5,36
Rapid Vienna,674,3,8,11,5,37,29,8,35
LASK Linz,674,4,9,7,8,33,30,3,34
SC Rheindorf,674,5,7,6,11,23,28,-5,27
Vienna,674,6,6,7,11,24,38,-14,25
Mattersburg,674,7,5,6,13,30,44,-14,21
FC Salzburg,675,1,13,8,3,42,19,23,47
SK Sturm Gra,675,2,13,3,8,33,26,7,42
Rapid Vienna,675,3,9,9,6,37,29,8,36
LASK Linz,675,4,8,7,9,28,30,-2,31
Mattersburg,675,5,6,8,10,33,41,-8,26
Vienna,675,6,6,7,11,25,39,-14,25
SC Rheindorf,675,7,5,6,13,17,31,-14,21
FC Salzburg,676,1,14,7,3,44,21,23,49
SK Sturm Gra,676,2,13,3,8,32,28,4,42
Rapid Vienna,676,3,9,9,6,35,26,9,36
LASK Linz,676,4,8,7,9,29,30,-1,31
Vienna,676,5,7,6,11,28,41,-13,27
Mattersburg,676,6,6,6,12,34,44,-10,24
SC Rheindorf,676,7,5,6,13,18,30,-12,21
FC Salzburg,677,1,14,7,3,48,20,28,49
SK Sturm Gra,677,2,12,4,8,33,30,3,40
Rapid Vienna,677,3,9,11,4,38,27,11,38
LASK Linz,677,4,8,7,9,27,28,-1,31
Mattersburg,677,5,6,7,11,29,41,-12,25
Vienna,677,6,6,5,13,24,44,-20,23
SC Rheindorf,677,7,5,7,12,19,28,-9,22
FC Salzburg,678,1,14,6,4,41,17,24,48
SK Sturm Gra,678,2,15,3,6,32,24,8,48
LASK Linz,678,3,9,5,10,29,29,0,32
Rapid Vienna,678,4,7,10,7,33,29,4,31
Mattersburg,678,5,8,5,11,33,42,-9,29
Vienna,678,6,7,5,12,25,39,-14,26
SC Rheindorf,678,7,4,6,14,17,30,-13,18
FC Salzburg,679,1,14,6,4,42,20,22,48
SK Sturm Gra,679,2,15,3,6,34,24,10,48
Rapid Vienna,679,3,8,9,7,35,30,5,33
LASK Linz,679,4,9,5,10,28,27,1,32
Mattersburg,679,5,7,6,11,30,39,-9,27
Vienna,679,6,6,5,13,25,41,-16,23
SC Rheindorf,679,7,5,6,13,18,31,-13,21
FC Salzburg,680,1,14,6,4,46,22,24,48
SK Sturm Gra,680,2,13,4,7,32,27,5,43
Rapid Vienna,680,3,10,10,4,39,25,14,40
LASK Linz,680,4,8,5,11,28,31,-3,29
Vienna,680,5,7,5,12,26,41,-15,26
SC Rheindorf,680,6,6,5,13,21,31,-10,23
Mattersburg,680,7,6,5,13,32,47,-15,23
FC Salzburg,681,1,13,8,3,40,17,23,47
SK Sturm Gra,681,2,12,5,7,33,31,2,41
Rapid Vienna,681,3,8,12,4,33,24,9,36
Vienna,681,4,8,5,11,26,37,-11,29
LASK Linz,681,5,7,6,11,26,32,-6,27
SC Rheindorf,681,6,7,5,12,24,29,-5,26
Mattersburg,681,7,6,5,13,30,42,-12,23
SK Sturm Gra,682,1,15,3,6,37,28,9,48
FC Salzburg,682,2,13,8,3,46,22,24,47
Rapid Vienna,682,3,7,11,6,35,30,5,32
LASK Linz,682,4,8,6,10,27,30,-3,30
Mattersburg,682,5,7,7,10,32,39,-7,28
Vienna,682,6,6,5,13,24,41,-17,23
SC Rheindorf,682,7,5,6,13,19,30,-11,21
FC Salzburg,683,1,15,7,2,46,19,27,52
SK Sturm Gra,683,2,12,5,7,35,30,5,41
Rapid Vienna,683,3,8,10,6,34,29,5,34
LASK Linz,683,4,8,8,8,30,28,2,32
Vienna,683,5,7,5,12,28,41,-13,26
Mattersburg,683,6,6,6,12,32,44,-12,24
SC Rheindorf,683,7,5,5,14,20,34,-14,20
FC Salzburg,684,1,13,8,3,45,21,24,47
SK Sturm Gra,684,2,12,4,8,33,30,3,40
Rapid Vienna,684,3,8,10,6,37,31,6,34
LASK Linz,684,4,8,8,8,28,27,1,32
Vienna,684,5,7,6,11,27,39,-12,27
SC Rheindorf,684,6,6,7,11,20,28,-8,25
Mattersburg,684,7,5,7,12,30,44,-14,22
FC Salzburg,685,1,15,7,2,49,17,32,52
SK Sturm Gra,685,2,13,4,7,32,29,3,43
Rapid Vienna,685,3,8,11,5,34,26,8,35
LASK Linz,685,4,8,5,11,25,30,-5,29
Mattersburg,685,5,6,6,12,29,43,-14,24
Vienna,685,6,6,6,12,25,41,-16,24
SC Rheindorf,685,7,6,5,13,22,30,-8,23
FC Salzburg,686,1,14,6,4,44,22,22,48
SK Sturm Gra,686,2,12,4,8,34,30,4,40
Rapid Vienna,686,3,8,10,6,36,30,6,34
LASK Linz,686,4,9,6,9,33,33,0,33
Mattersburg,686,5,7,5,12,31,42,-11,26
Vienna,686,6,7,5,12,27,39,-12,26
SC Rheindorf,686,7,6,6,12,19,28,-9,24
FC Salzburg,687,1,13,8,3,45,22,23,47
SK Sturm Gra,687,2,13,3,8,35,30,5,42
Rapid Vienna,687,3,8,10,6,34,28,6,34
LASK Linz,687,4,9,5,10,29,28,1,32
Mattersburg,687,5,7,6,11,33,42,-9,27
Vienna,687,6,7,5,12,25,40,-15,26
SC Rheindorf,687,7,6,5,13,17,28,-11,23
FC Salzburg,688,1,15,7,2,47,16,31,52
SK Sturm Gra,688,2,13,4,7,35,29,6,43
Rapid Vienna,688,3,8,9,7,34,30,4,33
LASK Linz,688,4,8,7,9,30,31,-1,31
Vienna,688,5,7,5,12,26,41,-15,26
Mattersburg,688,6,6,6,12,31,44,-13,24
SC Rheindorf,688,7,5,6,13,20,32,-12,21
FC Salzburg,689,1,14,8,2,44,19,25,50
SK Sturm Gra,689,2,11,6,7,31,28,3,39
Rapid Vienna,689,3,9,11,4,36,25,11,38
LASK Linz,689,4,8,7,9,26,28,-2,31
Vienna,689,5,7,5,12,26,39,-13,26
Mattersburg,689,6,6,7,11,33,43,-10,25
SC Rheindorf,689,7,4,6,14,18,32,-14,18
FC Salzburg,690,1,15,7,2,49,19,30,52
SK Sturm Gra,690,2,12,4,8,34,31,3,40
Rapid Vienna,690,3,8,10,6,36,33,3,34
LASK Linz,690,4,9,6,9,27,26,1,33
Mattersburg,690,5,6,7,11,29,39,-10,25
Vienna,690,6,6,7,11,25,39,-14,25
SC Rheindorf,690,7,5,5,14,20,33,-13,20
FC Salzburg,691,1,14,8,2,50,21,29,50
Rapid Vienna,691,2,10,10,4,41,27,14,40
SK Sturm Gra,691,3,12,3,9,33,31,2,39
LASK Linz,691,4,7,6,11,25,32,-7,27
Mattersburg,691,5,6,7,11,34,44,-10,25
Vienna,691,6,6,7,11,26,40,-14,25
SC Rheindorf,691,7,6,5,13,18,32,-14,23
FC Salzburg,692,1,14,8,2,46,21,25,50
SK Sturm Gra,692,2,13,4,7,32,27,5,43
Rapid Vienna,692,3,8,9,7,35,29,6,33
LASK Linz,692,4,7,7,10,27,30,-3,28
Mattersburg,692,5,7,7,10,36,44,-8,28
Vienna,692,6,6,6,12,24,39,-15,24
SC Rheindorf,692,7,5,7,12,22,32,-10,22
FC Salzburg,693,1,13,7,4,44,21,23,46
SK Sturm Gra,693,2,13,5,6,38,27,11,44
Rapid Vienna,693,3,8,11,5,34,31,3,35
Mattersburg,693,4,8,6,10,33,38,-5,30
LASK Linz,693,5,7,6,11,24,29,-5,27
SC Rheindorf,693,6,5,8,11,17,26,-9,23
Vienna,693,7,6,5,13,23,41,-18,23
FC Salzburg,694,1,13,9,2,43,17,26,48
SK Sturm Gra,694,2,13,4,7,33,28,5,43
Rapid Vienna,694,3,9,11,4,36,26,10,38
Mattersburg,694,4,8,6,10,35,36,-1,30
LASK Linz,694,5,7,6,11,25,30,-5,27
Vienna,694,6,6,5,13,23,45,-22,23
SC Rheindorf,694,7,5,5,14,17,30,-13,20
FC Salzburg,695,1,13,7,4,43,21,22,46
SK Sturm Gra,695,2,14,4,6,35,27,8,46
Rapid Vienna,695,3,10,10,4,38,24,14,40
LASK Linz,695,4,7,6,11,25,33,-8,27
Vienna,695,5,7,6,11,29,41,-12,27
Mattersburg,695,6,6,6,12,30,42,-12,24
SC Rheindorf,695,7,5,5,14,20,32,-12,20
FC Salzburg,696,1,15,7,2,47,18,29,52
SK Sturm Gra,696,2,13,3,8,40,33,7,42
LASK Linz,696,3,9,6,9,26,29,-3,33
Rapid Vienna,696,4,7,10,7,34,31,3,31
Vienna,696,5,7,6,11,29,39,-10,27
SC Rheindorf,696,6,7,5,12,22,28,-6,26
Mattersburg,696,7,5,5,14,27,47,-20,20
FC Salzburg,697,1,14,6,4,47,21,26,48
Rapid Vienna,697,2,10,10,4,39,28,11,40
SK Sturm Gra,697,3,11,3,10,30,32,-2,36
LASK Linz,697,4,9,6,9,29,28,1,33
Vienna,697,5,7,6,11,26,39,-13,27
Mattersburg,697,6,6,6,12,32,46,-14,24
SC Rheindorf,697,7,5,7,12,18,27,-9,22
FC Salzburg,698,1,14,7,3,42,19,23,49
SK Sturm Gra,698,2,13,4,7,35,29,6,43
Rapid Vienna,698,3,9,11,4,37,25,12,38
LASK Linz,698,4,8,6,10,27,30,-3,30
Vienna,698,5,7,6,11,28,40,-12,27
Mattersburg,698,6,6,5,13,31,44,-13,23
SC Rheindorf,698,7,5,5,14,18,31,-13,20
FC Salzburg,699,1,14,8,2,46,19,27,50
SK Sturm Gra,699,2,12,4,8,31,28,3,40
Rapid Vienna,699,3,9,11,4,40,29,11,38
LASK Linz,699,4,7,7,10,27,30,-3,28
Mattersburg,699,5,6,8,10,31,40,-9,26
Vienna,699,6,6,5,13,26,44,-18,23
SC Rheindorf,699,7,5,7,12,19,30,-11,22
FC Salzburg,700,1,14,8,2,44,17,27,50
SK Sturm Gra,700,2,12,5,7,31,28,3,41
Rapid Vienna,700,3,8,11,5,38,29,9,35
LASK Linz,700,4,9,6,9,34,31,3,33
Vienna,700,5,7,5,12,27,40,-13,26
SC Rheindorf,700,6,5,7,12,20,30,-10,22
Mattersburg,700,7,5,6,13,32,51,-19,21
FC Salzburg,701,1,16,6,2,51,16,35,54
SK Sturm Gra,701,2,13,3,8,33,34,-1,42
Rapid Vienna,701,3,8,9,7,34,29,5,33
LASK Linz,701,4,8,7,9,26,26,0,31
Vienna,701,5,6,6,12,26,42,-16,24
Mattersburg,701,6,5,8,11,28,41,-13,23
SC Rheindorf,701,7,5,7,12,17,27,-10,22
FC Salzburg,702,1,12,8,4,41,20,21,44
SK Sturm Gra,702,2,12,5,7,31,27,4,41
Rapid Vienna,702,3,10,9,5,36,25,11,39
LASK Linz,702,4,7,7,10,25,30,-5,28
Vienna,702,5,7,6,11,27,40,-13,27
Mattersburg,702,6,6,8,10,33,42,-9,26
SC Rheindorf,702,7,6,5,13,21,30,-9,23
FC Salzburg,703,1,14,6,4,42,18,24,48
SK Sturm Gra,703,2,13,4,7,33,28,5,43
Rapid Vienna,703,3,8,10,6,37,31,6,34
LASK Linz,703,4,8,5,11,24,29,-5,29
Vienna,703,5,8,5,11,27,37,-10,29
SC Rheindorf,703,6,6,6,12,20,29,-9,24
Mattersburg,703,7,6,6,12,31,42,-11,24
FC Salzburg,704,1,15,6,3,51,17,34,51
SK Sturm Gra,704,2,12,3,9,29,33,-4,39
Rapid Vienna,704,3,8,9,7,34,29,5,33
LASK Linz,704,4,9,6,9,33,30,3,33
Mattersburg,704,5,8,5,11,36,46,-10,29
Vienna,704,6,7,5,12,25,40,-15,26
SC Rheindorf,704,7,5,6,13,17,30,-13,21
FC Salzburg,705,1,14,7,3,42,17,25,49
SK Sturm Gra,705,2,14,3,7,35,27,8,45
Rapid Vienna,705,3,8,11,5,34,27,7,35
LASK Linz,705,4,8,7,9,28,29,-1,31
Mattersburg,705,5,7,5,12,31,43,-12,26
Vienna,705,6,7,5,12,26,39,-13,26
SC Rheindorf,705,7,4,6,14,17,31,-14,18
FC Salzburg,706,1,15,6,3,43,17,26,51
SK Sturm Gra,706,2,14,3,7,34,28,6,45
Rapid Vienna,706,3,9,10,5,35,25,10,37
LASK Linz,706,4,8,6,10,27,29,-2,30
Mattersburg,706,5,7,5,12,30,41,-11,26
Vienna,706,6,6,5,13,26,42,-16,23
SC Rheindorf,706,7,5,5,14,17,30,-13,20
FC Salzburg,707,1,13,7,4,43,21,22,46
SK Sturm Gra,707,2,14,3,7,38,26,12,45
Rapid Vienna,707,3,8,11,5,35,28,7,35
LASK Linz,707,4,7,7,10,26,33,-7,28
Vienna,707,5,7,5,12,27,40,-13,26
SC Rheindorf,707,6,6,7,11,22,29,-7,25
Mattersburg,707,7,6,6,12,31,45,-14,24
FC Salzburg,708,1,13,7,4,44,25,19,46
SK Sturm Gra,708,2,13,4,7,32,26,6,43
Rapid Vienna,708,3,10,9,5,38,25,13,39
LASK Linz,708,4,8,6,10,25,27,-2,30
Vienna,708,5,8,5,11,27,39,-12,29
SC Rheindorf,708,6,6,5,13,19,29,-10,23
Mattersburg,708,7,5,6,13,28,42,-14,21
FC Salzburg,709,1,15,7,2,51,17,34,52
SK Sturm Gra,709,2,13,3,8,35,32,3,42
LASK Linz,709,3,9,7,8,27,26,1,34
Rapid Vienna,709,4,7,11,6,33,30,3,32
Vienna,709,5,7,6,11,27,38,-11,27
Mattersburg,709,6,6,6,12,29,44,-15,24
SC Rheindorf,709,7,4,6,14,20,35,-15,18
FC Salzburg,710,1,15,7,2,47,16,31,52
SK Sturm Gra,710,2,12,4,8,32,28,4,40
Rapid Vienna,710,3,8,12,4,36,27,9,36
LASK Linz,710,4,8,8,8,30,28,2,32
Mattersburg,710,5,6,7,11,29,42,-13,25
Vienna,710,6,6,6,12,23,39,-16,24
SC Rheindorf,710,7,4,6,14,17,34,-17,18
FC Salzburg,711,1,14,8,2,46,19,27,50
SK Sturm Gra,711,2,11,6,7,32,29,3,39
Rapid Vienna,711,3,8,11,5,35,28,7,35
LASK Linz,711,4,9,7,8,29,28,1,34
Vienna,711,5,7,5,12,26,40,-14,26
Mattersburg,711,6,5,7,12,28,41,-13,22
SC Rheindorf,711,7,5,6,13,20,31,-11,21
FC Salzburg,712,1,16,6,2,49,17,32,54
SK Sturm Gra,712,2,13,3,8,31,30,1,42
Rapid Vienna,712,3,9,9,6,36,27,9,36
LASK Linz,712,4,9,6,9,26,27,-1,33
Mattersburg,712,5,6,7,11,28,39,-11,25
Vienna,712,6,6,6,12,24,39,-15,24
SC Rheindorf,712,7,4,5,15,16,31,-15,17
FC Salzburg,713,1,14,7,3,44,18,26,49
Rapid Vienna,713,2,10,9,5,38,25,13,39
SK Sturm Gra,713,3,12,3,9,30,28,2,39
LASK Linz,713,4,8,6,10,29,34,-5,30
Mattersburg,713,5,7,5,12,33,43,-10,26
SC Rheindorf,713,6,6,6,12,22,31,-9,24
Vienna,713,7,6,6,12,24,41,-17,24
FC Salzburg,714,1,16,6,2,48,17,31,54
SK Sturm Gra,714,2,12,4,8,30,30,0,40
Rapid Vienna,714,3,8,10,6,36,28,8,34
LASK Linz,714,4,9,6,9,28,29,-1,33
Mattersburg,714,5,6,6,12,29,43,-14,24
Vienna,714,6,6,6,12,27,42,-15,24
SC Rheindorf,714,7,5,6,13,20,29,-9,21
FC Salzburg,715,1,16,6,2,49,17,32,54
SK Sturm Gra,715,2,14,3,7,34,27,7,45
Rapid Vienna,715,3,8,10,6,34,28,6,34
LASK Linz,715,4,8,6,10,28,33,-5,30
Mattersburg,715,5,8,5,11,37,43,-6,29
Vienna,715,6,6,5,13,23,41,-18,23
SC Rheindorf,715,7,4,5,15,17,33,-16,17
FC Salzburg,716,1,15,6,3,46,21,25,51
SK Sturm Gra,716,2,12,4,8,32,31,1,40
Rapid Vienna,716,3,9,9,6,36,27,9,36
LASK Linz,716,4,10,6,8,31,26,5,36
Vienna,716,5,7,5,12,27,41,-14,26
SC Rheindorf,716,6,6,5,13,20,30,-10,23
Mattersburg,716,7,5,5,14,30,46,-16,20
FC Salzburg,717,1,16,6,2,48,15,33,54
SK Sturm Gra,717,2,12,4,8,34,30,4,40
Rapid Vienna,717,3,8,10,6,35,29,6,34
LASK Linz,717,4,8,5,11,30,35,-5,29
Mattersburg,717,5,8,5,11,35,45,-10,29
Vienna,717,6,6,5,13,25,42,-17,23
SC Rheindorf,717,7,5,7,12,17,28,-11,22
FC Salzburg,718,1,15,7,2,43,17,26,52
SK Sturm Gra,718,2,13,3,8,33,28,5,42
Rapid Vienna,718,3,9,11,4,35,24,11,38
LASK Linz,718,4,7,7,10,26,30,-4,28
Mattersburg,718,5,6,6,12,31,41,-10,24
Vienna,718,6,6,5,13,23,40,-17,23
SC Rheindorf,718,7,5,7,12,21,32,-11,22
FC Salzburg,719,1,15,6,3,47,17,30,51
SK Sturm Gra,719,2,13,4,7,34,29,5,43
Rapid Vienna,719,3,9,10,5,38,26,12,37
LASK Linz,719,4,7,7,10,26,32,-6,28
Mattersburg,719,5,6,7,11,30,43,-13,25
Vienna,719,6,6,6,12,24,40,-16,24
SC Rheindorf,719,7,5,6,13,20,32,-12,21
FC Salzburg,720,1,15,7,2,50,19,31,52
SK Sturm Gra,720,2,12,3,9,32,32,0,39
Rapid Vienna,720,3,8,10,6,36,28,8,34
SC Rheindorf,720,4,8,5,11,24,29,-5,29
LASK Linz,720,5,7,7,10,25,28,-3,28
Vienna,720,6,6,6,12,27,42,-15,24
Mattersburg,720,7,6,6,12,30,46,-16,24
FC Salzburg,721,1,14,7,3,43,19,24,49
Rapid Vienna,721,2,10,10,4,40,28,12,40
SK Sturm Gra,721,3,12,3,9,33,31,2,39
LASK Linz,721,4,7,8,9,25,28,-3,29
Vienna,721,5,7,6,11,27,38,-11,27
Mattersburg,721,6,6,6,12,30,42,-12,24
SC Rheindorf,721,7,5,6,13,19,31,-12,21
FC Salzburg,722,1,15,6,3,47,18,29,51
SK Sturm Gra,722,2,13,4,7,35,30,5,43
Rapid Vienna,722,3,7,11,6,36,31,5,32
LASK Linz,722,4,8,5,11,28,30,-2,29
Vienna,722,5,7,5,12,30,43,-13,26
SC Rheindorf,722,6,6,7,11,22,30,-8,25
Mattersburg,722,7,6,6,12,33,49,-16,24
FC Salzburg,723,1,12,9,3,42,20,22,45
SK Sturm Gra,723,2,14,3,7,32,26,6,45
LASK Linz,723,3,10,5,9,30,28,2,35
Rapid Vienna,723,4,7,11,6,33,28,5,32
Vienna,723,5,7,6,11,26,38,-12,27
Mattersburg,723,6,6,7,11,30,41,-11,25
SC Rheindorf,723,7,4,7,13,15,27,-12,19
FC Salzburg,724,1,14,7,3,44,19,25,49
SK Sturm Gra,724,2,13,4,7,36,29,7,43
Rapid Vienna,724,3,9,10,5,38,31,7,37
LASK Linz,724,4,8,7,9,28,28,0,31
Mattersburg,724,5,6,8,10,30,39,-9,26
Vienna,724,6,6,6,12,24,40,-16,24
SC Rheindorf,724,7,4,6,14,19,33,-14,18
FC Salzburg,725,1,13,9,2,44,19,25,48
SK Sturm Gra,725,2,12,6,6,34,29,5,42
Rapid Vienna,725,3,7,12,5,36,29,7,33
LASK Linz,725,4,8,7,9,27,30,-3,31
SC Rheindorf,725,5,6,6,12,23,28,-5,24
Mattersburg,725,6,6,6,12,29,43,-14,24
Vienna,725,7,6,6,12,26,41,-15,24
FC Salzburg,726,1,14,7,3,46,19,27,49
SK Sturm Gra,726,2,12,5,7,31,27,4,41
Rapid Vienna,726,3,9,10,5,37,28,9,37
LASK Linz,726,4,7,6,11,24,30,-6,27
Mattersburg,726,5,7,6,11,30,41,-11,27
Vienna,726,6,6,6,12,24,40,-16,24
SC Rheindorf,726,7,5,8,11,22,29,-7,23
FC Salzburg,727,1,15,6,3,48,17,31,51
SK Sturm Gra,727,2,14,4,6,32,25,7,46
Rapid Vienna,727,3,8,9,7,35,31,4,33
LASK Linz,727,4,8,6,10,26,30,-4,30
Vienna,727,5,7,5,12,26,42,-16,26
Mattersburg,727,6,6,6,12,31,42,-11,24
SC Rheindorf,727,7,4,8,12,19,30,-11,20
FC Salzburg,728,1,15,6,3,51,18,33,51
Rapid Vienna,728,2,10,10,4,41,26,15,40
SK Sturm Gra,728,3,12,3,9,31,36,-5,39
LASK Linz,728,4,8,6,10,25,29,-4,30
Mattersburg,728,5,6,6,12,31,43,-12,24
SC Rheindorf,728,6,5,8,11,21,29,-8,23
Vienna,728,7,6,5,13,23,42,-19,23
FC Salzburg,729,1,15,6,3,46,18,28,51
SK Sturm Gra,729,2,12,5,7,32,29,3,41
Rapid Vienna,729,3,8,11,5,37,29,8,35
LASK Linz,729,4,8,7,9,28,31,-3,31
Vienna,729,5,7,5,12,24,38,-14,26
Mattersburg,729,6,6,6,12,28,39,-11,24
SC Rheindorf,729,7,4,8,12,18,29,-11,20
FC Salzburg,730,1,14,7,3,42,17,25,49
SK Sturm Gra,730,2,13,4,7,34,29,5,43
Rapid Vienna,730,3,9,10,5,37,28,9,37
LASK Linz,730,4,8,7,9,28,29,-1,31
Mattersburg,730,5,6,8,10,32,41,-9,26
Vienna,730,6,6,6,12,26,42,-16,24
SC Rheindorf,730,7,4,6,14,18,31,-13,18
FC Salzburg,731,1,13,9,2,44,16,28,48
SK Sturm Gra,731,2,13,5,6,36,26,10,44
Rapid Vienna,731,3,7,11,6,34,30,4,32
LASK Linz,731,4,7,8,9,26,30,-4,29
Vienna,731,5,7,6,11,28,38,-10,27
Mattersburg,731,6,6,6,12,28,46,-18,24
SC Rheindorf,731,7,5,7,12,21,31,-10,22
SK Sturm Gra,732,1,15,3,6,36,27,9,48
FC Salzburg,732,2,13,6,5,41,20,21,45
Rapid Vienna,732,3,9,9,6,37,29,8,36
LASK Linz,732,4,8,6,10,28,30,-2,30
Vienna,732,5,7,6,11,27,39,-12,27
Mattersburg,732,6,6,6,12,30,42,-12,24
SC Rheindorf,732,7,5,6,13,19,31,-12,21
FC Salzburg,733,1,14,7,3,42,18,24,49
SK Sturm Gra,733,2,14,3,7,34,26,8,45
Rapid Vienna,733,3,9,9,6,37,29,8,36
LASK Linz,733,4,8,5,11,29,33,-4,29
Vienna,733,5,7,5,12,28,39,-11,26
Mattersburg,733,6,6,7,11,30,43,-13,25
SC Rheindorf,733,7,5,6,13,17,29,-12,21
FC Salzburg,734,1,15,7,2,51,20,31,52
SK Sturm Gra,734,2,13,4,7,35,32,3,43
Rapid Vienna,734,3,7,11,6,34,28,6,32
LASK Linz,734,4,8,7,9,30,31,-1,31
Mattersburg,734,5,7,6,11,34,44,-10,27
Vienna,734,6,6,5,13,25,42,-17,23
SC Rheindorf,734,7,5,6,13,16,28,-12,21
FC Salzburg,735,1,14,7,3,45,21,24,49
Rapid Vienna,735,2,10,9,5,41,28,13,39
SK Sturm Gra,735,3,11,6,7,31,30,1,39
LASK Linz,735,4,8,6,10,27,31,-4,30
Vienna,735,5,8,5,11,33,43,-10,29
SC Rheindorf,735,6,6,6,12,22,30,-8,24
Mattersburg,735,7,5,5,14,31,47,-16,20
FC Salzburg,736,1,13,8,3,45,20,25,47
SK Sturm Gra,736,2,13,3,8,32,28,4,42
Rapid Vienna,736,3,7,10,7,34,31,3,31
LASK Linz,736,4,8,6,10,28,30,-2,30
SC Rheindorf,736,5,7,6,11,22,28,-6,27
Mattersburg,736,6,7,6,11,33,42,-9,27
Vienna,736,7,7,5,12,24,39,-15,26
FC Salzburg,737,1,15,6,3,43,19,24,51
Rapid Vienna,737,2,10,10,4,40,24,16,40
SK Sturm Gra,737,3,11,4,9,30,30,0,37
LASK Linz,737,4,8,7,9,28,32,-4,31
Mattersburg,737,5,6,7,11,30,40,-10,25
Vienna,737,6,6,6,12,26,41,-15,24
SC Rheindorf,737,7,4,8,12,16,27,-11,20
FC Salzburg,738,1,14,7,3,46,19,27,49
SK Sturm Gra,738,2,14,3,7,36,28,8,45
Rapid Vienna,738,3,8,10,6,37,27,10,34
LASK Linz,738,4,8,6,10,28,32,-4,30
Vienna,738,5,7,6,11,27,40,-13,27
Mattersburg,738,6,5,8,11,31,45,-14,23
SC Rheindorf,738,7,5,6,13,16,30,-14,21
FC Salzburg,739,1,15,7,2,44,17,27,52
SK Sturm Gra,739,2,12,3,9,32,32,0,39
Rapid Vienna,739,3,9,9,6,39,28,11,36
LASK Linz,739,4,9,5,10,27,29,-2,32
Vienna,739,5,7,6,11,26,38,-12,27
Mattersburg,739,6,7,5,12,30,39,-9,26
SC Rheindorf,739,7,5,5,14,16,31,-15,20
FC Salzburg,740,1,15,7,2,46,15,31,52
SK Sturm Gra,740,2,13,3,8,32,29,3,42
Rapid Vienna,740,3,7,12,5,32,26,6,33
LASK Linz,740,4,8,7,9,26,26,0,31
SC Rheindorf,740,5,6,7,11,19,26,-7,25
Mattersburg,740,6,6,5,13,28,42,-14,23
Vienna,740,7,6,5,13,24,43,-19,23
FC Salzburg,741,1,13,7,4,44,20,24,46
SK Sturm Gra,741,2,12,4,8,34,32,2,40
LASK Linz,741,3,10,5,9,29,27,2,35
Rapid Vienna,741,4,8,10,6,35,29,6,34
SC Rheindorf,741,5,7,6,11,22,27,-5,27
Vienna,741,6,7,6,11,24,37,-13,27
Mattersburg,741,7,5,6,13,27,43,-16,21
FC Salzburg,742,1,15,6,3,46,16,30,51
SK Sturm Gra,742,2,13,4,7,31,27,4,43
LASK Linz,742,3,9,6,9,32,28,4,33
Rapid Vienna,742,4,7,10,7,36,32,4,31
Vienna,742,5,8,5,11,26,37,-11,29
SC Rheindorf,742,6,5,7,12,19,29,-10,22
Mattersburg,742,7,5,6,13,27,48,-21,21
FC Salzburg,743,1,15,6,3,44,17,27,51
Rapid Vienna,743,2,11,9,4,43,24,19,42
SK Sturm Gra,743,3,11,4,9,30,31,-1,37
LASK Linz,743,4,10,5,9,29,27,2,35
Vienna,743,5,6,6,12,25,42,-17,24
Mattersburg,743,6,5,6,13,30,45,-15,21
SC Rheindorf,743,7,5,6,13,19,34,-15,21
FC Salzburg,744,1,12,7,5,42,26,16,43
SK Sturm Gra,744,2,13,4,7,38,31,7,43
Rapid Vienna,744,3,9,10,5,37,27,10,37
LASK Linz,744,4,10,6,8,32,29,3,36
Vienna,744,5,7,6,11,27,39,-12,27
Mattersburg,744,6,6,6,12,30,42,-12,24
SC Rheindorf,744,7,5,5,14,18,30,-12,20
FC Salzburg,745,1,15,6,3,46,18,28,51
SK Sturm Gra,745,2,14,3,7,37,29,8,45
Rapid Vienna,745,3,7,10,7,36,33,3,31
LASK Linz,745,4,7,8,9,32,35,-3,29
Mattersburg,745,5,7,7,10,34,40,-6,28
Vienna,745,6,6,6,12,24,42,-18,24
SC Rheindorf,745,7,5,6,13,19,31,-12,21
FC Salzburg,746,1,16,6,2,49,18,31,54
SK Sturm Gra,746,2,12,4,8,36,33,3,40
Rapid Vienna,746,3,9,9,6,36,30,6,36
LASK Linz,746,4,9,5,10,32,34,-2,32
Vienna,746,5,7,5,12,27,39,-12,26
Mattersburg,746,6,6,5,13,30,45,-15,23
SC Rheindorf,746,7,5,6,13,18,29,-11,21
FC Salzburg,747,1,14,7,3,43,17,26,49
SK Sturm Gra,747,2,14,4,6,32,25,7,46
Rapid Vienna,747,3,9,10,5,38,27,11,37
LASK Linz,747,4,9,5,10,28,29,-1,32
Vienna,747,5,7,5,12,24,40,-16,26
Mattersburg,747,6,6,6,12,29,40,-11,24
SC Rheindorf,747,7,4,5,15,19,35,-16,17
FC Salzburg,748,1,14,7,3,45,21,24,49
Rapid Vienna,748,2,10,10,4,42,26,16,40
SK Sturm Gra,748,3,12,4,8,33,35,-2,40
LASK Linz,748,4,8,8,8,30,29,1,32
Mattersburg,748,5,6,6,12,30,42,-12,24
Vienna,748,6,6,6,12,24,39,-15,24
SC Rheindorf,748,7,4,7,13,19,31,-12,19
FC Salzburg,749,1,15,6,3,45,18,27,51
Rapid Vienna,749,2,9,11,4,35,24,11,38
SK Sturm Gra,749,3,11,4,9,28,29,-1,37
LASK Linz,749,4,9,7,8,26,25,1,34
Mattersburg,749,5,6,7,11,31,42,-11,25
Vienna,749,6,6,5,13,25,41,-16,23
SC Rheindorf,749,7,4,8,12,17,28,-11,20
FC Salzburg,750,1,14,7,3,47,19,28,49
SK Sturm Gra,750,2,12,4,8,37,34,3,40
Rapid Vienna,750,3,9,11,4,35,25,10,38
LASK Linz,750,4,8,6,10,28,33,-5,30
Mattersburg,750,5,7,6,11,34,43,-9,27
Vienna,750,6,6,6,12,25,41,-16,24
SC Rheindorf,750,7,5,6,13,19,30,-11,21
FC Salzburg,751,1,13,8,3,43,20,23,47
SK Sturm Gra,751,2,13,5,6,34,26,8,44
Rapid Vienna,751,3,7,10,7,32,27,5,31
LASK Linz,751,4,8,7,9,27,28,-1,31
Vienna,751,5,8,5,11,28,39,-11,29
Mattersburg,751,6,7,5,12,35,42,-7,26
SC Rheindorf,751,7,5,6,13,18,35,-17,21
FC Salzburg,752,1,15,6,3,44,18,26,51
SK Sturm Gra,752,2,12,3,9,33,30,3,39
Rapid Vienna,752,3,8,10,6,39,33,6,34
LASK Linz,752,4,8,7,9,32,34,-2,31
Vienna,752,5,8,5,11,26,37,-11,29
Mattersburg,752,6,6,6,12,32,42,-10,24
SC Rheindorf,752,7,5,7,12,23,35,-12,22
FC Salzburg,753,1,16,6,2,51,22,29,54
SK Sturm Gra,753,2,12,4,8,34,32,2,40
LASK Linz,753,3,9,6,9,29,28,1,33
Rapid Vienna,753,4,7,10,7,35,32,3,31
Vienna,753,5,7,5,12,29,42,-13,26
SC Rheindorf,753,6,5,8,11,22,31,-9,23
Mattersburg,753,7,6,5,13,30,43,-13,23
FC Salzburg,754,1,14,7,3,46,18,28,49
SK Sturm Gra,754,2,11,5,8,30,29,1,38
Rapid Vienna,754,3,8,12,4,36,27,9,36
LASK Linz,754,4,8,6,10,30,33,-3,30
Mattersburg,754,5,7,6,11,37,44,-7,27
Vienna,754,6,7,5,12,29,46,-17,26
SC Rheindorf,754,7,5,7,12,18,29,-11,22
FC Salzburg,755,1,14,7,3,46,21,25,49
SK Sturm Gra,755,2,11,5,8,32,30,2,38
Rapid Vienna,755,3,9,9,6,35,27,8,36
LASK Linz,755,4,9,5,10,29,31,-2,32
Mattersburg,755,5,7,6,11,32,43,-11,27
Vienna,755,6,7,5,12,27,40,-13,26
SC Rheindorf,755,7,5,7,12,20,29,-9,22
FC Salzburg,756,1,15,6,3,46,21,25,51
SK Sturm Gra,756,2,13,4,7,37,32,5,43
Rapid Vienna,756,3,9,9,6,37,29,8,36
LASK Linz,756,4,8,5,11,32,34,-2,29
Vienna,756,5,7,6,11,28,40,-12,27
Mattersburg,756,6,6,6,12,33,43,-10,24
SC Rheindorf,756,7,5,6,13,21,35,-14,21
FC Salzburg,757,1,13,7,4,42,22,20,46
SK Sturm Gra,757,2,14,4,6,35,28,7,46
Rapid Vienna,757,3,8,10,6,37,31,6,34
LASK Linz,757,4,8,6,10,31,34,-3,30
Mattersburg,757,5,7,5,12,32,42,-10,26
Vienna,757,6,7,5,12,28,39,-11,26
SC Rheindorf,757,7,6,5,13,19,28,-9,23
FC Salzburg,758,1,14,7,3,44,19,25,49
Rapid Vienna,758,2,9,10,5,36,29,7,37
SK Sturm Gra,758,3,11,4,9,29,28,1,37
LASK Linz,758,4,10,6,8,30,25,5,36
Mattersburg,758,5,6,7,11,30,39,-9,25
Vienna,758,6,6,5,13,23,42,-19,23
SC Rheindorf,758,7,5,7,12,19,29,-10,22
FC Salzburg,759,1,14,7,3,44,17,27,49
Rapid Vienna,759,2,11,9,4,39,25,14,42
SK Sturm Gra,759,3,11,4,9,30,32,-2,37
LASK Linz,759,4,7,7,10,26,32,-6,28
Mattersburg,759,5,6,8,10,31,39,-8,26
SC Rheindorf,759,6,6,6,12,21,28,-7,24
Vienna,759,7,6,5,13,25,43,-18,23
FC Salzburg,760,1,15,7,2,46,18,28,52
Rapid Vienna,760,2,9,9,6,36,28,8,36
SK Sturm Gra,760,3,11,3,10,29,31,-2,36
LASK Linz,760,4,8,7,9,27,29,-2,31
SC Rheindorf,760,5,7,6,11,21,27,-6,27
Vienna,760,6,7,6,11,25,38,-13,27
Mattersburg,760,7,5,6,13,28,41,-13,21
FC Salzburg,761,1,16,6,2,47,18,29,54
SK Sturm Gra,761,2,14,3,7,34,28,6,45
LASK Linz,761,3,10,5,9,29,27,2,35
Rapid Vienna,761,4,8,9,7,37,30,7,33
Mattersburg,761,5,6,5,13,30,42,-12,23
Vienna,761,6,6,5,13,26,43,-17,23
SC Rheindorf,761,7,5,5,14,17,32,-15,20
FC Salzburg,762,1,15,7,2,49,18,31,52
SK Sturm Gra,762,2,13,3,8,35,31,4,42
Rapid Vienna,762,3,9,10,5,36,27,9,37
LASK Linz,762,4,8,6,10,27,30,-3,30
Vienna,762,5,7,6,11,25,38,-13,27
Mattersburg,762,6,6,5,13,29,44,-15,23
SC Rheindorf,762,7,5,5,14,21,34,-13,20
FC Salzburg,763,1,14,8,2,46,21,25,50
SK Sturm Gra,763,2,12,5,7,31,27,4,41
Rapid Vienna,763,3,8,11,5,37,29,8,35
LASK Linz,763,4,8,6,10,26,29,-3,30
Mattersburg,763,5,8,6,10,37,41,-4,30
Vienna,763,6,6,5,13,24,41,-17,23
SC Rheindorf,763,7,4,7,13,16,29,-13,19
FC Salzburg,764,1,14,7,3,43,19,24,49
SK Sturm Gra,764,2,12,4,8,30,29,1,40
Rapid Vienna,764,3,8,11,5,35,25,10,35
Mattersburg,764,4,8,6,10,34,38,-4,30
LASK Linz,764,5,7,5,12,23,31,-8,26
Vienna,764,6,6,7,11,23,37,-14,25
SC Rheindorf,764,7,6,6,12,18,27,-9,24
FC Salzburg,765,1,16,6,2,46,16,30,54
SK Sturm Gra,765,2,13,4,7,33,26,7,43
Rapid Vienna,765,3,9,9,6,36,28,8,36
LASK Linz,765,4,8,6,10,26,30,-4,30
Mattersburg,765,5,6,7,11,32,44,-12,25
Vienna,765,6,6,6,12,25,40,-15,24
SC Rheindorf,765,7,4,6,14,16,30,-14,18
FC Salzburg,766,1,14,6,4,45,18,27,48
SK Sturm Gra,766,2,12,4,8,32,34,-2,40
Rapid Vienna,766,3,10,9,5,38,25,13,39
LASK Linz,766,4,8,6,10,26,32,-6,30
Mattersburg,766,5,7,6,11,34,43,-9,27
Vienna,766,6,7,5,12,25,40,-15,26
SC Rheindorf,766,7,5,6,13,24,32,-8,21
FC Salzburg,767,1,14,6,4,45,19,26,48
SK Sturm Gra,767,2,11,6,7,31,29,2,39
Rapid Vienna,767,3,8,12,4,36,27,9,36
Mattersburg,767,4,8,5,11,31,41,-10,29
LASK Linz,767,5,7,7,10,27,31,-4,28
Vienna,767,6,7,5,12,26,40,-14,26
SC Rheindorf,767,7,5,7,12,20,29,-9,22
FC Salzburg,768,1,13,6,5,49,28,21,45
SK Sturm Gra,768,2,12,4,8,37,35,2,40
Rapid Vienna,768,3,10,9,5,38,28,10,39
LASK Linz,768,4,8,7,9,27,27,0,31
Mattersburg,768,5,7,7,10,34,41,-7,28
Vienna,768,6,7,6,11,30,42,-12,27
SC Rheindorf,768,7,4,7,13,18,32,-14,19
FC Salzburg,769,1,13,8,3,44,19,25,47
SK Sturm Gra,769,2,13,4,7,30,27,3,43
Rapid Vienna,769,3,9,11,4,36,26,10,38
LASK Linz,769,4,9,6,9,28,28,0,33
Mattersburg,769,5,6,6,12,29,40,-11,24
Vienna,769,6,6,6,12,23,38,-15,24
SC Rheindorf,769,7,5,5,14,17,29,-12,20
FC Salzburg,770,1,15,6,3,46,18,28,51
Rapid Vienna,770,2,10,10,4,38,26,12,40
SK Sturm Gra,770,3,11,4,9,30,30,0,37
LASK Linz,770,4,8,6,10,27,29,-2,30
Vienna,770,5,7,5,12,25,39,-14,26
SC Rheindorf,770,6,5,8,11,21,30,-9,23
Mattersburg,770,7,5,7,12,29,44,-15,22
FC Salzburg,771,1,14,8,2,49,20,29,50
SK Sturm Gra,771,2,13,4,7,32,29,3,43
LASK Linz,771,3,11,5,8,33,27,6,38
Rapid Vienna,771,4,8,10,6,38,31,7,34
Vienna,771,5,7,5,12,25,42,-17,26
Mattersburg,771,6,6,5,13,33,44,-11,23
SC Rheindorf,771,7,4,5,15,17,34,-17,17
FC Salzburg,772,1,14,8,2,44,18,26,50
SK Sturm Gra,772,2,13,5,6,33,26,7,44
Rapid Vienna,772,3,9,10,5,38,27,11,37
LASK Linz,772,4,9,5,10,27,28,-1,32
Vienna,772,5,6,7,11,26,40,-14,25
Mattersburg,772,6,5,6,13,29,42,-13,21
SC Rheindorf,772,7,5,5,14,16,32,-16,20
FC Salzburg,773,1,13,8,3,40,18,22,47
SK Sturm Gra,773,2,12,5,7,31,26,5,41
Rapid Vienna,773,3,8,10,6,35,29,6,34
LASK Linz,773,4,8,6,10,27,28,-1,30
Mattersburg,773,5,7,7,10,30,38,-8,28
Vienna,773,6,6,7,11,23,37,-14,25
SC Rheindorf,773,7,5,7,12,18,28,-10,22
FC Salzburg,774,1,13,7,4,42,22,20,46
SK Sturm Gra,774,2,12,4,8,29,26,3,40
Rapid Vienna,774,3,10,9,5,37,25,12,39
Vienna,774,4,7,6,11,27,38,-11,27
LASK Linz,774,5,7,5,12,26,33,-7,26
Mattersburg,774,6,6,8,10,32,41,-9,26
SC Rheindorf,774,7,6,7,11,20,28,-8,25
FC Salzburg,775,1,13,7,4,43,20,23,46
SK Sturm Gra,775,2,13,4,7,32,28,4,43
Rapid Vienna,775,3,8,12,4,37,28,9,36
LASK Linz,775,4,7,7,10,27,32,-5,28
Mattersburg,775,5,7,6,11,31,40,-9,27
SC Rheindorf,775,6,6,6,12,23,30,-7,24
Vienna,775,7,6,6,12,24,39,-15,24
FC Salzburg,776,1,15,6,3,47,19,28,51
SK Sturm Gra,776,2,13,4,7,35,31,4,43
Rapid Vienna,776,3,10,10,4,37,26,11,40
Mattersburg,776,4,8,5,11,31,38,-7,29
LASK Linz,776,5,7,5,12,25,30,-5,26
Vienna,776,6,6,5,13,24,43,-19,23
SC Rheindorf,776,7,5,5,14,17,29,-12,20
FC Salzburg,777,1,15,6,3,46,21,25,51
SK Sturm Gra,777,2,13,3,8,34,31,3,42
LASK Linz,777,3,10,5,9,32,28,4,35
Rapid Vienna,777,4,7,10,7,34,32,2,31
Vienna,777,5,7,5,12,26,40,-14,26
SC Rheindorf,777,6,6,7,11,22,27,-5,25
Mattersburg,777,7,5,6,13,27,42,-15,21
FC Salzburg,778,1,13,8,3,42,18,24,47
SK Sturm Gra,778,2,13,4,7,36,27,9,43
Rapid Vienna,778,3,8,10,6,33,27,6,34
Mattersburg,778,4,7,7,10,31,38,-7,28
LASK Linz,778,5,7,5,12,25,34,-9,26
Vienna,778,6,7,5,12,25,40,-15,26
SC Rheindorf,778,7,6,7,11,18,26,-8,25
FC Salzburg,779,1,14,7,3,43,20,23,49
SK Sturm Gra,779,2,11,5,8,32,30,2,38
LASK Linz,779,3,9,7,8,29,27,2,34
Rapid Vienna,779,4,7,11,6,33,28,5,32
Vienna,779,5,7,5,12,26,39,-13,26
Mattersburg,779,6,6,7,11,31,41,-10,25
SC Rheindorf,779,7,5,8,11,19,28,-9,23
FC Salzburg,780,1,14,6,4,47,19,28,48
SK Sturm Gra,780,2,12,6,6,33,28,5,42
Rapid Vienna,780,3,9,10,5,37,30,7,37
LASK Linz,780,4,7,7,10,26,29,-3,28
Mattersburg,780,5,7,6,11,36,45,-9,27
Vienna,780,6,7,5,12,28,43,-15,26
SC Rheindorf,780,7,5,6,13,18,31,-13,21
FC Salzburg,781,1,13,7,4,45,24,21,46
SK Sturm Gra,781,2,11,5,8,33,37,-4,38
Rapid Vienna,781,3,8,10,6,36,28,8,34
LASK Linz,781,4,9,7,8,28,25,3,34
Vienna,781,5,7,6,11,28,40,-12,27
SC Rheindorf,781,6,6,7,11,25,28,-3,25
Mattersburg,781,7,6,6,12,32,45,-13,24
FC Salzburg,782,1,15,6,3,47,17,30,51
SK Sturm Gra,782,2,12,4,8,32,29,3,40
Rapid Vienna,782,3,9,10,5,37,29,8,37
LASK Linz,782,4,9,5,10,30,31,-1,32
Vienna,782,5,7,5,12,24,39,-15,26
SC Rheindorf,782,6,6,6,12,19,26,-7,24
Mattersburg,782,7,5,6,13,26,44,-18,21
FC Salzburg,783,1,14,8,2,47,19,28,50
SK Sturm Gra,783,2,13,5,6,36,28,8,44
Rapid Vienna,783,3,8,11,5,36,28,8,35
LASK Linz,783,4,8,8,8,27,27,0,32
Mattersburg,783,5,6,6,12,29,43,-14,24
Vienna,783,6,6,6,12,25,40,-15,24
SC Rheindorf,783,7,4,6,14,17,32,-15,18
FC Salzburg,784,1,14,8,2,45,18,27,50
SK Sturm Gra,784,2,12,5,7,32,31,1,41
Rapid Vienna,784,3,9,10,5,36,27,9,37
LASK Linz,784,4,7,6,11,25,32,-7,27
SC Rheindorf,784,5,7,5,12,24,27,-3,26
Mattersburg,784,6,6,6,12,33,45,-12,24
Vienna,784,7,6,6,12,28,43,-15,24
FC Salzburg,785,1,14,6,4,43,20,23,48
Rapid Vienna,785,2,10,10,4,39,26,13,40
SK Sturm Gra,785,3,11,4,9,30,30,0,37
LASK Linz,785,4,9,6,9,29,29,0,33
Vienna,785,5,7,5,12,25,38,-13,26
SC Rheindorf,785,6,6,6,12,20,28,-8,24
Mattersburg,785,7,6,5,13,28,43,-15,23
FC Salzburg,786,1,14,7,3,45,20,25,49
Rapid Vienna,786,2,10,10,4,36,25,11,40
SK Sturm Gra,786,3,12,4,8,34,30,4,40
LASK Linz,786,4,8,6,10,25,27,-2,30
Mattersburg,786,5,7,6,11,31,41,-10,27
Vienna,786,6,7,6,11,27,39,-12,27
SC Rheindorf,786,7,4,5,15,17,33,-16,17
FC Salzburg,787,1,15,7,2,45,16,29,52
SK Sturm Gra,787,2,12,4,8,32,33,-1,40
Rapid Vienna,787,3,8,11,5,34,27,7,35
LASK Linz,787,4,8,6,10,29,28,1,30
Mattersburg,787,5,7,6,11,34,44,-10,27
Vienna,787,6,6,5,13,25,42,-17,23
SC Rheindorf,787,7,5,7,12,25,34,-9,22
FC Salzburg,788,1,15,6,3,47,19,28,51
SK Sturm Gra,788,2,12,3,9,34,36,-2,39
LASK Linz,788,3,10,5,9,29,27,2,35
Rapid Vienna,788,4,8,10,6,39,31,8,34
Mattersburg,788,5,8,5,11,34,41,-7,29
Vienna,788,6,6,5,13,26,45,-19,23
SC Rheindorf,788,7,5,6,13,23,33,-10,21
FC Salzburg,789,1,13,8,3,41,17,24,47
Rapid Vienna,789,2,10,10,4,41,25,16,40
SK Sturm Gra,789,3,11,6,7,30,27,3,39
LASK Linz,789,4,9,6,9,26,29,-3,33
Vienna,789,5,7,5,12,27,42,-15,26
Mattersburg,789,6,6,5,13,29,41,-12,23
SC Rheindorf,789,7,5,6,13,17,30,-13,21
FC Salzburg,790,1,15,6,3,47,18,29,51
SK Sturm Gra,790,2,12,4,8,33,31,2,40
Rapid Vienna,790,3,9,9,6,36,30,6,36
LASK Linz,790,4,8,6,10,26,29,-3,30
Mattersburg,790,5,8,5,11,32,40,-8,29
Vienna,790,6,7,5,12,25,38,-13,26
SC Rheindorf,790,7,4,7,13,19,32,-13,19
FC Salzburg,791,1,14,7,3,45,22,23,49
SK Sturm Gra,791,2,13,5,6,35,27,8,44
LASK Linz,791,3,9,7,8,31,30,1,34
Rapid Vienna,791,4,8,9,7,36,30,6,33
Vienna,791,5,7,6,11,30,40,-10,27
Mattersburg,791,6,5,7,12,32,45,-13,22
SC Rheindorf,791,7,5,5,14,18,33,-15,20
FC Salzburg,792,1,14,6,4,44,19,25,48
SK Sturm Gra,792,2,13,3,8,32,31,1,42
Rapid Vienna,792,3,9,9,6,35,29,6,36
LASK Linz,792,4,9,5,10,28,26,2,32
Mattersburg,792,5,7,5,12,31,42,-11,26
Vienna,792,6,7,5,12,25,38,-13,26
SC Rheindorf,792,7,6,5,13,23,33,-10,23
FC Salzburg,793,1,14,8,2,44,18,26,50
SK Sturm Gra,793,2,12,5,7,30,28,2,41
LASK Linz,793,3,10,6,8,30,26,4,36
Rapid Vienna,793,4,8,10,6,36,27,9,34
Vienna,793,5,7,6,11,26,38,-12,27
Mattersburg,793,6,5,6,13,31,46,-15,21
SC Rheindorf,793,7,4,7,13,19,33,-14,19
FC Salzburg,794,1,16,6,2,49,21,28,54
SK Sturm Gra,794,2,14,3,7,35,29,6,45
Rapid Vienna,794,3,8,10,6,38,28,10,34
LASK Linz,794,4,7,7,10,24,28,-4,28
Vienna,794,5,7,5,12,26,39,-13,26
Mattersburg,794,6,5,7,12,29,43,-14,22
SC Rheindorf,794,7,5,6,13,19,32,-13,21
FC Salzburg,795,1,15,6,3,48,18,30,51
SK Sturm Gra,795,2,11,5,8,33,35,-2,38
Rapid Vienna,795,3,8,10,6,35,28,7,34
LASK Linz,795,4,8,7,9,28,30,-2,31
Vienna,795,5,7,5,12,27,41,-14,26
SC Rheindorf,795,6,6,7,11,19,27,-8,25
Mattersburg,795,7,6,6,12,32,43,-11,24
FC Salzburg,796,1,14,7,3,43,20,23,49
SK Sturm Gra,796,2,11,4,9,31,32,-1,37
Rapid Vienna,796,3,8,12,4,35,24,11,36
LASK Linz,796,4,8,6,10,27,29,-2,30
Vienna,796,5,8,5,11,30,38,-8,29
Mattersburg,796,6,7,5,12,29,42,-13,26
SC Rheindorf,796,7,6,5,13,19,29,-10,23
FC Salzburg,797,1,14,7,3,43,18,25,49
Rapid Vienna,797,2,10,9,5,37,25,12,39
SK Sturm Gra,797,3,11,5,8,33,33,0,38
LASK Linz,797,4,10,6,8,30,26,4,36
Vienna,797,5,7,5,12,25,39,-14,26
SC Rheindorf,797,6,5,6,13,17,30,-13,21
Mattersburg,797,7,5,6,13,28,42,-14,21
FC Salzburg,798,1,14,7,3,45,19,26,49
SK Sturm Gra,798,2,12,4,8,31,30,1,40
LASK Linz,798,3,10,6,8,29,26,3,36
Rapid Vienna,798,4,8,10,6,32,25,7,34
SC Rheindorf,798,5,6,6,12,22,29,-7,24
Mattersburg,798,6,6,6,12,34,46,-12,24
Vienna,798,7,6,5,13,24,42,-18,23
FC Salzburg,799,1,15,6,3,49,16,33,51
SK Sturm Gra,799,2,12,3,9,33,33,0,39
Rapid Vienna,799,3,9,9,6,36,32,4,36
LASK Linz,799,4,9,6,9,29,28,1,33
Vienna,799,5,8,5,11,26,38,-12,29
Mattersburg,799,6,5,7,12,28,43,-15,22
SC Rheindorf,799,7,5,6,13,18,29,-11,21
FC Salzburg,800,1,16,6,2,46,17,29,54
SK Sturm Gra,800,2,12,4,8,29,26,3,40
Rapid Vienna,800,3,8,11,5,35,27,8,35
LASK Linz,800,4,8,6,10,29,31,-2,30
Mattersburg,800,5,8,5,11,32,41,-9,29
Vienna,800,6,6,5,13,24,41,-17,23
SC Rheindorf,800,7,5,5,14,17,29,-12,20
FC Salzburg,801,1,15,6,3,42,16,26,51
SK Sturm Gra,801,2,13,4,7,35,28,7,43
Rapid Vienna,801,3,8,9,7,35,31,4,33
LASK Linz,801,4,8,5,11,27,30,-3,29
Mattersburg,801,5,7,6,11,31,41,-10,27
Vienna,801,6,7,5,12,26,38,-12,26
SC Rheindorf,801,7,5,7,12,19,31,-12,22
FC Salzburg,802,1,15,7,2,47,18,29,52
SK Sturm Gra,802,2,14,3,7,37,28,9,45
Rapid Vienna,802,3,8,10,6,33,26,7,34
Mattersburg,802,4,7,7,10,31,38,-7,28
LASK Linz,802,5,7,5,12,25,33,-8,26
Vienna,802,6,6,5,13,25,42,-17,23
SC Rheindorf,802,7,5,7,12,17,30,-13,22
FC Salzburg,803,1,14,8,2,44,16,28,50
SK Sturm Gra,803,2,13,4,7,32,27,5,43
LASK Linz,803,3,9,7,8,28,27,1,34
Rapid Vienna,803,4,7,11,6,32,26,6,32
Mattersburg,803,5,7,6,11,30,40,-10,27
Vienna,803,6,6,5,13,23,41,-18,23
SC Rheindorf,803,7,4,7,13,17,29,-12,19
FC Salzburg,804,1,15,6,3,49,20,29,51
SK Sturm Gra,804,2,13,4,7,32,29,3,43
Rapid Vienna,804,3,8,11,5,36,28,8,35
LASK Linz,804,4,9,6,9,27,26,1,33
Vienna,804,5,8,5,11,27,39,-12,29
Mattersburg,804,6,6,5,13,30,42,-12,23
SC Rheindorf,804,7,4,5,15,15,32,-17,17
FC Salzburg,805,1,15,6,3,51,21,30,51
SK Sturm Gra,805,2,12,4,8,38,33,5,40
Rapid Vienna,805,3,10,9,5,39,28,11,39
Mattersburg,805,4,8,5,11,31,40,-9,29
LASK Linz,805,5,7,7,10,26,29,-3,28
Vienna,805,6,7,5,12,28,42,-14,26
SC Rheindorf,805,7,4,6,14,16,36,-20,18
FC Salzburg,806,1,14,7,3,41,17,24,49
SK Sturm Gra,806,2,13,5,6,32,25,7,44
Rapid Vienna,806,3,7,11,6,31,26,5,32
LASK Linz,806,4,8,7,9,25,29,-4,31
Mattersburg,806,5,8,5,11,35,38,-3,29
Vienna,806,6,6,5,13,25,43,-18,23
SC Rheindorf,806,7,5,6,13,19,30,-11,21
FC Salzburg,807,1,14,8,2,46,18,28,50
SK Sturm Gra,807,2,13,4,7,36,29,7,43
Rapid Vienna,807,3,7,12,5,35,28,7,33
LASK Linz,807,4,7,7,10,28,33,-5,28
SC Rheindorf,807,5,6,7,11,21,29,-8,25
Vienna,807,6,6,7,11,24,38,-14,25
Mattersburg,807,7,5,7,12,29,44,-15,22
FC Salzburg,808,1,14,7,3,42,17,25,49
SK Sturm Gra,808,2,12,4,8,33,29,4,40
Rapid Vienna,808,3,9,10,5,36,28,8,37
LASK Linz,808,4,9,5,10,27,30,-3,32
Vienna,808,5,7,5,12,25,43,-18,26
Mattersburg,808,6,6,6,12,31,38,-7,24
SC Rheindorf,808,7,6,5,13,21,30,-9,23
FC Salzburg,809,1,16,6,2,47,16,31,54
SK Sturm Gra,809,2,14,3,7,34,30,4,45
Rapid Vienna,809,3,8,9,7,34,29,5,33
LASK Linz,809,4,8,7,9,29,29,0,31
Vienna,809,5,7,5,12,27,42,-15,26
Mattersburg,809,6,6,6,12,31,43,-12,24
SC Rheindorf,809,7,4,6,14,19,32,-13,18
FC Salzburg,810,1,13,7,4,44,20,24,46
Rapid Vienna,810,2,10,10,4,36,25,11,40
SK Sturm Gra,810,3,12,4,8,30,27,3,40
Vienna,810,4,8,5,11,27,38,-11,29
LASK Linz,810,5,7,7,10,25,28,-3,28
Mattersburg,810,6,6,6,12,28,42,-14,24
SC Rheindorf,810,7,6,5,13,22,32,-10,23
FC Salzburg,811,1,15,6,3,47,18,29,51
SK Sturm Gra,811,2,12,4,8,33,34,-1,40
Rapid Vienna,811,3,8,10,6,36,28,8,34
LASK Linz,811,4,7,8,9,26,30,-4,29
Vienna,811,5,7,6,11,26,39,-13,27
SC Rheindorf,811,6,6,7,11,22,26,-4,25
Mattersburg,811,7,5,7,12,29,44,-15,22
FC Salzburg,812,1,15,6,3,43,17,26,51
SK Sturm Gra,812,2,11,4,9,29,30,-1,37
LASK Linz,812,3,9,7,8,29,27,2,34
Rapid Vienna,812,4,7,12,5,33,27,6,33
SC Rheindorf,812,5,6,7,11,19,26,-7,25
Mattersburg,812,6,6,6,12,31,41,-10,24
Vienna,812,7,6,6,12,25,41,-16,24
FC Salzburg,813,1,13,6,5,42,21,21,45
SK Sturm Gra,813,2,12,4,8,34,29,5,40
Rapid Vienna,813,3,10,9,5,40,29,11,39
LASK Linz,813,4,8,6,10,26,30,-4,30
Vienna,813,5,8,5,11,28,39,-11,29
Mattersburg,813,6,7,6,11,32,41,-9,27
SC Rheindorf,813,7,5,6,13,19,32,-13,21
SK Sturm Gra,814,1,15,3,6,39,27,12,48
FC Salzburg,814,2,13,8,3,47,23,24,47
Rapid Vienna,814,3,9,10,5,40,31,9,37
LASK Linz,814,4,9,5,10,28,32,-4,32
Mattersburg,814,5,6,6,12,32,43,-11,24
Vienna,814,6,6,5,13,24,43,-19,23
SC Rheindorf,814,7,5,5,14,20,31,-11,20
FC Salzburg,815,1,15,7,2,50,19,31,52
SK Sturm Gra,815,2,12,4,8,31,30,1,40
Rapid Vienna,815,3,8,12,4,36,27,9,36
LASK Linz,815,4,8,7,9,26,28,-2,31
Mattersburg,815,5,8,5,11,34,42,-8,29
Vienna,815,6,6,5,13,26,43,-17,23
SC Rheindorf,815,7,4,6,14,17,31,-14,18
FC Salzburg,816,1,14,6,4,42,20,22,48
SK Sturm Gra,816,2,12,5,7,31,27,4,41
Rapid Vienna,816,3,9,10,5,39,28,11,37
LASK Linz,816,4,8,6,10,26,30,-4,30
Vienna,816,5,7,5,12,24,40,-16,26
Mattersburg,816,6,6,6,12,32,41,-9,24
SC Rheindorf,816,7,5,8,11,21,29,-8,23
FC Salzburg,817,1,16,6,2,45,16,29,54
SK Sturm Gra,817,2,13,3,8,30,27,3,42
Rapid Vienna,817,3,7,10,7,31,27,4,31
LASK Linz,817,4,8,6,10,26,28,-2,30
SC Rheindorf,817,5,7,5,12,23,30,-7,26
Mattersburg,817,6,6,6,12,34,46,-12,24
Vienna,817,7,6,6,12,25,40,-15,24
FC Salzburg,818,1,14,7,3,42,16,26,49
SK Sturm Gra,818,2,12,5,7,29,26,3,41
Rapid Vienna,818,3,10,9,5,37,24,13,39
LASK Linz,818,4,8,6,10,25,31,-6,30
Mattersburg,818,5,7,5,12,31,38,-7,26
Vienna,818,6,7,5,12,24,40,-16,26
SC Rheindorf,818,7,5,5,14,17,30,-13,20
FC Salzburg,819,1,16,6,2,48,17,31,54
SK Sturm Gra,819,2,13,3,8,34,30,4,42
Rapid Vienna,819,3,9,9,6,38,31,7,36
LASK Linz,819,4,9,5,10,28,31,-3,32
Mattersburg,819,5,7,5,12,33,42,-9,26
Vienna,819,6,7,5,12,25,39,-14,26
SC Rheindorf,819,7,4,5,15,19,35,-16,17
FC Salzburg,820,1,16,6,2,47,18,29,54
SK Sturm Gra,820,2,13,4,7,33,28,5,43
Rapid Vienna,820,3,8,10,6,37,30,7,34
LASK Linz,820,4,9,5,10,27,28,-1,32
Vienna,820,5,7,5,12,25,41,-16,26
SC Rheindorf,820,6,6,5,13,19,29,-10,23
Mattersburg,820,7,5,5,14,30,44,-14,20
FC Salzburg,821,1,16,6,2,48,17,31,54
SK Sturm Gra,821,2,12,3,9,32,31,1,39
LASK Linz,821,3,11,5,8,29,25,4,38
Rapid Vienna,821,4,9,9,6,36,26,10,36
Vienna,821,5,6,6,12,26,42,-16,24
Mattersburg,821,6,5,7,12,32,44,-12,22
SC Rheindorf,821,7,4,6,14,17,35,-18,18
FC Salzburg,822,1,13,9,2,43,18,25,48
SK Sturm Gra,822,2,12,5,7,32,28,4,41
LASK Linz,822,3,10,6,8,31,29,2,36
Rapid Vienna,822,4,8,10,6,34,27,7,34
Vienna,822,5,7,5,12,27,42,-15,26
Mattersburg,822,6,5,7,12,34,46,-12,22
SC Rheindorf,822,7,4,8,12,19,30,-11,20
FC Salzburg,823,1,16,6,2,48,18,30,54
SK Sturm Gra,823,2,11,4,9,31,30,1,37
Rapid Vienna,823,3,9,9,6,36,31,5,36
LASK Linz,823,4,10,5,9,30,27,3,35
Mattersburg,823,5,6,6,12,33,46,-13,24
Vienna,823,6,6,6,12,27,42,-15,24
SC Rheindorf,823,7,5,6,13,17,28,-11,21
FC Salzburg,824,1,13,9,2,43,18,25,48
SK Sturm Gra,824,2,11,7,6,34,30,4,40
Rapid Vienna,824,3,7,13,4,35,27,8,34
LASK Linz,824,4,8,7,9,28,31,-3,31
Mattersburg,824,5,7,6,11,32,39,-7,27
Vienna,824,6,6,7,11,27,41,-14,25
SC Rheindorf,824,7,4,7,13,19,32,-13,19
FC Salzburg,825,1,16,6,2,47,16,31,54
SK Sturm Gra,825,2,13,4,7,34,28,6,43
LASK Linz,825,3,9,7,8,27,25,2,34
Rapid Vienna,825,4,7,9,8,32,30,2,30
Mattersburg,825,5,6,6,12,29,40,-11,24
SC Rheindorf,825,6,6,5,13,19,30,-11,23
Vienna,825,7,6,5,13,23,42,-19,23
FC Salzburg,826,1,13,7,4,44,25,19,46
SK Sturm Gra,826,2,14,4,6,37,27,10,46
Rapid Vienna,826,3,9,10,5,36,27,9,37
LASK Linz,826,4,8,6,10,28,30,-2,30
Vienna,826,5,7,6,11,28,41,-13,27
Mattersburg,826,6,7,5,12,33,43,-10,26
SC Rheindorf,826,7,4,6,14,17,30,-13,18
FC Salzburg,827,1,13,7,4,44,19,25,46
SK Sturm Gra,827,2,14,3,7,35,27,8,45
Rapid Vienna,827,3,9,9,6,37,30,7,36
LASK Linz,827,4,10,5,9,29,28,1,35
Vienna,827,5,6,7,11,27,41,-14,25
Mattersburg,827,6,5,7,12,33,48,-15,22
SC Rheindorf,827,7,5,6,13,20,32,-12,21
FC Salzburg,828,1,14,7,3,44,19,25,49
Rapid Vienna,828,2,9,10,5,41,27,14,37
SK Sturm Gra,828,3,11,4,9,31,31,0,37
LASK Linz,828,4,7,8,9,25,28,-3,29
Vienna,828,5,8,5,11,28,37,-9,29
SC Rheindorf,828,6,6,6,12,18,31,-13,24
Mattersburg,828,7,5,8,11,28,42,-14,23
FC Salzburg,829,1,13,8,3,42,20,22,47
SK Sturm Gra,829,2,12,4,8,34,30,4,40
Rapid Vienna,829,3,9,10,5,35,27,8,37
LASK Linz,829,4,8,7,9,26,28,-2,31
Mattersburg,829,5,6,8,10,33,40,-7,26
Vienna,829,6,6,6,12,24,39,-15,24
SC Rheindorf,829,7,5,7,12,19,29,-10,22
FC Salzburg,830,1,15,7,2,49,17,32,52
SK Sturm Gra,830,2,12,3,9,32,30,2,39
Rapid Vienna,830,3,8,11,5,36,27,9,35
LASK Linz,830,4,10,5,9,30,28,2,35
Mattersburg,830,5,7,5,12,30,43,-13,26
Vienna,830,6,6,5,13,24,43,-19,23
SC Rheindorf,830,7,5,6,13,19,32,-13,21
FC Salzburg,831,1,14,6,4,43,20,23,48
SK Sturm Gra,831,2,14,3,7,33,28,5,45
Rapid Vienna,831,3,7,11,6,34,28,6,32
LASK Linz,831,4,7,7,10,28,31,-3,28
Mattersburg,831,5,7,6,11,32,40,-8,27
Vienna,831,6,7,5,12,26,40,-14,26
SC Rheindorf,831,7,6,6,12,20,29,-9,24
FC Salzburg,832,1,13,7,4,43,22,21,46
SK Sturm Gra,832,2,13,4,7,32,28,4,43
Rapid Vienna,832,3,9,9,6,35,27,8,36
LASK Linz,832,4,8,7,9,26,27,-1,31
Mattersburg,832,5,7,6,11,32,39,-7,27
Vienna,832,6,7,5,12,26,39,-13,26
SC Rheindorf,832,7,5,6,13,19,31,-12,21
FC Salzburg,833,1,15,7,2,49,19,30,52
SK Sturm Gra,833,2,12,3,9,29,32,-3,39
Rapid Vienna,833,3,8,11,5,37,28,9,35
LASK Linz,833,4,8,7,9,27,28,-1,31
Vienna,833,5,7,6,11,29,39,-10,27
Mattersburg,833,6,6,5,13,28,43,-15,23
SC Rheindorf,833,7,5,7,12,18,28,-10,22
FC Salzburg,834,1,15,7,2,44,16,28,52
SK Sturm Gra,834,2,13,3,8,34,29,5,42
Rapid Vienna,834,3,9,9,6,36,28,8,36
LASK Linz,834,4,9,5,10,27,29,-2,32
Vienna,834,5,6,6,12,24,39,-15,24
SC Rheindorf,834,6,6,5,13,20,30,-10,23
Mattersburg,834,7,5,7,12,27,41,-14,22
FC Salzburg,835,1,15,7,2,46,19,27,52
SK Sturm Gra,835,2,13,4,7,32,26,6,43
Rapid Vienna,835,3,8,12,4,40,28,12,36
LASK Linz,835,4,7,6,11,24,32,-8,27
SC Rheindorf,835,5,6,6,12,20,29,-9,24
Mattersburg,835,6,6,6,12,28,40,-12,24
Vienna,835,7,6,5,13,25,41,-16,23
FC Salzburg,836,1,15,7,2,45,17,28,52
SK Sturm Gra,836,2,13,4,7,33,29,4,43
Rapid Vienna,836,3,8,11,5,36,26,10,35
LASK Linz,836,4,8,6,10,29,32,-3,30
Vienna,836,5,7,5,12,30,41,-11,26
Mattersburg,836,6,6,5,13,33,48,-15,23
SC Rheindorf,836,7,5,6,13,20,33,-13,21
FC Salzburg,837,1,15,7,2,42,16,26,52
SK Sturm Gra,837,2,11,5,8,31,30,1,38
Rapid Vienna,837,3,7,11,6,33,27,6,32
LASK Linz,837,4,8,7,9,25,27,-2,31
Vienna,837,5,7,6,11,29,37,-8,27
SC Rheindorf,837,6,6,6,12,21,29,-8,24
Mattersburg,837,7,6,6,12,29,44,-15,24
FC Salzburg,838,1,14,6,4,43,20,23,48
SK Sturm Gra,838,2,12,4,8,35,30,5,40
Rapid Vienna,838,3,9,11,4,38,27,11,38
Mattersburg,838,4,8,5,11,32,38,-6,29
LASK Linz,838,5,7,7,10,24,32,-8,28
Vienna,838,6,7,5,12,25,39,-14,26
SC Rheindorf,838,7,5,6,13,20,31,-11,21
FC Salzburg,839,1,15,6,3,45,21,24,51
SK Sturm Gra,839,2,13,3,8,34,30,4,42
Rapid Vienna,839,3,10,9,5,41,29,12,39
LASK Linz,839,4,9,5,10,31,30,1,32
Vienna,839,5,7,5,12,26,39,-13,26
Mattersburg,839,6,6,5,13,29,43,-14,23
SC Rheindorf,839,7,5,5,14,21,35,-14,20
FC Salzburg,840,1,15,7,2,48,18,30,52
SK Sturm Gra,840,2,13,4,7,33,28,5,43
Rapid Vienna,840,3,8,12,4,35,25,10,36
LASK Linz,840,4,8,6,10,24,26,-2,30
Mattersburg,840,5,7,5,12,29,41,-12,26
Vienna,840,6,7,5,12,26,42,-16,26
SC Rheindorf,840,7,4,5,15,16,31,-15,17
FC Salzburg,841,1,13,6,5,40,21,19,45
SK Sturm Gra,841,2,13,5,6,34,27,7,44
Rapid Vienna,841,3,9,11,4,38,27,11,38
Vienna,841,4,8,5,11,26,37,-11,29
LASK Linz,841,5,7,5,12,26,32,-6,26
Mattersburg,841,6,6,6,12,31,42,-11,24
SC Rheindorf,841,7,5,8,11,19,28,-9,23
FC Salzburg,842,1,14,6,4,50,19,31,48
Rapid Vienna,842,2,10,9,5,38,26,12,39
SK Sturm Gra,842,3,11,5,8,30,32,-2,38
LASK Linz,842,4,8,7,9,25,26,-1,31
Vienna,842,5,8,5,11,28,38,-10,29
Mattersburg,842,6,6,6,12,28,45,-17,24
SC Rheindorf,842,7,4,8,12,18,31,-13,20
FC Salzburg,843,1,15,6,3,46,18,28,51
Rapid Vienna,843,2,9,11,4,38,27,11,38
SK Sturm Gra,843,3,11,5,8,33,32,1,38
LASK Linz,843,4,10,5,9,29,28,1,35
Mattersburg,843,5,6,6,12,28,41,-13,24
Vienna,843,6,6,5,13,23,40,-17,23
SC Rheindorf,843,7,4,8,12,19,30,-11,20
FC Salzburg,844,1,16,6,2,47,17,30,54
SK Sturm Gra,844,2,13,4,7,32,28,4,43
Rapid Vienna,844,3,8,10,6,33,27,6,34
LASK Linz,844,4,7,7,10,25,28,-3,28
Vienna,844,5,7,5,12,24,39,-15,26
SC Rheindorf,844,6,5,7,12,17,27,-10,22
Mattersburg,844,7,5,7,12,28,40,-12,22
FC Salzburg,845,1,16,6,2,46,15,31,54
SK Sturm Gra,845,2,12,4,8,30,29,1,40
Rapid Vienna,845,3,9,10,5,37,28,9,37
Mattersburg,845,4,8,5,11,32,38,-6,29
LASK Linz,845,5,7,5,12,25,34,-9,26
SC Rheindorf,845,6,6,5,13,21,29,-8,23
Vienna,845,7,6,5,13,24,42,-18,23
FC Salzburg,846,1,14,7,3,44,18,26,49
SK Sturm Gra,846,2,12,5,7,33,30,3,41
Rapid Vienna,846,3,7,11,6,36,32,4,32
LASK Linz,846,4,8,7,9,28,28,0,31
SC Rheindorf,846,5,7,6,11,21,26,-5,27
Vienna,846,6,7,5,12,26,40,-14,26
Mattersburg,846,7,6,5,13,29,43,-14,23
FC Salzburg,847,1,16,6,2,47,17,30,54
SK Sturm Gra,847,2,12,5,7,32,29,3,41
Rapid Vienna,847,3,8,10,6,36,29,7,34
LASK Linz,847,4,8,7,9,25,28,-3,31
Mattersburg,847,5,7,5,12,34,41,-7,26
Vienna,847,6,6,5,13,24,42,-18,23
SC Rheindorf,847,7,5,6,13,19,31,-12,21
FC Salzburg,848,1,14,8,2,48,20,28,50
SK Sturm Gra,848,2,13,4,7,32,27,5,43
Rapid Vienna,848,3,8,11,5,37,29,8,35
LASK Linz,848,4,9,5,10,26,28,-2,32
SC Rheindorf,848,5,6,6,12,21,28,-7,24
Vienna,848,6,6,6,12,24,40,-16,24
Mattersburg,848,7,5,6,13,29,45,-16,21
FC Salzburg,849,1,14,8,2,50,21,29,50
SK Sturm Gra,849,2,12,4,8,36,32,4,40
Rapid Vienna,849,3,7,12,5,37,32,5,33
LASK Linz,849,4,9,6,9,30,28,2,33
SC Rheindorf,849,5,7,6,11,22,29,-7,27
Vienna,849,6,7,5,12,27,44,-17,26
Mattersburg,849,7,5,5,14,31,47,-16,20
FC Salzburg,850,1,14,8,2,46,19,27,50
SK Sturm Gra,850,2,11,6,7,31,30,1,39
Rapid Vienna,850,3,7,12,5,35,28,7,33
LASK Linz,850,4,8,7,9,26,28,-2,31
Vienna,850,5,7,5,12,26,39,-13,26
SC Rheindorf,850,6,6,6,12,25,32,-7,24
Mattersburg,850,7,6,6,12,32,45,-13,24
FC Salzburg,851,1,16,6,2,51,16,35,54
SK Sturm Gra,851,2,12,4,8,31,32,-1,40
Rapid Vienna,851,3,8,11,5,36,26,10,35
LASK Linz,851,4,7,8,9,26,28,-2,29
Vienna,851,5,7,5,12,26,42,-16,26
SC Rheindorf,851,6,5,7,12,21,32,-11,22
Mattersburg,851,7,5,7,12,31,46,-15,22
FC Salzburg,852,1,14,7,3,46,21,25,49
SK Sturm Gra,852,2,12,5,7,32,26,6,41
Rapid Vienna,852,3,8,10,6,37,30,7,34
LASK Linz,852,4,9,6,9,30,30,0,33
Mattersburg,852,5,7,5,12,35,46,-11,26
SC Rheindorf,852,6,6,6,12,19,30,-11,24
Vienna,852,7,6,5,13,26,42,-16,23
FC Salzburg,853,1,15,6,3,47,19,28,51
SK Sturm Gra,853,2,12,5,7,30,28,2,41
Rapid Vienna,853,3,8,11,5,36,27,9,35
LASK Linz,853,4,8,8,8,28,27,1,32
Vienna,853,5,7,5,12,25,39,-14,26
SC Rheindorf,853,6,6,6,12,20,28,-8,24
Mattersburg,853,7,5,5,14,31,49,-18,20
FC Salzburg,854,1,13,8,3,42,19,23,47
SK Sturm Gra,854,2,13,4,7,32,26,6,43
Rapid Vienna,854,3,9,10,5,36,25,11,37
LASK Linz,854,4,8,6,10,26,30,-4,30
Mattersburg,854,5,6,8,10,33,42,-9,26
Vienna,854,6,6,7,11,26,40,-14,25
SC Rheindorf,854,7,5,5,14,17,30,-13,20
FC Salzburg,855,1,14,7,3,45,19,26,49
SK Sturm Gra,855,2,12,4,8,32,31,1,40
LASK Linz,855,3,10,5,9,32,27,5,35
Rapid Vienna,855,4,8,10,6,37,31,6,34
Vienna,855,5,8,5,11,27,37,-10,29
Mattersburg,855,6,5,7,12,29,45,-16,22
SC Rheindorf,855,7,5,6,13,17,29,-12,21
FC Salzburg,856,1,13,7,4,42,20,22,46
SK Sturm Gra,856,2,11,4,9,33,33,0,37
Rapid Vienna,856,3,8,11,5,35,28,7,35
LASK Linz,856,4,10,5,9,32,30,2,35
Mattersburg,856,5,7,7,10,31,39,-8,28
Vienna,856,6,7,5,12,24,38,-14,26
SC Rheindorf,856,7,5,7,12,20,29,-9,22
FC Salzburg,857,1,15,7,2,46,18,28,52
Rapid Vienna,857,2,9,9,6,38,28,10,36
SK Sturm Gra,857,3,11,3,10,31,34,-3,36
LASK Linz,857,4,9,6,9,28,28,0,33
Vienna,857,5,7,6,11,27,40,-13,27
SC Rheindorf,857,6,7,5,12,24,31,-7,26
Mattersburg,857,7,5,6,13,30,45,-15,21
FC Salzburg,858,1,15,7,2,48,18,30,52
SK Sturm Gra,858,2,12,4,8,33,32,1,40
Rapid Vienna,858,3,9,9,6,39,27,12,36
LASK Linz,858,4,8,6,10,26,32,-6,30
Vienna,858,5,7,6,11,27,39,-12,27
Mattersburg,858,6,6,5,13,28,43,-15,23
SC Rheindorf,858,7,5,7,12,19,29,-10,22
FC Salzburg,859,1,14,6,4,46,25,21,48
SK Sturm Gra,859,2,12,4,8,36,31,5,40
Rapid Vienna,859,3,9,10,5,39,28,11,37
LASK Linz,859,4,9,7,8,28,27,1,34
Vienna,859,5,8,5,11,29,39,-10,29
SC Rheindorf,859,6,5,7,12,18,30,-12,22
Mattersburg,859,7,5,5,14,28,44,-16,20
FC Salzburg,860,1,16,6,2,48,18,30,54
SK Sturm Gra,860,2,12,4,8,35,30,5,40
Rapid Vienna,860,3,9,10,5,37,29,8,37
LASK Linz,860,4,8,6,10,27,30,-3,30
Vienna,860,5,6,6,12,25,41,-16,24
SC Rheindorf,860,6,6,5,13,17,28,-11,23
Mattersburg,860,7,5,7,12,31,44,-13,22
FC Salzburg,861,1,16,6,2,46,16,30,54
SK Sturm Gra,861,2,11,3,10,30,34,-4,36
LASK Linz,861,3,10,5,9,27,26,1,35
Rapid Vienna,861,4,8,10,6,36,27,9,34
Mattersburg,861,5,7,5,12,32,44,-12,26
SC Rheindorf,861,6,6,6,12,22,29,-7,24
Vienna,861,7,6,5,13,24,41,-17,23
FC Salzburg,862,1,14,6,4,45,22,23,48
SK Sturm Gra,862,2,13,4,7,34,28,6,43
Rapid Vienna,862,3,9,10,5,37,26,11,37
LASK Linz,862,4,9,6,9,31,30,1,33
Vienna,862,5,7,5,12,27,41,-14,26
Mattersburg,862,6,6,5,13,29,44,-15,23
SC Rheindorf,862,7,5,6,13,22,34,-12,21
FC Salzburg,863,1,13,7,4,42,20,22,46
SK Sturm Gra,863,2,14,4,6,37,28,9,46
Rapid Vienna,863,3,9,11,4,39,29,10,38
LASK Linz,863,4,7,5,12,25,32,-7,26
Mattersburg,863,5,6,8,10,32,41,-9,26
Vienna,863,6,6,6,12,24,39,-15,24
SC Rheindorf,863,7,5,7,12,21,31,-10,22
FC Salzburg,864,1,13,9,2,44,18,26,48
SK Sturm Gra,864,2,11,6,7,32,29,3,39
Rapid Vienna,864,3,9,10,5,35,25,10,37
LASK Linz,864,4,8,8,8,28,28,0,32
Vienna,864,5,7,6,11,29,40,-11,27
Mattersburg,864,6,6,6,12,38,46,-8,24
SC Rheindorf,864,7,4,7,13,16,36,-20,19
FC Salzburg,865,1,16,6,2,51,19,32,54
SK Sturm Gra,865,2,12,3,9,32,30,2,39
Rapid Vienna,865,3,9,9,6,34,27,7,36
LASK Linz,865,4,10,5,9,28,26,2,35
Mattersburg,865,5,7,5,12,35,45,-10,26
Vienna,865,6,6,5,13,25,44,-19,23
SC Rheindorf,865,7,5,5,14,17,31,-14,20
FC Salzburg,866,1,15,6,3,50,20,30,51
SK Sturm Gra,866,2,12,5,7,31,29,2,41
Rapid Vienna,866,3,9,10,5,37,28,9,37
LASK Linz,866,4,9,7,8,31,27,4,34
Vienna,866,5,7,5,12,27,45,-18,26
Mattersburg,866,6,5,6,13,31,46,-15,21
SC Rheindorf,866,7,5,5,14,19,31,-12,20
FC Salzburg,867,1,14,6,4,46,20,26,48
SK Sturm Gra,867,2,13,4,7,33,27,6,43
Rapid Vienna,867,3,9,9,6,39,29,10,36
Mattersburg,867,4,8,5,11,36,44,-8,29
LASK Linz,867,5,7,6,11,29,36,-7,27
Vienna,867,6,7,5,12,25,38,-13,26
SC Rheindorf,867,7,6,5,13,20,34,-14,23
FC Salzburg,868,1,14,6,4,48,21,27,48
SK Sturm Gra,868,2,13,5,6,31,25,6,44
Rapid Vienna,868,3,7,10,7,35,33,2,31
LASK Linz,868,4,8,6,10,28,29,-1,30
Mattersburg,868,5,8,6,10,36,41,-5,30
Vienna,868,6,6,6,12,26,43,-17,24
SC Rheindorf,868,7,5,7,12,18,30,-12,22
FC Salzburg,869,1,13,8,3,46,23,23,47
SK Sturm Gra,869,2,12,5,7,32,28,4,41
Rapid Vienna,869,3,9,11,4,34,24,10,38
LASK Linz,869,4,8,8,8,26,26,0,32
Vienna,869,5,7,5,12,26,40,-14,26
Mattersburg,869,6,5,8,11,30,41,-11,23
SC Rheindorf,869,7,4,7,13,18,30,-12,19
FC Salzburg,870,1,14,8,2,44,17,27,50
SK Sturm Gra,870,2,13,4,7,33,26,7,43
Rapid Vienna,870,3,8,9,7,35,32,3,33
LASK Linz,870,4,8,5,11,26,31,-5,29
Vienna,870,5,7,6,11,26,38,-12,27
Mattersburg,870,6,7,5,12,31,41,-10,26
SC Rheindorf,870,7,6,5,13,20,30,-10,23
FC Salzburg,871,1,13,9,2,43,18,25,48
Rapid Vienna,871,2,9,11,4,42,31,11,38
SK Sturm Gra,871,3,11,5,8,32,30,2,38
LASK Linz,871,4,9,6,9,32,30,2,33
Vienna,871,5,6,7,11,23,37,-14,25
SC Rheindorf,871,6,5,7,12,20,31,-11,22
Mattersburg,871,7,5,7,12,29,44,-15,22
FC Salzburg,872,1,16,6,2,49,19,30,54
SK Sturm Gra,872,2,12,3,9,30,30,0,39
Rapid Vienna,872,3,9,10,5,37,26,11,37
LASK Linz,872,4,8,7,9,28,28,0,31
Vienna,872,5,6,6,12,25,41,-16,24
Mattersburg,872,6,5,8,11,33,44,-11,23
SC Rheindorf,872,7,5,6,13,17,31,-14,21
FC Salzburg,873,1,12,9,3,39,17,22,45
SK Sturm Gra,873,2,13,4,7,34,28,6,43
Rapid Vienna,873,3,10,10,4,37,26,11,40
LASK Linz,873,4,9,6,9,30,29,1,33
Mattersburg,873,5,7,6,11,33,40,-7,27
Vienna,873,6,6,6,12,24,39,-15,24
SC Rheindorf,873,7,4,5,15,16,34,-18,17
FC Salzburg,874,1,15,7,2,47,19,28,52
SK Sturm Gra,874,2,13,3,8,36,30,6,42
Rapid Vienna,874,3,7,10,7,33,31,2,31
LASK Linz,874,4,7,7,10,24,30,-6,28
Vienna,874,5,7,6,11,28,39,-11,27
Mattersburg,874,6,7,5,12,33,44,-11,26
SC Rheindorf,874,7,6,6,12,21,29,-8,24
FC Salzburg,875,1,14,8,2,46,21,25,50
SK Sturm Gra,875,2,13,4,7,30,25,5,43
Rapid Vienna,875,3,8,11,5,39,30,9,35
LASK Linz,875,4,10,5,9,31,28,3,35
Vienna,875,5,7,5,12,25,39,-14,26
Mattersburg,875,6,6,6,12,31,41,-10,24
SC Rheindorf,875,7,4,5,15,17,35,-18,17
FC Salzburg,876,1,16,6,2,46,16,30,54
SK Sturm Gra,876,2,13,4,7,35,29,6,43
Rapid Vienna,876,3,8,9,7,36,29,7,33
LASK Linz,876,4,8,6,10,28,31,-3,30
Vienna,876,5,7,5,12,27,42,-15,26
Mattersburg,876,6,6,6,12,35,44,-9,24
SC Rheindorf,876,7,5,6,13,18,34,-16,21
FC Salzburg,877,1,14,6,4,41,21,20,48
SK Sturm Gra,877,2,14,4,6,35,25,10,46
Rapid Vienna,877,3,9,10,5,38,27,11,37
LASK Linz,877,4,7,6,11,25,29,-4,27
Mattersburg,877,5,7,5,12,29,40,-11,26
Vienna,877,6,7,5,12,25,39,-14,26
SC Rheindorf,877,7,5,6,13,18,30,-12,21
FC Salzburg,878,1,14,7,3,43,17,26,49
SK Sturm Gra,878,2,12,3,9,32,32,0,39
Rapid Vienna,878,3,8,9,7,35,30,5,33
LASK Linz,878,4,9,5,10,33,33,0,32
Vienna,878,5,7,6,11,26,38,-12,27
SC Rheindorf,878,6,7,5,12,21,30,-9,26
Mattersburg,878,7,7,5,12,32,42,-10,26
FC Salzburg,879,1,14,8,2,49,19,30,50
SK Sturm Gra,879,2,13,4,7,34,28,6,43
Rapid Vienna,879,3,8,11,5,36,31,5,35
LASK Linz,879,4,8,7,9,27,28,-1,31
Vienna,879,5,6,7,11,26,40,-14,25
Mattersburg,879,6,6,6,12,30,43,-13,24
SC Rheindorf,879,7,4,7,13,21,34,-13,19
FC Salzburg,880,1,13,7,4,42,21,21,46
SK Sturm Gra,880,2,13,3,8,32,28,4,42
Rapid Vienna,880,3,8,11,5,33,26,7,35
LASK Linz,880,4,9,6,9,30,29,1,33
Vienna,880,5,8,5,11,26,37,-11,29
Mattersburg,880,6,7,6,11,31,40,-9,27
SC Rheindorf,880,7,4,6,14,16,29,-13,18
FC Salzburg,881,1,13,7,4,43,21,22,46
SK Sturm Gra,881,2,12,5,7,31,28,3,41
Rapid Vienna,881,3,7,12,5,32,25,7,33
LASK Linz,881,4,8,7,9,25,26,-1,31
Mattersburg,881,5,7,6,11,32,42,-10,27
Vienna,881,6,7,5,12,26,39,-13,26
SC Rheindorf,881,7,6,6,12,20,28,-8,24
FC Salzburg,882,1,14,7,3,41,17,24,49
SK Sturm Gra,882,2,14,3,7,37,30,7,45
Rapid Vienna,882,3,8,10,6,38,29,9,34
LASK Linz,882,4,8,7,9,27,28,-1,31
Mattersburg,882,5,6,7,11,30,39,-9,25
Vienna,882,6,6,6,12,23,39,-16,24
SC Rheindorf,882,7,5,6,13,18,32,-14,21
FC Salzburg,883,1,15,7,2,48,15,33,52
SK Sturm Gra,883,2,13,3,8,35,28,7,42
Rapid Vienna,883,3,9,10,5,37,30,7,37
LASK Linz,883,4,7,7,10,26,33,-7,28
Mattersburg,883,5,6,7,11,29,41,-12,25
Vienna,883,6,6,7,11,24,38,-14,25
SC Rheindorf,883,7,4,7,13,16,30,-14,19
FC Salzburg,884,1,13,7,4,42,19,23,46
Rapid Vienna,884,2,10,10,4,36,24,12,40
SK Sturm Gra,884,3,11,6,7,30,27,3,39
LASK Linz,884,4,9,6,9,27,27,0,33
Mattersburg,884,5,6,6,12,30,41,-11,24
Vienna,884,6,6,6,12,25,42,-17,24
SC Rheindorf,884,7,5,7,12,19,29,-10,22
FC Salzburg,885,1,16,6,2,47,18,29,54
SK Sturm Gra,885,2,12,4,8,31,29,2,40
Rapid Vienna,885,3,9,9,6,37,28,9,36
LASK Linz,885,4,9,6,9,30,28,2,33
Vienna,885,5,7,5,12,27,41,-14,26
SC Rheindorf,885,6,6,5,13,20,30,-10,23
Mattersburg,885,7,5,5,14,31,49,-18,20
FC Salzburg,886,1,12,10,2,41,18,23,46
SK Sturm Gra,886,2,12,5,7,32,27,5,41
Rapid Vienna,886,3,8,12,4,35,25,10,36
LASK Linz,886,4,9,6,9,28,27,1,33
Mattersburg,886,5,7,7,10,30,38,-8,28
Vienna,886,6,6,6,12,25,40,-15,24
SC Rheindorf,886,7,4,6,14,18,34,-16,18
FC Salzburg,887,1,16,6,2,47,17,30,54
SK Sturm Gra,887,2,12,3,9,30,29,1,39
LASK Linz,887,3,10,6,8,30,27,3,36
Rapid Vienna,887,4,8,9,7,36,28,8,33
Vienna,887,5,7,5,12,26,41,-15,26
SC Rheindorf,887,6,5,7,12,19,32,-13,22
Mattersburg,887,7,5,6,13,28,42,-14,21
FC Salzburg,888,1,13,7,4,40,18,22,46
SK Sturm Gra,888,2,12,5,7,32,28,4,41
Rapid Vienna,888,3,10,9,5,36,26,10,39
LASK Linz,888,4,9,5,10,28,29,-1,32
Vienna,888,5,7,6,11,26,38,-12,27
SC Rheindorf,888,6,6,6,12,20,28,-8,24
Mattersburg,888,7,5,6,13,29,44,-15,21
FC Salzburg,889,1,14,7,3,48,19,29,49
SK Sturm Gra,889,2,13,3,8,35,31,4,42
Rapid Vienna,889,3,8,10,6,35,29,6,34
LASK Linz,889,4,9,5,10,31,32,-1,32
SC Rheindorf,889,5,7,5,12,22,31,-9,26
Mattersburg,889,6,7,5,12,34,45,-11,26
Vienna,889,7,6,5,13,24,42,-18,23
FC Salzburg,890,1,15,6,3,46,16,30,51
SK Sturm Gra,890,2,13,4,7,35,26,9,43
Rapid Vienna,890,3,8,9,7,33,31,2,33
LASK Linz,890,4,9,6,9,27,27,0,33
Mattersburg,890,5,7,6,11,31,41,-10,27
Vienna,890,6,7,5,12,26,43,-17,26
SC Rheindorf,890,7,4,6,14,18,32,-14,18
FC Salzburg,891,1,15,7,2,48,17,31,52
SK Sturm Gra,891,2,11,5,8,31,31,0,38
LASK Linz,891,3,10,6,8,29,25,4,36
Rapid Vienna,891,4,7,11,6,34,29,5,32
Vienna,891,5,7,5,12,24,41,-17,26
Mattersburg,891,6,6,5,13,29,42,-13,23
SC Rheindorf,891,7,5,7,12,17,27,-10,22
FC Salzburg,892,1,15,6,3,46,21,25,51
SK Sturm Gra,892,2,13,3,8,34,32,2,42
Rapid Vienna,892,3,9,9,6,40,32,8,36
LASK Linz,892,4,8,6,10,29,32,-3,30
Mattersburg,892,5,7,5,12,36,44,-8,26
Vienna,892,6,7,5,12,27,40,-13,26
SC Rheindorf,892,7,5,6,13,22,33,-11,21
FC Salzburg,893,1,16,6,2,47,16,31,54
SK Sturm Gra,893,2,12,4,8,31,32,-1,40
Rapid Vienna,893,3,10,9,5,38,26,12,39
LASK Linz,893,4,8,5,11,25,29,-4,29
Mattersburg,893,5,7,6,11,32,41,-9,27
Vienna,893,6,6,6,12,24,39,-15,24
SC Rheindorf,893,7,4,6,14,18,32,-14,18
FC Salzburg,894,1,14,7,3,44,17,27,49
SK Sturm Gra,894,2,12,4,8,31,31,0,40
Rapid Vienna,894,3,9,10,5,37,27,10,37
Mattersburg,894,4,8,5,11,32,40,-8,29
LASK Linz,894,5,7,7,10,29,33,-4,28
Vienna,894,6,7,6,11,26,39,-13,27
SC Rheindorf,894,7,5,5,14,17,29,-12,20
FC Salzburg,895,1,16,6,2,48,17,31,54
SK Sturm Gra,895,2,13,4,7,31,28,3,43
Rapid Vienna,895,3,8,9,7,35,29,6,33
LASK Linz,895,4,9,5,10,26,30,-4,32
Vienna,895,5,7,5,12,24,38,-14,26
SC Rheindorf,895,6,6,6,12,24,28,-4,24
Mattersburg,895,7,5,5,14,27,45,-18,20
FC Salzburg,896,1,14,7,3,45,18,27,49
SK Sturm Gra,896,2,15,3,6,38,26,12,48
Rapid Vienna,896,3,8,10,6,34,31,3,34
LASK Linz,896,4,8,7,9,27,30,-3,31
Mattersburg,896,5,6,6,12,29,41,-12,24
Vienna,896,6,6,5,13,24,42,-18,23
SC Rheindorf,896,7,5,6,13,19,28,-9,21
FC Salzburg,897,1,15,7,2,51,21,30,52
SK Sturm Gra,897,2,12,5,7,32,29,3,41
Rapid Vienna,897,3,7,11,6,36,32,4,32
LASK Linz,897,4,8,7,9,29,30,-1,31
SC Rheindorf,897,5,7,6,11,24,29,-5,27
Vienna,897,6,7,5,12,29,42,-13,26
Mattersburg,897,7,5,5,14,29,47,-18,20
FC Salzburg,898,1,13,6,5,41,19,22,45
Rapid Vienna,898,2,11,9,4,42,25,17,42
SK Sturm Gra,898,3,11,4,9,34,35,-1,37
LASK Linz,898,4,8,7,9,29,30,-1,31
Mattersburg,898,5,7,7,10,32,40,-8,28
Vienna,898,6,7,5,12,24,38,-14,26
SC Rheindorf,898,7,5,6,13,21,36,-15,21
FC Salzburg,899,1,13,7,4,45,22,23,46
SK Sturm Gra,899,2,12,6,6,37,31,6,42
Rapid Vienna,899,3,9,10,5,37,28,9,37
LASK Linz,899,4,9,7,8,30,29,1,34
Mattersburg,899,5,7,5,12,32,40,-8,26
Vienna,899,6,7,5,12,26,41,-15,26
SC Rheindorf,899,7,4,6,14,18,34,-16,18
FC Salzburg,900,1,14,6,4,44,22,22,48
SK Sturm Gra,900,2,14,4,6,36,29,7,46
LASK Linz,900,3,8,7,9,31,31,0,31
Rapid Vienna,900,4,7,9,8,35,33,2,30
Vienna,900,5,8,5,11,28,38,-10,29
SC Rheindorf,900,6,5,8,11,20,28,-8,23
Mattersburg,900,7,5,7,12,29,42,-13,22
FC Salzburg,901,1,16,6,2,47,17,30,54
SK Sturm Gra,901,2,12,5,7,35,32,3,41
Rapid Vienna,901,3,7,11,6,36,32,4,32
LASK Linz,901,4,8,8,8,30,30,0,32
Vienna,901,5,6,6,12,24,39,-15,24
SC Rheindorf,901,6,5,8,11,20,29,-9,23
Mattersburg,901,7,5,6,13,28,41,-13,21
FC Salzburg,902,1,14,6,4,46,19,27,48
SK Sturm Gra,902,2,14,3,7,33,28,5,45
Rapid Vienna,902,3,8,9,7,35,30,5,33
LASK Linz,902,4,8,6,10,27,29,-2,30
Vienna,902,5,7,5,12,26,40,-14,26
Mattersburg,902,6,6,7,11,31,43,-12,25
SC Rheindorf,902,7,6,6,12,19,28,-9,24
FC Salzburg,903,1,15,6,3,46,18,28,51
Rapid Vienna,903,2,11,9,4,40,25,15,42
SK Sturm Gra,903,3,12,4,8,31,29,2,40
LASK Linz,903,4,9,5,10,26,29,-3,32
Mattersburg,903,5,7,5,12,30,39,-9,26
Vienna,903,6,6,5,13,23,41,-18,23
SC Rheindorf,903,7,4,6,14,15,30,-15,18
FC Salzburg,904,1,14,7,3,46,19,27,49
SK Sturm Gra,904,2,12,4,8,31,33,-2,40
Rapid Vienna,904,3,9,10,5,37,26,11,37
LASK Linz,904,4,8,6,10,26,29,-3,30
Vienna,904,5,7,6,11,27,39,-12,27
Mattersburg,904,6,6,7,11,30,40,-10,25
SC Rheindorf,904,7,5,6,13,20,31,-11,21
FC Salzburg,905,1,16,6,2,47,17,30,54
SK Sturm Gra,905,2,13,3,8,35,30,5,42
Rapid Vienna,905,3,7,11,6,34,29,5,32
LASK Linz,905,4,8,7,9,26,29,-3,31
Vienna,905,5,7,5,12,25,40,-15,26
Mattersburg,905,6,6,6,12,32,43,-11,24
SC Rheindorf,905,7,4,8,12,18,29,-11,20
FC Salzburg,906,1,15,7,2,46,19,27,52
SK Sturm Gra,906,2,13,5,6,35,29,6,44
Rapid Vienna,906,3,8,10,6,36,28,8,34
LASK Linz,906,4,9,6,9,30,30,0,33
Mattersburg,906,5,6,6,12,31,42,-11,24
Vienna,906,6,6,6,12,25,41,-16,24
SC Rheindorf,906,7,4,6,14,18,32,-14,18
FC Salzburg,907,1,12,9,3,42,20,22,45
SK Sturm Gra,907,2,13,3,8,32,28,4,42
Rapid Vienna,907,3,9,11,4,35,25,10,38
LASK Linz,907,4,8,7,9,25,25,0,31
Vienna,907,5,7,6,11,25,38,-13,27
SC Rheindorf,907,6,6,5,13,21,31,-10,23
Mattersburg,907,7,5,7,12,28,41,-13,22
FC Salzburg,908,1,13,9,2,43,17,26,48
Rapid Vienna,908,2,9,11,4,33,23,10,38
SK Sturm Gra,908,3,11,3,10,28,31,-3,36
LASK Linz,908,4,8,6,10,26,29,-3,30
Vienna,908,5,7,6,11,28,39,-11,27
SC Rheindorf,908,6,7,5,12,20,27,-7,26
Mattersburg,908,7,6,6,12,31,43,-12,24
FC Salzburg,909,1,14,8,2,43,17,26,50
SK Sturm Gra,909,2,12,4,8,31,28,3,40
Rapid Vienna,909,3,8,12,4,35,26,9,36
LASK Linz,909,4,8,5,11,28,31,-3,29
SC Rheindorf,909,5,7,6,11,23,28,-5,27
Vienna,909,6,7,6,11,25,38,-13,27
Mattersburg,909,7,5,5,14,29,46,-17,20
FC Salzburg,910,1,14,7,3,47,20,27,49
SK Sturm Gra,910,2,12,5,7,32,28,4,41
Rapid Vienna,910,3,9,10,5,37,27,10,37
LASK Linz,910,4,9,6,9,27,27,0,33
Vienna,910,5,7,6,11,26,39,-13,27
Mattersburg,910,6,6,5,13,27,42,-15,23
SC Rheindorf,910,7,5,5,14,18,31,-13,20
FC Salzburg,911,1,13,8,3,42,20,22,47
Rapid Vienna,911,2,10,9,5,36,25,11,39
SK Sturm Gra,911,3,11,5,8,30,28,2,38
LASK Linz,911,4,8,6,10,27,29,-2,30
Vienna,911,5,7,6,11,27,39,-12,27
Mattersburg,911,6,6,7,11,29,39,-10,25
SC Rheindorf,911,7,5,7,12,20,31,-11,22
FC Salzburg,912,1,16,6,2,46,19,27,54
SK Sturm Gra,912,2,11,4,9,32,32,0,37
Rapid Vienna,912,3,8,11,5,35,27,8,35
LASK Linz,912,4,9,6,9,29,29,0,33
Mattersburg,912,5,7,5,12,31,40,-9,26
SC Rheindorf,912,6,6,5,13,20,30,-10,23
Vienna,912,7,6,5,13,25,41,-16,23
FC Salzburg,913,1,13,8,3,44,20,24,47
SK Sturm Gra,913,2,12,5,7,34,29,5,41
Rapid Vienna,913,3,9,11,4,36,24,12,38
LASK Linz,913,4,8,7,9,30,31,-1,31
Mattersburg,913,5,6,7,11,30,41,-11,25
Vienna,913,6,6,6,12,23,41,-18,24
SC Rheindorf,913,7,5,6,13,19,30,-11,21
FC Salzburg,914,1,15,7,2,45,18,27,52
SK Sturm Gra,914,2,12,3,9,31,28,3,39
Rapid Vienna,914,3,9,9,6,34,26,8,36
LASK Linz,914,4,8,5,11,27,32,-5,29
Vienna,914,5,7,6,11,26,39,-13,27
SC Rheindorf,914,6,6,6,12,19,28,-9,24
Mattersburg,914,7,6,6,12,30,41,-11,24
FC Salzburg,915,1,14,7,3,44,19,25,49
Rapid Vienna,915,2,11,9,4,38,24,14,42
SK Sturm Gra,915,3,11,4,9,30,31,-1,37
LASK Linz,915,4,9,6,9,28,28,0,33
Mattersburg,915,5,6,6,12,29,40,-11,24
Vienna,915,6,6,5,13,25,41,-16,23
SC Rheindorf,915,7,5,7,12,19,30,-11,22
FC Salzburg,916,1,15,6,3,46,20,26,51
SK Sturm Gra,916,2,11,5,8,32,30,2,38
Rapid Vienna,916,3,8,11,5,34,26,8,35
LASK Linz,916,4,8,6,10,26,32,-6,30
Vienna,916,5,7,6,11,26,39,-13,27
SC Rheindorf,916,6,6,6,12,21,29,-8,24
Mattersburg,916,7,6,6,12,32,41,-9,24
FC Salzburg,917,1,13,7,4,43,20,23,46
SK Sturm Gra,917,2,12,6,6,33,27,6,42
Rapid Vienna,917,3,8,11,5,35,28,7,35
LASK Linz,917,4,7,8,9,25,29,-4,29
Mattersburg,917,5,8,5,11,32,39,-7,29
Vienna,917,6,7,5,12,26,40,-14,26
SC Rheindorf,917,7,4,8,12,18,29,-11,20
FC Salzburg,918,1,15,7,2,45,15,30,52
SK Sturm Gra,918,2,11,5,8,30,31,-1,38
Rapid Vienna,918,3,9,10,5,39,31,8,37
LASK Linz,918,4,7,7,10,26,30,-4,28
Mattersburg,918,5,7,5,12,32,40,-8,26
SC Rheindorf,918,6,6,6,12,24,32,-8,24
Vienna,918,7,6,6,12,23,40,-17,24
FC Salzburg,919,1,13,8,3,42,19,23,47
SK Sturm Gra,919,2,13,4,7,35,31,4,43
Rapid Vienna,919,3,8,12,4,35,26,9,36
LASK Linz,919,4,8,6,10,28,31,-3,30
Vienna,919,5,7,6,11,28,38,-10,27
SC Rheindorf,919,6,6,5,13,20,28,-8,23
Mattersburg,919,7,6,5,13,31,46,-15,23
FC Salzburg,920,1,14,8,2,46,20,26,50
SK Sturm Gra,920,2,14,4,6,36,27,9,46
Rapid Vienna,920,3,7,11,6,34,29,5,32
LASK Linz,920,4,8,6,10,25,30,-5,30
SC Rheindorf,920,5,6,6,12,22,28,-6,24
Mattersburg,920,6,6,6,12,29,41,-12,24
Vienna,920,7,6,5,13,25,42,-17,23
FC Salzburg,921,1,13,9,2,43,18,25,48
SK Sturm Gra,921,2,12,5,7,29,26,3,41
Rapid Vienna,921,3,8,12,4,35,25,10,36
LASK Linz,921,4,9,7,8,27,26,1,34
Mattersburg,921,5,7,6,11,32,40,-8,27
Vienna,921,6,6,6,12,24,40,-16,24
SC Rheindorf,921,7,4,5,15,16,31,-15,17
FC Salzburg,922,1,15,7,2,44,16,28,52
SK Sturm Gra,922,2,11,5,8,29,27,2,38
Rapid Vienna,922,3,8,11,5,34,26,8,35
LASK Linz,922,4,7,8,9,27,31,-4,29
Mattersburg,922,5,7,6,11,32,41,-9,27
Vienna,922,6,6,6,12,23,38,-15,24
SC Rheindorf,922,7,5,7,12,20,30,-10,22
FC Salzburg,923,1,16,6,2,46,16,30,54
SK Sturm Gra,923,2,12,3,9,32,31,1,39
Rapid Vienna,923,3,8,10,6,38,31,7,34
LASK Linz,923,4,7,8,9,27,30,-3,29
SC Rheindorf,923,5,6,7,11,20,28,-8,25
Mattersburg,923,6,6,7,11,29,40,-11,25
Vienna,923,7,6,5,13,23,39,-16,23
FC Salzburg,924,1,14,6,4,43,18,25,48
SK Sturm Gra,924,2,14,4,6,35,27,8,46
Rapid Vienna,924,3,7,10,7,33,29,4,31
LASK Linz,924,4,8,7,9,27,28,-1,31
Mattersburg,924,5,7,6,11,36,41,-5,27
Vienna,924,6,7,5,12,25,43,-18,26
SC Rheindorf,924,7,5,6,13,18,31,-13,21
FC Salzburg,925,1,14,8,2,48,20,28,50
Rapid Vienna,925,2,10,10,4,38,24,14,40
SK Sturm Gra,925,3,11,5,8,33,32,1,38
LASK Linz,925,4,8,7,9,27,27,0,31
Vienna,925,5,6,7,11,25,39,-14,25
Mattersburg,925,6,6,6,12,30,44,-14,24
SC Rheindorf,925,7,4,7,13,16,31,-15,19
FC Salzburg,926,1,15,6,3,46,17,29,51
SK Sturm Gra,926,2,14,3,7,36,29,7,45
Rapid Vienna,926,3,9,9,6,36,29,7,36
LASK Linz,926,4,8,7,9,27,29,-2,31
Vienna,926,5,7,5,12,25,38,-13,26
SC Rheindorf,926,6,5,6,13,17,29,-12,21
Mattersburg,926,7,5,6,13,28,44,-16,21
FC Salzburg,927,1,14,7,3,44,20,24,49
SK Sturm Gra,927,2,13,3,8,36,30,6,42
Rapid Vienna,927,3,9,10,5,37,29,8,37
LASK Linz,927,4,8,7,9,28,27,1,31
Vienna,927,5,7,6,11,26,38,-12,27
SC Rheindorf,927,6,6,5,13,19,31,-12,23
Mattersburg,927,7,5,6,13,27,42,-15,21
FC Salzburg,928,1,15,7,2,48,18,30,52
SK Sturm Gra,928,2,14,3,7,33,26,7,45
LASK Linz,928,3,9,5,10,28,29,-1,32
Rapid Vienna,928,4,7,10,7,37,33,4,31
Mattersburg,928,5,7,6,11,37,41,-4,27
Vienna,928,6,6,5,13,23,44,-21,23
SC Rheindorf,928,7,5,6,13,23,38,-15,21
FC Salzburg,929,1,14,8,2,41,16,25,50
SK Sturm Gra,929,2,13,4,7,31,26,5,43
Rapid Vienna,929,3,9,9,6,35,26,9,36
LASK Linz,929,4,8,6,10,27,29,-2,30
Mattersburg,929,5,6,7,11,33,43,-10,25
SC Rheindorf,929,6,6,5,13,20,30,-10,23
Vienna,929,7,6,5,13,26,43,-17,23
FC Salzburg,930,1,15,6,3,46,21,25,51
SK Sturm Gra,930,2,12,3,9,32,29,3,39
Rapid Vienna,930,3,9,10,5,39,29,10,37
LASK Linz,930,4,8,6,10,28,33,-5,30
Mattersburg,930,5,7,5,12,36,44,-8,26
SC Rheindorf,930,6,7,5,12,20,28,-8,26
Vienna,930,7,6,5,13,24,41,-17,23
FC Salzburg,931,1,15,6,3,50,17,33,51
SK Sturm Gra,931,2,12,3,9,30,31,-1,39
Rapid Vienna,931,3,9,11,4,37,27,10,38
LASK Linz,931,4,8,6,10,31,32,-1,30
Mattersburg,931,5,7,5,12,34,49,-15,26
Vienna,931,6,7,5,12,28,44,-16,26
SC Rheindorf,931,7,5,6,13,22,32,-10,21
FC Salzburg,932,1,14,8,2,47,20,27,50
SK Sturm Gra,932,2,14,3,7,34,28,6,45
Rapid Vienna,932,3,8,11,5,38,30,8,35
LASK Linz,932,4,7,6,11,25,30,-5,27
Vienna,932,5,7,6,11,29,41,-12,27
Mattersburg,932,6,6,6,12,29,42,-13,24
SC Rheindorf,932,7,5,6,13,20,31,-11,21
FC Salzburg,933,1,15,7,2,42,16,26,52
SK Sturm Gra,933,2,12,5,7,33,28,5,41
LASK Linz,933,3,9,6,9,26,25,1,33
Rapid Vienna,933,4,7,11,6,34,29,5,32
Mattersburg,933,5,8,5,11,33,37,-4,29
Vienna,933,6,6,5,13,23,42,-19,23
SC Rheindorf,933,7,5,5,14,19,33,-14,20
FC Salzburg,934,1,15,6,3,49,19,30,51
SK Sturm Gra,934,2,13,3,8,30,32,-2,42
Rapid Vienna,934,3,9,9,6,36,28,8,36
LASK Linz,934,4,9,5,10,28,26,2,32
Mattersburg,934,5,7,5,12,33,42,-9,26
Vienna,934,6,7,5,12,26,39,-13,26
SC Rheindorf,934,7,5,5,14,17,33,-16,20
FC Salzburg,935,1,16,6,2,44,16,28,54
Rapid Vienna,935,2,10,9,5,36,25,11,39
SK Sturm Gra,935,3,12,3,9,32,31,1,39
LASK Linz,935,4,7,7,10,25,30,-5,28
SC Rheindorf,935,5,6,6,12,20,26,-6,24
Mattersburg,935,6,6,6,12,29,42,-13,24
Vienna,935,7,6,5,13,23,39,-16,23
FC Salzburg,936,1,13,8,3,43,20,23,47
SK Sturm Gra,936,2,13,4,7,34,29,5,43
Rapid Vienna,936,3,8,10,6,35,28,7,34
LASK Linz,936,4,8,6,10,27,27,0,30
SC Rheindorf,936,5,7,6,11,19,26,-7,27
Mattersburg,936,6,6,6,12,30,43,-13,24
Vienna,936,7,6,6,12,25,40,-15,24
FC Salzburg,937,1,14,8,2,48,19,29,50
SK Sturm Gra,937,2,12,4,8,32,32,0,40
Rapid Vienna,937,3,8,9,7,39,34,5,33
LASK Linz,937,4,8,6,10,27,30,-3,30
Vienna,937,5,7,6,11,27,40,-13,27
Mattersburg,937,6,6,7,11,31,40,-9,25
SC Rheindorf,937,7,6,6,12,18,27,-9,24
FC Salzburg,938,1,15,7,2,46,19,27,52
SK Sturm Gra,938,2,12,5,7,33,30,3,41
Rapid Vienna,938,3,7,11,6,34,28,6,32
LASK Linz,938,4,8,6,10,28,29,-1,30
Vienna,938,5,7,5,12,24,38,-14,26
Mattersburg,938,6,6,6,12,33,43,-10,24
SC Rheindorf,938,7,6,6,12,19,30,-11,24
FC Salzburg,939,1,15,7,2,50,18,32,52
SK Sturm Gra,939,2,11,5,8,33,33,0,38
LASK Linz,939,3,9,5,10,28,26,2,32
Rapid Vienna,939,4,7,11,6,34,35,-1,32
Vienna,939,5,7,6,11,28,39,-11,27
Mattersburg,939,6,6,6,12,28,41,-13,24
SC Rheindorf,939,7,5,8,11,18,27,-9,23
FC Salzburg,940,1,14,7,3,48,20,28,49
Rapid Vienna,940,2,9,10,5,38,28,10,37
SK Sturm Gra,940,3,11,3,10,32,36,-4,36
LASK Linz,940,4,9,5,10,27,30,-3,32
Mattersburg,940,5,7,6,11,32,40,-8,27
SC Rheindorf,940,6,7,5,12,21,28,-7,26
Vienna,940,7,6,6,12,26,42,-16,24
FC Salzburg,941,1,15,6,3,48,17,31,51
Rapid Vienna,941,2,10,9,5,39,29,10,39
SK Sturm Gra,941,3,12,3,9,36,33,3,39
LASK Linz,941,4,8,6,10,29,37,-8,30
Vienna,941,5,8,5,11,25,37,-12,29
SC Rheindorf,941,6,5,7,12,19,29,-10,22
Mattersburg,941,7,5,6,13,29,43,-14,21
FC Salzburg,942,1,16,6,2,48,16,32,54
SK Sturm Gra,942,2,14,3,7,34,28,6,45
Rapid Vienna,942,3,8,10,6,38,30,8,34
LASK Linz,942,4,8,7,9,27,29,-2,31
Vienna,942,5,7,5,12,28,40,-12,26
Mattersburg,942,6,5,6,13,29,45,-16,21
SC Rheindorf,942,7,5,5,14,17,33,-16,20
FC Salzburg,943,1,14,7,3,45,19,26,49
SK Sturm Gra,943,2,13,3,8,33,29,4,42
Rapid Vienna,943,3,9,9,6,36,29,7,36
LASK Linz,943,4,10,5,9,28,28,0,35
Vienna,943,5,7,6,11,26,38,-12,27
SC Rheindorf,943,6,5,6,13,20,31,-11,21
Mattersburg,943,7,5,6,13,29,43,-14,21
FC Salzburg,944,1,14,8,2,46,19,27,50
Rapid Vienna,944,2,9,10,5,34,26,8,37
SK Sturm Gra,944,3,11,4,9,30,30,0,37
LASK Linz,944,4,10,6,8,29,26,3,36
Mattersburg,944,5,7,7,10,35,42,-7,28
Vienna,944,6,6,5,13,26,44,-18,23
SC Rheindorf,944,7,4,6,14,17,30,-13,18
FC Salzburg,945,1,13,8,3,44,16,28,47
SK Sturm Gra,945,2,11,4,9,30,37,-7,37
Rapid Vienna,945,3,8,11,5,36,26,10,35
LASK Linz,945,4,9,6,9,25,26,-1,33
Vienna,945,5,7,6,11,24,37,-13,27
Mattersburg,945,6,7,5,12,30,39,-9,26
SC Rheindorf,945,7,6,6,12,22,30,-8,24
FC Salzburg,946,1,14,7,3,47,18,29,49
SK Sturm Gra,946,2,12,5,7,31,28,3,41
Rapid Vienna,946,3,8,10,6,33,26,7,34
LASK Linz,946,4,8,7,9,25,26,-1,31
Vienna,946,5,7,5,12,28,42,-14,26
SC Rheindorf,946,6,6,6,12,19,27,-8,24
Mattersburg,946,7,6,6,12,29,45,-16,24
FC Salzburg,947,1,14,7,3,43,19,24,49
SK Sturm Gra,947,2,12,4,8,36,32,4,40
Rapid Vienna,947,3,9,10,5,37,28,9,37
LASK Linz,947,4,8,5,11,25,33,-8,29
Mattersburg,947,5,7,5,12,31,40,-9,26
Vienna,947,6,7,5,12,27,40,-13,26
SC Rheindorf,947,7,6,6,12,21,28,-7,24
FC Salzburg,948,1,13,9,2,41,17,24,48
SK Sturm Gra,948,2,13,5,6,34,26,8,44
Rapid Vienna,948,3,7,11,6,32,26,6,32
LASK Linz,948,4,8,7,9,29,30,-1,31
Mattersburg,948,5,6,8,10,36,44,-8,26
Vienna,948,6,6,7,11,26,40,-14,25
SC Rheindorf,948,7,4,7,13,17,32,-15,19
FC Salzburg,949,1,14,7,3,49,22,27,49
SK Sturm Gra,949,2,13,3,8,33,32,1,42
Rapid Vienna,949,3,9,9,6,36,29,7,36
LASK Linz,949,4,9,6,9,28,27,1,33
Vienna,949,5,7,6,11,29,42,-13,27
Mattersburg,949,6,6,5,13,33,44,-11,23
SC Rheindorf,949,7,5,6,13,20,32,-12,21
FC Salzburg,950,1,16,6,2,46,18,28,54
SK Sturm Gra,950,2,13,3,8,33,28,5,42
Rapid Vienna,950,3,10,9,5,37,27,10,39
LASK Linz,950,4,8,5,11,24,32,-8,29
Vienna,950,5,7,5,12,25,38,-13,26
SC Rheindorf,950,6,6,5,13,23,30,-7,23
Mattersburg,950,7,5,5,14,29,44,-15,20
FC Salzburg,951,1,14,6,4,45,20,25,48
SK Sturm Gra,951,2,13,5,6,31,24,7,44
Rapid Vienna,951,3,8,11,5,34,26,8,35
LASK Linz,951,4,7,6,11,23,28,-5,27
Mattersburg,951,5,7,6,11,34,44,-10,27
Vienna,951,6,7,6,11,27,40,-13,27
SC Rheindorf,951,7,5,6,13,19,31,-12,21
FC Salzburg,952,1,14,7,3,43,18,25,49
LASK Linz,952,2,11,5,8,32,25,7,38
SK Sturm Gra,952,3,11,4,9,28,28,0,37
Rapid Vienna,952,4,8,11,5,35,28,7,35
Vienna,952,5,8,5,11,28,37,-9,29
Mattersburg,952,6,6,5,13,31,47,-16,23
SC Rheindorf,952,7,4,7,13,19,33,-14,19
FC Salzburg,953,1,14,7,3,44,18,26,49
SK Sturm Gra,953,2,13,4,7,35,28,7,43
Rapid Vienna,953,3,7,11,6,35,33,2,32
LASK Linz,953,4,8,6,10,26,29,-3,30
Mattersburg,953,5,7,5,12,31,41,-10,26
Vienna,953,6,7,5,12,24,38,-14,26
SC Rheindorf,953,7,6,6,12,22,30,-8,24
FC Salzburg,954,1,16,6,2,46,15,31,54
Rapid Vienna,954,2,9,9,6,35,25,10,36
SK Sturm Gra,954,3,11,3,10,28,34,-6,36
LASK Linz,954,4,9,5,10,29,29,0,32
Mattersburg,954,5,7,5,12,31,43,-12,26
Vienna,954,6,7,5,12,26,39,-13,26
SC Rheindorf,954,7,6,5,13,20,30,-10,23
FC Salzburg,955,1,16,6,2,50,18,32,54
SK Sturm Gra,955,2,12,3,9,31,33,-2,39
Rapid Vienna,955,3,9,9,6,36,28,8,36
LASK Linz,955,4,8,6,10,28,30,-2,30
Mattersburg,955,5,7,5,12,30,41,-11,26
SC Rheindorf,955,6,6,6,12,17,26,-9,24
Vienna,955,7,6,5,13,24,40,-16,23
FC Salzburg,956,1,15,6,3,49,20,29,51
SK Sturm Gra,956,2,12,3,9,33,32,1,39
Rapid Vienna,956,3,8,10,6,36,30,6,34
LASK Linz,956,4,8,7,9,27,31,-4,31
Mattersburg,956,5,7,5,12,32,39,-7,26
Vienna,956,6,7,5,12,25,41,-16,26
SC Rheindorf,956,7,6,6,12,19,28,-9,24
FC Salzburg,957,1,16,6,2,50,18,32,54
SK Sturm Gra,957,2,12,4,8,34,31,3,40
Rapid Vienna,957,3,7,9,8,34,32,2,30
LASK Linz,957,4,8,6,10,29,32,-3,30
Mattersburg,957,5,7,6,11,33,42,-9,27
SC Rheindorf,957,6,7,5,12,22,30,-8,26
Vienna,957,7,6,6,12,24,41,-17,24
FC Salzburg,958,1,13,9,2,41,15,26,48
SK Sturm Gra,958,2,12,5,7,33,28,5,41
Rapid Vienna,958,3,9,10,5,37,28,9,37
LASK Linz,958,4,9,6,9,33,30,3,33
Vienna,958,5,7,6,11,26,37,-11,27
Mattersburg,958,6,6,5,13,29,45,-16,23
SC Rheindorf,958,7,5,5,14,22,38,-16,20
FC Salzburg,959,1,15,7,2,46,18,28,52
SK Sturm Gra,959,2,12,4,8,32,30,2,40
Rapid Vienna,959,3,8,10,6,35,30,5,34
LASK Linz,959,4,8,8,8,30,28,2,32
Vienna,959,5,6,6,12,25,41,-16,24
Mattersburg,959,6,5,8,11,30,42,-12,23
SC Rheindorf,959,7,5,7,12,18,27,-9,22
FC Salzburg,960,1,15,6,3,51,20,31,51
SK Sturm Gra,960,2,12,3,9,32,35,-3,39
Rapid Vienna,960,3,9,10,5,37,29,8,37
Mattersburg,960,4,9,5,10,34,38,-4,32
LASK Linz,960,5,7,6,11,26,32,-6,27
Vienna,960,6,6,5,13,24,40,-16,23
SC Rheindorf,960,7,5,7,12,23,33,-10,22
FC Salzburg,961,1,15,6,3,43,18,25,51
SK Sturm Gra,961,2,13,3,8,32,28,4,42
Rapid Vienna,961,3,9,10,5,35,25,10,37
LASK Linz,961,4,8,6,10,27,29,-2,30
Mattersburg,961,5,6,6,12,31,42,-11,24
Vienna,961,6,6,6,12,26,42,-16,24
SC Rheindorf,961,7,5,7,12,18,28,-10,22
FC Salzburg,962,1,14,6,4,42,20,22,48
SK Sturm Gra,962,2,13,4,7,33,27,6,43
Rapid Vienna,962,3,9,11,4,39,25,14,38
LASK Linz,962,4,9,5,10,28,32,-4,32
Vienna,962,5,7,5,12,26,40,-14,26
SC Rheindorf,962,6,5,7,12,21,31,-10,22
Mattersburg,962,7,5,6,13,29,43,-14,21
FC Salzburg,963,1,13,6,5,41,22,19,45
SK Sturm Gra,963,2,13,5,6,35,28,7,44
Rapid Vienna,963,3,8,9,7,35,31,4,33
Mattersburg,963,4,9,5,10,39,39,0,32
LASK Linz,963,5,7,7,10,26,30,-4,28
Vienna,963,6,7,5,12,25,41,-16,26
SC Rheindorf,963,7,5,7,12,19,29,-10,22
FC Salzburg,964,1,15,6,3,48,17,31,51
SK Sturm Gra,964,2,12,4,8,30,28,2,40
Rapid Vienna,964,3,8,11,5,33,25,8,35
LASK Linz,964,4,9,6,9,26,27,-1,33
Mattersburg,964,5,7,5,12,31,40,-9,26
Vienna,964,6,7,5,12,26,44,-18,26
SC Rheindorf,964,7,4,7,13,16,29,-13,19
FC Salzburg,965,1,15,7,2,48,19,29,52
SK Sturm Gra,965,2,13,5,6,34,27,7,44
Rapid Vienna,965,3,7,12,5,35,28,7,33
LASK Linz,965,4,8,6,10,28,30,-2,30
Vienna,965,5,7,5,12,27,43,-16,26
SC Rheindorf,965,6,5,7,12,17,27,-10,22
Mattersburg,965,7,5,6,13,28,43,-15,21
FC Salzburg,966,1,15,7,2,47,18,29,52
SK Sturm Gra,966,2,13,3,8,34,28,6,42
Rapid Vienna,966,3,8,10,6,35,29,6,34
LASK Linz,966,4,9,5,10,28,31,-3,32
Vienna,966,5,6,7,11,25,39,-14,25
SC Rheindorf,966,6,6,6,12,19,27,-8,24
Mattersburg,966,7,5,6,13,29,45,-16,21
FC Salzburg,967,1,15,6,3,47,20,27,51
SK Sturm Gra,967,2,11,4,9,32,32,0,37
Rapid Vienna,967,3,9,9,6,35,28,7,36
LASK Linz,967,4,10,5,9,32,29,3,35
Vienna,967,5,7,5,12,29,42,-13,26
Mattersburg,967,6,6,6,12,30,43,-13,24
SC Rheindorf,967,7,5,7,12,18,29,-11,22
FC Salzburg,968,1,15,6,3,50,20,30,51
SK Sturm Gra,968,2,12,4,8,33,32,1,40
Rapid Vienna,968,3,9,11,4,35,25,10,38
LASK Linz,968,4,8,7,9,27,28,-1,31
Mattersburg,968,5,8,5,11,35,43,-8,29
Vienna,968,6,6,5,13,24,43,-19,23
SC Rheindorf,968,7,4,6,14,19,32,-13,18
FC Salzburg,969,1,14,8,2,41,16,25,50
SK Sturm Gra,969,2,13,4,7,33,26,7,43
LASK Linz,969,3,10,6,8,32,27,5,36
Rapid Vienna,969,4,7,10,7,33,32,1,31
Vienna,969,5,7,6,11,27,39,-12,27
Mattersburg,969,6,5,7,12,27,41,-14,22
SC Rheindorf,969,7,4,7,13,17,29,-12,19
FC Salzburg,970,1,16,6,2,51,18,33,54
SK Sturm Gra,970,2,13,4,7,35,29,6,43
LASK Linz,970,3,9,6,9,31,30,1,33
Rapid Vienna,970,4,7,9,8,33,30,3,30
SC Rheindorf,970,5,6,7,11,20,28,-8,25
Vienna,970,6,6,6,12,24,42,-18,24
Mattersburg,970,7,5,6,13,27,44,-17,21
FC Salzburg,971,1,15,6,3,48,18,30,51
SK Sturm Gra,971,2,12,4,8,32,31,1,40
Rapid Vienna,971,3,8,12,4,36,27,9,36
LASK Linz,971,4,8,6,10,29,28,1,30
SC Rheindorf,971,5,6,7,11,21,28,-7,25
Mattersburg,971,6,6,6,12,29,43,-14,24
Vienna,971,7,6,5,13,23,43,-20,23
FC Salzburg,972,1,15,6,3,47,22,25,51
SK Sturm Gra,972,2,13,4,7,35,28,7,43
Rapid Vienna,972,3,9,9,6,43,32,11,36
Vienna,972,4,8,5,11,30,38,-8,29
LASK Linz,972,5,8,5,11,27,35,-8,29
SC Rheindorf,972,6,5,7,12,21,32,-11,22
Mattersburg,972,7,5,6,13,30,46,-16,21
FC Salzburg,973,1,14,6,4,44,20,24,48
SK Sturm Gra,973,2,14,3,7,38,31,7,45
Rapid Vienna,973,3,9,10,5,35,27,8,37
LASK Linz,973,4,8,7,9,30,31,-1,31
Mattersburg,973,5,7,6,11,32,39,-7,27
Vienna,973,6,7,5,12,25,40,-15,26
SC Rheindorf,973,7,4,5,15,19,35,-16,17
FC Salzburg,974,1,15,7,2,45,17,28,52
SK Sturm Gra,974,2,13,3,8,35,29,6,42
Rapid Vienna,974,3,8,10,6,35,27,8,34
LASK Linz,974,4,9,5,10,27,27,0,32
Vienna,974,5,7,6,11,29,40,-11,27
Mattersburg,974,6,6,5,13,33,48,-15,23
SC Rheindorf,974,7,5,6,13,20,36,-16,21
FC Salzburg,975,1,15,6,3,46,20,26,51
SK Sturm Gra,975,2,13,3,8,35,29,6,42
Rapid Vienna,975,3,8,9,7,34,30,4,33
LASK Linz,975,4,7,6,11,25,32,-7,27
Mattersburg,975,5,7,6,11,32,42,-10,27
SC Rheindorf,975,6,7,5,12,23,29,-6,26
Vienna,975,7,7,5,12,26,39,-13,26
FC Salzburg,976,1,16,6,2,46,17,29,54
SK Sturm Gra,976,2,12,4,8,31,31,0,40
Rapid Vienna,976,3,9,9,6,36,27,9,36
LASK Linz,976,4,8,6,10,25,31,-6,30
Mattersburg,976,5,7,6,11,31,38,-7,27
Vienna,976,6,6,6,12,23,38,-15,24
SC Rheindorf,976,7,5,5,14,19,29,-10,20
FC Salzburg,977,1,13,9,2,45,19,26,48
SK Sturm Gra,977,2,13,4,7,36,29,7,43
Rapid Vienna,977,3,8,10,6,38,32,6,34
LASK Linz,977,4,8,5,11,27,32,-5,29
Vienna,977,5,7,6,11,27,40,-13,27
Mattersburg,977,6,7,5,12,34,42,-8,26
SC Rheindorf,977,7,6,5,13,19,32,-13,23
FC Salzburg,978,1,15,7,2,48,18,30,52
SK Sturm Gra,978,2,13,3,8,35,33,2,42
Rapid Vienna,978,3,10,9,5,42,30,12,39
LASK Linz,978,4,8,6,10,27,31,-4,30
Mattersburg,978,5,6,7,11,29,39,-10,25
Vienna,978,6,6,5,13,23,40,-17,23
SC Rheindorf,978,7,5,5,14,19,32,-13,20
FC Salzburg,979,1,15,7,2,44,16,28,52
SK Sturm Gra,979,2,13,5,6,33,24,9,44
Rapid Vienna,979,3,8,11,5,34,27,7,35
LASK Linz,979,4,8,7,9,27,29,-2,31
Vienna,979,5,7,5,12,28,40,-12,26
Mattersburg,979,6,5,6,13,29,46,-17,21
SC Rheindorf,979,7,4,7,13,18,31,-13,19
FC Salzburg,980,1,12,8,4,42,23,19,44
SK Sturm Gra,980,2,11,7,6,32,28,4,40
Rapid Vienna,980,3,9,11,4,41,27,14,38
LASK Linz,980,4,7,7,10,26,29,-3,28
Mattersburg,980,5,7,7,10,32,40,-8,28
Vienna,980,6,7,5,12,25,39,-14,26
SC Rheindorf,980,7,5,7,12,16,28,-12,22
FC Salzburg,981,1,14,7,3,43,18,25,49
SK Sturm Gra,981,2,13,3,8,35,29,6,42
Rapid Vienna,981,3,9,10,5,36,28,8,37
LASK Linz,981,4,8,6,10,28,31,-3,30
Mattersburg,981,5,7,6,11,30,37,-7,27
Vienna,981,6,6,6,12,24,41,-17,24
SC Rheindorf,981,7,5,6,13,21,33,-12,21
FC Salzburg,982,1,14,7,3,45,20,25,49
SK Sturm Gra,982,2,12,5,7,35,29,6,41
Rapid Vienna,982,3,10,10,4,38,27,11,40
LASK Linz,982,4,8,6,10,28,28,0,30
Mattersburg,982,5,7,5,12,31,42,-11,26
Vienna,982,6,6,6,12,25,40,-15,24
SC Rheindorf,982,7,5,5,14,17,33,-16,20
FC Salzburg,983,1,14,6,4,47,22,25,48
SK Sturm Gra,983,2,12,4,8,35,37,-2,40
Rapid Vienna,983,3,8,11,5,38,28,10,35
LASK Linz,983,4,9,6,9,30,28,2,33
Mattersburg,983,5,8,5,11,33,42,-9,29
Vienna,983,6,7,5,12,27,41,-14,26
SC Rheindorf,983,7,4,7,13,21,33,-12,19
FC Salzburg,984,1,16,6,2,50,19,31,54
SK Sturm Gra,984,2,12,3,9,31,29,2,39
Rapid Vienna,984,3,8,10,6,36,29,7,34
LASK Linz,984,4,9,6,9,28,28,0,33
Vienna,984,5,7,5,12,27,42,-15,26
Mattersburg,984,6,6,6,12,32,46,-14,24
SC Rheindorf,984,7,5,6,13,19,30,-11,21
FC Salzburg,985,1,14,7,3,45,19,26,49
SK Sturm Gra,985,2,12,5,7,34,29,5,41
Rapid Vienna,985,3,8,10,6,36,31,5,34
LASK Linz,985,4,8,7,9,28,30,-2,31
Vienna,985,5,8,5,11,28,38,-10,29
Mattersburg,985,6,6,5,13,29,42,-13,23
SC Rheindorf,985,7,5,7,12,18,29,-11,22
FC Salzburg,986,1,15,7,2,47,20,27,52
SK Sturm Gra,986,2,11,4,9,32,32,0,37
Rapid Vienna,986,3,8,10,6,36,28,8,34
LASK Linz,986,4,8,6,10,27,31,-4,30
Vienna,986,5,7,6,11,27,39,-12,27
SC Rheindorf,986,6,7,5,12,22,30,-8,26
Mattersburg,986,7,6,6,12,35,46,-11,24
FC Salzburg,987,1,13,6,5,43,23,20,45
SK Sturm Gra,987,2,13,4,7,38,32,6,43
Rapid Vienna,987,3,8,10,6,37,31,6,34
LASK Linz,987,4,8,6,10,26,29,-3,30
Vienna,987,5,8,5,11,27,39,-12,29
SC Rheindorf,987,6,6,7,11,22,29,-7,25
Mattersburg,987,7,6,6,12,32,42,-10,24
FC Salzburg,988,1,14,7,3,44,18,26,49
Rapid Vienna,988,2,9,10,5,37,28,9,37
SK Sturm Gra,988,3,11,4,9,31,30,1,37
LASK Linz,988,4,9,7,8,26,25,1,34
Mattersburg,988,5,6,7,11,30,41,-11,25
Vienna,988,6,6,6,12,24,40,-16,24
SC Rheindorf,988,7,5,7,12,19,29,-10,22
FC Salzburg,989,1,13,8,3,43,18,25,47
SK Sturm Gra,989,2,13,4,7,34,31,3,43
Rapid Vienna,989,3,7,11,6,34,29,5,32
LASK Linz,989,4,8,7,9,26,27,-1,31
Mattersburg,989,5,8,6,10,32,38,-6,30
Vienna,989,6,6,6,12,24,40,-16,24
SC Rheindorf,989,7,5,6,13,19,29,-10,21
FC Salzburg,990,1,15,7,2,46,15,31,52
SK Sturm Gra,990,2,11,7,6,32,28,4,40
Rapid Vienna,990,3,8,10,6,34,30,4,34
LASK Linz,990,4,8,6,10,26,29,-3,30
Mattersburg,990,5,7,5,12,33,43,-10,26
Vienna,990,6,7,5,12,27,41,-14,26
SC Rheindorf,990,7,5,6,13,18,30,-12,21
FC Salzburg,991,1,15,7,2,49,20,29,52
SK Sturm Gra,991,2,14,3,7,38,29,9,45
Rapid Vienna,991,3,8,10,6,36,32,4,34
LASK Linz,991,4,9,5,10,28,27,1,32
Mattersburg,991,5,7,6,11,29,37,-8,27
Vienna,991,6,6,6,12,25,41,-16,24
SC Rheindorf,991,7,4,5,15,16,35,-19,17
FC Salzburg,992,1,14,7,3,45,19,26,49
SK Sturm Gra,992,2,13,3,8,34,31,3,42
Rapid Vienna,992,3,9,9,6,40,29,11,36
LASK Linz,992,4,8,6,10,25,28,-3,30
Mattersburg,992,5,6,7,11,28,39,-11,25
SC Rheindorf,992,6,6,6,12,21,32,-11,24
Vienna,992,7,6,6,12,24,39,-15,24
FC Salzburg,993,1,13,8,3,44,21,23,47
SK Sturm Gra,993,2,12,4,8,30,28,2,40
Rapid Vienna,993,3,9,10,5,36,26,10,37
LASK Linz,993,4,8,6,10,27,28,-1,30
Vienna,993,5,7,6,11,25,38,-13,27
Mattersburg,993,6,6,7,11,35,41,-6,25
SC Rheindorf,993,7,6,5,13,18,33,-15,23
FC Salzburg,994,1,14,7,3,46,21,25,49
SK Sturm Gra,994,2,13,3,8,36,29,7,42
Rapid Vienna,994,3,9,11,4,37,26,11,38
LASK Linz,994,4,8,5,11,24,31,-7,29
Mattersburg,994,5,7,5,12,32,42,-10,26
Vienna,994,6,7,5,12,29,42,-13,26
SC Rheindorf,994,7,5,6,13,17,30,-13,21
FC Salzburg,995,1,13,7,4,44,22,22,46
SK Sturm Gra,995,2,14,4,6,34,26,8,46
Rapid Vienna,995,3,8,11,5,35,29,6,35
LASK Linz,995,4,7,7,10,25,29,-4,28
Vienna,995,5,7,6,11,27,38,-11,27
Mattersburg,995,6,5,9,10,30,40,-10,24
SC Rheindorf,995,7,4,8,12,18,29,-11,20
FC Salzburg,996,1,15,6,3,49,21,28,51
SK Sturm Gra,996,2,13,3,8,33,27,6,42
Rapid Vienna,996,3,8,10,6,37,30,7,34
LASK Linz,996,4,8,6,10,25,28,-3,30
Vienna,996,5,8,5,11,29,40,-11,29
Mattersburg,996,6,6,6,12,31,45,-14,24
SC Rheindorf,996,7,4,8,12,20,33,-13,20
FC Salzburg,997,1,15,7,2,44,17,27,52
SK Sturm Gra,997,2,12,4,8,32,30,2,40
Rapid Vienna,997,3,9,10,5,35,25,10,37
LASK Linz,997,4,7,7,10,26,31,-5,28
SC Rheindorf,997,5,7,5,12,23,26,-3,26
Vienna,997,6,6,6,12,24,39,-15,24
Mattersburg,997,7,5,7,12,29,45,-16,22
FC Salzburg,998,1,13,8,3,43,22,21,47
Rapid Vienna,998,2,10,10,4,40,24,16,40
SK Sturm Gra,998,3,11,4,9,29,30,-1,37
LASK Linz,998,4,8,6,10,24,29,-5,30
Vienna,998,5,7,6,11,26,39,-13,27
SC Rheindorf,998,6,6,6,12,22,28,-6,24
Mattersburg,998,7,6,6,12,28,40,-12,24
FC Salzburg,999,1,15,7,2,47,19,28,52
SK Sturm Gra,999,2,13,4,7,33,28,5,43
Rapid Vienna,999,3,8,11,5,35,27,8,35
Mattersburg,999,4,8,5,11,36,41,-5,29
LASK Linz,999,5,7,5,12,24,32,-8,26
Vienna,999,6,6,5,13,27,44,-17,23
SC Rheindorf,999,7,5,7,12,17,28,-11,22
FC Salzburg,1000,1,14,6,4,44,21,23,48
SK Sturm Gra,1000,2,13,4,7,35,28,7,43
Rapid Vienna,1000,3,9,9,6,36,28,8,36
LASK Linz,1000,4,7,7,10,26,31,-5,28
Vienna,1000,5,7,6,11,25,38,-13,27
SC Rheindorf,1000,6,6,7,11,21,28,-7,25
Mattersburg,1000,7,5,7,12,30,43,-13,22
FC Salzburg,1001,1,15,7,2,43,16,27,52
SK Sturm Gra,1001,2,11,4,9,29,29,0,37
Rapid Vienna,1001,3,8,9,7,34,28,6,33
LASK Linz,1001,4,8,7,9,28,29,-1,31
SC Rheindorf,1001,5,7,6,11,19,26,-7,27
Mattersburg,1001,6,7,5,12,32,42,-10,26
Vienna,1001,7,6,6,12,24,39,-15,24
FC Salzburg,1002,1,16,6,2,48,15,33,54
SK Sturm Gra,1002,2,13,3,8,32,28,4,42
Rapid Vienna,1002,3,8,10,6,37,32,5,34
LASK Linz,1002,4,8,6,10,25,27,-2,30
Mattersburg,1002,5,7,5,12,28,40,-12,26
SC Rheindorf,1002,6,6,5,13,18,30,-12,23
Vienna,1002,7,6,5,13,23,39,-16,23
SK Sturm Gra,1003,1,15,3,6,35,25,10,48
FC Salzburg,1003,2,13,7,4,43,19,24,46
Rapid Vienna,1003,3,8,11,5,36,27,9,35
LASK Linz,1003,4,9,6,9,28,27,1,33
Mattersburg,1003,5,7,5,12,29,39,-10,26
Vienna,1003,6,7,5,12,24,40,-16,26
SC Rheindorf,1003,7,4,5,15,17,35,-18,17
FC Salzburg,1004,1,15,6,3,46,19,27,51
SK Sturm Gra,1004,2,12,4,8,33,31,2,40
Rapid Vienna,1004,3,9,10,5,38,28,10,37
LASK Linz,1004,4,9,7,8,30,28,2,34
Vienna,1004,5,6,6,12,24,41,-17,24
Mattersburg,1004,6,5,7,12,29,42,-13,22
SC Rheindorf,1004,7,4,8,12,18,29,-11,20
FC Salzburg,1005,1,14,6,4,47,23,24,48
Rapid Vienna,1005,2,11,9,4,40,24,16,42
SK Sturm Gra,1005,3,12,3,9,32,29,3,39
Mattersburg,1005,4,9,5,10,40,41,-1,32
LASK Linz,1005,5,8,5,11,25,33,-8,29
Vienna,1005,6,6,5,13,27,47,-20,23
SC Rheindorf,1005,7,5,5,14,18,32,-14,20
FC Salzburg,1006,1,15,7,2,46,17,29,52
SK Sturm Gra,1006,2,13,4,7,34,30,4,43
Rapid Vienna,1006,3,8,10,6,34,28,6,34
LASK Linz,1006,4,9,5,10,27,26,1,32
Vienna,1006,5,7,6,11,28,39,-11,27
SC Rheindorf,1006,6,5,7,12,19,30,-11,22
Mattersburg,1006,7,5,5,14,26,44,-18,20
FC Salzburg,1007,1,14,6,4,44,19,25,48
SK Sturm Gra,1007,2,11,5,8,31,32,-1,38
Rapid Vienna,1007,3,9,10,5,37,26,11,37
LASK Linz,1007,4,8,6,10,27,30,-3,30
Mattersburg,1007,5,7,6,11,31,43,-12,27
Vienna,1007,6,7,5,12,28,38,-10,26
SC Rheindorf,1007,7,6,6,12,20,30,-10,24
FC Salzburg,1008,1,14,7,3,42,18,24,49
SK Sturm Gra,1008,2,12,4,8,33,31,2,40
LASK Linz,1008,3,9,6,9,28,28,0,33
Rapid Vienna,1008,4,7,10,7,33,28,5,31
Mattersburg,1008,5,6,8,10,31,40,-9,26
Vienna,1008,6,7,5,12,27,40,-13,26
SC Rheindorf,1008,7,5,8,11,18,27,-9,23
FC Salzburg,1009,1,14,7,3,47,19,28,49
Rapid Vienna,1009,2,11,9,4,38,26,12,42
SK Sturm Gra,1009,3,11,6,7,31,28,3,39
LASK Linz,1009,4,8,6,10,27,27,0,30
Mattersburg,1009,5,7,5,12,29,44,-15,26
Vienna,1009,6,6,5,13,24,41,-17,23
SC Rheindorf,1009,7,5,6,13,16,27,-11,21
FC Salzburg,1010,1,15,6,3,46,20,26,51
SK Sturm Gra,1010,2,13,3,8,32,30,2,42
Rapid Vienna,1010,3,10,9,5,38,26,12,39
LASK Linz,1010,4,7,5,12,26,34,-8,26
Mattersburg,1010,5,7,5,12,34,44,-10,26
Vienna,1010,6,7,5,12,28,39,-11,26
SC Rheindorf,1010,7,6,5,13,21,32,-11,23
FC Salzburg,1011,1,15,7,2,48,17,31,52
SK Sturm Gra,1011,2,13,3,8,33,36,-3,42
Rapid Vienna,1011,3,9,9,6,40,29,11,36
LASK Linz,1011,4,10,5,9,32,27,5,35
Vienna,1011,5,7,6,11,27,39,-12,27
Mattersburg,1011,6,5,6,13,29,43,-14,21
SC Rheindorf,1011,7,4,6,14,19,37,-18,18
FC Salzburg,1012,1,14,7,3,42,17,25,49
SK Sturm Gra,1012,2,11,5,8,33,32,1,38
Rapid Vienna,1012,3,8,10,6,37,30,7,34
LASK Linz,1012,4,9,6,9,29,27,2,33
Mattersburg,1012,5,9,5,10,33,38,-5,32
Vienna,1012,6,6,6,12,23,39,-16,24
SC Rheindorf,1012,7,4,7,13,18,32,-14,19
FC Salzburg,1013,1,14,7,3,43,17,26,49
SK Sturm Gra,1013,2,12,5,7,33,30,3,41
LASK Linz,1013,3,9,6,9,29,28,1,33
Rapid Vienna,1013,4,7,11,6,34,29,5,32
Vienna,1013,5,7,6,11,25,38,-13,27
SC Rheindorf,1013,6,6,7,11,21,28,-7,25
Mattersburg,1013,7,5,6,13,29,44,-15,21
FC Salzburg,1014,1,13,7,4,41,18,23,46
SK Sturm Gra,1014,2,13,4,7,32,30,2,43
Rapid Vienna,1014,3,8,12,4,35,25,10,36
LASK Linz,1014,4,9,7,8,30,25,5,34
Vienna,1014,5,7,6,11,25,38,-13,27
Mattersburg,1014,6,6,6,12,30,43,-13,24
SC Rheindorf,1014,7,4,6,14,17,31,-14,18
FC Salzburg,1015,1,15,7,2,46,17,29,52
SK Sturm Gra,1015,2,12,3,9,32,31,1,39
Rapid Vienna,1015,3,8,10,6,36,27,9,34
LASK Linz,1015,4,9,6,9,26,28,-2,33
SC Rheindorf,1015,5,6,7,11,21,29,-8,25
Vienna,1015,6,6,6,12,25,40,-15,24
Mattersburg,1015,7,5,7,12,28,42,-14,22
FC Salzburg,1016,1,15,6,3,44,17,27,51
SK Sturm Gra,1016,2,12,5,7,36,29,7,41
LASK Linz,1016,3,9,7,8,28,25,3,34
Rapid Vienna,1016,4,8,9,7,34,35,-1,33
Vienna,1016,5,7,6,11,26,38,-12,27
Mattersburg,1016,6,6,6,12,29,40,-11,24
SC Rheindorf,1016,7,4,7,13,20,33,-13,19
FC Salzburg,1017,1,15,6,3,43,16,27,51
SK Sturm Gra,1017,2,13,4,7,37,26,11,43
Rapid Vienna,1017,3,9,9,6,35,29,6,36
LASK Linz,1017,4,8,6,10,26,27,-1,30
Vienna,1017,5,8,5,11,28,39,-11,29
SC Rheindorf,1017,6,5,6,13,17,31,-14,21
Mattersburg,1017,7,5,6,13,29,47,-18,21
FC Salzburg,1018,1,14,7,3,46,20,26,49
SK Sturm Gra,1018,2,13,4,7,34,32,2,43
Rapid Vienna,1018,3,9,9,6,38,29,9,36
LASK Linz,1018,4,8,7,9,30,31,-1,31
Mattersburg,1018,5,7,7,10,36,42,-6,28
Vienna,1018,6,6,5,13,24,41,-17,23
SC Rheindorf,1018,7,4,7,13,17,30,-13,19
FC Salzburg,1019,1,16,6,2,47,16,31,54
SK Sturm Gra,1019,2,12,3,9,33,33,0,39
Rapid Vienna,1019,3,9,9,6,36,27,9,36
LASK Linz,1019,4,9,5,10,29,30,-1,32
SC Rheindorf,1019,5,6,6,12,19,29,-10,24
Mattersburg,1019,6,6,6,12,32,43,-11,24
Vienna,1019,7,6,5,13,26,44,-18,23
FC Salzburg,1020,1,15,7,2,46,18,28,52
SK Sturm Gra,1020,2,11,5,8,36,35,1,38
Rapid Vienna,1020,3,8,11,5,34,26,8,35
LASK Linz,1020,4,8,8,8,29,29,0,32
Mattersburg,1020,5,6,6,12,33,45,-12,24
Vienna,1020,6,6,6,12,27,43,-16,24
SC Rheindorf,1020,7,6,5,13,21,30,-9,23
FC Salzburg,1021,1,15,7,2,48,17,31,52
SK Sturm Gra,1021,2,12,4,8,31,28,3,40
Rapid Vienna,1021,3,9,10,5,35,29,6,37
LASK Linz,1021,4,8,6,10,27,29,-2,30
Mattersburg,1021,5,7,5,12,34,43,-9,26
Vienna,1021,6,6,6,12,24,42,-18,24
SC Rheindorf,1021,7,5,6,13,17,28,-11,21
FC Salzburg,1022,1,14,6,4,42,18,24,48
SK Sturm Gra,1022,2,12,4,8,33,30,3,40
Rapid Vienna,1022,3,8,10,6,32,27,5,34
LASK Linz,1022,4,8,7,9,24,25,-1,31
Mattersburg,1022,5,7,6,11,33,40,-7,27
Vienna,1022,6,7,5,12,26,40,-14,26
SC Rheindorf,1022,7,6,6,12,21,31,-10,24
FC Salzburg,1023,1,13,7,4,43,19,24,46
Rapid Vienna,1023,2,11,9,4,37,24,13,42
SK Sturm Gra,1023,3,13,3,8,32,28,4,42
LASK Linz,1023,4,8,6,10,27,28,-1,30
Mattersburg,1023,5,8,5,11,29,39,-10,29
Vienna,1023,6,6,6,12,24,39,-15,24
SC Rheindorf,1023,7,4,6,14,16,31,-15,18
FC Salzburg,1024,1,15,7,2,46,17,29,52
SK Sturm Gra,1024,2,13,4,7,35,29,6,43
Rapid Vienna,1024,3,8,11,5,37,27,10,35
LASK Linz,1024,4,9,6,9,31,32,-1,33
Mattersburg,1024,5,6,6,12,29,41,-12,24
Vienna,1024,6,6,5,13,24,41,-17,23
SC Rheindorf,1024,7,5,5,14,23,38,-15,20
FC Salzburg,1025,1,15,7,2,50,19,31,52
SK Sturm Gra,1025,2,11,4,9,32,31,1,37
Rapid Vienna,1025,3,8,11,5,36,28,8,35
LASK Linz,1025,4,9,6,9,28,26,2,33
Vienna,1025,5,7,5,12,26,44,-18,26
Mattersburg,1025,6,6,6,12,28,40,-12,24
SC Rheindorf,1025,7,5,7,12,18,30,-12,22
FC Salzburg,1026,1,14,8,2,44,15,29,50
SK Sturm Gra,1026,2,13,3,8,34,34,0,42
Rapid Vienna,1026,3,10,10,4,39,25,14,40
LASK Linz,1026,4,8,6,10,28,31,-3,30
Mattersburg,1026,5,6,8,10,30,39,-9,26
Vienna,1026,6,6,5,13,24,41,-17,23
SC Rheindorf,1026,7,4,6,14,17,31,-14,18
FC Salzburg,1027,1,14,7,3,42,18,24,49
SK Sturm Gra,1027,2,12,4,8,33,27,6,40
Rapid Vienna,1027,3,7,11,6,32,27,5,32
Mattersburg,1027,4,8,6,10,34,39,-5,30
LASK Linz,1027,5,7,7,10,24,30,-6,28
SC Rheindorf,1027,6,7,5,12,18,27,-9,26
Vienna,1027,7,6,6,12,26,41,-15,24
FC Salzburg,1028,1,14,7,3,43,21,22,49
Rapid Vienna,1028,2,10,9,5,39,25,14,39
SK Sturm Gra,1028,3,11,3,10,29,33,-4,36
SC Rheindorf,1028,4,8,5,11,26,27,-1,29
LASK Linz,1028,5,8,5,11,27,31,-4,29
Vienna,1028,6,7,6,11,27,39,-12,27
Mattersburg,1028,7,6,5,13,31,46,-15,23
FC Salzburg,1029,1,14,7,3,45,18,27,49
SK Sturm Gra,1029,2,11,4,9,30,32,-2,37
Rapid Vienna,1029,3,8,11,5,33,25,8,35
LASK Linz,1029,4,10,5,9,26,26,0,35
Mattersburg,1029,5,6,7,11,32,42,-10,25
SC Rheindorf,1029,6,6,6,12,24,30,-6,24
Vienna,1029,7,6,6,12,25,42,-17,24
FC Salzburg,1030,1,15,6,3,43,18,25,51
SK Sturm Gra,1030,2,13,4,7,31,27,4,43
Rapid Vienna,1030,3,8,9,7,35,29,6,33
LASK Linz,1030,4,8,6,10,28,30,-2,30
Vienna,1030,5,8,5,11,27,37,-10,29
Mattersburg,1030,6,7,5,12,31,41,-10,26
SC Rheindorf,1030,7,4,7,13,16,29,-13,19
FC Salzburg,1031,1,16,6,2,47,18,29,54
SK Sturm Gra,1031,2,12,3,9,33,31,2,39
Rapid Vienna,1031,3,9,9,6,36,26,10,36
LASK Linz,1031,4,8,6,10,26,30,-4,30
Mattersburg,1031,5,7,5,12,29,41,-12,26
Vienna,1031,6,7,5,12,27,40,-13,26
SC Rheindorf,1031,7,5,6,13,18,30,-12,21
FC Salzburg,1032,1,12,6,6,43,26,17,42
SK Sturm Gra,1032,2,12,5,7,31,27,4,41
Rapid Vienna,1032,3,9,10,5,35,27,8,37
LASK Linz,1032,4,7,7,10,24,28,-4,28
Mattersburg,1032,5,7,7,10,34,41,-7,28
SC Rheindorf,1032,6,7,6,11,22,26,-4,27
Vienna,1032,7,7,5,12,25,39,-14,26
FC Salzburg,1033,1,15,6,3,47,20,27,51
SK Sturm Gra,1033,2,13,3,8,32,30,2,42
Rapid Vienna,1033,3,9,9,6,38,27,11,36
LASK Linz,1033,4,9,5,10,28,29,-1,32
Vienna,1033,5,7,5,12,28,42,-14,26
SC Rheindorf,1033,6,6,5,13,20,30,-10,23
Mattersburg,1033,7,6,5,13,31,46,-15,23
FC Salzburg,1034,1,15,6,3,45,16,29,51
Rapid Vienna,1034,2,10,10,4,37,26,11,40
SK Sturm Gra,1034,3,12,4,8,32,31,1,40
LASK Linz,1034,4,8,5,11,27,31,-4,29
Mattersburg,1034,5,7,5,12,31,42,-11,26
SC Rheindorf,1034,6,6,5,13,18,27,-9,23
Vienna,1034,7,6,5,13,24,41,-17,23
FC Salzburg,1035,1,14,6,4,43,21,22,48
Rapid Vienna,1035,2,9,11,4,36,24,12,38
SK Sturm Gra,1035,3,11,4,9,29,28,1,37
LASK Linz,1035,4,8,7,9,27,30,-3,31
Vienna,1035,5,8,5,11,29,39,-10,29
Mattersburg,1035,6,6,6,12,33,47,-14,24
SC Rheindorf,1035,7,6,5,13,22,30,-8,23
FC Salzburg,1036,1,14,8,2,45,19,26,50
SK Sturm Gra,1036,2,12,4,8,31,29,2,40
Rapid Vienna,1036,3,8,10,6,34,28,6,34
LASK Linz,1036,4,8,7,9,29,29,0,31
Vienna,1036,5,7,5,12,29,42,-13,26
SC Rheindorf,1036,6,6,7,11,19,26,-7,25
Mattersburg,1036,7,5,7,12,28,42,-14,22
FC Salzburg,1037,1,13,8,3,47,21,26,47
SK Sturm Gra,1037,2,12,4,8,30,30,0,40
Rapid Vienna,1037,3,9,10,5,33,24,9,37
LASK Linz,1037,4,8,7,9,26,26,0,31
Mattersburg,1037,5,7,6,11,34,41,-7,27
Vienna,1037,6,6,7,11,27,41,-14,25
SC Rheindorf,1037,7,5,6,13,16,30,-14,21
FC Salzburg,1038,1,14,8,2,42,17,25,50
SK Sturm Gra,1038,2,12,3,9,30,28,2,39
LASK Linz,1038,3,11,5,8,31,26,5,38
Rapid Vienna,1038,4,8,9,7,34,27,7,33
Mattersburg,1038,5,6,7,11,30,39,-9,25
Vienna,1038,6,6,6,12,24,40,-16,24
SC Rheindorf,1038,7,5,6,13,18,32,-14,21
FC Salzburg,1039,1,15,7,2,44,16,28,52
SK Sturm Gra,1039,2,14,4,6,36,27,9,46
Rapid Vienna,1039,3,7,11,6,33,29,4,32
LASK Linz,1039,4,7,7,10,26,31,-5,28
Vienna,1039,5,7,5,12,25,41,-16,26
Mattersburg,1039,6,6,6,12,29,40,-11,24
SC Rheindorf,1039,7,5,6,13,20,29,-9,21
FC Salzburg,1040,1,15,7,2,44,16,28,52
SK Sturm Gra,1040,2,13,4,7,35,27,8,43
Rapid Vienna,1040,3,9,9,6,38,31,7,36
Mattersburg,1040,4,7,6,11,31,37,-6,27
LASK Linz,1040,5,7,6,11,25,32,-7,27
Vienna,1040,6,6,7,11,23,37,-14,25
SC Rheindorf,1040,7,5,5,14,16,32,-16,20
FC Salzburg,1041,1,15,7,2,50,19,31,52
SK Sturm Gra,1041,2,13,3,8,35,31,4,42
Rapid Vienna,1041,3,8,11,5,37,30,7,35
LASK Linz,1041,4,7,5,12,26,33,-7,26
Mattersburg,1041,5,7,5,12,33,44,-11,26
Vienna,1041,6,7,5,12,25,40,-15,26
SC Rheindorf,1041,7,6,6,12,20,29,-9,24
FC Salzburg,1042,1,14,8,2,43,16,27,50
SK Sturm Gra,1042,2,12,4,8,33,30,3,40
Rapid Vienna,1042,3,8,11,5,35,26,9,35
LASK Linz,1042,4,7,8,9,26,28,-2,29
Vienna,1042,5,7,5,12,26,40,-14,26
Mattersburg,1042,6,6,7,11,30,41,-11,25
SC Rheindorf,1042,7,6,5,13,23,35,-12,23
FC Salzburg,1043,1,13,8,3,41,18,23,47
SK Sturm Gra,1043,2,13,4,7,33,26,7,43
Rapid Vienna,1043,3,9,10,5,36,28,8,37
LASK Linz,1043,4,8,5,11,30,33,-3,29
Vienna,1043,5,8,5,11,29,38,-9,29
SC Rheindorf,1043,6,5,7,12,21,29,-8,22
Mattersburg,1043,7,5,7,12,31,49,-18,22
FC Salzburg,1044,1,15,7,2,48,18,30,52
SK Sturm Gra,1044,2,12,5,7,33,32,1,41
LASK Linz,1044,3,10,5,9,30,28,2,35
Rapid Vienna,1044,4,8,10,6,35,27,8,34
Mattersburg,1044,5,7,6,11,32,39,-7,27
Vienna,1044,6,6,5,13,23,40,-17,23
SC Rheindorf,1044,7,4,6,14,16,33,-17,18
FC Salzburg,1045,1,15,6,3,47,21,26,51
SK Sturm Gra,1045,2,14,3,7,36,26,10,45
LASK Linz,1045,3,10,6,8,28,25,3,36
Rapid Vienna,1045,4,8,9,7,34,29,5,33
Vienna,1045,5,7,5,12,26,40,-14,26
Mattersburg,1045,6,5,6,13,31,47,-16,21
SC Rheindorf,1045,7,4,7,13,19,33,-14,19
FC Salzburg,1046,1,14,6,4,45,21,24,48
Rapid Vienna,1046,2,10,10,4,38,27,11,40
SK Sturm Gra,1046,3,12,4,8,34,31,3,40
Mattersburg,1046,4,8,5,11,35,41,-6,29
LASK Linz,1046,5,7,5,12,27,35,-8,26
Vienna,1046,6,7,5,12,25,39,-14,26
SC Rheindorf,1046,7,6,5,13,20,30,-10,23
FC Salzburg,1047,1,14,6,4,44,22,22,48
SK Sturm Gra,1047,2,14,4,6,37,26,11,46
Rapid Vienna,1047,3,9,10,5,39,26,13,37
LASK Linz,1047,4,9,5,10,27,31,-4,32
Vienna,1047,5,7,5,12,27,42,-15,26
SC Rheindorf,1047,6,5,6,13,18,31,-13,21
Mattersburg,1047,7,5,6,13,32,46,-14,21
FC Salzburg,1048,1,14,6,4,47,23,24,48
SK Sturm Gra,1048,2,14,4,6,39,28,11,46
Rapid Vienna,1048,3,7,10,7,37,33,4,31
LASK Linz,1048,4,8,7,9,26,29,-3,31
Vienna,1048,5,8,5,11,25,37,-12,29
Mattersburg,1048,6,6,6,12,29,42,-13,24
SC Rheindorf,1048,7,4,8,12,19,30,-11,20
FC Salzburg,1049,1,16,6,2,51,20,31,54
SK Sturm Gra,1049,2,13,4,7,34,27,7,43
Rapid Vienna,1049,3,8,10,6,38,31,7,34
LASK Linz,1049,4,7,7,10,26,31,-5,28
Mattersburg,1049,5,6,6,12,31,43,-12,24
Vienna,1049,6,6,6,12,26,42,-16,24
SC Rheindorf,1049,7,6,5,13,19,31,-12,23
FC Salzburg,1050,1,16,6,2,52,18,34,54
SK Sturm Gra,1050,2,13,3,8,36,35,1,42
LASK Linz,1050,3,9,6,9,29,28,1,33
Rapid Vienna,1050,4,7,9,8,34,30,4,30
Mattersburg,1050,5,7,6,11,30,41,-11,27
Vienna,1050,6,6,6,12,26,41,-15,24
SC Rheindorf,1050,7,5,6,13,17,31,-14,21
FC Salzburg,1051,1,15,6,3,46,19,27,51
SK Sturm Gra,1051,2,13,4,7,34,29,5,43
LASK Linz,1051,3,10,6,8,29,26,3,36
Rapid Vienna,1051,4,7,10,7,33,29,4,31
Vienna,1051,5,7,6,11,26,38,-12,27
Mattersburg,1051,6,6,6,12,29,41,-12,24
SC Rheindorf,1051,7,4,6,14,18,33,-15,18
FC Salzburg,1052,1,15,7,2,43,17,26,52
SK Sturm Gra,1052,2,13,4,7,35,27,8,43
Rapid Vienna,1052,3,7,9,8,33,29,4,30
LASK Linz,1052,4,8,6,10,25,30,-5,30
SC Rheindorf,1052,5,7,6,11,22,29,-7,27
Mattersburg,1052,6,6,6,12,32,43,-11,24
Vienna,1052,7,6,6,12,25,40,-15,24
FC Salzburg,1053,1,14,8,2,48,20,28,50
SK Sturm Gra,1053,2,13,3,8,31,28,3,42
Rapid Vienna,1053,3,7,12,5,36,29,7,33
LASK Linz,1053,4,7,7,10,26,29,-3,28
Mattersburg,1053,5,7,5,12,32,43,-11,26
SC Rheindorf,1053,6,6,7,11,22,29,-7,25
Vienna,1053,7,6,6,12,25,42,-17,24
FC Salzburg,1054,1,13,8,3,44,20,24,47
Rapid Vienna,1054,2,10,10,4,41,26,15,40
SK Sturm Gra,1054,3,12,3,9,29,30,-1,39
LASK Linz,1054,4,8,5,11,27,31,-4,29
Mattersburg,1054,5,7,6,11,32,40,-8,27
Vienna,1054,6,6,7,11,26,40,-14,25
SC Rheindorf,1054,7,6,5,13,17,29,-12,23
FC Salzburg,1055,1,15,7,2,46,16,30,52
SK Sturm Gra,1055,2,12,4,8,30,27,3,40
LASK Linz,1055,3,10,6,8,31,27,4,36
Rapid Vienna,1055,4,7,10,7,32,28,4,31
Vienna,1055,5,7,5,12,25,40,-15,26
SC Rheindorf,1055,6,5,8,11,21,30,-9,23
Mattersburg,1055,7,5,6,13,31,48,-17,21
FC Salzburg,1056,1,14,7,3,44,20,24,49
SK Sturm Gra,1056,2,14,3,7,34,28,6,45
Rapid Vienna,1056,3,9,9,6,36,27,9,36
LASK Linz,1056,4,8,6,10,28,29,-1,30
Vienna,1056,5,7,6,11,26,39,-13,27
Mattersburg,1056,6,6,6,12,30,43,-13,24
SC Rheindorf,1056,7,5,5,14,18,30,-12,20
FC Salzburg,1057,1,14,6,4,47,21,26,48
SK Sturm Gra,1057,2,15,3,6,37,26,11,48
Rapid Vienna,1057,3,9,9,6,38,33,5,36
LASK Linz,1057,4,9,6,9,32,29,3,33
Vienna,1057,5,7,5,12,26,42,-16,26
Mattersburg,1057,6,5,6,13,29,46,-17,21
SC Rheindorf,1057,7,5,5,14,19,31,-12,20
FC Salzburg,1058,1,14,7,3,46,18,28,49
SK Sturm Gra,1058,2,12,5,7,31,31,0,41
Rapid Vienna,1058,3,9,9,6,35,26,9,36
LASK Linz,1058,4,8,7,9,26,26,0,31
Mattersburg,1058,5,7,7,10,32,38,-6,28
Vienna,1058,6,6,6,12,24,40,-16,24
SC Rheindorf,1058,7,4,7,13,16,31,-15,19
FC Salzburg,1059,1,13,7,4,43,20,23,46
SK Sturm Gra,1059,2,14,3,7,36,30,6,45
Rapid Vienna,1059,3,8,10,6,35,30,5,34
LASK Linz,1059,4,8,6,10,27,29,-2,30
Vienna,1059,5,7,5,12,26,39,-13,26
Mattersburg,1059,6,6,7,11,31,41,-10,25
SC Rheindorf,1059,7,6,6,12,19,28,-9,24
FC Salzburg,1060,1,14,8,2,45,18,27,50
SK Sturm Gra,1060,2,13,4,7,31,25,6,43
Rapid Vienna,1060,3,9,9,6,36,28,8,36
LASK Linz,1060,4,9,5,10,27,28,-1,32
Vienna,1060,5,7,6,11,25,38,-13,27
SC Rheindorf,1060,6,5,6,13,18,31,-13,21
Mattersburg,1060,7,5,6,13,28,42,-14,21
FC Salzburg,1061,1,16,6,2,45,17,28,54
SK Sturm Gra,1061,2,13,4,7,31,26,5,43
Rapid Vienna,1061,3,8,9,7,34,30,4,33
LASK Linz,1061,4,8,7,9,26,26,0,31
Vienna,1061,5,7,5,12,25,39,-14,26
Mattersburg,1061,6,5,7,12,29,41,-12,22
SC Rheindorf,1061,7,4,8,12,19,30,-11,20
FC Salzburg,1062,1,14,7,3,42,18,24,49
SK Sturm Gra,1062,2,12,4,8,30,27,3,40
Rapid Vienna,1062,3,9,9,6,33,25,8,36
LASK Linz,1062,4,10,6,8,29,26,3,36
Mattersburg,1062,5,6,6,12,28,42,-14,24
Vienna,1062,6,6,6,12,24,39,-15,24
SC Rheindorf,1062,7,5,6,13,19,28,-9,21
FC Salzburg,1063,1,15,6,3,46,18,28,51
SK Sturm Gra,1063,2,12,5,7,32,27,5,41
Rapid Vienna,1063,3,8,10,6,34,28,6,34
LASK Linz,1063,4,8,6,10,25,30,-5,30
Mattersburg,1063,5,8,5,11,31,39,-8,29
Vienna,1063,6,6,5,13,24,42,-18,23
SC Rheindorf,1063,7,5,7,12,21,29,-8,22
FC Salzburg,1064,1,14,7,3,44,18,26,49
Rapid Vienna,1064,2,9,10,5,36,28,8,37
SK Sturm Gra,1064,3,11,4,9,29,31,-2,37
LASK Linz,1064,4,8,7,9,28,29,-1,31
Vienna,1064,5,8,5,11,27,37,-10,29
Mattersburg,1064,6,6,6,12,31,42,-11,24
SC Rheindorf,1064,7,6,5,13,22,32,-10,23
FC Salzburg,1065,1,15,6,3,47,19,28,51
SK Sturm Gra,1065,2,13,3,8,33,31,2,42
Rapid Vienna,1065,3,8,11,5,38,29,9,35
LASK Linz,1065,4,7,8,9,30,33,-3,29
Mattersburg,1065,5,6,7,11,32,44,-12,25
SC Rheindorf,1065,6,5,8,11,20,28,-8,23
Vienna,1065,7,6,5,13,25,41,-16,23
FC Salzburg,1066,1,16,6,2,46,15,31,54
SK Sturm Gra,1066,2,13,4,7,34,28,6,43
Rapid Vienna,1066,3,9,9,6,34,27,7,36
LASK Linz,1066,4,9,5,10,31,31,0,32
Vienna,1066,5,6,6,12,24,42,-18,24
SC Rheindorf,1066,6,5,6,13,18,29,-11,21
Mattersburg,1066,7,5,6,13,29,44,-15,21
FC Salzburg,1067,1,15,7,2,44,17,27,52
SK Sturm Gra,1067,2,13,3,8,31,28,3,42
Rapid Vienna,1067,3,8,10,6,34,26,8,34
LASK Linz,1067,4,7,7,10,25,28,-3,28
Vienna,1067,5,7,5,12,24,39,-15,26
Mattersburg,1067,6,6,7,11,30,40,-10,25
SC Rheindorf,1067,7,6,5,13,18,28,-10,23
FC Salzburg,1068,1,14,7,3,47,18,29,49
SK Sturm Gra,1068,2,12,3,9,32,32,0,39
Rapid Vienna,1068,3,8,10,6,33,29,4,34
LASK Linz,1068,4,8,6,10,26,30,-4,30
Vienna,1068,5,8,5,11,27,38,-11,29
SC Rheindorf,1068,6,7,5,12,25,28,-3,26
Mattersburg,1068,7,6,6,12,33,48,-15,24
FC Salzburg,1069,1,14,8,2,41,16,25,50
SK Sturm Gra,1069,2,13,4,7,34,28,6,43
Rapid Vienna,1069,3,9,10,5,36,26,10,37
LASK Linz,1069,4,8,5,11,25,29,-4,29
Vienna,1069,5,6,7,11,24,38,-14,25
Mattersburg,1069,6,6,6,12,30,41,-11,24
SC Rheindorf,1069,7,5,6,13,18,30,-12,21
FC Salzburg,1070,1,14,7,3,45,19,26,49
Rapid Vienna,1070,2,10,10,4,37,25,12,40
SK Sturm Gra,1070,3,11,4,9,30,32,-2,37
LASK Linz,1070,4,9,5,10,29,28,1,32
Vienna,1070,5,7,6,11,25,38,-13,27
SC Rheindorf,1070,6,7,5,12,23,30,-7,26
Mattersburg,1070,7,5,5,14,28,45,-17,20
FC Salzburg,1071,1,16,6,2,50,17,33,54
SK Sturm Gra,1071,2,14,3,7,32,27,5,45
Rapid Vienna,1071,3,8,10,6,34,27,7,34
LASK Linz,1071,4,7,6,11,26,31,-5,27
Vienna,1071,5,7,5,12,24,38,-14,26
Mattersburg,1071,6,6,5,13,29,46,-17,23
SC Rheindorf,1071,7,5,7,12,20,29,-9,22
FC Salzburg,1072,1,14,6,4,43,21,22,48
SK Sturm Gra,1072,2,12,3,9,31,29,2,39
LASK Linz,1072,3,11,5,8,31,26,5,38
Rapid Vienna,1072,4,9,9,6,36,28,8,36
Vienna,1072,5,7,6,11,27,38,-11,27
SC Rheindorf,1072,6,6,5,13,18,28,-10,23
Mattersburg,1072,7,5,6,13,28,44,-16,21
FC Salzburg,1073,1,16,6,2,46,15,31,54
SK Sturm Gra,1073,2,11,4,9,30,32,-2,37
Rapid Vienna,1073,3,8,11,5,35,28,7,35
LASK Linz,1073,4,9,6,9,29,29,0,33
Vienna,1073,5,7,5,12,26,40,-14,26
SC Rheindorf,1073,6,5,8,11,22,29,-7,23
Mattersburg,1073,7,5,6,13,30,45,-15,21
FC Salzburg,1074,1,14,7,3,42,18,24,49
SK Sturm Gra,1074,2,13,5,6,34,28,6,44
Rapid Vienna,1074,3,8,11,5,34,26,8,35
LASK Linz,1074,4,8,6,10,27,29,-2,30
Mattersburg,1074,5,7,5,12,31,42,-11,26
SC Rheindorf,1074,6,6,5,13,21,30,-9,23
Vienna,1074,7,6,5,13,24,40,-16,23
FC Salzburg,1075,1,14,7,3,44,19,25,49
SK Sturm Gra,1075,2,11,5,8,31,32,-1,38
Rapid Vienna,1075,3,9,10,5,37,26,11,37
LASK Linz,1075,4,8,7,9,28,29,-1,31
SC Rheindorf,1075,5,7,6,11,21,28,-7,27
Mattersburg,1075,6,6,6,12,31,42,-11,24
Vienna,1075,7,6,5,13,26,42,-16,23
FC Salzburg,1076,1,16,6,2,48,18,30,54
SK Sturm Gra,1076,2,13,4,7,32,27,5,43
Rapid Vienna,1076,3,8,11,5,35,28,7,35
LASK Linz,1076,4,7,7,10,24,28,-4,28
Mattersburg,1076,5,7,5,12,30,40,-10,26
Vienna,1076,6,7,5,12,26,41,-15,26
SC Rheindorf,1076,7,4,6,14,17,30,-13,18
FC Salzburg,1077,1,14,7,3,43,17,26,49
SK Sturm Gra,1077,2,12,4,8,33,31,2,40
Rapid Vienna,1077,3,9,9,6,37,31,6,36
LASK Linz,1077,4,9,6,9,27,27,0,33
SC Rheindorf,1077,5,7,5,12,19,26,-7,26
Vienna,1077,6,6,7,11,24,38,-14,25
Mattersburg,1077,7,5,6,13,27,40,-13,21
FC Salzburg,1078,1,13,8,3,43,19,24,47
SK Sturm Gra,1078,2,13,4,7,31,26,5,43
Rapid Vienna,1078,3,9,10,5,35,26,9,37
LASK Linz,1078,4,9,6,9,27,27,0,33
Vienna,1078,5,7,5,12,26,41,-15,26
Mattersburg,1078,6,6,6,12,30,40,-10,24
SC Rheindorf,1078,7,4,7,13,17,30,-13,19
FC Salzburg,1079,1,14,8,2,49,19,30,50
SK Sturm Gra,1079,2,13,5,6,37,27,10,44
Rapid Vienna,1079,3,7,10,7,33,32,1,31
LASK Linz,1079,4,8,6,10,26,30,-4,30
Mattersburg,1079,5,7,5,12,33,45,-12,26
Vienna,1079,6,7,5,12,26,41,-15,26
SC Rheindorf,1079,7,6,5,13,21,31,-10,23
FC Salzburg,1080,1,13,7,4,40,19,21,46
SK Sturm Gra,1080,2,13,5,6,31,24,7,44
Rapid Vienna,1080,3,10,9,5,37,24,13,39
LASK Linz,1080,4,7,7,10,24,29,-5,28
Mattersburg,1080,5,7,6,11,30,39,-9,27
Vienna,1080,6,7,5,12,25,39,-14,26
SC Rheindorf,1080,7,4,7,13,16,29,-13,19
FC Salzburg,1081,1,15,7,2,46,16,30,52
Rapid Vienna,1081,2,9,11,4,38,27,11,38
SK Sturm Gra,1081,3,11,4,9,31,31,0,37
LASK Linz,1081,4,9,6,9,28,28,0,33
Mattersburg,1081,5,6,6,12,29,43,-14,24
Vienna,1081,6,6,5,13,24,41,-17,23
SC Rheindorf,1081,7,5,7,12,20,30,-10,22
FC Salzburg,1082,1,14,7,3,43,17,26,49
SK Sturm Gra,1082,2,11,4,9,31,32,-1,37
LASK Linz,1082,3,10,6,8,30,25,5,36
Rapid Vienna,1082,4,7,11,6,33,29,4,32
Mattersburg,1082,5,7,5,12,31,41,-10,26
Vienna,1082,6,7,5,12,25,40,-15,26
SC Rheindorf,1082,7,6,6,12,20,29,-9,24
FC Salzburg,1083,1,14,8,2,47,21,26,50
Rapid Vienna,1083,2,10,10,4,41,27,14,40
SK Sturm Gra,1083,3,12,3,9,31,32,-1,39
LASK Linz,1083,4,7,5,12,24,31,-7,26
Mattersburg,1083,5,7,5,12,34,42,-8,26
SC Rheindorf,1083,6,7,5,12,21,30,-9,26
Vienna,1083,7,6,6,12,28,43,-15,24
FC Salzburg,1084,1,15,6,3,46,19,27,51
SK Sturm Gra,1084,2,11,4,9,31,32,-1,37
Rapid Vienna,1084,3,9,9,6,35,28,7,36
LASK Linz,1084,4,9,6,9,28,27,1,33
Vienna,1084,5,8,5,11,29,39,-10,29
Mattersburg,1084,6,6,6,12,27,40,-13,24
SC Rheindorf,1084,7,5,6,13,20,31,-11,21
FC Salzburg,1085,1,15,6,3,49,18,31,51
SK Sturm Gra,1085,2,13,5,6,35,26,9,44
Rapid Vienna,1085,3,8,9,7,36,33,3,33
LASK Linz,1085,4,9,6,9,29,30,-1,33
Mattersburg,1085,5,8,5,11,32,42,-10,29
Vienna,1085,6,6,5,13,23,41,-18,23
SC Rheindorf,1085,7,4,6,14,18,32,-14,18
FC Salzburg,1086,1,13,9,2,45,19,26,48
SK Sturm Gra,1086,2,12,4,8,34,30,4,40
Rapid Vienna,1086,3,7,12,5,32,28,4,33
LASK Linz,1086,4,7,8,9,25,28,-3,29
SC Rheindorf,1086,5,6,7,11,22,29,-7,25
Vienna,1086,6,6,7,11,26,40,-14,25
Mattersburg,1086,7,5,9,10,28,38,-10,24
FC Salzburg,1087,1,14,8,2,47,19,28,50
SK Sturm Gra,1087,2,11,5,8,30,28,2,38
Rapid Vienna,1087,3,8,11,5,33,27,6,35
LASK Linz,1087,4,10,5,9,28,27,1,35
Mattersburg,1087,5,7,6,11,36,45,-9,27
Vienna,1087,6,6,7,11,28,42,-14,25
SC Rheindorf,1087,7,4,6,14,18,32,-14,18
FC Salzburg,1088,1,15,7,2,48,18,30,52
SK Sturm Gra,1088,2,12,3,9,31,30,1,39
Rapid Vienna,1088,3,8,12,4,35,26,9,36
LASK Linz,1088,4,8,6,10,28,31,-3,30
Mattersburg,1088,5,8,5,11,35,41,-6,29
Vienna,1088,6,6,5,13,25,42,-17,23
SC Rheindorf,1088,7,5,6,13,20,34,-14,21
FC Salzburg,1089,1,13,7,4,45,19,26,46
SK Sturm Gra,1089,2,12,4,8,32,27,5,40
Rapid Vienna,1089,3,10,9,5,38,27,11,39
LASK Linz,1089,4,8,7,9,31,34,-3,31
Vienna,1089,5,7,6,11,26,39,-13,27
SC Rheindorf,1089,6,6,6,12,22,32,-10,24
Mattersburg,1089,7,5,7,12,28,44,-16,22
FC Salzburg,1090,1,15,7,2,46,18,28,52
SK Sturm Gra,1090,2,13,3,8,35,31,4,42
Rapid Vienna,1090,3,9,9,6,38,30,8,36
Vienna,1090,4,7,6,11,27,40,-13,27
Mattersburg,1090,5,7,5,12,34,41,-7,26
LASK Linz,1090,6,7,5,12,24,33,-9,26
SC Rheindorf,1090,7,6,5,13,21,32,-11,23
FC Salzburg,1091,1,16,6,2,51,16,35,54
SK Sturm Gra,1091,2,12,4,8,32,33,-1,40
LASK Linz,1091,3,9,7,8,30,27,3,34
Rapid Vienna,1091,4,7,9,8,33,35,-2,30
SC Rheindorf,1091,5,7,6,11,24,27,-3,27
Mattersburg,1091,6,6,5,13,30,45,-15,23
Vienna,1091,7,6,5,13,24,41,-17,23
FC Salzburg,1092,1,14,7,3,44,21,23,49
SK Sturm Gra,1092,2,12,5,7,33,28,5,41
Rapid Vienna,1092,3,8,10,6,38,29,9,34
LASK Linz,1092,4,9,5,10,26,30,-4,32
Vienna,1092,5,7,5,12,27,40,-13,26
Mattersburg,1092,6,6,6,12,31,43,-12,24
SC Rheindorf,1092,7,5,8,11,22,30,-8,23
FC Salzburg,1093,1,13,8,3,42,19,23,47
SK Sturm Gra,1093,2,12,5,7,34,30,4,41
Rapid Vienna,1093,3,10,9,5,40,30,10,39
LASK Linz,1093,4,8,7,9,33,32,1,31
Mattersburg,1093,5,7,6,11,32,40,-8,27
Vienna,1093,6,6,6,12,25,41,-16,24
SC Rheindorf,1093,7,4,7,13,18,32,-14,19
FC Salzburg,1094,1,16,6,2,49,18,31,54
SK Sturm Gra,1094,2,13,4,7,34,29,5,43
Rapid Vienna,1094,3,8,9,7,33,29,4,33
LASK Linz,1094,4,8,7,9,27,29,-2,31
Mattersburg,1094,5,6,7,11,33,44,-11,25
Vienna,1094,6,6,6,12,24,39,-15,24
SC Rheindorf,1094,7,4,7,13,16,28,-12,19
FC Salzburg,1095,1,14,7,3,46,21,25,49
SK Sturm Gra,1095,2,12,4,8,33,31,2,40
Rapid Vienna,1095,3,10,9,5,40,27,13,39
LASK Linz,1095,4,8,5,11,25,31,-6,29
Mattersburg,1095,5,8,5,11,32,41,-9,29
Vienna,1095,6,6,6,12,26,41,-15,24
SC Rheindorf,1095,7,5,6,13,18,28,-10,21
FC Salzburg,1096,1,13,9,2,44,17,27,48
SK Sturm Gra,1096,2,13,5,6,33,27,6,44
Rapid Vienna,1096,3,9,10,5,38,26,12,37
Mattersburg,1096,4,8,5,11,34,43,-9,29
LASK Linz,1096,5,7,7,10,25,33,-8,28
Vienna,1096,6,6,6,12,26,41,-15,24
SC Rheindorf,1096,7,4,6,14,20,33,-13,18
FC Salzburg,1097,1,14,7,3,47,21,26,49
SK Sturm Gra,1097,2,13,4,7,33,29,4,43
Rapid Vienna,1097,3,8,10,6,35,27,8,34
LASK Linz,1097,4,8,5,11,26,31,-5,29
Mattersburg,1097,5,8,5,11,35,42,-7,29
Vienna,1097,6,7,5,12,26,40,-14,26
SC Rheindorf,1097,7,5,6,13,20,32,-12,21
FC Salzburg,1098,1,14,6,4,43,20,23,48
SK Sturm Gra,1098,2,13,5,6,34,28,6,44
Rapid Vienna,1098,3,8,11,5,36,27,9,35
LASK Linz,1098,4,9,7,8,34,27,7,34
Mattersburg,1098,5,6,6,12,33,45,-12,24
Vienna,1098,6,6,6,12,26,41,-15,24
SC Rheindorf,1098,7,5,5,14,19,37,-18,20
FC Salzburg,1099,1,14,8,2,46,19,27,50
SK Sturm Gra,1099,2,11,6,7,34,31,3,39
Rapid Vienna,1099,3,9,11,4,36,26,10,38
LASK Linz,1099,4,9,6,9,29,28,1,33
Mattersburg,1099,5,7,5,12,34,44,-10,26
Vienna,1099,6,6,5,13,24,42,-18,23
SC Rheindorf,1099,7,4,7,13,19,32,-13,19
FC Salzburg,1100,1,14,6,4,46,23,23,48
SK Sturm Gra,1100,2,12,5,7,33,27,6,41
Rapid Vienna,1100,3,8,10,6,35,30,5,34
LASK Linz,1100,4,9,6,9,27,26,1,33
Mattersburg,1100,5,9,5,10,37,39,-2,32
Vienna,1100,6,6,5,13,25,44,-19,23
SC Rheindorf,1100,7,4,7,13,17,31,-14,19
FC Salzburg,1101,1,14,6,4,45,21,24,48
SK Sturm Gra,1101,2,13,4,7,32,26,6,43
Rapid Vienna,1101,3,9,10,5,39,29,10,37
LASK Linz,1101,4,8,7,9,27,28,-1,31
Vienna,1101,5,8,5,11,27,37,-10,29
Mattersburg,1101,6,6,5,13,29,44,-15,23
SC Rheindorf,1101,7,4,7,13,16,30,-14,19
FC Salzburg,1102,1,14,6,4,43,19,24,48
SK Sturm Gra,1102,2,14,3,7,34,26,8,45
Rapid Vienna,1102,3,9,9,6,34,26,8,36
LASK Linz,1102,4,8,6,10,25,28,-3,30
SC Rheindorf,1102,5,6,6,12,20,29,-9,24
Vienna,1102,6,6,6,12,23,39,-16,24
Mattersburg,1102,7,5,8,11,27,39,-12,23
FC Salzburg,1103,1,13,8,3,45,19,26,47
SK Sturm Gra,1103,2,12,5,7,32,28,4,41
Rapid Vienna,1103,3,10,10,4,37,24,13,40
LASK Linz,1103,4,7,6,11,24,30,-6,27
Vienna,1103,5,7,5,12,26,41,-15,26
SC Rheindorf,1103,6,6,6,12,21,31,-10,24
Mattersburg,1103,7,6,6,12,31,43,-12,24
FC Salzburg,1104,1,15,7,2,51,17,34,52
SK Sturm Gra,1104,2,11,5,8,28,30,-2,38
Rapid Vienna,1104,3,9,10,5,33,26,7,37
LASK Linz,1104,4,10,5,9,29,26,3,35
Vienna,1104,5,7,6,11,26,38,-12,27
SC Rheindorf,1104,6,5,6,13,19,29,-10,21
Mattersburg,1104,7,5,5,14,27,47,-20,20
FC Salzburg,1105,1,15,7,2,47,19,28,52
SK Sturm Gra,1105,2,12,4,8,31,28,3,40
Rapid Vienna,1105,3,7,11,6,37,31,6,32
LASK Linz,1105,4,8,6,10,26,29,-3,30
Vienna,1105,5,7,5,12,25,38,-13,26
SC Rheindorf,1105,6,6,7,11,19,26,-7,25
Mattersburg,1105,7,6,6,12,27,41,-14,24
FC Salzburg,1106,1,15,6,3,45,19,26,51
SK Sturm Gra,1106,2,12,4,8,31,26,5,40
Rapid Vienna,1106,3,7,10,7,37,35,2,31
LASK Linz,1106,4,8,6,10,27,29,-2,30
Mattersburg,1106,5,7,7,10,33,41,-8,28
SC Rheindorf,1106,6,6,7,11,21,29,-8,25
Vienna,1106,7,6,6,12,24,39,-15,24
FC Salzburg,1107,1,15,7,2,48,16,32,52
SK Sturm Gra,1107,2,11,5,8,30,29,1,38
Rapid Vienna,1107,3,8,11,5,33,28,5,35
LASK Linz,1107,4,8,7,9,26,27,-1,31
Mattersburg,1107,5,7,7,10,29,37,-8,28
Vienna,1107,6,6,6,12,24,41,-17,24
SC Rheindorf,1107,7,4,7,13,19,31,-12,19
FC Salzburg,1108,1,13,8,3,40,18,22,47
SK Sturm Gra,1108,2,12,4,8,35,31,4,40
Rapid Vienna,1108,3,10,9,5,37,30,7,39
LASK Linz,1108,4,8,6,10,29,29,0,30
Mattersburg,1108,5,6,7,11,32,42,-10,25
SC Rheindorf,1108,6,6,6,12,23,31,-8,24
Vienna,1108,7,6,6,12,25,40,-15,24
FC Salzburg,1109,1,14,8,2,42,17,25,50
SK Sturm Gra,1109,2,12,5,7,31,27,4,41
Rapid Vienna,1109,3,8,9,7,32,32,0,33
LASK Linz,1109,4,8,7,9,28,25,3,31
Mattersburg,1109,5,6,7,11,31,39,-8,25
Vienna,1109,6,6,6,12,23,40,-17,24
SC Rheindorf,1109,7,5,8,11,20,27,-7,23
FC Salzburg,1110,1,14,7,3,41,17,24,49
Rapid Vienna,1110,2,10,10,4,37,26,11,40
SK Sturm Gra,1110,3,11,4,9,30,29,1,37
LASK Linz,1110,4,8,8,8,28,28,0,32
Vienna,1110,5,7,6,11,27,39,-12,27
Mattersburg,1110,6,6,6,12,31,43,-12,24
SC Rheindorf,1110,7,5,5,14,18,30,-12,20
FC Salzburg,1111,1,15,7,2,43,17,26,52
SK Sturm Gra,1111,2,12,3,9,32,30,2,39
Rapid Vienna,1111,3,9,9,6,36,28,8,36
LASK Linz,1111,4,8,5,11,24,28,-4,29
Mattersburg,1111,5,7,6,11,30,39,-9,27
Vienna,1111,6,7,5,12,25,39,-14,26
SC Rheindorf,1111,7,6,5,13,19,28,-9,23
FC Salzburg,1112,1,15,6,3,44,17,27,51
Rapid Vienna,1112,2,10,9,5,37,26,11,39
SK Sturm Gra,1112,3,11,3,10,32,32,0,36
LASK Linz,1112,4,10,5,9,33,31,2,35
Mattersburg,1112,5,7,5,12,30,42,-12,26
Vienna,1112,6,7,5,12,25,39,-14,26
SC Rheindorf,1112,7,5,5,14,20,34,-14,20
FC Salzburg,1113,1,14,7,3,44,20,24,49
Rapid Vienna,1113,2,10,10,4,39,24,15,40
SK Sturm Gra,1113,3,11,4,9,29,30,-1,37
LASK Linz,1113,4,8,7,9,26,31,-5,31
Vienna,1113,5,7,6,11,25,38,-13,27
SC Rheindorf,1113,6,6,5,13,21,28,-7,23
Mattersburg,1113,7,5,7,12,32,45,-13,22
FC Salzburg,1114,1,14,8,2,47,18,29,50
SK Sturm Gra,1114,2,14,3,7,35,28,7,45
Rapid Vienna,1114,3,8,10,6,37,28,9,34
LASK Linz,1114,4,9,6,9,29,29,0,33
Vienna,1114,5,7,6,11,26,39,-13,27
Mattersburg,1114,6,5,6,13,30,48,-18,21
SC Rheindorf,1114,7,5,5,14,20,34,-14,20
FC Salzburg,1115,1,13,6,5,41,21,20,45
SK Sturm Gra,1115,2,12,5,7,30,29,1,41
LASK Linz,1115,3,10,6,8,30,25,5,36
Rapid Vienna,1115,4,8,10,6,36,28,8,34
Vienna,1115,5,7,6,11,26,39,-13,27
Mattersburg,1115,6,5,8,11,32,43,-11,23
SC Rheindorf,1115,7,5,7,12,19,29,-10,22
FC Salzburg,1116,1,16,6,2,48,17,31,54
SK Sturm Gra,1116,2,11,5,8,32,31,1,38
Rapid Vienna,1116,3,8,10,6,34,31,3,34
LASK Linz,1116,4,9,5,10,29,29,0,32
Vienna,1116,5,7,5,12,25,39,-14,26
Mattersburg,1116,6,6,6,12,30,41,-11,24
SC Rheindorf,1116,7,5,7,12,19,29,-10,22
FC Salzburg,1117,1,13,8,3,46,20,26,47
SK Sturm Gra,1117,2,12,4,8,33,31,2,40
Rapid Vienna,1117,3,10,9,5,36,26,10,39
LASK Linz,1117,4,10,5,9,29,30,-1,35
Vienna,1117,5,7,6,11,28,38,-10,27
Mattersburg,1117,6,5,7,12,30,45,-15,22
SC Rheindorf,1117,7,4,7,13,19,31,-12,19
FC Salzburg,1118,1,14,8,2,45,19,26,50
SK Sturm Gra,1118,2,12,3,9,30,31,-1,39
Rapid Vienna,1118,3,8,11,5,35,26,9,35
LASK Linz,1118,4,9,6,9,31,27,4,33
Vienna,1118,5,7,6,11,28,40,-12,27
SC Rheindorf,1118,6,6,7,11,22,28,-6,25
Mattersburg,1118,7,5,5,14,29,49,-20,20
FC Salzburg,1119,1,14,7,3,48,20,28,49
Rapid Vienna,1119,2,10,9,5,37,25,12,39
SK Sturm Gra,1119,3,12,3,9,31,32,-1,39
LASK Linz,1119,4,8,6,10,28,31,-3,30
Vienna,1119,5,7,6,11,28,40,-12,27
SC Rheindorf,1119,6,6,6,12,20,30,-10,24
Mattersburg,1119,7,6,5,13,33,47,-14,23
FC Salzburg,1120,1,14,7,3,47,19,28,49
SK Sturm Gra,1120,2,13,3,8,32,31,1,42
Rapid Vienna,1120,3,9,9,6,35,26,9,36
LASK Linz,1120,4,10,5,9,28,28,0,35
Vienna,1120,5,7,6,11,27,39,-12,27
Mattersburg,1120,6,7,5,12,33,43,-10,26
SC Rheindorf,1120,7,4,5,15,16,32,-16,17
FC Salzburg,1121,1,16,6,2,46,17,29,54
SK Sturm Gra,1121,2,12,4,8,33,32,1,40
Rapid Vienna,1121,3,8,10,6,37,30,7,34
LASK Linz,1121,4,7,7,10,26,31,-5,28
SC Rheindorf,1121,5,7,5,12,26,33,-7,26
Mattersburg,1121,6,7,5,12,33,42,-9,26
Vienna,1121,7,6,5,13,25,41,-16,23
FC Salzburg,1122,1,14,8,2,45,17,28,50
SK Sturm Gra,1122,2,11,6,7,32,31,1,39
Rapid Vienna,1122,3,7,11,6,33,29,4,32
LASK Linz,1122,4,8,6,10,29,33,-4,30
Mattersburg,1122,5,7,7,10,33,40,-7,28
Vienna,1122,6,6,7,11,26,40,-14,25
SC Rheindorf,1122,7,5,7,12,19,27,-8,22
FC Salzburg,1123,1,13,8,3,40,17,23,47
SK Sturm Gra,1123,2,13,3,8,32,29,3,42
Rapid Vienna,1123,3,8,10,6,34,27,7,34
LASK Linz,1123,4,8,6,10,26,28,-2,30
Mattersburg,1123,5,8,5,11,31,39,-8,29
SC Rheindorf,1123,6,6,6,12,20,28,-8,24
Vienna,1123,7,6,6,12,24,39,-15,24
FC Salzburg,1124,1,15,6,3,45,19,26,51
SK Sturm Gra,1124,2,12,4,8,33,28,5,40
Rapid Vienna,1124,3,10,9,5,36,26,10,39
LASK Linz,1124,4,7,6,11,25,31,-6,27
Mattersburg,1124,5,7,6,11,29,39,-10,27
Vienna,1124,6,7,6,11,28,41,-13,27
SC Rheindorf,1124,7,5,5,14,18,30,-12,20
FC Salzburg,1125,1,14,7,3,45,22,23,49
SK Sturm Gra,1125,2,12,5,7,32,28,4,41
Rapid Vienna,1125,3,9,10,5,37,27,10,37
LASK Linz,1125,4,7,9,8,26,27,-1,30
Vienna,1125,5,7,5,12,27,41,-14,26
Mattersburg,1125,6,6,7,11,32,42,-10,25
SC Rheindorf,1125,7,4,7,13,19,31,-12,19
FC Salzburg,1126,1,15,7,2,45,18,27,52
SK Sturm Gra,1126,2,12,5,7,35,29,6,41
Rapid Vienna,1126,3,10,9,5,37,28,9,39
Mattersburg,1126,4,8,5,11,34,38,-4,29
LASK Linz,1126,5,7,5,12,25,33,-8,26
Vienna,1126,6,6,5,13,25,42,-17,23
SC Rheindorf,1126,7,5,6,13,17,30,-13,21
FC Salzburg,1127,1,14,8,2,44,18,26,50
SK Sturm Gra,1127,2,12,5,7,36,30,6,41
Rapid Vienna,1127,3,8,12,4,35,26,9,36
LASK Linz,1127,4,8,7,9,27,29,-2,31
Mattersburg,1127,5,7,6,11,29,37,-8,27
Vienna,1127,6,7,5,12,24,39,-15,26
SC Rheindorf,1127,7,4,5,15,15,31,-16,17
FC Salzburg,1128,1,14,7,3,44,20,24,49
SK Sturm Gra,1128,2,12,3,9,34,33,1,39
Rapid Vienna,1128,3,8,11,5,35,27,8,35
LASK Linz,1128,4,9,7,8,30,29,1,34
Mattersburg,1128,5,7,6,11,31,42,-11,27
Vienna,1128,6,7,5,12,26,38,-12,26
SC Rheindorf,1128,7,5,5,14,20,31,-11,20
FC Salzburg,1129,1,15,6,3,51,19,32,51
SK Sturm Gra,1129,2,13,3,8,35,31,4,42
Rapid Vienna,1129,3,9,9,6,37,29,8,36
SC Rheindorf,1129,4,7,6,11,24,28,-4,27
LASK Linz,1129,5,7,6,11,26,34,-8,27
Mattersburg,1129,6,7,5,12,33,47,-14,26
Vienna,1129,7,6,5,13,25,43,-18,23
FC Salzburg,1130,1,14,7,3,45,19,26,49
SK Sturm Gra,1130,2,12,5,7,31,28,3,41
Rapid Vienna,1130,3,8,10,6,37,29,8,34
LASK Linz,1130,4,8,7,9,27,28,-1,31
Mattersburg,1130,5,7,6,11,31,41,-10,27
Vienna,1130,6,7,6,11,25,38,-13,27
SC Rheindorf,1130,7,5,5,14,19,32,-13,20
FC Salzburg,1131,1,13,9,2,45,19,26,48
SK Sturm Gra,1131,2,12,5,7,34,32,2,41
Rapid Vienna,1131,3,8,10,6,37,31,6,34
Mattersburg,1131,4,8,6,10,33,37,-4,30
LASK Linz,1131,5,8,5,11,26,29,-3,29
Vienna,1131,6,6,6,12,26,42,-16,24
SC Rheindorf,1131,7,6,5,13,22,33,-11,23
FC Salzburg,1132,1,16,6,2,49,18,31,54
Rapid Vienna,1132,2,9,10,5,36,28,8,37
SK Sturm Gra,1132,3,11,4,9,33,32,1,37
LASK Linz,1132,4,10,6,8,29,27,2,36
Vienna,1132,5,7,5,12,26,41,-15,26
Mattersburg,1132,6,5,6,13,27,41,-14,21
SC Rheindorf,1132,7,4,7,13,16,29,-13,19
FC Salzburg,1133,1,15,7,2,46,19,27,52
SK Sturm Gra,1133,2,11,5,8,30,28,2,38
LASK Linz,1133,3,9,6,9,29,28,1,33
Rapid Vienna,1133,4,7,11,6,34,29,5,32
Vienna,1133,5,7,5,12,27,41,-14,26
SC Rheindorf,1133,6,6,6,12,19,29,-10,24
Mattersburg,1133,7,6,6,12,35,46,-11,24
FC Salzburg,1134,1,15,6,3,48,17,31,51
SK Sturm Gra,1134,2,13,4,7,34,27,7,43
Rapid Vienna,1134,3,9,11,4,35,25,10,38
LASK Linz,1134,4,8,7,9,27,27,0,31
Vienna,1134,5,7,5,12,26,43,-17,26
Mattersburg,1134,6,6,5,13,31,45,-14,23
SC Rheindorf,1134,7,4,6,14,16,33,-17,18
FC Salzburg,1135,1,15,7,2,44,15,29,52
SK Sturm Gra,1135,2,11,5,8,30,32,-2,38
Rapid Vienna,1135,3,8,10,6,34,27,7,34
LASK Linz,1135,4,8,6,10,25,32,-7,30
Vienna,1135,5,7,5,12,27,38,-11,26
Mattersburg,1135,6,7,5,12,31,43,-12,26
SC Rheindorf,1135,7,6,6,12,24,28,-4,24
FC Salzburg,1136,1,14,6,4,43,19,24,48
SK Sturm Gra,1136,2,12,4,8,30,27,3,40
Rapid Vienna,1136,3,10,9,5,37,27,10,39
LASK Linz,1136,4,9,5,10,27,28,-1,32
Mattersburg,1136,5,7,5,12,29,41,-12,26
Vienna,1136,6,7,5,12,27,40,-13,26
SC Rheindorf,1136,7,5,6,13,16,27,-11,21
FC Salzburg,1137,1,15,6,3,45,16,29,51
SK Sturm Gra,1137,2,12,3,9,31,29,2,39
Rapid Vienna,1137,3,8,9,7,35,30,5,33
LASK Linz,1137,4,9,6,9,29,29,0,33
Vienna,1137,5,7,5,12,26,44,-18,26
SC Rheindorf,1137,6,6,7,11,22,29,-7,25
Mattersburg,1137,7,6,6,12,34,45,-11,24
FC Salzburg,1138,1,13,6,5,41,19,22,45
Rapid Vienna,1138,2,10,10,4,36,25,11,40
SK Sturm Gra,1138,3,12,4,8,32,29,3,40
LASK Linz,1138,4,7,8,9,25,27,-2,29
Mattersburg,1138,5,7,7,10,33,39,-6,28
Vienna,1138,6,7,6,11,26,39,-13,27
SC Rheindorf,1138,7,5,5,14,16,31,-15,20
FC Salzburg,1139,1,14,8,2,45,19,26,50
SK Sturm Gra,1139,2,12,3,9,32,30,2,39
Rapid Vienna,1139,3,8,11,5,35,29,6,35
LASK Linz,1139,4,9,5,10,29,28,1,32
Vienna,1139,5,7,5,12,27,40,-13,26
SC Rheindorf,1139,6,6,7,11,20,28,-8,25
Mattersburg,1139,7,5,7,12,29,43,-14,22
FC Salzburg,1140,1,16,6,2,47,18,29,54
SK Sturm Gra,1140,2,13,3,8,34,29,5,42
Rapid Vienna,1140,3,9,9,6,37,29,8,36
LASK Linz,1140,4,8,5,11,26,30,-4,29
Vienna,1140,5,7,5,12,26,40,-14,26
Mattersburg,1140,6,6,6,12,29,42,-13,24
SC Rheindorf,1140,7,5,6,13,17,28,-11,21
FC Salzburg,1141,1,14,8,2,46,20,26,50
SK Sturm Gra,1141,2,13,5,6,36,27,9,44
Rapid Vienna,1141,3,8,10,6,37,29,8,34
LASK Linz,1141,4,8,7,9,28,31,-3,31
Vienna,1141,5,7,5,12,28,42,-14,26
Mattersburg,1141,6,6,6,12,31,41,-10,24
SC Rheindorf,1141,7,4,7,13,17,33,-16,19
FC Salzburg,1142,1,15,6,3,44,17,27,51
SK Sturm Gra,1142,2,11,6,7,33,31,2,39
Rapid Vienna,1142,3,8,10,6,37,31,6,34
LASK Linz,1142,4,8,7,9,27,30,-3,31
Mattersburg,1142,5,8,5,11,34,39,-5,29
Vienna,1142,6,7,5,12,24,38,-14,26
SC Rheindorf,1142,7,4,7,13,19,32,-13,19
FC Salzburg,1143,1,14,7,3,44,17,27,49
SK Sturm Gra,1143,2,13,4,7,35,29,6,43
Rapid Vienna,1143,3,9,10,5,35,27,8,37
Mattersburg,1143,4,8,5,11,31,40,-9,29
LASK Linz,1143,5,7,6,11,27,33,-6,27
SC Rheindorf,1143,6,6,5,13,19,29,-10,23
Vienna,1143,7,6,5,13,23,39,-16,23
FC Salzburg,1144,1,13,8,3,44,20,24,47
SK Sturm Gra,1144,2,11,6,7,31,28,3,39
Rapid Vienna,1144,3,8,12,4,37,28,9,36
Vienna,1144,4,8,5,11,28,40,-12,29
LASK Linz,1144,5,7,7,10,25,30,-5,28
Mattersburg,1144,6,7,5,12,32,41,-9,26
SC Rheindorf,1144,7,5,7,12,22,32,-10,22
FC Salzburg,1145,1,14,6,4,45,18,27,48
SK Sturm Gra,1145,2,14,3,7,37,26,11,45
Rapid Vienna,1145,3,8,10,6,34,27,7,34
Mattersburg,1145,4,8,6,10,32,37,-5,30
LASK Linz,1145,5,7,7,10,25,32,-7,28
Vienna,1145,6,6,6,12,24,43,-19,24
SC Rheindorf,1145,7,5,6,13,18,32,-14,21
FC Salzburg,1146,1,16,6,2,47,19,28,54
SK Sturm Gra,1146,2,13,3,8,34,28,6,42
Rapid Vienna,1146,3,8,10,6,37,29,8,34
LASK Linz,1146,4,8,6,10,29,33,-4,30
Mattersburg,1146,5,7,6,11,32,39,-7,27
Vienna,1146,6,6,6,12,23,38,-15,24
SC Rheindorf,1146,7,5,5,14,20,36,-16,20
FC Salzburg,1147,1,13,7,4,44,21,23,46
SK Sturm Gra,1147,2,13,5,6,31,25,6,44
LASK Linz,1147,3,10,5,9,32,25,7,35
Rapid Vienna,1147,4,7,12,5,35,29,6,33
Mattersburg,1147,5,6,7,11,31,41,-10,25
Vienna,1147,6,6,6,12,23,41,-18,24
SC Rheindorf,1147,7,4,8,12,18,32,-14,20
FC Salzburg,1148,1,14,8,2,44,17,27,50
SK Sturm Gra,1148,2,11,6,7,29,27,2,39
Rapid Vienna,1148,3,8,12,4,40,27,13,36
LASK Linz,1148,4,8,6,10,28,35,-7,30
Mattersburg,1148,5,7,5,12,33,43,-10,26
Vienna,1148,6,7,5,12,25,39,-14,26
SC Rheindorf,1148,7,5,6,13,21,32,-11,21
FC Salzburg,1149,1,15,7,2,44,15,29,52
SK Sturm Gra,1149,2,12,5,7,31,28,3,41
Rapid Vienna,1149,3,8,9,7,33,28,5,33
LASK Linz,1149,4,8,6,10,28,30,-2,30
Mattersburg,1149,5,7,7,10,33,39,-6,28
Vienna,1149,6,6,5,13,23,43,-20,23
SC Rheindorf,1149,7,5,7,12,21,30,-9,22
FC Salzburg,1150,1,14,6,4,47,21,26,48
SK Sturm Gra,1150,2,12,4,8,34,31,3,40
Rapid Vienna,1150,3,8,10,6,35,29,6,34
LASK Linz,1150,4,9,5,10,32,34,-2,32
Vienna,1150,5,8,5,11,29,41,-12,29
Mattersburg,1150,6,6,6,12,32,45,-13,24
SC Rheindorf,1150,7,5,8,11,21,29,-8,23
FC Salzburg,1151,1,13,8,3,44,19,25,47
SK Sturm Gra,1151,2,13,3,8,34,31,3,42
Rapid Vienna,1151,3,8,11,5,36,29,7,35
LASK Linz,1151,4,8,7,9,29,29,0,31
Vienna,1151,5,8,5,11,27,39,-12,29
SC Rheindorf,1151,6,6,5,13,20,31,-11,23
Mattersburg,1151,7,5,7,12,29,41,-12,22
FC Salzburg,1152,1,13,8,3,47,24,23,47
SK Sturm Gra,1152,2,14,4,6,35,26,9,46
Rapid Vienna,1152,3,8,10,6,34,28,6,34
LASK Linz,1152,4,8,5,11,26,30,-4,29
Mattersburg,1152,5,8,5,11,34,40,-6,29
Vienna,1152,6,6,6,12,28,43,-15,24
SC Rheindorf,1152,7,5,6,13,19,32,-13,21
FC Salzburg,1153,1,15,7,2,46,16,30,52
SK Sturm Gra,1153,2,12,4,8,31,28,3,40
LASK Linz,1153,3,10,6,8,34,29,5,36
Rapid Vienna,1153,4,7,10,7,33,32,1,31
Vienna,1153,5,6,6,12,25,42,-17,24
Mattersburg,1153,6,5,8,11,30,41,-11,23
SC Rheindorf,1153,7,6,5,13,20,31,-11,23
FC Salzburg,1154,1,14,7,3,47,20,27,49
SK Sturm Gra,1154,2,12,5,7,37,33,4,41
Rapid Vienna,1154,3,9,9,6,37,29,8,36
LASK Linz,1154,4,8,6,10,26,30,-4,30
Mattersburg,1154,5,7,6,11,32,40,-8,27
Vienna,1154,6,7,5,12,26,41,-15,26
SC Rheindorf,1154,7,5,6,13,20,32,-12,21
FC Salzburg,1155,1,14,8,2,44,18,26,50
SK Sturm Gra,1155,2,12,5,7,32,27,5,41
Rapid Vienna,1155,3,7,12,5,34,28,6,33
LASK Linz,1155,4,9,6,9,26,26,0,33
Mattersburg,1155,5,7,6,11,34,41,-7,27
Vienna,1155,6,6,6,12,25,41,-16,24
SC Rheindorf,1155,7,4,7,13,19,33,-14,19
FC Salzburg,1156,1,15,7,2,46,17,29,52
SK Sturm Gra,1156,2,13,4,7,38,30,8,43
Rapid Vienna,1156,3,7,9,8,34,32,2,30
LASK Linz,1156,4,8,5,11,26,32,-6,29
Vienna,1156,5,7,6,11,27,39,-12,27
SC Rheindorf,1156,6,6,7,11,21,28,-7,25
Mattersburg,1156,7,6,6,12,30,44,-14,24
FC Salzburg,1157,1,16,6,2,46,17,29,54
SK Sturm Gra,1157,2,11,4,9,30,31,-1,37
Rapid Vienna,1157,3,8,9,7,35,31,4,33
LASK Linz,1157,4,8,7,9,29,28,1,31
SC Rheindorf,1157,5,7,6,11,20,26,-6,27
Mattersburg,1157,6,6,6,12,28,40,-12,24
Vienna,1157,7,6,6,12,25,40,-15,24
SK Sturm Gra,1158,1,14,3,7,37,29,8,45
FC Salzburg,1158,2,12,7,5,42,23,19,43
Rapid Vienna,1158,3,9,10,5,36,25,11,37
LASK Linz,1158,4,8,5,11,26,33,-7,29
Vienna,1158,5,8,5,11,27,39,-12,29
Mattersburg,1158,6,7,5,12,34,43,-9,26
SC Rheindorf,1158,7,6,5,13,20,30,-10,23
FC Salzburg,1159,1,15,6,3,48,20,28,51
SK Sturm Gra,1159,2,12,3,9,33,30,3,39
Rapid Vienna,1159,3,8,10,6,32,27,5,34
LASK Linz,1159,4,8,6,10,26,30,-4,30
Vienna,1159,5,8,5,11,29,40,-11,29
Mattersburg,1159,6,6,6,12,31,43,-12,24
SC Rheindorf,1159,7,5,8,11,19,28,-9,23
FC Salzburg,1160,1,14,7,3,42,17,25,49
SK Sturm Gra,1160,2,12,5,7,32,27,5,41
Rapid Vienna,1160,3,8,11,5,34,27,7,35
LASK Linz,1160,4,9,6,9,28,29,-1,33
Mattersburg,1160,5,8,5,11,32,38,-6,29
Vienna,1160,6,6,5,13,24,40,-16,23
SC Rheindorf,1160,7,4,7,13,20,34,-14,19
FC Salzburg,1161,1,15,7,2,48,18,30,52
SK Sturm Gra,1161,2,13,3,8,32,30,2,42
Rapid Vienna,1161,3,9,10,5,39,31,8,37
LASK Linz,1161,4,10,5,9,34,29,5,35
Mattersburg,1161,5,6,6,12,34,47,-13,24
Vienna,1161,6,6,6,12,25,41,-16,24
SC Rheindorf,1161,7,4,5,15,18,34,-16,17
FC Salzburg,1162,1,16,6,2,44,17,27,54
SK Sturm Gra,1162,2,12,5,7,31,27,4,41
LASK Linz,1162,3,10,5,9,29,26,3,35
Rapid Vienna,1162,4,7,11,6,34,28,6,32
Vienna,1162,5,7,5,12,25,38,-13,26
SC Rheindorf,1162,6,5,7,12,18,27,-9,22
Mattersburg,1162,7,5,5,14,28,46,-18,20
FC Salzburg,1163,1,14,7,3,46,18,28,49
SK Sturm Gra,1163,2,12,4,8,32,30,2,40
Rapid Vienna,1163,3,9,10,5,36,27,9,37
LASK Linz,1163,4,7,7,10,25,29,-4,28
SC Rheindorf,1163,5,7,6,11,24,28,-4,27
Vienna,1163,6,6,6,12,24,43,-19,24
Mattersburg,1163,7,5,8,11,29,41,-12,23
FC Salzburg,1164,1,14,8,2,45,17,28,50
SK Sturm Gra,1164,2,13,4,7,33,26,7,43
Rapid Vienna,1164,3,8,11,5,34,26,8,35
LASK Linz,1164,4,7,7,10,24,29,-5,28
Mattersburg,1164,5,7,6,11,30,41,-11,27
SC Rheindorf,1164,6,6,5,13,18,29,-11,23
Vienna,1164,7,6,5,13,25,41,-16,23
FC Salzburg,1165,1,14,6,4,43,23,20,48
Rapid Vienna,1165,2,9,11,4,39,24,15,38
SK Sturm Gra,1165,3,11,5,8,31,33,-2,38
LASK Linz,1165,4,8,7,9,32,31,1,31
Vienna,1165,5,8,5,11,26,38,-12,29
SC Rheindorf,1165,6,5,7,12,19,29,-10,22
Mattersburg,1165,7,5,7,12,30,42,-12,22
FC Salzburg,1166,1,13,6,5,42,22,20,45
SK Sturm Gra,1166,2,13,3,8,35,30,5,42
Rapid Vienna,1166,3,9,10,5,38,29,9,37
LASK Linz,1166,4,8,6,10,29,31,-2,30
Mattersburg,1166,5,7,6,11,32,41,-9,27
Vienna,1166,6,7,5,12,27,41,-14,26
SC Rheindorf,1166,7,6,6,12,21,30,-9,24
FC Salzburg,1167,1,15,6,3,49,19,30,51
SK Sturm Gra,1167,2,13,4,7,32,26,6,43
Rapid Vienna,1167,3,8,10,6,36,28,8,34
LASK Linz,1167,4,9,5,10,29,33,-4,32
Vienna,1167,5,7,5,12,28,43,-15,26
Mattersburg,1167,6,6,5,13,35,52,-17,23
SC Rheindorf,1167,7,5,7,12,22,30,-8,22
FC Salzburg,1168,1,16,6,2,45,16,29,54
SK Sturm Gra,1168,2,12,3,9,34,30,4,39
LASK Linz,1168,3,10,5,9,32,32,0,35
Rapid Vienna,1168,4,8,9,7,33,29,4,33
Mattersburg,1168,5,8,5,11,35,42,-7,29
Vienna,1168,6,6,5,13,24,42,-18,23
SC Rheindorf,1168,7,5,5,14,21,33,-12,20
FC Salzburg,1169,1,13,7,4,44,23,21,46
SK Sturm Gra,1169,2,12,5,7,33,28,5,41
Rapid Vienna,1169,3,9,11,4,38,25,13,38
LASK Linz,1169,4,8,8,8,26,25,1,32
Vienna,1169,5,7,6,11,25,38,-13,27
Mattersburg,1169,6,6,7,11,30,40,-10,25
SC Rheindorf,1169,7,4,6,14,16,33,-17,18
FC Salzburg,1170,1,15,6,3,50,17,33,51
SK Sturm Gra,1170,2,14,3,7,37,28,9,45
Rapid Vienna,1170,3,8,10,6,35,29,6,34
LASK Linz,1170,4,9,6,9,27,27,0,33
Mattersburg,1170,5,6,7,11,30,46,-16,25
Vienna,1170,6,6,6,12,24,40,-16,24
SC Rheindorf,1170,7,4,6,14,17,33,-16,18
FC Salzburg,1171,1,15,6,3,50,20,30,51
SK Sturm Gra,1171,2,12,4,8,30,28,2,40
Rapid Vienna,1171,3,10,9,5,40,26,14,39
LASK Linz,1171,4,10,5,9,30,26,4,35
Vienna,1171,5,7,5,12,25,43,-18,26
SC Rheindorf,1171,6,5,6,13,17,32,-15,21
Mattersburg,1171,7,5,5,14,28,45,-17,20
FC Salzburg,1172,1,13,7,4,43,20,23,46
Rapid Vienna,1172,2,10,10,4,39,25,14,40
SK Sturm Gra,1172,3,12,4,8,34,31,3,40
Vienna,1172,4,8,5,11,27,39,-12,29
LASK Linz,1172,5,7,6,11,23,33,-10,27
Mattersburg,1172,6,6,7,11,31,39,-8,25
SC Rheindorf,1172,7,4,9,11,16,26,-10,21
FC Salzburg,1173,1,15,7,2,46,17,29,52
SK Sturm Gra,1173,2,12,5,7,31,27,4,41
Rapid Vienna,1173,3,9,10,5,38,27,11,37
LASK Linz,1173,4,7,6,11,26,36,-10,27
Mattersburg,1173,5,7,5,12,31,40,-9,26
Vienna,1173,6,6,6,12,23,38,-15,24
SC Rheindorf,1173,7,5,7,12,19,29,-10,22
FC Salzburg,1174,1,14,7,3,45,20,25,49
SK Sturm Gra,1174,2,12,5,7,31,27,4,41
Rapid Vienna,1174,3,8,11,5,36,27,9,35
LASK Linz,1174,4,7,9,8,25,26,-1,30
Mattersburg,1174,5,7,6,11,33,43,-10,27
Vienna,1174,6,6,5,13,27,43,-16,23
SC Rheindorf,1174,7,5,7,12,19,30,-11,22
FC Salzburg,1175,1,14,7,3,47,17,30,49
SK Sturm Gra,1175,2,13,3,8,31,27,4,42
Rapid Vienna,1175,3,8,9,7,33,29,4,33
LASK Linz,1175,4,9,6,9,28,27,1,33
Vienna,1175,5,7,6,11,30,39,-9,27
SC Rheindorf,1175,6,6,6,12,20,28,-8,24
Mattersburg,1175,7,6,5,13,28,50,-22,23
FC Salzburg,1176,1,15,7,2,48,18,30,52
SK Sturm Gra,1176,2,12,5,7,34,30,4,41
Rapid Vienna,1176,3,7,12,5,33,27,6,33
LASK Linz,1176,4,8,6,10,27,28,-1,30
Mattersburg,1176,5,8,5,11,35,44,-9,29
Vienna,1176,6,6,5,13,26,44,-18,23
SC Rheindorf,1176,7,4,8,12,19,31,-12,20
FC Salzburg,1177,1,15,7,2,47,20,27,52
SK Sturm Gra,1177,2,12,4,8,34,30,4,40
Rapid Vienna,1177,3,8,9,7,34,31,3,33
LASK Linz,1177,4,8,6,10,29,30,-1,30
Mattersburg,1177,5,8,5,11,33,40,-7,29
Vienna,1177,6,6,6,12,26,41,-15,24
SC Rheindorf,1177,7,6,5,13,19,30,-11,23
FC Salzburg,1178,1,14,7,3,42,18,24,49
SK Sturm Gra,1178,2,12,3,9,31,33,-2,39
Rapid Vienna,1178,3,9,10,5,38,25,13,37
LASK Linz,1178,4,8,5,11,25,30,-5,29
SC Rheindorf,1178,5,6,7,11,21,27,-6,25
Mattersburg,1178,6,6,7,11,28,38,-10,25
Vienna,1178,7,6,7,11,24,38,-14,25
SK Sturm Gra,1179,1,15,3,6,36,25,11,48
FC Salzburg,1179,2,13,8,3,43,19,24,47
Rapid Vienna,1179,3,8,9,7,36,31,5,33
LASK Linz,1179,4,8,7,9,28,28,0,31
Mattersburg,1179,5,7,7,10,35,42,-7,28
Vienna,1179,6,6,6,12,24,39,-15,24
SC Rheindorf,1179,7,4,6,14,19,37,-18,18
FC Salzburg,1180,1,16,6,2,46,16,30,54
SK Sturm Gra,1180,2,13,3,8,34,28,6,42
Rapid Vienna,1180,3,7,10,7,32,29,3,31
LASK Linz,1180,4,8,5,11,27,32,-5,29
Vienna,1180,5,7,5,12,26,42,-16,26
SC Rheindorf,1180,6,6,7,11,19,26,-7,25
Mattersburg,1180,7,6,6,12,30,41,-11,24
FC Salzburg,1181,1,14,8,2,47,17,30,50
SK Sturm Gra,1181,2,12,5,7,32,27,5,41
Rapid Vienna,1181,3,9,10,5,36,26,10,37
LASK Linz,1181,4,9,6,9,27,27,0,33
Mattersburg,1181,5,7,6,11,29,42,-13,27
Vienna,1181,6,6,5,13,24,41,-17,23
SC Rheindorf,1181,7,4,6,14,18,33,-15,18
FC Salzburg,1182,1,14,7,3,47,21,26,49
SK Sturm Gra,1182,2,14,3,7,34,26,8,45
Rapid Vienna,1182,3,9,10,5,39,28,11,37
LASK Linz,1182,4,8,7,9,27,27,0,31
Vienna,1182,5,7,6,11,27,40,-13,27
Mattersburg,1182,6,5,6,13,29,44,-15,21
SC Rheindorf,1182,7,4,7,13,16,33,-17,19
FC Salzburg,1183,1,16,6,2,48,18,30,54
SK Sturm Gra,1183,2,12,5,7,33,29,4,41
Rapid Vienna,1183,3,8,10,6,34,26,8,34
LASK Linz,1183,4,8,6,10,30,32,-2,30
Vienna,1183,5,7,5,12,28,41,-13,26
Mattersburg,1183,6,6,5,13,30,46,-16,23
SC Rheindorf,1183,7,5,7,12,18,29,-11,22
FC Salzburg,1184,1,14,6,4,42,18,24,48
Rapid Vienna,1184,2,10,10,4,36,24,12,40
SK Sturm Gra,1184,3,12,4,8,29,28,1,40
LASK Linz,1184,4,7,7,10,25,28,-3,28
Vienna,1184,5,7,6,11,26,39,-13,27
Mattersburg,1184,6,6,7,11,33,43,-10,25
SC Rheindorf,1184,7,5,6,13,19,30,-11,21
FC Salzburg,1185,1,14,7,3,50,22,28,49
SK Sturm Gra,1185,2,12,4,8,33,33,0,40
Rapid Vienna,1185,3,7,10,7,34,31,3,31
Mattersburg,1185,4,8,6,10,34,39,-5,30
LASK Linz,1185,5,8,5,11,26,30,-4,29
SC Rheindorf,1185,6,7,5,12,20,28,-8,26
Vienna,1185,7,7,5,12,25,39,-14,26
FC Salzburg,1186,1,16,6,2,48,18,30,54
SK Sturm Gra,1186,2,12,4,8,32,34,-2,40
Rapid Vienna,1186,3,9,10,5,37,25,12,37
LASK Linz,1186,4,7,7,10,25,29,-4,28
Mattersburg,1186,5,7,5,12,32,42,-10,26
Vienna,1186,6,7,5,12,29,43,-14,26
SC Rheindorf,1186,7,4,7,13,17,29,-12,19
FC Salzburg,1187,1,14,7,3,46,18,28,49
SK Sturm Gra,1187,2,14,4,6,33,26,7,46
Rapid Vienna,1187,3,8,9,7,36,34,2,33
LASK Linz,1187,4,9,5,10,30,30,0,32
Vienna,1187,5,6,7,11,25,39,-14,25
Mattersburg,1187,6,6,6,12,30,41,-11,24
SC Rheindorf,1187,7,5,6,13,18,30,-12,21
FC Salzburg,1188,1,15,6,3,49,20,29,51
SK Sturm Gra,1188,2,13,4,7,34,29,5,43
Rapid Vienna,1188,3,8,11,5,36,28,8,35
LASK Linz,1188,4,8,7,9,26,28,-2,31
SC Rheindorf,1188,5,6,6,12,21,29,-8,24
Mattersburg,1188,6,6,5,13,29,44,-15,23
Vienna,1188,7,6,5,13,24,41,-17,23
FC Salzburg,1189,1,14,8,2,46,18,28,50
SK Sturm Gra,1189,2,12,5,7,30,27,3,41
LASK Linz,1189,3,10,5,9,29,26,3,35
Rapid Vienna,1189,4,7,9,8,32,30,2,30
Vienna,1189,5,7,6,11,28,39,-11,27
Mattersburg,1189,6,7,5,12,29,42,-13,26
SC Rheindorf,1189,7,5,6,13,16,28,-12,21
FC Salzburg,1190,1,13,8,3,48,21,27,47
SK Sturm Gra,1190,2,13,3,8,31,32,-1,42
Rapid Vienna,1190,3,10,9,5,39,25,14,39
LASK Linz,1190,4,8,7,9,26,28,-2,31
Vienna,1190,5,7,6,11,27,40,-13,27
Mattersburg,1190,6,6,7,11,32,42,-10,25
SC Rheindorf,1190,7,4,6,14,16,31,-15,18
FC Salzburg,1191,1,15,7,2,45,19,26,52
SK Sturm Gra,1191,2,11,4,9,31,30,1,37
Rapid Vienna,1191,3,8,10,6,32,29,3,34
LASK Linz,1191,4,8,7,9,30,27,3,31
SC Rheindorf,1191,5,7,5,12,21,29,-8,26
Mattersburg,1191,6,6,7,11,32,42,-10,25
Vienna,1191,7,6,6,12,26,41,-15,24
FC Salzburg,1192,1,15,6,3,54,18,36,51
SK Sturm Gra,1192,2,13,3,8,32,34,-2,42
Rapid Vienna,1192,3,8,9,7,34,30,4,33
SC Rheindorf,1192,4,8,5,11,20,25,-5,29
LASK Linz,1192,5,7,6,11,24,30,-6,27
Vienna,1192,6,7,6,11,28,41,-13,27
Mattersburg,1192,7,5,7,12,30,44,-14,22
FC Salzburg,1193,1,16,6,2,48,19,29,54
SK Sturm Gra,1193,2,12,4,8,32,28,4,40
LASK Linz,1193,3,11,5,8,29,26,3,38
Rapid Vienna,1193,4,8,9,7,34,29,5,33
Mattersburg,1193,5,6,6,12,31,42,-11,24
Vienna,1193,6,6,6,12,24,40,-16,24
SC Rheindorf,1193,7,4,6,14,17,31,-14,18
FC Salzburg,1194,1,14,7,3,45,19,26,49
SK Sturm Gra,1194,2,14,4,6,34,26,8,46
Rapid Vienna,1194,3,8,10,6,36,28,8,34
LASK Linz,1194,4,9,5,10,27,32,-5,32
Vienna,1194,5,7,5,12,27,40,-13,26
Mattersburg,1194,6,6,5,13,31,43,-12,23
SC Rheindorf,1194,7,5,6,13,20,32,-12,21
FC Salzburg,1195,1,14,7,3,44,19,25,49
Rapid Vienna,1195,2,10,10,4,38,26,12,40
SK Sturm Gra,1195,3,11,5,8,29,29,0,38
LASK Linz,1195,4,7,7,10,25,28,-3,28
SC Rheindorf,1195,5,6,7,11,22,28,-6,25
Mattersburg,1195,6,6,7,11,33,42,-9,25
Vienna,1195,7,6,5,13,25,44,-19,23
FC Salzburg,1196,1,14,7,3,42,16,26,49
SK Sturm Gra,1196,2,14,4,6,35,26,9,46
Rapid Vienna,1196,3,9,10,5,39,29,10,37
LASK Linz,1196,4,7,7,10,24,30,-6,28
Mattersburg,1196,5,6,7,11,29,39,-10,25
Vienna,1196,6,6,6,12,23,40,-17,24
SC Rheindorf,1196,7,4,7,13,20,32,-12,19
FC Salzburg,1197,1,14,7,3,46,18,28,49
SK Sturm Gra,1197,2,11,5,8,32,32,0,38
Rapid Vienna,1197,3,8,12,4,39,30,9,36
LASK Linz,1197,4,8,8,8,30,30,0,32
Mattersburg,1197,5,6,7,11,32,42,-10,25
Vienna,1197,6,6,7,11,27,41,-14,25
SC Rheindorf,1197,7,4,8,12,17,30,-13,20
FC Salzburg,1198,1,12,8,4,38,19,19,44
SK Sturm Gra,1198,2,13,5,6,34,27,7,44
Rapid Vienna,1198,3,10,9,5,40,26,14,39
LASK Linz,1198,4,7,7,10,25,32,-7,28
Vienna,1198,5,7,6,11,25,37,-12,27
Mattersburg,1198,6,6,6,12,29,41,-12,24
SC Rheindorf,1198,7,5,7,12,17,26,-9,22
FC Salzburg,1199,1,16,6,2,46,16,30,54
SK Sturm Gra,1199,2,12,4,8,30,27,3,40
LASK Linz,1199,3,8,8,8,27,27,0,32
Rapid Vienna,1199,4,7,10,7,32,28,4,31
Mattersburg,1199,5,6,7,11,33,41,-8,25
Vienna,1199,6,6,6,12,24,40,-16,24
SC Rheindorf,1199,7,6,5,13,19,32,-13,23
FC Salzburg,1200,1,16,6,2,51,18,33,54
SK Sturm Gra,1200,2,12,3,9,31,29,2,39
LASK Linz,1200,3,9,6,9,29,28,1,33
Rapid Vienna,1200,4,7,11,6,35,34,1,32
SC Rheindorf,1200,5,7,6,11,25,31,-6,27
Vienna,1200,6,7,5,12,28,40,-12,26
Mattersburg,1200,7,5,5,14,28,47,-19,20
FC Salzburg,1201,1,15,7,2,46,18,28,52
SK Sturm Gra,1201,2,11,5,8,31,32,-1,38
Rapid Vienna,1201,3,8,12,4,35,24,11,36
LASK Linz,1201,4,8,5,11,30,32,-2,29
Mattersburg,1201,5,6,7,11,28,40,-12,25
Vienna,1201,6,6,6,12,23,38,-15,24
SC Rheindorf,1201,7,5,8,11,19,28,-9,23
FC Salzburg,1202,1,14,6,4,45,22,23,48
SK Sturm Gra,1202,2,15,3,6,39,26,13,48
Rapid Vienna,1202,3,8,11,5,35,29,6,35
LASK Linz,1202,4,8,7,9,29,29,0,31
Vienna,1202,5,7,5,12,27,40,-13,26
SC Rheindorf,1202,6,5,6,13,19,31,-12,21
Mattersburg,1202,7,5,6,13,29,46,-17,21
FC Salzburg,1203,1,14,6,4,47,24,23,48
SK Sturm Gra,1203,2,12,4,8,32,30,2,40
Rapid Vienna,1203,3,8,9,7,36,32,4,33
LASK Linz,1203,4,9,5,10,27,28,-1,32
Vienna,1203,5,8,5,11,26,38,-12,29
Mattersburg,1203,6,7,5,12,33,42,-9,26
SC Rheindorf,1203,7,6,6,12,20,27,-7,24
FC Salzburg,1204,1,16,6,2,47,19,28,54
SK Sturm Gra,1204,2,13,4,7,36,32,4,43
Rapid Vienna,1204,3,7,11,6,34,28,6,32
LASK Linz,1204,4,9,5,10,27,28,-1,32
Mattersburg,1204,5,8,5,11,32,38,-6,29
Vienna,1204,6,6,5,13,25,43,-18,23
SC Rheindorf,1204,7,4,6,14,17,30,-13,18
FC Salzburg,1205,1,16,6,2,50,16,34,54
SK Sturm Gra,1205,2,13,3,8,31,27,4,42
Rapid Vienna,1205,3,9,10,5,37,26,11,37
LASK Linz,1205,4,8,6,10,26,29,-3,30
Vienna,1205,5,7,5,12,27,44,-17,26
Mattersburg,1205,6,6,5,13,29,43,-14,23
SC Rheindorf,1205,7,5,5,14,18,33,-15,20
FC Salzburg,1206,1,14,6,4,46,22,24,48
SK Sturm Gra,1206,2,14,3,7,33,27,6,45
Rapid Vienna,1206,3,8,9,7,33,28,5,33
LASK Linz,1206,4,9,5,10,31,27,4,32
Vienna,1206,5,8,5,11,28,39,-11,29
SC Rheindorf,1206,6,7,5,12,20,28,-8,26
Mattersburg,1206,7,5,5,14,29,49,-20,20
SK Sturm Gra,1207,1,14,3,7,34,28,6,45
FC Salzburg,1207,2,12,8,4,42,21,21,44
Rapid Vienna,1207,3,9,9,6,39,31,8,36
LASK Linz,1207,4,8,5,11,27,32,-5,29
Mattersburg,1207,5,7,7,10,32,37,-5,28
SC Rheindorf,1207,6,6,6,12,22,31,-9,24
Vienna,1207,7,6,6,12,24,40,-16,24
SK Sturm Gra,1208,1,14,4,6,35,27,8,46
FC Salzburg,1208,2,13,6,5,42,22,20,45
Rapid Vienna,1208,3,9,11,4,37,26,11,38
LASK Linz,1208,4,7,7,10,25,29,-4,28
Vienna,1208,5,7,5,12,26,40,-14,26
Mattersburg,1208,6,6,7,11,28,38,-10,25
SC Rheindorf,1208,7,5,6,13,18,29,-11,21
FC Salzburg,1209,1,15,6,3,44,16,28,51
SK Sturm Gra,1209,2,14,4,6,36,27,9,46
Rapid Vienna,1209,3,8,9,7,37,32,5,33
LASK Linz,1209,4,9,5,10,27,29,-2,32
Mattersburg,1209,5,7,5,12,33,42,-9,26
Vienna,1209,6,6,5,13,24,43,-19,23
SC Rheindorf,1209,7,5,6,13,20,32,-12,21
FC Salzburg,1210,1,15,7,2,44,16,28,52
SK Sturm Gra,1210,2,12,4,8,31,29,2,40
Rapid Vienna,1210,3,9,10,5,38,28,10,37
LASK Linz,1210,4,8,7,9,28,29,-1,31
Vienna,1210,5,6,7,11,24,38,-14,25
Mattersburg,1210,6,5,7,12,27,39,-12,22
SC Rheindorf,1210,7,4,8,12,17,30,-13,20
FC Salzburg,1211,1,14,6,4,44,21,23,48
Rapid Vienna,1211,2,10,9,5,40,28,12,39
SK Sturm Gra,1211,3,11,4,9,33,34,-1,37
LASK Linz,1211,4,9,6,9,30,31,-1,33
Mattersburg,1211,5,7,6,11,33,39,-6,27
Vienna,1211,6,6,6,12,26,42,-16,24
SC Rheindorf,1211,7,6,5,13,19,30,-11,23
FC Salzburg,1212,1,16,6,2,48,17,31,54
SK Sturm Gra,1212,2,12,3,9,32,32,0,39
Rapid Vienna,1212,3,9,9,6,35,28,7,36
LASK Linz,1212,4,8,6,10,26,28,-2,30
Mattersburg,1212,5,7,6,11,33,43,-10,27
Vienna,1212,6,6,6,12,25,40,-15,24
SC Rheindorf,1212,7,5,6,13,22,33,-11,21
FC Salzburg,1213,1,15,7,2,47,16,31,52
SK Sturm Gra,1213,2,13,4,7,34,28,6,43
Rapid Vienna,1213,3,7,12,5,35,29,6,33
LASK Linz,1213,4,8,6,10,27,28,-1,30
Vienna,1213,5,7,5,12,24,41,-17,26
SC Rheindorf,1213,6,5,7,12,18,29,-11,22
Mattersburg,1213,7,5,7,12,28,42,-14,22
FC Salzburg,1214,1,13,6,5,43,23,20,45
SK Sturm Gra,1214,2,14,3,7,37,30,7,45
Rapid Vienna,1214,3,10,9,5,39,27,12,39
LASK Linz,1214,4,9,6,9,28,29,-1,33
Mattersburg,1214,5,7,5,12,31,42,-11,26
Vienna,1214,6,7,5,12,26,40,-14,26
SC Rheindorf,1214,7,4,6,14,17,30,-13,18
FC Salzburg,1215,1,15,7,2,46,16,30,52
SK Sturm Gra,1215,2,12,5,7,31,28,3,41
Rapid Vienna,1215,3,8,10,6,34,30,4,34
LASK Linz,1215,4,8,5,11,26,30,-4,29
Mattersburg,1215,5,6,7,11,33,42,-9,25
SC Rheindorf,1215,6,6,6,12,19,28,-9,24
Vienna,1215,7,6,6,12,25,40,-15,24
FC Salzburg,1216,1,14,7,3,43,18,25,49
SK Sturm Gra,1216,2,13,4,7,37,30,7,43
Rapid Vienna,1216,3,9,10,5,38,28,10,37
LASK Linz,1216,4,8,7,9,26,30,-4,31
Vienna,1216,5,7,6,11,26,39,-13,27
Mattersburg,1216,6,5,7,12,30,42,-12,22
SC Rheindorf,1216,7,4,7,13,18,31,-13,19
FC Salzburg,1217,1,15,7,2,46,17,29,52
SK Sturm Gra,1217,2,13,5,6,33,26,7,44
Rapid Vienna,1217,3,7,11,6,32,27,5,32
LASK Linz,1217,4,7,8,9,26,29,-3,29
Mattersburg,1217,5,7,5,12,34,42,-8,26
Vienna,1217,6,7,5,12,26,41,-15,26
SC Rheindorf,1217,7,4,7,13,16,31,-15,19
FC Salzburg,1218,1,14,8,2,44,17,27,50
SK Sturm Gra,1218,2,13,5,6,36,29,7,44
Rapid Vienna,1218,3,8,10,6,37,33,4,34
LASK Linz,1218,4,9,6,9,32,29,3,33
Mattersburg,1218,5,7,5,12,29,40,-11,26
Vienna,1218,6,6,5,13,23,41,-18,23
SC Rheindorf,1218,7,5,5,14,20,32,-12,20
FC Salzburg,1219,1,14,6,4,45,22,23,48
SK Sturm Gra,1219,2,14,3,7,38,30,8,45
Rapid Vienna,1219,3,10,9,5,37,27,10,39
Mattersburg,1219,4,7,6,11,32,41,-9,27
LASK Linz,1219,5,7,5,12,24,30,-6,26
Vienna,1219,6,7,5,12,26,40,-14,26
SC Rheindorf,1219,7,5,6,13,21,33,-12,21
FC Salzburg,1220,1,14,7,3,46,22,24,49
SK Sturm Gra,1220,2,12,3,9,33,29,4,39
Rapid Vienna,1220,3,9,9,6,38,29,9,36
LASK Linz,1220,4,9,5,10,26,31,-5,32
Vienna,1220,5,7,6,11,28,41,-13,27
SC Rheindorf,1220,6,7,5,12,19,28,-9,26
Mattersburg,1220,7,6,5,13,32,42,-10,23
FC Salzburg,1221,1,16,6,2,48,18,30,54
SK Sturm Gra,1221,2,14,3,7,36,29,7,45
Rapid Vienna,1221,3,8,10,6,37,28,9,34
LASK Linz,1221,4,9,6,9,26,26,0,33
Vienna,1221,5,6,6,12,25,41,-16,24
Mattersburg,1221,6,5,6,13,29,45,-16,21
SC Rheindorf,1221,7,5,5,14,17,31,-14,20
FC Salzburg,1222,1,15,6,3,49,19,30,51
SK Sturm Gra,1222,2,13,4,7,34,29,5,43
LASK Linz,1222,3,9,5,10,27,30,-3,32
Rapid Vienna,1222,4,7,9,8,32,31,1,30
Vienna,1222,5,7,6,11,25,38,-13,27
SC Rheindorf,1222,6,6,6,12,21,28,-7,24
Mattersburg,1222,7,6,6,12,30,43,-13,24
FC Salzburg,1223,1,15,6,3,45,17,28,51
SK Sturm Gra,1223,2,12,3,9,31,30,1,39
Rapid Vienna,1223,3,9,9,6,34,27,7,36
LASK Linz,1223,4,8,5,11,26,30,-4,29
SC Rheindorf,1223,5,8,5,11,20,25,-5,29
Vienna,1223,6,7,5,12,28,41,-13,26
Mattersburg,1223,7,6,5,13,29,43,-14,23
FC Salzburg,1224,1,15,7,2,44,17,27,52
SK Sturm Gra,1224,2,11,5,8,30,28,2,38
Rapid Vienna,1224,3,8,11,5,34,25,9,35
LASK Linz,1224,4,9,6,9,28,28,0,33
Vienna,1224,5,7,5,12,25,40,-15,26
Mattersburg,1224,6,6,6,12,31,42,-11,24
SC Rheindorf,1224,7,5,6,13,19,31,-12,21
FC Salzburg,1225,1,15,6,3,47,19,28,51
SK Sturm Gra,1225,2,12,3,9,33,34,-1,39
Rapid Vienna,1225,3,8,10,6,36,32,4,34
LASK Linz,1225,4,8,6,10,30,32,-2,30
Mattersburg,1225,5,8,5,11,36,41,-5,29
Vienna,1225,6,7,5,12,26,39,-13,26
SC Rheindorf,1225,7,6,5,13,23,34,-11,23
FC Salzburg,1226,1,12,9,3,43,21,22,45
Rapid Vienna,1226,2,10,9,5,34,24,10,39
SK Sturm Gra,1226,3,11,5,8,30,28,2,38
LASK Linz,1226,4,9,7,8,28,25,3,34
Vienna,1226,5,7,6,11,30,41,-11,27
Mattersburg,1226,6,6,7,11,33,44,-11,25
SC Rheindorf,1226,7,5,5,14,19,34,-15,20
FC Salzburg,1227,1,14,7,3,43,18,25,49
SK Sturm Gra,1227,2,12,4,8,35,30,5,40
Rapid Vienna,1227,3,9,11,4,39,26,13,38
LASK Linz,1227,4,7,7,10,28,37,-9,28
Vienna,1227,5,7,5,12,26,40,-14,26
SC Rheindorf,1227,6,6,6,12,21,30,-9,24
Mattersburg,1227,7,6,6,12,31,42,-11,24
FC Salzburg,1228,1,15,6,3,50,18,32,51
Rapid Vienna,1228,2,10,9,5,36,25,11,39
SK Sturm Gra,1228,3,11,4,9,29,32,-3,37
LASK Linz,1228,4,9,5,10,27,28,-1,32
SC Rheindorf,1228,5,6,6,12,18,27,-9,24
Mattersburg,1228,6,6,6,12,31,45,-14,24
Vienna,1228,7,6,6,12,27,43,-16,24
FC Salzburg,1229,1,14,6,4,43,21,22,48
SK Sturm Gra,1229,2,12,4,8,31,30,1,40
Rapid Vienna,1229,3,9,11,4,37,26,11,38
LASK Linz,1229,4,8,6,10,28,30,-2,30
Vienna,1229,5,8,5,11,27,37,-10,29
Mattersburg,1229,6,6,6,12,31,43,-12,24
SC Rheindorf,1229,7,5,6,13,17,27,-10,21
FC Salzburg,1230,1,15,7,2,49,22,27,52
SK Sturm Gra,1230,2,12,5,7,34,29,5,41
Rapid Vienna,1230,3,8,9,7,37,30,7,33
LASK Linz,1230,4,9,6,9,29,30,-1,33
Vienna,1230,5,6,7,11,24,38,-14,25
SC Rheindorf,1230,6,5,7,12,19,30,-11,22
Mattersburg,1230,7,5,7,12,31,44,-13,22
FC Salzburg,1231,1,15,7,2,46,19,27,52
SK Sturm Gra,1231,2,12,5,7,31,28,3,41
LASK Linz,1231,3,8,7,9,30,28,2,31
Rapid Vienna,1231,4,7,9,8,31,30,1,30
Mattersburg,1231,5,7,6,11,33,40,-7,27
SC Rheindorf,1231,6,6,7,11,20,27,-7,25
Vienna,1231,7,6,5,13,25,44,-19,23
FC Salzburg,1232,1,14,6,4,49,21,28,48
SK Sturm Gra,1232,2,14,3,7,35,28,7,45
Rapid Vienna,1232,3,8,10,6,36,32,4,34
LASK Linz,1232,4,9,6,9,29,30,-1,33
Vienna,1232,5,7,6,11,26,39,-13,27
SC Rheindorf,1232,6,5,7,12,17,27,-10,22
Mattersburg,1232,7,5,6,13,28,43,-15,21
FC Salzburg,1233,1,16,6,2,53,19,34,54
SK Sturm Gra,1233,2,12,4,8,32,31,1,40
Rapid Vienna,1233,3,7,12,5,38,34,4,33
LASK Linz,1233,4,7,8,9,28,31,-3,29
Vienna,1233,5,7,5,12,27,42,-15,26
SC Rheindorf,1233,6,6,7,11,21,28,-7,25
Mattersburg,1233,7,5,6,13,31,45,-14,21
FC Salzburg,1234,1,13,8,3,44,20,24,47
SK Sturm Gra,1234,2,13,4,7,38,27,11,43
Rapid Vienna,1234,3,8,10,6,34,30,4,34
LASK Linz,1234,4,8,7,9,30,34,-4,31
Vienna,1234,5,8,5,11,29,39,-10,29
Mattersburg,1234,6,6,6,12,31,43,-12,24
SC Rheindorf,1234,7,5,6,13,20,33,-13,21
FC Salzburg,1235,1,15,7,2,49,18,31,52
SK Sturm Gra,1235,2,12,4,8,30,32,-2,40
Rapid Vienna,1235,3,9,10,5,38,29,9,37
LASK Linz,1235,4,9,7,8,31,27,4,34
Vienna,1235,5,7,5,12,27,40,-13,26
Mattersburg,1235,6,5,7,12,26,42,-16,22
SC Rheindorf,1235,7,4,6,14,19,32,-13,18
FC Salzburg,1236,1,15,7,2,50,20,30,52
Rapid Vienna,1236,2,9,11,4,40,30,10,38
SK Sturm Gra,1236,3,11,4,9,31,31,0,37
LASK Linz,1236,4,10,6,8,32,27,5,36
Vienna,1236,5,7,5,12,26,38,-12,26
SC Rheindorf,1236,6,5,6,13,23,33,-10,21
Mattersburg,1236,7,5,5,14,28,51,-23,20
FC Salzburg,1237,1,13,9,2,41,17,24,48
SK Sturm Gra,1237,2,12,4,8,31,28,3,40
Rapid Vienna,1237,3,8,11,5,34,26,8,35
LASK Linz,1237,4,8,6,10,25,28,-3,30
Mattersburg,1237,5,6,8,10,33,42,-9,26
SC Rheindorf,1237,6,6,6,12,20,28,-8,24
Vienna,1237,7,6,6,12,25,40,-15,24
FC Salzburg,1238,1,14,6,4,48,18,30,48
SK Sturm Gra,1238,2,13,3,8,32,31,1,42
Rapid Vienna,1238,3,8,11,5,35,27,8,35
LASK Linz,1238,4,8,7,9,27,28,-1,31
Vienna,1238,5,8,5,11,28,37,-9,29
Mattersburg,1238,6,6,5,13,28,47,-19,23
SC Rheindorf,1238,7,5,7,12,19,29,-10,22
FC Salzburg,1239,1,13,8,3,43,18,25,47
SK Sturm Gra,1239,2,11,6,7,35,32,3,39
Rapid Vienna,1239,3,8,11,5,36,28,8,35
LASK Linz,1239,4,8,7,9,29,30,-1,31
Vienna,1239,5,8,5,11,26,37,-11,29
Mattersburg,1239,6,7,5,12,31,42,-11,26
SC Rheindorf,1239,7,4,8,12,20,33,-13,20
FC Salzburg,1240,1,14,7,3,47,21,26,49
SK Sturm Gra,1240,2,12,4,8,32,28,4,40
Rapid Vienna,1240,3,9,9,6,36,29,7,36
LASK Linz,1240,4,10,5,9,29,28,1,35
Mattersburg,1240,5,8,5,11,36,41,-5,29
Vienna,1240,6,6,6,12,24,41,-17,24
SC Rheindorf,1240,7,4,6,14,16,32,-16,18
FC Salzburg,1241,1,14,6,4,50,27,23,48
SK Sturm Gra,1241,2,11,4,9,31,33,-2,37
Rapid Vienna,1241,3,9,9,6,38,30,8,36
LASK Linz,1241,4,8,7,9,28,28,0,31
SC Rheindorf,1241,5,8,5,11,23,26,-3,29
Vienna,1241,6,7,5,12,26,40,-14,26
Mattersburg,1241,7,6,6,12,32,44,-12,24
FC Salzburg,1242,1,15,6,3,42,16,26,51
SK Sturm Gra,1242,2,12,4,8,32,28,4,40
Rapid Vienna,1242,3,9,10,5,36,25,11,37
Vienna,1242,4,8,5,11,27,39,-12,29
LASK Linz,1242,5,7,7,10,25,31,-6,28
Mattersburg,1242,6,7,5,12,34,43,-9,26
SC Rheindorf,1242,7,4,7,13,19,33,-14,19
FC Salzburg,1243,1,14,7,3,46,19,27,49
SK Sturm Gra,1243,2,13,3,8,34,32,2,42
Rapid Vienna,1243,3,9,9,6,39,29,10,36
LASK Linz,1243,4,8,6,10,27,29,-2,30
Mattersburg,1243,5,8,6,10,35,41,-6,30
Vienna,1243,6,6,6,12,26,41,-15,24
SC Rheindorf,1243,7,5,5,14,19,35,-16,20
FC Salzburg,1244,1,13,7,4,41,19,22,46
SK Sturm Gra,1244,2,12,6,6,32,27,5,42
Rapid Vienna,1244,3,9,10,5,38,28,10,37
LASK Linz,1244,4,7,7,10,25,29,-4,28
Vienna,1244,5,7,6,11,25,37,-12,27
Mattersburg,1244,6,6,7,11,30,41,-11,25
SC Rheindorf,1244,7,5,7,12,19,29,-10,22
FC Salzburg,1245,1,13,9,2,41,15,26,48
SK Sturm Gra,1245,2,13,4,7,35,28,7,43
LASK Linz,1245,3,9,7,8,30,28,2,34
Rapid Vienna,1245,4,7,11,6,32,29,3,32
Mattersburg,1245,5,6,6,12,29,42,-13,24
Vienna,1245,6,6,6,12,24,39,-15,24
SC Rheindorf,1245,7,5,7,12,20,30,-10,22
FC Salzburg,1246,1,13,9,2,42,18,24,48
SK Sturm Gra,1246,2,12,4,8,31,29,2,40
Rapid Vienna,1246,3,8,11,5,33,26,7,35
LASK Linz,1246,4,10,5,9,30,25,5,35
Vienna,1246,5,7,6,11,28,38,-10,27
Mattersburg,1246,6,6,6,12,32,46,-14,24
SC Rheindorf,1246,7,4,7,13,18,32,-14,19
FC Salzburg,1247,1,15,7,2,47,17,30,52
SK Sturm Gra,1247,2,13,4,7,36,28,8,43
Rapid Vienna,1247,3,7,10,7,31,28,3,31
LASK Linz,1247,4,8,6,10,25,30,-5,30
SC Rheindorf,1247,5,6,7,11,20,28,-8,25
Vienna,1247,6,6,6,12,24,39,-15,24
Mattersburg,1247,7,5,8,11,28,41,-13,23
FC Salzburg,1248,1,13,8,3,43,18,25,47
SK Sturm Gra,1248,2,13,4,7,31,26,5,43
Rapid Vienna,1248,3,8,11,5,35,30,5,35
LASK Linz,1248,4,8,7,9,26,27,-1,31
SC Rheindorf,1248,5,6,7,11,23,28,-5,25
Vienna,1248,6,6,6,12,25,41,-16,24
Mattersburg,1248,7,6,5,13,31,44,-13,23
FC Salzburg,1249,1,14,7,3,41,17,24,49
SK Sturm Gra,1249,2,12,4,8,31,29,2,40
Rapid Vienna,1249,3,8,10,6,35,28,7,34
LASK Linz,1249,4,9,5,10,30,31,-1,32
Vienna,1249,5,8,5,11,27,38,-11,29
Mattersburg,1249,6,6,7,11,30,40,-10,25
SC Rheindorf,1249,7,4,8,12,17,28,-11,20
FC Salzburg,1250,1,15,6,3,46,20,26,51
SK Sturm Gra,1250,2,13,3,8,33,28,5,42
Rapid Vienna,1250,3,9,10,5,38,31,7,37
Vienna,1250,4,8,5,11,31,39,-8,29
LASK Linz,1250,5,7,6,11,26,31,-5,27
Mattersburg,1250,6,6,6,12,30,42,-12,24
SC Rheindorf,1250,7,5,6,13,21,34,-13,21
FC Salzburg,1251,1,14,8,2,47,21,26,50
Rapid Vienna,1251,2,10,9,5,37,26,11,39
SK Sturm Gra,1251,3,12,3,9,32,32,0,39
LASK Linz,1251,4,8,6,10,28,29,-1,30
Vienna,1251,5,7,6,11,30,40,-10,27
Mattersburg,1251,6,5,8,11,29,43,-14,23
SC Rheindorf,1251,7,5,6,13,18,30,-12,21
FC Salzburg,1252,1,14,8,2,45,16,29,50
SK Sturm Gra,1252,2,12,4,8,31,28,3,40
Rapid Vienna,1252,3,8,11,5,34,26,8,35
LASK Linz,1252,4,7,6,11,25,31,-6,27
Mattersburg,1252,5,7,6,11,30,42,-12,27
SC Rheindorf,1252,6,7,5,12,20,27,-7,26
Vienna,1252,7,6,6,12,24,39,-15,24
FC Salzburg,1253,1,14,7,3,47,21,26,49
SK Sturm Gra,1253,2,13,4,7,37,27,10,43
LASK Linz,1253,3,9,6,9,27,29,-2,33
Rapid Vienna,1253,4,7,9,8,33,34,-1,30
SC Rheindorf,1253,5,7,6,11,21,27,-6,27
Vienna,1253,6,7,6,11,25,38,-13,27
Mattersburg,1253,7,5,6,13,29,43,-14,21
FC Salzburg,1254,1,13,8,3,43,17,26,47
SK Sturm Gra,1254,2,11,5,8,29,30,-1,38
LASK Linz,1254,3,10,6,8,28,24,4,36
Rapid Vienna,1254,4,8,11,5,33,27,6,35
Mattersburg,1254,5,7,7,10,30,37,-7,28
Vienna,1254,6,6,6,12,25,40,-15,24
SC Rheindorf,1254,7,4,7,13,15,28,-13,19
FC Salzburg,1255,1,16,6,2,48,18,30,54
SK Sturm Gra,1255,2,12,4,8,36,33,3,40
Rapid Vienna,1255,3,8,11,5,36,28,8,35
LASK Linz,1255,4,8,6,10,27,32,-5,30
SC Rheindorf,1255,5,7,5,12,23,28,-5,26
Vienna,1255,6,7,5,12,26,40,-14,26
Mattersburg,1255,7,5,5,14,27,44,-17,20
FC Salzburg,1256,1,14,6,4,47,20,27,48
SK Sturm Gra,1256,2,13,4,7,33,27,6,43
Rapid Vienna,1256,3,9,10,5,36,30,6,37
LASK Linz,1256,4,8,7,9,27,27,0,31
Mattersburg,1256,5,7,6,11,32,40,-8,27
Vienna,1256,6,7,5,12,26,41,-15,26
SC Rheindorf,1256,7,4,6,14,19,35,-16,18
FC Salzburg,1257,1,15,6,3,43,17,26,51
SK Sturm Gra,1257,2,13,3,8,38,31,7,42
Rapid Vienna,1257,3,8,9,7,34,31,3,33
LASK Linz,1257,4,9,5,10,31,32,-1,32
Mattersburg,1257,5,8,5,11,33,39,-6,29
Vienna,1257,6,7,5,12,24,40,-16,26
SC Rheindorf,1257,7,5,5,14,20,33,-13,20
FC Salzburg,1258,1,14,8,2,49,21,28,50
SK Sturm Gra,1258,2,13,4,7,34,29,5,43
Rapid Vienna,1258,3,9,10,5,38,28,10,37
LASK Linz,1258,4,7,8,9,27,29,-2,29
Mattersburg,1258,5,7,6,11,33,42,-9,27
Vienna,1258,6,6,6,12,28,44,-16,24
SC Rheindorf,1258,7,4,6,14,17,33,-16,18
FC Salzburg,1259,1,15,6,3,47,19,28,51
SK Sturm Gra,1259,2,12,3,9,30,29,1,39
Rapid Vienna,1259,3,9,11,4,37,27,10,38
LASK Linz,1259,4,8,6,10,27,29,-2,30
Vienna,1259,5,7,5,12,27,41,-14,26
SC Rheindorf,1259,6,6,6,12,18,27,-9,24
Mattersburg,1259,7,6,5,13,28,42,-14,23
FC Salzburg,1260,1,15,6,3,44,20,24,51
SK Sturm Gra,1260,2,12,5,7,32,28,4,41
Rapid Vienna,1260,3,9,9,6,38,27,11,36
LASK Linz,1260,4,8,7,9,28,29,-1,31
Vienna,1260,5,7,6,11,26,38,-12,27
Mattersburg,1260,6,6,6,12,30,41,-11,24
SC Rheindorf,1260,7,4,7,13,17,32,-15,19
FC Salzburg,1261,1,14,6,4,46,21,25,48
SK Sturm Gra,1261,2,13,3,8,31,29,2,42
Rapid Vienna,1261,3,8,9,7,32,27,5,33
LASK Linz,1261,4,9,5,10,27,26,1,32
Vienna,1261,5,8,5,11,28,39,-11,29
Mattersburg,1261,6,7,5,12,30,40,-10,26
SC Rheindorf,1261,7,6,5,13,17,29,-12,23
FC Salzburg,1262,1,13,7,4,41,19,22,46
SK Sturm Gra,1262,2,14,4,6,36,26,10,46
Rapid Vienna,1262,3,8,10,6,35,30,5,34
LASK Linz,1262,4,9,6,9,27,28,-1,33
Mattersburg,1262,5,7,6,11,30,39,-9,27
Vienna,1262,6,7,5,12,25,39,-14,26
SC Rheindorf,1262,7,4,6,14,17,30,-13,18
FC Salzburg,1263,1,15,7,2,48,17,31,52
Rapid Vienna,1263,2,9,10,5,39,28,11,37
SK Sturm Gra,1263,3,11,4,9,30,34,-4,37
LASK Linz,1263,4,8,7,9,24,28,-4,31
Mattersburg,1263,5,7,6,11,32,39,-7,27
SC Rheindorf,1263,6,6,5,13,23,30,-7,23
Vienna,1263,7,6,5,13,24,44,-20,23
FC Salzburg,1264,1,15,7,2,46,16,30,52
SK Sturm Gra,1264,2,13,5,6,33,27,6,44
Rapid Vienna,1264,3,7,10,7,32,29,3,31
LASK Linz,1264,4,8,7,9,27,28,-1,31
Mattersburg,1264,5,7,6,11,37,43,-6,27
Vienna,1264,6,6,5,13,24,45,-21,23
SC Rheindorf,1264,7,4,8,12,17,28,-11,20
FC Salzburg,1265,1,15,7,2,47,20,27,52
SK Sturm Gra,1265,2,12,5,7,34,30,4,41
Rapid Vienna,1265,3,9,10,5,34,25,9,37
LASK Linz,1265,4,9,5,10,29,30,-1,32
Mattersburg,1265,5,7,5,12,31,42,-11,26
Vienna,1265,6,7,5,12,25,39,-14,26
SC Rheindorf,1265,7,4,5,15,16,30,-14,17
FC Salzburg,1266,1,14,8,2,47,18,29,50
SK Sturm Gra,1266,2,11,6,7,34,34,0,39
LASK Linz,1266,3,10,6,8,34,28,6,36
Rapid Vienna,1266,4,7,12,5,37,30,7,33
Mattersburg,1266,5,6,7,11,31,44,-13,25
Vienna,1266,6,6,6,12,26,42,-16,24
SC Rheindorf,1266,7,4,7,13,21,34,-13,19
FC Salzburg,1267,1,14,7,3,45,18,27,49
SK Sturm Gra,1267,2,14,4,6,34,26,8,46
Rapid Vienna,1267,3,9,11,4,37,26,11,38
LASK Linz,1267,4,7,5,12,24,32,-8,26
Vienna,1267,5,7,5,12,26,41,-15,26
SC Rheindorf,1267,6,6,5,13,20,28,-8,23
Mattersburg,1267,7,6,5,13,28,43,-15,23
FC Salzburg,1268,1,15,7,2,49,19,30,52
SK Sturm Gra,1268,2,14,3,7,36,28,8,45
Rapid Vienna,1268,3,8,9,7,35,31,4,33
LASK Linz,1268,4,9,5,10,26,26,0,32
Vienna,1268,5,7,6,11,25,38,-13,27
Mattersburg,1268,6,6,6,12,29,43,-14,24
SC Rheindorf,1268,7,4,6,14,17,32,-15,18
FC Salzburg,1269,1,14,7,3,47,20,27,49
SK Sturm Gra,1269,2,13,4,7,40,33,7,43
Rapid Vienna,1269,3,9,9,6,38,31,7,36
LASK Linz,1269,4,8,6,10,28,33,-5,30
Vienna,1269,5,7,5,12,25,40,-15,26
Mattersburg,1269,6,6,7,11,32,40,-8,25
SC Rheindorf,1269,7,5,6,13,20,33,-13,21
SK Sturm Gra,1270,1,14,4,6,36,28,8,46
FC Salzburg,1270,2,13,6,5,42,22,20,45
Rapid Vienna,1270,3,9,9,6,37,28,9,36
LASK Linz,1270,4,9,5,10,29,29,0,32
Vienna,1270,5,7,6,11,25,38,-13,27
Mattersburg,1270,6,6,7,11,27,38,-11,25
SC Rheindorf,1270,7,4,7,13,17,30,-13,19
SK Sturm Gra,1271,1,14,4,6,37,27,10,46
FC Salzburg,1271,2,12,8,4,39,22,17,44
Rapid Vienna,1271,3,8,10,6,37,29,8,34
LASK Linz,1271,4,9,6,9,29,29,0,33
Vienna,1271,5,7,6,11,26,38,-12,27
Mattersburg,1271,6,6,6,12,30,42,-12,24
SC Rheindorf,1271,7,5,6,13,20,31,-11,21
FC Salzburg,1272,1,13,7,4,44,19,25,46
SK Sturm Gra,1272,2,12,5,7,32,31,1,41
Rapid Vienna,1272,3,8,11,5,34,26,8,35
LASK Linz,1272,4,8,8,8,28,28,0,32
Vienna,1272,5,8,5,11,26,37,-11,29
Mattersburg,1272,6,6,7,11,33,44,-11,25
SC Rheindorf,1272,7,4,7,13,20,32,-12,19
FC Salzburg,1273,1,15,7,2,50,19,31,52
SK Sturm Gra,1273,2,12,4,8,30,31,-1,40
Rapid Vienna,1273,3,8,10,6,36,30,6,34
LASK Linz,1273,4,8,6,10,29,32,-3,30
Vienna,1273,5,7,5,12,26,40,-14,26
SC Rheindorf,1273,6,6,6,12,22,28,-6,24
Mattersburg,1273,7,6,6,12,31,44,-13,24
FC Salzburg,1274,1,16,6,2,47,19,28,54
SK Sturm Gra,1274,2,12,4,8,36,31,5,40
Rapid Vienna,1274,3,8,9,7,35,30,5,33
LASK Linz,1274,4,8,6,10,27,33,-6,30
Mattersburg,1274,5,7,5,12,35,46,-11,26
Vienna,1274,6,7,5,12,28,39,-11,26
SC Rheindorf,1274,7,5,7,12,17,27,-10,22
FC Salzburg,1275,1,15,6,3,41,18,23,51
SK Sturm Gra,1275,2,13,3,8,34,29,5,42
Rapid Vienna,1275,3,10,9,5,42,30,12,39
LASK Linz,1275,4,8,6,10,26,28,-2,30
Mattersburg,1275,5,7,5,12,29,39,-10,26
Vienna,1275,6,6,5,13,23,39,-16,23
SC Rheindorf,1275,7,5,6,13,21,33,-12,21
FC Salzburg,1276,1,16,6,2,50,19,31,54
SK Sturm Gra,1276,2,13,4,7,34,29,5,43
Rapid Vienna,1276,3,9,10,5,37,27,10,37
Mattersburg,1276,4,8,5,11,33,40,-7,29
LASK Linz,1276,5,7,6,11,24,28,-4,27
Vienna,1276,6,6,5,13,24,44,-20,23
SC Rheindorf,1276,7,4,6,14,17,32,-15,18
FC Salzburg,1277,1,15,7,2,53,19,34,52
SK Sturm Gra,1277,2,11,5,8,28,32,-4,38
Rapid Vienna,1277,3,9,10,5,37,27,10,37
LASK Linz,1277,4,8,6,10,26,28,-2,30
Vienna,1277,5,7,6,11,28,39,-11,27
SC Rheindorf,1277,6,5,7,12,18,31,-13,22
Mattersburg,1277,7,5,7,12,31,45,-14,22
FC Salzburg,1278,1,15,7,2,46,18,28,52
SK Sturm Gra,1278,2,12,6,6,36,31,5,42
Rapid Vienna,1278,3,8,10,6,37,29,8,34
LASK Linz,1278,4,9,7,8,31,29,2,34
Mattersburg,1278,5,7,5,12,35,41,-6,26
Vienna,1278,6,6,5,13,23,43,-20,23
SC Rheindorf,1278,7,4,6,14,18,35,-17,18
FC Salzburg,1279,1,15,7,2,50,19,31,52
SK Sturm Gra,1279,2,13,3,8,40,32,8,42
Rapid Vienna,1279,3,9,9,6,37,32,5,36
LASK Linz,1279,4,9,5,10,29,32,-3,32
Vienna,1279,5,7,6,11,26,38,-12,27
Mattersburg,1279,6,7,5,12,34,46,-12,26
SC Rheindorf,1279,7,4,5,15,20,37,-17,17
FC Salzburg,1280,1,14,7,3,45,19,26,49
SK Sturm Gra,1280,2,14,3,7,37,27,10,45
Rapid Vienna,1280,3,9,10,5,37,27,10,37
LASK Linz,1280,4,8,6,10,26,30,-4,30
Vienna,1280,5,8,5,11,26,37,-11,29
Mattersburg,1280,6,6,5,13,29,44,-15,23
SC Rheindorf,1280,7,4,6,14,19,35,-16,18
FC Salzburg,1281,1,16,6,2,46,17,29,54
SK Sturm Gra,1281,2,12,4,8,34,31,3,40
Rapid Vienna,1281,3,8,11,5,36,27,9,35
LASK Linz,1281,4,8,6,10,29,30,-1,30
Vienna,1281,5,7,5,12,24,38,-14,26
SC Rheindorf,1281,6,6,5,13,19,29,-10,23
Mattersburg,1281,7,6,5,13,28,44,-16,23
FC Salzburg,1282,1,14,6,4,47,23,24,48
SK Sturm Gra,1282,2,14,4,6,38,28,10,46
Rapid Vienna,1282,3,7,10,7,32,32,0,31
LASK Linz,1282,4,8,6,10,27,29,-2,30
Vienna,1282,5,8,5,11,31,40,-9,29
SC Rheindorf,1282,6,6,6,12,22,31,-9,24
Mattersburg,1282,7,6,5,13,32,46,-14,23
FC Salzburg,1283,1,14,6,4,42,19,23,48
SK Sturm Gra,1283,2,13,5,6,33,27,6,44
Rapid Vienna,1283,3,9,9,6,37,29,8,36
LASK Linz,1283,4,9,6,9,28,27,1,33
Mattersburg,1283,5,7,5,12,32,43,-11,26
Vienna,1283,6,7,5,12,27,39,-12,26
SC Rheindorf,1283,7,4,6,14,17,32,-15,18
FC Salzburg,1284,1,14,7,3,45,19,26,49
SK Sturm Gra,1284,2,13,3,8,37,31,6,42
LASK Linz,1284,3,10,6,8,32,29,3,36
Rapid Vienna,1284,4,8,10,6,35,28,7,34
Vienna,1284,5,8,5,11,26,38,-12,29
SC Rheindorf,1284,6,5,6,13,18,31,-13,21
Mattersburg,1284,7,5,5,14,32,49,-17,20
FC Salzburg,1285,1,16,6,2,48,17,31,54
SK Sturm Gra,1285,2,11,5,8,30,28,2,38
Rapid Vienna,1285,3,9,10,5,37,28,9,37
LASK Linz,1285,4,8,8,8,28,28,0,32
Mattersburg,1285,5,6,6,12,32,45,-13,24
Vienna,1285,6,6,6,12,24,40,-16,24
SC Rheindorf,1285,7,4,7,13,20,33,-13,19
FC Salzburg,1286,1,14,7,3,47,17,30,49
SK Sturm Gra,1286,2,13,4,7,33,30,3,43
LASK Linz,1286,3,9,6,9,32,31,1,33
Rapid Vienna,1286,4,7,10,7,34,31,3,31
Mattersburg,1286,5,7,6,11,32,46,-14,27
Vienna,1286,6,6,6,12,25,40,-15,24
SC Rheindorf,1286,7,5,7,12,21,29,-8,22
FC Salzburg,1287,1,14,7,3,43,17,26,49
SK Sturm Gra,1287,2,13,3,8,32,28,4,42
Rapid Vienna,1287,3,8,11,5,35,27,8,35
LASK Linz,1287,4,9,6,9,28,29,-1,33
Vienna,1287,5,7,5,12,27,41,-14,26
SC Rheindorf,1287,6,6,5,13,21,31,-10,23
Mattersburg,1287,7,6,5,13,31,44,-13,23
FC Salzburg,1288,1,13,8,3,46,24,22,47
SK Sturm Gra,1288,2,13,4,7,33,27,6,43
Rapid Vienna,1288,3,8,9,7,37,31,6,33
LASK Linz,1288,4,9,5,10,29,30,-1,32
Mattersburg,1288,5,8,5,11,31,40,-9,29
Vienna,1288,6,6,6,12,28,43,-15,24
SC Rheindorf,1288,7,6,5,13,19,28,-9,23
FC Salzburg,1289,1,15,7,2,50,19,31,52
SK Sturm Gra,1289,2,13,4,7,35,30,5,43
Rapid Vienna,1289,3,7,12,5,34,29,5,33
LASK Linz,1289,4,9,5,10,31,28,3,32
Mattersburg,1289,5,6,6,12,30,45,-15,24
Vienna,1289,6,6,6,12,24,41,-17,24
SC Rheindorf,1289,7,5,6,13,21,33,-12,21
FC Salzburg,1290,1,15,6,3,43,19,24,51
SK Sturm Gra,1290,2,12,6,6,32,26,6,42
Rapid Vienna,1290,3,9,10,5,35,25,10,37
LASK Linz,1290,4,7,7,10,24,28,-4,28
Mattersburg,1290,5,6,7,11,31,40,-9,25
Vienna,1290,6,6,6,12,24,39,-15,24
SC Rheindorf,1290,7,5,6,13,16,28,-12,21
FC Salzburg,1291,1,13,7,4,43,21,22,46
SK Sturm Gra,1291,2,12,4,8,32,29,3,40
Rapid Vienna,1291,3,9,10,5,36,25,11,37
LASK Linz,1291,4,9,7,8,30,26,4,34
Vienna,1291,5,6,7,11,24,38,-14,25
Mattersburg,1291,6,6,6,12,32,47,-15,24
SC Rheindorf,1291,7,6,5,13,20,31,-11,23
FC Salzburg,1292,1,14,6,4,41,18,23,48
SK Sturm Gra,1292,2,12,3,9,30,30,0,39
Rapid Vienna,1292,3,9,11,4,38,26,12,38
LASK Linz,1292,4,10,6,8,32,28,4,36
Vienna,1292,5,8,5,11,27,37,-10,29
Mattersburg,1292,6,6,5,13,30,43,-13,23
SC Rheindorf,1292,7,4,6,14,18,34,-16,18
FC Salzburg,1293,1,15,6,3,45,18,27,51
SK Sturm Gra,1293,2,11,4,9,30,32,-2,37
LASK Linz,1293,3,9,5,10,31,32,-1,32
Rapid Vienna,1293,4,7,10,7,33,32,1,31
Vienna,1293,5,8,5,11,29,37,-8,29
SC Rheindorf,1293,6,7,6,11,23,28,-5,27
Mattersburg,1293,7,6,6,12,30,42,-12,24
FC Salzburg,1294,1,15,7,2,45,17,28,52
SK Sturm Gra,1294,2,12,3,9,29,30,-1,39
Rapid Vienna,1294,3,9,9,6,37,28,9,36
LASK Linz,1294,4,8,5,11,27,29,-2,29
Mattersburg,1294,5,7,6,11,32,39,-7,27
SC Rheindorf,1294,6,6,6,12,19,28,-9,24
Vienna,1294,7,6,6,12,24,42,-18,24
FC Salzburg,1295,1,13,8,3,41,17,24,47
SK Sturm Gra,1295,2,13,3,8,32,27,5,42
Rapid Vienna,1295,3,8,10,6,32,28,4,34
LASK Linz,1295,4,9,7,8,28,26,2,34
Vienna,1295,5,7,6,11,25,38,-13,27
Mattersburg,1295,6,5,8,11,29,40,-11,23
SC Rheindorf,1295,7,5,6,13,18,29,-11,21
FC Salzburg,1296,1,15,7,2,43,16,27,52
SK Sturm Gra,1296,2,12,3,9,31,30,1,39
LASK Linz,1296,3,10,5,9,27,27,0,35
Rapid Vienna,1296,4,8,10,6,36,27,9,34
Mattersburg,1296,5,6,7,11,29,40,-11,25
Vienna,1296,6,6,5,13,23,40,-17,23
SC Rheindorf,1296,7,5,7,12,20,29,-9,22
FC Salzburg,1297,1,15,7,2,48,19,29,52
SK Sturm Gra,1297,2,11,6,7,31,29,2,39
Rapid Vienna,1297,3,8,11,5,36,29,7,35
LASK Linz,1297,4,8,7,9,27,27,0,31
Mattersburg,1297,5,6,7,11,34,43,-9,25
Vienna,1297,6,6,7,11,27,41,-14,25
SC Rheindorf,1297,7,4,7,13,17,32,-15,19
FC Salzburg,1298,1,14,8,2,49,18,31,50
SK Sturm Gra,1298,2,11,5,8,30,29,1,38
LASK Linz,1298,3,10,6,8,28,26,2,36
Rapid Vienna,1298,4,8,10,6,35,28,7,34
Mattersburg,1298,5,6,6,12,30,39,-9,24
SC Rheindorf,1298,6,6,6,12,18,27,-9,24
Vienna,1298,7,6,5,13,24,47,-23,23
FC Salzburg,1299,1,15,6,3,47,17,30,51
SK Sturm Gra,1299,2,13,4,7,32,27,5,43
Rapid Vienna,1299,3,8,10,6,35,29,6,34
LASK Linz,1299,4,8,6,10,30,33,-3,30
Mattersburg,1299,5,8,5,11,35,43,-8,29
Vienna,1299,6,6,5,13,23,41,-18,23
SC Rheindorf,1299,7,5,6,13,21,33,-12,21
FC Salzburg,1300,1,14,6,4,42,18,24,48
SK Sturm Gra,1300,2,12,5,7,31,28,3,41
Rapid Vienna,1300,3,8,12,4,35,26,9,36
LASK Linz,1300,4,7,7,10,25,29,-4,28
Mattersburg,1300,5,7,5,12,32,39,-7,26
Vienna,1300,6,7,5,12,24,40,-16,26
SC Rheindorf,1300,7,6,6,12,20,29,-9,24
FC Salzburg,1301,1,15,6,3,46,17,29,51
Rapid Vienna,1301,2,9,10,5,37,27,10,37
SK Sturm Gra,1301,3,11,4,9,30,31,-1,37
LASK Linz,1301,4,9,5,10,26,28,-2,32
Mattersburg,1301,5,8,5,11,31,38,-7,29
Vienna,1301,6,7,5,12,24,39,-15,26
SC Rheindorf,1301,7,5,5,14,18,32,-14,20
FC Salzburg,1302,1,13,6,5,43,22,21,45
SK Sturm Gra,1302,2,12,4,8,31,29,2,40
LASK Linz,1302,3,11,5,8,34,25,9,38
Rapid Vienna,1302,4,8,10,6,35,28,7,34
Mattersburg,1302,5,7,5,12,33,41,-8,26
Vienna,1302,6,7,5,12,25,39,-14,26
SC Rheindorf,1302,7,6,5,13,17,34,-17,23
FC Salzburg,1303,1,14,6,4,43,20,23,48
Rapid Vienna,1303,2,11,9,4,46,24,22,42
SK Sturm Gra,1303,3,12,5,7,32,33,-1,41
LASK Linz,1303,4,7,6,11,26,33,-7,27
SC Rheindorf,1303,5,6,6,12,22,32,-10,24
Mattersburg,1303,6,6,6,12,34,46,-12,24
Vienna,1303,7,6,6,12,26,41,-15,24
FC Salzburg,1304,1,14,6,4,45,22,23,48
SK Sturm Gra,1304,2,12,4,8,32,30,2,40
Rapid Vienna,1304,3,8,10,6,36,30,6,34
LASK Linz,1304,4,8,7,9,25,27,-2,31
Vienna,1304,5,8,5,11,30,39,-9,29
Mattersburg,1304,6,6,6,12,32,44,-12,24
SC Rheindorf,1304,7,5,8,11,20,28,-8,23
FC Salzburg,1305,1,14,7,3,44,18,26,49
SK Sturm Gra,1305,2,13,4,7,35,27,8,43
Rapid Vienna,1305,3,8,10,6,33,28,5,34
LASK Linz,1305,4,8,5,11,25,30,-5,29
Mattersburg,1305,5,7,6,11,31,41,-10,27
Vienna,1305,6,6,6,12,25,40,-15,24
SC Rheindorf,1305,7,5,8,11,18,27,-9,23
FC Salzburg,1306,1,15,6,3,42,16,26,51
SK Sturm Gra,1306,2,14,3,7,33,26,7,45
Rapid Vienna,1306,3,7,10,7,33,29,4,31
LASK Linz,1306,4,8,6,10,29,32,-3,30
Mattersburg,1306,5,7,6,11,32,40,-8,27
SC Rheindorf,1306,6,6,6,12,21,29,-8,24
Vienna,1306,7,6,5,13,24,42,-18,23
FC Salzburg,1307,1,15,6,3,47,18,29,51
Rapid Vienna,1307,2,9,10,5,34,25,9,37
SK Sturm Gra,1307,3,11,3,10,29,31,-2,36
LASK Linz,1307,4,9,5,10,26,29,-3,32
SC Rheindorf,1307,5,7,6,11,20,26,-6,27
Mattersburg,1307,6,7,5,12,30,41,-11,26
Vienna,1307,7,6,5,13,26,42,-16,23
FC Salzburg,1308,1,14,7,3,44,18,26,49
SK Sturm Gra,1308,2,13,4,7,37,32,5,43
Rapid Vienna,1308,3,9,10,5,39,30,9,37
LASK Linz,1308,4,7,6,11,24,28,-4,27
Vienna,1308,5,7,5,12,28,43,-15,26
SC Rheindorf,1308,6,6,6,12,24,33,-9,24
Mattersburg,1308,7,6,6,12,33,45,-12,24
FC Salzburg,1309,1,14,8,2,45,18,27,50
SK Sturm Gra,1309,2,12,6,6,34,28,6,42
Rapid Vienna,1309,3,8,9,7,35,30,5,33
LASK Linz,1309,4,8,6,10,27,30,-3,30
SC Rheindorf,1309,5,7,6,11,24,27,-3,27
Vienna,1309,6,7,5,12,27,42,-15,26
Mattersburg,1309,7,5,6,13,31,48,-17,21
FC Salzburg,1310,1,13,9,2,45,18,27,48
SK Sturm Gra,1310,2,12,5,7,34,29,5,41
Rapid Vienna,1310,3,9,11,4,40,26,14,38
LASK Linz,1310,4,8,7,9,28,28,0,31
Vienna,1310,5,6,6,12,24,39,-15,24
Mattersburg,1310,6,6,6,12,28,44,-16,24
SC Rheindorf,1310,7,4,8,12,19,34,-15,20
FC Salzburg,1311,1,13,7,4,43,18,25,46
SK Sturm Gra,1311,2,13,4,7,33,27,6,43
Rapid Vienna,1311,3,9,9,6,36,29,7,36
LASK Linz,1311,4,10,5,9,30,29,1,35
Mattersburg,1311,5,7,5,12,31,44,-13,26
Vienna,1311,6,7,5,12,25,39,-14,26
SC Rheindorf,1311,7,5,5,14,20,32,-12,20
FC Salzburg,1312,1,14,7,3,44,20,24,49
SK Sturm Gra,1312,2,13,4,7,38,30,8,43
Rapid Vienna,1312,3,10,9,5,36,25,11,39
LASK Linz,1312,4,7,6,11,26,35,-9,27
Mattersburg,1312,5,6,7,11,29,39,-10,25
Vienna,1312,6,6,6,12,25,40,-15,24
SC Rheindorf,1312,7,5,7,12,21,30,-9,22
FC Salzburg,1313,1,14,6,4,44,20,24,48
SK Sturm Gra,1313,2,12,4,8,31,28,3,40
Rapid Vienna,1313,3,10,9,5,37,27,10,39
LASK Linz,1313,4,7,7,10,26,29,-3,28
Vienna,1313,5,7,5,12,27,40,-13,26
SC Rheindorf,1313,6,6,7,11,22,30,-8,25
Mattersburg,1313,7,6,6,12,32,45,-13,24
FC Salzburg,1314,1,14,6,4,45,20,25,48
SK Sturm Gra,1314,2,12,5,7,32,30,2,41
Rapid Vienna,1314,3,8,11,5,36,27,9,35
LASK Linz,1314,4,8,6,10,29,31,-2,30
Mattersburg,1314,5,8,5,11,33,40,-7,29
Vienna,1314,6,7,5,12,25,40,-15,26
SC Rheindorf,1314,7,5,6,13,18,30,-12,21
FC Salzburg,1315,1,14,7,3,46,18,28,49
LASK Linz,1315,2,11,5,8,31,27,4,38
SK Sturm Gra,1315,3,11,5,8,33,33,0,38
Rapid Vienna,1315,4,9,10,5,39,29,10,37
Vienna,1315,5,7,5,12,26,40,-14,26
Mattersburg,1315,6,5,6,13,31,48,-17,21
SC Rheindorf,1315,7,4,8,12,20,31,-11,20
FC Salzburg,1316,1,15,7,2,44,17,27,52
SK Sturm Gra,1316,2,14,3,7,36,30,6,45
Rapid Vienna,1316,3,7,11,6,33,27,6,32
LASK Linz,1316,4,8,6,10,26,30,-4,30
Vienna,1316,5,7,5,12,26,39,-13,26
SC Rheindorf,1316,6,6,5,13,21,30,-9,23
Mattersburg,1316,7,6,5,13,27,40,-13,23
FC Salzburg,1317,1,15,6,3,47,20,27,51
SK Sturm Gra,1317,2,12,5,7,33,30,3,41
Rapid Vienna,1317,3,8,10,6,38,34,4,34
LASK Linz,1317,4,8,6,10,30,30,0,30
Mattersburg,1317,5,8,5,11,33,40,-7,29
Vienna,1317,6,7,5,12,26,41,-15,26
SC Rheindorf,1317,7,5,5,14,19,31,-12,20
FC Salzburg,1318,1,16,6,2,45,15,30,54
SK Sturm Gra,1318,2,12,4,8,31,29,2,40
Rapid Vienna,1318,3,8,11,5,35,26,9,35
LASK Linz,1318,4,9,5,10,27,29,-2,32
SC Rheindorf,1318,5,6,6,12,20,29,-9,24
Mattersburg,1318,6,6,5,13,29,41,-12,23
Vienna,1318,7,6,5,13,24,42,-18,23
FC Salzburg,1319,1,15,6,3,43,17,26,51
SK Sturm Gra,1319,2,12,4,8,32,29,3,40
Rapid Vienna,1319,3,8,12,4,36,26,10,36
LASK Linz,1319,4,8,7,9,26,29,-3,31
Mattersburg,1319,5,7,6,11,34,41,-7,27
Vienna,1319,6,6,5,13,24,41,-17,23
SC Rheindorf,1319,7,5,6,13,19,31,-12,21
FC Salzburg,1320,1,14,8,2,44,19,25,50
Rapid Vienna,1320,2,10,9,5,37,25,12,39
SK Sturm Gra,1320,3,12,3,9,33,33,0,39
LASK Linz,1320,4,9,5,10,28,30,-2,32
Vienna,1320,5,6,7,11,26,40,-14,25
SC Rheindorf,1320,6,6,5,13,20,27,-7,23
Mattersburg,1320,7,5,7,12,29,43,-14,22
FC Salzburg,1321,1,15,7,2,49,19,30,52
SK Sturm Gra,1321,2,12,5,7,33,29,4,41
Rapid Vienna,1321,3,10,9,5,38,28,10,39
LASK Linz,1321,4,8,6,10,26,28,-2,30
Mattersburg,1321,5,7,5,12,30,42,-12,26
Vienna,1321,6,6,5,13,23,39,-16,23
SC Rheindorf,1321,7,5,5,14,17,31,-14,20
FC Salzburg,1322,1,16,6,2,50,18,32,54
SK Sturm Gra,1322,2,12,4,8,31,31,0,40
Rapid Vienna,1322,3,9,10,5,38,28,10,37
LASK Linz,1322,4,8,6,10,29,30,-1,30
Vienna,1322,5,6,6,12,26,42,-16,24
SC Rheindorf,1322,6,5,7,12,20,29,-9,22
Mattersburg,1322,7,5,7,12,28,44,-16,22
FC Salzburg,1323,1,13,7,4,42,21,21,46
SK Sturm Gra,1323,2,11,4,9,29,31,-2,37
Rapid Vienna,1323,3,9,9,6,37,26,11,36
LASK Linz,1323,4,9,5,10,25,28,-3,32
Mattersburg,1323,5,8,5,11,35,41,-6,29
Vienna,1323,6,8,5,11,30,38,-8,29
SC Rheindorf,1323,7,6,5,13,18,31,-13,23
FC Salzburg,1324,1,14,7,3,47,20,27,49
SK Sturm Gra,1324,2,13,3,8,32,30,2,42
Rapid Vienna,1324,3,8,11,5,36,26,10,35
LASK Linz,1324,4,8,6,10,28,29,-1,30
Vienna,1324,5,8,5,11,30,39,-9,29
SC Rheindorf,1324,6,6,5,13,17,30,-13,23
Mattersburg,1324,7,6,5,13,30,46,-16,23
FC Salzburg,1325,1,16,6,2,47,17,30,54
SK Sturm Gra,1325,2,11,5,8,31,29,2,38
Rapid Vienna,1325,3,8,10,6,35,28,7,34
LASK Linz,1325,4,8,5,11,25,30,-5,29
SC Rheindorf,1325,5,7,6,11,22,27,-5,27
Mattersburg,1325,6,6,6,12,30,41,-11,24
Vienna,1325,7,6,6,12,24,42,-18,24
FC Salzburg,1326,1,16,6,2,46,16,30,54
SK Sturm Gra,1326,2,13,3,8,32,29,3,42
Rapid Vienna,1326,3,9,9,6,37,28,9,36
LASK Linz,1326,4,8,6,10,28,30,-2,30
Mattersburg,1326,5,6,7,11,31,41,-10,25
Vienna,1326,6,6,6,12,24,39,-15,24
SC Rheindorf,1326,7,5,5,14,17,32,-15,20
FC Salzburg,1327,1,16,6,2,50,18,32,54
SK Sturm Gra,1327,2,13,3,8,33,29,4,42
LASK Linz,1327,3,9,5,10,29,29,0,32
Rapid Vienna,1327,4,7,9,8,32,33,-1,30
SC Rheindorf,1327,5,7,6,11,25,29,-4,27
Mattersburg,1327,6,6,6,12,32,44,-12,24
Vienna,1327,7,6,5,13,26,45,-19,23
FC Salzburg,1328,1,16,6,2,53,19,34,54
SK Sturm Gra,1328,2,13,4,7,37,35,2,43
LASK Linz,1328,3,10,6,8,30,27,3,36
Rapid Vienna,1328,4,8,9,7,34,32,2,33
Vienna,1328,5,7,5,12,25,39,-14,26
Mattersburg,1328,6,5,6,13,30,44,-14,21
SC Rheindorf,1328,7,4,6,14,20,33,-13,18
FC Salzburg,1329,1,14,7,3,45,22,23,49
SK Sturm Gra,1329,2,11,5,8,30,28,2,38
Rapid Vienna,1329,3,9,10,5,37,26,11,37
LASK Linz,1329,4,9,6,9,28,28,0,33
Mattersburg,1329,5,7,6,11,34,43,-9,27
Vienna,1329,6,6,7,11,26,40,-14,25
SC Rheindorf,1329,7,5,5,14,17,30,-13,20
FC Salzburg,1330,1,14,8,2,48,18,30,50
SK Sturm Gra,1330,2,12,5,7,29,28,1,41
Rapid Vienna,1330,3,8,12,4,35,24,11,36
LASK Linz,1330,4,8,8,8,25,25,0,32
Vienna,1330,5,6,7,11,26,40,-14,25
SC Rheindorf,1330,6,5,6,13,19,32,-13,21
Mattersburg,1330,7,5,6,13,31,46,-15,21
FC Salzburg,1331,1,12,8,4,40,20,20,44
SK Sturm Gra,1331,2,12,5,7,30,27,3,41
LASK Linz,1331,3,9,7,8,27,24,3,34
Rapid Vienna,1331,4,8,9,7,33,27,6,33
Vienna,1331,5,7,6,11,26,39,-13,27
Mattersburg,1331,6,6,8,10,30,39,-9,26
SC Rheindorf,1331,7,6,5,13,19,29,-10,23
FC Salzburg,1332,1,13,8,3,44,19,25,47
SK Sturm Gra,1332,2,13,4,7,31,27,4,43
Rapid Vienna,1332,3,8,10,6,33,26,7,34
LASK Linz,1332,4,9,6,9,26,25,1,33
Vienna,1332,5,7,6,11,27,40,-13,27
SC Rheindorf,1332,6,6,5,13,20,29,-9,23
Mattersburg,1332,7,5,7,12,30,45,-15,22
FC Salzburg,1333,1,16,6,2,47,17,30,54
SK Sturm Gra,1333,2,13,4,7,33,29,4,43
LASK Linz,1333,3,10,5,9,32,28,4,35
Rapid Vienna,1333,4,8,10,6,35,29,6,34
Mattersburg,1333,5,7,5,12,31,41,-10,26
Vienna,1333,6,6,5,13,24,41,-17,23
SC Rheindorf,1333,7,4,5,15,15,32,-17,17
FC Salzburg,1334,1,14,6,4,45,19,26,48
SK Sturm Gra,1334,2,13,4,7,36,30,6,43
Rapid Vienna,1334,3,8,10,6,32,27,5,34
LASK Linz,1334,4,9,5,10,30,29,1,32
Vienna,1334,5,8,5,11,26,38,-12,29
SC Rheindorf,1334,6,5,8,11,18,27,-9,23
Mattersburg,1334,7,5,6,13,26,43,-17,21
FC Salzburg,1335,1,16,6,2,46,17,29,54
SK Sturm Gra,1335,2,14,3,7,33,27,6,45
Rapid Vienna,1335,3,9,9,6,41,32,9,36
LASK Linz,1335,4,8,6,10,26,28,-2,30
Mattersburg,1335,5,7,5,12,35,42,-7,26
Vienna,1335,6,6,5,13,24,43,-19,23
SC Rheindorf,1335,7,4,6,14,19,35,-16,18
FC Salzburg,1336,1,14,7,3,48,20,28,49
SK Sturm Gra,1336,2,12,4,8,32,29,3,40
Rapid Vienna,1336,3,9,10,5,39,29,10,37
LASK Linz,1336,4,9,6,9,28,28,0,33
Mattersburg,1336,5,6,6,12,30,45,-15,24
Vienna,1336,6,6,6,12,25,40,-15,24
SC Rheindorf,1336,7,5,7,12,20,31,-11,22
FC Salzburg,1337,1,13,8,3,45,20,25,47
SK Sturm Gra,1337,2,11,6,7,32,30,2,39
Rapid Vienna,1337,3,8,12,4,39,28,11,36
LASK Linz,1337,4,8,8,8,27,27,0,32
Mattersburg,1337,5,6,8,10,29,38,-9,26
Vienna,1337,6,6,6,12,24,41,-17,24
SC Rheindorf,1337,7,5,6,13,22,34,-12,21
FC Salzburg,1338,1,13,8,3,43,19,24,47
SK Sturm Gra,1338,2,12,5,7,34,28,6,41
Rapid Vienna,1338,3,10,10,4,38,25,13,40
LASK Linz,1338,4,8,6,10,26,30,-4,30
Mattersburg,1338,5,7,6,11,31,41,-10,27
Vienna,1338,6,6,7,11,24,38,-14,25
SC Rheindorf,1338,7,4,6,14,16,31,-15,18
FC Salzburg,1339,1,14,7,3,44,22,22,49
SK Sturm Gra,1339,2,12,5,7,33,29,4,41
Rapid Vienna,1339,3,7,12,5,36,29,7,33
LASK Linz,1339,4,8,8,8,28,28,0,32
Mattersburg,1339,5,6,7,11,34,42,-8,25
Vienna,1339,6,6,6,12,26,41,-15,24
SC Rheindorf,1339,7,6,5,13,20,30,-10,23
FC Salzburg,1340,1,15,6,3,47,19,28,51
SK Sturm Gra,1340,2,13,3,8,36,30,6,42
Rapid Vienna,1340,3,8,9,7,34,34,0,33
LASK Linz,1340,4,8,6,10,28,29,-1,30
SC Rheindorf,1340,5,7,6,11,23,28,-5,27
Vienna,1340,6,7,5,12,26,40,-14,26
Mattersburg,1340,7,6,5,13,30,44,-14,23
FC Salzburg,1341,1,15,6,3,46,18,28,51
SK Sturm Gra,1341,2,13,3,8,37,33,4,42
Rapid Vienna,1341,3,7,9,8,36,35,1,30
LASK Linz,1341,4,8,6,10,33,35,-2,30
Mattersburg,1341,5,7,6,11,34,42,-8,27
SC Rheindorf,1341,6,7,5,12,20,29,-9,26
Vienna,1341,7,7,5,12,25,39,-14,26
FC Salzburg,1342,1,14,8,2,48,16,32,50
Rapid Vienna,1342,2,9,10,5,36,28,8,37
SK Sturm Gra,1342,3,11,3,10,30,33,-3,36
LASK Linz,1342,4,9,5,10,28,28,0,32
SC Rheindorf,1342,5,7,6,11,20,26,-6,27
Vienna,1342,6,7,5,12,26,43,-17,26
Mattersburg,1342,7,5,7,12,27,41,-14,22
FC Salzburg,1343,1,14,8,2,44,19,25,50
SK Sturm Gra,1343,2,12,4,8,34,31,3,40
LASK Linz,1343,3,9,6,9,30,28,2,33
Rapid Vienna,1343,4,7,11,6,34,29,5,32
SC Rheindorf,1343,5,7,6,11,21,28,-7,27
Vienna,1343,6,7,6,11,28,39,-11,27
Mattersburg,1343,7,5,5,14,26,43,-17,20
FC Salzburg,1344,1,16,6,2,49,16,33,54
Rapid Vienna,1344,2,10,9,5,38,27,11,39
SK Sturm Gra,1344,3,11,4,9,31,33,-2,37
LASK Linz,1344,4,8,6,10,30,31,-1,30
SC Rheindorf,1344,5,6,6,12,21,30,-9,24
Mattersburg,1344,6,6,6,12,32,46,-14,24
Vienna,1344,7,6,5,13,24,42,-18,23
FC Salzburg,1345,1,14,7,3,43,19,24,49
SK Sturm Gra,1345,2,13,3,8,34,29,5,42
Rapid Vienna,1345,3,10,9,5,37,28,9,39
LASK Linz,1345,4,9,6,9,28,28,0,33
Mattersburg,1345,5,7,6,11,35,41,-6,27
Vienna,1345,6,6,6,12,24,40,-16,24
SC Rheindorf,1345,7,4,5,15,16,32,-16,17
FC Salzburg,1346,1,14,6,4,44,18,26,48
SK Sturm Gra,1346,2,13,5,6,34,28,6,44
Rapid Vienna,1346,3,9,10,5,34,25,9,37
LASK Linz,1346,4,9,6,9,28,27,1,33
Mattersburg,1346,5,7,6,11,30,41,-11,27
Vienna,1346,6,6,5,13,25,42,-17,23
SC Rheindorf,1346,7,4,6,14,17,31,-14,18
FC Salzburg,1347,1,14,8,2,47,20,27,50
SK Sturm Gra,1347,2,12,6,6,32,27,5,42
Rapid Vienna,1347,3,8,11,5,37,29,8,35
LASK Linz,1347,4,8,6,10,27,29,-2,30
Mattersburg,1347,5,7,6,11,37,41,-4,27
Vienna,1347,6,6,5,13,23,44,-21,23
SC Rheindorf,1347,7,5,6,13,19,32,-13,21
FC Salzburg,1348,1,14,8,2,45,20,25,50
SK Sturm Gra,1348,2,13,3,8,34,27,7,42
Rapid Vienna,1348,3,8,10,6,33,28,5,34
LASK Linz,1348,4,8,5,11,29,34,-5,29
SC Rheindorf,1348,5,7,5,12,19,27,-8,26
Vienna,1348,6,6,7,11,27,41,-14,25
Mattersburg,1348,7,6,6,12,34,44,-10,24
FC Salzburg,1349,1,13,7,4,44,20,24,46
SK Sturm Gra,1349,2,14,4,6,37,26,11,46
Rapid Vienna,1349,3,10,10,4,41,26,15,40
Vienna,1349,4,7,6,11,27,40,-13,27
LASK Linz,1349,5,7,5,12,27,37,-10,26
Mattersburg,1349,6,7,5,12,36,48,-12,26
SC Rheindorf,1349,7,5,5,14,20,35,-15,20
FC Salzburg,1350,1,15,6,3,48,17,31,51
SK Sturm Gra,1350,2,13,4,7,34,27,7,43
LASK Linz,1350,3,10,5,9,29,28,1,35
Rapid Vienna,1350,4,8,10,6,35,32,3,34
Mattersburg,1350,5,7,5,12,31,43,-12,26
Vienna,1350,6,6,5,13,24,41,-17,23
SC Rheindorf,1350,7,5,5,14,20,33,-13,20
FC Salzburg,1351,1,13,7,4,41,20,21,46
Rapid Vienna,1351,2,10,9,5,42,29,13,39
SK Sturm Gra,1351,3,11,5,8,32,31,1,38
LASK Linz,1351,4,10,6,8,30,28,2,36
Vienna,1351,5,7,5,12,28,41,-13,26
Mattersburg,1351,6,6,7,11,31,41,-10,25
SC Rheindorf,1351,7,4,7,13,18,32,-14,19
FC Salzburg,1352,1,16,6,2,48,17,31,54
SK Sturm Gra,1352,2,13,4,7,35,33,2,43
Rapid Vienna,1352,3,8,10,6,36,28,8,34
LASK Linz,1352,4,7,9,8,27,28,-1,30
Vienna,1352,5,7,5,12,24,39,-15,26
Mattersburg,1352,6,6,6,12,31,41,-10,24
SC Rheindorf,1352,7,4,6,14,18,33,-15,18
FC Salzburg,1353,1,14,7,3,45,20,25,49
SK Sturm Gra,1353,2,11,6,7,30,29,1,39
Rapid Vienna,1353,3,8,12,4,38,26,12,36
LASK Linz,1353,4,8,8,8,29,28,1,32
Mattersburg,1353,5,7,6,11,29,40,-11,27
Vienna,1353,6,6,5,13,24,41,-17,23
SC Rheindorf,1353,7,5,6,13,19,30,-11,21
FC Salzburg,1354,1,14,8,2,47,19,28,50
SK Sturm Gra,1354,2,12,5,7,30,27,3,41
Rapid Vienna,1354,3,7,13,4,37,29,8,34
LASK Linz,1354,4,8,6,10,29,30,-1,30
Mattersburg,1354,5,6,7,11,32,44,-12,25
Vienna,1354,6,6,6,12,24,40,-16,24
SC Rheindorf,1354,7,5,7,12,20,30,-10,22
FC Salzburg,1355,1,15,7,2,47,18,29,52
SK Sturm Gra,1355,2,11,5,8,30,29,1,38
Rapid Vienna,1355,3,8,11,5,33,25,8,35
LASK Linz,1355,4,7,8,9,27,29,-2,29
Vienna,1355,5,7,5,12,26,41,-15,26
SC Rheindorf,1355,6,6,7,11,19,27,-8,25
Mattersburg,1355,7,5,7,12,29,42,-13,22
FC Salzburg,1356,1,16,6,2,46,16,30,54
SK Sturm Gra,1356,2,12,5,7,34,27,7,41
Rapid Vienna,1356,3,8,11,5,34,26,8,35
LASK Linz,1356,4,7,5,12,25,35,-10,26
Vienna,1356,5,7,5,12,25,39,-14,26
Mattersburg,1356,6,6,6,12,28,42,-14,24
SC Rheindorf,1356,7,5,8,11,19,26,-7,23
FC Salzburg,1357,1,15,6,3,43,17,26,51
SK Sturm Gra,1357,2,12,4,8,34,29,5,40
Rapid Vienna,1357,3,8,9,7,34,29,5,33
LASK Linz,1357,4,8,6,10,28,33,-5,30
Mattersburg,1357,5,7,6,11,34,42,-8,27
Vienna,1357,6,7,6,11,26,39,-13,27
SC Rheindorf,1357,7,5,7,12,18,28,-10,22
FC Salzburg,1358,1,14,7,3,43,20,23,49
SK Sturm Gra,1358,2,14,4,6,39,26,13,46
LASK Linz,1358,3,9,6,9,29,30,-1,33
Rapid Vienna,1358,4,7,10,7,34,29,5,31
Mattersburg,1358,5,7,5,12,32,42,-10,26
Vienna,1358,6,6,6,12,23,39,-16,24
SC Rheindorf,1358,7,5,6,13,18,32,-14,21
FC Salzburg,1359,1,14,7,3,41,17,24,49
Rapid Vienna,1359,2,10,9,5,36,28,8,39
SK Sturm Gra,1359,3,12,3,9,32,31,1,39
LASK Linz,1359,4,9,7,8,33,28,5,34
Vienna,1359,5,7,6,11,25,38,-13,27
SC Rheindorf,1359,6,5,6,13,19,30,-11,21
Mattersburg,1359,7,5,6,13,31,45,-14,21
FC Salzburg,1360,1,14,8,2,44,17,27,50
SK Sturm Gra,1360,2,12,5,7,31,27,4,41
Rapid Vienna,1360,3,8,12,4,37,26,11,36
LASK Linz,1360,4,7,6,11,26,32,-6,27
Mattersburg,1360,5,6,7,11,30,41,-11,25
SC Rheindorf,1360,6,6,6,12,21,30,-9,24
Vienna,1360,7,6,6,12,24,40,-16,24
FC Salzburg,1361,1,15,7,2,46,18,28,52
SK Sturm Gra,1361,2,13,5,6,34,26,8,44
Rapid Vienna,1361,3,8,10,6,38,35,3,34
LASK Linz,1361,4,8,7,9,29,30,-1,31
Vienna,1361,5,7,5,12,25,39,-14,26
Mattersburg,1361,6,6,6,12,31,42,-11,24
SC Rheindorf,1361,7,4,6,14,16,29,-13,18
FC Salzburg,1362,1,14,8,2,46,17,29,50
SK Sturm Gra,1362,2,13,4,7,34,26,8,43
Rapid Vienna,1362,3,9,10,5,35,26,9,37
LASK Linz,1362,4,8,6,10,27,32,-5,30
Vienna,1362,5,6,7,11,25,39,-14,25
Mattersburg,1362,6,6,6,12,31,45,-14,24
SC Rheindorf,1362,7,4,7,13,17,30,-13,19
FC Salzburg,1363,1,16,6,2,47,17,30,54
SK Sturm Gra,1363,2,13,4,7,37,31,6,43
Rapid Vienna,1363,3,7,11,6,34,29,5,32
LASK Linz,1363,4,8,6,10,32,33,-1,30
Vienna,1363,5,7,5,12,25,39,-14,26
SC Rheindorf,1363,6,5,8,11,21,29,-8,23
Mattersburg,1363,7,5,6,13,27,45,-18,21
FC Salzburg,1364,1,13,8,3,43,19,24,47
SK Sturm Gra,1364,2,13,4,7,32,28,4,43
Rapid Vienna,1364,3,8,10,6,33,27,6,34
LASK Linz,1364,4,9,7,8,31,29,2,34
Vienna,1364,5,7,6,11,28,41,-13,27
Mattersburg,1364,6,7,5,12,33,43,-10,26
SC Rheindorf,1364,7,4,6,14,17,30,-13,18
FC Salzburg,1365,1,16,6,2,50,16,34,54
SK Sturm Gra,1365,2,13,3,8,33,29,4,42
LASK Linz,1365,3,10,5,9,32,29,3,35
Rapid Vienna,1365,4,7,10,7,33,32,1,31
SC Rheindorf,1365,5,6,6,12,21,29,-8,24
Vienna,1365,6,6,6,12,25,42,-17,24
Mattersburg,1365,7,5,6,13,28,45,-17,21
FC Salzburg,1366,1,15,7,2,47,19,28,52
SK Sturm Gra,1366,2,13,4,7,31,26,5,43
Rapid Vienna,1366,3,9,10,5,35,26,9,37
LASK Linz,1366,4,7,6,11,26,30,-4,27
Vienna,1366,5,7,5,12,28,42,-14,26
Mattersburg,1366,6,6,6,12,31,44,-13,24
SC Rheindorf,1366,7,5,6,13,18,29,-11,21
FC Salzburg,1367,1,15,6,3,47,19,28,51
SK Sturm Gra,1367,2,11,5,8,31,33,-2,38
Rapid Vienna,1367,3,8,11,5,35,27,8,35
LASK Linz,1367,4,8,6,10,26,28,-2,30
SC Rheindorf,1367,5,7,6,11,22,29,-7,27
Vienna,1367,6,7,5,12,25,38,-13,26
Mattersburg,1367,7,6,5,13,29,41,-12,23
FC Salzburg,1368,1,16,6,2,50,19,31,54
Rapid Vienna,1368,2,10,9,5,37,27,10,39
SK Sturm Gra,1368,3,12,3,9,32,32,0,39
SC Rheindorf,1368,4,7,5,12,23,28,-5,26
LASK Linz,1368,5,7,5,12,27,33,-6,26
Mattersburg,1368,6,7,5,12,31,44,-13,26
Vienna,1368,7,6,5,13,25,42,-17,23
FC Salzburg,1369,1,14,8,2,45,18,27,50
SK Sturm Gra,1369,2,12,5,7,32,29,3,41
Rapid Vienna,1369,3,8,11,5,35,27,8,35
LASK Linz,1369,4,7,6,11,26,31,-5,27
Vienna,1369,5,7,6,11,27,39,-12,27
SC Rheindorf,1369,6,6,7,11,23,29,-6,25
Mattersburg,1369,7,6,5,13,32,47,-15,23
FC Salzburg,1370,1,15,7,2,45,16,29,52
SK Sturm Gra,1370,2,13,4,7,34,28,6,43
Rapid Vienna,1370,3,8,10,6,33,32,1,34
LASK Linz,1370,4,9,6,9,30,26,4,33
Mattersburg,1370,5,6,7,11,32,41,-9,25
Vienna,1370,6,6,5,13,25,43,-18,23
SC Rheindorf,1370,7,4,7,13,20,33,-13,19
FC Salzburg,1371,1,14,8,2,46,18,28,50
SK Sturm Gra,1371,2,14,3,7,35,28,7,45
Rapid Vienna,1371,3,7,10,7,34,31,3,31
LASK Linz,1371,4,8,6,10,27,29,-2,30
Vienna,1371,5,7,6,11,25,38,-13,27
SC Rheindorf,1371,6,7,5,12,23,30,-7,26
Mattersburg,1371,7,5,6,13,31,47,-16,21
FC Salzburg,1372,1,15,7,2,48,18,30,52
SK Sturm Gra,1372,2,14,4,6,35,26,9,46
Rapid Vienna,1372,3,7,10,7,33,30,3,31
LASK Linz,1372,4,8,6,10,26,30,-4,30
Mattersburg,1372,5,6,6,12,33,45,-12,24
Vienna,1372,6,6,6,12,25,41,-16,24
SC Rheindorf,1372,7,5,7,12,21,31,-10,22
FC Salzburg,1373,1,15,7,2,44,17,27,52
SK Sturm Gra,1373,2,12,4,8,32,30,2,40
LASK Linz,1373,3,9,6,9,26,26,0,33
Rapid Vienna,1373,4,7,10,7,35,30,5,31
Mattersburg,1373,5,5,9,10,31,41,-10,24
Vienna,1373,6,6,6,12,24,39,-15,24
SC Rheindorf,1373,7,5,8,11,22,31,-9,23
FC Salzburg,1374,1,14,8,2,44,17,27,50
SK Sturm Gra,1374,2,11,4,9,32,34,-2,37
Rapid Vienna,1374,3,8,10,6,36,30,6,34
LASK Linz,1374,4,8,6,10,28,29,-1,30
SC Rheindorf,1374,5,8,5,11,23,28,-5,29
Vienna,1374,6,7,5,12,27,40,-13,26
Mattersburg,1374,7,6,6,12,30,42,-12,24
FC Salzburg,1375,1,13,8,3,45,19,26,47
SK Sturm Gra,1375,2,12,4,8,30,28,2,40
Rapid Vienna,1375,3,8,11,5,36,28,8,35
LASK Linz,1375,4,8,7,9,26,27,-1,31
SC Rheindorf,1375,5,7,6,11,23,29,-6,27
Vienna,1375,6,7,5,12,25,42,-17,26
Mattersburg,1375,7,5,7,12,29,41,-12,22
FC Salzburg,1376,1,14,8,2,46,18,28,50
SK Sturm Gra,1376,2,13,5,6,35,28,7,44
Rapid Vienna,1376,3,9,10,5,39,30,9,37
LASK Linz,1376,4,8,6,10,28,30,-2,30
Vienna,1376,5,6,7,11,25,39,-14,25
Mattersburg,1376,6,5,7,12,29,42,-13,22
SC Rheindorf,1376,7,4,7,13,19,34,-15,19
FC Salzburg,1377,1,15,7,2,46,19,27,52
SK Sturm Gra,1377,2,12,5,7,34,30,4,41
Rapid Vienna,1377,3,9,10,5,38,28,10,37
LASK Linz,1377,4,7,5,12,25,31,-6,26
Vienna,1377,5,7,5,12,26,39,-13,26
Mattersburg,1377,6,6,6,12,29,42,-13,24
SC Rheindorf,1377,7,5,8,11,20,29,-9,23
FC Salzburg,1378,1,15,7,2,48,18,30,52
SK Sturm Gra,1378,2,14,3,7,37,29,8,45
Rapid Vienna,1378,3,7,10,7,31,29,2,31
LASK Linz,1378,4,8,6,10,27,30,-3,30
Vienna,1378,5,7,5,12,28,39,-11,26
Mattersburg,1378,6,7,5,12,32,46,-14,26
SC Rheindorf,1378,7,5,6,13,20,32,-12,21
FC Salzburg,1379,1,14,7,3,44,18,26,49
SK Sturm Gra,1379,2,13,4,7,35,30,5,43
Rapid Vienna,1379,3,8,10,6,34,28,6,34
LASK Linz,1379,4,8,5,11,26,31,-5,29
Mattersburg,1379,5,7,6,11,29,37,-8,27
Vienna,1379,6,7,5,12,24,39,-15,26
SC Rheindorf,1379,7,5,7,12,19,28,-9,22
FC Salzburg,1380,1,15,6,3,46,20,26,51
SK Sturm Gra,1380,2,12,4,8,30,29,1,40
Rapid Vienna,1380,3,9,9,6,35,28,7,36
LASK Linz,1380,4,9,6,9,29,29,0,33
Vienna,1380,5,7,5,12,28,41,-13,26
Mattersburg,1380,6,6,5,13,34,46,-12,23
SC Rheindorf,1380,7,5,7,12,18,27,-9,22
FC Salzburg,1381,1,13,6,5,45,24,21,45
SK Sturm Gra,1381,2,12,4,8,33,31,2,40
Rapid Vienna,1381,3,9,9,6,38,29,9,36
LASK Linz,1381,4,10,6,8,31,29,2,36
Vienna,1381,5,8,5,11,28,40,-12,29
Mattersburg,1381,6,6,7,11,34,43,-9,25
SC Rheindorf,1381,7,4,7,13,18,31,-13,19
FC Salzburg,1382,1,15,6,3,50,20,30,51
SK Sturm Gra,1382,2,12,4,8,31,31,0,40
Rapid Vienna,1382,3,8,9,7,33,29,4,33
LASK Linz,1382,4,9,6,9,31,29,2,33
Vienna,1382,5,8,5,11,30,39,-9,29
SC Rheindorf,1382,6,6,5,13,19,29,-10,23
Mattersburg,1382,7,6,5,13,30,47,-17,23
FC Salzburg,1383,1,15,7,2,47,18,29,52
SK Sturm Gra,1383,2,13,5,6,32,25,7,44
Rapid Vienna,1383,3,8,9,7,37,31,6,33
LASK Linz,1383,4,9,5,10,28,33,-5,32
Mattersburg,1383,5,7,6,11,34,41,-7,27
Vienna,1383,6,6,6,12,24,40,-16,24
SC Rheindorf,1383,7,4,6,14,16,30,-14,18
FC Salzburg,1384,1,15,6,3,42,17,25,51
SK Sturm Gra,1384,2,12,4,8,31,28,3,40
LASK Linz,1384,3,9,5,10,27,29,-2,32
Rapid Vienna,1384,4,7,10,7,32,28,4,31
Vienna,1384,5,8,5,11,26,38,-12,29
Mattersburg,1384,6,7,5,12,30,40,-10,26
SC Rheindorf,1384,7,5,7,12,22,30,-8,22
FC Salzburg,1385,1,13,9,2,41,17,24,48
SK Sturm Gra,1385,2,12,4,8,33,30,3,40
Rapid Vienna,1385,3,8,11,5,34,26,8,35
LASK Linz,1385,4,7,7,10,25,28,-3,28
Mattersburg,1385,5,6,8,10,31,39,-8,26
SC Rheindorf,1385,6,7,5,12,21,30,-9,26
Vienna,1385,7,6,6,12,25,40,-15,24
FC Salzburg,1386,1,14,7,3,42,16,26,49
Rapid Vienna,1386,2,11,9,4,39,23,16,42
SK Sturm Gra,1386,3,12,4,8,31,28,3,40
LASK Linz,1386,4,9,5,10,28,30,-2,32
Mattersburg,1386,5,7,5,12,33,45,-12,26
Vienna,1386,6,6,5,13,23,40,-17,23
SC Rheindorf,1386,7,5,5,14,19,33,-14,20
FC Salzburg,1387,1,14,7,3,44,18,26,49
SK Sturm Gra,1387,2,12,4,8,32,28,4,40
Rapid Vienna,1387,3,9,11,4,36,25,11,38
LASK Linz,1387,4,9,5,10,27,28,-1,32
Vienna,1387,5,6,7,11,26,40,-14,25
SC Rheindorf,1387,6,6,6,12,21,30,-9,24
Mattersburg,1387,7,5,6,13,28,45,-17,21
FC Salzburg,1388,1,15,7,2,44,18,26,52
SK Sturm Gra,1388,2,11,5,8,29,28,1,38
Rapid Vienna,1388,3,8,11,5,35,27,8,35
LASK Linz,1388,4,9,5,10,29,29,0,32
Vienna,1388,5,6,7,11,27,41,-14,25
SC Rheindorf,1388,6,5,8,11,19,28,-9,23
Mattersburg,1388,7,5,7,12,31,43,-12,22
FC Salzburg,1389,1,15,7,2,46,16,30,52
SK Sturm Gra,1389,2,13,4,7,33,30,3,43
Rapid Vienna,1389,3,7,9,8,32,29,3,30
LASK Linz,1389,4,8,5,11,25,28,-3,29
Vienna,1389,5,7,6,11,26,37,-11,27
Mattersburg,1389,6,7,5,12,31,42,-11,26
SC Rheindorf,1389,7,6,6,12,18,29,-11,24
FC Salzburg,1390,1,13,6,5,45,25,20,45
SK Sturm Gra,1390,2,13,4,7,35,30,5,43
Rapid Vienna,1390,3,9,10,5,37,28,9,37
Mattersburg,1390,4,8,6,10,34,40,-6,30
LASK Linz,1390,5,7,7,10,26,29,-3,28
Vienna,1390,6,7,6,11,28,41,-13,27
SC Rheindorf,1390,7,4,7,13,19,31,-12,19
FC Salzburg,1391,1,15,6,3,44,18,26,51
SK Sturm Gra,1391,2,14,3,7,34,29,5,45
Rapid Vienna,1391,3,9,9,6,35,26,9,36
LASK Linz,1391,4,8,6,10,29,31,-2,30
Mattersburg,1391,5,6,7,11,33,44,-11,25
Vienna,1391,6,6,6,12,26,41,-15,24
SC Rheindorf,1391,7,5,5,14,19,31,-12,20
FC Salzburg,1392,1,13,7,4,41,19,22,46
SK Sturm Gra,1392,2,14,3,7,35,27,8,45
Rapid Vienna,1392,3,9,11,4,35,25,10,38
LASK Linz,1392,4,8,7,9,28,29,-1,31
Mattersburg,1392,5,7,5,12,31,42,-11,26
Vienna,1392,6,6,6,12,24,40,-16,24
SC Rheindorf,1392,7,4,7,13,18,30,-12,19
FC Salzburg,1393,1,13,7,4,45,23,22,46
SK Sturm Gra,1393,2,12,4,8,34,31,3,40
Rapid Vienna,1393,3,10,9,5,37,27,10,39
LASK Linz,1393,4,9,5,10,31,30,1,32
Mattersburg,1393,5,8,5,11,35,42,-7,29
Vienna,1393,6,7,5,12,26,42,-16,26
SC Rheindorf,1393,7,5,5,14,20,33,-13,20
FC Salzburg,1394,1,16,6,2,46,17,29,54
Rapid Vienna,1394,2,9,10,5,34,25,9,37
SK Sturm Gra,1394,3,11,4,9,30,31,-1,37
LASK Linz,1394,4,9,6,9,26,26,0,33
Vienna,1394,5,6,6,12,24,39,-15,24
Mattersburg,1394,6,5,7,12,29,41,-12,22
SC Rheindorf,1394,7,4,9,11,17,27,-10,21
FC Salzburg,1395,1,13,7,4,41,20,21,46
SK Sturm Gra,1395,2,11,5,8,30,28,2,38
LASK Linz,1395,3,10,6,8,28,26,2,36
Rapid Vienna,1395,4,8,10,6,34,29,5,34
Mattersburg,1395,5,8,6,10,33,38,-5,30
SC Rheindorf,1395,6,6,5,13,19,28,-9,23
Vienna,1395,7,6,5,13,25,41,-16,23
SK Sturm Gra,1396,1,14,4,6,35,25,10,46
FC Salzburg,1396,2,13,6,5,41,23,18,45
Rapid Vienna,1396,3,8,11,5,36,27,9,35
LASK Linz,1396,4,8,6,10,24,29,-5,30
Mattersburg,1396,5,7,6,11,30,39,-9,27
SC Rheindorf,1396,6,5,8,11,19,26,-7,23
Vienna,1396,7,6,5,13,25,41,-16,23
FC Salzburg,1397,1,12,8,4,43,22,21,44
SK Sturm Gra,1397,2,12,4,8,35,28,7,40
Rapid Vienna,1397,3,8,10,6,36,34,2,34
LASK Linz,1397,4,9,5,10,28,29,-1,32
Mattersburg,1397,5,8,6,10,33,39,-6,30
Vienna,1397,6,7,6,11,26,39,-13,27
SC Rheindorf,1397,7,6,5,13,18,28,-10,23
FC Salzburg,1398,1,14,7,3,46,21,25,49
SK Sturm Gra,1398,2,12,4,8,32,30,2,40
Rapid Vienna,1398,3,9,9,6,37,29,8,36
LASK Linz,1398,4,8,5,11,28,32,-4,29
Mattersburg,1398,5,8,5,11,36,41,-5,29
Vienna,1398,6,7,6,11,27,40,-13,27
SC Rheindorf,1398,7,5,6,13,21,34,-13,21
FC Salzburg,1399,1,15,7,2,47,17,30,52
Rapid Vienna,1399,2,10,10,4,37,25,12,40
SK Sturm Gra,1399,3,12,4,8,32,31,1,40
LASK Linz,1399,4,8,7,9,25,26,-1,31
Mattersburg,1399,5,6,7,11,31,41,-10,25
Vienna,1399,6,6,6,12,28,44,-16,24
SC Rheindorf,1399,7,4,5,15,17,33,-16,17
FC Salzburg,1400,1,14,6,4,46,22,24,48
SK Sturm Gra,1400,2,13,4,7,33,29,4,43
LASK Linz,1400,3,10,5,9,30,27,3,35
Rapid Vienna,1400,4,8,10,6,35,28,7,34
Mattersburg,1400,5,7,5,12,33,42,-9,26
Vienna,1400,6,7,5,12,26,40,-14,26
SC Rheindorf,1400,7,5,5,14,17,32,-15,20
FC Salzburg,1401,1,13,8,3,41,17,24,47
SK Sturm Gra,1401,2,12,3,9,31,34,-3,39
Rapid Vienna,1401,3,9,10,5,39,27,12,37
LASK Linz,1401,4,10,5,9,29,28,1,35
Mattersburg,1401,5,8,5,11,32,42,-10,29
Vienna,1401,6,6,6,12,23,38,-15,24
SC Rheindorf,1401,7,5,5,14,22,31,-9,20
FC Salzburg,1402,1,15,7,2,43,16,27,52
SK Sturm Gra,1402,2,13,5,6,34,27,7,44
Rapid Vienna,1402,3,9,9,6,37,28,9,36
LASK Linz,1402,4,8,6,10,31,33,-2,30
Vienna,1402,5,7,5,12,26,40,-14,26
SC Rheindorf,1402,6,5,6,13,20,33,-13,21
Mattersburg,1402,7,5,6,13,33,47,-14,21
FC Salzburg,1403,1,15,6,3,50,19,31,51
SK Sturm Gra,1403,2,14,3,7,34,29,5,45
Rapid Vienna,1403,3,8,10,6,35,27,8,34
LASK Linz,1403,4,8,6,10,26,28,-2,30
Vienna,1403,5,7,5,12,28,41,-13,26
SC Rheindorf,1403,6,6,5,13,19,32,-13,23
Mattersburg,1403,7,6,5,13,31,47,-16,23
FC Salzburg,1404,1,14,6,4,45,19,26,48
SK Sturm Gra,1404,2,13,3,8,34,32,2,42
Rapid Vienna,1404,3,9,11,4,38,28,10,38
LASK Linz,1404,4,7,7,10,28,31,-3,28
Mattersburg,1404,5,7,7,10,30,37,-7,28
Vienna,1404,6,6,5,13,25,43,-18,23
SC Rheindorf,1404,7,5,7,12,21,31,-10,22
FC Salzburg,1405,1,15,7,2,45,19,26,52
SK Sturm Gra,1405,2,13,4,7,34,27,7,43
Rapid Vienna,1405,3,7,11,6,33,29,4,32
Mattersburg,1405,4,8,5,11,31,38,-7,29
LASK Linz,1405,5,7,6,11,24,30,-6,27
SC Rheindorf,1405,6,6,6,12,19,27,-8,24
Vienna,1405,7,6,5,13,26,42,-16,23
SK Sturm Gra,1406,1,14,3,7,38,29,9,45
FC Salzburg,1406,2,12,8,4,40,20,20,44
Rapid Vienna,1406,3,10,10,4,37,26,11,40
LASK Linz,1406,4,9,6,9,34,30,4,33
Vienna,1406,5,7,6,11,26,37,-11,27
Mattersburg,1406,6,5,6,13,27,47,-20,21
SC Rheindorf,1406,7,5,5,14,20,33,-13,20
FC Salzburg,1407,1,15,6,3,45,16,29,51
SK Sturm Gra,1407,2,12,4,8,32,29,3,40
Rapid Vienna,1407,3,8,10,6,34,29,5,34
LASK Linz,1407,4,9,5,10,27,30,-3,32
Vienna,1407,5,8,5,11,25,37,-12,29
Mattersburg,1407,6,6,6,12,28,40,-12,24
SC Rheindorf,1407,7,5,6,13,20,30,-10,21
FC Salzburg,1408,1,16,6,2,52,17,35,54
SK Sturm Gra,1408,2,13,3,8,36,33,3,42
Rapid Vienna,1408,3,8,10,6,33,28,5,34
Mattersburg,1408,4,8,5,11,35,42,-7,29
LASK Linz,1408,5,7,6,11,28,33,-5,27
SC Rheindorf,1408,6,6,5,13,20,31,-11,23
Vienna,1408,7,6,5,13,24,44,-20,23
FC Salzburg,1409,1,15,7,2,48,19,29,52
SK Sturm Gra,1409,2,11,4,9,29,29,0,37
Rapid Vienna,1409,3,9,9,6,38,29,9,36
LASK Linz,1409,4,9,6,9,30,27,3,33
Vienna,1409,5,7,6,11,26,39,-13,27
Mattersburg,1409,6,6,5,13,33,47,-14,23
SC Rheindorf,1409,7,6,5,13,19,33,-14,23
FC Salzburg,1410,1,14,6,4,46,22,24,48
SK Sturm Gra,1410,2,13,3,8,32,27,5,42
Rapid Vienna,1410,3,9,9,6,35,29,6,36
LASK Linz,1410,4,9,6,9,26,26,0,33
Mattersburg,1410,5,7,5,12,34,44,-10,26
Vienna,1410,6,7,5,12,25,39,-14,26
SC Rheindorf,1410,7,5,6,13,18,29,-11,21
FC Salzburg,1411,1,13,6,5,47,23,24,45
SK Sturm Gra,1411,2,14,3,7,37,31,6,45
Rapid Vienna,1411,3,10,9,5,40,29,11,39
Mattersburg,1411,4,8,5,11,32,41,-9,29
LASK Linz,1411,5,7,5,12,30,37,-7,26
Vienna,1411,6,7,5,12,26,40,-14,26
SC Rheindorf,1411,7,6,5,13,20,31,-11,23
FC Salzburg,1412,1,13,7,4,47,21,26,46
SK Sturm Gra,1412,2,11,5,8,32,31,1,38
Rapid Vienna,1412,3,8,10,6,34,33,1,34
Mattersburg,1412,4,8,6,10,36,40,-4,30
LASK Linz,1412,5,7,8,9,26,30,-4,29
Vienna,1412,6,7,5,12,26,40,-14,26
SC Rheindorf,1412,7,6,7,11,21,27,-6,25
FC Salzburg,1413,1,13,7,4,41,22,19,46
Rapid Vienna,1413,2,10,10,4,40,24,16,40
SK Sturm Gra,1413,3,12,4,8,35,30,5,40
Vienna,1413,4,8,5,11,27,38,-11,29
LASK Linz,1413,5,7,7,10,26,33,-7,28
Mattersburg,1413,6,6,6,12,34,44,-10,24
SC Rheindorf,1413,7,5,7,12,20,32,-12,22
FC Salzburg,1414,1,15,7,2,49,17,32,52
SK Sturm Gra,1414,2,11,5,8,30,30,0,38
Rapid Vienna,1414,3,9,10,5,38,30,8,37
LASK Linz,1414,4,7,7,10,26,29,-3,28
Mattersburg,1414,5,6,7,11,28,39,-11,25
SC Rheindorf,1414,6,6,6,12,21,29,-8,24
Vienna,1414,7,6,6,12,24,42,-18,24
FC Salzburg,1415,1,15,7,2,45,17,28,52
SK Sturm Gra,1415,2,12,3,9,31,31,0,39
Rapid Vienna,1415,3,9,10,5,37,26,11,37
LASK Linz,1415,4,8,6,10,25,27,-2,30
Vienna,1415,5,7,6,11,26,39,-13,27
SC Rheindorf,1415,6,6,5,13,21,31,-10,23
Mattersburg,1415,7,6,5,13,31,45,-14,23
FC Salzburg,1416,1,15,7,2,49,18,31,52
SK Sturm Gra,1416,2,11,4,9,31,32,-1,37
LASK Linz,1416,3,10,6,8,27,25,2,36
Rapid Vienna,1416,4,7,12,5,35,28,7,33
Vienna,1416,5,7,5,12,27,42,-15,26
Mattersburg,1416,6,6,5,13,29,44,-15,23
SC Rheindorf,1416,7,5,7,12,21,30,-9,22
FC Salzburg,1417,1,15,6,3,45,18,27,51
SK Sturm Gra,1417,2,12,5,7,34,29,5,41
Rapid Vienna,1417,3,8,11,5,34,26,8,35
LASK Linz,1417,4,8,6,10,27,32,-5,30
SC Rheindorf,1417,5,6,6,12,21,30,-9,24
Mattersburg,1417,6,6,6,12,29,39,-10,24
Vienna,1417,7,6,6,12,24,40,-16,24
FC Salzburg,1418,1,13,7,4,46,21,25,46
SK Sturm Gra,1418,2,12,6,6,39,31,8,42
Rapid Vienna,1418,3,10,10,4,37,26,11,40
LASK Linz,1418,4,9,5,10,28,32,-4,32
Mattersburg,1418,5,6,7,11,29,39,-10,25
Vienna,1418,6,6,6,12,24,42,-18,24
SC Rheindorf,1418,7,4,7,13,19,31,-12,19
FC Salzburg,1419,1,13,7,4,42,21,21,46
SK Sturm Gra,1419,2,11,5,8,29,28,1,38
Rapid Vienna,1419,3,9,10,5,39,26,13,37
Mattersburg,1419,4,8,6,10,36,37,-1,30
SC Rheindorf,1419,5,7,6,11,21,28,-7,27
LASK Linz,1419,6,7,6,11,24,33,-9,27
Vienna,1419,7,6,6,12,25,43,-18,24
FC Salzburg,1420,1,14,7,3,42,18,24,49
SK Sturm Gra,1420,2,12,4,8,30,28,2,40
Rapid Vienna,1420,3,9,9,6,36,31,5,36
LASK Linz,1420,4,9,6,9,29,26,3,33
Mattersburg,1420,5,7,5,12,30,40,-10,26
Vienna,1420,6,7,5,12,25,39,-14,26
SC Rheindorf,1420,7,5,6,13,21,31,-10,21
FC Salzburg,1421,1,15,6,3,52,19,33,51
SK Sturm Gra,1421,2,11,6,7,30,27,3,39
Rapid Vienna,1421,3,9,10,5,38,26,12,37
LASK Linz,1421,4,7,7,10,26,33,-7,28
SC Rheindorf,1421,5,6,7,11,23,28,-5,25
Mattersburg,1421,6,6,6,12,32,45,-13,24
Vienna,1421,7,6,6,12,24,47,-23,24
FC Salzburg,1422,1,14,7,3,45,20,25,49
SK Sturm Gra,1422,2,12,4,8,34,33,1,40
Rapid Vienna,1422,3,9,10,5,37,27,10,37
LASK Linz,1422,4,10,5,9,32,31,1,35
Mattersburg,1422,5,6,8,10,33,41,-8,26
Vienna,1422,6,6,6,12,24,40,-16,24
SC Rheindorf,1422,7,4,6,14,19,32,-13,18
FC Salzburg,1423,1,14,7,3,46,19,27,49
SK Sturm Gra,1423,2,14,3,7,37,28,9,45
Rapid Vienna,1423,3,8,10,6,33,26,7,34
LASK Linz,1423,4,9,5,10,29,29,0,32
Mattersburg,1423,5,7,6,11,32,39,-7,27
Vienna,1423,6,7,5,12,24,41,-17,26
SC Rheindorf,1423,7,4,6,14,20,39,-19,18
FC Salzburg,1424,1,15,6,3,44,18,26,51
SK Sturm Gra,1424,2,12,4,8,36,31,5,40
Rapid Vienna,1424,3,7,10,7,37,33,4,31
LASK Linz,1424,4,8,6,10,28,33,-5,30
SC Rheindorf,1424,5,7,6,11,23,29,-6,27
Vienna,1424,6,7,5,12,28,39,-11,26
Mattersburg,1424,7,6,7,11,33,46,-13,25
FC Salzburg,1425,1,14,7,3,43,22,21,49
SK Sturm Gra,1425,2,13,4,7,35,29,6,43
Rapid Vienna,1425,3,8,9,7,33,29,4,33
LASK Linz,1425,4,8,6,10,27,29,-2,30
Mattersburg,1425,5,7,6,11,34,40,-6,27
Vienna,1425,6,7,6,11,30,40,-10,27
SC Rheindorf,1425,7,5,6,13,17,30,-13,21
FC Salzburg,1426,1,15,6,3,46,18,28,51
SK Sturm Gra,1426,2,13,3,8,33,27,6,42
Rapid Vienna,1426,3,9,9,6,34,26,8,36
LASK Linz,1426,4,7,6,11,26,32,-6,27
SC Rheindorf,1426,5,7,5,12,19,28,-9,26
Vienna,1426,6,7,5,12,29,41,-12,26
Mattersburg,1426,7,6,6,12,29,44,-15,24
FC Salzburg,1427,1,16,6,2,49,16,33,54
SK Sturm Gra,1427,2,12,4,8,31,32,-1,40
Rapid Vienna,1427,3,10,9,5,38,27,11,39
LASK Linz,1427,4,8,6,10,26,27,-1,30
Vienna,1427,5,7,5,12,27,40,-13,26
Mattersburg,1427,6,6,5,13,29,44,-15,23
SC Rheindorf,1427,7,4,7,13,16,30,-14,19
FC Salzburg,1428,1,16,6,2,48,16,32,54
SK Sturm Gra,1428,2,13,4,7,32,28,4,43
LASK Linz,1428,3,8,7,9,28,28,0,31
Rapid Vienna,1428,4,7,9,8,32,34,-2,30
Mattersburg,1428,5,7,5,12,32,42,-10,26
SC Rheindorf,1428,6,6,6,12,21,28,-7,24
Vienna,1428,7,6,5,13,24,41,-17,23
FC Salzburg,1429,1,14,8,2,47,19,28,50
SK Sturm Gra,1429,2,11,6,7,32,29,3,39
Rapid Vienna,1429,3,7,10,7,36,39,-3,31
LASK Linz,1429,4,8,6,10,32,29,3,30
SC Rheindorf,1429,5,8,5,11,24,28,-4,29
Mattersburg,1429,6,7,6,11,32,40,-8,27
Vienna,1429,7,6,5,13,24,43,-19,23
FC Salzburg,1430,1,16,6,2,49,18,31,54
SK Sturm Gra,1430,2,12,4,8,30,28,2,40
Rapid Vienna,1430,3,8,10,6,35,28,7,34
LASK Linz,1430,4,9,6,9,30,30,0,33
Mattersburg,1430,5,7,6,11,33,44,-11,27
Vienna,1430,6,6,5,13,25,41,-16,23
SC Rheindorf,1430,7,4,7,13,19,32,-13,19
SK Sturm Gra,1431,1,15,3,6,36,26,10,48
FC Salzburg,1431,2,13,8,3,40,17,23,47
Rapid Vienna,1431,3,7,11,6,34,30,4,32
LASK Linz,1431,4,8,5,11,27,31,-4,29
Vienna,1431,5,7,5,12,26,40,-14,26
Mattersburg,1431,6,6,7,11,30,40,-10,25
SC Rheindorf,1431,7,5,7,12,20,29,-9,22
FC Salzburg,1432,1,15,7,2,47,17,30,52
SK Sturm Gra,1432,2,12,4,8,31,28,3,40
Rapid Vienna,1432,3,9,9,6,36,27,9,36
LASK Linz,1432,4,9,5,10,28,30,-2,32
Vienna,1432,5,7,5,12,27,43,-16,26
Mattersburg,1432,6,6,7,11,32,41,-9,25
SC Rheindorf,1432,7,4,7,13,16,31,-15,19
FC Salzburg,1433,1,15,7,2,50,20,30,52
SK Sturm Gra,1433,2,14,3,7,35,28,7,45
Rapid Vienna,1433,3,7,10,7,33,28,5,31
LASK Linz,1433,4,8,6,10,26,29,-3,30
Vienna,1433,5,7,5,12,24,38,-14,26
SC Rheindorf,1433,6,6,6,12,20,28,-8,24
Mattersburg,1433,7,6,5,13,31,48,-17,23
FC Salzburg,1434,1,15,7,2,44,16,28,52
SK Sturm Gra,1434,2,12,5,7,38,30,8,41
Rapid Vienna,1434,3,8,11,5,35,27,8,35
LASK Linz,1434,4,10,5,9,28,31,-3,35
Vienna,1434,5,7,5,12,27,40,-13,26
Mattersburg,1434,6,6,5,13,30,45,-15,23
SC Rheindorf,1434,7,4,6,14,20,33,-13,18
FC Salzburg,1435,1,15,7,2,43,16,27,52
SK Sturm Gra,1435,2,12,5,7,33,30,3,41
Rapid Vienna,1435,3,8,10,6,36,28,8,34
LASK Linz,1435,4,8,8,8,28,27,1,32
Mattersburg,1435,5,7,6,11,33,41,-8,27
Vienna,1435,6,6,6,12,23,39,-16,24
SC Rheindorf,1435,7,4,6,14,20,35,-15,18
FC Salzburg,1436,1,15,7,2,44,18,26,52
SK Sturm Gra,1436,2,12,5,7,33,29,4,41
Rapid Vienna,1436,3,9,11,4,37,24,13,38
LASK Linz,1436,4,9,6,9,27,30,-3,33
Mattersburg,1436,5,6,6,12,33,41,-8,24
Vienna,1436,6,6,6,12,26,41,-15,24
SC Rheindorf,1436,7,4,5,15,15,32,-17,17
FC Salzburg,1437,1,14,8,2,47,18,29,50
SK Sturm Gra,1437,2,14,3,7,36,32,4,45
Rapid Vienna,1437,3,7,10,7,34,30,4,31
LASK Linz,1437,4,7,7,10,26,29,-3,28
Vienna,1437,5,7,6,11,26,38,-12,27
Mattersburg,1437,6,6,7,11,32,40,-8,25
SC Rheindorf,1437,7,6,5,13,20,34,-14,23
FC Salzburg,1438,1,16,6,2,49,16,33,54
Rapid Vienna,1438,2,10,9,5,38,26,12,39
SK Sturm Gra,1438,3,12,3,9,31,36,-5,39
SC Rheindorf,1438,4,7,5,12,22,27,-5,26
LASK Linz,1438,5,7,5,12,24,32,-8,26
Mattersburg,1438,6,6,6,12,29,41,-12,24
Vienna,1438,7,6,6,12,25,40,-15,24
FC Salzburg,1439,1,16,6,2,49,17,32,54
SK Sturm Gra,1439,2,12,4,8,34,33,1,40
Rapid Vienna,1439,3,10,9,5,38,26,12,39
LASK Linz,1439,4,7,5,12,26,33,-7,26
Mattersburg,1439,5,7,5,12,31,42,-11,26
SC Rheindorf,1439,6,6,6,12,20,29,-9,24
Vienna,1439,7,6,5,13,25,43,-18,23
FC Salzburg,1440,1,16,6,2,46,17,29,54
SK Sturm Gra,1440,2,12,4,8,33,28,5,40
Rapid Vienna,1440,3,8,10,6,36,28,8,34
LASK Linz,1440,4,9,5,10,28,31,-3,32
Mattersburg,1440,5,6,6,12,29,40,-11,24
Vienna,1440,6,6,6,12,24,41,-17,24
SC Rheindorf,1440,7,6,5,13,18,29,-11,23
FC Salzburg,1441,1,15,7,2,48,18,30,52
SK Sturm Gra,1441,2,14,3,7,37,31,6,45
Rapid Vienna,1441,3,8,11,5,38,30,8,35
LASK Linz,1441,4,7,7,10,27,32,-5,28
Mattersburg,1441,5,6,7,11,34,44,-10,25
Vienna,1441,6,6,6,12,26,41,-15,24
SC Rheindorf,1441,7,4,7,13,22,36,-14,19
FC Salzburg,1442,1,13,6,5,42,20,22,45
SK Sturm Gra,1442,2,14,3,7,32,25,7,45
Rapid Vienna,1442,3,9,10,5,36,27,9,37
LASK Linz,1442,4,8,6,10,27,29,-2,30
Mattersburg,1442,5,7,6,11,30,39,-9,27
Vienna,1442,6,7,5,12,25,40,-15,26
SC Rheindorf,1442,7,5,6,13,17,29,-12,21
FC Salzburg,1443,1,14,7,3,44,18,26,49
SK Sturm Gra,1443,2,12,5,7,31,27,4,41
Rapid Vienna,1443,3,8,12,4,34,25,9,36
LASK Linz,1443,4,7,6,11,24,29,-5,27
Mattersburg,1443,5,7,5,12,31,42,-11,26
SC Rheindorf,1443,6,6,7,11,17,25,-8,25
Vienna,1443,7,6,6,12,24,39,-15,24
FC Salzburg,1444,1,15,7,2,48,18,30,52
SK Sturm Gra,1444,2,12,4,8,33,32,1,40
Rapid Vienna,1444,3,9,9,6,35,28,7,36
LASK Linz,1444,4,8,6,10,28,31,-3,30
Mattersburg,1444,5,7,5,12,30,43,-13,26
SC Rheindorf,1444,6,6,6,12,22,28,-6,24
Vienna,1444,7,6,5,13,25,41,-16,23
FC Salzburg,1445,1,15,7,2,47,18,29,52
SK Sturm Gra,1445,2,13,3,8,32,29,3,42
Rapid Vienna,1445,3,8,10,6,34,28,6,34
SC Rheindorf,1445,4,7,6,11,21,27,-6,27
LASK Linz,1445,5,7,5,12,24,30,-6,26
Vienna,1445,6,6,7,11,26,40,-14,25
Mattersburg,1445,7,6,6,12,31,43,-12,24
FC Salzburg,1446,1,13,8,3,42,18,24,47
SK Sturm Gra,1446,2,12,5,7,34,31,3,41
LASK Linz,1446,3,10,6,8,33,29,4,36
Rapid Vienna,1446,4,7,11,6,34,28,6,32
Mattersburg,1446,5,7,6,11,31,42,-11,27
Vienna,1446,6,6,7,11,25,39,-14,25
SC Rheindorf,1446,7,4,7,13,23,35,-12,19
FC Salzburg,1447,1,16,6,2,46,16,30,54
SK Sturm Gra,1447,2,11,4,9,33,32,1,37
Rapid Vienna,1447,3,8,10,6,35,29,6,34
LASK Linz,1447,4,9,5,10,29,30,-1,32
Vienna,1447,5,7,5,12,28,39,-11,26
Mattersburg,1447,6,7,5,12,28,43,-15,26
SC Rheindorf,1447,7,6,5,13,20,30,-10,23
FC Salzburg,1448,1,15,7,2,47,17,30,52
SK Sturm Gra,1448,2,12,6,6,36,30,6,42
Rapid Vienna,1448,3,9,9,6,38,28,10,36
LASK Linz,1448,4,7,6,11,26,31,-5,27
Vienna,1448,5,7,5,12,25,38,-13,26
Mattersburg,1448,6,6,6,12,29,45,-16,24
SC Rheindorf,1448,7,5,7,12,20,32,-12,22
FC Salzburg,1449,1,15,7,2,44,18,26,52
SK Sturm Gra,1449,2,12,5,7,34,30,4,41
LASK Linz,1449,3,10,5,9,30,28,2,35
Rapid Vienna,1449,4,8,10,6,34,26,8,34
Mattersburg,1449,5,8,5,11,32,38,-6,29
Vienna,1449,6,6,5,13,25,41,-16,23
SC Rheindorf,1449,7,4,5,15,17,35,-18,17
FC Salzburg,1450,1,14,8,2,42,16,26,50
SK Sturm Gra,1450,2,13,5,6,34,27,7,44
Rapid Vienna,1450,3,7,11,6,32,26,6,32
LASK Linz,1450,4,7,7,10,24,28,-4,28
Vienna,1450,5,7,6,11,26,37,-11,27
SC Rheindorf,1450,6,6,7,11,20,28,-8,25
Mattersburg,1450,7,5,6,13,29,45,-16,21
FC Salzburg,1451,1,15,6,3,42,17,25,51
SK Sturm Gra,1451,2,13,3,8,33,29,4,42
Rapid Vienna,1451,3,8,11,5,34,26,8,35
LASK Linz,1451,4,7,7,10,26,31,-5,28
Vienna,1451,5,7,5,12,28,38,-10,26
SC Rheindorf,1451,6,6,7,11,19,26,-7,25
Mattersburg,1451,7,6,5,13,30,45,-15,23
FC Salzburg,1452,1,15,6,3,46,19,27,51
SK Sturm Gra,1452,2,12,4,8,35,32,3,40
Rapid Vienna,1452,3,8,10,6,36,32,4,34
LASK Linz,1452,4,8,7,9,32,31,1,31
Vienna,1452,5,7,6,11,28,41,-13,27
Mattersburg,1452,6,6,7,11,34,44,-10,25
SC Rheindorf,1452,7,5,6,13,21,33,-12,21
FC Salzburg,1453,1,15,6,3,44,20,24,51
SK Sturm Gra,1453,2,12,4,8,33,28,5,40
Rapid Vienna,1453,3,8,10,6,36,29,7,34
LASK Linz,1453,4,7,9,8,27,28,-1,30
Vienna,1453,5,7,5,12,26,39,-13,26
SC Rheindorf,1453,6,6,6,12,20,30,-10,24
Mattersburg,1453,7,6,6,12,33,45,-12,24
FC Salzburg,1454,1,15,7,2,48,19,29,52
SK Sturm Gra,1454,2,13,3,8,34,29,5,42
Rapid Vienna,1454,3,8,9,7,33,34,-1,33
LASK Linz,1454,4,9,5,10,31,27,4,32
SC Rheindorf,1454,5,7,5,12,22,29,-7,26
Vienna,1454,6,6,7,11,26,40,-14,25
Mattersburg,1454,7,5,6,13,31,47,-16,21
FC Salzburg,1455,1,14,8,2,46,16,30,50
SK Sturm Gra,1455,2,13,3,8,32,28,4,42
Rapid Vienna,1455,3,9,10,5,35,28,7,37
LASK Linz,1455,4,8,6,10,28,29,-1,30
Mattersburg,1455,5,7,6,11,32,40,-8,27
Vienna,1455,6,7,5,12,25,42,-17,26
SC Rheindorf,1455,7,4,6,14,20,35,-15,18
FC Salzburg,1456,1,15,6,3,44,19,25,51
SK Sturm Gra,1456,2,12,3,9,31,29,2,39
Rapid Vienna,1456,3,9,10,5,36,26,10,37
LASK Linz,1456,4,8,5,11,27,30,-3,29
Mattersburg,1456,5,7,6,11,34,43,-9,27
SC Rheindorf,1456,6,6,6,12,18,28,-10,24
Vienna,1456,7,6,6,12,28,43,-15,24
FC Salzburg,1457,1,15,6,3,50,18,32,51
SK Sturm Gra,1457,2,12,3,9,33,30,3,39
Rapid Vienna,1457,3,8,11,5,33,26,7,35
LASK Linz,1457,4,8,6,10,26,29,-3,30
Vienna,1457,5,8,5,11,27,38,-11,29
SC Rheindorf,1457,6,6,6,12,18,27,-9,24
Mattersburg,1457,7,6,5,13,28,47,-19,23
FC Salzburg,1458,1,15,7,2,50,19,31,52
SK Sturm Gra,1458,2,14,3,7,33,26,7,45
Rapid Vienna,1458,3,8,9,7,37,32,5,33
LASK Linz,1458,4,8,5,11,30,33,-3,29
Mattersburg,1458,5,7,5,12,32,46,-14,26
Vienna,1458,6,6,6,12,27,42,-15,24
SC Rheindorf,1458,7,6,5,13,18,29,-11,23
FC Salzburg,1459,1,15,7,2,46,19,27,52
SK Sturm Gra,1459,2,11,4,9,32,31,1,37
Rapid Vienna,1459,3,8,11,5,35,27,8,35
LASK Linz,1459,4,7,7,10,27,34,-7,28
SC Rheindorf,1459,5,7,6,11,23,29,-6,27
Vienna,1459,6,7,5,12,27,40,-13,26
Mattersburg,1459,7,6,6,12,34,44,-10,24
FC Salzburg,1460,1,15,7,2,46,18,28,52
SK Sturm Gra,1460,2,12,5,7,35,30,5,41
Rapid Vienna,1460,3,8,10,6,35,29,6,34
LASK Linz,1460,4,8,6,10,28,31,-3,30
SC Rheindorf,1460,5,7,5,12,25,32,-7,26
Vienna,1460,6,6,6,12,24,39,-15,24
Mattersburg,1460,7,5,7,12,30,44,-14,22
FC Salzburg,1461,1,15,7,2,45,16,29,52
SK Sturm Gra,1461,2,13,4,7,32,29,3,43
Rapid Vienna,1461,3,8,9,7,36,32,4,33
LASK Linz,1461,4,9,5,10,28,30,-2,32
Vienna,1461,5,7,5,12,24,38,-14,26
Mattersburg,1461,6,6,6,12,32,40,-8,24
SC Rheindorf,1461,7,5,6,13,20,32,-12,21
FC Salzburg,1462,1,14,7,3,46,22,24,49
SK Sturm Gra,1462,2,13,4,7,34,27,7,43
Rapid Vienna,1462,3,8,12,4,36,27,9,36
Vienna,1462,4,8,5,11,28,39,-11,29
LASK Linz,1462,5,7,6,11,24,29,-5,27
Mattersburg,1462,6,6,6,12,30,42,-12,24
SC Rheindorf,1462,7,5,6,13,18,30,-12,21
FC Salzburg,1463,1,15,7,2,48,15,33,52
Rapid Vienna,1463,2,10,10,4,37,26,11,40
SK Sturm Gra,1463,3,11,4,9,29,32,-3,37
LASK Linz,1463,4,7,6,11,24,30,-6,27
SC Rheindorf,1463,5,7,5,12,19,27,-8,26
Mattersburg,1463,6,6,6,12,31,42,-11,24
Vienna,1463,7,6,6,12,25,41,-16,24
FC Salzburg,1464,1,16,6,2,46,16,30,54
SK Sturm Gra,1464,2,13,4,7,32,26,6,43
Rapid Vienna,1464,3,8,10,6,34,28,6,34
LASK Linz,1464,4,8,5,11,28,33,-5,29
Vienna,1464,5,7,5,12,26,40,-14,26
SC Rheindorf,1464,6,6,5,13,20,28,-8,23
Mattersburg,1464,7,6,5,13,31,46,-15,23
FC Salzburg,1465,1,15,6,3,47,17,30,51
Rapid Vienna,1465,2,10,10,4,37,24,13,40
SK Sturm Gra,1465,3,11,5,8,31,29,2,38
LASK Linz,1465,4,9,6,9,28,28,0,33
Mattersburg,1465,5,7,5,12,32,41,-9,26
Vienna,1465,6,6,5,13,24,44,-20,23
SC Rheindorf,1465,7,5,5,14,17,33,-16,20
FC Salzburg,1466,1,14,7,3,49,20,29,49
SK Sturm Gra,1466,2,15,3,6,36,27,9,48
Rapid Vienna,1466,3,8,10,6,33,27,6,34
LASK Linz,1466,4,8,6,10,28,28,0,30
Vienna,1466,5,6,7,11,28,42,-14,25
SC Rheindorf,1466,6,5,7,12,19,29,-10,22
Mattersburg,1466,7,5,6,13,30,50,-20,21
FC Salzburg,1467,1,14,8,2,42,16,26,50
SK Sturm Gra,1467,2,12,4,8,32,29,3,40
Rapid Vienna,1467,3,7,11,6,34,31,3,32
LASK Linz,1467,4,8,6,10,29,31,-2,30
SC Rheindorf,1467,5,7,6,11,27,30,-3,27
Vienna,1467,6,6,7,11,24,38,-14,25
Mattersburg,1467,7,6,6,12,29,42,-13,24
FC Salzburg,1468,1,13,9,2,42,18,24,48
SK Sturm Gra,1468,2,14,4,6,35,25,10,46
LASK Linz,1468,3,9,5,10,28,29,-1,32
Rapid Vienna,1468,4,7,9,8,31,31,0,30
Mattersburg,1468,5,7,6,11,32,41,-9,27
Vienna,1468,6,7,6,11,27,39,-12,27
SC Rheindorf,1468,7,5,5,14,19,31,-12,20
FC Salzburg,1469,1,15,7,2,47,17,30,52
SK Sturm Gra,1469,2,12,4,8,29,29,0,40
Rapid Vienna,1469,3,9,11,4,37,24,13,38
LASK Linz,1469,4,7,5,12,24,33,-9,26
Vienna,1469,5,7,5,12,27,42,-15,26
SC Rheindorf,1469,6,6,6,12,21,29,-8,24
Mattersburg,1469,7,6,6,12,31,42,-11,24
FC Salzburg,1470,1,14,8,2,46,19,27,50
SK Sturm Gra,1470,2,12,3,9,34,34,0,39
Rapid Vienna,1470,3,8,11,5,37,29,8,35
LASK Linz,1470,4,8,5,11,26,30,-4,29
Vienna,1470,5,7,6,11,26,37,-11,27
Mattersburg,1470,6,7,5,12,32,43,-11,26
SC Rheindorf,1470,7,6,6,12,22,31,-9,24
FC Salzburg,1471,1,15,6,3,47,20,27,51
SK Sturm Gra,1471,2,13,4,7,33,30,3,43
Rapid Vienna,1471,3,8,9,7,34,29,5,33
LASK Linz,1471,4,9,6,9,29,29,0,33
Vienna,1471,5,8,5,11,27,38,-11,29
Mattersburg,1471,6,6,6,12,31,42,-11,24
SC Rheindorf,1471,7,4,6,14,16,29,-13,18
FC Salzburg,1472,1,14,8,2,50,21,29,50
SK Sturm Gra,1472,2,12,4,8,30,29,1,40
Rapid Vienna,1472,3,9,11,4,37,26,11,38
LASK Linz,1472,4,7,7,10,27,30,-3,28
Vienna,1472,5,7,5,12,31,45,-14,26
Mattersburg,1472,6,5,8,11,30,44,-14,23
SC Rheindorf,1472,7,5,7,12,18,28,-10,22
FC Salzburg,1473,1,16,6,2,48,16,32,54
SK Sturm Gra,1473,2,11,5,8,33,31,2,38
Rapid Vienna,1473,3,9,9,6,39,29,10,36
LASK Linz,1473,4,7,6,11,27,34,-7,27
Vienna,1473,5,7,5,12,25,41,-16,26
SC Rheindorf,1473,6,6,7,11,24,32,-8,25
Mattersburg,1473,7,6,6,12,32,45,-13,24
FC Salzburg,1474,1,13,8,3,43,20,23,47
SK Sturm Gra,1474,2,14,3,7,31,25,6,45
Rapid Vienna,1474,3,9,10,5,39,27,12,37
LASK Linz,1474,4,9,6,9,28,28,0,33
Mattersburg,1474,5,6,7,11,32,42,-10,25
Vienna,1474,6,6,7,11,24,38,-14,25
SC Rheindorf,1474,7,4,5,15,17,34,-17,17
FC Salzburg,1475,1,14,7,3,47,20,27,49
SK Sturm Gra,1475,2,12,4,8,33,32,1,40
Rapid Vienna,1475,3,8,10,6,34,28,6,34
LASK Linz,1475,4,8,7,9,27,28,-1,31
Mattersburg,1475,5,8,5,11,38,42,-4,29
Vienna,1475,6,7,6,11,27,40,-13,27
SC Rheindorf,1475,7,4,7,13,18,34,-16,19
FC Salzburg,1476,1,14,7,3,43,20,23,49
SK Sturm Gra,1476,2,13,4,7,34,30,4,43
Rapid Vienna,1476,3,8,9,7,35,28,7,33
LASK Linz,1476,4,9,5,10,30,32,-2,32
Mattersburg,1476,5,8,6,10,35,39,-4,30
Vienna,1476,6,6,5,13,24,41,-17,23
SC Rheindorf,1476,7,5,6,13,20,31,-11,21
FC Salzburg,1477,1,15,7,2,48,16,32,52
Rapid Vienna,1477,2,10,10,4,38,27,11,40
SK Sturm Gra,1477,3,11,3,10,30,33,-3,36
LASK Linz,1477,4,8,6,10,27,29,-2,30
SC Rheindorf,1477,5,7,5,12,22,28,-6,26
Vienna,1477,6,7,5,12,25,41,-16,26
Mattersburg,1477,7,5,6,13,29,45,-16,21
FC Salzburg,1478,1,16,6,2,46,17,29,54
SK Sturm Gra,1478,2,13,3,8,32,28,4,42
Rapid Vienna,1478,3,8,10,6,39,32,7,34
LASK Linz,1478,4,8,7,9,31,31,0,31
Mattersburg,1478,5,6,6,12,33,44,-11,24
Vienna,1478,6,6,6,12,25,40,-15,24
SC Rheindorf,1478,7,5,6,13,20,34,-14,21
FC Salzburg,1479,1,15,6,3,44,18,26,51
SK Sturm Gra,1479,2,12,4,8,29,26,3,40
LASK Linz,1479,3,10,6,8,30,26,4,36
Rapid Vienna,1479,4,8,11,5,36,29,7,35
Vienna,1479,5,7,5,12,25,39,-14,26
Mattersburg,1479,6,6,5,13,28,42,-14,23
SC Rheindorf,1479,7,5,5,14,18,30,-12,20
FC Salzburg,1480,1,14,6,4,44,17,27,48
SK Sturm Gra,1480,2,12,4,8,31,31,0,40
LASK Linz,1480,3,9,7,8,28,26,2,34
Rapid Vienna,1480,4,8,9,7,34,28,6,33
Mattersburg,1480,5,8,6,10,31,38,-7,30
SC Rheindorf,1480,6,6,5,13,20,30,-10,23
Vienna,1480,7,6,5,13,23,41,-18,23
FC Salzburg,1481,1,16,6,2,48,18,30,54
SK Sturm Gra,1481,2,13,3,8,33,29,4,42
LASK Linz,1481,3,9,5,10,31,33,-2,32
Rapid Vienna,1481,4,7,10,7,34,31,3,31
Mattersburg,1481,5,8,5,11,36,41,-5,29
Vienna,1481,6,6,5,13,24,42,-18,23
SC Rheindorf,1481,7,5,6,13,18,30,-12,21
FC Salzburg,1482,1,14,8,2,46,16,30,50
SK Sturm Gra,1482,2,12,5,7,32,29,3,41
Rapid Vienna,1482,3,8,11,5,35,26,9,35
LASK Linz,1482,4,8,6,10,26,32,-6,30
Mattersburg,1482,5,7,6,11,34,40,-6,27
Vienna,1482,6,6,6,12,24,40,-16,24
SC Rheindorf,1482,7,5,6,13,18,32,-14,21
FC Salzburg,1483,1,16,6,2,54,16,38,54
SK Sturm Gra,1483,2,13,3,8,30,33,-3,42
Rapid Vienna,1483,3,9,9,6,37,27,10,36
Mattersburg,1483,4,8,5,11,30,41,-11,29
LASK Linz,1483,5,7,5,12,24,29,-5,26
SC Rheindorf,1483,6,6,5,13,20,32,-12,23
Vienna,1483,7,6,5,13,23,40,-17,23
FC Salzburg,1484,1,14,8,2,43,16,27,50
SK Sturm Gra,1484,2,14,4,6,34,25,9,46
Rapid Vienna,1484,3,9,10,5,34,27,7,37
LASK Linz,1484,4,8,6,10,26,28,-2,30
Vienna,1484,5,6,6,12,24,40,-16,24
SC Rheindorf,1484,6,5,6,13,17,28,-11,21
Mattersburg,1484,7,5,6,13,29,43,-14,21
FC Salzburg,1485,1,15,6,3,47,18,29,51
SK Sturm Gra,1485,2,12,5,7,32,30,2,41
Rapid Vienna,1485,3,9,9,6,37,29,8,36
LASK Linz,1485,4,9,6,9,30,32,-2,33
Mattersburg,1485,5,6,7,11,31,39,-8,25
Vienna,1485,6,6,6,12,25,41,-16,24
SC Rheindorf,1485,7,4,7,13,18,31,-13,19
FC Salzburg,1486,1,14,6,4,46,20,26,48
SK Sturm Gra,1486,2,12,4,8,32,31,1,40
Rapid Vienna,1486,3,9,10,5,39,30,9,37
LASK Linz,1486,4,8,6,10,28,30,-2,30
Mattersburg,1486,5,7,6,11,33,41,-8,27
Vienna,1486,6,7,5,12,24,40,-16,26
SC Rheindorf,1486,7,5,7,12,19,29,-10,22
FC Salzburg,1487,1,15,7,2,49,17,32,52
SK Sturm Gra,1487,2,13,5,6,32,26,6,44
Rapid Vienna,1487,3,8,11,5,34,28,6,35
LASK Linz,1487,4,8,5,11,27,32,-5,29
Vienna,1487,5,6,6,12,24,43,-19,24
SC Rheindorf,1487,6,5,7,12,20,28,-8,22
Mattersburg,1487,7,5,7,12,28,40,-12,22
FC Salzburg,1488,1,14,7,3,45,19,26,49
SK Sturm Gra,1488,2,13,4,7,32,28,4,43
Rapid Vienna,1488,3,8,9,7,34,29,5,33
LASK Linz,1488,4,9,5,10,28,28,0,32
Vienna,1488,5,8,5,11,27,38,-11,29
SC Rheindorf,1488,6,6,5,13,20,30,-10,23
Mattersburg,1488,7,6,5,13,29,43,-14,23
FC Salzburg,1489,1,14,7,3,44,18,26,49
SK Sturm Gra,1489,2,12,6,6,35,30,5,42
Rapid Vienna,1489,3,8,10,6,36,31,5,34
LASK Linz,1489,4,8,5,11,28,31,-3,29
Mattersburg,1489,5,7,6,11,31,40,-9,27
Vienna,1489,6,7,6,11,24,37,-13,27
SC Rheindorf,1489,7,5,6,13,20,31,-11,21
FC Salzburg,1490,1,14,6,4,44,20,24,48
SK Sturm Gra,1490,2,14,3,7,34,25,9,45
Rapid Vienna,1490,3,10,9,5,36,27,9,39
LASK Linz,1490,4,8,5,11,27,32,-5,29
Vienna,1490,5,7,5,12,26,40,-14,26
SC Rheindorf,1490,6,6,5,13,17,27,-10,23
Mattersburg,1490,7,6,5,13,32,45,-13,23
FC Salzburg,1491,1,14,7,3,48,21,27,49
SK Sturm Gra,1491,2,13,4,7,33,27,6,43
Rapid Vienna,1491,3,7,10,7,32,30,2,31
LASK Linz,1491,4,7,7,10,25,31,-6,28
Mattersburg,1491,5,7,6,11,39,46,-7,27
Vienna,1491,6,7,5,12,28,42,-14,26
SC Rheindorf,1491,7,6,7,11,20,28,-8,25
FC Salzburg,1492,1,15,6,3,46,19,27,51
SK Sturm Gra,1492,2,14,3,7,36,29,7,45
LASK Linz,1492,3,9,6,9,30,30,0,33
Rapid Vienna,1492,4,7,9,8,34,31,3,30
SC Rheindorf,1492,5,7,5,12,18,26,-8,26
Mattersburg,1492,6,6,6,12,33,44,-11,24
Vienna,1492,7,6,5,13,26,44,-18,23
FC Salzburg,1493,1,13,9,2,45,20,25,48
SK Sturm Gra,1493,2,11,6,7,32,29,3,39
Rapid Vienna,1493,3,9,9,6,34,27,7,36
LASK Linz,1493,4,8,6,10,26,30,-4,30
Mattersburg,1493,5,7,6,11,38,43,-5,27
SC Rheindorf,1493,6,6,6,12,19,27,-8,24
Vienna,1493,7,6,6,12,27,45,-18,24
FC Salzburg,1494,1,14,7,3,49,23,26,49
Rapid Vienna,1494,2,11,9,4,43,27,16,42
SK Sturm Gra,1494,3,12,4,8,33,34,-1,40
SC Rheindorf,1494,4,7,5,12,21,27,-6,26
LASK Linz,1494,5,7,5,12,25,32,-7,26
Mattersburg,1494,6,6,6,12,32,44,-12,24
Vienna,1494,7,6,6,12,25,41,-16,24
FC Salzburg,1495,1,15,7,2,45,17,28,52
SK Sturm Gra,1495,2,13,3,8,35,31,4,42
Rapid Vienna,1495,3,8,9,7,33,29,4,33
LASK Linz,1495,4,8,6,10,26,30,-4,30
Mattersburg,1495,5,7,6,11,39,40,-1,27
Vienna,1495,6,6,6,12,25,43,-18,24
SC Rheindorf,1495,7,6,5,13,19,32,-13,23
FC Salzburg,1496,1,16,6,2,47,16,31,54
SK Sturm Gra,1496,2,13,3,8,31,29,2,42
Rapid Vienna,1496,3,8,9,7,35,29,6,33
LASK Linz,1496,4,8,5,11,25,31,-6,29
SC Rheindorf,1496,5,7,5,12,20,28,-8,26
Vienna,1496,6,7,5,12,26,40,-14,26
Mattersburg,1496,7,6,5,13,32,43,-11,23
FC Salzburg,1497,1,13,7,4,43,20,23,46
SK Sturm Gra,1497,2,12,5,7,34,30,4,41
Rapid Vienna,1497,3,9,11,4,36,26,10,38
LASK Linz,1497,4,7,7,10,25,30,-5,28
Vienna,1497,5,7,6,11,27,38,-11,27
Mattersburg,1497,6,7,5,12,30,41,-11,26
SC Rheindorf,1497,7,5,7,12,20,30,-10,22
FC Salzburg,1498,1,12,9,3,39,17,22,45
SK Sturm Gra,1498,2,11,5,8,31,30,1,38
Rapid Vienna,1498,3,8,12,4,33,24,9,36
LASK Linz,1498,4,8,7,9,28,29,-1,31
Mattersburg,1498,5,6,8,10,31,40,-9,26
Vienna,1498,6,6,7,11,24,38,-14,25
SC Rheindorf,1498,7,5,8,11,21,29,-8,23
FC Salzburg,1499,1,15,7,2,46,19,27,52
SK Sturm Gra,1499,2,13,4,7,33,25,8,43
Rapid Vienna,1499,3,8,10,6,37,29,8,34
LASK Linz,1499,4,8,7,9,29,27,2,31
Mattersburg,1499,5,8,5,11,33,40,-7,29
Vienna,1499,6,6,6,12,25,41,-16,24
SC Rheindorf,1499,7,4,5,15,17,39,-22,17
FC Salzburg,1500,1,13,8,3,43,19,24,47
SK Sturm Gra,1500,2,14,4,6,36,27,9,46
Rapid Vienna,1500,3,7,12,5,34,28,6,33
LASK Linz,1500,4,9,6,9,27,27,0,33
Vienna,1500,5,8,5,11,27,37,-10,29
Mattersburg,1500,6,5,6,13,28,44,-16,21
SC Rheindorf,1500,7,4,7,13,17,30,-13,19
FC Salzburg,1501,1,14,7,3,45,19,26,49
SK Sturm Gra,1501,2,11,4,9,30,34,-4,37
Rapid Vienna,1501,3,8,11,5,35,27,8,35
LASK Linz,1501,4,9,7,8,32,28,4,34
Mattersburg,1501,5,6,8,10,33,41,-8,26
Vienna,1501,6,6,6,12,25,42,-17,24
SC Rheindorf,1501,7,5,7,12,21,30,-9,22
FC Salzburg,1502,1,16,6,2,48,17,31,54
SK Sturm Gra,1502,2,11,5,8,31,34,-3,38
Rapid Vienna,1502,3,8,11,5,40,31,9,35
LASK Linz,1502,4,9,5,10,33,32,1,32
SC Rheindorf,1502,5,6,7,11,22,29,-7,25
Mattersburg,1502,6,6,5,13,28,42,-14,23
Vienna,1502,7,6,5,13,24,41,-17,23
FC Salzburg,1503,1,15,7,2,46,16,30,52
SK Sturm Gra,1503,2,13,5,6,33,26,7,44
Rapid Vienna,1503,3,7,11,6,34,28,6,32
LASK Linz,1503,4,8,7,9,27,30,-3,31
Mattersburg,1503,5,6,6,12,32,43,-11,24
Vienna,1503,6,6,5,13,24,44,-20,23
SC Rheindorf,1503,7,5,7,12,21,30,-9,22
FC Salzburg,1504,1,15,6,3,43,18,25,51
SK Sturm Gra,1504,2,12,3,9,31,29,2,39
Rapid Vienna,1504,3,9,10,5,35,26,9,37
LASK Linz,1504,4,9,5,10,29,29,0,32
SC Rheindorf,1504,5,7,6,11,19,26,-7,27
Vienna,1504,6,7,5,12,28,40,-12,26
Mattersburg,1504,7,5,5,14,28,45,-17,20
FC Salzburg,1505,1,16,6,2,48,17,31,54
SK Sturm Gra,1505,2,12,4,8,34,31,3,40
Rapid Vienna,1505,3,9,10,5,36,29,7,37
LASK Linz,1505,4,7,7,10,29,34,-5,28
Mattersburg,1505,5,7,6,11,35,42,-7,27
Vienna,1505,6,6,5,13,24,42,-18,23
SC Rheindorf,1505,7,4,8,12,18,29,-11,20
FC Salzburg,1506,1,14,6,4,50,20,30,48
SK Sturm Gra,1506,2,12,4,8,34,35,-1,40
Rapid Vienna,1506,3,10,9,5,38,25,13,39
LASK Linz,1506,4,9,7,8,29,28,1,34
Vienna,1506,5,7,6,11,27,40,-13,27
SC Rheindorf,1506,6,5,6,13,20,32,-12,21
Mattersburg,1506,7,5,6,13,28,46,-18,21
FC Salzburg,1507,1,14,8,2,43,17,26,50
SK Sturm Gra,1507,2,13,4,7,34,26,8,43
LASK Linz,1507,3,10,5,9,30,26,4,35
Rapid Vienna,1507,4,8,9,7,37,36,1,33
Mattersburg,1507,5,7,5,12,30,41,-11,26
Vienna,1507,6,6,6,12,25,40,-15,24
SC Rheindorf,1507,7,5,5,14,20,33,-13,20
FC Salzburg,1508,1,16,6,2,50,17,33,54
SK Sturm Gra,1508,2,13,3,8,35,32,3,42
Rapid Vienna,1508,3,8,10,6,33,28,5,34
LASK Linz,1508,4,9,6,9,28,27,1,33
Mattersburg,1508,5,7,5,12,32,45,-13,26
Vienna,1508,6,7,5,12,26,39,-13,26
SC Rheindorf,1508,7,4,5,15,19,35,-16,17
FC Salzburg,1509,1,15,7,2,49,18,31,52
SK Sturm Gra,1509,2,12,5,7,33,32,1,41
Rapid Vienna,1509,3,8,11,5,37,29,8,35
LASK Linz,1509,4,7,7,10,27,31,-4,28
Vienna,1509,5,7,6,11,24,37,-13,27
Mattersburg,1509,6,7,5,12,33,42,-9,26
SC Rheindorf,1509,7,4,7,13,15,29,-14,19
FC Salzburg,1510,1,12,7,5,39,20,19,43
SK Sturm Gra,1510,2,13,3,8,31,26,5,42
Rapid Vienna,1510,3,9,10,5,34,25,9,37
LASK Linz,1510,4,8,6,10,28,32,-4,30
Vienna,1510,5,8,5,11,28,38,-10,29
SC Rheindorf,1510,6,7,5,12,24,27,-3,26
Mattersburg,1510,7,6,6,12,28,44,-16,24
FC Salzburg,1511,1,15,6,3,49,18,31,51
SK Sturm Gra,1511,2,13,3,8,33,29,4,42
Rapid Vienna,1511,3,9,9,6,34,27,7,36
LASK Linz,1511,4,9,5,10,29,27,2,32
Mattersburg,1511,5,8,5,11,32,45,-13,29
Vienna,1511,6,7,5,12,25,38,-13,26
SC Rheindorf,1511,7,4,5,15,16,34,-18,17
FC Salzburg,1512,1,15,7,2,47,21,26,52
SK Sturm Gra,1512,2,14,3,7,33,27,6,45
LASK Linz,1512,3,9,5,10,29,28,1,32
Rapid Vienna,1512,4,7,10,7,34,30,4,31
Mattersburg,1512,5,7,6,11,32,41,-9,27
Vienna,1512,6,6,6,12,25,40,-15,24
SC Rheindorf,1512,7,4,7,13,18,31,-13,19
FC Salzburg,1513,1,15,6,3,44,20,24,51
SK Sturm Gra,1513,2,13,3,8,33,28,5,42
Rapid Vienna,1513,3,8,9,7,38,30,8,33
LASK Linz,1513,4,9,6,9,30,31,-1,33
Vienna,1513,5,8,5,11,28,37,-9,29
Mattersburg,1513,6,6,5,13,32,46,-14,23
SC Rheindorf,1513,7,5,6,13,19,32,-13,21
FC Salzburg,1514,1,15,6,3,49,21,28,51
SK Sturm Gra,1514,2,12,3,9,32,29,3,39
Rapid Vienna,1514,3,9,10,5,42,30,12,37
LASK Linz,1514,4,7,8,9,25,28,-3,29
Vienna,1514,5,7,6,11,26,38,-12,27
SC Rheindorf,1514,6,6,6,12,19,32,-13,24
Mattersburg,1514,7,5,7,12,28,43,-15,22
FC Salzburg,1515,1,16,6,2,49,17,32,54
SK Sturm Gra,1515,2,13,3,8,31,28,3,42
Rapid Vienna,1515,3,9,10,5,37,25,12,37
LASK Linz,1515,4,8,6,10,26,31,-5,30
Mattersburg,1515,5,8,5,11,36,45,-9,29
Vienna,1515,6,6,5,13,25,43,-18,23
SC Rheindorf,1515,7,4,5,15,17,32,-15,17
FC Salzburg,1516,1,15,7,2,44,17,27,52
SK Sturm Gra,1516,2,14,3,7,34,29,5,45
Rapid Vienna,1516,3,8,11,5,35,26,9,35
Mattersburg,1516,4,8,5,11,36,39,-3,29
LASK Linz,1516,5,7,5,12,25,32,-7,26
Vienna,1516,6,6,5,13,23,40,-17,23
SC Rheindorf,1516,7,5,6,13,19,33,-14,21
FC Salzburg,1517,1,14,6,4,45,18,27,48
SK Sturm Gra,1517,2,12,5,7,32,27,5,41
Rapid Vienna,1517,3,9,10,5,36,30,6,37
Mattersburg,1517,4,8,6,10,32,38,-6,30
LASK Linz,1517,5,7,6,11,25,32,-7,27
Vienna,1517,6,6,6,12,24,41,-17,24
SC Rheindorf,1517,7,5,7,12,23,31,-8,22
FC Salzburg,1518,1,15,7,2,48,20,28,52
SK Sturm Gra,1518,2,11,6,7,33,30,3,39
LASK Linz,1518,3,10,6,8,28,24,4,36
Rapid Vienna,1518,4,8,10,6,35,27,8,34
Vienna,1518,5,6,6,12,28,43,-15,24
Mattersburg,1518,6,5,8,11,32,45,-13,23
SC Rheindorf,1518,7,4,7,13,22,37,-15,19
FC Salzburg,1519,1,15,6,3,47,20,27,51
SK Sturm Gra,1519,2,12,4,8,32,29,3,40
LASK Linz,1519,3,9,6,9,28,28,0,33
Rapid Vienna,1519,4,7,9,8,34,33,1,30
Mattersburg,1519,5,7,5,12,33,44,-11,26
Vienna,1519,6,7,5,12,26,41,-15,26
SC Rheindorf,1519,7,6,7,11,23,28,-5,25
FC Salzburg,1520,1,14,6,4,44,22,22,48
SK Sturm Gra,1520,2,13,3,8,34,31,3,42
Rapid Vienna,1520,3,10,9,5,43,30,13,39
Vienna,1520,4,8,5,11,27,37,-10,29
LASK Linz,1520,5,7,6,11,28,33,-5,27
Mattersburg,1520,6,7,5,12,31,40,-9,26
SC Rheindorf,1520,7,5,6,13,20,34,-14,21
FC Salzburg,1521,1,15,6,3,46,17,29,51
SK Sturm Gra,1521,2,13,3,8,31,30,1,42
Rapid Vienna,1521,3,10,9,5,38,25,13,39
LASK Linz,1521,4,8,5,11,25,31,-6,29
Mattersburg,1521,5,7,5,12,31,43,-12,26
Vienna,1521,6,7,5,12,27,41,-14,26
SC Rheindorf,1521,7,5,5,14,18,29,-11,20
FC Salzburg,1522,1,16,6,2,49,19,30,54
SK Sturm Gra,1522,2,13,3,8,33,30,3,42
Rapid Vienna,1522,3,8,9,7,34,29,5,33
LASK Linz,1522,4,8,6,10,25,30,-5,30
Vienna,1522,5,7,5,12,25,39,-14,26
SC Rheindorf,1522,6,6,6,12,20,26,-6,24
Mattersburg,1522,7,6,5,13,29,42,-13,23
FC Salzburg,1523,1,14,7,3,47,21,26,49
SK Sturm Gra,1523,2,13,4,7,34,31,3,43
Rapid Vienna,1523,3,9,9,6,39,30,9,36
LASK Linz,1523,4,8,7,9,30,33,-3,31
Mattersburg,1523,5,7,6,11,34,42,-8,27
Vienna,1523,6,6,7,11,26,40,-14,25
SC Rheindorf,1523,7,4,6,14,21,34,-13,18
FC Salzburg,1524,1,15,6,3,47,17,30,51
SK Sturm Gra,1524,2,13,4,7,34,26,8,43
Rapid Vienna,1524,3,10,9,5,39,30,9,39
LASK Linz,1524,4,7,5,12,28,36,-8,26
SC Rheindorf,1524,5,6,6,12,21,31,-10,24
Mattersburg,1524,6,6,6,12,34,45,-11,24
Vienna,1524,7,6,6,12,25,43,-18,24
FC Salzburg,1525,1,14,8,2,46,19,27,50
SK Sturm Gra,1525,2,13,5,6,35,28,7,44
Rapid Vienna,1525,3,7,11,6,32,27,5,32
LASK Linz,1525,4,9,5,10,27,30,-3,32
Vienna,1525,5,6,7,11,25,39,-14,25
SC Rheindorf,1525,6,6,6,12,20,28,-8,24
Mattersburg,1525,7,5,6,13,30,44,-14,21
FC Salzburg,1526,1,14,8,2,44,16,28,50
SK Sturm Gra,1526,2,11,5,8,31,31,0,38
Rapid Vienna,1526,3,9,9,6,36,29,7,36
LASK Linz,1526,4,8,6,10,26,29,-3,30
Mattersburg,1526,5,7,7,10,31,39,-8,28
Vienna,1526,6,6,6,12,25,40,-15,24
SC Rheindorf,1526,7,6,5,13,21,30,-9,23
FC Salzburg,1527,1,13,8,3,41,17,24,47
SK Sturm Gra,1527,2,13,4,7,35,28,7,43
Rapid Vienna,1527,3,7,13,4,34,26,8,34
LASK Linz,1527,4,8,7,9,27,30,-3,31
Vienna,1527,5,6,7,11,23,37,-14,25
Mattersburg,1527,6,6,6,12,30,41,-11,24
SC Rheindorf,1527,7,5,7,12,18,29,-11,22
FC Salzburg,1528,1,16,6,2,50,21,29,54
SK Sturm Gra,1528,2,12,3,9,31,32,-1,39
Rapid Vienna,1528,3,9,10,5,35,25,10,37
LASK Linz,1528,4,8,5,11,25,30,-5,29
Vienna,1528,5,7,5,12,29,42,-13,26
Mattersburg,1528,6,6,6,12,33,45,-12,24
SC Rheindorf,1528,7,5,7,12,22,30,-8,22
FC Salzburg,1529,1,15,6,3,46,18,28,51
SK Sturm Gra,1529,2,13,3,8,31,29,2,42
LASK Linz,1529,3,9,5,10,27,29,-2,32
Rapid Vienna,1529,4,7,10,7,32,27,5,31
Mattersburg,1529,5,7,5,12,31,40,-9,26
Vienna,1529,6,7,5,12,26,41,-15,26
SC Rheindorf,1529,7,6,6,12,19,28,-9,24
FC Salzburg,1530,1,15,6,3,45,20,25,51
SK Sturm Gra,1530,2,12,3,9,34,32,2,39
Rapid Vienna,1530,3,9,9,6,36,29,7,36
LASK Linz,1530,4,9,6,9,29,28,1,33
Mattersburg,1530,5,7,5,12,34,40,-6,26
SC Rheindorf,1530,6,6,6,12,19,30,-11,24
Vienna,1530,7,6,5,13,24,42,-18,23
FC Salzburg,1531,1,16,6,2,50,17,33,54
Rapid Vienna,1531,2,9,10,5,36,28,8,37
SK Sturm Gra,1531,3,11,3,10,30,32,-2,36
LASK Linz,1531,4,8,7,9,30,31,-1,31
Mattersburg,1531,5,6,7,11,29,40,-11,25
Vienna,1531,6,6,6,12,24,41,-17,24
SC Rheindorf,1531,7,6,5,13,19,29,-10,23
FC Salzburg,1532,1,14,6,4,42,17,25,48
SK Sturm Gra,1532,2,14,3,7,33,26,7,45
Rapid Vienna,1532,3,8,10,6,34,27,7,34
Mattersburg,1532,4,8,5,11,30,39,-9,29
LASK Linz,1532,5,7,7,10,26,30,-4,28
SC Rheindorf,1532,6,6,6,12,19,28,-9,24
Vienna,1532,7,6,5,13,24,41,-17,23
FC Salzburg,1533,1,14,8,2,42,16,26,50
SK Sturm Gra,1533,2,12,5,7,33,30,3,41
Rapid Vienna,1533,3,7,12,5,36,29,7,33
LASK Linz,1533,4,8,6,10,30,33,-3,30
Vienna,1533,5,6,7,11,25,39,-14,25
SC Rheindorf,1533,6,6,6,12,24,30,-6,24
Mattersburg,1533,7,6,6,12,31,44,-13,24
FC Salzburg,1534,1,14,7,3,46,22,24,49
SK Sturm Gra,1534,2,14,4,6,39,29,10,46
LASK Linz,1534,3,10,5,9,29,28,1,35
Rapid Vienna,1534,4,8,9,7,34,31,3,33
Vienna,1534,5,8,5,11,30,41,-11,29
SC Rheindorf,1534,6,5,5,14,20,32,-12,20
Mattersburg,1534,7,5,5,14,31,46,-15,20
FC Salzburg,1535,1,13,9,2,40,16,24,48
SK Sturm Gra,1535,2,12,6,6,34,25,9,42
Rapid Vienna,1535,3,8,11,5,34,30,4,35
LASK Linz,1535,4,8,7,9,26,27,-1,31
Mattersburg,1535,5,7,6,11,32,40,-8,27
Vienna,1535,6,6,7,11,26,40,-14,25
SC Rheindorf,1535,7,4,6,14,17,31,-14,18
FC Salzburg,1536,1,14,7,3,48,19,29,49
SK Sturm Gra,1536,2,13,3,8,33,31,2,42
Rapid Vienna,1536,3,10,10,4,38,26,12,40
LASK Linz,1536,4,8,6,10,25,26,-1,30
Mattersburg,1536,5,7,6,11,31,44,-13,27
Vienna,1536,6,6,6,12,26,41,-15,24
SC Rheindorf,1536,7,4,6,14,19,33,-14,18
FC Salzburg,1537,1,16,6,2,44,15,29,54
SK Sturm Gra,1537,2,13,3,8,32,27,5,42
Rapid Vienna,1537,3,8,9,7,32,26,6,33
LASK Linz,1537,4,9,5,10,27,28,-1,32
Vienna,1537,5,7,5,12,24,40,-16,26
SC Rheindorf,1537,6,6,5,13,22,32,-10,23
Mattersburg,1537,7,6,5,13,30,43,-13,23
FC Salzburg,1538,1,15,7,2,47,19,28,52
SK Sturm Gra,1538,2,11,5,8,30,30,0,38
Rapid Vienna,1538,3,9,9,6,36,27,9,36
LASK Linz,1538,4,8,6,10,27,30,-3,30
Mattersburg,1538,5,6,7,11,32,42,-10,25
SC Rheindorf,1538,6,6,6,12,23,32,-9,24
Vienna,1538,7,6,6,12,25,40,-15,24
FC Salzburg,1539,1,16,6,2,46,17,29,54
SK Sturm Gra,1539,2,12,4,8,32,29,3,40
Rapid Vienna,1539,3,8,10,6,35,28,7,34
LASK Linz,1539,4,9,5,10,27,28,-1,32
Vienna,1539,5,7,5,12,26,40,-14,26
Mattersburg,1539,6,6,5,13,28,42,-14,23
SC Rheindorf,1539,7,5,7,12,20,30,-10,22
FC Salzburg,1540,1,16,6,2,47,16,31,54
SK Sturm Gra,1540,2,14,3,7,38,26,12,45
Rapid Vienna,1540,3,7,10,7,33,32,1,31
LASK Linz,1540,4,8,6,10,28,31,-3,30
Mattersburg,1540,5,7,5,12,33,43,-10,26
Vienna,1540,6,7,5,12,25,41,-16,26
SC Rheindorf,1540,7,5,5,14,16,31,-15,20
FC Salzburg,1541,1,14,8,2,43,17,26,50
SK Sturm Gra,1541,2,13,5,6,36,27,9,44
Rapid Vienna,1541,3,8,11,5,35,29,6,35
LASK Linz,1541,4,8,7,9,29,30,-1,31
Vienna,1541,5,7,5,12,25,39,-14,26
Mattersburg,1541,6,6,6,12,31,41,-10,24
SC Rheindorf,1541,7,4,6,14,17,33,-16,18
FC Salzburg,1542,1,15,7,2,47,19,28,52
SK Sturm Gra,1542,2,12,4,8,34,33,1,40
Rapid Vienna,1542,3,7,12,5,37,30,7,33
LASK Linz,1542,4,8,5,11,28,31,-3,29
Mattersburg,1542,5,8,5,11,33,41,-8,29
SC Rheindorf,1542,6,6,6,12,20,28,-8,24
Vienna,1542,7,6,5,13,24,41,-17,23
FC Salzburg,1543,1,14,7,3,45,18,27,49
SK Sturm Gra,1543,2,12,4,8,31,31,0,40
LASK Linz,1543,3,10,6,8,30,28,2,36
Rapid Vienna,1543,4,8,10,6,36,29,7,34
Vienna,1543,5,7,5,12,24,38,-14,26
Mattersburg,1543,6,6,7,11,30,40,-10,25
SC Rheindorf,1543,7,4,7,13,18,30,-12,19
FC Salzburg,1544,1,13,7,4,41,20,21,46
SK Sturm Gra,1544,2,12,5,7,35,30,5,41
Rapid Vienna,1544,3,9,9,6,37,31,6,36
LASK Linz,1544,4,8,6,10,32,31,1,30
Mattersburg,1544,5,8,5,11,31,40,-9,29
Vienna,1544,6,7,6,11,26,38,-12,27
SC Rheindorf,1544,7,5,6,13,18,30,-12,21
FC Salzburg,1545,1,15,7,2,47,17,30,52
SK Sturm Gra,1545,2,14,3,7,32,27,5,45
LASK Linz,1545,3,9,5,10,30,28,2,32
Rapid Vienna,1545,4,7,9,8,32,32,0,30
Vienna,1545,5,7,6,11,26,39,-13,27
Mattersburg,1545,6,7,5,12,32,42,-10,26
SC Rheindorf,1545,7,5,5,14,19,33,-14,20
FC Salzburg,1546,1,13,8,3,46,20,26,47
SK Sturm Gra,1546,2,13,4,7,30,27,3,43
Rapid Vienna,1546,3,9,10,5,35,26,9,37
LASK Linz,1546,4,10,6,8,30,26,4,36
Vienna,1546,5,7,5,12,26,43,-17,26
Mattersburg,1546,6,5,7,12,33,45,-12,22
SC Rheindorf,1546,7,4,6,14,18,31,-13,18
FC Salzburg,1547,1,15,6,3,46,21,25,51
SK Sturm Gra,1547,2,12,4,8,35,30,5,40
Rapid Vienna,1547,3,8,9,7,33,30,3,33
LASK Linz,1547,4,9,5,10,27,27,0,32
Mattersburg,1547,5,7,5,12,34,43,-9,26
Vienna,1547,6,7,5,12,25,40,-15,26
SC Rheindorf,1547,7,6,6,12,19,28,-9,24
FC Salzburg,1548,1,14,7,3,41,20,21,49
SK Sturm Gra,1548,2,14,3,7,34,28,6,45
LASK Linz,1548,3,9,6,9,27,28,-1,33
Rapid Vienna,1548,4,7,10,7,32,28,4,31
Vienna,1548,5,7,5,12,29,39,-10,26
Mattersburg,1548,6,6,6,12,29,40,-11,24
SC Rheindorf,1548,7,6,5,13,20,29,-9,23
FC Salzburg,1549,1,12,9,3,42,20,22,45
SK Sturm Gra,1549,2,11,5,8,31,29,2,38
Rapid Vienna,1549,3,9,10,5,35,27,8,37
LASK Linz,1549,4,10,6,8,34,28,6,36
Mattersburg,1549,5,7,6,11,32,39,-7,27
Vienna,1549,6,6,6,12,25,42,-17,24
SC Rheindorf,1549,7,5,6,13,18,32,-14,21
FC Salzburg,1550,1,14,8,2,45,18,27,50
SK Sturm Gra,1550,2,12,5,7,32,27,5,41
Rapid Vienna,1550,3,9,10,5,37,27,10,37
LASK Linz,1550,4,9,6,9,28,31,-3,33
Mattersburg,1550,5,7,6,11,37,45,-8,27
Vienna,1550,6,6,5,13,25,41,-16,23
SC Rheindorf,1550,7,4,6,14,20,35,-15,18
FC Salzburg,1551,1,15,7,2,47,21,26,52
SK Sturm Gra,1551,2,13,3,8,32,27,5,42
Rapid Vienna,1551,3,8,9,7,36,30,6,33
LASK Linz,1551,4,9,5,10,28,29,-1,32
SC Rheindorf,1551,5,6,6,12,20,30,-10,24
Mattersburg,1551,6,6,6,12,31,42,-11,24
Vienna,1551,7,6,6,12,25,40,-15,24
FC Salzburg,1552,1,16,6,2,53,19,34,54
SK Sturm Gra,1552,2,13,4,7,32,28,4,43
Rapid Vienna,1552,3,8,9,7,38,30,8,33
LASK Linz,1552,4,8,5,11,27,34,-7,29
Mattersburg,1552,5,7,6,11,33,43,-10,27
Vienna,1552,6,6,6,12,25,43,-18,24
SC Rheindorf,1552,7,5,6,13,17,28,-11,21
FC Salzburg,1553,1,14,8,2,45,17,28,50
SK Sturm Gra,1553,2,12,5,7,31,27,4,41
LASK Linz,1553,3,10,6,8,31,26,5,36
Rapid Vienna,1553,4,7,11,6,33,29,4,32
Vienna,1553,5,7,5,12,26,42,-16,26
SC Rheindorf,1553,6,4,9,11,17,27,-10,21
Mattersburg,1553,7,5,6,13,29,44,-15,21
FC Salzburg,1554,1,14,7,3,47,17,30,49
SK Sturm Gra,1554,2,14,4,6,35,26,9,46
Rapid Vienna,1554,3,8,11,5,36,29,7,35
LASK Linz,1554,4,8,6,10,26,30,-4,30
Vienna,1554,5,7,5,12,26,41,-15,26
Mattersburg,1554,6,6,5,13,29,47,-18,23
SC Rheindorf,1554,7,5,6,13,19,28,-9,21
FC Salzburg,1555,1,13,6,5,44,23,21,45
SK Sturm Gra,1555,2,12,5,7,32,27,5,41
Rapid Vienna,1555,3,9,10,5,36,26,10,37
LASK Linz,1555,4,8,6,10,29,31,-2,30
Vienna,1555,5,8,5,11,29,41,-12,29
Mattersburg,1555,6,7,6,11,32,41,-9,27
SC Rheindorf,1555,7,5,6,13,18,31,-13,21
FC Salzburg,1556,1,14,8,2,47,17,30,50
SK Sturm Gra,1556,2,13,3,8,33,33,0,42
Rapid Vienna,1556,3,8,11,5,35,27,8,35
LASK Linz,1556,4,8,8,8,25,25,0,32
Vienna,1556,5,6,7,11,26,40,-14,25
Mattersburg,1556,6,5,8,11,31,42,-11,23
SC Rheindorf,1556,7,4,7,13,16,29,-13,19
FC Salzburg,1557,1,15,7,2,49,21,28,52
SK Sturm Gra,1557,2,14,3,7,35,27,8,45
Rapid Vienna,1557,3,7,11,6,34,30,4,32
LASK Linz,1557,4,7,6,11,25,30,-5,27
Vienna,1557,5,7,5,12,31,42,-11,26
Mattersburg,1557,6,6,7,11,33,46,-13,25
SC Rheindorf,1557,7,5,7,12,19,30,-11,22
FC Salzburg,1558,1,16,6,2,49,16,33,54
Rapid Vienna,1558,2,10,9,5,39,27,12,39
SK Sturm Gra,1558,3,12,3,9,30,31,-1,39
LASK Linz,1558,4,8,5,11,26,32,-6,29
SC Rheindorf,1558,5,6,6,12,21,28,-7,24
Vienna,1558,6,6,6,12,26,45,-19,24
Mattersburg,1558,7,5,7,12,28,40,-12,22
FC Salzburg,1559,1,15,6,3,46,20,26,51
SK Sturm Gra,1559,2,14,3,7,36,30,6,45
Rapid Vienna,1559,3,10,9,5,38,27,11,39
LASK Linz,1559,4,8,6,10,29,31,-2,30
Mattersburg,1559,5,6,7,11,33,44,-11,25
Vienna,1559,6,6,6,12,25,41,-16,24
SC Rheindorf,1559,7,4,5,15,18,32,-14,17
FC Salzburg,1560,1,16,6,2,49,18,31,54
SK Sturm Gra,1560,2,13,3,8,32,29,3,42
Rapid Vienna,1560,3,9,9,6,35,26,9,36
Mattersburg,1560,4,7,6,11,34,44,-10,27
LASK Linz,1560,5,7,5,12,26,31,-5,26
Vienna,1560,6,6,6,12,26,43,-17,24
SC Rheindorf,1560,7,6,5,13,18,29,-11,23
FC Salzburg,1561,1,15,6,3,45,18,27,51
SK Sturm Gra,1561,2,11,4,9,30,30,0,37
Rapid Vienna,1561,3,9,9,6,40,31,9,36
LASK Linz,1561,4,9,7,8,30,29,1,34
Vienna,1561,5,7,5,12,28,41,-13,26
SC Rheindorf,1561,6,6,6,12,23,32,-9,24
Mattersburg,1561,7,5,7,12,32,47,-15,22
FC Salzburg,1562,1,15,7,2,49,22,27,52
SK Sturm Gra,1562,2,12,4,8,32,29,3,40
Rapid Vienna,1562,3,8,10,6,38,31,7,34
LASK Linz,1562,4,8,6,10,27,31,-4,30
Mattersburg,1562,5,7,6,11,40,48,-8,27
Vienna,1562,6,6,7,11,28,42,-14,25
SC Rheindorf,1562,7,4,8,12,20,31,-11,20
FC Salzburg,1563,1,14,7,3,46,18,28,49
SK Sturm Gra,1563,2,13,3,8,34,32,2,42
Rapid Vienna,1563,3,10,9,5,37,27,10,39
LASK Linz,1563,4,8,6,10,27,30,-3,30
Vienna,1563,5,7,6,11,26,39,-13,27
Mattersburg,1563,6,6,5,13,33,44,-11,23
SC Rheindorf,1563,7,5,6,13,18,31,-13,21
FC Salzburg,1564,1,15,7,2,45,17,28,52
SK Sturm Gra,1564,2,13,4,7,34,30,4,43
Rapid Vienna,1564,3,9,10,5,34,26,8,37
LASK Linz,1564,4,7,6,11,26,30,-4,27
Vienna,1564,5,7,6,11,25,38,-13,27
SC Rheindorf,1564,6,6,5,13,21,30,-9,23
Mattersburg,1564,7,5,6,13,28,42,-14,21
FC Salzburg,1565,1,13,9,2,43,18,25,48
SK Sturm Gra,1565,2,12,5,7,30,26,4,41
Rapid Vienna,1565,3,9,10,5,36,26,10,37
LASK Linz,1565,4,10,5,9,30,26,4,35
Vienna,1565,5,6,6,12,26,42,-16,24
Mattersburg,1565,6,6,5,13,30,42,-12,23
SC Rheindorf,1565,7,5,6,13,17,32,-15,21
FC Salzburg,1566,1,13,9,2,49,20,29,48
SK Sturm Gra,1566,2,12,5,7,32,27,5,41
Rapid Vienna,1566,3,8,11,5,33,27,6,35
LASK Linz,1566,4,8,5,11,30,33,-3,29
Vienna,1566,5,7,6,11,28,41,-13,27
SC Rheindorf,1566,6,6,6,12,19,28,-9,24
Mattersburg,1566,7,6,6,12,32,47,-15,24
FC Salzburg,1567,1,14,6,4,42,18,24,48
SK Sturm Gra,1567,2,14,4,6,34,25,9,46
Rapid Vienna,1567,3,8,9,7,36,28,8,33
LASK Linz,1567,4,8,5,11,26,30,-4,29
Mattersburg,1567,5,7,6,11,29,40,-11,27
Vienna,1567,6,7,6,11,24,37,-13,27
SC Rheindorf,1567,7,5,6,13,19,32,-13,21
FC Salzburg,1568,1,15,6,3,44,19,25,51
SK Sturm Gra,1568,2,13,4,7,36,29,7,43
Rapid Vienna,1568,3,8,9,7,34,29,5,33
LASK Linz,1568,4,9,6,9,28,29,-1,33
Vienna,1568,5,7,5,12,25,39,-14,26
Mattersburg,1568,6,6,5,13,31,40,-9,23
SC Rheindorf,1568,7,6,5,13,21,34,-13,23
FC Salzburg,1569,1,13,7,4,42,20,22,46
Rapid Vienna,1569,2,11,9,4,41,25,16,42
SK Sturm Gra,1569,3,12,4,8,33,28,5,40
LASK Linz,1569,4,8,5,11,26,30,-4,29
Mattersburg,1569,5,6,7,11,29,41,-12,25
Vienna,1569,6,6,7,11,25,39,-14,25
SC Rheindorf,1569,7,5,7,12,17,30,-13,22
FC Salzburg,1570,1,14,8,2,44,19,25,50
SK Sturm Gra,1570,2,13,4,7,32,27,5,43
LASK Linz,1570,3,11,5,8,31,27,4,38
Rapid Vienna,1570,4,7,10,7,34,29,5,31
Vienna,1570,5,6,6,12,24,39,-15,24
Mattersburg,1570,6,5,7,12,29,41,-12,22
SC Rheindorf,1570,7,5,6,13,17,29,-12,21
FC Salzburg,1571,1,13,8,3,42,19,23,47
SK Sturm Gra,1571,2,11,6,7,30,27,3,39
Rapid Vienna,1571,3,9,11,4,35,24,11,38
LASK Linz,1571,4,8,7,9,27,28,-1,31
Mattersburg,1571,5,6,7,11,28,38,-10,25
Vienna,1571,6,6,6,12,26,41,-15,24
SC Rheindorf,1571,7,5,7,12,19,30,-11,22
FC Salzburg,1572,1,15,7,2,44,16,28,52
SK Sturm Gra,1572,2,11,5,8,29,30,-1,38
Rapid Vienna,1572,3,8,9,7,35,28,7,33
LASK Linz,1572,4,8,7,9,27,27,0,31
SC Rheindorf,1572,5,7,5,12,23,32,-9,26
Vienna,1572,6,7,5,12,26,40,-14,26
Mattersburg,1572,7,6,6,12,32,43,-11,24
FC Salzburg,1573,1,14,8,2,46,19,27,50
SK Sturm Gra,1573,2,12,3,9,30,31,-1,39
Rapid Vienna,1573,3,9,10,5,37,26,11,37
LASK Linz,1573,4,9,6,9,29,29,0,33
Vienna,1573,5,7,6,11,28,40,-12,27
Mattersburg,1573,6,6,5,13,32,45,-13,23
SC Rheindorf,1573,7,5,6,13,18,30,-12,21
FC Salzburg,1574,1,13,9,2,42,18,24,48
SK Sturm Gra,1574,2,12,5,7,33,30,3,41
Rapid Vienna,1574,3,7,12,5,33,28,5,33
LASK Linz,1574,4,9,5,10,30,31,-1,32
Mattersburg,1574,5,7,6,11,32,40,-8,27
Vienna,1574,6,6,7,11,26,40,-14,25
SC Rheindorf,1574,7,5,6,13,21,30,-9,21
FC Salzburg,1575,1,14,7,3,43,19,24,49
SK Sturm Gra,1575,2,11,5,8,30,30,0,38
Rapid Vienna,1575,3,8,10,6,36,28,8,34
LASK Linz,1575,4,9,5,10,28,29,-1,32
Vienna,1575,5,8,5,11,29,38,-9,29
SC Rheindorf,1575,6,6,6,12,20,29,-9,24
Mattersburg,1575,7,6,6,12,30,43,-13,24
FC Salzburg,1576,1,15,7,2,45,17,28,52
SK Sturm Gra,1576,2,12,5,7,32,28,4,41
LASK Linz,1576,3,9,6,9,28,28,0,33
Rapid Vienna,1576,4,7,11,6,33,27,6,32
SC Rheindorf,1576,5,6,6,12,19,28,-9,24
Vienna,1576,6,6,6,12,24,41,-17,24
Mattersburg,1576,7,5,7,12,28,40,-12,22
FC Salzburg,1577,1,15,6,3,45,18,27,51
SK Sturm Gra,1577,2,13,5,6,33,26,7,44
Rapid Vienna,1577,3,8,11,5,37,28,9,35
LASK Linz,1577,4,8,6,10,27,31,-4,30
Mattersburg,1577,5,8,5,11,35,40,-5,29
Vienna,1577,6,6,5,13,23,43,-20,23
SC Rheindorf,1577,7,4,6,14,18,32,-14,18
FC Salzburg,1578,1,13,6,5,42,19,23,45
SK Sturm Gra,1578,2,13,4,7,31,27,4,43
Rapid Vienna,1578,3,10,10,4,37,24,13,40
LASK Linz,1578,4,9,5,10,31,30,1,32
Mattersburg,1578,5,7,6,11,33,41,-8,27
Vienna,1578,6,6,5,13,24,43,-19,23
SC Rheindorf,1578,7,5,6,13,19,33,-14,21
FC Salzburg,1579,1,14,6,4,45,21,24,48
SK Sturm Gra,1579,2,14,3,7,36,30,6,45
Rapid Vienna,1579,3,10,9,5,37,25,12,39
LASK Linz,1579,4,7,7,10,27,32,-5,28
Mattersburg,1579,5,7,6,11,32,42,-10,27
Vienna,1579,6,6,5,13,26,42,-16,23
SC Rheindorf,1579,7,5,6,13,20,31,-11,21
FC Salzburg,1580,1,16,6,2,44,16,28,54
SK Sturm Gra,1580,2,12,4,8,31,28,3,40
Rapid Vienna,1580,3,10,9,5,39,28,11,39
LASK Linz,1580,4,7,6,11,29,33,-4,27
Vienna,1580,5,7,5,12,25,40,-15,26
SC Rheindorf,1580,6,5,7,12,18,29,-11,22
Mattersburg,1580,7,5,7,12,30,42,-12,22
FC Salzburg,1581,1,14,6,4,44,21,23,48
SK Sturm Gra,1581,2,11,6,7,33,30,3,39
LASK Linz,1581,3,10,6,8,29,25,4,36
Rapid Vienna,1581,4,8,11,5,36,28,8,35
Mattersburg,1581,5,7,6,11,32,40,-8,27
Vienna,1581,6,6,5,13,23,42,-19,23
SC Rheindorf,1581,7,4,8,12,19,30,-11,20
FC Salzburg,1582,1,15,7,2,45,16,29,52
SK Sturm Gra,1582,2,11,5,8,30,28,2,38
Rapid Vienna,1582,3,9,9,6,33,27,6,36
LASK Linz,1582,4,9,6,9,28,29,-1,33
Vienna,1582,5,6,6,12,24,40,-16,24
Mattersburg,1582,6,5,8,11,29,42,-13,23
SC Rheindorf,1582,7,5,7,12,21,28,-7,22
FC Salzburg,1583,1,14,7,3,50,19,31,49
SK Sturm Gra,1583,2,12,3,9,31,33,-2,39
Rapid Vienna,1583,3,9,11,4,37,27,10,38
LASK Linz,1583,4,9,6,9,29,28,1,33
Vienna,1583,5,7,6,11,26,39,-13,27
Mattersburg,1583,6,6,6,12,28,44,-16,24
SC Rheindorf,1583,7,5,5,14,17,28,-11,20
FC Salzburg,1584,1,14,8,2,45,18,27,50
SK Sturm Gra,1584,2,12,4,8,30,27,3,40
Rapid Vienna,1584,3,7,12,5,34,27,7,33
LASK Linz,1584,4,9,5,10,30,33,-3,32
Vienna,1584,5,7,5,12,26,41,-15,26
SC Rheindorf,1584,6,6,6,12,22,29,-7,24
Mattersburg,1584,7,6,6,12,31,43,-12,24
FC Salzburg,1585,1,14,7,3,42,19,23,49
SK Sturm Gra,1585,2,14,3,7,40,29,11,45
Rapid Vienna,1585,3,9,9,6,37,29,8,36
LASK Linz,1585,4,9,6,9,33,34,-1,33
Mattersburg,1585,5,5,9,10,29,39,-10,24
Vienna,1585,6,6,6,12,24,39,-15,24
SC Rheindorf,1585,7,4,6,14,16,32,-16,18
FC Salzburg,1586,1,13,8,3,45,19,26,47
Rapid Vienna,1586,2,10,10,4,40,28,12,40
SK Sturm Gra,1586,3,11,6,7,31,28,3,39
LASK Linz,1586,4,7,7,10,27,30,-3,28
Vienna,1586,5,7,5,12,26,43,-17,26
Mattersburg,1586,6,6,7,11,31,42,-11,25
SC Rheindorf,1586,7,5,7,12,19,29,-10,22
FC Salzburg,1587,1,15,6,3,47,18,29,51
SK Sturm Gra,1587,2,13,4,7,34,26,8,43
Rapid Vienna,1587,3,9,9,6,36,31,5,36
LASK Linz,1587,4,7,7,10,24,27,-3,28
Mattersburg,1587,5,7,5,12,30,43,-13,26
Vienna,1587,6,7,5,12,26,40,-14,26
SC Rheindorf,1587,7,5,6,13,17,29,-12,21
FC Salzburg,1588,1,16,6,2,49,15,34,54
SK Sturm Gra,1588,2,11,6,7,33,33,0,39
Rapid Vienna,1588,3,8,11,5,35,28,7,35
LASK Linz,1588,4,7,8,9,29,32,-3,29
Mattersburg,1588,5,8,5,11,33,41,-8,29
Vienna,1588,6,6,5,13,23,40,-17,23
SC Rheindorf,1588,7,4,7,13,19,32,-13,19
FC Salzburg,1589,1,15,7,2,48,17,31,52
SK Sturm Gra,1589,2,13,4,7,35,31,4,43
LASK Linz,1589,3,9,7,8,33,29,4,34
Rapid Vienna,1589,4,8,9,7,32,28,4,33
Mattersburg,1589,5,6,6,12,31,46,-15,24
Vienna,1589,6,6,5,13,24,42,-18,23
SC Rheindorf,1589,7,5,6,13,21,31,-10,21
FC Salzburg,1590,1,15,6,3,46,19,27,51
SK Sturm Gra,1590,2,13,3,8,34,28,6,42
LASK Linz,1590,3,11,5,8,30,27,3,38
Rapid Vienna,1590,4,8,10,6,35,28,7,34
Vienna,1590,5,6,6,12,24,39,-15,24
Mattersburg,1590,6,5,7,12,30,45,-15,22
SC Rheindorf,1590,7,4,7,13,19,32,-13,19
FC Salzburg,1591,1,15,7,2,47,20,27,52
SK Sturm Gra,1591,2,12,3,9,32,30,2,39
Rapid Vienna,1591,3,9,10,5,36,27,9,37
LASK Linz,1591,4,9,5,10,29,31,-2,32
Mattersburg,1591,5,7,6,11,32,42,-10,27
Vienna,1591,6,6,6,12,28,43,-15,24
SC Rheindorf,1591,7,5,5,14,17,28,-11,20
FC Salzburg,1592,1,14,7,3,47,17,30,49
SK Sturm Gra,1592,2,14,3,7,33,27,6,45
Rapid Vienna,1592,3,9,9,6,36,28,8,36
LASK Linz,1592,4,7,6,11,27,33,-6,27
Mattersburg,1592,5,6,7,11,31,44,-13,25
Vienna,1592,6,6,7,11,23,37,-14,25
SC Rheindorf,1592,7,6,5,13,21,32,-11,23
FC Salzburg,1593,1,14,7,3,41,17,24,49
SK Sturm Gra,1593,2,13,3,8,34,27,7,42
Rapid Vienna,1593,3,8,10,6,34,27,7,34
Mattersburg,1593,4,8,5,11,34,40,-6,29
LASK Linz,1593,5,8,5,11,27,35,-8,29
Vienna,1593,6,7,5,12,25,38,-13,26
SC Rheindorf,1593,7,6,5,13,17,28,-11,23
FC Salzburg,1594,1,14,7,3,52,24,28,49
SK Sturm Gra,1594,2,11,5,8,34,32,2,38
Rapid Vienna,1594,3,8,10,6,38,30,8,34
LASK Linz,1594,4,9,6,9,30,30,0,33
SC Rheindorf,1594,5,7,6,11,22,27,-5,27
Vienna,1594,6,6,6,12,25,44,-19,24
Mattersburg,1594,7,5,8,11,31,45,-14,23
FC Salzburg,1595,1,15,6,3,46,18,28,51
SK Sturm Gra,1595,2,12,3,9,31,30,1,39
Rapid Vienna,1595,3,9,9,6,36,28,8,36
LASK Linz,1595,4,9,6,9,29,29,0,33
SC Rheindorf,1595,5,6,6,12,21,29,-8,24
Mattersburg,1595,6,6,6,12,28,41,-13,24
Vienna,1595,7,6,6,12,24,40,-16,24
FC Salzburg,1596,1,14,6,4,46,22,24,48
SK Sturm Gra,1596,2,13,3,8,35,27,8,42
Rapid Vienna,1596,3,9,11,4,35,24,11,38
Mattersburg,1596,4,8,6,10,34,41,-7,30
LASK Linz,1596,5,7,7,10,24,31,-7,28
Vienna,1596,6,6,5,13,23,40,-17,23
SC Rheindorf,1596,7,5,6,13,18,30,-12,21
FC Salzburg,1597,1,15,7,2,43,16,27,52
Rapid Vienna,1597,2,10,9,5,39,27,12,39
SK Sturm Gra,1597,3,11,3,10,30,34,-4,36
LASK Linz,1597,4,9,5,10,28,29,-1,32
Vienna,1597,5,7,6,11,27,38,-11,27
SC Rheindorf,1597,6,6,5,13,22,31,-9,23
Mattersburg,1597,7,6,5,13,28,42,-14,23
FC Salzburg,1598,1,15,7,2,49,18,31,52
SK Sturm Gra,1598,2,12,4,8,31,27,4,40
Rapid Vienna,1598,3,8,10,6,38,32,6,34
LASK Linz,1598,4,7,7,10,27,30,-3,28
Mattersburg,1598,5,7,6,11,33,40,-7,27
Vienna,1598,6,7,5,12,25,42,-17,26
SC Rheindorf,1598,7,6,5,13,21,35,-14,23
FC Salzburg,1599,1,15,6,3,46,17,29,51
SK Sturm Gra,1599,2,12,4,8,30,30,0,40
Rapid Vienna,1599,3,8,10,6,34,30,4,34
LASK Linz,1599,4,9,6,9,27,25,2,33
Vienna,1599,5,8,5,11,27,38,-11,29
Mattersburg,1599,6,6,6,12,29,41,-12,24
SC Rheindorf,1599,7,5,5,14,21,33,-12,20
FC Salzburg,1600,1,13,9,2,44,19,25,48
SK Sturm Gra,1600,2,12,4,8,32,31,1,40
Rapid Vienna,1600,3,9,10,5,38,28,10,37
LASK Linz,1600,4,8,5,11,28,32,-4,29
SC Rheindorf,1600,5,7,6,11,25,30,-5,27
Vienna,1600,6,7,6,11,27,39,-12,27
Mattersburg,1600,7,5,6,13,31,46,-15,21
FC Salzburg,1601,1,15,7,2,51,17,34,52
SK Sturm Gra,1601,2,12,5,7,32,27,5,41
LASK Linz,1601,3,8,8,8,28,27,1,32
Rapid Vienna,1601,4,7,10,7,33,30,3,31
Vienna,1601,5,7,5,12,25,43,-18,26
Mattersburg,1601,6,6,6,12,33,47,-14,24
SC Rheindorf,1601,7,5,7,12,20,31,-11,22
FC Salzburg,1602,1,16,6,2,50,20,30,54
SK Sturm Gra,1602,2,11,4,9,31,31,0,37
Rapid Vienna,1602,3,8,10,6,36,31,5,34
LASK Linz,1602,4,9,6,9,27,28,-1,33
Mattersburg,1602,5,7,6,11,35,41,-6,27
Vienna,1602,6,6,6,12,26,43,-17,24
SC Rheindorf,1602,7,5,6,13,23,34,-11,21
FC Salzburg,1603,1,15,7,2,47,17,30,52
SK Sturm Gra,1603,2,11,7,6,34,30,4,40
LASK Linz,1603,3,9,6,9,31,29,2,33
Rapid Vienna,1603,4,7,11,6,36,31,5,32
Mattersburg,1603,5,7,5,12,32,43,-11,26
Vienna,1603,6,7,5,12,25,40,-15,26
SC Rheindorf,1603,7,4,7,13,18,33,-15,19
FC Salzburg,1604,1,15,7,2,46,17,29,52
SK Sturm Gra,1604,2,12,3,9,30,28,2,39
Rapid Vienna,1604,3,8,10,6,35,29,6,34
LASK Linz,1604,4,9,6,9,28,28,0,33
SC Rheindorf,1604,5,7,5,12,21,29,-8,26
Mattersburg,1604,6,6,6,12,31,41,-10,24
Vienna,1604,7,6,5,13,24,43,-19,23
FC Salzburg,1605,1,14,6,4,44,18,26,48
SK Sturm Gra,1605,2,13,5,6,35,28,7,44
Rapid Vienna,1605,3,9,10,5,39,30,9,37
LASK Linz,1605,4,7,7,10,27,32,-5,28
Mattersburg,1605,5,7,6,11,35,41,-6,27
Vienna,1605,6,6,6,12,24,40,-16,24
SC Rheindorf,1605,7,5,6,13,18,33,-15,21
FC Salzburg,1606,1,15,6,3,49,18,31,51
Rapid Vienna,1606,2,11,9,4,40,25,15,42
SK Sturm Gra,1606,3,12,3,9,36,32,4,39
LASK Linz,1606,4,9,5,10,26,33,-7,32
Mattersburg,1606,5,7,5,12,32,41,-9,26
Vienna,1606,6,6,5,13,24,42,-18,23
SC Rheindorf,1606,7,5,5,14,18,34,-16,20
FC Salzburg,1607,1,14,6,4,43,21,22,48
SK Sturm Gra,1607,2,11,6,7,31,29,2,39
Rapid Vienna,1607,3,9,11,4,37,27,10,38
LASK Linz,1607,4,8,8,8,28,28,0,32
Vienna,1607,5,8,5,11,28,38,-10,29
SC Rheindorf,1607,6,5,6,13,20,30,-10,21
Mattersburg,1607,7,5,6,13,29,43,-14,21
FC Salzburg,1608,1,14,6,4,44,20,24,48
SK Sturm Gra,1608,2,12,4,8,33,29,4,40
Rapid Vienna,1608,3,8,10,6,32,25,7,34
LASK Linz,1608,4,9,5,10,26,30,-4,32
Mattersburg,1608,5,8,5,11,33,41,-8,29
SC Rheindorf,1608,6,7,5,12,23,29,-6,26
Vienna,1608,7,6,5,13,23,40,-17,23
FC Salzburg,1609,1,12,9,3,41,21,20,45
SK Sturm Gra,1609,2,12,5,7,31,28,3,41
Rapid Vienna,1609,3,9,11,4,38,25,13,38
LASK Linz,1609,4,9,6,9,30,28,2,33
Mattersburg,1609,5,6,6,12,31,44,-13,24
Vienna,1609,6,6,6,12,24,40,-16,24
SC Rheindorf,1609,7,5,7,12,20,29,-9,22
FC Salzburg,1610,1,15,6,3,44,19,25,51
Rapid Vienna,1610,2,9,11,4,37,26,11,38
SK Sturm Gra,1610,3,11,5,8,31,29,2,38
LASK Linz,1610,4,8,7,9,29,32,-3,31
Mattersburg,1610,5,7,5,12,37,45,-8,26
Vienna,1610,6,6,5,13,25,42,-17,23
SC Rheindorf,1610,7,5,7,12,20,30,-10,22
FC Salzburg,1611,1,14,7,3,44,20,24,49
SK Sturm Gra,1611,2,13,3,8,35,28,7,42
Rapid Vienna,1611,3,9,10,5,35,29,6,37
LASK Linz,1611,4,8,6,10,25,28,-3,30
Mattersburg,1611,5,8,5,11,33,40,-7,29
Vienna,1611,6,7,5,12,26,40,-14,26
SC Rheindorf,1611,7,4,6,14,17,30,-13,18
FC Salzburg,1612,1,13,8,3,43,20,23,47
SK Sturm Gra,1612,2,12,4,8,31,27,4,40
Rapid Vienna,1612,3,8,9,7,32,28,4,33
Mattersburg,1612,4,8,6,10,35,38,-3,30
LASK Linz,1612,5,8,5,11,25,30,-5,29
SC Rheindorf,1612,6,7,5,12,21,29,-8,26
Vienna,1612,7,7,5,12,25,40,-15,26
SK Sturm Gra,1613,1,14,3,7,33,27,6,45
FC Salzburg,1613,2,12,7,5,39,19,20,43
Rapid Vienna,1613,3,9,9,6,39,30,9,36
LASK Linz,1613,4,8,5,11,26,29,-3,29
Mattersburg,1613,5,7,6,11,29,38,-9,27
SC Rheindorf,1613,6,7,5,12,19,28,-9,26
Vienna,1613,7,6,7,11,25,39,-14,25
FC Salzburg,1614,1,14,6,4,44,22,22,48
SK Sturm Gra,1614,2,12,5,7,35,31,4,41
Rapid Vienna,1614,3,8,11,5,37,29,8,35
LASK Linz,1614,4,9,7,8,28,26,2,34
Vienna,1614,5,7,5,12,26,41,-15,26
Mattersburg,1614,6,6,5,13,29,42,-13,23
SC Rheindorf,1614,7,5,7,12,22,30,-8,22
FC Salzburg,1615,1,15,6,3,43,17,26,51
SK Sturm Gra,1615,2,13,3,8,30,27,3,42
Rapid Vienna,1615,3,9,10,5,36,27,9,37
LASK Linz,1615,4,9,6,9,27,27,0,33
Mattersburg,1615,5,7,5,12,32,40,-8,26
Vienna,1615,6,7,5,12,24,38,-14,26
SC Rheindorf,1615,7,4,5,15,18,34,-16,17
FC Salzburg,1616,1,14,8,2,43,16,27,50
SK Sturm Gra,1616,2,11,7,6,31,27,4,40
Rapid Vienna,1616,3,7,11,6,35,31,4,32
LASK Linz,1616,4,8,7,9,27,26,1,31
Mattersburg,1616,5,6,8,10,31,40,-9,26
SC Rheindorf,1616,6,5,8,11,18,27,-9,23
Vienna,1616,7,6,5,13,24,42,-18,23
FC Salzburg,1617,1,16,6,2,47,18,29,54
SK Sturm Gra,1617,2,14,3,7,31,26,5,45
Rapid Vienna,1617,3,9,9,6,37,28,9,36
LASK Linz,1617,4,7,6,11,25,29,-4,27
Vienna,1617,5,7,5,12,27,39,-12,26
Mattersburg,1617,6,6,6,12,28,42,-14,24
SC Rheindorf,1617,7,5,5,14,16,29,-13,20
FC Salzburg,1618,1,14,7,3,44,19,25,49
SK Sturm Gra,1618,2,13,3,8,32,30,2,42
Rapid Vienna,1618,3,10,10,4,37,25,12,40
LASK Linz,1618,4,9,5,10,27,28,-1,32
Mattersburg,1618,5,7,5,12,33,43,-10,26
Vienna,1618,6,6,6,12,25,40,-15,24
SC Rheindorf,1618,7,4,6,14,17,30,-13,18
FC Salzburg,1619,1,16,6,2,49,17,32,54
SK Sturm Gra,1619,2,12,5,7,33,30,3,41
LASK Linz,1619,3,9,7,8,30,29,1,34
Rapid Vienna,1619,4,7,11,6,33,28,5,32
Mattersburg,1619,5,6,7,11,32,43,-11,25
Vienna,1619,6,6,5,13,25,43,-18,23
SC Rheindorf,1619,7,4,7,13,17,29,-12,19
FC Salzburg,1620,1,13,7,4,42,21,21,46
SK Sturm Gra,1620,2,13,4,7,34,28,6,43
Rapid Vienna,1620,3,8,10,6,35,29,6,34
LASK Linz,1620,4,8,6,10,29,33,-4,30
Mattersburg,1620,5,7,6,11,36,43,-7,27
Vienna,1620,6,7,6,11,27,37,-10,27
SC Rheindorf,1620,7,5,7,12,19,31,-12,22
FC Salzburg,1621,1,13,8,3,44,21,23,47
SK Sturm Gra,1621,2,13,4,7,32,27,5,43
Rapid Vienna,1621,3,8,11,5,34,26,8,35
LASK Linz,1621,4,9,6,9,27,27,0,33
Vienna,1621,5,6,6,12,26,41,-15,24
Mattersburg,1621,6,5,8,11,30,41,-11,23
SC Rheindorf,1621,7,5,7,12,20,30,-10,22
FC Salzburg,1622,1,12,9,3,43,21,22,45
SK Sturm Gra,1622,2,11,5,8,30,32,-2,38
Rapid Vienna,1622,3,8,11,5,37,29,8,35
LASK Linz,1622,4,8,8,8,25,25,0,32
SC Rheindorf,1622,5,7,6,11,24,27,-3,27
Vienna,1622,6,7,6,11,27,39,-12,27
Mattersburg,1622,7,5,7,12,27,40,-13,22
FC Salzburg,1623,1,15,6,3,46,20,26,51
SK Sturm Gra,1623,2,13,3,8,34,29,5,42
Rapid Vienna,1623,3,8,10,6,35,29,6,34
LASK Linz,1623,4,8,6,10,27,29,-2,30
SC Rheindorf,1623,5,7,6,11,22,28,-6,27
Vienna,1623,6,6,6,12,24,40,-16,24
Mattersburg,1623,7,5,7,12,29,42,-13,22
FC Salzburg,1624,1,15,7,2,48,20,28,52
SK Sturm Gra,1624,2,11,4,9,31,32,-1,37
Rapid Vienna,1624,3,9,9,6,37,28,9,36
LASK Linz,1624,4,8,6,10,27,29,-2,30
Mattersburg,1624,5,7,6,11,32,40,-8,27
SC Rheindorf,1624,6,7,5,12,19,27,-8,26
Vienna,1624,7,6,5,13,23,41,-18,23
FC Salzburg,1625,1,14,6,4,48,23,25,48
Rapid Vienna,1625,2,10,10,4,40,27,13,40
SK Sturm Gra,1625,3,11,4,9,34,36,-2,37
LASK Linz,1625,4,9,5,10,29,34,-5,32
Mattersburg,1625,5,7,5,12,32,42,-10,26
Vienna,1625,6,7,5,12,26,41,-15,26
SC Rheindorf,1625,7,5,7,12,22,28,-6,22
FC Salzburg,1626,1,15,6,3,47,22,25,51
SK Sturm Gra,1626,2,12,4,8,34,29,5,40
Rapid Vienna,1626,3,10,9,5,38,26,12,39
LASK Linz,1626,4,9,6,9,29,31,-2,33
Vienna,1626,5,7,5,12,28,41,-13,26
Mattersburg,1626,6,5,6,13,28,43,-15,21
SC Rheindorf,1626,7,4,8,12,16,28,-12,20
FC Salzburg,1627,1,13,8,3,47,20,27,47
SK Sturm Gra,1627,2,13,4,7,33,30,3,43
Rapid Vienna,1627,3,7,11,6,34,30,4,32
LASK Linz,1627,4,8,5,11,26,28,-2,29
Mattersburg,1627,5,7,6,11,30,43,-13,27
Vienna,1627,6,7,6,11,26,39,-13,27
SC Rheindorf,1627,7,6,6,12,22,28,-6,24
FC Salzburg,1628,1,15,7,2,50,17,33,52
SK Sturm Gra,1628,2,11,4,9,28,28,0,37
Rapid Vienna,1628,3,9,9,6,34,29,5,36
LASK Linz,1628,4,9,6,9,29,27,2,33
SC Rheindorf,1628,5,6,6,12,20,27,-7,24
Vienna,1628,6,6,6,12,26,41,-15,24
Mattersburg,1628,7,6,6,12,28,46,-18,24
FC Salzburg,1629,1,15,6,3,43,17,26,51
SK Sturm Gra,1629,2,12,5,7,32,27,5,41
Rapid Vienna,1629,3,8,11,5,36,28,8,35
LASK Linz,1629,4,8,6,10,29,29,0,30
Mattersburg,1629,5,6,7,11,29,40,-11,25
Vienna,1629,6,6,6,12,23,39,-16,24
SC Rheindorf,1629,7,5,7,12,19,31,-12,22
FC Salzburg,1630,1,15,7,2,48,19,29,52
SK Sturm Gra,1630,2,11,4,9,31,33,-2,37
LASK Linz,1630,3,10,6,8,33,29,4,36
Rapid Vienna,1630,4,8,10,6,37,31,6,34
Vienna,1630,5,7,5,12,26,40,-14,26
Mattersburg,1630,6,6,6,12,33,44,-11,24
SC Rheindorf,1630,7,5,6,13,21,33,-12,21
FC Salzburg,1631,1,14,8,2,44,17,27,50
SK Sturm Gra,1631,2,12,5,7,31,29,2,41
Rapid Vienna,1631,3,8,11,5,35,27,8,35
LASK Linz,1631,4,9,5,10,29,33,-4,32
Mattersburg,1631,5,8,6,10,33,36,-3,30
Vienna,1631,6,6,5,13,24,41,-17,23
SC Rheindorf,1631,7,4,6,14,17,30,-13,18
FC Salzburg,1632,1,14,8,2,46,20,26,50
SK Sturm Gra,1632,2,12,4,8,35,31,4,40
Rapid Vienna,1632,3,9,11,4,37,26,11,38
Mattersburg,1632,4,8,5,11,33,39,-6,29
LASK Linz,1632,5,8,5,11,25,31,-6,29
Vienna,1632,6,6,6,12,24,40,-16,24
SC Rheindorf,1632,7,4,7,13,17,30,-13,19
FC Salzburg,1633,1,14,8,2,48,18,30,50
SK Sturm Gra,1633,2,12,5,7,33,32,1,41
Rapid Vienna,1633,3,7,12,5,37,31,6,33
LASK Linz,1633,4,8,7,9,26,26,0,31
Vienna,1633,5,7,6,11,26,38,-12,27
SC Rheindorf,1633,6,5,7,12,20,30,-10,22
Mattersburg,1633,7,5,7,12,29,44,-15,22
FC Salzburg,1634,1,14,6,4,47,20,27,48
SK Sturm Gra,1634,2,12,6,6,33,28,5,42
Rapid Vienna,1634,3,8,10,6,36,30,6,34
LASK Linz,1634,4,9,6,9,26,26,0,33
Mattersburg,1634,5,7,5,12,31,43,-12,26
Vienna,1634,6,7,5,12,25,39,-14,26
SC Rheindorf,1634,7,5,6,13,18,30,-12,21
FC Salzburg,1635,1,14,7,3,47,21,26,49
SK Sturm Gra,1635,2,12,4,8,34,30,4,40
LASK Linz,1635,3,10,6,8,31,27,4,36
Rapid Vienna,1635,4,7,11,6,34,31,3,32
Mattersburg,1635,5,7,6,11,34,43,-9,27
Vienna,1635,6,6,5,13,25,43,-18,23
SC Rheindorf,1635,7,4,9,11,17,27,-10,21
FC Salzburg,1636,1,14,6,4,47,23,24,48
SK Sturm Gra,1636,2,12,4,8,34,33,1,40
Rapid Vienna,1636,3,10,9,5,42,28,14,39
LASK Linz,1636,4,10,5,9,28,27,1,35
Vienna,1636,5,8,5,11,30,40,-10,29
SC Rheindorf,1636,6,5,6,13,19,33,-14,21
Mattersburg,1636,7,5,5,14,30,46,-16,20
FC Salzburg,1637,1,15,6,3,43,16,27,51
SK Sturm Gra,1637,2,13,5,6,35,28,7,44
Rapid Vienna,1637,3,8,9,7,36,31,5,33
LASK Linz,1637,4,8,7,9,29,30,-1,31
Vienna,1637,5,7,5,12,25,39,-14,26
Mattersburg,1637,6,6,6,12,31,43,-12,24
SC Rheindorf,1637,7,4,8,12,18,30,-12,20
FC Salzburg,1638,1,15,7,2,45,19,26,52
SK Sturm Gra,1638,2,11,4,9,30,31,-1,37
Rapid Vienna,1638,3,9,9,6,37,28,9,36
LASK Linz,1638,4,9,5,10,30,32,-2,32
Vienna,1638,5,7,5,12,29,42,-13,26
Mattersburg,1638,6,6,7,11,32,41,-9,25
SC Rheindorf,1638,7,5,7,12,18,28,-10,22
FC Salzburg,1639,1,14,7,3,48,20,28,49
SK Sturm Gra,1639,2,15,3,6,36,26,10,48
Rapid Vienna,1639,3,7,11,6,36,32,4,32
LASK Linz,1639,4,8,7,9,25,28,-3,31
Vienna,1639,5,6,7,11,29,43,-14,25
SC Rheindorf,1639,6,5,7,12,20,29,-9,22
Mattersburg,1639,7,5,6,13,31,47,-16,21
FC Salzburg,1640,1,16,6,2,48,19,29,54
Rapid Vienna,1640,2,9,10,5,39,28,11,37
SK Sturm Gra,1640,3,11,4,9,33,36,-3,37
LASK Linz,1640,4,9,5,10,31,33,-2,32
Mattersburg,1640,5,7,5,12,33,44,-11,26
SC Rheindorf,1640,6,6,5,13,24,31,-7,23
Vienna,1640,7,6,5,13,26,43,-17,23
FC Salzburg,1641,1,15,6,3,44,17,27,51
SK Sturm Gra,1641,2,13,3,8,32,27,5,42
Rapid Vienna,1641,3,9,10,5,36,28,8,37
LASK Linz,1641,4,8,5,11,26,29,-3,29
Mattersburg,1641,5,7,5,12,29,40,-11,26
Vienna,1641,6,7,5,12,26,40,-14,26
SC Rheindorf,1641,7,5,6,13,18,30,-12,21
FC Salzburg,1642,1,16,6,2,49,17,32,54
SK Sturm Gra,1642,2,12,5,7,32,32,0,41
LASK Linz,1642,3,9,6,9,32,30,2,33
Rapid Vienna,1642,4,7,10,7,34,31,3,31
Vienna,1642,5,7,5,12,26,39,-13,26
SC Rheindorf,1642,6,6,7,11,25,29,-4,25
Mattersburg,1642,7,5,5,14,28,48,-20,20
SK Sturm Gra,1643,1,14,4,6,38,26,12,46
FC Salzburg,1643,2,12,8,4,44,24,20,44
Rapid Vienna,1643,3,7,10,7,36,32,4,31
LASK Linz,1643,4,8,6,10,28,34,-6,30
Vienna,1643,5,8,5,11,29,40,-11,29
Mattersburg,1643,6,6,7,11,31,41,-10,25
SC Rheindorf,1643,7,5,8,11,21,30,-9,23
FC Salzburg,1644,1,15,6,3,45,17,28,51
SK Sturm Gra,1644,2,13,3,8,32,31,1,42
Rapid Vienna,1644,3,8,10,6,34,27,7,34
LASK Linz,1644,4,9,6,9,31,28,3,33
Vienna,1644,5,8,5,11,26,38,-12,29
SC Rheindorf,1644,6,5,6,13,19,31,-12,21
Mattersburg,1644,7,5,6,13,29,44,-15,21
FC Salzburg,1645,1,15,6,3,47,19,28,51
SK Sturm Gra,1645,2,11,5,8,30,28,2,38
LASK Linz,1645,3,10,6,8,28,26,2,36
Rapid Vienna,1645,4,7,11,6,34,29,5,32
Vienna,1645,5,7,5,12,27,43,-16,26
Mattersburg,1645,6,6,6,12,30,41,-11,24
SC Rheindorf,1645,7,4,9,11,17,27,-10,21
FC Salzburg,1646,1,14,7,3,45,19,26,49
SK Sturm Gra,1646,2,12,5,7,35,29,6,41
Rapid Vienna,1646,3,9,10,5,40,29,11,37
LASK Linz,1646,4,8,6,10,30,34,-4,30
Mattersburg,1646,5,7,6,11,30,39,-9,27
Vienna,1646,6,6,5,13,24,43,-19,23
SC Rheindorf,1646,7,5,7,12,20,31,-11,22
FC Salzburg,1647,1,14,8,2,44,18,26,50
SK Sturm Gra,1647,2,12,5,7,32,28,4,41
Rapid Vienna,1647,3,8,11,5,34,26,8,35
LASK Linz,1647,4,9,6,9,28,28,0,33
Mattersburg,1647,5,7,5,12,31,42,-11,26
Vienna,1647,6,7,5,12,27,41,-14,26
SC Rheindorf,1647,7,4,6,14,16,29,-13,18
FC Salzburg,1648,1,13,8,3,43,20,23,47
SK Sturm Gra,1648,2,12,4,8,30,28,2,40
Rapid Vienna,1648,3,9,9,6,35,28,7,36
Mattersburg,1648,4,8,6,10,31,38,-7,30
LASK Linz,1648,5,8,5,11,25,28,-3,29
SC Rheindorf,1648,6,6,6,12,21,28,-7,24
Vienna,1648,7,6,6,12,24,39,-15,24
FC Salzburg,1649,1,15,7,2,45,16,29,52
SK Sturm Gra,1649,2,13,4,7,32,28,4,43
Rapid Vienna,1649,3,8,10,6,35,29,6,34
LASK Linz,1649,4,8,7,9,25,27,-2,31
Mattersburg,1649,5,6,7,11,29,37,-8,25
Vienna,1649,6,6,6,12,24,39,-15,24
SC Rheindorf,1649,7,4,7,13,16,30,-14,19
FC Salzburg,1650,1,14,6,4,45,19,26,48
SK Sturm Gra,1650,2,13,3,8,36,35,1,42
Rapid Vienna,1650,3,8,11,5,36,30,6,35
LASK Linz,1650,4,8,7,9,28,28,0,31
Vienna,1650,5,8,5,11,26,38,-12,29
Mattersburg,1650,6,6,6,12,30,40,-10,24
SC Rheindorf,1650,7,5,6,13,20,31,-11,21
FC Salzburg,1651,1,13,8,3,43,21,22,47
SK Sturm Gra,1651,2,12,5,7,35,30,5,41
Rapid Vienna,1651,3,9,10,5,37,26,11,37
LASK Linz,1651,4,7,8,9,28,30,-2,29
Vienna,1651,5,7,5,12,25,41,-16,26
Mattersburg,1651,6,6,7,11,35,42,-7,25
SC Rheindorf,1651,7,6,5,13,20,33,-13,23
FC Salzburg,1652,1,13,9,2,42,17,25,48
SK Sturm Gra,1652,2,11,4,9,28,31,-3,37
LASK Linz,1652,3,10,6,8,33,25,8,36
Rapid Vienna,1652,4,8,10,6,36,29,7,34
SC Rheindorf,1652,5,7,6,11,22,26,-4,27
Mattersburg,1652,6,6,6,12,29,44,-15,24
Vienna,1652,7,6,5,13,23,41,-18,23
FC Salzburg,1653,1,16,6,2,46,18,28,54
Rapid Vienna,1653,2,9,9,6,39,29,10,36
LASK Linz,1653,3,10,6,8,33,30,3,36
SK Sturm Gra,1653,4,11,3,10,32,34,-2,36
Vienna,1653,5,6,6,12,26,41,-15,24
SC Rheindorf,1653,6,6,5,13,19,31,-12,23
Mattersburg,1653,7,5,7,12,30,42,-12,22
FC Salzburg,1654,1,14,7,3,44,16,28,49
SK Sturm Gra,1654,2,12,4,8,31,29,2,40
Rapid Vienna,1654,3,9,11,4,35,25,10,38
LASK Linz,1654,4,9,5,10,29,28,1,32
Vienna,1654,5,7,5,12,31,39,-8,26
Mattersburg,1654,6,6,5,13,29,52,-23,23
SC Rheindorf,1654,7,5,7,12,20,30,-10,22
FC Salzburg,1655,1,14,6,4,45,20,25,48
SK Sturm Gra,1655,2,13,4,7,35,28,7,43
Rapid Vienna,1655,3,9,11,4,35,25,10,38
LASK Linz,1655,4,8,7,9,27,30,-3,31
Mattersburg,1655,5,7,6,11,33,42,-9,27
Vienna,1655,6,6,5,13,26,42,-16,23
SC Rheindorf,1655,7,4,7,13,16,30,-14,19
FC Salzburg,1656,1,14,7,3,46,20,26,49
Rapid Vienna,1656,2,10,10,4,40,27,13,40
SK Sturm Gra,1656,3,12,4,8,31,30,1,40
LASK Linz,1656,4,9,6,9,29,28,1,33
Mattersburg,1656,5,6,6,12,32,42,-10,24
Vienna,1656,6,6,5,13,26,45,-19,23
SC Rheindorf,1656,7,5,6,13,16,28,-12,21
FC Salzburg,1657,1,15,6,3,53,18,35,51
SK Sturm Gra,1657,2,13,3,8,30,35,-5,42
Rapid Vienna,1657,3,9,10,5,36,26,10,37
LASK Linz,1657,4,8,7,9,29,30,-1,31
Vienna,1657,5,7,5,12,25,39,-14,26
Mattersburg,1657,6,6,6,12,32,45,-13,24
SC Rheindorf,1657,7,4,7,13,17,29,-12,19
FC Salzburg,1658,1,13,7,4,44,24,20,46
SK Sturm Gra,1658,2,11,6,7,30,27,3,39
LASK Linz,1658,3,10,5,9,26,27,-1,35
Rapid Vienna,1658,4,8,10,6,35,28,7,34
Mattersburg,1658,5,7,6,11,37,42,-5,27
Vienna,1658,6,7,6,11,26,38,-12,27
SC Rheindorf,1658,7,5,6,13,20,32,-12,21
FC Salzburg,1659,1,15,7,2,46,17,29,52
SK Sturm Gra,1659,2,11,5,8,31,30,1,38
Rapid Vienna,1659,3,7,12,5,35,28,7,33
LASK Linz,1659,4,8,7,9,31,29,2,31
Vienna,1659,5,7,6,11,27,38,-11,27
SC Rheindorf,1659,6,6,6,12,20,28,-8,24
Mattersburg,1659,7,6,5,13,27,47,-20,23
FC Salzburg,1660,1,14,8,2,46,21,25,50
Rapid Vienna,1660,2,9,10,5,35,26,9,37
SK Sturm Gra,1660,3,11,4,9,32,33,-1,37
LASK Linz,1660,4,10,6,8,29,26,3,36
Vienna,1660,5,6,6,12,26,41,-15,24
SC Rheindorf,1660,6,6,5,13,20,29,-9,23
Mattersburg,1660,7,5,7,12,31,43,-12,22
FC Salzburg,1661,1,15,7,2,51,16,35,52
SK Sturm Gra,1661,2,13,5,6,35,29,6,44
Rapid Vienna,1661,3,9,9,6,37,32,5,36
LASK Linz,1661,4,8,6,10,28,29,-1,30
Mattersburg,1661,5,7,5,12,31,45,-14,26
Vienna,1661,6,6,5,13,24,42,-18,23
SC Rheindorf,1661,7,4,7,13,18,31,-13,19
FC Salzburg,1662,1,14,7,3,46,18,28,49
Rapid Vienna,1662,2,11,9,4,38,25,13,42
SK Sturm Gra,1662,3,11,4,9,30,34,-4,37
LASK Linz,1662,4,8,6,10,29,33,-4,30
Vienna,1662,5,7,6,11,26,38,-12,27
Mattersburg,1662,6,6,6,12,33,45,-12,24
SC Rheindorf,1662,7,5,6,13,20,29,-9,21
FC Salzburg,1663,1,14,8,2,45,18,27,50
SK Sturm Gra,1663,2,11,5,8,31,30,1,38
Rapid Vienna,1663,3,7,12,5,35,28,7,33
LASK Linz,1663,4,9,5,10,29,29,0,32
Vienna,1663,5,7,5,12,28,40,-12,26
SC Rheindorf,1663,6,6,7,11,20,28,-8,25
Mattersburg,1663,7,6,6,12,31,46,-15,24
FC Salzburg,1664,1,14,7,3,47,20,27,49
SK Sturm Gra,1664,2,13,4,7,35,27,8,43
Rapid Vienna,1664,3,9,10,5,39,30,9,37
LASK Linz,1664,4,7,6,11,24,33,-9,27
Vienna,1664,5,7,5,12,27,40,-13,26
SC Rheindorf,1664,6,6,6,12,21,29,-8,24
Mattersburg,1664,7,6,6,12,30,44,-14,24
FC Salzburg,1665,1,16,6,2,49,17,32,54
SK Sturm Gra,1665,2,12,3,9,35,36,-1,39
Rapid Vienna,1665,3,8,10,6,35,29,6,34
LASK Linz,1665,4,9,5,10,31,33,-2,32
Mattersburg,1665,5,6,7,11,30,41,-11,25
Vienna,1665,6,6,6,12,24,39,-15,24
SC Rheindorf,1665,7,5,7,12,20,29,-9,22
FC Salzburg,1666,1,14,7,3,41,17,24,49
SK Sturm Gra,1666,2,13,4,7,37,32,5,43
Rapid Vienna,1666,3,9,10,5,36,27,9,37
LASK Linz,1666,4,7,6,11,27,31,-4,27
Vienna,1666,5,7,5,12,25,38,-13,26
Mattersburg,1666,6,6,7,11,27,38,-11,25
SC Rheindorf,1666,7,5,7,12,19,29,-10,22
FC Salzburg,1667,1,13,7,4,43,19,24,46
SK Sturm Gra,1667,2,12,4,8,31,29,2,40
Rapid Vienna,1667,3,10,9,5,37,27,10,39
LASK Linz,1667,4,10,5,9,31,28,3,35
Vienna,1667,5,7,6,11,26,39,-13,27
Mattersburg,1667,6,6,6,12,32,42,-10,24
SC Rheindorf,1667,7,5,5,14,18,34,-16,20
FC Salzburg,1668,1,14,7,3,43,18,25,49
SK Sturm Gra,1668,2,13,4,7,35,25,10,43
Rapid Vienna,1668,3,9,10,5,37,28,9,37
Mattersburg,1668,4,8,6,10,34,38,-4,30
LASK Linz,1668,5,7,5,12,24,36,-12,26
Vienna,1668,6,7,5,12,24,40,-16,26
SC Rheindorf,1668,7,5,5,14,21,33,-12,20
FC Salzburg,1669,1,15,7,2,46,19,27,52
SK Sturm Gra,1669,2,12,4,8,32,30,2,40
Rapid Vienna,1669,3,8,10,6,35,28,7,34
LASK Linz,1669,4,8,7,9,27,28,-1,31
Mattersburg,1669,5,6,7,11,30,40,-10,25
SC Rheindorf,1669,6,6,6,12,21,29,-8,24
Vienna,1669,7,6,5,13,26,43,-17,23
FC Salzburg,1670,1,15,6,3,51,17,34,51
SK Sturm Gra,1670,2,14,3,7,32,32,0,45
LASK Linz,1670,3,9,6,9,30,29,1,33
Rapid Vienna,1670,4,7,10,7,33,29,4,31
Mattersburg,1670,5,7,6,11,33,41,-8,27
Vienna,1670,6,7,5,12,25,41,-16,26
SC Rheindorf,1670,7,4,6,14,16,31,-15,18
FC Salzburg,1671,1,14,7,3,46,18,28,49
SK Sturm Gra,1671,2,13,4,7,36,28,8,43
Rapid Vienna,1671,3,7,12,5,31,27,4,33
Mattersburg,1671,4,8,5,11,32,39,-7,29
LASK Linz,1671,5,7,6,11,23,31,-8,27
SC Rheindorf,1671,6,6,6,12,20,30,-10,24
Vienna,1671,7,6,6,12,26,41,-15,24
FC Salzburg,1672,1,14,7,3,45,19,26,49
SK Sturm Gra,1672,2,13,3,8,32,29,3,42
Rapid Vienna,1672,3,8,10,6,36,30,6,34
LASK Linz,1672,4,8,5,11,28,30,-2,29
Vienna,1672,5,8,5,11,27,38,-11,29
Mattersburg,1672,6,7,5,12,33,45,-12,26
SC Rheindorf,1672,7,6,5,13,20,30,-10,23
FC Salzburg,1673,1,15,6,3,47,21,26,51
SK Sturm Gra,1673,2,13,4,7,37,32,5,43
Rapid Vienna,1673,3,8,10,6,37,30,7,34
LASK Linz,1673,4,9,6,9,25,25,0,33
Vienna,1673,5,6,6,12,25,40,-15,24
SC Rheindorf,1673,6,5,7,12,20,29,-9,22
Mattersburg,1673,7,5,7,12,28,42,-14,22
FC Salzburg,1674,1,14,7,3,44,18,26,49
SK Sturm Gra,1674,2,14,3,7,37,27,10,45
Rapid Vienna,1674,3,9,10,5,36,27,9,37
LASK Linz,1674,4,8,5,11,25,30,-5,29
Mattersburg,1674,5,7,6,11,34,42,-8,27
Vienna,1674,6,6,6,12,24,41,-17,24
SC Rheindorf,1674,7,4,7,13,18,33,-15,19
FC Salzburg,1675,1,14,7,3,45,18,27,49
SK Sturm Gra,1675,2,13,4,7,37,31,6,43
Rapid Vienna,1675,3,8,9,7,37,30,7,33
LASK Linz,1675,4,8,6,10,26,30,-4,30
Mattersburg,1675,5,7,6,11,30,40,-10,27
SC Rheindorf,1675,6,7,5,12,24,31,-7,26
Vienna,1675,7,6,5,13,25,44,-19,23
FC Salzburg,1676,1,15,6,3,46,16,30,51
SK Sturm Gra,1676,2,11,4,9,29,31,-2,37
Rapid Vienna,1676,3,9,9,6,34,28,6,36
LASK Linz,1676,4,8,5,11,26,29,-3,29
Vienna,1676,5,8,5,11,27,39,-12,29
Mattersburg,1676,6,7,5,12,30,41,-11,26
SC Rheindorf,1676,7,6,6,12,20,28,-8,24
FC Salzburg,1677,1,14,7,3,45,18,27,49
Rapid Vienna,1677,2,10,10,4,39,28,11,40
SK Sturm Gra,1677,3,12,4,8,32,30,2,40
LASK Linz,1677,4,8,6,10,26,29,-3,30
Mattersburg,1677,5,7,5,12,32,43,-11,26
Vienna,1677,6,7,5,12,27,42,-15,26
SC Rheindorf,1677,7,5,5,14,19,30,-11,20
FC Salzburg,1678,1,15,7,2,44,18,26,52
SK Sturm Gra,1678,2,13,4,7,39,29,10,43
Rapid Vienna,1678,3,7,11,6,32,27,5,32
LASK Linz,1678,4,7,7,10,26,33,-7,28
Mattersburg,1678,5,6,8,10,33,42,-9,26
SC Rheindorf,1678,6,5,8,11,19,28,-9,23
Vienna,1678,7,6,5,13,25,41,-16,23
FC Salzburg,1679,1,14,8,2,49,18,31,50
SK Sturm Gra,1679,2,11,5,8,32,32,0,38
Rapid Vienna,1679,3,8,12,4,34,25,9,36
LASK Linz,1679,4,8,8,8,33,30,3,32
Mattersburg,1679,5,6,7,11,31,44,-13,25
Vienna,1679,6,6,7,11,27,41,-14,25
SC Rheindorf,1679,7,5,5,14,16,32,-16,20
FC Salzburg,1680,1,13,7,4,44,21,23,46
Rapid Vienna,1680,2,10,9,5,38,29,9,39
SK Sturm Gra,1680,3,12,3,9,34,32,2,39
LASK Linz,1680,4,10,5,9,28,27,1,35
Mattersburg,1680,5,6,7,11,31,38,-7,25
Vienna,1680,6,6,6,12,24,40,-16,24
SC Rheindorf,1680,7,6,5,13,20,32,-12,23
FC Salzburg,1681,1,14,6,4,44,20,24,48
SK Sturm Gra,1681,2,12,4,8,31,29,2,40
Rapid Vienna,1681,3,8,10,6,34,33,1,34
LASK Linz,1681,4,8,5,11,26,29,-3,29
Mattersburg,1681,5,7,7,10,34,39,-5,28
SC Rheindorf,1681,6,7,6,11,24,26,-2,27
Vienna,1681,7,6,6,12,25,42,-17,24
FC Salzburg,1682,1,15,6,3,45,19,26,51
SK Sturm Gra,1682,2,12,4,8,32,29,3,40
Rapid Vienna,1682,3,9,10,5,36,27,9,37
LASK Linz,1682,4,7,7,10,25,29,-4,28
SC Rheindorf,1682,5,6,7,11,19,27,-8,25
Mattersburg,1682,6,6,6,12,30,41,-11,24
Vienna,1682,7,6,6,12,26,41,-15,24
FC Salzburg,1683,1,15,7,2,45,16,29,52
SK Sturm Gra,1683,2,12,4,8,32,33,-1,40
Rapid Vienna,1683,3,9,11,4,36,25,11,38
LASK Linz,1683,4,8,5,11,26,29,-3,29
Mattersburg,1683,5,7,5,12,31,40,-9,26
SC Rheindorf,1683,6,6,5,13,20,30,-10,23
Vienna,1683,7,6,5,13,24,41,-17,23
SK Sturm Gra,1684,1,15,3,6,34,25,9,48
FC Salzburg,1684,2,13,7,4,42,19,23,46
Rapid Vienna,1684,3,9,10,5,34,26,8,37
LASK Linz,1684,4,7,6,11,27,31,-4,27
Vienna,1684,5,7,5,12,26,41,-15,26
Mattersburg,1684,6,6,7,11,29,39,-10,25
SC Rheindorf,1684,7,5,6,13,18,29,-11,21
FC Salzburg,1685,1,14,8,2,44,18,26,50
SK Sturm Gra,1685,2,13,3,8,30,26,4,42
Rapid Vienna,1685,3,8,11,5,34,26,8,35
LASK Linz,1685,4,8,6,10,26,29,-3,30
Mattersburg,1685,5,7,6,11,33,39,-6,27
Vienna,1685,6,6,6,12,25,43,-18,24
SC Rheindorf,1685,7,4,8,12,15,26,-11,20
FC Salzburg,1686,1,16,6,2,46,18,28,54
SK Sturm Gra,1686,2,12,3,9,32,31,1,39
LASK Linz,1686,3,10,6,8,28,26,2,36
Rapid Vienna,1686,4,8,9,7,35,28,7,33
Mattersburg,1686,5,6,7,11,31,41,-10,25
Vienna,1686,6,6,5,13,25,42,-17,23
SC Rheindorf,1686,7,5,6,13,18,29,-11,21
FC Salzburg,1687,1,13,9,2,44,20,24,48
SK Sturm Gra,1687,2,12,5,7,31,27,4,41
Rapid Vienna,1687,3,8,10,6,35,31,4,34
LASK Linz,1687,4,8,6,10,28,30,-2,30
Vienna,1687,5,7,6,11,26,38,-12,27
Mattersburg,1687,6,7,5,12,36,44,-8,26
SC Rheindorf,1687,7,5,7,12,21,31,-10,22
FC Salzburg,1688,1,16,6,2,50,20,30,54
SK Sturm Gra,1688,2,13,4,7,37,31,6,43
Rapid Vienna,1688,3,9,10,5,38,26,12,37
LASK Linz,1688,4,8,6,10,26,28,-2,30
Vienna,1688,5,7,5,12,27,39,-12,26
Mattersburg,1688,6,5,7,12,28,45,-17,22
SC Rheindorf,1688,7,4,6,14,17,34,-17,18
FC Salzburg,1689,1,15,6,3,45,19,26,51
SK Sturm Gra,1689,2,12,4,8,33,30,3,40
Rapid Vienna,1689,3,8,9,7,33,30,3,33
Mattersburg,1689,4,8,5,11,35,40,-5,29
LASK Linz,1689,5,7,7,10,25,30,-5,28
Vienna,1689,6,7,5,12,28,40,-12,26
SC Rheindorf,1689,7,6,6,12,20,30,-10,24
FC Salzburg,1690,1,15,7,2,46,19,27,52
SK Sturm Gra,1690,2,13,3,8,34,27,7,42
Rapid Vienna,1690,3,9,10,5,37,29,8,37
LASK Linz,1690,4,9,5,10,26,27,-1,32
Mattersburg,1690,5,7,5,12,31,42,-11,26
Vienna,1690,6,7,5,12,25,39,-14,26
SC Rheindorf,1690,7,4,5,15,18,34,-16,17
FC Salzburg,1691,1,15,6,3,45,18,27,51
SK Sturm Gra,1691,2,11,4,9,28,30,-2,37
Rapid Vienna,1691,3,9,9,6,39,28,11,36
LASK Linz,1691,4,8,6,10,27,30,-3,30
SC Rheindorf,1691,5,7,6,11,22,28,-6,27
Vienna,1691,6,7,5,12,24,38,-14,26
Mattersburg,1691,7,6,6,12,31,44,-13,24
FC Salzburg,1692,1,14,8,2,45,18,27,50
SK Sturm Gra,1692,2,12,5,7,30,27,3,41
Rapid Vienna,1692,3,8,11,5,37,29,8,35
LASK Linz,1692,4,8,5,11,26,32,-6,29
SC Rheindorf,1692,5,7,5,12,22,27,-5,26
Mattersburg,1692,6,6,6,12,31,43,-12,24
Vienna,1692,7,6,6,12,25,40,-15,24
FC Salzburg,1693,1,14,7,3,45,18,27,49
SK Sturm Gra,1693,2,12,5,7,31,27,4,41
Rapid Vienna,1693,3,10,10,4,37,25,12,40
LASK Linz,1693,4,8,6,10,29,29,0,30
Vienna,1693,5,7,5,12,25,40,-15,26
SC Rheindorf,1693,6,6,5,13,23,34,-11,23
Mattersburg,1693,7,5,6,13,32,49,-17,21
FC Salzburg,1694,1,14,8,2,45,18,27,50
SK Sturm Gra,1694,2,12,4,8,32,28,4,40
Rapid Vienna,1694,3,9,10,5,36,26,10,37
LASK Linz,1694,4,8,5,11,26,33,-7,29
SC Rheindorf,1694,5,7,5,12,21,26,-5,26
Vienna,1694,6,7,5,12,25,41,-16,26
Mattersburg,1694,7,6,5,13,30,43,-13,23
FC Salzburg,1695,1,13,7,4,40,18,22,46
SK Sturm Gra,1695,2,14,3,7,34,29,5,45
Rapid Vienna,1695,3,9,10,5,35,27,8,37
LASK Linz,1695,4,7,7,10,28,32,-4,28
Vienna,1695,5,7,6,11,27,39,-12,27
Mattersburg,1695,6,6,6,12,31,43,-12,24
SC Rheindorf,1695,7,6,5,13,24,31,-7,23
FC Salzburg,1696,1,16,6,2,49,17,32,54
SK Sturm Gra,1696,2,12,4,8,33,29,4,40
Rapid Vienna,1696,3,8,9,7,35,30,5,33
LASK Linz,1696,4,8,5,11,26,32,-6,29
SC Rheindorf,1696,5,7,6,11,18,25,-7,27
Mattersburg,1696,6,7,5,12,30,40,-10,26
Vienna,1696,7,6,5,13,24,42,-18,23
FC Salzburg,1697,1,13,7,4,44,21,23,46
SK Sturm Gra,1697,2,13,3,8,33,30,3,42
Rapid Vienna,1697,3,9,9,6,36,30,6,36
LASK Linz,1697,4,9,5,10,26,30,-4,32
Mattersburg,1697,5,7,6,11,32,40,-8,27
Vienna,1697,6,7,5,12,26,38,-12,26
SC Rheindorf,1697,7,6,5,13,23,31,-8,23
FC Salzburg,1698,1,12,10,2,42,19,23,46
SK Sturm Gra,1698,2,13,4,7,33,28,5,43
Rapid Vienna,1698,3,7,11,6,35,31,4,32
LASK Linz,1698,4,9,5,10,30,29,1,32
Vienna,1698,5,7,6,11,24,37,-13,27
SC Rheindorf,1698,6,6,7,11,21,28,-7,25
Mattersburg,1698,7,5,7,12,30,43,-13,22
FC Salzburg,1699,1,16,6,2,46,17,29,54
SK Sturm Gra,1699,2,14,3,7,34,27,7,45
Rapid Vienna,1699,3,8,10,6,35,28,7,34
LASK Linz,1699,4,8,6,10,30,31,-1,30
Vienna,1699,5,7,5,12,27,39,-12,26
Mattersburg,1699,6,6,6,12,30,44,-14,24
SC Rheindorf,1699,7,4,6,14,17,33,-16,18
FC Salzburg,1700,1,15,7,2,46,19,27,52
SK Sturm Gra,1700,2,12,5,7,32,29,3,41
LASK Linz,1700,3,11,5,8,31,26,5,38
Rapid Vienna,1700,4,7,9,8,34,32,2,30
SC Rheindorf,1700,5,6,6,12,21,28,-7,24
Vienna,1700,6,6,6,12,25,41,-16,24
Mattersburg,1700,7,5,6,13,30,44,-14,21
FC Salzburg,1701,1,14,7,3,42,18,24,49
SK Sturm Gra,1701,2,12,3,9,35,32,3,39
Rapid Vienna,1701,3,8,10,6,33,27,6,34
LASK Linz,1701,4,9,6,9,30,31,-1,33
Vienna,1701,5,8,5,11,27,39,-12,29
Mattersburg,1701,6,6,6,12,34,43,-9,24
SC Rheindorf,1701,7,6,5,13,20,31,-11,23
FC Salzburg,1702,1,14,6,4,45,20,25,48
SK Sturm Gra,1702,2,12,4,8,33,32,1,40
Rapid Vienna,1702,3,9,10,5,38,29,9,37
LASK Linz,1702,4,8,7,9,27,28,-1,31
Vienna,1702,5,8,5,11,28,39,-11,29
Mattersburg,1702,6,7,5,12,32,42,-10,26
SC Rheindorf,1702,7,5,5,14,19,32,-13,20
FC Salzburg,1703,1,15,6,3,47,20,27,51
SK Sturm Gra,1703,2,11,5,8,30,29,1,38
Rapid Vienna,1703,3,9,10,5,38,29,9,37
LASK Linz,1703,4,8,6,10,25,28,-3,30
Vienna,1703,5,8,5,11,29,40,-11,29
SC Rheindorf,1703,6,7,5,12,20,26,-6,26
Mattersburg,1703,7,5,5,14,27,44,-17,20
FC Salzburg,1704,1,15,7,2,55,19,36,52
SK Sturm Gra,1704,2,12,3,9,31,32,-1,39
LASK Linz,1704,3,10,6,8,31,27,4,36
Rapid Vienna,1704,4,7,12,5,35,28,7,33
SC Rheindorf,1704,5,6,6,12,17,27,-10,24
Vienna,1704,6,6,5,13,27,44,-17,23
Mattersburg,1704,7,6,5,13,32,51,-19,23
SK Sturm Gra,1705,1,13,5,6,35,27,8,44
FC Salzburg,1705,2,12,7,5,39,20,19,43
Rapid Vienna,1705,3,10,10,4,35,24,11,40
Vienna,1705,4,8,5,11,27,38,-11,29
Mattersburg,1705,5,7,6,11,33,41,-8,27
LASK Linz,1705,6,7,5,12,25,33,-8,26
SC Rheindorf,1705,7,5,6,13,21,32,-11,21
FC Salzburg,1706,1,15,6,3,47,21,26,51
SK Sturm Gra,1706,2,14,3,7,35,28,7,45
Rapid Vienna,1706,3,9,9,6,35,28,7,36
Vienna,1706,4,8,5,11,29,41,-12,29
LASK Linz,1706,5,7,5,12,25,31,-6,26
Mattersburg,1706,6,6,6,12,35,46,-11,24
SC Rheindorf,1706,7,5,6,13,20,31,-11,21
FC Salzburg,1707,1,14,8,2,45,16,29,50
SK Sturm Gra,1707,2,13,5,6,33,26,7,44
LASK Linz,1707,3,9,7,8,30,28,2,34
Rapid Vienna,1707,4,7,10,7,32,30,2,31
Vienna,1707,5,7,6,11,28,40,-12,27
SC Rheindorf,1707,6,6,5,13,20,30,-10,23
Mattersburg,1707,7,5,5,14,29,47,-18,20
FC Salzburg,1708,1,13,8,3,42,20,22,47
SK Sturm Gra,1708,2,11,5,8,29,29,0,38
Rapid Vienna,1708,3,9,10,5,36,26,10,37
LASK Linz,1708,4,9,7,8,27,26,1,34
Vienna,1708,5,7,6,11,26,37,-11,27
Mattersburg,1708,6,5,8,11,31,44,-13,23
SC Rheindorf,1708,7,5,6,13,19,28,-9,21
FC Salzburg,1709,1,14,7,3,40,18,22,49
Rapid Vienna,1709,2,10,9,5,42,29,13,39
SK Sturm Gra,1709,3,11,3,10,31,35,-4,36
LASK Linz,1709,4,10,5,9,31,28,3,35
Vienna,1709,5,7,5,12,27,39,-12,26
Mattersburg,1709,6,6,6,12,30,41,-11,24
SC Rheindorf,1709,7,6,5,13,20,31,-11,23
FC Salzburg,1710,1,15,7,2,44,16,28,52
SK Sturm Gra,1710,2,11,5,8,29,30,-1,38
Rapid Vienna,1710,3,9,10,5,38,28,10,37
LASK Linz,1710,4,7,6,11,28,32,-4,27
Vienna,1710,5,7,6,11,27,38,-11,27
SC Rheindorf,1710,6,6,6,12,22,31,-9,24
Mattersburg,1710,7,6,6,12,31,44,-13,24
FC Salzburg,1711,1,16,6,2,47,20,27,54
SK Sturm Gra,1711,2,12,5,7,34,30,4,41
Rapid Vienna,1711,3,8,11,5,36,28,8,35
LASK Linz,1711,4,8,7,9,29,29,0,31
Vienna,1711,5,6,6,12,26,41,-15,24
Mattersburg,1711,6,5,7,12,30,43,-13,22
SC Rheindorf,1711,7,4,8,12,18,29,-11,20
FC Salzburg,1712,1,16,6,2,47,19,28,54
SK Sturm Gra,1712,2,13,4,7,35,26,9,43
Rapid Vienna,1712,3,8,9,7,33,29,4,33
LASK Linz,1712,4,8,6,10,26,31,-5,30
Vienna,1712,5,6,6,12,26,41,-15,24
Mattersburg,1712,6,5,8,11,32,44,-12,23
SC Rheindorf,1712,7,5,7,12,20,29,-9,22
FC Salzburg,1713,1,14,8,2,46,15,31,50
SK Sturm Gra,1713,2,13,4,7,33,28,5,43
Rapid Vienna,1713,3,9,9,6,35,29,6,36
LASK Linz,1713,4,7,7,10,27,30,-3,28
Mattersburg,1713,5,6,8,10,31,39,-8,26
Vienna,1713,6,6,6,12,25,43,-18,24
SC Rheindorf,1713,7,5,6,13,17,30,-13,21
FC Salzburg,1714,1,14,7,3,42,18,24,49
SK Sturm Gra,1714,2,12,4,8,30,28,2,40
Rapid Vienna,1714,3,9,10,5,37,26,11,37
LASK Linz,1714,4,9,5,10,27,30,-3,32
Vienna,1714,5,7,6,11,25,38,-13,27
Mattersburg,1714,6,7,5,12,30,39,-9,26
SC Rheindorf,1714,7,5,5,14,18,30,-12,20
FC Salzburg,1715,1,15,6,3,49,19,30,51
SK Sturm Gra,1715,2,14,3,7,34,31,3,45
Rapid Vienna,1715,3,10,9,5,39,29,10,39
LASK Linz,1715,4,7,5,12,27,32,-5,26
Mattersburg,1715,5,7,5,12,29,42,-13,26
SC Rheindorf,1715,6,6,5,13,21,30,-9,23
Vienna,1715,7,6,5,13,23,39,-16,23
FC Salzburg,1716,1,14,7,3,43,19,24,49
SK Sturm Gra,1716,2,12,4,8,32,29,3,40
Rapid Vienna,1716,3,9,11,4,36,26,10,38
LASK Linz,1716,4,8,6,10,25,27,-2,30
Vienna,1716,5,7,5,12,26,40,-14,26
SC Rheindorf,1716,6,6,6,12,19,28,-9,24
Mattersburg,1716,7,6,5,13,31,43,-12,23
FC Salzburg,1717,1,14,7,3,43,18,25,49
SK Sturm Gra,1717,2,13,4,7,35,26,9,43
LASK Linz,1717,3,9,6,9,33,28,5,33
Rapid Vienna,1717,4,7,11,6,31,31,0,32
Mattersburg,1717,5,7,5,12,31,44,-13,26
Vienna,1717,6,7,5,12,24,38,-14,26
SC Rheindorf,1717,7,4,8,12,16,28,-12,20
FC Salzburg,1718,1,14,8,2,45,19,26,50
SK Sturm Gra,1718,2,12,4,8,34,31,3,40
Rapid Vienna,1718,3,9,9,6,38,29,9,36
LASK Linz,1718,4,7,8,9,26,29,-3,29
Mattersburg,1718,5,6,8,10,32,41,-9,26
Vienna,1718,6,6,6,12,25,40,-15,24
SC Rheindorf,1718,7,5,7,12,20,31,-11,22
FC Salzburg,1719,1,16,6,2,46,15,31,54
Rapid Vienna,1719,2,9,10,5,35,27,8,37
SK Sturm Gra,1719,3,11,4,9,29,29,0,37
LASK Linz,1719,4,8,8,8,26,25,1,32
Vienna,1719,5,7,5,12,25,40,-15,26
SC Rheindorf,1719,6,5,7,12,17,27,-10,22
Mattersburg,1719,7,5,6,13,28,43,-15,21
FC Salzburg,1720,1,15,7,2,45,18,27,52
SK Sturm Gra,1720,2,13,4,7,34,27,7,43
Rapid Vienna,1720,3,8,10,6,34,26,8,34
LASK Linz,1720,4,7,7,10,24,29,-5,28
Vienna,1720,5,7,5,12,25,40,-15,26
Mattersburg,1720,6,6,7,11,31,39,-8,25
SC Rheindorf,1720,7,5,6,13,17,31,-14,21
FC Salzburg,1721,1,15,6,3,45,18,27,51
SK Sturm Gra,1721,2,15,3,6,36,24,12,48
Rapid Vienna,1721,3,8,10,6,33,27,6,34
LASK Linz,1721,4,8,7,9,24,26,-2,31
Mattersburg,1721,5,6,7,11,28,38,-10,25
Vienna,1721,6,6,6,12,25,42,-17,24
SC Rheindorf,1721,7,4,5,15,16,32,-16,17
FC Salzburg,1722,1,15,7,2,48,17,31,52
SK Sturm Gra,1722,2,12,5,7,37,33,4,41
Rapid Vienna,1722,3,7,12,5,37,30,7,33
LASK Linz,1722,4,9,6,9,30,29,1,33
Mattersburg,1722,5,7,5,12,31,43,-12,26
Vienna,1722,6,6,5,13,23,43,-20,23
SC Rheindorf,1722,7,5,6,13,18,29,-11,21
FC Salzburg,1723,1,14,6,4,43,18,25,48
SK Sturm Gra,1723,2,12,4,8,33,32,1,40
Rapid Vienna,1723,3,10,9,5,38,26,12,39
LASK Linz,1723,4,8,6,10,29,32,-3,30
Mattersburg,1723,5,7,6,11,31,39,-8,27
Vienna,1723,6,7,5,12,26,40,-14,26
SC Rheindorf,1723,7,5,6,13,17,30,-13,21
FC Salzburg,1724,1,16,6,2,48,20,28,54
SK Sturm Gra,1724,2,12,3,9,31,35,-4,39
Rapid Vienna,1724,3,9,9,6,41,30,11,36
LASK Linz,1724,4,10,5,9,30,28,2,35
Vienna,1724,5,7,5,12,24,38,-14,26
SC Rheindorf,1724,6,6,5,13,21,29,-8,23
Mattersburg,1724,7,5,5,14,28,43,-15,20
FC Salzburg,1725,1,14,7,3,44,19,25,49
SK Sturm Gra,1725,2,13,3,8,32,28,4,42
Rapid Vienna,1725,3,9,9,6,38,28,10,36
LASK Linz,1725,4,10,5,9,29,27,2,35
Mattersburg,1725,5,6,7,11,30,40,-10,25
Vienna,1725,6,6,5,13,24,42,-18,23
SC Rheindorf,1725,7,5,6,13,20,33,-13,21
FC Salzburg,1726,1,14,6,4,44,19,25,48
SK Sturm Gra,1726,2,13,4,7,33,28,5,43
Rapid Vienna,1726,3,9,9,6,34,26,8,36
LASK Linz,1726,4,8,7,9,26,27,-1,31
Vienna,1726,5,8,5,11,26,37,-11,29
Mattersburg,1726,6,6,6,12,29,43,-14,24
SC Rheindorf,1726,7,5,5,14,17,29,-12,20
FC Salzburg,1727,1,14,6,4,44,21,23,48
SK Sturm Gra,1727,2,12,5,7,32,28,4,41
Rapid Vienna,1727,3,10,9,5,42,30,12,39
LASK Linz,1727,4,8,6,10,25,31,-6,30
Vienna,1727,5,8,5,11,30,39,-9,29
Mattersburg,1727,6,6,5,13,30,43,-13,23
SC Rheindorf,1727,7,5,6,13,21,32,-11,21
FC Salzburg,1728,1,16,6,2,46,19,27,54
SK Sturm Gra,1728,2,11,6,7,32,29,3,39
Rapid Vienna,1728,3,9,10,5,37,26,11,37
LASK Linz,1728,4,8,7,9,27,28,-1,31
Vienna,1728,5,7,5,12,26,39,-13,26
SC Rheindorf,1728,6,5,6,13,20,32,-12,21
Mattersburg,1728,7,5,6,13,27,42,-15,21
FC Salzburg,1729,1,15,6,3,48,22,26,51
SK Sturm Gra,1729,2,13,4,7,35,28,7,43
Rapid Vienna,1729,3,10,9,5,39,25,14,39
LASK Linz,1729,4,9,5,10,27,29,-2,32
Mattersburg,1729,5,6,6,12,32,44,-12,24
Vienna,1729,6,6,5,13,26,44,-18,23
SC Rheindorf,1729,7,4,7,13,17,32,-15,19
FC Salzburg,1730,1,14,7,3,44,20,24,49
SK Sturm Gra,1730,2,14,4,6,35,26,9,46
Rapid Vienna,1730,3,8,9,7,38,30,8,33
LASK Linz,1730,4,9,5,10,29,31,-2,32
Vienna,1730,5,7,6,11,25,38,-13,27
Mattersburg,1730,6,7,5,12,31,41,-10,26
SC Rheindorf,1730,7,4,6,14,19,35,-16,18
FC Salzburg,1731,1,15,7,2,46,17,29,52
SK Sturm Gra,1731,2,13,4,7,37,32,5,43
Rapid Vienna,1731,3,8,10,6,36,31,5,34
LASK Linz,1731,4,8,6,10,28,31,-3,30
Mattersburg,1731,5,6,7,11,29,38,-9,25
Vienna,1731,6,6,6,12,24,40,-16,24
SC Rheindorf,1731,7,5,6,13,21,32,-11,21
FC Salzburg,1732,1,13,7,4,43,22,21,46
SK Sturm Gra,1732,2,13,3,8,34,30,4,42
Rapid Vienna,1732,3,9,11,4,37,25,12,38
LASK Linz,1732,4,7,6,11,25,30,-5,27
Mattersburg,1732,5,7,5,12,32,40,-8,26
SC Rheindorf,1732,6,7,5,12,22,32,-10,26
Vienna,1732,7,7,5,12,25,39,-14,26
FC Salzburg,1733,1,13,8,3,46,21,25,47
SK Sturm Gra,1733,2,13,4,7,37,29,8,43
Rapid Vienna,1733,3,8,12,4,36,27,9,36
LASK Linz,1733,4,8,6,10,26,33,-7,30
Mattersburg,1733,5,7,7,10,36,42,-6,28
Vienna,1733,6,6,7,11,26,40,-14,25
SC Rheindorf,1733,7,4,6,14,19,34,-15,18
FC Salzburg,1734,1,15,6,3,46,18,28,51
SK Sturm Gra,1734,2,13,3,8,32,27,5,42
Rapid Vienna,1734,3,9,9,6,37,30,7,36
LASK Linz,1734,4,10,6,8,32,27,5,36
Vienna,1734,5,7,5,12,25,40,-15,26
Mattersburg,1734,6,6,6,12,31,40,-9,24
SC Rheindorf,1734,7,4,5,15,16,37,-21,17
FC Salzburg,1735,1,15,6,3,46,19,27,51
SK Sturm Gra,1735,2,12,4,8,30,28,2,40
Rapid Vienna,1735,3,10,9,5,36,27,9,39
LASK Linz,1735,4,7,6,11,24,29,-5,27
SC Rheindorf,1735,5,7,5,12,22,27,-5,26
Vienna,1735,6,7,5,12,25,38,-13,26
Mattersburg,1735,7,6,5,13,29,44,-15,23
FC Salzburg,1736,1,15,6,3,47,21,26,51
SK Sturm Gra,1736,2,12,3,9,35,31,4,39
Rapid Vienna,1736,3,9,10,5,41,31,10,37
LASK Linz,1736,4,9,5,10,30,32,-2,32
Vienna,1736,5,7,5,12,26,42,-16,26
SC Rheindorf,1736,6,6,6,12,24,29,-5,24
Mattersburg,1736,7,6,5,13,28,45,-17,23
FC Salzburg,1737,1,14,7,3,46,17,29,49
SK Sturm Gra,1737,2,14,3,7,34,27,7,45
Rapid Vienna,1737,3,8,10,6,36,29,7,34
LASK Linz,1737,4,8,7,9,27,29,-2,31
Mattersburg,1737,5,7,6,11,33,42,-9,27
Vienna,1737,6,6,5,13,25,45,-20,23
SC Rheindorf,1737,7,5,6,13,20,32,-12,21
FC Salzburg,1738,1,15,7,2,46,17,29,52
SK Sturm Gra,1738,2,12,5,7,31,27,4,41
Rapid Vienna,1738,3,9,9,6,38,31,7,36
Mattersburg,1738,4,8,5,11,33,41,-8,29
LASK Linz,1738,5,7,6,11,25,29,-4,27
Vienna,1738,6,6,6,12,23,40,-17,24
SC Rheindorf,1738,7,5,6,13,20,31,-11,21
FC Salzburg,1739,1,15,6,3,44,17,27,51
SK Sturm Gra,1739,2,11,5,8,32,30,2,38
Rapid Vienna,1739,3,7,11,6,34,28,6,32
LASK Linz,1739,4,8,8,8,27,27,0,32
Mattersburg,1739,5,7,6,11,33,43,-10,27
Vienna,1739,6,7,5,12,24,38,-14,26
SC Rheindorf,1739,7,5,7,12,19,30,-11,22
FC Salzburg,1740,1,15,6,3,50,16,34,51
SK Sturm Gra,1740,2,12,4,8,33,33,0,40
LASK Linz,1740,3,10,6,8,31,28,3,36
Rapid Vienna,1740,4,8,9,7,36,32,4,33
Mattersburg,1740,5,7,5,12,28,41,-13,26
SC Rheindorf,1740,6,6,5,13,22,31,-9,23
Vienna,1740,7,6,5,13,23,42,-19,23
FC Salzburg,1741,1,15,6,3,47,20,27,51
SK Sturm Gra,1741,2,12,4,8,34,31,3,40
Rapid Vienna,1741,3,8,9,7,35,30,5,33
LASK Linz,1741,4,8,6,10,27,28,-1,30
Vienna,1741,5,8,5,11,26,38,-12,29
Mattersburg,1741,6,7,5,12,31,41,-10,26
SC Rheindorf,1741,7,6,5,13,19,31,-12,23
FC Salzburg,1742,1,14,8,2,47,18,29,50
SK Sturm Gra,1742,2,12,5,7,34,31,3,41
Rapid Vienna,1742,3,8,11,5,36,27,9,35
LASK Linz,1742,4,8,6,10,28,32,-4,30
SC Rheindorf,1742,5,6,6,12,24,31,-7,24
Mattersburg,1742,6,6,6,12,29,41,-12,24
Vienna,1742,7,6,6,12,24,42,-18,24
FC Salzburg,1743,1,14,6,4,45,20,25,48
Rapid Vienna,1743,2,10,10,4,40,27,13,40
SK Sturm Gra,1743,3,12,4,8,30,30,0,40
LASK Linz,1743,4,8,5,11,25,28,-3,29
Vienna,1743,5,7,6,11,26,39,-13,27
Mattersburg,1743,6,6,7,11,30,42,-12,25
SC Rheindorf,1743,7,5,6,13,21,31,-10,21
FC Salzburg,1744,1,15,6,3,48,17,31,51
SK Sturm Gra,1744,2,14,3,7,36,31,5,45
Rapid Vienna,1744,3,8,10,6,37,31,6,34
LASK Linz,1744,4,8,7,9,27,29,-2,31
Mattersburg,1744,5,7,5,12,32,40,-8,26
Vienna,1744,6,7,5,12,24,41,-17,26
SC Rheindorf,1744,7,4,6,14,17,32,-15,18
FC Salzburg,1745,1,13,7,4,44,18,26,46
SK Sturm Gra,1745,2,13,3,8,32,30,2,42
Rapid Vienna,1745,3,10,9,5,39,28,11,39
LASK Linz,1745,4,8,7,9,26,27,-1,31
SC Rheindorf,1745,5,6,6,12,22,30,-8,24
Mattersburg,1745,6,6,6,12,32,44,-12,24
Vienna,1745,7,6,6,12,23,41,-18,24
FC Salzburg,1746,1,12,10,2,41,18,23,46
SK Sturm Gra,1746,2,11,4,9,31,32,-1,37
Rapid Vienna,1746,3,8,12,4,36,27,9,36
LASK Linz,1746,4,8,6,10,30,32,-2,30
SC Rheindorf,1746,5,7,6,11,23,28,-5,27
Mattersburg,1746,6,6,7,11,32,42,-10,25
Vienna,1746,7,6,7,11,25,39,-14,25
FC Salzburg,1747,1,13,8,3,42,18,24,47
Rapid Vienna,1747,2,10,10,4,37,25,12,40
SK Sturm Gra,1747,3,11,6,7,30,27,3,39
LASK Linz,1747,4,8,6,10,26,29,-3,30
Mattersburg,1747,5,7,6,11,31,41,-10,27
Vienna,1747,6,6,6,12,25,40,-15,24
SC Rheindorf,1747,7,4,8,12,18,29,-11,20
FC Salzburg,1748,1,13,8,3,44,20,24,47
SK Sturm Gra,1748,2,12,4,8,33,29,4,40
LASK Linz,1748,3,9,6,9,28,29,-1,33
Rapid Vienna,1748,4,7,11,6,35,31,4,32
SC Rheindorf,1748,5,8,5,11,22,26,-4,29
Mattersburg,1748,6,7,5,12,32,40,-8,26
Vienna,1748,7,6,5,13,24,43,-19,23
FC Salzburg,1749,1,14,6,4,47,21,26,48
SK Sturm Gra,1749,2,13,3,8,35,29,6,42
Rapid Vienna,1749,3,8,10,6,35,30,5,34
LASK Linz,1749,4,9,6,9,27,27,0,33
Vienna,1749,5,7,5,12,25,39,-14,26
SC Rheindorf,1749,6,6,6,12,20,29,-9,24
Mattersburg,1749,7,6,6,12,31,45,-14,24
FC Salzburg,1750,1,15,6,3,43,16,27,51
Rapid Vienna,1750,2,10,10,4,36,24,12,40
SK Sturm Gra,1750,3,11,4,9,28,28,0,37
LASK Linz,1750,4,8,6,10,29,32,-3,30
Mattersburg,1750,5,6,7,11,32,43,-11,25
Vienna,1750,6,6,6,12,24,40,-16,24
SC Rheindorf,1750,7,5,7,12,21,30,-9,22
FC Salzburg,1751,1,13,8,3,44,23,21,47
SK Sturm Gra,1751,2,14,3,7,35,28,7,45
Rapid Vienna,1751,3,7,11,6,35,29,6,32
LASK Linz,1751,4,7,7,10,25,29,-4,28
SC Rheindorf,1751,5,7,6,11,23,28,-5,27
Mattersburg,1751,6,6,7,11,33,43,-10,25
Vienna,1751,7,6,6,12,24,39,-15,24
FC Salzburg,1752,1,16,6,2,44,16,28,54
SK Sturm Gra,1752,2,13,4,7,34,25,9,43
Rapid Vienna,1752,3,8,10,6,34,29,5,34
LASK Linz,1752,4,7,7,10,25,30,-5,28
Vienna,1752,5,7,5,12,26,40,-14,26
Mattersburg,1752,6,6,5,13,30,43,-13,23
SC Rheindorf,1752,7,5,7,12,20,30,-10,22
FC Salzburg,1753,1,12,9,3,40,18,22,45
SK Sturm Gra,1753,2,12,4,8,30,27,3,40
Rapid Vienna,1753,3,9,11,4,34,24,10,38
LASK Linz,1753,4,8,7,9,25,27,-2,31
Vienna,1753,5,6,7,11,26,40,-14,25
SC Rheindorf,1753,6,5,8,11,20,28,-8,23
Mattersburg,1753,7,5,8,11,30,41,-11,23
FC Salzburg,1754,1,15,6,3,43,18,25,51
Rapid Vienna,1754,2,9,10,5,39,27,12,37
SK Sturm Gra,1754,3,11,4,9,30,32,-2,37
LASK Linz,1754,4,8,8,8,26,25,1,32
Vienna,1754,5,7,5,12,25,39,-14,26
Mattersburg,1754,6,6,7,11,31,40,-9,25
SC Rheindorf,1754,7,5,6,13,20,33,-13,21
FC Salzburg,1755,1,15,6,3,49,18,31,51
SK Sturm Gra,1755,2,14,3,7,34,30,4,45
Rapid Vienna,1755,3,9,9,6,36,27,9,36
LASK Linz,1755,4,9,5,10,30,30,0,32
Mattersburg,1755,5,8,5,11,32,41,-9,29
Vienna,1755,6,6,5,13,24,42,-18,23
SC Rheindorf,1755,7,4,5,15,16,33,-17,17
FC Salzburg,1756,1,15,7,2,47,17,30,52
SK Sturm Gra,1756,2,13,3,8,31,29,2,42
Rapid Vienna,1756,3,9,9,6,39,29,10,36
Mattersburg,1756,4,8,6,10,35,39,-4,30
LASK Linz,1756,5,7,5,12,26,32,-6,26
SC Rheindorf,1756,6,6,5,13,20,35,-15,23
Vienna,1756,7,6,5,13,24,41,-17,23
FC Salzburg,1757,1,16,6,2,45,16,29,54
SK Sturm Gra,1757,2,12,3,9,31,32,-1,39
Rapid Vienna,1757,3,8,10,6,34,26,8,34
LASK Linz,1757,4,7,7,10,24,28,-4,28
Vienna,1757,5,7,5,12,26,40,-14,26
SC Rheindorf,1757,6,6,7,11,20,26,-6,25
Mattersburg,1757,7,6,6,12,31,43,-12,24
FC Salzburg,1758,1,15,7,2,44,17,27,52
SK Sturm Gra,1758,2,12,3,9,33,30,3,39
Rapid Vienna,1758,3,9,10,5,37,27,10,37
LASK Linz,1758,4,7,6,11,26,33,-7,27
Mattersburg,1758,5,7,6,11,34,44,-10,27
Vienna,1758,6,7,5,12,27,39,-12,26
SC Rheindorf,1758,7,5,7,12,19,30,-11,22
FC Salzburg,1759,1,15,6,3,48,18,30,51
SK Sturm Gra,1759,2,13,3,8,33,31,2,42
Rapid Vienna,1759,3,8,10,6,36,31,5,34
LASK Linz,1759,4,8,6,10,28,32,-4,30
Vienna,1759,5,8,5,11,30,38,-8,29
Mattersburg,1759,6,6,6,12,31,45,-14,24
SC Rheindorf,1759,7,5,6,13,19,30,-11,21
FC Salzburg,1760,1,14,7,3,43,17,26,49
SK Sturm Gra,1760,2,13,3,8,33,29,4,42
Rapid Vienna,1760,3,9,10,5,35,25,10,37
LASK Linz,1760,4,10,5,9,32,30,2,35
Mattersburg,1760,5,6,6,12,32,43,-11,24
Vienna,1760,6,6,6,12,24,41,-17,24
SC Rheindorf,1760,7,5,5,14,17,31,-14,20
FC Salzburg,1761,1,15,6,3,45,18,27,51
SK Sturm Gra,1761,2,13,3,8,36,32,4,42
Rapid Vienna,1761,3,9,9,6,37,28,9,36
LASK Linz,1761,4,10,6,8,32,29,3,36
Vienna,1761,5,7,5,12,28,40,-12,26
Mattersburg,1761,6,6,5,13,32,49,-17,23
SC Rheindorf,1761,7,4,6,14,21,35,-14,18
FC Salzburg,1762,1,14,6,4,45,19,26,48
Rapid Vienna,1762,2,11,9,4,40,28,12,42
SK Sturm Gra,1762,3,13,3,8,32,27,5,42
LASK Linz,1762,4,8,6,10,28,30,-2,30
Vienna,1762,5,6,6,12,25,40,-15,24
Mattersburg,1762,6,5,8,11,32,46,-14,23
SC Rheindorf,1762,7,5,6,13,22,34,-12,21
FC Salzburg,1763,1,16,6,2,49,21,28,54
SK Sturm Gra,1763,2,11,4,9,33,32,1,37
LASK Linz,1763,3,10,6,8,30,27,3,36
Rapid Vienna,1763,4,8,10,6,34,28,6,34
Vienna,1763,5,7,5,12,30,42,-12,26
SC Rheindorf,1763,6,5,7,12,18,28,-10,22
Mattersburg,1763,7,5,6,13,29,45,-16,21
FC Salzburg,1764,1,14,8,2,45,17,28,50
SK Sturm Gra,1764,2,13,4,7,32,28,4,43
Rapid Vienna,1764,3,8,11,5,35,26,9,35
LASK Linz,1764,4,8,5,11,28,32,-4,29
Mattersburg,1764,5,7,6,11,32,41,-9,27
Vienna,1764,6,7,5,12,26,41,-15,26
SC Rheindorf,1764,7,5,5,14,19,32,-13,20
FC Salzburg,1765,1,15,6,3,47,19,28,51
SK Sturm Gra,1765,2,13,3,8,31,31,0,42
Rapid Vienna,1765,3,8,11,5,39,31,8,35
Vienna,1765,4,8,5,11,28,39,-11,29
LASK Linz,1765,5,7,7,10,27,30,-3,28
Mattersburg,1765,6,6,6,12,30,41,-11,24
SC Rheindorf,1765,7,5,6,13,20,31,-11,21
SK Sturm Gra,1766,1,15,3,6,38,27,11,48
FC Salzburg,1766,2,12,7,5,42,23,19,43
Rapid Vienna,1766,3,9,9,6,38,31,7,36
LASK Linz,1766,4,9,5,10,30,31,-1,32
Mattersburg,1766,5,7,7,10,31,38,-7,28
Vienna,1766,6,7,6,11,26,39,-13,27
SC Rheindorf,1766,7,4,5,15,18,34,-16,17
FC Salzburg,1767,1,14,8,2,45,19,26,50
SK Sturm Gra,1767,2,12,4,8,33,32,1,40
Rapid Vienna,1767,3,9,11,4,38,27,11,38
LASK Linz,1767,4,7,7,10,28,31,-3,28
Vienna,1767,5,7,5,12,28,41,-13,26
Mattersburg,1767,6,5,8,11,30,42,-12,23
SC Rheindorf,1767,7,4,9,11,19,29,-10,21
FC Salzburg,1768,1,14,7,3,42,18,24,49
Rapid Vienna,1768,2,10,10,4,36,25,11,40
SK Sturm Gra,1768,3,11,4,9,32,33,-1,37
SC Rheindorf,1768,4,7,6,11,25,26,-1,27
LASK Linz,1768,5,7,6,11,25,33,-8,27
Mattersburg,1768,6,7,6,11,33,42,-9,27
Vienna,1768,7,6,5,13,24,40,-16,23
FC Salzburg,1769,1,16,6,2,50,19,31,54
SK Sturm Gra,1769,2,13,3,8,33,31,2,42
LASK Linz,1769,3,9,5,10,26,27,-1,32
Rapid Vienna,1769,4,7,10,7,34,30,4,31
Mattersburg,1769,5,7,5,12,33,44,-11,26
Vienna,1769,6,7,5,12,25,40,-15,26
SC Rheindorf,1769,7,5,6,13,22,32,-10,21
FC Salzburg,1770,1,16,6,2,49,17,32,54
SK Sturm Gra,1770,2,13,3,8,33,31,2,42
Rapid Vienna,1770,3,7,9,8,31,34,-3,30
LASK Linz,1770,4,8,5,11,27,27,0,29
SC Rheindorf,1770,5,7,5,12,24,29,-5,26
Mattersburg,1770,6,7,5,12,31,44,-13,26
Vienna,1770,7,7,5,12,26,39,-13,26
FC Salzburg,1771,1,15,6,3,43,17,26,51
SK Sturm Gra,1771,2,12,4,8,34,28,6,40
LASK Linz,1771,3,9,6,9,31,31,0,33
Rapid Vienna,1771,4,7,10,7,33,31,2,31
Vienna,1771,5,8,5,11,26,38,-12,29
SC Rheindorf,1771,6,6,6,12,19,27,-8,24
Mattersburg,1771,7,6,5,13,29,43,-14,23
FC Salzburg,1772,1,15,6,3,45,16,29,51
SK Sturm Gra,1772,2,13,4,7,33,26,7,43
Rapid Vienna,1772,3,7,11,6,34,31,3,32
LASK Linz,1772,4,8,6,10,29,31,-2,30
Vienna,1772,5,7,5,12,24,40,-16,26
Mattersburg,1772,6,6,6,12,31,45,-14,24
SC Rheindorf,1772,7,5,8,11,19,26,-7,23
FC Salzburg,1773,1,14,7,3,42,17,25,49
Rapid Vienna,1773,2,9,11,4,34,23,11,38
LASK Linz,1773,3,10,6,8,30,28,2,36
SK Sturm Gra,1773,4,11,3,10,30,33,-3,36
Vienna,1773,5,8,5,11,27,37,-10,29
Mattersburg,1773,6,6,5,13,29,43,-14,23
SC Rheindorf,1773,7,5,5,14,19,30,-11,20
FC Salzburg,1774,1,15,6,3,48,18,30,51
SK Sturm Gra,1774,2,12,4,8,35,33,2,40
Rapid Vienna,1774,3,8,10,6,36,30,6,34
LASK Linz,1774,4,8,6,10,29,33,-4,30
Vienna,1774,5,7,5,12,26,43,-17,26
SC Rheindorf,1774,6,6,7,11,19,26,-7,25
Mattersburg,1774,7,6,6,12,30,40,-10,24
FC Salzburg,1775,1,15,6,3,45,17,28,51
SK Sturm Gra,1775,2,12,5,7,31,27,4,41
Rapid Vienna,1775,3,9,9,6,35,27,8,36
LASK Linz,1775,4,8,7,9,28,29,-1,31
Vienna,1775,5,7,5,12,28,41,-13,26
Mattersburg,1775,6,6,6,12,33,47,-14,24
SC Rheindorf,1775,7,5,6,13,19,31,-12,21
FC Salzburg,1776,1,14,7,3,49,18,31,49
SK Sturm Gra,1776,2,12,4,8,34,36,-2,40
Rapid Vienna,1776,3,10,9,5,43,31,12,39
LASK Linz,1776,4,10,6,8,34,25,9,36
Mattersburg,1776,5,6,5,13,29,46,-17,23
Vienna,1776,6,6,5,13,23,43,-20,23
SC Rheindorf,1776,7,5,6,13,17,30,-13,21
FC Salzburg,1777,1,15,6,3,48,19,29,51
SK Sturm Gra,1777,2,13,3,8,32,30,2,42
Rapid Vienna,1777,3,9,9,6,39,27,12,36
LASK Linz,1777,4,8,5,11,25,32,-7,29
Vienna,1777,5,8,5,11,28,38,-10,29
Mattersburg,1777,6,7,5,12,32,44,-12,26
SC Rheindorf,1777,7,5,5,14,19,33,-14,20
FC Salzburg,1778,1,12,10,2,42,19,23,46
SK Sturm Gra,1778,2,12,6,6,33,28,5,42
Rapid Vienna,1778,3,8,12,4,38,26,12,36
LASK Linz,1778,4,8,7,9,25,26,-1,31
Mattersburg,1778,5,6,8,10,31,40,-9,26
Vienna,1778,6,6,7,11,24,38,-14,25
SC Rheindorf,1778,7,4,6,14,16,32,-16,18
FC Salzburg,1779,1,15,7,2,43,17,26,52
SK Sturm Gra,1779,2,13,4,7,32,26,6,43
Rapid Vienna,1779,3,8,10,6,34,28,6,34
LASK Linz,1779,4,8,7,9,28,29,-1,31
Vienna,1779,5,7,5,12,26,40,-14,26
Mattersburg,1779,6,6,6,12,29,40,-11,24
SC Rheindorf,1779,7,5,5,14,17,29,-12,20
FC Salzburg,1780,1,14,6,4,46,19,27,48
SK Sturm Gra,1780,2,11,5,8,32,31,1,38
Rapid Vienna,1780,3,9,10,5,36,27,9,37
LASK Linz,1780,4,8,7,9,29,30,-1,31
Mattersburg,1780,5,7,5,12,33,43,-10,26
Vienna,1780,6,7,5,12,24,41,-17,26
SC Rheindorf,1780,7,6,6,12,19,28,-9,24
FC Salzburg,1781,1,15,7,2,46,18,28,52
SK Sturm Gra,1781,2,12,4,8,34,29,5,40
Rapid Vienna,1781,3,8,10,6,34,31,3,34
LASK Linz,1781,4,8,6,10,28,31,-3,30
Vienna,1781,5,7,5,12,28,40,-12,26
SC Rheindorf,1781,6,6,7,11,21,28,-7,25
Mattersburg,1781,7,5,7,12,29,43,-14,22
FC Salzburg,1782,1,14,7,3,44,19,25,49
SK Sturm Gra,1782,2,12,5,7,30,26,4,41
Rapid Vienna,1782,3,8,9,7,36,30,6,33
LASK Linz,1782,4,8,7,9,27,27,0,31
Mattersburg,1782,5,7,7,10,33,41,-8,28
Vienna,1782,6,7,6,11,26,39,-13,27
SC Rheindorf,1782,7,4,7,13,17,31,-14,19
FC Salzburg,1783,1,15,7,2,48,19,29,52
SK Sturm Gra,1783,2,13,4,7,34,31,3,43
Rapid Vienna,1783,3,9,9,6,35,29,6,36
LASK Linz,1783,4,8,5,11,30,32,-2,29
Mattersburg,1783,5,7,6,11,36,43,-7,27
Vienna,1783,6,6,6,12,25,41,-16,24
SC Rheindorf,1783,7,5,5,14,17,30,-13,20
FC Salzburg,1784,1,14,6,4,44,20,24,48
SK Sturm Gra,1784,2,13,4,7,35,29,6,43
Rapid Vienna,1784,3,9,10,5,36,27,9,37
LASK Linz,1784,4,9,6,9,30,27,3,33
Mattersburg,1784,5,6,6,12,30,45,-15,24
Vienna,1784,6,6,6,12,24,40,-16,24
SC Rheindorf,1784,7,5,6,13,20,31,-11,21
FC Salzburg,1785,1,15,7,2,49,20,29,52
SK Sturm Gra,1785,2,11,5,8,31,30,1,38
Rapid Vienna,1785,3,8,11,5,37,28,9,35
LASK Linz,1785,4,8,7,9,28,29,-1,31
SC Rheindorf,1785,5,7,5,12,20,28,-8,26
Vienna,1785,6,7,5,12,27,39,-12,26
Mattersburg,1785,7,5,6,13,28,46,-18,21
FC Salzburg,1786,1,15,6,3,47,19,28,51
SK Sturm Gra,1786,2,14,4,6,36,25,11,46
Rapid Vienna,1786,3,7,9,8,32,31,1,30
LASK Linz,1786,4,8,6,10,27,30,-3,30
SC Rheindorf,1786,5,7,6,11,19,25,-6,27
Mattersburg,1786,6,6,6,12,31,43,-12,24
Vienna,1786,7,6,5,13,24,43,-19,23
FC Salzburg,1787,1,12,7,5,39,19,20,43
SK Sturm Gra,1787,2,13,4,7,35,30,5,43
Rapid Vienna,1787,3,8,9,7,33,27,6,33
Mattersburg,1787,4,9,5,10,32,38,-6,32
LASK Linz,1787,5,8,5,11,27,31,-4,29
SC Rheindorf,1787,6,7,5,12,21,28,-7,26
Vienna,1787,7,7,5,12,25,39,-14,26
FC Salzburg,1788,1,16,6,2,49,20,29,54
SK Sturm Gra,1788,2,12,3,9,34,32,2,39
Rapid Vienna,1788,3,9,9,6,43,34,9,36
LASK Linz,1788,4,9,6,9,29,30,-1,33
Vienna,1788,5,6,6,12,25,40,-15,24
SC Rheindorf,1788,6,6,5,13,20,30,-10,23
Mattersburg,1788,7,5,7,12,28,42,-14,22
FC Salzburg,1789,1,13,7,4,41,19,22,46
SK Sturm Gra,1789,2,12,5,7,31,28,3,41
Rapid Vienna,1789,3,10,9,5,39,26,13,39
LASK Linz,1789,4,8,6,10,26,31,-5,30
Vienna,1789,5,7,5,12,26,40,-14,26
Mattersburg,1789,6,6,7,11,32,42,-10,25
SC Rheindorf,1789,7,5,7,12,19,28,-9,22
FC Salzburg,1790,1,16,6,2,48,19,29,54
SK Sturm Gra,1790,2,12,5,7,35,32,3,41
Rapid Vienna,1790,3,8,10,6,36,28,8,34
LASK Linz,1790,4,7,7,10,25,31,-6,28
Mattersburg,1790,5,7,6,11,34,41,-7,27
Vienna,1790,6,6,6,12,26,42,-16,24
SC Rheindorf,1790,7,5,6,13,19,30,-11,21
FC Salzburg,1791,1,15,7,2,46,17,29,52
SK Sturm Gra,1791,2,12,5,7,33,29,4,41
Rapid Vienna,1791,3,8,11,5,36,28,8,35
LASK Linz,1791,4,8,6,10,29,32,-3,30
Vienna,1791,5,7,5,12,25,40,-15,26
Mattersburg,1791,6,6,6,12,28,41,-13,24
SC Rheindorf,1791,7,5,6,13,20,30,-10,21
FC Salzburg,1792,1,14,7,3,45,20,25,49
SK Sturm Gra,1792,2,13,4,7,34,30,4,43
Rapid Vienna,1792,3,9,10,5,37,26,11,37
LASK Linz,1792,4,10,5,9,29,28,1,35
Vienna,1792,5,7,5,12,24,38,-14,26
Mattersburg,1792,6,5,6,13,29,44,-15,21
SC Rheindorf,1792,7,4,7,13,18,30,-12,19
FC Salzburg,1793,1,16,6,2,49,18,31,54
SK Sturm Gra,1793,2,12,4,8,34,31,3,40
Rapid Vienna,1793,3,9,9,6,38,30,8,36
LASK Linz,1793,4,9,6,9,31,30,1,33
Vienna,1793,5,7,5,12,27,41,-14,26
Mattersburg,1793,6,6,6,12,31,44,-13,24
SC Rheindorf,1793,7,4,6,14,16,32,-16,18
FC Salzburg,1794,1,13,9,2,45,20,25,48
SK Sturm Gra,1794,2,12,5,7,32,27,5,41
Rapid Vienna,1794,3,10,9,5,37,26,11,39
Mattersburg,1794,4,7,6,11,35,45,-10,27
Vienna,1794,5,7,6,11,25,37,-12,27
LASK Linz,1794,6,7,5,12,26,33,-7,26
SC Rheindorf,1794,7,5,6,13,16,28,-12,21
FC Salzburg,1795,1,14,8,2,44,18,26,50
SK Sturm Gra,1795,2,12,4,8,33,29,4,40
Rapid Vienna,1795,3,8,10,6,35,29,6,34
LASK Linz,1795,4,9,5,10,28,30,-2,32
SC Rheindorf,1795,5,7,6,11,22,28,-6,27
Vienna,1795,6,7,6,11,29,41,-12,27
Mattersburg,1795,7,5,5,14,30,46,-16,20
FC Salzburg,1796,1,13,8,3,42,19,23,47
Rapid Vienna,1796,2,10,10,4,38,26,12,40
SK Sturm Gra,1796,3,12,3,9,31,29,2,39
Mattersburg,1796,4,8,6,10,36,43,-7,30
LASK Linz,1796,5,8,5,11,26,31,-5,29
Vienna,1796,6,6,6,12,27,42,-15,24
SC Rheindorf,1796,7,5,6,13,20,30,-10,21
FC Salzburg,1797,1,14,7,3,47,22,25,49
SK Sturm Gra,1797,2,11,7,6,32,28,4,40
Rapid Vienna,1797,3,9,11,4,36,26,10,38
LASK Linz,1797,4,7,7,10,25,29,-4,28
Mattersburg,1797,5,7,6,11,32,41,-9,27
Vienna,1797,6,6,5,13,24,41,-17,23
SC Rheindorf,1797,7,5,7,12,20,29,-9,22
FC Salzburg,1798,1,14,8,2,44,18,26,50
SK Sturm Gra,1798,2,11,4,9,30,31,-1,37
Rapid Vienna,1798,3,8,12,4,36,27,9,36
LASK Linz,1798,4,7,8,9,26,30,-4,29
Vienna,1798,5,7,6,11,27,39,-12,27
SC Rheindorf,1798,6,6,7,11,23,30,-7,25
Mattersburg,1798,7,6,5,13,32,43,-11,23
FC Salzburg,1799,1,13,7,4,44,21,23,46
SK Sturm Gra,1799,2,12,5,7,35,29,6,41
Rapid Vienna,1799,3,8,11,5,37,29,8,35
LASK Linz,1799,4,9,5,10,28,31,-3,32
Vienna,1799,5,7,6,11,26,39,-13,27
SC Rheindorf,1799,6,6,6,12,19,28,-9,24
Mattersburg,1799,7,6,6,12,28,40,-12,24
FC Salzburg,1800,1,16,6,2,47,17,30,54
SK Sturm Gra,1800,2,12,4,8,31,27,4,40
LASK Linz,1800,3,9,6,9,28,28,0,33
Rapid Vienna,1800,4,7,11,6,33,30,3,32
Mattersburg,1800,5,7,5,12,34,43,-9,26
Vienna,1800,6,7,5,12,28,42,-14,26
SC Rheindorf,1800,7,4,7,13,17,31,-14,19
FC Salzburg,1801,1,15,6,3,44,16,28,51
SK Sturm Gra,1801,2,12,5,7,32,29,3,41
Rapid Vienna,1801,3,8,9,7,34,30,4,33
LASK Linz,1801,4,8,8,8,31,30,1,32
SC Rheindorf,1801,5,6,7,11,18,25,-7,25
Mattersburg,1801,6,6,6,12,31,42,-11,24
Vienna,1801,7,6,5,13,23,41,-18,23
FC Salzburg,1802,1,14,7,3,47,18,29,49
SK Sturm Gra,1802,2,13,4,7,32,27,5,43
Rapid Vienna,1802,3,9,10,5,38,30,8,37
Vienna,1802,4,7,6,11,31,39,-8,27
LASK Linz,1802,5,7,5,12,25,31,-6,26
SC Rheindorf,1802,6,6,7,11,22,30,-8,25
Mattersburg,1802,7,6,5,13,28,48,-20,23
FC Salzburg,1803,1,14,8,2,46,16,30,50
Rapid Vienna,1803,2,10,10,4,35,24,11,40
SK Sturm Gra,1803,3,12,4,8,31,28,3,40
LASK Linz,1803,4,8,6,10,27,29,-2,30
Vienna,1803,5,7,5,12,27,42,-15,26
SC Rheindorf,1803,6,6,5,13,19,29,-10,23
Mattersburg,1803,7,5,6,13,30,47,-17,21
FC Salzburg,1804,1,15,6,3,46,20,26,51
SK Sturm Gra,1804,2,12,3,9,32,32,0,39
Rapid Vienna,1804,3,9,9,6,40,31,9,36
LASK Linz,1804,4,8,6,10,28,31,-3,30
Mattersburg,1804,5,7,6,11,32,41,-9,27
Vienna,1804,6,7,5,12,27,41,-14,26
SC Rheindorf,1804,7,6,5,13,23,32,-9,23
FC Salzburg,1805,1,14,6,4,45,23,22,48
SK Sturm Gra,1805,2,15,3,6,38,28,10,48
Rapid Vienna,1805,3,9,10,5,39,30,9,37
LASK Linz,1805,4,8,6,10,28,33,-5,30
Mattersburg,1805,5,6,6,12,30,40,-10,24
Vienna,1805,6,6,5,13,24,42,-18,23
SC Rheindorf,1805,7,5,6,13,22,30,-8,21
FC Salzburg,1806,1,15,6,3,49,18,31,51
Rapid Vienna,1806,2,9,10,5,37,27,10,37
SK Sturm Gra,1806,3,11,4,9,32,34,-2,37
LASK Linz,1806,4,10,6,8,36,27,9,36
Vienna,1806,5,7,5,12,24,40,-16,26
SC Rheindorf,1806,6,6,6,12,21,33,-12,24
Mattersburg,1806,7,5,5,14,29,49,-20,20
FC Salzburg,1807,1,16,6,2,50,19,31,54
SK Sturm Gra,1807,2,13,3,8,32,29,3,42
Rapid Vienna,1807,3,10,9,5,37,28,9,39
LASK Linz,1807,4,7,6,11,26,32,-6,27
Vienna,1807,5,7,5,12,26,40,-14,26
Mattersburg,1807,6,6,6,12,31,42,-11,24
SC Rheindorf,1807,7,4,7,13,17,29,-12,19
FC Salzburg,1808,1,14,7,3,46,19,27,49
SK Sturm Gra,1808,2,12,6,6,32,27,5,42
Rapid Vienna,1808,3,8,9,7,35,30,5,33
LASK Linz,1808,4,8,8,8,29,29,0,32
Vienna,1808,5,7,5,12,25,38,-13,26
Mattersburg,1808,6,6,6,12,31,44,-13,24
SC Rheindorf,1808,7,5,7,12,21,32,-11,22
FC Salzburg,1809,1,15,6,3,45,18,27,51
SK Sturm Gra,1809,2,12,3,9,30,30,0,39
Rapid Vienna,1809,3,9,10,5,36,25,11,37
LASK Linz,1809,4,8,6,10,25,28,-3,30
Vienna,1809,5,8,5,11,28,39,-11,29
Mattersburg,1809,6,7,5,12,31,42,-11,26
SC Rheindorf,1809,7,5,5,14,17,30,-13,20
FC Salzburg,1810,1,13,8,3,42,19,23,47
SK Sturm Gra,1810,2,13,4,7,31,26,5,43
Rapid Vienna,1810,3,8,12,4,38,28,10,36
LASK Linz,1810,4,8,6,10,27,30,-3,30
Vienna,1810,5,7,5,12,25,39,-14,26
Mattersburg,1810,6,6,6,12,31,40,-9,24
SC Rheindorf,1810,7,6,5,13,20,32,-12,23
FC Salzburg,1811,1,14,7,3,46,21,25,49
SK Sturm Gra,1811,2,13,3,8,36,32,4,42
Rapid Vienna,1811,3,10,10,4,41,28,13,40
LASK Linz,1811,4,8,6,10,25,28,-3,30
Mattersburg,1811,5,7,6,11,32,42,-10,27
Vienna,1811,6,6,5,13,26,42,-16,23
SC Rheindorf,1811,7,4,7,13,17,30,-13,19
SK Sturm Gra,1812,1,14,4,6,40,27,13,46
FC Salzburg,1812,2,12,8,4,43,22,21,44
Rapid Vienna,1812,3,10,9,5,35,27,8,39
LASK Linz,1812,4,8,6,10,26,30,-4,30
Vienna,1812,5,7,6,11,28,41,-13,27
Mattersburg,1812,6,5,7,12,30,43,-13,22
SC Rheindorf,1812,7,4,8,12,18,30,-12,20
FC Salzburg,1813,1,16,6,2,47,15,32,54
SK Sturm Gra,1813,2,13,3,8,32,28,4,42
Rapid Vienna,1813,3,9,9,6,35,27,8,36
LASK Linz,1813,4,7,6,11,25,32,-7,27
Mattersburg,1813,5,7,6,11,31,42,-11,27
SC Rheindorf,1813,6,6,5,13,21,29,-8,23
Vienna,1813,7,6,5,13,23,41,-18,23
FC Salzburg,1814,1,14,6,4,45,22,23,48
SK Sturm Gra,1814,2,13,4,7,36,30,6,43
Rapid Vienna,1814,3,10,9,5,39,29,10,39
LASK Linz,1814,4,9,6,9,29,31,-2,33
Mattersburg,1814,5,7,6,11,35,42,-7,27
Vienna,1814,6,6,5,13,26,42,-16,23
SC Rheindorf,1814,7,4,6,14,18,32,-14,18
FC Salzburg,1815,1,14,7,3,44,17,27,49
SK Sturm Gra,1815,2,13,4,7,33,27,6,43
LASK Linz,1815,3,10,5,9,29,27,2,35
Rapid Vienna,1815,4,7,11,6,33,29,4,32
SC Rheindorf,1815,5,7,5,12,20,28,-8,26
Vienna,1815,6,7,5,12,27,39,-12,26
Mattersburg,1815,7,5,5,14,28,47,-19,20
FC Salzburg,1816,1,16,6,2,46,15,31,54
SK Sturm Gra,1816,2,11,5,8,31,32,-1,38
Rapid Vienna,1816,3,8,10,6,34,27,7,34
LASK Linz,1816,4,7,7,10,27,31,-4,28
SC Rheindorf,1816,5,7,6,11,22,26,-4,27
Vienna,1816,6,7,5,12,26,40,-14,26
Mattersburg,1816,7,6,5,13,30,45,-15,23
FC Salzburg,1817,1,15,7,2,45,16,29,52
SK Sturm Gra,1817,2,13,4,7,32,27,5,43
Rapid Vienna,1817,3,8,9,7,32,27,5,33
LASK Linz,1817,4,9,6,9,27,26,1,33
Mattersburg,1817,5,8,5,11,32,41,-9,29
Vienna,1817,6,6,6,12,25,40,-15,24
SC Rheindorf,1817,7,4,5,15,17,33,-16,17
FC Salzburg,1818,1,14,7,3,45,21,24,49
SK Sturm Gra,1818,2,13,5,6,36,28,8,44
Rapid Vienna,1818,3,9,9,6,37,29,8,36
LASK Linz,1818,4,8,6,10,27,31,-4,30
Mattersburg,1818,5,7,5,12,34,43,-9,26
Vienna,1818,6,7,5,12,27,40,-13,26
SC Rheindorf,1818,7,4,7,13,16,30,-14,19
FC Salzburg,1819,1,13,6,5,43,23,20,45
SK Sturm Gra,1819,2,14,3,7,35,28,7,45
Rapid Vienna,1819,3,9,9,6,37,28,9,36
LASK Linz,1819,4,8,5,11,29,33,-4,29
Vienna,1819,5,8,5,11,28,39,-11,29
SC Rheindorf,1819,6,7,5,12,20,27,-7,26
Mattersburg,1819,7,6,5,13,30,44,-14,23
FC Salzburg,1820,1,14,7,3,48,21,27,49
Rapid Vienna,1820,2,10,9,5,40,28,12,39
SK Sturm Gra,1820,3,11,5,8,31,31,0,38
LASK Linz,1820,4,10,6,8,31,27,4,36
Vienna,1820,5,7,5,12,26,41,-15,26
Mattersburg,1820,6,5,7,12,29,43,-14,22
SC Rheindorf,1820,7,4,7,13,18,32,-14,19
FC Salzburg,1821,1,14,7,3,42,18,24,49
SK Sturm Gra,1821,2,11,6,7,32,30,2,39
Rapid Vienna,1821,3,9,10,5,39,28,11,37
LASK Linz,1821,4,8,8,8,29,29,0,32
Mattersburg,1821,5,7,6,11,31,40,-9,27
Vienna,1821,6,6,5,13,25,41,-16,23
SC Rheindorf,1821,7,4,8,12,19,31,-12,20
FC Salzburg,1822,1,14,7,3,48,21,27,49
SK Sturm Gra,1822,2,12,4,8,30,27,3,40
LASK Linz,1822,3,10,6,8,29,26,3,36
Rapid Vienna,1822,4,8,9,7,35,30,5,33
SC Rheindorf,1822,5,6,7,11,20,28,-8,25
Vienna,1822,6,6,7,11,26,40,-14,25
Mattersburg,1822,7,5,6,13,27,43,-16,21
FC Salzburg,1823,1,15,6,3,46,19,27,51
SK Sturm Gra,1823,2,13,3,8,35,30,5,42
Rapid Vienna,1823,3,9,10,5,37,29,8,37
LASK Linz,1823,4,9,5,10,29,28,1,32
Vienna,1823,5,7,5,12,25,39,-14,26
SC Rheindorf,1823,6,5,7,12,18,29,-11,22
Mattersburg,1823,7,5,6,13,26,42,-16,21
FC Salzburg,1824,1,12,8,4,40,19,21,44
SK Sturm Gra,1824,2,12,6,6,34,27,7,42
Rapid Vienna,1824,3,9,11,4,38,25,13,38
LASK Linz,1824,4,9,6,9,28,30,-2,33
Vienna,1824,5,8,5,11,26,38,-12,29
Mattersburg,1824,6,6,6,12,30,41,-11,24
SC Rheindorf,1824,7,4,6,14,17,33,-16,18
FC Salzburg,1825,1,14,6,4,48,22,26,48
SK Sturm Gra,1825,2,12,5,7,31,27,4,41
Rapid Vienna,1825,3,8,11,5,35,25,10,35
Vienna,1825,4,8,5,11,28,39,-11,29
LASK Linz,1825,5,7,7,10,24,30,-6,28
Mattersburg,1825,6,7,5,12,32,47,-15,26
SC Rheindorf,1825,7,5,7,12,22,30,-8,22
FC Salzburg,1826,1,16,6,2,44,15,29,54
SK Sturm Gra,1826,2,12,5,7,36,29,7,41
Rapid Vienna,1826,3,7,10,7,32,34,-2,31
LASK Linz,1826,4,8,6,10,31,30,1,30
Mattersburg,1826,5,8,5,11,32,41,-9,29
Vienna,1826,6,6,5,13,24,40,-16,23
SC Rheindorf,1826,7,5,7,12,16,26,-10,22
FC Salzburg,1827,1,14,8,2,50,19,31,50
SK Sturm Gra,1827,2,13,3,8,34,31,3,42
Rapid Vienna,1827,3,10,10,4,41,28,13,40
Mattersburg,1827,4,7,6,11,34,42,-8,27
LASK Linz,1827,5,7,6,11,27,35,-8,27
Vienna,1827,6,7,5,12,26,41,-15,26
SC Rheindorf,1827,7,4,6,14,18,34,-16,18
FC Salzburg,1828,1,15,7,2,46,17,29,52
SK Sturm Gra,1828,2,13,4,7,34,27,7,43
Rapid Vienna,1828,3,10,9,5,37,25,12,39
LASK Linz,1828,4,7,7,10,27,34,-7,28
Mattersburg,1828,5,7,6,11,33,41,-8,27
Vienna,1828,6,6,5,13,24,44,-20,23
SC Rheindorf,1828,7,4,6,14,18,31,-13,18
FC Salzburg,1829,1,15,6,3,47,19,28,51
SK Sturm Gra,1829,2,12,4,8,32,30,2,40
Rapid Vienna,1829,3,8,10,6,36,33,3,34
LASK Linz,1829,4,8,7,9,28,29,-1,31
Vienna,1829,5,7,6,11,25,38,-13,27
SC Rheindorf,1829,6,6,6,12,22,29,-7,24
Mattersburg,1829,7,5,7,12,28,40,-12,22
FC Salzburg,1830,1,15,6,3,48,19,29,51
SK Sturm Gra,1830,2,13,3,8,33,30,3,42
Rapid Vienna,1830,3,9,9,6,34,26,8,36
LASK Linz,1830,4,8,6,10,26,32,-6,30
Vienna,1830,5,7,5,12,30,42,-12,26
Mattersburg,1830,6,6,6,12,33,45,-12,24
SC Rheindorf,1830,7,5,7,12,18,28,-10,22
FC Salzburg,1831,1,15,7,2,46,20,26,52
SK Sturm Gra,1831,2,12,5,7,33,29,4,41
LASK Linz,1831,3,9,7,8,28,25,3,34
Rapid Vienna,1831,4,7,9,8,36,34,2,30
Vienna,1831,5,7,5,12,29,42,-13,26
SC Rheindorf,1831,6,6,7,11,19,26,-7,25
Mattersburg,1831,7,5,6,13,28,43,-15,21
FC Salzburg,1832,1,13,7,4,44,20,24,46
SK Sturm Gra,1832,2,13,4,7,35,28,7,43
Rapid Vienna,1832,3,8,11,5,37,28,9,35
LASK Linz,1832,4,8,7,9,28,29,-1,31
Vienna,1832,5,7,6,11,25,38,-13,27
SC Rheindorf,1832,6,6,6,12,20,30,-10,24
Mattersburg,1832,7,5,7,12,29,45,-16,22
FC Salzburg,1833,1,14,6,4,42,21,21,48
SK Sturm Gra,1833,2,12,4,8,30,29,1,40
Rapid Vienna,1833,3,9,9,6,37,30,7,36
LASK Linz,1833,4,9,7,8,31,26,5,34
Mattersburg,1833,5,6,7,11,31,42,-11,25
Vienna,1833,6,6,6,12,26,41,-15,24
SC Rheindorf,1833,7,5,7,12,22,30,-8,22
FC Salzburg,1834,1,15,7,2,46,19,27,52
SK Sturm Gra,1834,2,13,3,8,31,28,3,42
Rapid Vienna,1834,3,9,9,6,37,27,10,36
LASK Linz,1834,4,10,5,9,30,26,4,35
Mattersburg,1834,5,6,7,11,31,43,-12,25
Vienna,1834,6,6,5,13,26,42,-16,23
SC Rheindorf,1834,7,4,6,14,18,34,-16,18
FC Salzburg,1835,1,15,6,3,48,18,30,51
Rapid Vienna,1835,2,10,10,4,37,26,11,40
SK Sturm Gra,1835,3,12,4,8,35,31,4,40
LASK Linz,1835,4,8,5,11,25,30,-5,29
Mattersburg,1835,5,7,6,11,37,45,-8,27
Vienna,1835,6,6,6,12,25,41,-16,24
SC Rheindorf,1835,7,5,5,14,17,33,-16,20
FC Salzburg,1836,1,15,6,3,46,18,28,51
SK Sturm Gra,1836,2,11,5,8,29,30,-1,38
Rapid Vienna,1836,3,8,10,6,33,26,7,34
LASK Linz,1836,4,8,6,10,26,28,-2,30
Mattersburg,1836,5,7,6,11,34,41,-7,27
SC Rheindorf,1836,6,7,5,12,19,29,-10,26
Vienna,1836,7,6,6,12,26,41,-15,24
FC Salzburg,1837,1,15,6,3,44,17,27,51
SK Sturm Gra,1837,2,13,4,7,35,31,4,43
Rapid Vienna,1837,3,8,11,5,40,31,9,35
LASK Linz,1837,4,8,5,11,27,31,-4,29
Mattersburg,1837,5,7,6,11,32,39,-7,27
Vienna,1837,6,6,6,12,24,40,-16,24
SC Rheindorf,1837,7,5,6,13,19,32,-13,21
FC Salzburg,1838,1,15,6,3,50,16,34,51
SK Sturm Gra,1838,2,11,4,9,29,31,-2,37
Rapid Vienna,1838,3,8,10,6,36,31,5,34
LASK Linz,1838,4,9,6,9,29,31,-2,33
Mattersburg,1838,5,7,6,11,36,43,-7,27
Vienna,1838,6,7,6,11,26,39,-13,27
SC Rheindorf,1838,7,5,6,13,17,32,-15,21
FC Salzburg,1839,1,14,7,3,45,19,26,49
SK Sturm Gra,1839,2,14,3,7,33,28,5,45
Rapid Vienna,1839,3,9,9,6,35,29,6,36
LASK Linz,1839,4,8,6,10,28,32,-4,30
Mattersburg,1839,5,7,7,10,30,38,-8,28
Vienna,1839,6,6,5,13,24,41,-17,23
SC Rheindorf,1839,7,5,5,14,20,28,-8,20
FC Salzburg,1840,1,16,6,2,54,18,36,54
SK Sturm Gra,1840,2,12,3,9,33,31,2,39
Rapid Vienna,1840,3,7,10,7,33,32,1,31
LASK Linz,1840,4,8,6,10,26,28,-2,30
SC Rheindorf,1840,5,8,5,11,21,26,-5,29
Vienna,1840,6,7,5,12,27,45,-18,26
Mattersburg,1840,7,6,5,13,32,46,-14,23
FC Salzburg,1841,1,14,7,3,46,20,26,49
SK Sturm Gra,1841,2,12,5,7,32,30,2,41
Rapid Vienna,1841,3,7,13,4,39,31,8,34
Mattersburg,1841,4,9,5,10,33,37,-4,32
LASK Linz,1841,5,7,6,11,25,29,-4,27
Vienna,1841,6,6,5,13,23,40,-17,23
SC Rheindorf,1841,7,5,7,12,20,31,-11,22
FC Salzburg,1842,1,13,7,4,44,23,21,46
SK Sturm Gra,1842,2,12,5,7,32,28,4,41
Rapid Vienna,1842,3,8,11,5,35,26,9,35
LASK Linz,1842,4,7,7,10,25,28,-3,28
Mattersburg,1842,5,7,7,10,30,38,-8,28
Vienna,1842,6,7,6,11,29,41,-12,27
SC Rheindorf,1842,7,5,7,12,18,29,-11,22
FC Salzburg,1843,1,14,7,3,47,19,28,49
SK Sturm Gra,1843,2,12,3,9,30,30,0,39
Rapid Vienna,1843,3,9,10,5,34,27,7,37
LASK Linz,1843,4,9,5,10,30,30,0,32
Vienna,1843,5,8,5,11,29,40,-11,29
SC Rheindorf,1843,6,6,5,13,20,28,-8,23
Mattersburg,1843,7,6,5,13,32,48,-16,23
FC Salzburg,1844,1,15,7,2,48,19,29,52
SK Sturm Gra,1844,2,13,4,7,34,29,5,43
LASK Linz,1844,3,9,7,8,29,26,3,34
Rapid Vienna,1844,4,8,9,7,35,31,4,33
Vienna,1844,5,7,6,11,27,40,-13,27
Mattersburg,1844,6,5,6,13,31,47,-16,21
SC Rheindorf,1844,7,4,7,13,18,30,-12,19
FC Salzburg,1845,1,12,8,4,44,25,19,44
SK Sturm Gra,1845,2,13,3,8,34,30,4,42
Rapid Vienna,1845,3,9,10,5,38,28,10,37
LASK Linz,1845,4,9,6,9,29,28,1,33
Vienna,1845,5,7,6,11,30,41,-11,27
Mattersburg,1845,6,5,8,11,31,43,-12,23
SC Rheindorf,1845,7,5,7,12,18,29,-11,22
FC Salzburg,1846,1,15,6,3,46,19,27,51
SK Sturm Gra,1846,2,12,4,8,30,29,1,40
Rapid Vienna,1846,3,10,9,5,39,28,11,39
LASK Linz,1846,4,8,6,10,27,29,-2,30
Mattersburg,1846,5,8,5,11,31,38,-7,29
Vienna,1846,6,6,5,13,23,41,-18,23
SC Rheindorf,1846,7,4,7,13,18,30,-12,19
FC Salzburg,1847,1,14,7,3,44,17,27,49
SK Sturm Gra,1847,2,12,4,8,30,30,0,40
Rapid Vienna,1847,3,8,9,7,33,28,5,33
LASK Linz,1847,4,8,5,11,27,30,-3,29
Mattersburg,1847,5,8,5,11,29,39,-10,29
Vienna,1847,6,7,6,11,27,38,-11,27
SC Rheindorf,1847,7,6,6,12,20,28,-8,24
FC Salzburg,1848,1,16,6,2,49,18,31,54
SK Sturm Gra,1848,2,12,4,8,32,28,4,40
Rapid Vienna,1848,3,9,9,6,34,30,4,36
LASK Linz,1848,4,7,8,9,26,28,-2,29
Vienna,1848,5,6,6,12,25,41,-16,24
Mattersburg,1848,6,5,8,11,30,41,-11,23
SC Rheindorf,1848,7,5,7,12,18,28,-10,22
FC Salzburg,1849,1,15,6,3,46,20,26,51
SK Sturm Gra,1849,2,12,3,9,32,30,2,39
LASK Linz,1849,3,10,5,9,31,29,2,35
Rapid Vienna,1849,4,7,9,8,35,33,2,30
Vienna,1849,5,8,5,11,28,38,-10,29
SC Rheindorf,1849,6,6,6,12,22,31,-9,24
Mattersburg,1849,7,6,6,12,31,44,-13,24
FC Salzburg,1850,1,14,8,2,46,18,28,50
SK Sturm Gra,1850,2,14,3,7,35,28,7,45
Rapid Vienna,1850,3,8,11,5,39,31,8,35
Mattersburg,1850,4,7,7,10,34,38,-4,28
LASK Linz,1850,5,7,6,11,28,36,-8,27
Vienna,1850,6,6,5,13,23,43,-20,23
SC Rheindorf,1850,7,4,8,12,18,29,-11,20
FC Salzburg,1851,1,13,8,3,42,20,22,47
Rapid Vienna,1851,2,11,9,4,37,24,13,42
SK Sturm Gra,1851,3,13,3,8,34,30,4,42
LASK Linz,1851,4,7,6,11,30,37,-7,27
Vienna,1851,5,7,6,11,26,39,-13,27
Mattersburg,1851,6,6,7,11,36,45,-9,25
SC Rheindorf,1851,7,5,5,14,22,32,-10,20
FC Salzburg,1852,1,16,6,2,49,18,31,54
SK Sturm Gra,1852,2,13,4,7,36,31,5,43
Rapid Vienna,1852,3,8,11,5,36,30,6,35
LASK Linz,1852,4,7,6,11,29,33,-4,27
Mattersburg,1852,5,7,5,12,33,44,-11,26
Vienna,1852,6,7,5,12,27,41,-14,26
SC Rheindorf,1852,7,5,5,14,20,33,-13,20
FC Salzburg,1853,1,14,6,4,43,20,23,48
SK Sturm Gra,1853,2,13,5,6,35,29,6,44
Rapid Vienna,1853,3,9,9,6,39,27,12,36
LASK Linz,1853,4,9,6,9,30,30,0,33
Vienna,1853,5,7,5,12,25,39,-14,26
SC Rheindorf,1853,6,5,7,12,24,37,-13,22
Mattersburg,1853,7,5,6,13,30,44,-14,21
FC Salzburg,1854,1,13,6,5,41,19,22,45
SK Sturm Gra,1854,2,13,4,7,30,25,5,43
Rapid Vienna,1854,3,9,9,6,37,29,8,36
LASK Linz,1854,4,9,5,10,29,28,1,32
Vienna,1854,5,8,5,11,26,38,-12,29
SC Rheindorf,1854,6,6,7,11,19,27,-8,25
Mattersburg,1854,7,5,6,13,28,44,-16,21
FC Salzburg,1855,1,15,7,2,46,17,29,52
SK Sturm Gra,1855,2,13,5,6,34,27,7,44
Rapid Vienna,1855,3,7,12,5,34,27,7,33
LASK Linz,1855,4,8,6,10,26,28,-2,30
Mattersburg,1855,5,6,7,11,33,43,-10,25
Vienna,1855,6,6,6,12,24,40,-16,24
SC Rheindorf,1855,7,4,7,13,18,33,-15,19
FC Salzburg,1856,1,14,7,3,45,18,27,49
SK Sturm Gra,1856,2,12,5,7,31,29,2,41
Rapid Vienna,1856,3,10,9,5,41,29,12,39
LASK Linz,1856,4,8,5,11,26,32,-6,29
SC Rheindorf,1856,5,7,6,11,24,28,-4,27
Vienna,1856,6,7,5,12,25,41,-16,26
Mattersburg,1856,7,5,5,14,28,43,-15,20
FC Salzburg,1857,1,14,8,2,45,18,27,50
SK Sturm Gra,1857,2,14,4,6,36,24,12,46
Rapid Vienna,1857,3,8,11,5,33,26,7,35
LASK Linz,1857,4,9,6,9,27,28,-1,33
Vienna,1857,5,7,5,12,26,39,-13,26
Mattersburg,1857,6,6,5,13,29,44,-15,23
SC Rheindorf,1857,7,4,5,15,16,33,-17,17
FC Salzburg,1858,1,12,8,4,40,22,18,44
SK Sturm Gra,1858,2,13,4,7,33,27,6,43
LASK Linz,1858,3,9,7,8,26,25,1,34
Rapid Vienna,1858,4,7,12,5,34,27,7,33
Vienna,1858,5,8,5,11,30,39,-9,29
SC Rheindorf,1858,6,6,6,12,18,27,-9,24
Mattersburg,1858,7,5,6,13,29,43,-14,21
FC Salzburg,1859,1,14,8,2,47,21,26,50
SK Sturm Gra,1859,2,12,5,7,34,31,3,41
Rapid Vienna,1859,3,7,11,6,35,29,6,32
LASK Linz,1859,4,8,6,10,28,29,-1,30
SC Rheindorf,1859,5,7,6,11,22,28,-6,27
Vienna,1859,6,6,7,11,26,40,-14,25
Mattersburg,1859,7,5,7,12,30,44,-14,22
FC Salzburg,1860,1,14,8,2,46,19,27,50
SK Sturm Gra,1860,2,11,5,8,32,31,1,38
Rapid Vienna,1860,3,8,10,6,37,33,4,34
LASK Linz,1860,4,9,6,9,29,27,2,33
Vienna,1860,5,6,7,11,25,39,-14,25
SC Rheindorf,1860,6,6,6,12,23,31,-8,24
Mattersburg,1860,7,5,8,11,31,43,-12,23
FC Salzburg,1861,1,15,7,2,48,16,32,52
SK Sturm Gra,1861,2,13,3,8,33,33,0,42
LASK Linz,1861,3,10,5,9,28,27,1,35
Rapid Vienna,1861,4,7,9,8,35,36,-1,30
Vienna,1861,5,7,6,11,25,37,-12,27
SC Rheindorf,1861,6,6,5,13,22,28,-6,23
Mattersburg,1861,7,6,5,13,27,41,-14,23
FC Salzburg,1862,1,15,6,3,46,19,27,51
SK Sturm Gra,1862,2,12,4,8,33,30,3,40
Rapid Vienna,1862,3,9,10,5,38,27,11,37
LASK Linz,1862,4,8,7,9,26,28,-2,31
Mattersburg,1862,5,7,6,11,33,41,-8,27
Vienna,1862,6,6,6,12,25,41,-16,24
SC Rheindorf,1862,7,4,7,13,16,31,-15,19
FC Salzburg,1863,1,15,7,2,45,15,30,52
SK Sturm Gra,1863,2,12,5,7,33,30,3,41
Rapid Vienna,1863,3,8,11,5,34,26,8,35
LASK Linz,1863,4,7,8,9,25,28,-3,29
Mattersburg,1863,5,6,6,12,29,42,-13,24
Vienna,1863,6,6,6,12,24,39,-15,24
SC Rheindorf,1863,7,6,5,13,18,28,-10,23
FC Salzburg,1864,1,14,7,3,46,22,24,49
SK Sturm Gra,1864,2,12,5,7,33,28,5,41
Rapid Vienna,1864,3,7,12,5,34,28,6,33
LASK Linz,1864,4,7,9,8,27,28,-1,30
Mattersburg,1864,5,7,6,11,32,42,-10,27
SC Rheindorf,1864,6,5,8,11,21,27,-6,23
Vienna,1864,7,6,5,13,25,43,-18,23
FC Salzburg,1865,1,15,7,2,45,16,29,52
SK Sturm Gra,1865,2,13,4,7,35,26,9,43
Rapid Vienna,1865,3,8,11,5,34,27,7,35
LASK Linz,1865,4,8,6,10,27,32,-5,30
Mattersburg,1865,5,7,5,12,34,44,-10,26
Vienna,1865,6,6,5,13,27,44,-17,23
SC Rheindorf,1865,7,5,6,13,18,31,-13,21
FC Salzburg,1866,1,13,7,4,41,20,21,46
SK Sturm Gra,1866,2,12,4,8,30,27,3,40
Rapid Vienna,1866,3,8,9,7,37,29,8,33
Mattersburg,1866,4,9,5,10,37,39,-2,32
LASK Linz,1866,5,9,5,10,27,30,-3,32
SC Rheindorf,1866,6,7,5,12,20,29,-9,26
Vienna,1866,7,6,5,13,24,42,-18,23
FC Salzburg,1867,1,15,7,2,46,17,29,52
Rapid Vienna,1867,2,9,11,4,36,25,11,38
SK Sturm Gra,1867,3,11,5,8,32,32,0,38
LASK Linz,1867,4,9,7,8,29,25,4,34
Mattersburg,1867,5,7,5,12,29,39,-10,26
Vienna,1867,6,6,5,13,23,41,-18,23
SC Rheindorf,1867,7,4,6,14,17,33,-16,18
FC Salzburg,1868,1,14,7,3,44,19,25,49
SK Sturm Gra,1868,2,13,5,6,35,26,9,44
Rapid Vienna,1868,3,7,10,7,33,30,3,31
LASK Linz,1868,4,7,6,11,26,32,-6,27
Vienna,1868,5,7,6,11,25,38,-13,27
SC Rheindorf,1868,6,6,7,11,19,27,-8,25
Mattersburg,1868,7,6,7,11,31,41,-10,25
FC Salzburg,1869,1,16,6,2,48,16,32,54
Rapid Vienna,1869,2,10,9,5,40,27,13,39
SK Sturm Gra,1869,3,11,3,10,32,32,0,36
LASK Linz,1869,4,9,5,10,30,35,-5,32
Vienna,1869,5,7,5,12,26,41,-15,26
SC Rheindorf,1869,6,6,6,12,22,30,-8,24
Mattersburg,1869,7,5,6,13,31,48,-17,21
FC Salzburg,1870,1,14,7,3,44,18,26,49
SK Sturm Gra,1870,2,13,5,6,33,27,6,44
Rapid Vienna,1870,3,9,11,4,35,25,10,38
Mattersburg,1870,4,8,5,11,34,39,-5,29
LASK Linz,1870,5,7,7,10,23,27,-4,28
Vienna,1870,6,6,5,13,24,43,-19,23
SC Rheindorf,1870,7,4,6,14,16,30,-14,18
FC Salzburg,1871,1,14,6,4,48,22,26,48
SK Sturm Gra,1871,2,12,3,9,31,34,-3,39
LASK Linz,1871,3,10,5,9,29,29,0,35
Rapid Vienna,1871,4,8,10,6,36,28,8,34
Mattersburg,1871,5,8,5,11,35,42,-7,29
Vienna,1871,6,7,5,12,27,42,-15,26
SC Rheindorf,1871,7,5,6,13,21,30,-9,21
FC Salzburg,1872,1,14,8,2,43,16,27,50
SK Sturm Gra,1872,2,12,4,8,29,26,3,40
Rapid Vienna,1872,3,9,10,5,33,24,9,37
LASK Linz,1872,4,7,7,10,24,28,-4,28
Vienna,1872,5,7,5,12,25,41,-16,26
SC Rheindorf,1872,6,6,6,12,19,27,-8,24
Mattersburg,1872,7,5,8,11,30,41,-11,23
FC Salzburg,1873,1,15,7,2,47,16,31,52
Rapid Vienna,1873,2,9,11,4,37,25,12,38
SK Sturm Gra,1873,3,11,5,8,30,29,1,38
LASK Linz,1873,4,7,7,10,25,30,-5,28
Mattersburg,1873,5,6,7,11,32,42,-10,25
Vienna,1873,6,6,6,12,25,43,-18,24
SC Rheindorf,1873,7,5,7,12,17,28,-11,22
FC Salzburg,1874,1,14,7,3,46,20,26,49
Rapid Vienna,1874,2,10,9,5,37,27,10,39
SK Sturm Gra,1874,3,12,3,9,31,31,0,39
LASK Linz,1874,4,8,6,10,30,33,-3,30
SC Rheindorf,1874,5,7,5,12,21,27,-6,26
Mattersburg,1874,6,6,6,12,31,42,-11,24
Vienna,1874,7,6,6,12,25,41,-16,24
FC Salzburg,1875,1,15,6,3,44,16,28,51
SK Sturm Gra,1875,2,12,4,8,30,28,2,40
Rapid Vienna,1875,3,7,12,5,34,28,6,33
LASK Linz,1875,4,8,7,9,29,31,-2,31
Vienna,1875,5,8,5,11,27,39,-12,29
Mattersburg,1875,6,6,5,13,33,45,-12,23
SC Rheindorf,1875,7,5,7,12,22,32,-10,22
FC Salzburg,1876,1,14,7,3,42,17,25,49
SK Sturm Gra,1876,2,13,3,8,34,28,6,42
Rapid Vienna,1876,3,9,9,6,38,30,8,36
LASK Linz,1876,4,9,5,10,28,30,-2,32
Vienna,1876,5,6,7,11,27,41,-14,25
Mattersburg,1876,6,6,6,12,30,42,-12,24
SC Rheindorf,1876,7,6,5,13,20,31,-11,23
FC Salzburg,1877,1,15,6,3,47,18,29,51
SK Sturm Gra,1877,2,11,4,9,28,28,0,37
Rapid Vienna,1877,3,7,12,5,34,30,4,33
LASK Linz,1877,4,9,6,9,27,27,0,33
Mattersburg,1877,5,9,5,10,34,37,-3,32
Vienna,1877,6,6,5,13,24,42,-18,23
SC Rheindorf,1877,7,5,6,13,19,31,-12,21
FC Salzburg,1878,1,14,6,4,47,22,25,48
SK Sturm Gra,1878,2,14,3,7,35,28,7,45
Rapid Vienna,1878,3,8,10,6,35,29,6,34
Mattersburg,1878,4,8,5,11,34,40,-6,29
LASK Linz,1878,5,7,7,10,27,31,-4,28
Vienna,1878,6,7,5,12,25,39,-14,26
SC Rheindorf,1878,7,5,6,13,17,31,-14,21
FC Salzburg,1879,1,15,7,2,46,19,27,52
SK Sturm Gra,1879,2,12,5,7,31,25,6,41
Rapid Vienna,1879,3,8,11,5,36,30,6,35
LASK Linz,1879,4,8,6,10,27,29,-2,30
Mattersburg,1879,5,7,5,12,33,45,-12,26
Vienna,1879,6,7,5,12,27,40,-13,26
SC Rheindorf,1879,7,4,7,13,17,29,-12,19
FC Salzburg,1880,1,15,7,2,50,19,31,52
SK Sturm Gra,1880,2,11,7,6,30,26,4,40
Rapid Vienna,1880,3,7,12,5,34,30,4,33
LASK Linz,1880,4,8,7,9,29,27,2,31
Mattersburg,1880,5,7,5,12,33,42,-9,26
Vienna,1880,6,7,5,12,27,43,-16,26
SC Rheindorf,1880,7,4,7,13,17,33,-16,19
FC Salzburg,1881,1,14,8,2,46,19,27,50
SK Sturm Gra,1881,2,12,4,8,32,30,2,40
LASK Linz,1881,3,10,6,8,32,27,5,36
Rapid Vienna,1881,4,7,10,7,35,32,3,31
Mattersburg,1881,5,6,7,11,29,41,-12,25
Vienna,1881,6,6,7,11,25,39,-14,25
SC Rheindorf,1881,7,5,6,13,19,30,-11,21
FC Salzburg,1882,1,13,8,3,46,24,22,47
SK Sturm Gra,1882,2,12,5,7,35,31,4,41
Rapid Vienna,1882,3,8,11,5,38,32,6,35
LASK Linz,1882,4,9,6,9,30,28,2,33
Mattersburg,1882,5,7,7,10,34,40,-6,28
Vienna,1882,6,6,5,13,25,42,-17,23
SC Rheindorf,1882,7,4,8,12,19,30,-11,20
FC Salzburg,1883,1,16,6,2,52,20,32,54
SK Sturm Gra,1883,2,13,4,7,35,30,5,43
LASK Linz,1883,3,10,5,9,28,25,3,35
Rapid Vienna,1883,4,7,11,6,34,28,6,32
Mattersburg,1883,5,7,5,12,33,46,-13,26
Vienna,1883,6,6,5,13,24,44,-20,23
SC Rheindorf,1883,7,4,6,14,18,31,-13,18
FC Salzburg,1884,1,15,6,3,47,17,30,51
SK Sturm Gra,1884,2,12,3,9,31,29,2,39
Rapid Vienna,1884,3,9,10,5,38,29,9,37
LASK Linz,1884,4,8,7,9,27,28,-1,31
Mattersburg,1884,5,6,7,11,31,44,-13,25
Vienna,1884,6,6,6,12,24,41,-17,24
SC Rheindorf,1884,7,6,5,13,20,30,-10,23
FC Salzburg,1885,1,15,7,2,46,18,28,52
SK Sturm Gra,1885,2,13,4,7,34,26,8,43
Rapid Vienna,1885,3,9,9,6,36,27,9,36
LASK Linz,1885,4,8,6,10,27,31,-4,30
Vienna,1885,5,7,5,12,26,40,-14,26
Mattersburg,1885,6,6,5,13,29,43,-14,23
SC Rheindorf,1885,7,5,6,13,18,31,-13,21
FC Salzburg,1886,1,14,7,3,43,19,24,49
SK Sturm Gra,1886,2,12,4,8,31,30,1,40
Rapid Vienna,1886,3,7,13,4,36,28,8,34
LASK Linz,1886,4,9,6,9,27,27,0,33
Vienna,1886,5,7,5,12,28,40,-12,26
SC Rheindorf,1886,6,6,7,11,21,27,-6,25
Mattersburg,1886,7,5,6,13,28,43,-15,21
FC Salzburg,1887,1,12,9,3,42,20,22,45
SK Sturm Gra,1887,2,12,5,7,31,27,4,41
Rapid Vienna,1887,3,10,10,4,36,25,11,40
LASK Linz,1887,4,9,5,10,27,30,-3,32
Mattersburg,1887,5,8,6,10,33,38,-5,30
Vienna,1887,6,6,6,12,24,39,-15,24
SC Rheindorf,1887,7,4,5,15,16,30,-14,17
FC Salzburg,1888,1,14,7,3,47,20,27,49
SK Sturm Gra,1888,2,13,5,6,33,27,6,44
Rapid Vienna,1888,3,8,12,4,36,27,9,36
LASK Linz,1888,4,7,7,10,25,28,-3,28
Mattersburg,1888,5,7,6,11,32,41,-9,27
Vienna,1888,6,6,6,12,24,40,-16,24
SC Rheindorf,1888,7,4,7,13,15,29,-14,19
FC Salzburg,1889,1,14,7,3,43,17,26,49
Rapid Vienna,1889,2,11,9,4,38,24,14,42
SK Sturm Gra,1889,3,11,3,10,30,33,-3,36
LASK Linz,1889,4,8,5,11,28,31,-3,29
SC Rheindorf,1889,5,7,5,12,24,29,-5,26
Mattersburg,1889,6,7,5,12,31,45,-14,26
Vienna,1889,7,6,6,12,24,39,-15,24
FC Salzburg,1890,1,16,6,2,46,16,30,54
SK Sturm Gra,1890,2,12,5,7,36,33,3,41
Rapid Vienna,1890,3,8,10,6,35,28,7,34
LASK Linz,1890,4,8,5,11,31,39,-8,29
Vienna,1890,5,7,5,12,26,38,-12,26
Mattersburg,1890,6,6,6,12,30,43,-13,24
SC Rheindorf,1890,7,5,7,12,22,29,-7,22
FC Salzburg,1891,1,16,6,2,47,16,31,54
Rapid Vienna,1891,2,9,9,6,38,28,10,36
SK Sturm Gra,1891,3,11,3,10,28,29,-1,36
LASK Linz,1891,4,9,6,9,27,27,0,33
Vienna,1891,5,7,5,12,26,41,-15,26
SC Rheindorf,1891,6,6,6,12,17,28,-11,24
Mattersburg,1891,7,6,5,13,30,44,-14,23
FC Salzburg,1892,1,16,6,2,50,18,32,54
SK Sturm Gra,1892,2,13,3,8,33,31,2,42
Rapid Vienna,1892,3,7,10,7,35,33,2,31
LASK Linz,1892,4,8,6,10,28,33,-5,30
Vienna,1892,5,7,5,12,26,40,-14,26
Mattersburg,1892,6,6,6,12,30,38,-8,24
SC Rheindorf,1892,7,5,8,11,20,29,-9,23
FC Salzburg,1893,1,13,9,2,47,22,25,48
SK Sturm Gra,1893,2,12,3,9,32,31,1,39
Rapid Vienna,1893,3,9,11,4,40,29,11,38
Mattersburg,1893,4,8,6,10,33,39,-6,30
LASK Linz,1893,5,7,5,12,23,30,-7,26
SC Rheindorf,1893,6,6,6,12,22,30,-8,24
Vienna,1893,7,6,6,12,26,42,-16,24
FC Salzburg,1894,1,14,6,4,43,17,26,48
Rapid Vienna,1894,2,10,9,5,36,24,12,39
SK Sturm Gra,1894,3,12,3,9,30,30,0,39
Mattersburg,1894,4,9,5,10,34,37,-3,32
LASK Linz,1894,5,8,5,11,25,29,-4,29
SC Rheindorf,1894,6,6,5,13,18,31,-13,23
Vienna,1894,7,6,5,13,23,41,-18,23
FC Salzburg,1895,1,14,8,2,44,17,27,50
SK Sturm Gra,1895,2,12,4,8,36,31,5,40
Rapid Vienna,1895,3,10,9,5,38,28,10,39
Mattersburg,1895,4,8,6,10,34,38,-4,30
LASK Linz,1895,5,7,7,10,27,30,-3,28
Vienna,1895,6,6,6,12,23,41,-18,24
SC Rheindorf,1895,7,4,6,14,18,35,-17,18
FC Salzburg,1896,1,15,6,3,43,17,26,51
SK Sturm Gra,1896,2,12,4,8,33,31,2,40
Rapid Vienna,1896,3,8,11,5,33,25,8,35
LASK Linz,1896,4,9,6,9,28,28,0,33
SC Rheindorf,1896,5,6,7,11,22,28,-6,25
Mattersburg,1896,6,6,5,13,30,43,-13,23
Vienna,1896,7,6,5,13,24,41,-17,23
FC Salzburg,1897,1,16,6,2,46,16,30,54
SK Sturm Gra,1897,2,13,4,7,35,28,7,43
LASK Linz,1897,3,9,7,8,27,25,2,34
Rapid Vienna,1897,4,8,9,7,36,32,4,33
Mattersburg,1897,5,7,6,11,30,39,-9,27
Vienna,1897,6,6,5,13,23,41,-18,23
SC Rheindorf,1897,7,4,5,15,16,32,-16,17
FC Salzburg,1898,1,15,6,3,48,19,29,51
Rapid Vienna,1898,2,10,9,5,38,26,12,39
SK Sturm Gra,1898,3,11,3,10,31,32,-1,36
LASK Linz,1898,4,9,7,8,28,27,1,34
Vienna,1898,5,7,5,12,25,39,-14,26
SC Rheindorf,1898,6,6,6,12,18,28,-10,24
Mattersburg,1898,7,5,6,13,27,44,-17,21
FC Salzburg,1899,1,15,6,3,45,18,27,51
SK Sturm Gra,1899,2,14,4,6,34,25,9,46
Rapid Vienna,1899,3,8,9,7,34,31,3,33
LASK Linz,1899,4,9,5,10,28,29,-1,32
Mattersburg,1899,5,7,6,11,31,40,-9,27
Vienna,1899,6,6,5,13,23,40,-17,23
SC Rheindorf,1899,7,4,7,13,17,29,-12,19
FC Salzburg,1900,1,15,6,3,47,20,27,51
SK Sturm Gra,1900,2,12,4,8,30,29,1,40
Rapid Vienna,1900,3,10,9,5,38,28,10,39
LASK Linz,1900,4,7,7,10,24,27,-3,28
Mattersburg,1900,5,7,6,11,31,43,-12,27
Vienna,1900,6,7,5,12,28,39,-11,26
SC Rheindorf,1900,7,4,7,13,18,30,-12,19
FC Salzburg,1901,1,15,6,3,48,17,31,51
SK Sturm Gra,1901,2,12,4,8,34,32,2,40
Rapid Vienna,1901,3,10,9,5,37,25,12,39
LASK Linz,1901,4,8,6,10,26,30,-4,30
Mattersburg,1901,5,7,5,12,29,41,-12,26
Vienna,1901,6,7,5,12,24,41,-17,26
SC Rheindorf,1901,7,4,7,13,19,31,-12,19
FC Salzburg,1902,1,15,6,3,47,19,28,51
SK Sturm Gra,1902,2,14,3,7,41,28,13,45
Rapid Vienna,1902,3,8,10,6,32,25,7,34
LASK Linz,1902,4,9,5,10,26,33,-7,32
Mattersburg,1902,5,7,6,11,32,41,-9,27
Vienna,1902,6,6,6,12,27,43,-16,24
SC Rheindorf,1902,7,4,6,14,16,32,-16,18
FC Salzburg,1903,1,14,8,2,46,19,27,50
SK Sturm Gra,1903,2,13,3,8,33,27,6,42
Rapid Vienna,1903,3,9,10,5,35,27,8,37
LASK Linz,1903,4,8,6,10,26,28,-2,30
Vienna,1903,5,7,6,11,29,39,-10,27
Mattersburg,1903,6,6,6,12,29,45,-16,24
SC Rheindorf,1903,7,5,5,14,17,30,-13,20
FC Salzburg,1904,1,15,6,3,44,18,26,51
SK Sturm Gra,1904,2,14,3,7,36,28,8,45
Rapid Vienna,1904,3,9,10,5,37,29,8,37
LASK Linz,1904,4,8,5,11,27,31,-4,29
Mattersburg,1904,5,7,6,11,32,40,-8,27
Vienna,1904,6,6,5,13,25,42,-17,23
SC Rheindorf,1904,7,4,7,13,17,30,-13,19
FC Salzburg,1905,1,14,6,4,42,18,24,48
SK Sturm Gra,1905,2,14,3,7,34,28,6,45
Rapid Vienna,1905,3,9,10,5,36,27,9,37
Mattersburg,1905,4,8,6,10,34,40,-6,30
LASK Linz,1905,5,7,7,10,28,32,-4,28
Vienna,1905,6,6,5,13,24,41,-17,23
SC Rheindorf,1905,7,4,7,13,18,30,-12,19
FC Salzburg,1906,1,14,6,4,45,20,25,48
SK Sturm Gra,1906,2,12,5,7,34,32,2,41
Rapid Vienna,1906,3,8,10,6,34,26,8,34
LASK Linz,1906,4,8,6,10,25,31,-6,30
Mattersburg,1906,5,7,6,11,32,40,-8,27
Vienna,1906,6,7,5,12,26,40,-14,26
SC Rheindorf,1906,7,6,6,12,22,29,-7,24
FC Salzburg,1907,1,15,6,3,46,17,29,51
SK Sturm Gra,1907,2,12,5,7,34,30,4,41
Rapid Vienna,1907,3,7,11,6,33,29,4,32
LASK Linz,1907,4,8,7,9,26,27,-1,31
Vienna,1907,5,7,5,12,26,40,-14,26
SC Rheindorf,1907,6,6,6,12,20,28,-8,24
Mattersburg,1907,7,6,6,12,30,44,-14,24
FC Salzburg,1908,1,13,9,2,45,20,25,48
SK Sturm Gra,1908,2,13,5,6,36,29,7,44
Rapid Vienna,1908,3,7,13,4,36,28,8,34
LASK Linz,1908,4,8,7,9,29,29,0,31
Vienna,1908,5,7,6,11,29,40,-11,27
SC Rheindorf,1908,6,5,6,13,21,34,-13,21
Mattersburg,1908,7,5,6,13,29,45,-16,21
FC Salzburg,1909,1,14,8,2,45,16,29,50
SK Sturm Gra,1909,2,12,4,8,32,31,1,40
Rapid Vienna,1909,3,9,10,5,38,29,9,37
LASK Linz,1909,4,7,6,11,23,29,-6,27
Mattersburg,1909,5,7,6,11,31,38,-7,27
Vienna,1909,6,6,7,11,23,37,-14,25
SC Rheindorf,1909,7,6,5,13,19,31,-12,23
FC Salzburg,1910,1,15,6,3,46,17,29,51
SK Sturm Gra,1910,2,11,4,9,29,29,0,37
Rapid Vienna,1910,3,9,9,6,34,27,7,36
LASK Linz,1910,4,10,5,9,27,25,2,35
Mattersburg,1910,5,8,5,11,31,42,-11,29
Vienna,1910,6,7,5,12,26,39,-13,26
SC Rheindorf,1910,7,4,6,14,15,29,-14,18
FC Salzburg,1911,1,13,7,4,44,21,23,46
SK Sturm Gra,1911,2,12,6,6,33,28,5,42
Rapid Vienna,1911,3,9,9,6,35,28,7,36
LASK Linz,1911,4,8,7,9,30,32,-2,31
Mattersburg,1911,5,7,7,10,31,38,-7,28
Vienna,1911,6,6,5,13,25,43,-18,23
SC Rheindorf,1911,7,5,7,12,21,29,-8,22
FC Salzburg,1912,1,14,6,4,45,21,24,48
SK Sturm Gra,1912,2,14,4,6,35,27,8,46
Rapid Vienna,1912,3,8,11,5,34,26,8,35
LASK Linz,1912,4,8,5,11,27,29,-2,29
Vienna,1912,5,8,5,11,30,39,-9,29
Mattersburg,1912,6,7,5,12,31,44,-13,26
SC Rheindorf,1912,7,4,6,14,18,34,-16,18
FC Salzburg,1913,1,14,8,2,42,17,25,50
SK Sturm Gra,1913,2,12,6,6,33,28,5,42
Rapid Vienna,1913,3,8,11,5,36,27,9,35
LASK Linz,1913,4,9,7,8,29,27,2,34
Vienna,1913,5,7,5,12,25,39,-14,26
Mattersburg,1913,6,6,5,13,32,43,-11,23
SC Rheindorf,1913,7,4,6,14,17,33,-16,18
FC Salzburg,1914,1,14,7,3,44,21,23,49
SK Sturm Gra,1914,2,11,5,8,29,28,1,38
Rapid Vienna,1914,3,8,11,5,35,27,8,35
LASK Linz,1914,4,9,6,9,27,28,-1,33
Vienna,1914,5,8,5,11,29,39,-10,29
SC Rheindorf,1914,6,6,5,13,22,30,-8,23
Mattersburg,1914,7,6,5,13,31,44,-13,23
FC Salzburg,1915,1,14,8,2,48,20,28,50
SK Sturm Gra,1915,2,13,5,6,36,28,8,44
Rapid Vienna,1915,3,8,11,5,37,32,5,35
LASK Linz,1915,4,7,8,9,25,29,-4,29
Mattersburg,1915,5,7,6,11,32,37,-5,27
Vienna,1915,6,6,6,12,25,44,-19,24
SC Rheindorf,1915,7,4,6,14,17,30,-13,18
FC Salzburg,1916,1,14,7,3,50,20,30,49
SK Sturm Gra,1916,2,14,3,7,34,25,9,45
LASK Linz,1916,3,9,5,10,25,26,-1,32
Rapid Vienna,1916,4,7,9,8,32,33,-1,30
SC Rheindorf,1916,5,7,5,12,21,30,-9,26
Mattersburg,1916,6,7,5,12,33,45,-12,26
Vienna,1916,7,6,6,12,26,42,-16,24
FC Salzburg,1917,1,15,7,2,46,18,28,52
SK Sturm Gra,1917,2,12,4,8,31,30,1,40
Rapid Vienna,1917,3,9,10,5,35,27,8,37
LASK Linz,1917,4,7,7,10,26,29,-3,28
Mattersburg,1917,5,6,8,10,33,42,-9,26
Vienna,1917,6,6,5,13,24,40,-16,23
SC Rheindorf,1917,7,5,7,12,18,27,-9,22
FC Salzburg,1918,1,16,6,2,45,18,27,54
SK Sturm Gra,1918,2,12,3,9,35,32,3,39
Rapid Vienna,1918,3,8,10,6,38,31,7,34
LASK Linz,1918,4,9,6,9,29,30,-1,33
SC Rheindorf,1918,5,6,7,11,21,29,-8,25
Mattersburg,1918,6,6,5,13,30,42,-12,23
Vienna,1918,7,6,5,13,24,40,-16,23
FC Salzburg,1919,1,15,6,3,42,16,26,51
SK Sturm Gra,1919,2,12,4,8,31,28,3,40
Rapid Vienna,1919,3,7,10,7,31,28,3,31
LASK Linz,1919,4,8,7,9,26,27,-1,31
Vienna,1919,5,7,5,12,28,39,-11,26
Mattersburg,1919,6,7,5,12,30,43,-13,26
SC Rheindorf,1919,7,6,7,11,20,27,-7,25
FC Salzburg,1920,1,14,7,3,47,22,25,49
SK Sturm Gra,1920,2,13,4,7,33,27,6,43
Rapid Vienna,1920,3,8,9,7,35,28,7,33
LASK Linz,1920,4,8,6,10,28,33,-5,30
Vienna,1920,5,7,6,11,27,39,-12,27
Mattersburg,1920,6,6,6,12,31,44,-13,24
SC Rheindorf,1920,7,5,8,11,20,28,-8,23
FC Salzburg,1921,1,15,6,3,46,20,26,51
SK Sturm Gra,1921,2,11,6,7,31,30,1,39
Rapid Vienna,1921,3,8,10,6,39,30,9,34
LASK Linz,1921,4,9,6,9,31,29,2,33
Vienna,1921,5,7,5,12,27,39,-12,26
SC Rheindorf,1921,6,6,6,12,18,30,-12,24
Mattersburg,1921,7,6,5,13,29,43,-14,23
FC Salzburg,1922,1,15,7,2,45,16,29,52
SK Sturm Gra,1922,2,12,4,8,33,32,1,40
Rapid Vienna,1922,3,8,11,5,36,29,7,35
LASK Linz,1922,4,9,5,10,31,30,1,32
Vienna,1922,5,7,6,11,24,37,-13,27
Mattersburg,1922,6,6,5,13,29,43,-14,23
SC Rheindorf,1922,7,5,6,13,18,29,-11,21
FC Salzburg,1923,1,14,6,4,45,18,27,48
SK Sturm Gra,1923,2,12,5,7,33,30,3,41
Rapid Vienna,1923,3,9,10,5,35,28,7,37
LASK Linz,1923,4,9,7,8,33,26,7,34
Mattersburg,1923,5,7,5,12,30,43,-13,26
Vienna,1923,6,7,5,12,24,39,-15,26
SC Rheindorf,1923,7,4,6,14,17,33,-16,18
FC Salzburg,1924,1,15,7,2,47,19,28,52
SK Sturm Gra,1924,2,11,5,8,33,32,1,38
Rapid Vienna,1924,3,7,12,5,36,29,7,33
LASK Linz,1924,4,7,7,10,26,30,-4,28
SC Rheindorf,1924,5,7,6,11,22,27,-5,27
Mattersburg,1924,6,7,6,11,32,40,-8,27
Vienna,1924,7,6,5,13,24,43,-19,23
FC Salzburg,1925,1,15,6,3,46,20,26,51
SK Sturm Gra,1925,2,13,3,8,36,27,9,42
Rapid Vienna,1925,3,9,9,6,39,37,2,36
LASK Linz,1925,4,9,6,9,29,27,2,33
Vienna,1925,5,7,5,12,25,38,-13,26
Mattersburg,1925,6,6,6,12,30,42,-12,24
SC Rheindorf,1925,7,5,5,14,18,32,-14,20
FC Salzburg,1926,1,15,6,3,44,17,27,51
SK Sturm Gra,1926,2,13,4,7,31,28,3,43
Rapid Vienna,1926,3,9,10,5,37,26,11,37
LASK Linz,1926,4,8,8,8,31,28,3,32
Vienna,1926,5,7,5,12,25,39,-14,26
Mattersburg,1926,6,5,6,13,29,43,-14,21
SC Rheindorf,1926,7,5,5,14,17,33,-16,20
FC Salzburg,1927,1,16,6,2,45,16,29,54
SK Sturm Gra,1927,2,13,4,7,34,30,4,43
Rapid Vienna,1927,3,8,10,6,37,30,7,34
LASK Linz,1927,4,8,5,11,25,29,-4,29
Mattersburg,1927,5,7,6,11,30,38,-8,27
Vienna,1927,6,6,5,13,23,40,-17,23
SC Rheindorf,1927,7,4,8,12,19,30,-11,20
FC Salzburg,1928,1,14,6,4,46,29,17,48
LASK Linz,1928,2,11,5,8,33,25,8,38
Rapid Vienna,1928,3,9,10,5,41,29,12,37
SK Sturm Gra,1928,4,11,4,9,31,34,-3,37
Mattersburg,1928,5,7,5,12,36,40,-4,26
Vienna,1928,6,7,5,12,27,42,-15,26
SC Rheindorf,1928,7,5,5,14,18,33,-15,20
FC Salzburg,1929,1,13,9,2,45,18,27,48
SK Sturm Gra,1929,2,12,4,8,33,30,3,40
Rapid Vienna,1929,3,9,11,4,35,24,11,38
LASK Linz,1929,4,9,6,9,27,27,0,33
Vienna,1929,5,7,6,11,25,38,-13,27
Mattersburg,1929,6,5,7,12,28,43,-15,22
SC Rheindorf,1929,7,4,7,13,17,30,-13,19
FC Salzburg,1930,1,14,7,3,45,19,26,49
Rapid Vienna,1930,2,10,10,4,36,25,11,40
SK Sturm Gra,1930,3,11,5,8,29,28,1,38
LASK Linz,1930,4,8,6,10,25,30,-5,30
Vienna,1930,5,7,5,12,25,40,-15,26
Mattersburg,1930,6,6,7,11,33,40,-7,25
SC Rheindorf,1930,7,4,8,12,18,29,-11,20
FC Salzburg,1931,1,14,7,3,45,19,26,49
SK Sturm Gra,1931,2,14,3,7,34,28,6,45
Rapid Vienna,1931,3,9,10,5,38,26,12,37
Mattersburg,1931,4,8,6,10,35,40,-5,30
LASK Linz,1931,5,8,5,11,25,29,-4,29
Vienna,1931,6,6,5,13,24,44,-20,23
SC Rheindorf,1931,7,4,6,14,18,33,-15,18
FC Salzburg,1932,1,14,6,4,43,21,22,48
SK Sturm Gra,1932,2,12,4,8,31,28,3,40
Rapid Vienna,1932,3,9,9,6,38,29,9,36
LASK Linz,1932,4,9,5,10,27,27,0,32
Vienna,1932,5,8,5,11,27,38,-11,29
Mattersburg,1932,6,7,5,12,30,41,-11,26
SC Rheindorf,1932,7,5,6,13,18,30,-12,21
FC Salzburg,1933,1,15,7,2,48,17,31,52
SK Sturm Gra,1933,2,13,4,7,33,29,4,43
Rapid Vienna,1933,3,9,9,6,39,31,8,36
SC Rheindorf,1933,4,7,5,12,26,31,-5,26
LASK Linz,1933,5,7,5,12,25,32,-7,26
Mattersburg,1933,6,6,6,12,34,49,-15,24
Vienna,1933,7,6,6,12,24,40,-16,24
FC Salzburg,1934,1,16,6,2,45,15,30,54
SK Sturm Gra,1934,2,12,4,8,32,29,3,40
Rapid Vienna,1934,3,10,9,5,42,27,15,39
LASK Linz,1934,4,8,6,10,27,32,-5,30
Vienna,1934,5,7,5,12,25,40,-15,26
Mattersburg,1934,6,6,5,13,29,41,-12,23
SC Rheindorf,1934,7,5,5,14,18,34,-16,20
FC Salzburg,1935,1,15,6,3,45,18,27,51
SK Sturm Gra,1935,2,13,3,8,32,30,2,42
Rapid Vienna,1935,3,9,10,5,38,26,12,37
LASK Linz,1935,4,7,7,10,26,30,-4,28
Mattersburg,1935,5,7,6,11,32,41,-9,27
Vienna,1935,6,6,6,12,25,41,-16,24
SC Rheindorf,1935,7,5,6,13,21,33,-12,21
FC Salzburg,1936,1,14,6,4,44,21,23,48
SK Sturm Gra,1936,2,13,4,7,36,30,6,43
Rapid Vienna,1936,3,9,9,6,38,31,7,36
LASK Linz,1936,4,8,5,11,26,30,-4,29
Vienna,1936,5,8,5,11,28,39,-11,29
SC Rheindorf,1936,6,6,6,12,25,30,-5,24
Mattersburg,1936,7,6,5,13,29,45,-16,23
FC Salzburg,1937,1,15,7,2,50,19,31,52
SK Sturm Gra,1937,2,14,3,7,37,30,7,45
Rapid Vienna,1937,3,8,9,7,36,32,4,33
LASK Linz,1937,4,8,5,11,27,32,-5,29
Mattersburg,1937,5,7,6,11,33,41,-8,27
Vienna,1937,6,6,6,12,26,41,-15,24
SC Rheindorf,1937,7,5,6,13,19,33,-14,21
FC Salzburg,1938,1,16,6,2,44,16,28,54
SK Sturm Gra,1938,2,12,5,7,35,30,5,41
Rapid Vienna,1938,3,8,10,6,36,28,8,34
LASK Linz,1938,4,9,5,10,26,29,-3,32
Mattersburg,1938,5,8,5,11,32,38,-6,29
Vienna,1938,6,6,5,13,24,41,-17,23
SC Rheindorf,1938,7,4,6,14,16,31,-15,18
FC Salzburg,1939,1,14,7,3,43,19,24,49
SK Sturm Gra,1939,2,14,4,6,37,25,12,46
Rapid Vienna,1939,3,9,10,5,39,29,10,37
LASK Linz,1939,4,8,5,11,27,35,-8,29
Vienna,1939,5,7,5,12,28,38,-10,26
Mattersburg,1939,6,6,5,13,29,47,-18,23
SC Rheindorf,1939,7,5,6,13,22,32,-10,21
FC Salzburg,1940,1,14,6,4,46,19,27,48
SK Sturm Gra,1940,2,11,6,7,29,29,0,39
Rapid Vienna,1940,3,8,11,5,35,26,9,35
LASK Linz,1940,4,8,7,9,26,28,-2,31
Vienna,1940,5,7,6,11,25,37,-12,27
Mattersburg,1940,6,6,7,11,29,42,-13,25
SC Rheindorf,1940,7,5,7,12,20,29,-9,22
FC Salzburg,1941,1,14,7,3,43,19,24,49
SK Sturm Gra,1941,2,11,6,7,32,29,3,39
Rapid Vienna,1941,3,8,10,6,37,30,7,34
LASK Linz,1941,4,9,5,10,27,29,-2,32
Vienna,1941,5,7,6,11,25,38,-13,27
Mattersburg,1941,6,6,6,12,32,41,-9,24
SC Rheindorf,1941,7,6,6,12,23,33,-10,24
FC Salzburg,1942,1,13,9,2,44,20,24,48
SK Sturm Gra,1942,2,11,6,7,33,31,2,39
Rapid Vienna,1942,3,8,10,6,37,29,8,34
Mattersburg,1942,4,8,6,10,35,38,-3,30
LASK Linz,1942,5,8,6,10,29,33,-4,30
SC Rheindorf,1942,6,6,6,12,21,31,-10,24
Vienna,1942,7,6,5,13,25,42,-17,23
FC Salzburg,1943,1,13,8,3,39,16,23,47
SK Sturm Gra,1943,2,11,5,8,28,28,0,38
Rapid Vienna,1943,3,9,9,6,33,26,7,36
LASK Linz,1943,4,9,6,9,30,28,2,33
Vienna,1943,5,8,5,11,27,37,-10,29
SC Rheindorf,1943,6,6,6,12,19,27,-8,24
Mattersburg,1943,7,5,7,12,29,43,-14,22
FC Salzburg,1944,1,13,9,2,40,16,24,48
SK Sturm Gra,1944,2,12,4,8,32,29,3,40
Rapid Vienna,1944,3,9,11,4,37,25,12,38
LASK Linz,1944,4,8,6,10,27,32,-5,30
Mattersburg,1944,5,7,6,11,33,40,-7,27
Vienna,1944,6,6,7,11,25,39,-14,25
SC Rheindorf,1944,7,5,5,14,17,30,-13,20
FC Salzburg,1945,1,14,7,3,45,20,25,49
SK Sturm Gra,1945,2,13,4,7,33,28,5,43
Rapid Vienna,1945,3,8,11,5,37,27,10,35
Mattersburg,1945,4,9,5,10,36,41,-5,32
LASK Linz,1945,5,8,6,10,28,29,-1,30
Vienna,1945,6,6,5,13,24,40,-16,23
SC Rheindorf,1945,7,4,6,14,16,34,-18,18
FC Salzburg,1946,1,14,8,2,48,20,28,50
SK Sturm Gra,1946,2,12,4,8,33,31,2,40
Rapid Vienna,1946,3,8,10,6,36,30,6,34
LASK Linz,1946,4,9,5,10,28,31,-3,32
Vienna,1946,5,7,6,11,29,40,-11,27
SC Rheindorf,1946,6,6,7,11,24,30,-6,25
Mattersburg,1946,7,5,6,13,30,46,-16,21
FC Salzburg,1947,1,14,8,2,41,15,26,50
Rapid Vienna,1947,2,9,10,5,36,25,11,37
SK Sturm Gra,1947,3,11,4,9,32,35,-3,37
LASK Linz,1947,4,8,7,9,30,29,1,31
Mattersburg,1947,5,7,6,11,31,40,-9,27
Vienna,1947,6,7,6,11,26,39,-13,27
SC Rheindorf,1947,7,5,5,14,20,33,-13,20
FC Salzburg,1948,1,13,7,4,43,23,20,46
SK Sturm Gra,1948,2,13,5,6,31,24,7,44
Rapid Vienna,1948,3,9,9,6,39,29,10,36
LASK Linz,1948,4,9,7,8,29,27,2,34
Mattersburg,1948,5,5,9,10,33,43,-10,24
Vienna,1948,6,6,6,12,26,41,-15,24
SC Rheindorf,1948,7,4,7,13,15,29,-14,19
FC Salzburg,1949,1,15,7,2,48,19,29,52
SK Sturm Gra,1949,2,13,3,8,34,30,4,42
Rapid Vienna,1949,3,8,10,6,37,30,7,34
LASK Linz,1949,4,7,7,10,25,29,-4,28
Vienna,1949,5,7,6,11,27,38,-11,27
Mattersburg,1949,6,6,6,12,31,45,-14,24
SC Rheindorf,1949,7,5,7,12,21,32,-11,22
FC Salzburg,1950,1,16,6,2,48,17,31,54
SK Sturm Gra,1950,2,12,3,9,32,32,0,39
LASK Linz,1950,3,9,6,9,28,28,0,33
Rapid Vienna,1950,4,7,9,8,35,32,3,30
Mattersburg,1950,5,7,5,12,31,41,-10,26
Vienna,1950,6,7,5,12,28,44,-16,26
SC Rheindorf,1950,7,6,6,12,19,27,-8,24
FC Salzburg,1951,1,15,6,3,46,20,26,51
SK Sturm Gra,1951,2,13,4,7,35,28,7,43
Rapid Vienna,1951,3,9,11,4,36,24,12,38
LASK Linz,1951,4,7,6,11,25,29,-4,27
Mattersburg,1951,5,7,6,11,31,40,-9,27
Vienna,1951,6,6,6,12,27,43,-16,24
SC Rheindorf,1951,7,5,5,14,19,35,-16,20
FC Salzburg,1952,1,14,6,4,45,22,23,48
SK Sturm Gra,1952,2,13,3,8,31,28,3,42
Rapid Vienna,1952,3,9,9,6,36,26,10,36
LASK Linz,1952,4,9,5,10,27,28,-1,32
Mattersburg,1952,5,8,5,11,35,40,-5,29
Vienna,1952,6,7,5,12,25,43,-18,26
SC Rheindorf,1952,7,5,5,14,17,29,-12,20
FC Salzburg,1953,1,13,7,4,44,21,23,46
SK Sturm Gra,1953,2,14,3,7,36,28,8,45
Rapid Vienna,1953,3,9,10,5,33,24,9,37
LASK Linz,1953,4,7,6,11,25,31,-6,27
Vienna,1953,5,7,5,12,25,40,-15,26
Mattersburg,1953,6,6,7,11,30,40,-10,25
SC Rheindorf,1953,7,5,8,11,17,26,-9,23
FC Salzburg,1954,1,15,6,3,45,19,26,51
Rapid Vienna,1954,2,9,11,4,39,26,13,38
SK Sturm Gra,1954,3,11,5,8,32,31,1,38
LASK Linz,1954,4,9,6,9,29,30,-1,33
Vienna,1954,5,7,5,12,27,39,-12,26
SC Rheindorf,1954,6,5,8,11,21,29,-8,23
Mattersburg,1954,7,5,5,14,26,45,-19,20
FC Salzburg,1955,1,15,7,2,46,19,27,52
SK Sturm Gra,1955,2,11,4,9,31,32,-1,37
LASK Linz,1955,3,10,5,9,28,26,2,35
Rapid Vienna,1955,4,7,10,7,34,30,4,31
Mattersburg,1955,5,7,6,11,33,40,-7,27
SC Rheindorf,1955,6,7,5,12,22,29,-7,26
Vienna,1955,7,6,5,13,24,42,-18,23
FC Salzburg,1956,1,15,6,3,48,19,29,51
SK Sturm Gra,1956,2,13,4,7,32,28,4,43
Rapid Vienna,1956,3,9,10,5,35,27,8,37
LASK Linz,1956,4,9,5,10,28,28,0,32
Mattersburg,1956,5,6,7,11,29,39,-10,25
Vienna,1956,6,6,6,12,24,40,-16,24
SC Rheindorf,1956,7,4,6,14,17,32,-15,18
FC Salzburg,1957,1,15,7,2,50,16,34,52
SK Sturm Gra,1957,2,14,3,7,32,29,3,45
Rapid Vienna,1957,3,8,10,6,32,28,4,34
LASK Linz,1957,4,9,5,10,28,29,-1,32
Vienna,1957,5,7,5,12,26,43,-17,26
Mattersburg,1957,6,6,5,13,32,43,-11,23
SC Rheindorf,1957,7,5,5,14,18,30,-12,20
FC Salzburg,1958,1,15,7,2,44,18,26,52
SK Sturm Gra,1958,2,14,3,7,33,27,6,45
Rapid Vienna,1958,3,7,11,6,33,28,5,32
LASK Linz,1958,4,8,5,11,26,28,-2,29
Mattersburg,1958,5,7,5,12,30,40,-10,26
Vienna,1958,6,7,5,12,24,38,-14,26
SC Rheindorf,1958,7,5,6,13,18,29,-11,21
FC Salzburg,1959,1,14,7,3,45,21,24,49
SK Sturm Gra,1959,2,13,4,7,35,29,6,43
Rapid Vienna,1959,3,8,10,6,37,31,6,34
LASK Linz,1959,4,9,6,9,33,32,1,33
Mattersburg,1959,5,7,5,12,33,43,-10,26
Vienna,1959,6,7,5,12,26,40,-14,26
SC Rheindorf,1959,7,5,5,14,16,29,-13,20
FC Salzburg,1960,1,12,8,4,44,23,21,44
SK Sturm Gra,1960,2,12,5,7,35,30,5,41
LASK Linz,1960,3,10,5,9,31,30,1,35
Rapid Vienna,1960,4,8,9,7,35,30,5,33
Vienna,1960,5,8,5,11,27,38,-11,29
Mattersburg,1960,6,7,6,11,33,43,-10,27
SC Rheindorf,1960,7,5,6,13,19,30,-11,21
FC Salzburg,1961,1,14,6,4,43,21,22,48
SK Sturm Gra,1961,2,13,5,6,37,25,12,44
Rapid Vienna,1961,3,9,10,5,34,26,8,37
LASK Linz,1961,4,9,5,10,26,31,-5,32
Mattersburg,1961,5,8,5,11,34,41,-7,29
Vienna,1961,6,6,5,13,24,41,-17,23
SC Rheindorf,1961,7,4,6,14,18,31,-13,18
FC Salzburg,1962,1,15,7,2,45,16,29,52
SK Sturm Gra,1962,2,12,5,7,33,29,4,41
Rapid Vienna,1962,3,9,9,6,39,29,10,36
LASK Linz,1962,4,8,6,10,27,31,-4,30
Vienna,1962,5,7,5,12,25,38,-13,26
SC Rheindorf,1962,6,6,5,13,18,30,-12,23
Mattersburg,1962,7,6,5,13,29,43,-14,23
FC Salzburg,1963,1,14,7,3,43,18,25,49
SK Sturm Gra,1963,2,13,5,6,35,27,8,44
Rapid Vienna,1963,3,9,9,6,36,28,8,36
LASK Linz,1963,4,7,6,11,26,32,-6,27
Vienna,1963,5,7,5,12,25,39,-14,26
SC Rheindorf,1963,6,6,7,11,24,29,-5,25
Mattersburg,1963,7,6,5,13,27,43,-16,23
FC Salzburg,1964,1,16,6,2,48,18,30,54
SK Sturm Gra,1964,2,13,3,8,39,31,8,42
LASK Linz,1964,3,9,5,10,26,28,-2,32
Rapid Vienna,1964,4,7,9,8,32,31,1,30
Vienna,1964,5,7,5,12,26,38,-12,26
Mattersburg,1964,6,7,5,12,33,48,-15,26
SC Rheindorf,1964,7,6,5,13,23,33,-10,23
FC Salzburg,1965,1,14,7,3,44,20,24,49
Rapid Vienna,1965,2,10,10,4,41,29,12,40
SK Sturm Gra,1965,3,11,6,7,32,30,2,39
LASK Linz,1965,4,9,6,9,30,29,1,33
Vienna,1965,5,7,5,12,28,40,-12,26
SC Rheindorf,1965,6,6,5,13,23,34,-11,23
Mattersburg,1965,7,5,5,14,31,47,-16,20
FC Salzburg,1966,1,13,8,3,42,19,23,47
SK Sturm Gra,1966,2,13,4,7,34,27,7,43
Rapid Vienna,1966,3,9,11,4,36,26,10,38
LASK Linz,1966,4,8,5,11,27,30,-3,29
Mattersburg,1966,5,6,6,12,29,42,-13,24
Vienna,1966,6,6,6,12,26,41,-15,24
SC Rheindorf,1966,7,5,8,11,18,27,-9,23
FC Salzburg,1967,1,15,7,2,46,18,28,52
SK Sturm Gra,1967,2,11,3,10,28,35,-7,36
Rapid Vienna,1967,3,8,11,5,38,28,10,35
LASK Linz,1967,4,9,5,10,30,29,1,32
Mattersburg,1967,5,7,5,12,32,42,-10,26
Vienna,1967,6,7,5,12,25,40,-15,26
SC Rheindorf,1967,7,6,6,12,20,27,-7,24
FC Salzburg,1968,1,14,8,2,45,17,28,50
SK Sturm Gra,1968,2,12,3,9,32,29,3,39
Rapid Vienna,1968,3,9,11,4,38,27,11,38
LASK Linz,1968,4,8,6,10,25,29,-4,30
Vienna,1968,5,7,6,11,25,38,-13,27
SC Rheindorf,1968,6,6,7,11,22,29,-7,25
Mattersburg,1968,7,5,5,14,28,46,-18,20
FC Salzburg,1969,1,15,7,2,48,19,29,52
SK Sturm Gra,1969,2,13,3,8,34,31,3,42
Rapid Vienna,1969,3,8,11,5,37,29,8,35
LASK Linz,1969,4,8,5,11,27,29,-2,29
Mattersburg,1969,5,7,6,11,31,40,-9,27
Vienna,1969,6,6,5,13,25,42,-17,23
SC Rheindorf,1969,7,5,7,12,19,31,-12,22
FC Salzburg,1970,1,14,7,3,45,18,27,49
Rapid Vienna,1970,2,10,10,4,37,25,12,40
SK Sturm Gra,1970,3,11,4,9,29,31,-2,37
LASK Linz,1970,4,9,5,10,27,27,0,32
Vienna,1970,5,7,5,12,27,41,-14,26
SC Rheindorf,1970,6,5,8,11,19,28,-9,23
Mattersburg,1970,7,5,7,12,28,42,-14,22
FC Salzburg,1971,1,16,6,2,44,15,29,54
SK Sturm Gra,1971,2,12,4,8,32,30,2,40
Rapid Vienna,1971,3,8,10,6,34,27,7,34
LASK Linz,1971,4,8,5,11,28,31,-3,29
Mattersburg,1971,5,6,7,11,30,41,-11,25
Vienna,1971,6,6,6,12,24,39,-15,24
SC Rheindorf,1971,7,5,8,11,21,30,-9,23
FC Salzburg,1972,1,15,6,3,47,17,30,51
SK Sturm Gra,1972,2,13,3,8,33,29,4,42
LASK Linz,1972,3,9,5,10,26,27,-1,32
Rapid Vienna,1972,4,7,9,8,34,33,1,30
SC Rheindorf,1972,5,7,6,11,23,27,-4,27
Vienna,1972,6,7,5,12,26,40,-14,26
Mattersburg,1972,7,6,6,12,29,45,-16,24
FC Salzburg,1973,1,14,7,3,43,18,25,49
Rapid Vienna,1973,2,10,10,4,42,26,16,40
SK Sturm Gra,1973,3,12,4,8,31,30,1,40
LASK Linz,1973,4,7,8,9,27,29,-2,29
Mattersburg,1973,5,6,8,10,30,38,-8,26
Vienna,1973,6,6,6,12,24,39,-15,24
SC Rheindorf,1973,7,4,7,13,17,34,-17,19
FC Salzburg,1974,1,15,6,3,45,17,28,51
SK Sturm Gra,1974,2,13,4,7,34,29,5,43
LASK Linz,1974,3,10,5,9,30,29,1,35
Rapid Vienna,1974,4,7,9,8,31,29,2,30
Vienna,1974,5,7,5,12,25,39,-14,26
Mattersburg,1974,6,6,6,12,31,43,-12,24
SC Rheindorf,1974,7,5,7,12,20,30,-10,22
FC Salzburg,1975,1,13,6,5,44,21,23,45
Rapid Vienna,1975,2,10,10,4,37,25,12,40
SK Sturm Gra,1975,3,12,4,8,29,27,2,40
LASK Linz,1975,4,9,6,9,28,27,1,33
Vienna,1975,5,8,5,11,27,38,-11,29
Mattersburg,1975,6,6,5,13,29,45,-16,23
SC Rheindorf,1975,7,4,8,12,16,27,-11,20
FC Salzburg,1976,1,13,7,4,42,21,21,46
SK Sturm Gra,1976,2,13,4,7,34,26,8,43
Rapid Vienna,1976,3,8,11,5,34,26,8,35
LASK Linz,1976,4,9,6,9,31,29,2,33
Vienna,1976,5,7,6,11,27,39,-12,27
SC Rheindorf,1976,6,6,5,13,21,31,-10,23
Mattersburg,1976,7,6,5,13,30,47,-17,23
FC Salzburg,1977,1,13,9,2,44,18,26,48
SK Sturm Gra,1977,2,12,4,8,34,28,6,40
Rapid Vienna,1977,3,9,10,5,35,25,10,37
LASK Linz,1977,4,7,6,11,25,35,-10,27
Vienna,1977,5,7,6,11,26,39,-13,27
Mattersburg,1977,6,6,7,11,35,42,-7,25
SC Rheindorf,1977,7,6,6,12,20,32,-12,24
FC Salzburg,1978,1,15,7,2,48,20,28,52
SK Sturm Gra,1978,2,12,5,7,32,28,4,41
Rapid Vienna,1978,3,7,11,6,35,29,6,32
LASK Linz,1978,4,8,6,10,25,28,-3,30
SC Rheindorf,1978,5,6,7,11,20,28,-8,25
Mattersburg,1978,6,6,6,12,30,41,-11,24
Vienna,1978,7,6,6,12,25,41,-16,24
FC Salzburg,1979,1,14,8,2,43,17,26,50
SK Sturm Gra,1979,2,11,3,10,30,31,-1,36
LASK Linz,1979,3,10,5,9,31,29,2,35
Rapid Vienna,1979,4,8,10,6,36,29,7,34
SC Rheindorf,1979,5,7,5,12,20,27,-7,26
Vienna,1979,6,6,7,11,24,38,-14,25
Mattersburg,1979,7,6,6,12,30,43,-13,24
FC Salzburg,1980,1,15,6,3,45,20,25,51
SK Sturm Gra,1980,2,13,3,8,35,31,4,42
Rapid Vienna,1980,3,7,11,6,34,29,5,32
LASK Linz,1980,4,8,6,10,28,31,-3,30
Mattersburg,1980,5,7,6,11,31,39,-8,27
Vienna,1980,6,7,5,12,25,39,-14,26
SC Rheindorf,1980,7,5,7,12,21,30,-9,22
FC Salzburg,1981,1,14,6,4,46,23,23,48
SK Sturm Gra,1981,2,13,3,8,34,29,5,42
Rapid Vienna,1981,3,9,9,6,36,30,6,36
LASK Linz,1981,4,9,6,9,30,28,2,33
Mattersburg,1981,5,7,6,11,31,39,-8,27
Vienna,1981,6,7,5,12,25,40,-15,26
SC Rheindorf,1981,7,5,5,14,17,30,-13,20
FC Salzburg,1982,1,14,7,3,41,17,24,49
SK Sturm Gra,1982,2,14,3,7,34,27,7,45
Rapid Vienna,1982,3,10,10,4,34,23,11,40
LASK Linz,1982,4,7,7,10,24,27,-3,28
Mattersburg,1982,5,6,7,11,29,39,-10,25
Vienna,1982,6,6,6,12,24,40,-16,24
SC Rheindorf,1982,7,4,6,14,17,30,-13,18
FC Salzburg,1983,1,15,6,3,45,18,27,51
Rapid Vienna,1983,2,10,10,4,37,23,14,40
SK Sturm Gra,1983,3,11,5,8,31,30,1,38
LASK Linz,1983,4,9,6,9,27,29,-2,33
Vienna,1983,5,7,5,12,25,39,-14,26
Mattersburg,1983,6,6,5,13,31,44,-13,23
SC Rheindorf,1983,7,4,7,13,17,30,-13,19
FC Salzburg,1984,1,14,7,3,44,20,24,49
SK Sturm Gra,1984,2,12,4,8,33,33,0,40
Rapid Vienna,1984,3,7,11,6,33,27,6,32
LASK Linz,1984,4,8,6,10,30,33,-3,30
Mattersburg,1984,5,7,6,11,33,41,-8,27
Vienna,1984,6,7,6,11,27,37,-10,27
SC Rheindorf,1984,7,6,6,12,20,29,-9,24
FC Salzburg,1985,1,14,6,4,44,20,24,48
SK Sturm Gra,1985,2,12,4,8,31,30,1,40
LASK Linz,1985,3,9,7,8,31,28,3,34
Rapid Vienna,1985,4,7,11,6,31,26,5,32
Mattersburg,1985,5,7,6,11,36,45,-9,27
Vienna,1985,6,7,6,11,27,40,-13,27
SC Rheindorf,1985,7,4,8,12,20,31,-11,20
FC Salzburg,1986,1,14,6,4,44,22,22,48
SK Sturm Gra,1986,2,13,4,7,34,29,5,43
Rapid Vienna,1986,3,8,11,5,36,29,7,35
LASK Linz,1986,4,7,7,10,28,34,-6,28
Vienna,1986,5,7,6,11,27,39,-12,27
Mattersburg,1986,6,6,7,11,31,40,-9,25
SC Rheindorf,1986,7,5,7,12,21,28,-7,22
FC Salzburg,1987,1,15,6,3,49,21,28,51
SK Sturm Gra,1987,2,12,4,8,33,28,5,40
LASK Linz,1987,3,9,6,9,30,31,-1,33
Rapid Vienna,1987,4,7,10,7,34,29,5,31
SC Rheindorf,1987,5,7,5,12,19,27,-8,26
Mattersburg,1987,6,6,7,11,31,42,-11,25
Vienna,1987,7,6,6,12,25,43,-18,24
FC Salzburg,1988,1,14,6,4,43,19,24,48
SK Sturm Gra,1988,2,13,3,8,32,29,3,42
LASK Linz,1988,3,10,6,8,27,25,2,36
Rapid Vienna,1988,4,8,10,6,34,27,7,34
Mattersburg,1988,5,7,5,12,29,39,-10,26
Vienna,1988,6,7,5,12,25,39,-14,26
SC Rheindorf,1988,7,5,5,14,21,33,-12,20
FC Salzburg,1989,1,14,6,4,42,20,22,48
Rapid Vienna,1989,2,11,9,4,38,24,14,42
SK Sturm Gra,1989,3,12,4,8,30,27,3,40
LASK Linz,1989,4,7,6,11,24,28,-4,27
Vienna,1989,5,7,6,11,24,37,-13,27
Mattersburg,1989,6,6,7,11,30,41,-11,25
SC Rheindorf,1989,7,5,6,13,21,32,-11,21
FC Salzburg,1990,1,13,7,4,41,20,21,46
SK Sturm Gra,1990,2,12,4,8,32,30,2,40
Rapid Vienna,1990,3,10,9,5,39,28,11,39
Vienna,1990,4,8,5,11,28,38,-10,29
LASK Linz,1990,5,7,7,10,24,27,-3,28
Mattersburg,1990,6,7,6,11,31,40,-9,27
SC Rheindorf,1990,7,5,6,13,18,30,-12,21
FC Salzburg,1991,1,13,8,3,45,22,23,47
SK Sturm Gra,1991,2,14,4,6,37,25,12,46
Rapid Vienna,1991,3,8,12,4,36,27,9,36
LASK Linz,1991,4,9,6,9,29,30,-1,33
Vienna,1991,5,6,7,11,25,39,-14,25
Mattersburg,1991,6,5,6,13,28,45,-17,21
SC Rheindorf,1991,7,5,5,14,19,31,-12,20
FC Salzburg,1992,1,15,7,2,46,16,30,52
SK Sturm Gra,1992,2,13,4,7,34,30,4,43
Rapid Vienna,1992,3,8,10,6,35,29,6,34
LASK Linz,1992,4,7,6,11,26,32,-6,27
Vienna,1992,5,7,5,12,26,42,-16,26
SC Rheindorf,1992,6,6,6,12,22,30,-8,24
Mattersburg,1992,7,6,6,12,34,44,-10,24
FC Salzburg,1993,1,13,7,4,40,18,22,46
SK Sturm Gra,1993,2,13,3,8,32,29,3,42
LASK Linz,1993,3,9,6,9,27,26,1,33
Rapid Vienna,1993,4,7,10,7,31,27,4,31
Vienna,1993,5,7,6,11,25,37,-12,27
Mattersburg,1993,6,6,8,10,31,40,-9,26
SC Rheindorf,1993,7,6,6,12,22,31,-9,24
FC Salzburg,1994,1,14,7,3,44,19,25,49
Rapid Vienna,1994,2,10,10,4,40,25,15,40
SK Sturm Gra,1994,3,12,4,8,32,31,1,40
LASK Linz,1994,4,8,7,9,25,29,-4,31
Mattersburg,1994,5,7,6,11,35,41,-6,27
Vienna,1994,6,7,5,12,26,39,-13,26
SC Rheindorf,1994,7,4,5,15,16,34,-18,17
FC Salzburg,1995,1,15,7,2,46,19,27,52
SK Sturm Gra,1995,2,12,4,8,32,29,3,40
Rapid Vienna,1995,3,9,9,6,36,26,10,36
LASK Linz,1995,4,9,7,8,27,25,2,34
Vienna,1995,5,7,5,12,26,39,-13,26
Mattersburg,1995,6,6,6,12,32,43,-11,24
SC Rheindorf,1995,7,4,6,14,16,34,-18,18
FC Salzburg,1996,1,15,7,2,49,21,28,52
SK Sturm Gra,1996,2,11,7,6,33,29,4,40
Rapid Vienna,1996,3,9,10,5,38,28,10,37
LASK Linz,1996,4,8,6,10,25,29,-4,30
Vienna,1996,5,7,5,12,25,41,-16,26
Mattersburg,1996,6,6,5,13,29,41,-12,23
SC Rheindorf,1996,7,5,6,13,20,30,-10,21
FC Salzburg,1997,1,14,8,2,44,16,28,50
Rapid Vienna,1997,2,10,10,4,39,28,11,40
SK Sturm Gra,1997,3,11,5,8,30,29,1,38
LASK Linz,1997,4,8,6,10,27,29,-2,30
Vienna,1997,5,7,6,11,26,38,-12,27
Mattersburg,1997,6,6,6,12,29,42,-13,24
SC Rheindorf,1997,7,4,7,13,17,30,-13,19
FC Salzburg,1998,1,16,6,2,51,17,34,54
SK Sturm Gra,1998,2,13,3,8,35,29,6,42
Rapid Vienna,1998,3,9,10,5,36,27,9,37
LASK Linz,1998,4,8,6,10,28,31,-3,30
Vienna,1998,5,7,5,12,24,38,-14,26
SC Rheindorf,1998,6,5,6,13,18,29,-11,21
Mattersburg,1998,7,5,6,13,26,47,-21,21
FC Salzburg,1999,1,14,7,3,44,20,24,49
SK Sturm Gra,1999,2,12,5,7,33,29,4,41
Rapid Vienna,1999,3,9,9,6,37,29,8,36
SC Rheindorf,1999,4,7,6,11,22,26,-4,27
LASK Linz,1999,5,7,6,11,26,33,-7,27
Vienna,1999,6,6,7,11,26,40,-14,25
Mattersburg,1999,7,6,6,12,29,40,-11,24
FC Salzburg,2000,1,14,6,4,48,20,28,48
SK Sturm Gra,2000,2,12,4,8,33,32,1,40
Rapid Vienna,2000,3,9,10,5,35,26,9,37
LASK Linz,2000,4,8,7,9,28,29,-1,31
Mattersburg,2000,5,8,6,10,32,37,-5,30
Vienna,2000,6,6,5,13,24,45,-21,23
SC Rheindorf,2000,7,5,6,13,18,29,-11,21
FC Salzburg,2001,1,15,6,3,47,19,28,51
SK Sturm Gra,2001,2,12,5,7,30,29,1,41
Rapid Vienna,2001,3,7,11,6,33,29,4,32
LASK Linz,2001,4,8,6,10,27,30,-3,30
Vienna,2001,5,8,5,11,28,37,-9,29
Mattersburg,2001,6,6,6,12,32,43,-11,24
SC Rheindorf,2001,7,4,9,11,19,29,-10,21
FC Salzburg,2002,1,14,7,3,42,17,25,49
SK Sturm Gra,2002,2,13,3,8,32,27,5,42
Rapid Vienna,2002,3,8,10,6,35,28,7,34
Vienna,2002,4,8,5,11,25,37,-12,29
LASK Linz,2002,5,7,7,10,25,29,-4,28
Mattersburg,2002,6,7,6,11,32,38,-6,27
SC Rheindorf,2002,7,5,6,13,17,32,-15,21
FC Salzburg,2003,1,16,6,2,47,20,27,54
SK Sturm Gra,2003,2,12,4,8,31,28,3,40
Rapid Vienna,2003,3,10,9,5,40,30,10,39
LASK Linz,2003,4,8,6,10,26,29,-3,30
Vienna,2003,5,7,5,12,26,40,-14,26
Mattersburg,2003,6,6,6,12,33,43,-10,24
SC Rheindorf,2003,7,4,6,14,21,34,-13,18
FC Salzburg,2004,1,15,7,2,47,19,28,52
SK Sturm Gra,2004,2,12,5,7,37,32,5,41
Rapid Vienna,2004,3,8,11,5,35,28,7,35
LASK Linz,2004,4,8,8,8,31,31,0,32
Vienna,2004,5,6,6,12,24,41,-17,24
SC Rheindorf,2004,6,5,7,12,19,29,-10,22
Mattersburg,2004,7,5,6,13,29,42,-13,21
FC Salzburg,2005,1,13,7,4,42,20,22,46
SK Sturm Gra,2005,2,12,5,7,31,28,3,41
Rapid Vienna,2005,3,9,10,5,37,26,11,37
SC Rheindorf,2005,4,8,5,11,24,27,-3,29
Mattersburg,2005,5,8,5,11,34,42,-8,29
LASK Linz,2005,6,7,5,12,23,31,-8,26
Vienna,2005,7,6,5,13,27,44,-17,23
FC Salzburg,2006,1,15,6,3,52,19,33,51
SK Sturm Gra,2006,2,13,4,7,34,30,4,43
Rapid Vienna,2006,3,8,10,6,36,29,7,34
LASK Linz,2006,4,8,6,10,27,32,-5,30
Vienna,2006,5,7,5,12,26,41,-15,26
SC Rheindorf,2006,6,6,6,12,21,28,-7,24
Mattersburg,2006,7,6,5,13,28,45,-17,23
FC Salzburg,2007,1,15,7,2,47,15,32,52
SK Sturm Gra,2007,2,13,3,8,35,28,7,42
Rapid Vienna,2007,3,9,10,5,35,27,8,37
LASK Linz,2007,4,9,6,9,29,29,0,33
Vienna,2007,5,6,6,12,23,40,-17,24
Mattersburg,2007,6,5,7,12,32,47,-15,22
SC Rheindorf,2007,7,5,5,14,23,38,-15,20
SK Sturm Gra,2008,1,14,4,6,32,25,7,46
FC Salzburg,2008,2,12,8,4,39,19,20,44
Rapid Vienna,2008,3,8,10,6,36,29,7,34
LASK Linz,2008,4,9,5,10,31,31,0,32
Vienna,2008,5,7,6,11,27,38,-11,27
Mattersburg,2008,6,6,6,12,32,45,-13,24
SC Rheindorf,2008,7,5,7,12,20,30,-10,22
FC Salzburg,2009,1,13,8,3,44,20,24,47
SK Sturm Gra,2009,2,12,6,6,33,28,5,42
Rapid Vienna,2009,3,7,12,5,38,31,7,33
LASK Linz,2009,4,8,7,9,28,29,-1,31
Vienna,2009,5,8,5,11,27,38,-11,29
Mattersburg,2009,6,6,6,12,32,45,-13,24
SC Rheindorf,2009,7,4,8,12,19,30,-11,20
FC Salzburg,2010,1,13,7,4,40,17,23,46
SK Sturm Gra,2010,2,12,4,8,30,29,1,40
Rapid Vienna,2010,3,10,9,5,36,25,11,39
LASK Linz,2010,4,8,6,10,26,28,-2,30
Vienna,2010,5,8,5,11,28,37,-9,29
Mattersburg,2010,6,6,6,12,28,43,-15,24
SC Rheindorf,2010,7,6,5,13,21,30,-9,23
FC Salzburg,2011,1,15,7,2,47,19,28,52
SK Sturm Gra,2011,2,11,6,7,30,29,1,39
LASK Linz,2011,3,9,6,9,30,26,4,33
Rapid Vienna,2011,4,7,10,7,33,31,2,31
Vienna,2011,5,7,6,11,28,39,-11,27
SC Rheindorf,2011,6,6,6,12,17,29,-12,24
Mattersburg,2011,7,6,5,13,33,45,-12,23
FC Salzburg,2012,1,15,7,2,48,18,30,52
SK Sturm Gra,2012,2,12,4,8,32,29,3,40
Rapid Vienna,2012,3,8,11,5,40,28,12,35
LASK Linz,2012,4,9,6,9,27,32,-5,33
Vienna,2012,5,7,6,11,26,39,-13,27
Mattersburg,2012,6,6,6,12,28,41,-13,24
SC Rheindorf,2012,7,4,6,14,16,30,-14,18
FC Salzburg,2013,1,15,7,2,45,18,27,52
SK Sturm Gra,2013,2,11,5,8,29,27,2,38
Rapid Vienna,2013,3,8,10,6,34,31,3,34
LASK Linz,2013,4,9,5,10,28,29,-1,32
Mattersburg,2013,5,8,5,11,33,38,-5,29
Vienna,2013,6,6,6,12,25,40,-15,24
SC Rheindorf,2013,7,5,6,13,18,29,-11,21
FC Salzburg,2014,1,15,6,3,49,19,30,51
SK Sturm Gra,2014,2,13,3,8,31,29,2,42
Rapid Vienna,2014,3,10,9,5,36,25,11,39
LASK Linz,2014,4,8,6,10,27,29,-2,30
Vienna,2014,5,7,5,12,28,42,-14,26
SC Rheindorf,2014,6,6,5,13,21,32,-11,23
Mattersburg,2014,7,5,6,13,32,48,-16,21
FC Salzburg,2015,1,14,7,3,47,19,28,49
SK Sturm Gra,2015,2,11,4,9,29,32,-3,37
Rapid Vienna,2015,3,8,12,4,37,28,9,36
LASK Linz,2015,4,8,7,9,26,27,-1,31
Vienna,2015,5,8,5,11,26,38,-12,29
SC Rheindorf,2015,6,5,8,11,22,29,-7,23
Mattersburg,2015,7,5,7,12,30,44,-14,22
FC Salzburg,2016,1,12,9,3,42,20,22,45
SK Sturm Gra,2016,2,12,6,6,35,29,6,42
Rapid Vienna,2016,3,7,13,4,36,28,8,34
LASK Linz,2016,4,8,7,9,26,28,-2,31
Vienna,2016,5,6,7,11,28,42,-14,25
Mattersburg,2016,6,6,6,12,29,41,-12,24
SC Rheindorf,2016,7,5,8,11,18,26,-8,23
FC Salzburg,2017,1,13,7,4,41,19,22,46
SK Sturm Gra,2017,2,13,5,6,33,27,6,44
Rapid Vienna,2017,3,9,10,5,38,29,9,37
LASK Linz,2017,4,9,6,9,30,27,3,33
Vienna,2017,5,8,5,11,28,40,-12,29
Mattersburg,2017,6,5,6,13,29,44,-15,21
SC Rheindorf,2017,7,5,5,14,19,32,-13,20
FC Salzburg,2018,1,15,7,2,46,16,30,52
SK Sturm Gra,2018,2,11,5,8,30,29,1,38
LASK Linz,2018,3,10,5,9,31,28,3,35
Rapid Vienna,2018,4,8,10,6,34,26,8,34
Vienna,2018,5,7,5,12,28,40,-12,26
Mattersburg,2018,6,7,5,12,31,47,-16,26
SC Rheindorf,2018,7,4,7,13,18,32,-14,19
FC Salzburg,2019,1,14,7,3,42,19,23,49
SK Sturm Gra,2019,2,11,5,8,31,30,1,38
LASK Linz,2019,3,9,6,9,31,29,2,33
Rapid Vienna,2019,4,8,9,7,34,33,1,33
Vienna,2019,5,8,5,11,27,38,-11,29
SC Rheindorf,2019,6,6,6,12,23,28,-5,24
Mattersburg,2019,7,6,6,12,30,41,-11,24
FC Salzburg,2020,1,15,6,3,45,18,27,51
Rapid Vienna,2020,2,11,9,4,44,25,19,42
SK Sturm Gra,2020,3,12,4,8,30,29,1,40
LASK Linz,2020,4,8,7,9,27,26,1,31
Vienna,2020,5,7,5,12,24,39,-15,26
Mattersburg,2020,6,5,6,13,27,42,-15,21
SC Rheindorf,2020,7,4,7,13,16,34,-18,19
FC Salzburg,2021,1,15,6,3,48,16,32,51
SK Sturm Gra,2021,2,13,3,8,31,29,2,42
Rapid Vienna,2021,3,9,9,6,35,26,9,36
LASK Linz,2021,4,9,6,9,28,27,1,33
Vienna,2021,5,7,5,12,24,40,-16,26
Mattersburg,2021,6,6,5,13,29,46,-17,23
SC Rheindorf,2021,7,5,6,13,19,30,-11,21
FC Salzburg,2022,1,15,7,2,47,17,30,52
SK Sturm Gra,2022,2,13,4,7,33,30,3,43
Rapid Vienna,2022,3,8,10,6,37,29,8,34
LASK Linz,2022,4,8,6,10,28,30,-2,30
Mattersburg,2022,5,6,7,11,32,42,-10,25
Vienna,2022,6,6,5,13,23,42,-19,23
SC Rheindorf,2022,7,5,7,12,19,29,-10,22
FC Salzburg,2023,1,14,8,2,46,18,28,50
SK Sturm Gra,2023,2,11,5,8,33,34,-1,38
LASK Linz,2023,3,10,6,8,30,28,2,36
Rapid Vienna,2023,4,8,10,6,35,28,7,34
Vienna,2023,5,7,6,11,26,39,-13,27
SC Rheindorf,2023,6,6,5,13,20,28,-8,23
Mattersburg,2023,7,5,6,13,28,43,-15,21
FC Salzburg,2024,1,12,8,4,41,21,20,44
SK Sturm Gra,2024,2,12,4,8,32,29,3,40
Rapid Vienna,2024,3,8,10,6,38,30,8,34
LASK Linz,2024,4,9,6,9,31,31,0,33
Mattersburg,2024,5,8,6,10,31,38,-7,30
SC Rheindorf,2024,6,6,6,12,23,32,-9,24
Vienna,2024,7,6,6,12,24,39,-15,24
FC Salzburg,2025,1,16,6,2,44,15,29,54
SK Sturm Gra,2025,2,14,3,7,34,26,8,45
LASK Linz,2025,3,9,5,10,26,28,-2,32
Rapid Vienna,2025,4,7,9,8,32,30,2,30
Mattersburg,2025,5,7,6,11,31,39,-8,27
Vienna,2025,6,6,6,12,25,40,-15,24
SC Rheindorf,2025,7,5,5,14,17,31,-14,20
FC Salzburg,2026,1,14,7,3,49,20,29,49
SK Sturm Gra,2026,2,12,4,8,35,36,-1,40
Rapid Vienna,2026,3,9,11,4,39,27,12,38
LASK Linz,2026,4,9,5,10,30,34,-4,32
Vienna,2026,5,8,5,11,29,39,-10,29
Mattersburg,2026,6,6,5,13,33,44,-11,23
SC Rheindorf,2026,7,4,7,13,18,33,-15,19
FC Salzburg,2027,1,15,6,3,43,18,25,51
SK Sturm Gra,2027,2,13,4,7,33,25,8,43
Rapid Vienna,2027,3,8,11,5,35,25,10,35
LASK Linz,2027,4,8,7,9,28,30,-2,31
Vienna,2027,5,7,6,11,26,39,-13,27
Mattersburg,2027,6,6,7,11,31,41,-10,25
SC Rheindorf,2027,7,4,5,15,16,34,-18,17
FC Salzburg,2028,1,14,7,3,47,21,26,49
Rapid Vienna,2028,2,10,10,4,45,28,17,40
SK Sturm Gra,2028,3,11,6,7,36,33,3,39
LASK Linz,2028,4,7,6,11,26,33,-7,27
Mattersburg,2028,5,7,6,11,34,42,-8,27
Vienna,2028,6,6,6,12,25,40,-15,24
SC Rheindorf,2028,7,6,5,13,19,35,-16,23
FC Salzburg,2029,1,14,8,2,44,19,25,50
SK Sturm Gra,2029,2,11,6,7,32,29,3,39
Rapid Vienna,2029,3,8,10,6,35,28,7,34
LASK Linz,2029,4,8,7,9,28,28,0,31
Vienna,2029,5,7,5,12,26,40,-14,26
SC Rheindorf,2029,6,6,6,12,20,30,-10,24
Mattersburg,2029,7,6,6,12,32,43,-11,24
FC Salzburg,2030,1,13,8,3,44,21,23,47
SK Sturm Gra,2030,2,12,4,8,32,30,2,40
Rapid Vienna,2030,3,7,11,6,35,30,5,32
LASK Linz,2030,4,8,7,9,27,28,-1,31
Mattersburg,2030,5,7,6,11,32,41,-9,27
SC Rheindorf,2030,6,7,5,12,22,26,-4,26
Vienna,2030,7,7,5,12,26,42,-16,26
FC Salzburg,2031,1,15,6,3,46,18,28,51
Rapid Vienna,2031,2,10,10,4,36,24,12,40
SK Sturm Gra,2031,3,11,4,9,29,30,-1,37
LASK Linz,2031,4,8,6,10,27,30,-3,30
Mattersburg,2031,5,7,6,11,32,40,-8,27
SC Rheindorf,2031,6,6,5,13,19,30,-11,23
Vienna,2031,7,6,5,13,23,40,-17,23
FC Salzburg,2032,1,15,6,3,47,18,29,51
SK Sturm Gra,2032,2,12,4,8,36,31,5,40
LASK Linz,2032,3,10,6,8,32,28,4,36
Rapid Vienna,2032,4,8,9,7,36,31,5,33
Vienna,2032,5,8,5,11,28,38,-10,29
Mattersburg,2032,6,6,5,13,34,50,-16,23
SC Rheindorf,2032,7,5,5,14,18,35,-17,20
FC Salzburg,2033,1,14,7,3,45,19,26,49
SK Sturm Gra,2033,2,13,4,7,32,27,5,43
Rapid Vienna,2033,3,7,10,7,33,28,5,31
LASK Linz,2033,4,8,7,9,29,30,-1,31
Mattersburg,2033,5,8,6,10,35,41,-6,30
Vienna,2033,6,6,5,13,23,41,-18,23
SC Rheindorf,2033,7,5,7,12,19,30,-11,22
FC Salzburg,2034,1,15,7,2,48,20,28,52
SK Sturm Gra,2034,2,11,6,7,32,31,1,39
LASK Linz,2034,3,9,6,9,32,30,2,33
Rapid Vienna,2034,4,7,11,6,35,30,5,32
SC Rheindorf,2034,5,7,6,11,23,27,-4,27
Mattersburg,2034,6,6,5,13,30,45,-15,23
Vienna,2034,7,6,5,13,24,41,-17,23
FC Salzburg,2035,1,16,6,2,45,17,28,54
SK Sturm Gra,2035,2,13,3,8,34,29,5,42
Rapid Vienna,2035,3,7,10,7,33,30,3,31
LASK Linz,2035,4,8,6,10,26,28,-2,30
Vienna,2035,5,7,5,12,26,38,-12,26
SC Rheindorf,2035,6,6,6,12,20,29,-9,24
Mattersburg,2035,7,6,6,12,30,43,-13,24
FC Salzburg,2036,1,14,6,4,42,18,24,48
SK Sturm Gra,2036,2,13,4,7,31,25,6,43
Rapid Vienna,2036,3,10,10,4,35,23,12,40
LASK Linz,2036,4,9,5,10,25,28,-3,32
Mattersburg,2036,5,7,5,12,32,41,-9,26
Vienna,2036,6,6,5,13,25,42,-17,23
SC Rheindorf,2036,7,5,5,14,16,29,-13,20
FC Salzburg,2037,1,14,7,3,42,18,24,49
SK Sturm Gra,2037,2,12,4,8,35,31,4,40
Rapid Vienna,2037,3,10,9,5,40,28,12,39
LASK Linz,2037,4,9,5,10,29,31,-2,32
Mattersburg,2037,5,6,7,11,29,39,-10,25
Vienna,2037,6,6,7,11,24,38,-14,25
SC Rheindorf,2037,7,4,7,13,22,36,-14,19
FC Salzburg,2038,1,15,7,2,47,18,29,52
SK Sturm Gra,2038,2,12,3,9,32,31,1,39
Rapid Vienna,2038,3,9,10,5,34,25,9,37
LASK Linz,2038,4,10,5,9,30,29,1,35
Vienna,2038,5,7,5,12,26,41,-15,26
SC Rheindorf,2038,6,6,5,13,19,29,-10,23
Mattersburg,2038,7,5,5,14,29,44,-15,20
FC Salzburg,2039,1,15,6,3,47,17,30,51
LASK Linz,2039,2,11,5,8,32,25,7,38
SK Sturm Gra,2039,3,11,5,8,31,32,-1,38
Rapid Vienna,2039,4,8,10,6,34,30,4,34
Vienna,2039,5,7,6,11,24,37,-13,27
SC Rheindorf,2039,6,5,6,13,18,29,-11,21
Mattersburg,2039,7,5,6,13,29,45,-16,21
FC Salzburg,2040,1,15,7,2,45,17,28,52
SK Sturm Gra,2040,2,12,4,8,33,31,2,40
LASK Linz,2040,3,10,6,8,32,29,3,36
Rapid Vienna,2040,4,7,9,8,33,31,2,30
SC Rheindorf,2040,5,6,6,12,19,27,-8,24
Mattersburg,2040,6,6,6,12,30,41,-11,24
Vienna,2040,7,6,6,12,25,41,-16,24
FC Salzburg,2041,1,13,7,4,43,23,20,46
SK Sturm Gra,2041,2,13,4,7,34,26,8,43
Rapid Vienna,2041,3,8,10,6,38,31,7,34
LASK Linz,2041,4,8,5,11,27,32,-5,29
Vienna,2041,5,7,6,11,27,40,-13,27
Mattersburg,2041,6,7,5,12,28,39,-11,26
SC Rheindorf,2041,7,6,7,11,21,27,-6,25
FC Salzburg,2042,1,13,9,2,46,21,25,48
SK Sturm Gra,2042,2,13,3,8,32,29,3,42
Rapid Vienna,2042,3,8,11,5,36,26,10,35
LASK Linz,2042,4,10,5,9,28,27,1,35
Mattersburg,2042,5,7,6,11,31,40,-9,27
Vienna,2042,6,6,6,12,26,41,-15,24
SC Rheindorf,2042,7,4,6,14,15,30,-15,18
FC Salzburg,2043,1,15,7,2,48,17,31,52
SK Sturm Gra,2043,2,13,3,8,32,28,4,42
LASK Linz,2043,3,9,5,10,29,31,-2,32
Rapid Vienna,2043,4,7,10,7,34,29,5,31
SC Rheindorf,2043,5,7,6,11,21,27,-6,27
Mattersburg,2043,6,6,6,12,31,45,-14,24
Vienna,2043,7,6,5,13,24,42,-18,23
FC Salzburg,2044,1,14,7,3,47,20,27,49
SK Sturm Gra,2044,2,11,7,6,34,30,4,40
Rapid Vienna,2044,3,8,10,6,38,30,8,34
LASK Linz,2044,4,9,6,9,30,32,-2,33
SC Rheindorf,2044,5,7,6,11,23,26,-3,27
Mattersburg,2044,6,6,5,13,30,46,-16,23
Vienna,2044,7,6,5,13,25,43,-18,23
FC Salzburg,2045,1,15,6,3,47,18,29,51
SK Sturm Gra,2045,2,12,4,8,32,29,3,40
Rapid Vienna,2045,3,9,10,5,38,30,8,37
Mattersburg,2045,4,8,5,11,32,40,-8,29
LASK Linz,2045,5,7,5,12,25,32,-7,26
Vienna,2045,6,7,5,12,25,39,-14,26
SC Rheindorf,2045,7,6,5,13,19,30,-11,23
FC Salzburg,2046,1,13,7,4,44,22,22,46
Rapid Vienna,2046,2,10,10,4,40,25,15,40
SK Sturm Gra,2046,3,12,4,8,32,33,-1,40
LASK Linz,2046,4,9,6,9,30,31,-1,33
Vienna,2046,5,6,7,11,24,38,-14,25
Mattersburg,2046,6,5,8,11,31,43,-12,23
SC Rheindorf,2046,7,5,6,13,22,31,-9,21
FC Salzburg,2047,1,13,8,3,41,18,23,47
SK Sturm Gra,2047,2,13,5,6,35,27,8,44
Rapid Vienna,2047,3,9,10,5,36,27,9,37
LASK Linz,2047,4,9,5,10,28,29,-1,32
Vienna,2047,5,7,5,12,24,38,-14,26
Mattersburg,2047,6,6,6,12,29,41,-12,24
SC Rheindorf,2047,7,4,7,13,20,33,-13,19
FC Salzburg,2048,1,13,8,3,44,19,25,47
SK Sturm Gra,2048,2,13,3,8,32,29,3,42
Rapid Vienna,2048,3,9,11,4,38,27,11,38
LASK Linz,2048,4,8,7,9,27,29,-2,31
Mattersburg,2048,5,7,6,11,31,39,-8,27
Vienna,2048,6,7,6,11,25,38,-13,27
SC Rheindorf,2048,7,4,5,15,17,33,-16,17
FC Salzburg,2049,1,15,7,2,49,16,33,52
SK Sturm Gra,2049,2,13,4,7,33,33,0,43
Rapid Vienna,2049,3,8,10,6,33,29,4,34
LASK Linz,2049,4,8,5,11,29,30,-1,29
Vienna,2049,5,7,5,12,27,40,-13,26
SC Rheindorf,2049,6,6,6,12,20,29,-9,24
Mattersburg,2049,7,6,5,13,29,43,-14,23
FC Salzburg,2050,1,14,6,4,45,20,25,48
SK Sturm Gra,2050,2,14,3,7,34,28,6,45
Rapid Vienna,2050,3,9,9,6,38,28,10,36
LASK Linz,2050,4,9,6,9,30,30,0,33
Vienna,2050,5,7,5,12,25,40,-15,26
Mattersburg,2050,6,6,6,12,31,45,-14,24
SC Rheindorf,2050,7,5,5,14,18,30,-12,20
FC Salzburg,2051,1,13,9,2,44,19,25,48
SK Sturm Gra,2051,2,13,5,6,32,26,6,44
Rapid Vienna,2051,3,8,10,6,34,30,4,34
LASK Linz,2051,4,8,5,11,24,27,-3,29
Vienna,2051,5,7,6,11,27,39,-12,27
Mattersburg,2051,6,7,5,12,30,42,-12,26
SC Rheindorf,2051,7,5,6,13,21,29,-8,21
FC Salzburg,2052,1,14,7,3,46,18,28,49
Rapid Vienna,2052,2,9,11,4,39,27,12,38
SK Sturm Gra,2052,3,11,3,10,31,34,-3,36
LASK Linz,2052,4,9,6,9,27,28,-1,33
Vienna,2052,5,7,6,11,25,38,-13,27
SC Rheindorf,2052,6,6,6,12,23,31,-8,24
Mattersburg,2052,7,5,7,12,27,42,-15,22
FC Salzburg,2053,1,13,9,2,43,19,24,48
SK Sturm Gra,2053,2,12,5,7,33,27,6,41
Rapid Vienna,2053,3,9,11,4,37,25,12,38
LASK Linz,2053,4,9,5,10,27,28,-1,32
Mattersburg,2053,5,7,6,11,32,40,-8,27
Vienna,2053,6,6,6,12,25,40,-15,24
SC Rheindorf,2053,7,4,6,14,17,35,-18,18
FC Salzburg,2054,1,14,7,3,46,22,24,49
SK Sturm Gra,2054,2,12,4,8,33,31,2,40
Rapid Vienna,2054,3,8,10,6,38,31,7,34
LASK Linz,2054,4,9,7,8,28,25,3,34
Vienna,2054,5,7,5,12,26,40,-14,26
Mattersburg,2054,6,6,7,11,30,40,-10,25
SC Rheindorf,2054,7,4,8,12,17,29,-12,20
FC Salzburg,2055,1,15,7,2,44,17,27,52
SK Sturm Gra,2055,2,13,4,7,34,28,6,43
Rapid Vienna,2055,3,9,10,5,37,27,10,37
LASK Linz,2055,4,7,7,10,30,33,-3,28
Mattersburg,2055,5,6,6,12,34,45,-11,24
SC Rheindorf,2055,6,6,5,13,22,35,-13,23
Vienna,2055,7,6,5,13,24,40,-16,23
FC Salzburg,2056,1,14,7,3,44,21,23,49
SK Sturm Gra,2056,2,12,5,7,33,28,5,41
LASK Linz,2056,3,9,7,8,30,26,4,34
Rapid Vienna,2056,4,7,11,6,35,32,3,32
Vienna,2056,5,7,6,11,27,38,-11,27
SC Rheindorf,2056,6,5,7,12,20,31,-11,22
Mattersburg,2056,7,5,7,12,29,42,-13,22
FC Salzburg,2057,1,13,9,2,44,20,24,48
SK Sturm Gra,2057,2,12,4,8,34,32,2,40
Rapid Vienna,2057,3,9,11,4,37,26,11,38
LASK Linz,2057,4,9,6,9,29,27,2,33
Mattersburg,2057,5,7,5,12,31,42,-11,26
Vienna,2057,6,6,6,12,24,40,-16,24
SC Rheindorf,2057,7,5,5,14,19,31,-12,20
FC Salzburg,2058,1,13,7,4,42,17,25,46
SK Sturm Gra,2058,2,14,3,7,34,27,7,45
Rapid Vienna,2058,3,10,9,5,36,26,10,39
LASK Linz,2058,4,8,6,10,28,29,-1,30
Mattersburg,2058,5,6,8,10,30,39,-9,26
Vienna,2058,6,6,6,12,24,42,-18,24
SC Rheindorf,2058,7,4,7,13,17,31,-14,19
FC Salzburg,2059,1,14,6,4,50,22,28,48
SK Sturm Gra,2059,2,12,4,8,33,32,1,40
Rapid Vienna,2059,3,9,10,5,36,25,11,37
LASK Linz,2059,4,7,7,10,28,33,-5,28
Vienna,2059,5,7,6,11,26,39,-13,27
Mattersburg,2059,6,6,7,11,32,45,-13,25
SC Rheindorf,2059,7,6,6,12,21,30,-9,24
FC Salzburg,2060,1,14,8,2,43,17,26,50
Rapid Vienna,2060,2,10,10,4,38,24,14,40
SK Sturm Gra,2060,3,12,4,8,30,28,2,40
Vienna,2060,4,7,6,11,27,40,-13,27
Mattersburg,2060,5,7,5,12,35,44,-9,26
LASK Linz,2060,6,7,5,12,23,33,-10,26
SC Rheindorf,2060,7,5,6,13,19,29,-10,21
FC Salzburg,2061,1,15,7,2,50,20,30,52
SK Sturm Gra,2061,2,13,3,8,34,29,5,42
Rapid Vienna,2061,3,8,11,5,40,32,8,35
LASK Linz,2061,4,9,5,10,26,28,-2,32
Vienna,2061,5,7,5,12,27,41,-14,26
SC Rheindorf,2061,6,5,7,12,20,30,-10,22
Mattersburg,2061,7,5,6,13,28,45,-17,21
FC Salzburg,2062,1,15,7,2,46,19,27,52
SK Sturm Gra,2062,2,12,4,8,31,28,3,40
LASK Linz,2062,3,10,5,9,28,26,2,35
Rapid Vienna,2062,4,8,9,7,34,29,5,33
Vienna,2062,5,7,5,12,29,40,-11,26
SC Rheindorf,2062,6,6,5,13,20,29,-9,23
Mattersburg,2062,7,6,5,13,31,48,-17,23
FC Salzburg,2063,1,13,8,3,44,21,23,47
SK Sturm Gra,2063,2,14,4,6,34,27,7,46
Rapid Vienna,2063,3,8,11,5,37,28,9,35
LASK Linz,2063,4,7,6,11,24,30,-6,27
Vienna,2063,5,7,5,12,29,39,-10,26
Mattersburg,2063,6,6,7,11,30,44,-14,25
SC Rheindorf,2063,7,5,7,12,22,31,-9,22
FC Salzburg,2064,1,14,7,3,43,18,25,49
SK Sturm Gra,2064,2,12,3,9,30,29,1,39
Rapid Vienna,2064,3,9,10,5,35,25,10,37
LASK Linz,2064,4,9,5,10,27,28,-1,32
Vienna,2064,5,7,6,11,30,39,-9,27
Mattersburg,2064,6,6,6,12,28,44,-16,24
SC Rheindorf,2064,7,5,7,12,18,28,-10,22
FC Salzburg,2065,1,14,7,3,45,19,26,49
SK Sturm Gra,2065,2,11,6,7,31,29,2,39
LASK Linz,2065,3,9,7,8,32,27,5,34
Rapid Vienna,2065,4,8,10,6,34,30,4,34
Mattersburg,2065,5,7,5,12,35,46,-11,26
SC Rheindorf,2065,6,6,6,12,21,31,-10,24
Vienna,2065,7,6,5,13,26,42,-16,23
FC Salzburg,2066,1,15,7,2,45,19,26,52
SK Sturm Gra,2066,2,13,4,7,38,31,7,43
Rapid Vienna,2066,3,8,9,7,35,30,5,33
LASK Linz,2066,4,8,7,9,28,29,-1,31
Vienna,2066,5,7,5,12,27,41,-14,26
Mattersburg,2066,6,6,7,11,34,41,-7,25
SC Rheindorf,2066,7,5,5,14,21,37,-16,20
FC Salzburg,2067,1,14,6,4,45,19,26,48
SK Sturm Gra,2067,2,12,3,9,35,33,2,39
Rapid Vienna,2067,3,9,11,4,37,26,11,38
LASK Linz,2067,4,7,8,9,29,32,-3,29
Vienna,2067,5,7,5,12,27,41,-14,26
SC Rheindorf,2067,6,6,7,11,23,31,-8,25
Mattersburg,2067,7,6,6,12,31,45,-14,24
FC Salzburg,2068,1,14,6,4,45,18,27,48
Rapid Vienna,2068,2,10,10,4,39,27,12,40
SK Sturm Gra,2068,3,12,4,8,33,30,3,40
LASK Linz,2068,4,9,6,9,27,26,1,33
Mattersburg,2068,5,6,7,11,31,45,-14,25
Vienna,2068,6,6,5,13,25,41,-16,23
SC Rheindorf,2068,7,5,6,13,18,31,-13,21
FC Salzburg,2069,1,15,7,2,48,19,29,52
SK Sturm Gra,2069,2,11,7,6,31,27,4,40
Rapid Vienna,2069,3,7,11,6,35,32,3,32
LASK Linz,2069,4,8,8,8,27,27,0,32
Mattersburg,2069,5,6,6,12,30,43,-13,24
Vienna,2069,6,6,6,12,26,41,-15,24
SC Rheindorf,2069,7,5,7,12,20,28,-8,22
FC Salzburg,2070,1,14,8,2,44,16,28,50
SK Sturm Gra,2070,2,12,4,8,34,33,1,40
Rapid Vienna,2070,3,9,11,4,37,27,10,38
Mattersburg,2070,4,8,5,11,32,40,-8,29
LASK Linz,2070,5,7,7,10,29,32,-3,28
Vienna,2070,6,6,6,12,26,42,-16,24
SC Rheindorf,2070,7,4,7,13,16,28,-12,19
FC Salzburg,2071,1,15,6,3,46,19,27,51
SK Sturm Gra,2071,2,13,4,7,38,32,6,43
LASK Linz,2071,3,10,5,9,30,28,2,35
Rapid Vienna,2071,4,8,10,6,39,34,5,34
Mattersburg,2071,5,7,5,12,30,39,-9,26
Vienna,2071,6,6,5,13,23,40,-17,23
SC Rheindorf,2071,7,5,5,14,21,35,-14,20
FC Salzburg,2072,1,15,6,3,44,17,27,51
SK Sturm Gra,2072,2,14,3,7,37,27,10,45
Rapid Vienna,2072,3,9,9,6,36,31,5,36
LASK Linz,2072,4,10,5,9,30,29,1,35
Vienna,2072,5,7,5,12,26,40,-14,26
SC Rheindorf,2072,6,5,5,14,19,31,-12,20
Mattersburg,2072,7,5,5,14,29,46,-17,20
FC Salzburg,2073,1,15,6,3,46,18,28,51
SK Sturm Gra,2073,2,14,3,7,32,27,5,45
Rapid Vienna,2073,3,9,10,5,37,25,12,37
LASK Linz,2073,4,7,6,11,25,32,-7,27
Vienna,2073,5,7,5,12,24,40,-16,26
Mattersburg,2073,6,6,6,12,33,42,-9,24
SC Rheindorf,2073,7,5,6,13,20,33,-13,21
FC Salzburg,2074,1,15,6,3,43,18,25,51
SK Sturm Gra,2074,2,12,5,7,29,25,4,41
Rapid Vienna,2074,3,7,10,7,31,27,4,31
LASK Linz,2074,4,8,6,10,25,30,-5,30
Vienna,2074,5,8,5,11,26,37,-11,29
SC Rheindorf,2074,6,6,7,11,21,25,-4,25
Mattersburg,2074,7,6,5,13,29,42,-13,23
FC Salzburg,2075,1,15,7,2,49,18,31,52
SK Sturm Gra,2075,2,12,4,8,32,29,3,40
Rapid Vienna,2075,3,8,11,5,35,27,8,35
LASK Linz,2075,4,8,5,11,26,30,-4,29
Vienna,2075,5,7,5,12,27,44,-17,26
SC Rheindorf,2075,6,6,6,12,19,28,-9,24
Mattersburg,2075,7,6,6,12,30,42,-12,24
FC Salzburg,2076,1,15,7,2,46,17,29,52
SK Sturm Gra,2076,2,11,5,8,31,31,0,38
Rapid Vienna,2076,3,8,11,5,35,27,8,35
LASK Linz,2076,4,8,6,10,25,29,-4,30
Vienna,2076,5,7,6,11,26,39,-13,27
Mattersburg,2076,6,7,5,12,33,42,-9,26
SC Rheindorf,2076,7,4,8,12,19,30,-11,20
FC Salzburg,2077,1,14,6,4,45,20,25,48
SK Sturm Gra,2077,2,13,4,7,33,29,4,43
Rapid Vienna,2077,3,8,9,7,35,30,5,33
LASK Linz,2077,4,9,5,10,28,29,-1,32
Vienna,2077,5,8,5,11,28,37,-9,29
Mattersburg,2077,6,7,5,12,30,43,-13,26
SC Rheindorf,2077,7,5,6,13,18,29,-11,21
FC Salzburg,2078,1,16,6,2,48,18,30,54
SK Sturm Gra,2078,2,11,4,9,30,30,0,37
LASK Linz,2078,3,10,5,9,27,25,2,35
Rapid Vienna,2078,4,7,11,6,34,29,5,32
Vienna,2078,5,7,5,12,26,41,-15,26
Mattersburg,2078,6,6,6,12,30,42,-12,24
SC Rheindorf,2078,7,5,7,12,19,29,-10,22
FC Salzburg,2079,1,13,9,2,42,18,24,48
SK Sturm Gra,2079,2,12,5,7,31,26,5,41
Rapid Vienna,2079,3,7,13,4,34,26,8,34
LASK Linz,2079,4,7,7,10,24,29,-5,28
Mattersburg,2079,5,6,8,10,32,40,-8,26
SC Rheindorf,2079,6,6,6,12,21,30,-9,24
Vienna,2079,7,6,6,12,24,39,-15,24
FC Salzburg,2080,1,15,7,2,47,17,30,52
SK Sturm Gra,2080,2,12,3,9,30,31,-1,39
Rapid Vienna,2080,3,8,10,6,34,30,4,34
LASK Linz,2080,4,9,5,10,32,31,1,32
SC Rheindorf,2080,5,7,5,12,24,27,-3,26
Mattersburg,2080,6,7,5,12,30,44,-14,26
Vienna,2080,7,6,5,13,24,41,-17,23
FC Salzburg,2081,1,13,8,3,44,21,23,47
SK Sturm Gra,2081,2,12,5,7,34,28,6,41
LASK Linz,2081,3,9,7,8,28,26,2,34
Rapid Vienna,2081,4,8,9,7,33,29,4,33
Mattersburg,2081,5,7,6,11,32,42,-10,27
Vienna,2081,6,7,6,11,27,39,-12,27
SC Rheindorf,2081,7,4,7,13,18,31,-13,19
FC Salzburg,2082,1,14,7,3,46,19,27,49
SK Sturm Gra,2082,2,13,3,8,33,30,3,42
Rapid Vienna,2082,3,8,11,5,38,27,11,35
LASK Linz,2082,4,7,7,10,28,31,-3,28
Vienna,2082,5,7,5,12,28,41,-13,26
Mattersburg,2082,6,6,7,11,35,48,-13,25
SC Rheindorf,2082,7,6,6,12,20,32,-12,24
FC Salzburg,2083,1,15,6,3,45,19,26,51
SK Sturm Gra,2083,2,14,4,6,32,24,8,46
Rapid Vienna,2083,3,7,11,6,34,30,4,32
LASK Linz,2083,4,8,7,9,27,27,0,31
Mattersburg,2083,5,6,6,12,30,41,-11,24
Vienna,2083,6,6,5,13,23,40,-17,23
SC Rheindorf,2083,7,5,7,12,16,26,-10,22
FC Salzburg,2084,1,16,6,2,45,18,27,54
SK Sturm Gra,2084,2,14,3,7,36,28,8,45
Rapid Vienna,2084,3,8,9,7,37,31,6,33
LASK Linz,2084,4,8,5,11,25,30,-5,29
Vienna,2084,5,7,5,12,27,39,-12,26
SC Rheindorf,2084,6,6,5,13,18,29,-11,23
Mattersburg,2084,7,6,5,13,30,43,-13,23
FC Salzburg,2085,1,14,7,3,47,18,29,49
SK Sturm Gra,2085,2,14,4,6,38,26,12,46
Rapid Vienna,2085,3,7,10,7,31,29,2,31
LASK Linz,2085,4,8,5,11,24,31,-7,29
Vienna,2085,5,8,5,11,27,38,-11,29
Mattersburg,2085,6,7,5,12,31,44,-13,26
SC Rheindorf,2085,7,5,6,13,18,30,-12,21
FC Salzburg,2086,1,12,9,3,39,18,21,45
SK Sturm Gra,2086,2,13,4,7,32,27,5,43
Rapid Vienna,2086,3,8,9,7,34,29,5,33
LASK Linz,2086,4,9,5,10,31,31,0,32
Vienna,2086,5,7,6,11,25,37,-12,27
SC Rheindorf,2086,6,7,5,12,22,28,-6,26
Mattersburg,2086,7,6,6,12,30,43,-13,24
FC Salzburg,2087,1,15,6,3,44,20,24,51
SK Sturm Gra,2087,2,12,4,8,31,28,3,40
Rapid Vienna,2087,3,8,10,6,36,28,8,34
LASK Linz,2087,4,9,6,9,27,27,0,33
Vienna,2087,5,7,5,12,26,40,-14,26
SC Rheindorf,2087,6,6,6,12,23,31,-8,24
Mattersburg,2087,7,6,5,13,30,43,-13,23
FC Salzburg,2088,1,15,7,2,49,20,29,52
SK Sturm Gra,2088,2,12,4,8,33,29,4,40
Rapid Vienna,2088,3,9,10,5,39,28,11,37
LASK Linz,2088,4,10,5,9,29,28,1,35
Mattersburg,2088,5,6,6,12,32,43,-11,24
Vienna,2088,6,6,6,12,24,42,-18,24
SC Rheindorf,2088,7,4,6,14,16,32,-16,18
FC Salzburg,2089,1,13,7,4,42,18,24,46
SK Sturm Gra,2089,2,13,3,8,32,29,3,42
Rapid Vienna,2089,3,9,11,4,37,26,11,38
Mattersburg,2089,4,8,6,10,34,40,-6,30
LASK Linz,2089,5,7,6,11,26,31,-5,27
Vienna,2089,6,6,6,12,25,42,-17,24
SC Rheindorf,2089,7,6,5,13,20,30,-10,23
FC Salzburg,2090,1,15,7,2,48,19,29,52
SK Sturm Gra,2090,2,13,4,7,41,28,13,43
Rapid Vienna,2090,3,7,11,6,32,28,4,32
LASK Linz,2090,4,7,7,10,26,36,-10,28
Vienna,2090,5,7,6,11,28,39,-11,27
SC Rheindorf,2090,6,5,8,11,22,31,-9,23
Mattersburg,2090,7,6,5,13,29,45,-16,23
FC Salzburg,2091,1,16,6,2,47,16,31,54
SK Sturm Gra,2091,2,12,5,7,34,28,6,41
LASK Linz,2091,3,9,6,9,26,26,0,33
Rapid Vienna,2091,4,7,9,8,34,33,1,30
Mattersburg,2091,5,7,5,12,28,41,-13,26
Vienna,2091,6,7,5,12,26,41,-15,26
SC Rheindorf,2091,7,5,6,13,19,29,-10,21
FC Salzburg,2092,1,15,7,2,46,17,29,52
SK Sturm Gra,2092,2,12,3,9,32,30,2,39
Rapid Vienna,2092,3,9,10,5,37,28,9,37
SC Rheindorf,2092,4,7,6,11,22,26,-4,27
LASK Linz,2092,5,7,5,12,27,35,-8,26
Mattersburg,2092,6,7,5,12,33,43,-10,26
Vienna,2092,7,6,6,12,24,42,-18,24
FC Salzburg,2093,1,15,7,2,50,18,32,52
SK Sturm Gra,2093,2,13,3,8,38,31,7,42
Rapid Vienna,2093,3,9,9,6,35,29,6,36
LASK Linz,2093,4,8,5,11,28,32,-4,29
Vienna,2093,5,7,6,11,25,38,-13,27
SC Rheindorf,2093,6,6,5,13,21,31,-10,23
Mattersburg,2093,7,6,5,13,31,49,-18,23
FC Salzburg,2094,1,15,6,3,45,19,26,51
SK Sturm Gra,2094,2,13,3,8,36,28,8,42
Rapid Vienna,2094,3,10,9,5,41,26,15,39
Mattersburg,2094,4,7,6,11,28,39,-11,27
LASK Linz,2094,5,7,6,11,23,35,-12,27
SC Rheindorf,2094,6,6,5,13,20,29,-9,23
Vienna,2094,7,6,5,13,23,40,-17,23
FC Salzburg,2095,1,15,6,3,45,18,27,51
Rapid Vienna,2095,2,10,10,4,35,23,12,40
SK Sturm Gra,2095,3,11,5,8,29,29,0,38
LASK Linz,2095,4,9,6,9,31,28,3,33
Vienna,2095,5,7,5,12,26,41,-15,26
SC Rheindorf,2095,6,5,7,12,21,31,-10,22
Mattersburg,2095,7,5,5,14,28,45,-17,20
FC Salzburg,2096,1,14,8,2,45,16,29,50
SK Sturm Gra,2096,2,13,3,8,33,31,2,42
Rapid Vienna,2096,3,8,10,6,34,30,4,34
LASK Linz,2096,4,8,6,10,28,30,-2,30
Mattersburg,2096,5,6,7,11,29,41,-12,25
Vienna,2096,6,6,7,11,24,38,-14,25
SC Rheindorf,2096,7,6,5,13,21,28,-7,23
FC Salzburg,2097,1,15,6,3,47,17,30,51
Rapid Vienna,2097,2,11,9,4,40,25,15,42
SK Sturm Gra,2097,3,11,4,9,32,33,-1,37
LASK Linz,2097,4,8,5,11,27,31,-4,29
Vienna,2097,5,7,5,12,25,38,-13,26
SC Rheindorf,2097,6,6,6,12,19,30,-11,24
Mattersburg,2097,7,6,5,13,29,45,-16,23
FC Salzburg,2098,1,14,7,3,42,18,24,49
SK Sturm Gra,2098,2,13,4,7,31,26,5,43
Rapid Vienna,2098,3,8,9,7,35,30,5,33
LASK Linz,2098,4,9,6,9,27,27,0,33
SC Rheindorf,2098,5,7,6,11,22,28,-6,27
Mattersburg,2098,6,6,5,13,29,41,-12,23
Vienna,2098,7,6,5,13,24,40,-16,23
SK Sturm Gra,2099,1,15,3,6,36,26,10,48
FC Salzburg,2099,2,13,7,4,42,19,23,46
Rapid Vienna,2099,3,7,12,5,39,33,6,33
LASK Linz,2099,4,9,6,9,34,32,2,33
Vienna,2099,5,7,5,12,26,44,-18,26
Mattersburg,2099,6,6,6,12,33,43,-10,24
SC Rheindorf,2099,7,4,7,13,21,34,-13,19
FC Salzburg,2100,1,14,6,4,45,19,26,48
SK Sturm Gra,2100,2,14,4,6,34,25,9,46
Rapid Vienna,2100,3,8,9,7,35,30,5,33
LASK Linz,2100,4,8,7,9,29,32,-3,31
SC Rheindorf,2100,5,6,6,12,21,29,-8,24
Vienna,2100,6,6,6,12,25,41,-16,24
Mattersburg,2100,7,5,8,11,31,44,-13,23
FC Salzburg,2101,1,14,8,2,45,19,26,50
SK Sturm Gra,2101,2,13,4,7,33,28,5,43
Rapid Vienna,2101,3,9,9,6,38,29,9,36
LASK Linz,2101,4,8,6,10,27,29,-2,30
Vienna,2101,5,7,6,11,29,37,-8,27
SC Rheindorf,2101,6,5,7,12,21,32,-11,22
Mattersburg,2101,7,5,6,13,31,50,-19,21
FC Salzburg,2102,1,16,6,2,47,17,30,54
SK Sturm Gra,2102,2,12,3,9,33,29,4,39
Rapid Vienna,2102,3,8,9,7,33,29,4,33
LASK Linz,2102,4,8,6,10,26,31,-5,30
Mattersburg,2102,5,7,5,12,34,41,-7,26
Vienna,2102,6,7,5,12,25,39,-14,26
SC Rheindorf,2102,7,6,6,12,19,31,-12,24
FC Salzburg,2103,1,14,7,3,44,19,25,49
Rapid Vienna,2103,2,9,10,5,40,26,14,37
SK Sturm Gra,2103,3,11,4,9,31,34,-3,37
LASK Linz,2103,4,10,6,8,26,24,2,36
Vienna,2103,5,8,5,11,26,37,-11,29
Mattersburg,2103,6,5,7,12,29,42,-13,22
SC Rheindorf,2103,7,4,7,13,20,34,-14,19
FC Salzburg,2104,1,14,7,3,44,18,26,49
SK Sturm Gra,2104,2,11,6,7,30,28,2,39
Rapid Vienna,2104,3,8,11,5,37,28,9,35
LASK Linz,2104,4,9,7,8,31,30,1,34
Vienna,2104,5,7,6,11,27,39,-12,27
Mattersburg,2104,6,5,7,12,30,46,-16,22
SC Rheindorf,2104,7,5,6,13,21,31,-10,21
FC Salzburg,2105,1,14,6,4,43,21,22,48
Rapid Vienna,2105,2,10,9,5,39,29,10,39
SK Sturm Gra,2105,3,12,3,9,32,31,1,39
LASK Linz,2105,4,9,5,10,30,31,-1,32
Mattersburg,2105,5,7,5,12,34,42,-8,26
Vienna,2105,6,7,5,12,24,38,-14,26
SC Rheindorf,2105,7,6,5,13,21,31,-10,23
FC Salzburg,2106,1,15,6,3,45,18,27,51
SK Sturm Gra,2106,2,13,4,7,36,27,9,43
Rapid Vienna,2106,3,8,11,5,35,27,8,35
LASK Linz,2106,4,9,6,9,27,28,-1,33
Mattersburg,2106,5,7,5,12,30,41,-11,26
Vienna,2106,6,7,5,12,25,39,-14,26
SC Rheindorf,2106,7,4,5,15,17,35,-18,17
FC Salzburg,2107,1,13,8,3,45,22,23,47
SK Sturm Gra,2107,2,13,4,7,35,30,5,43
Rapid Vienna,2107,3,8,10,6,36,28,8,34
LASK Linz,2107,4,8,5,11,25,30,-5,29
Mattersburg,2107,5,7,7,10,36,42,-6,28
Vienna,2107,6,7,5,12,29,43,-14,26
SC Rheindorf,2107,7,5,7,12,18,29,-11,22
FC Salzburg,2108,1,14,6,4,46,22,24,48
SK Sturm Gra,2108,2,13,3,8,33,30,3,42
Rapid Vienna,2108,3,9,9,6,35,26,9,36
LASK Linz,2108,4,9,5,10,28,30,-2,32
Vienna,2108,5,7,5,12,27,41,-14,26
SC Rheindorf,2108,6,6,6,12,22,31,-9,24
Mattersburg,2108,7,6,6,12,33,44,-11,24
FC Salzburg,2109,1,16,6,2,47,19,28,54
SK Sturm Gra,2109,2,13,4,7,35,29,6,43
Rapid Vienna,2109,3,8,9,7,35,30,5,33
LASK Linz,2109,4,9,5,10,28,27,1,32
Mattersburg,2109,5,7,5,12,34,44,-10,26
Vienna,2109,6,6,5,13,26,44,-18,23
SC Rheindorf,2109,7,5,6,13,19,31,-12,21
FC Salzburg,2110,1,14,8,2,46,19,27,50
SK Sturm Gra,2110,2,13,4,7,34,30,4,43
Rapid Vienna,2110,3,8,10,6,37,30,7,34
LASK Linz,2110,4,9,6,9,30,28,2,33
Mattersburg,2110,5,7,5,12,32,42,-10,26
Vienna,2110,6,6,6,12,24,40,-16,24
SC Rheindorf,2110,7,4,7,13,21,35,-14,19
FC Salzburg,2111,1,15,6,3,44,19,25,51
SK Sturm Gra,2111,2,13,3,8,34,29,5,42
Rapid Vienna,2111,3,10,9,5,39,28,11,39
Vienna,2111,4,8,5,11,26,37,-11,29
LASK Linz,2111,5,7,6,11,29,36,-7,27
Mattersburg,2111,6,6,5,13,31,43,-12,23
SC Rheindorf,2111,7,5,6,13,20,31,-11,21
FC Salzburg,2112,1,14,8,2,45,19,26,50
SK Sturm Gra,2112,2,13,4,7,33,27,6,43
LASK Linz,2112,3,9,5,10,28,28,0,32
Rapid Vienna,2112,4,7,10,7,34,32,2,31
Mattersburg,2112,5,7,6,11,32,40,-8,27
Vienna,2112,6,6,6,12,24,39,-15,24
SC Rheindorf,2112,7,5,7,12,18,29,-11,22
FC Salzburg,2113,1,14,7,3,44,18,26,49
LASK Linz,2113,2,11,5,8,37,28,9,38
SK Sturm Gra,2113,3,11,4,9,30,31,-1,37
Rapid Vienna,2113,4,8,10,6,35,29,6,34
Vienna,2113,5,8,5,11,27,37,-10,29
Mattersburg,2113,6,6,6,12,30,43,-13,24
SC Rheindorf,2113,7,5,5,14,19,36,-17,20
FC Salzburg,2114,1,12,9,3,39,20,19,45
SK Sturm Gra,2114,2,13,4,7,33,29,4,43
Rapid Vienna,2114,3,9,9,6,40,31,9,36
LASK Linz,2114,4,9,5,10,31,29,2,32
Mattersburg,2114,5,7,6,11,31,39,-8,27
Vienna,2114,6,7,6,11,25,38,-13,27
SC Rheindorf,2114,7,5,5,14,18,31,-13,20
FC Salzburg,2115,1,14,7,3,48,19,29,49
SK Sturm Gra,2115,2,14,3,7,38,29,9,45
Rapid Vienna,2115,3,9,10,5,35,26,9,37
LASK Linz,2115,4,7,7,10,26,29,-3,28
Vienna,2115,5,6,7,11,25,39,-14,25
Mattersburg,2115,6,5,8,11,31,45,-14,23
SC Rheindorf,2115,7,5,6,13,19,35,-16,21
FC Salzburg,2116,1,15,7,2,46,18,28,52
SK Sturm Gra,2116,2,12,4,8,33,31,2,40
Rapid Vienna,2116,3,9,9,6,40,32,8,36
LASK Linz,2116,4,9,6,9,30,29,1,33
Vienna,2116,5,7,6,11,25,38,-13,27
SC Rheindorf,2116,6,5,6,13,22,34,-12,21
Mattersburg,2116,7,5,6,13,29,43,-14,21
FC Salzburg,2117,1,15,6,3,49,17,32,51
SK Sturm Gra,2117,2,11,4,9,31,36,-5,37
Rapid Vienna,2117,3,8,9,7,35,29,6,33
LASK Linz,2117,4,9,6,9,30,30,0,33
SC Rheindorf,2117,5,7,6,11,24,31,-7,27
Vienna,2117,6,7,5,12,25,39,-14,26
Mattersburg,2117,7,6,6,12,34,46,-12,24
FC Salzburg,2118,1,13,6,5,42,23,19,45
SK Sturm Gra,2118,2,13,5,6,34,27,7,44
Rapid Vienna,2118,3,9,11,4,36,26,10,38
Mattersburg,2118,4,8,6,10,31,36,-5,30
LASK Linz,2118,5,7,8,9,25,27,-2,29
Vienna,2118,6,6,5,13,24,41,-17,23
SC Rheindorf,2118,7,4,7,13,16,28,-12,19
FC Salzburg,2119,1,15,7,2,44,18,26,52
SK Sturm Gra,2119,2,13,4,7,34,27,7,43
Rapid Vienna,2119,3,9,9,6,38,29,9,36
LASK Linz,2119,4,8,6,10,27,29,-2,30
Mattersburg,2119,5,7,5,12,31,39,-8,26
Vienna,2119,6,6,6,12,24,39,-15,24
SC Rheindorf,2119,7,5,5,14,18,35,-17,20
FC Salzburg,2120,1,15,7,2,44,17,27,52
SK Sturm Gra,2120,2,13,3,8,33,28,5,42
Rapid Vienna,2120,3,9,9,6,36,32,4,36
LASK Linz,2120,4,9,5,10,30,29,1,32
Mattersburg,2120,5,8,5,11,32,39,-7,29
Vienna,2120,6,6,6,12,24,39,-15,24
SC Rheindorf,2120,7,4,5,15,19,34,-15,17
FC Salzburg,2121,1,16,6,2,47,17,30,54
SK Sturm Gra,2121,2,14,3,7,37,28,9,45
Rapid Vienna,2121,3,9,9,6,37,31,6,36
LASK Linz,2121,4,7,6,11,26,34,-8,27
Vienna,2121,5,7,5,12,25,39,-14,26
Mattersburg,2121,6,6,6,12,32,40,-8,24
SC Rheindorf,2121,7,5,5,14,17,32,-15,20
FC Salzburg,2122,1,14,8,2,46,16,30,50
SK Sturm Gra,2122,2,13,4,7,35,28,7,43
Rapid Vienna,2122,3,8,12,4,33,24,9,36
LASK Linz,2122,4,7,7,10,25,34,-9,28
Mattersburg,2122,5,7,6,11,30,43,-13,27
Vienna,2122,6,6,6,12,25,40,-15,24
SC Rheindorf,2122,7,5,5,14,19,28,-9,20
FC Salzburg,2123,1,15,6,3,44,17,27,51
SK Sturm Gra,2123,2,13,4,7,33,28,5,43
Rapid Vienna,2123,3,9,9,6,35,27,8,36
LASK Linz,2123,4,9,5,10,29,30,-1,32
SC Rheindorf,2123,5,6,6,12,23,28,-5,24
Mattersburg,2123,6,6,5,13,30,46,-16,23
Vienna,2123,7,6,5,13,25,43,-18,23
FC Salzburg,2124,1,15,6,3,45,18,27,51
SK Sturm Gra,2124,2,12,4,8,31,28,3,40
Rapid Vienna,2124,3,7,11,6,32,26,6,32
LASK Linz,2124,4,7,8,9,26,28,-2,29
Vienna,2124,5,8,5,11,27,39,-12,29
SC Rheindorf,2124,6,6,6,12,20,30,-10,24
Mattersburg,2124,7,6,6,12,31,43,-12,24
FC Salzburg,2125,1,12,8,4,41,21,20,44
Rapid Vienna,2125,2,10,10,4,36,24,12,40
SK Sturm Gra,2125,3,11,5,8,32,31,1,38
Vienna,2125,4,8,5,11,25,37,-12,29
LASK Linz,2125,5,7,7,10,26,30,-4,28
Mattersburg,2125,6,7,6,11,31,38,-7,27
SC Rheindorf,2125,7,5,7,12,21,31,-10,22
FC Salzburg,2126,1,15,7,2,46,19,27,52
SK Sturm Gra,2126,2,13,4,7,34,29,5,43
Rapid Vienna,2126,3,7,11,6,33,28,5,32
LASK Linz,2126,4,8,7,9,26,27,-1,31
Vienna,2126,5,7,6,11,26,39,-13,27
Mattersburg,2126,6,6,6,12,29,40,-11,24
SC Rheindorf,2126,7,4,7,13,15,27,-12,19
SK Sturm Gra,2127,1,14,4,6,36,27,9,46
FC Salzburg,2127,2,13,6,5,44,23,21,45
Rapid Vienna,2127,3,9,10,5,36,27,9,37
Vienna,2127,4,8,5,11,27,37,-10,29
LASK Linz,2127,5,7,6,11,23,32,-9,27
SC Rheindorf,2127,6,6,6,12,21,29,-8,24
Mattersburg,2127,7,6,5,13,30,42,-12,23
FC Salzburg,2128,1,14,8,2,50,20,30,50
SK Sturm Gra,2128,2,13,3,8,34,32,2,42
Rapid Vienna,2128,3,10,10,4,47,29,18,40
LASK Linz,2128,4,9,5,10,27,31,-4,32
Vienna,2128,5,7,5,12,27,44,-17,26
Mattersburg,2128,6,5,7,12,26,40,-14,22
SC Rheindorf,2128,7,4,6,14,15,30,-15,18
FC Salzburg,2129,1,15,7,2,48,18,30,52
SK Sturm Gra,2129,2,11,6,7,32,29,3,39
Rapid Vienna,2129,3,9,10,5,35,26,9,37
Mattersburg,2129,4,8,5,11,31,42,-11,29
LASK Linz,2129,5,7,6,11,24,31,-7,27
Vienna,2129,6,6,6,12,24,39,-15,24
SC Rheindorf,2129,7,5,6,13,20,29,-9,21
FC Salzburg,2130,1,12,9,3,45,25,20,45
SK Sturm Gra,2130,2,12,5,7,32,28,4,41
Rapid Vienna,2130,3,9,10,5,40,28,12,37
LASK Linz,2130,4,8,8,8,30,30,0,32
Mattersburg,2130,5,7,7,10,34,40,-6,28
Vienna,2130,6,6,6,12,26,41,-15,24
SC Rheindorf,2130,7,4,7,13,18,33,-15,19
FC Salzburg,2131,1,16,6,2,47,16,31,54
SK Sturm Gra,2131,2,12,5,7,31,28,3,41
Rapid Vienna,2131,3,9,9,6,35,27,8,36
LASK Linz,2131,4,8,7,9,25,26,-1,31
Vienna,2131,5,6,6,12,24,39,-15,24
Mattersburg,2131,6,5,7,12,30,44,-14,22
SC Rheindorf,2131,7,4,8,12,19,31,-12,20
FC Salzburg,2132,1,15,6,3,47,18,29,51
SK Sturm Gra,2132,2,12,5,7,31,27,4,41
Rapid Vienna,2132,3,9,10,5,36,26,10,37
LASK Linz,2132,4,9,5,10,27,30,-3,32
Mattersburg,2132,5,6,6,12,29,42,-13,24
Vienna,2132,6,6,6,12,26,41,-15,24
SC Rheindorf,2132,7,5,6,13,17,29,-12,21
FC Salzburg,2133,1,15,6,3,47,21,26,51
SK Sturm Gra,2133,2,13,4,7,33,29,4,43
Rapid Vienna,2133,3,8,9,7,36,30,6,33
LASK Linz,2133,4,8,6,10,27,33,-6,30
Mattersburg,2133,5,8,5,11,34,40,-6,29
Vienna,2133,6,7,5,12,25,38,-13,26
SC Rheindorf,2133,7,5,5,14,20,31,-11,20
FC Salzburg,2134,1,15,7,2,45,17,28,52
SK Sturm Gra,2134,2,13,3,8,32,27,5,42
Rapid Vienna,2134,3,8,10,6,34,26,8,34
LASK Linz,2134,4,9,5,10,29,30,-1,32
SC Rheindorf,2134,5,7,5,12,22,28,-6,26
Vienna,2134,6,7,5,12,27,40,-13,26
Mattersburg,2134,7,5,5,14,30,51,-21,20
FC Salzburg,2135,1,14,6,4,49,22,27,48
SK Sturm Gra,2135,2,13,5,6,36,29,7,44
Rapid Vienna,2135,3,8,11,5,37,30,7,35
LASK Linz,2135,4,7,7,10,28,31,-3,28
Mattersburg,2135,5,6,7,11,31,45,-14,25
SC Rheindorf,2135,6,6,6,12,23,31,-8,24
Vienna,2135,7,6,6,12,25,41,-16,24
FC Salzburg,2136,1,15,7,2,45,16,29,52
SK Sturm Gra,2136,2,11,6,7,33,30,3,39
Rapid Vienna,2136,3,9,10,5,37,26,11,37
LASK Linz,2136,4,9,5,10,28,30,-2,32
SC Rheindorf,2136,5,6,6,12,21,31,-10,24
Vienna,2136,6,6,6,12,24,42,-18,24
Mattersburg,2136,7,5,6,13,29,42,-13,21
FC Salzburg,2137,1,15,7,2,45,17,28,52
SK Sturm Gra,2137,2,12,3,9,31,32,-1,39
Rapid Vienna,2137,3,8,10,6,36,30,6,34
LASK Linz,2137,4,9,5,10,29,29,0,32
Mattersburg,2137,5,7,6,11,35,41,-6,27
SC Rheindorf,2137,6,6,6,12,20,29,-9,24
Vienna,2137,7,6,5,13,25,43,-18,23
FC Salzburg,2138,1,14,8,2,44,19,25,50
Rapid Vienna,2138,2,9,11,4,36,26,10,38
SK Sturm Gra,2138,3,11,4,9,33,32,1,37
LASK Linz,2138,4,9,6,9,26,27,-1,33
SC Rheindorf,2138,5,7,5,12,23,29,-6,26
Vienna,2138,6,7,5,12,27,40,-13,26
Mattersburg,2138,7,5,5,14,30,46,-16,20
FC Salzburg,2139,1,13,7,4,43,22,21,46
SK Sturm Gra,2139,2,11,6,7,30,27,3,39
Rapid Vienna,2139,3,9,11,4,36,26,10,38
LASK Linz,2139,4,7,8,9,26,29,-3,29
Mattersburg,2139,5,6,8,10,33,41,-8,26
Vienna,2139,6,6,7,11,26,40,-14,25
SC Rheindorf,2139,7,5,7,12,19,28,-9,22
FC Salzburg,2140,1,13,9,2,44,20,24,48
SK Sturm Gra,2140,2,12,4,8,34,31,3,40
Rapid Vienna,2140,3,8,11,5,36,27,9,35
LASK Linz,2140,4,9,6,9,27,28,-1,33
Mattersburg,2140,5,6,7,11,31,41,-10,25
Vienna,2140,6,6,7,11,26,40,-14,25
SC Rheindorf,2140,7,4,8,12,18,29,-11,20
FC Salzburg,2141,1,13,7,4,44,22,22,46
Rapid Vienna,2141,2,11,9,4,38,24,14,42
SK Sturm Gra,2141,3,13,3,8,32,28,4,42
LASK Linz,2141,4,7,6,11,24,31,-7,27
Vienna,2141,5,7,6,11,28,40,-12,27
Mattersburg,2141,6,7,5,12,33,43,-10,26
SC Rheindorf,2141,7,5,6,13,18,29,-11,21
FC Salzburg,2142,1,15,6,3,47,19,28,51
SK Sturm Gra,2142,2,13,4,7,32,28,4,43
Rapid Vienna,2142,3,9,10,5,37,27,10,37
LASK Linz,2142,4,9,6,9,28,27,1,33
Mattersburg,2142,5,7,6,11,31,42,-11,27
Vienna,2142,6,6,5,13,24,40,-16,23
SC Rheindorf,2142,7,4,5,15,16,32,-16,17
FC Salzburg,2143,1,15,6,3,46,19,27,51
SK Sturm Gra,2143,2,14,3,7,33,28,5,45
LASK Linz,2143,3,8,7,9,30,32,-2,31
Rapid Vienna,2143,4,7,9,8,33,32,1,30
Vienna,2143,5,7,5,12,26,40,-14,26
Mattersburg,2143,6,6,7,11,34,43,-9,25
SC Rheindorf,2143,7,5,7,12,19,27,-8,22
FC Salzburg,2144,1,16,6,2,47,16,31,54
SK Sturm Gra,2144,2,13,4,7,35,30,5,43
Rapid Vienna,2144,3,8,9,7,37,31,6,33
LASK Linz,2144,4,9,5,10,31,29,2,32
Mattersburg,2144,5,8,5,11,33,44,-11,29
Vienna,2144,6,6,5,13,25,41,-16,23
SC Rheindorf,2144,7,4,6,14,18,35,-17,18
FC Salzburg,2145,1,16,6,2,53,18,35,54
SK Sturm Gra,2145,2,13,3,8,34,32,2,42
Rapid Vienna,2145,3,8,9,7,37,33,4,33
LASK Linz,2145,4,9,5,10,32,33,-1,32
Mattersburg,2145,5,7,5,12,30,43,-13,26
Vienna,2145,6,7,5,12,27,41,-14,26
SC Rheindorf,2145,7,5,5,14,18,31,-13,20
FC Salzburg,2146,1,15,7,2,47,19,28,52
SK Sturm Gra,2146,2,12,3,9,31,29,2,39
LASK Linz,2146,3,10,6,8,30,27,3,36
Rapid Vienna,2146,4,8,11,5,36,29,7,35
Mattersburg,2146,5,6,6,12,31,42,-11,24
Vienna,2146,6,6,5,13,26,44,-18,23
SC Rheindorf,2146,7,4,8,12,19,30,-11,20
FC Salzburg,2147,1,15,7,2,47,19,28,52
SK Sturm Gra,2147,2,13,4,7,33,27,6,43
Rapid Vienna,2147,3,8,11,5,34,25,9,35
LASK Linz,2147,4,8,6,10,26,29,-3,30
Mattersburg,2147,5,7,6,11,36,43,-7,27
Vienna,2147,6,6,6,12,28,43,-15,24
SC Rheindorf,2147,7,4,6,14,16,34,-18,18
FC Salzburg,2148,1,14,7,3,45,18,27,49
SK Sturm Gra,2148,2,13,5,6,32,25,7,44
LASK Linz,2148,3,10,5,9,30,30,0,35
Rapid Vienna,2148,4,8,9,7,36,29,7,33
Mattersburg,2148,5,7,5,12,34,46,-12,26
Vienna,2148,6,7,5,12,25,39,-14,26
SC Rheindorf,2148,7,4,6,14,19,34,-15,18
FC Salzburg,2149,1,13,7,4,43,19,24,46
SK Sturm Gra,2149,2,13,4,7,34,27,7,43
Rapid Vienna,2149,3,9,9,6,41,31,10,36
LASK Linz,2149,4,9,6,9,29,30,-1,33
Vienna,2149,5,8,5,11,26,37,-11,29
Mattersburg,2149,6,6,6,12,28,42,-14,24
SC Rheindorf,2149,7,5,5,14,19,34,-15,20
FC Salzburg,2150,1,13,7,4,45,22,23,46
SK Sturm Gra,2150,2,14,4,6,35,27,8,46
Rapid Vienna,2150,3,9,10,5,40,29,11,37
LASK Linz,2150,4,8,5,11,28,32,-4,29
Vienna,2150,5,7,6,11,27,39,-12,27
Mattersburg,2150,6,6,6,12,30,45,-15,24
SC Rheindorf,2150,7,4,8,12,23,34,-11,20
FC Salzburg,2151,1,14,7,3,47,20,27,49
SK Sturm Gra,2151,2,13,4,7,36,31,5,43
Rapid Vienna,2151,3,9,10,5,43,32,11,37
LASK Linz,2151,4,8,6,10,29,32,-3,30
Mattersburg,2151,5,7,6,11,32,41,-9,27
Vienna,2151,6,6,5,13,23,42,-19,23
SC Rheindorf,2151,7,5,6,13,21,33,-12,21
FC Salzburg,2152,1,15,6,3,48,18,30,51
SK Sturm Gra,2152,2,12,5,7,36,33,3,41
Rapid Vienna,2152,3,9,11,4,37,26,11,38
LASK Linz,2152,4,7,7,10,25,28,-3,28
Mattersburg,2152,5,6,7,11,31,43,-12,25
Vienna,2152,6,6,6,12,25,42,-17,24
SC Rheindorf,2152,7,5,6,13,20,32,-12,21
FC Salzburg,2153,1,15,6,3,48,17,31,51
SK Sturm Gra,2153,2,12,4,8,31,31,0,40
Rapid Vienna,2153,3,8,10,6,35,27,8,34
LASK Linz,2153,4,9,6,9,27,27,0,33
Vienna,2153,5,7,5,12,25,43,-18,26
SC Rheindorf,2153,6,6,7,11,22,27,-5,25
Mattersburg,2153,7,5,6,13,28,44,-16,21
FC Salzburg,2154,1,15,7,2,47,16,31,52
SK Sturm Gra,2154,2,12,4,8,34,33,1,40
Rapid Vienna,2154,3,8,10,6,38,31,7,34
LASK Linz,2154,4,8,7,9,26,29,-3,31
Mattersburg,2154,5,7,5,12,32,42,-10,26
Vienna,2154,6,7,5,12,25,40,-15,26
SC Rheindorf,2154,7,5,6,13,19,30,-11,21
FC Salzburg,2155,1,14,7,3,44,21,23,49
Rapid Vienna,2155,2,10,10,4,38,25,13,40
SK Sturm Gra,2155,3,12,3,9,31,30,1,39
Vienna,2155,4,8,5,11,33,42,-9,29
LASK Linz,2155,5,7,5,12,25,31,-6,26
SC Rheindorf,2155,6,6,6,12,20,29,-9,24
Mattersburg,2155,7,6,6,12,30,43,-13,24
FC Salzburg,2156,1,13,9,2,42,18,24,48
SK Sturm Gra,2156,2,12,5,7,34,29,5,41
Rapid Vienna,2156,3,8,11,5,36,30,6,35
LASK Linz,2156,4,7,6,11,27,33,-6,27
Vienna,2156,5,7,6,11,25,38,-13,27
SC Rheindorf,2156,6,7,5,12,22,27,-5,26
Mattersburg,2156,7,6,6,12,30,41,-11,24
FC Salzburg,2157,1,14,8,2,41,16,25,50
SK Sturm Gra,2157,2,12,5,7,33,29,4,41
LASK Linz,2157,3,10,6,8,29,25,4,36
Rapid Vienna,2157,4,8,9,7,37,30,7,33
Mattersburg,2157,5,7,5,12,32,41,-9,26
Vienna,2157,6,6,6,12,25,40,-15,24
SC Rheindorf,2157,7,5,5,14,18,34,-16,20
FC Salzburg,2158,1,16,6,2,50,19,31,54
Rapid Vienna,2158,2,10,9,5,37,27,10,39
SK Sturm Gra,2158,3,12,3,9,33,32,1,39
LASK Linz,2158,4,9,5,10,30,31,-1,32
Mattersburg,2158,5,7,5,12,33,45,-12,26
Vienna,2158,6,6,5,13,26,42,-16,23
SC Rheindorf,2158,7,5,5,14,20,33,-13,20
FC Salzburg,2159,1,14,7,3,43,19,24,49
SK Sturm Gra,2159,2,14,4,6,34,27,7,46
Rapid Vienna,2159,3,10,9,5,40,25,15,39
LASK Linz,2159,4,8,6,10,27,31,-4,30
Vienna,2159,5,7,5,12,26,39,-13,26
Mattersburg,2159,6,5,6,13,30,46,-16,21
SC Rheindorf,2159,7,5,5,14,19,32,-13,20
FC Salzburg,2160,1,14,7,3,43,19,24,49
SK Sturm Gra,2160,2,13,4,7,34,28,6,43
Rapid Vienna,2160,3,9,9,6,36,30,6,36
LASK Linz,2160,4,9,5,10,28,27,1,32
SC Rheindorf,2160,5,6,6,12,22,30,-8,24
Vienna,2160,6,6,6,12,24,40,-16,24
Mattersburg,2160,7,6,5,13,29,42,-13,23
FC Salzburg,2161,1,14,8,2,44,17,27,50
Rapid Vienna,2161,2,9,11,4,39,28,11,38
SK Sturm Gra,2161,3,11,3,10,29,32,-3,36
LASK Linz,2161,4,8,7,9,28,27,1,31
Vienna,2161,5,7,6,11,25,37,-12,27
Mattersburg,2161,6,6,6,12,29,42,-13,24
SC Rheindorf,2161,7,6,5,13,21,32,-11,23
FC Salzburg,2162,1,12,9,3,39,17,22,45
SK Sturm Gra,2162,2,13,4,7,33,26,7,43
Rapid Vienna,2162,3,8,10,6,33,27,6,34
LASK Linz,2162,4,8,7,9,26,28,-2,31
Vienna,2162,5,7,6,11,26,39,-13,27
SC Rheindorf,2162,6,6,6,12,22,31,-9,24
Mattersburg,2162,7,5,8,11,32,43,-11,23
FC Salzburg,2163,1,14,6,4,49,21,28,48
SK Sturm Gra,2163,2,13,3,8,34,29,5,42
Rapid Vienna,2163,3,9,11,4,36,26,10,38
LASK Linz,2163,4,7,8,9,25,28,-3,29
Vienna,2163,5,8,5,11,26,38,-12,29
Mattersburg,2163,6,6,6,12,29,44,-15,24
SC Rheindorf,2163,7,4,7,13,15,28,-13,19
FC Salzburg,2164,1,14,8,2,44,17,27,50
SK Sturm Gra,2164,2,12,4,8,35,31,4,40
Rapid Vienna,2164,3,9,9,6,37,32,5,36
LASK Linz,2164,4,9,5,10,30,32,-2,32
Vienna,2164,5,7,5,12,27,40,-13,26
Mattersburg,2164,6,6,6,12,30,43,-13,24
SC Rheindorf,2164,7,6,5,13,23,31,-8,23
FC Salzburg,2165,1,15,6,3,45,18,27,51
SK Sturm Gra,2165,2,13,3,8,35,29,6,42
Rapid Vienna,2165,3,7,11,6,34,30,4,32
LASK Linz,2165,4,8,8,8,30,30,0,32
Mattersburg,2165,5,7,6,11,32,41,-9,27
Vienna,2165,6,7,5,12,24,38,-14,26
SC Rheindorf,2165,7,4,7,13,18,32,-14,19
FC Salzburg,2166,1,14,8,2,48,22,26,50
SK Sturm Gra,2166,2,13,3,8,37,33,4,42
Rapid Vienna,2166,3,9,9,6,38,27,11,36
LASK Linz,2166,4,7,6,11,27,32,-5,27
Mattersburg,2166,5,7,6,11,35,45,-10,27
SC Rheindorf,2166,6,6,6,12,22,33,-11,24
Vienna,2166,7,6,6,12,29,44,-15,24
FC Salzburg,2167,1,14,6,4,44,20,24,48
SK Sturm Gra,2167,2,13,4,7,35,28,7,43
LASK Linz,2167,3,10,5,9,28,26,2,35
Rapid Vienna,2167,4,7,10,7,34,32,2,31
Vienna,2167,5,7,6,11,25,38,-13,27
SC Rheindorf,2167,6,7,5,12,20,28,-8,26
Mattersburg,2167,7,5,6,13,27,41,-14,21
FC Salzburg,2168,1,14,6,4,45,19,26,48
SK Sturm Gra,2168,2,14,4,6,34,26,8,46
Rapid Vienna,2168,3,9,9,6,34,27,7,36
LASK Linz,2168,4,8,6,10,27,29,-2,30
Vienna,2168,5,7,5,12,27,40,-13,26
SC Rheindorf,2168,6,6,7,11,22,29,-7,25
Mattersburg,2168,7,5,5,14,30,49,-19,20
FC Salzburg,2169,1,13,6,5,43,23,20,45
SK Sturm Gra,2169,2,13,4,7,33,28,5,43
Rapid Vienna,2169,3,8,11,5,39,29,10,35
Vienna,2169,4,8,5,11,28,40,-12,29
LASK Linz,2169,5,7,7,10,25,29,-4,28
Mattersburg,2169,6,7,6,11,30,39,-9,27
SC Rheindorf,2169,7,4,9,11,18,28,-10,21
FC Salzburg,2170,1,13,8,3,42,19,23,47
SK Sturm Gra,2170,2,13,4,7,32,27,5,43
Rapid Vienna,2170,3,9,9,6,34,28,6,36
LASK Linz,2170,4,8,5,11,25,29,-4,29
Vienna,2170,5,7,6,11,25,38,-13,27
SC Rheindorf,2170,6,6,6,12,22,28,-6,24
Mattersburg,2170,7,6,6,12,30,41,-11,24
FC Salzburg,2171,1,14,7,3,45,18,27,49
SK Sturm Gra,2171,2,13,5,6,39,29,10,44
Rapid Vienna,2171,3,7,11,6,36,32,4,32
LASK Linz,2171,4,7,6,11,26,34,-8,27
Vienna,2171,5,7,6,11,26,38,-12,27
Mattersburg,2171,6,7,5,12,34,46,-12,26
SC Rheindorf,2171,7,6,6,12,21,30,-9,24
FC Salzburg,2172,1,13,7,4,45,23,22,46
SK Sturm Gra,2172,2,12,5,7,36,30,6,41
Rapid Vienna,2172,3,9,9,6,39,31,8,36
LASK Linz,2172,4,9,7,8,30,28,2,34
Vienna,2172,5,7,6,11,27,40,-13,27
Mattersburg,2172,6,6,6,12,29,44,-15,24
SC Rheindorf,2172,7,5,6,13,21,31,-10,21
FC Salzburg,2173,1,16,6,2,43,15,28,54
SK Sturm Gra,2173,2,14,3,7,37,26,11,45
Rapid Vienna,2173,3,8,10,6,33,28,5,34
LASK Linz,2173,4,7,7,10,25,30,-5,28
Vienna,2173,5,7,5,12,25,40,-15,26
SC Rheindorf,2173,6,5,7,12,18,27,-9,22
Mattersburg,2173,7,5,6,13,27,42,-15,21
FC Salzburg,2174,1,14,7,3,48,20,28,49
SK Sturm Gra,2174,2,13,3,8,34,31,3,42
Rapid Vienna,2174,3,10,9,5,39,30,9,39
LASK Linz,2174,4,9,6,9,32,30,2,33
Vienna,2174,5,7,6,11,26,38,-12,27
Mattersburg,2174,6,6,5,13,34,48,-14,23
SC Rheindorf,2174,7,4,6,14,18,34,-16,18
FC Salzburg,2175,1,15,7,2,48,19,29,52
SK Sturm Gra,2175,2,11,5,8,32,30,2,38
Rapid Vienna,2175,3,7,10,7,34,32,2,31
LASK Linz,2175,4,8,7,9,27,29,-2,31
SC Rheindorf,2175,5,7,6,11,24,29,-5,27
Mattersburg,2175,6,6,8,10,31,40,-9,26
Vienna,2175,7,6,5,13,23,40,-17,23
FC Salzburg,2176,1,13,7,4,42,19,23,46
SK Sturm Gra,2176,2,14,3,7,31,26,5,45
Rapid Vienna,2176,3,10,9,5,38,26,12,39
LASK Linz,2176,4,8,5,11,25,30,-5,29
Mattersburg,2176,5,7,7,10,32,39,-7,28
Vienna,2176,6,6,6,12,24,40,-16,24
SC Rheindorf,2176,7,5,5,14,19,31,-12,20
FC Salzburg,2177,1,13,6,5,44,21,23,45
SK Sturm Gra,2177,2,13,5,6,36,27,9,44
Rapid Vienna,2177,3,8,10,6,33,29,4,34
LASK Linz,2177,4,8,8,8,27,27,0,32
Mattersburg,2177,5,7,5,12,32,43,-11,26
SC Rheindorf,2177,6,6,7,11,20,27,-7,25
Vienna,2177,7,6,5,13,25,43,-18,23
FC Salzburg,2178,1,14,6,4,44,19,25,48
SK Sturm Gra,2178,2,13,3,8,37,30,7,42
Rapid Vienna,2178,3,10,9,5,40,28,12,39
Vienna,2178,4,8,5,11,25,37,-12,29
LASK Linz,2178,5,7,6,11,23,28,-5,27
SC Rheindorf,2178,6,6,6,12,20,33,-13,24
Mattersburg,2178,7,6,5,13,27,41,-14,23
FC Salzburg,2179,1,15,7,2,46,16,30,52
SK Sturm Gra,2179,2,12,4,8,31,28,3,40
Rapid Vienna,2179,3,9,10,5,36,26,10,37
LASK Linz,2179,4,8,5,11,26,31,-5,29
Mattersburg,2179,5,7,5,12,33,44,-11,26
Vienna,2179,6,7,5,12,26,41,-15,26
SC Rheindorf,2179,7,5,6,13,20,32,-12,21
FC Salzburg,2180,1,14,7,3,47,22,25,49
SK Sturm Gra,2180,2,11,5,8,35,34,1,38
Rapid Vienna,2180,3,9,10,5,37,27,10,37
LASK Linz,2180,4,7,9,8,27,28,-1,30
Vienna,2180,5,7,6,11,26,39,-13,27
SC Rheindorf,2180,6,6,6,12,22,31,-9,24
Mattersburg,2180,7,5,7,12,30,43,-13,22
FC Salzburg,2181,1,13,8,3,43,21,22,47
SK Sturm Gra,2181,2,14,3,7,34,26,8,45
Rapid Vienna,2181,3,8,9,7,34,27,7,33
LASK Linz,2181,4,7,7,10,24,29,-5,28
SC Rheindorf,2181,5,7,6,11,19,26,-7,27
Mattersburg,2181,6,6,7,11,31,40,-9,25
Vienna,2181,7,6,6,12,26,42,-16,24
FC Salzburg,2182,1,14,6,4,43,20,23,48
SK Sturm Gra,2182,2,14,4,6,36,27,9,46
Rapid Vienna,2182,3,9,10,5,39,29,10,37
Mattersburg,2182,4,8,5,11,34,39,-5,29
LASK Linz,2182,5,7,6,11,26,31,-5,27
Vienna,2182,6,6,5,13,23,42,-19,23
SC Rheindorf,2182,7,5,6,13,21,34,-13,21
FC Salzburg,2183,1,15,7,2,44,15,29,52
SK Sturm Gra,2183,2,13,3,8,32,28,4,42
Rapid Vienna,2183,3,8,11,5,34,26,8,35
Mattersburg,2183,4,8,5,11,34,42,-8,29
LASK Linz,2183,5,7,6,11,24,30,-6,27
Vienna,2183,6,6,5,13,23,40,-17,23
SC Rheindorf,2183,7,5,7,12,23,33,-10,22
FC Salzburg,2184,1,14,8,2,44,16,28,50
SK Sturm Gra,2184,2,12,3,9,32,29,3,39
Rapid Vienna,2184,3,9,10,5,36,29,7,37
Mattersburg,2184,4,7,7,10,34,41,-7,28
LASK Linz,2184,5,7,6,11,24,30,-6,27
SC Rheindorf,2184,6,6,6,12,20,29,-9,24
Vienna,2184,7,6,6,12,25,41,-16,24
FC Salzburg,2185,1,14,8,2,45,19,26,50
Rapid Vienna,2185,2,10,9,5,39,29,10,39
SK Sturm Gra,2185,3,12,3,9,33,31,2,39
LASK Linz,2185,4,8,5,11,27,32,-5,29
Mattersburg,2185,5,6,7,11,29,39,-10,25
SC Rheindorf,2185,6,6,6,12,19,27,-8,24
Vienna,2185,7,6,6,12,24,39,-15,24
FC Salzburg,2186,1,16,6,2,50,17,33,54
SK Sturm Gra,2186,2,12,3,9,32,32,0,39
Rapid Vienna,2186,3,9,9,6,35,28,7,36
LASK Linz,2186,4,8,5,11,27,30,-3,29
Mattersburg,2186,5,7,6,11,34,45,-11,27
Vienna,2186,6,6,6,12,26,41,-15,24
SC Rheindorf,2186,7,6,5,13,21,32,-11,23
FC Salzburg,2187,1,15,7,2,43,15,28,52
SK Sturm Gra,2187,2,13,3,8,35,28,7,42
Rapid Vienna,2187,3,8,11,5,36,26,10,35
LASK Linz,2187,4,7,6,11,25,36,-11,27
Vienna,2187,5,7,5,12,25,40,-15,26
Mattersburg,2187,6,6,6,12,32,42,-10,24
SC Rheindorf,2187,7,5,8,11,20,29,-9,23
FC Salzburg,2188,1,14,6,4,44,19,25,48
SK Sturm Gra,2188,2,11,5,8,30,29,1,38
Rapid Vienna,2188,3,9,10,5,36,26,10,37
LASK Linz,2188,4,8,7,9,27,29,-2,31
Vienna,2188,5,8,5,11,27,38,-11,29
Mattersburg,2188,6,7,5,12,34,44,-10,26
SC Rheindorf,2188,7,5,6,13,19,32,-13,21
FC Salzburg,2189,1,13,7,4,43,22,21,46
SK Sturm Gra,2189,2,14,4,6,36,27,9,46
Rapid Vienna,2189,3,7,12,5,33,27,6,33
LASK Linz,2189,4,7,7,10,27,30,-3,28
Mattersburg,2189,5,7,5,12,29,41,-12,26
Vienna,2189,6,7,5,12,26,39,-13,26
SC Rheindorf,2189,7,6,6,12,18,26,-8,24
FC Salzburg,2190,1,14,7,3,45,20,25,49
SK Sturm Gra,2190,2,13,3,8,34,31,3,42
Rapid Vienna,2190,3,8,10,6,36,30,6,34
LASK Linz,2190,4,8,6,10,28,33,-5,30
Vienna,2190,5,8,5,11,27,38,-11,29
Mattersburg,2190,6,7,5,12,34,41,-7,26
SC Rheindorf,2190,7,5,6,13,20,31,-11,21
FC Salzburg,2191,1,16,6,2,52,18,34,54
SK Sturm Gra,2191,2,12,4,8,31,30,1,40
LASK Linz,2191,3,10,6,8,29,25,4,36
Rapid Vienna,2191,4,8,10,6,34,28,6,34
Vienna,2191,5,7,5,12,26,41,-15,26
SC Rheindorf,2191,6,5,6,13,17,30,-13,21
Mattersburg,2191,7,5,5,14,28,45,-17,20
FC Salzburg,2192,1,16,6,2,48,16,32,54
SK Sturm Gra,2192,2,13,3,8,33,29,4,42
Rapid Vienna,2192,3,8,9,7,33,28,5,33
LASK Linz,2192,4,9,6,9,28,29,-1,33
Mattersburg,2192,5,6,6,12,28,42,-14,24
Vienna,2192,6,6,6,12,24,40,-16,24
SC Rheindorf,2192,7,5,6,13,19,29,-10,21
FC Salzburg,2193,1,15,7,2,50,16,34,52
SK Sturm Gra,2193,2,13,3,8,32,29,3,42
Rapid Vienna,2193,3,8,10,6,35,29,6,34
LASK Linz,2193,4,9,6,9,29,29,0,33
Mattersburg,2193,5,7,5,12,34,50,-16,26
Vienna,2193,6,6,5,13,24,40,-16,23
SC Rheindorf,2193,7,5,6,13,20,31,-11,21
FC Salzburg,2194,1,15,7,2,48,17,31,52
SK Sturm Gra,2194,2,14,3,7,34,28,6,45
Rapid Vienna,2194,3,8,10,6,35,29,6,34
Mattersburg,2194,4,7,6,11,34,43,-9,27
LASK Linz,2194,5,7,5,12,25,34,-9,26
Vienna,2194,6,6,6,12,25,42,-17,24
SC Rheindorf,2194,7,6,5,13,21,29,-8,23
FC Salzburg,2195,1,15,7,2,45,18,27,52
SK Sturm Gra,2195,2,12,4,8,33,28,5,40
Rapid Vienna,2195,3,9,9,6,34,28,6,36
LASK Linz,2195,4,8,5,11,27,31,-4,29
Mattersburg,2195,5,8,5,11,35,42,-7,29
Vienna,2195,6,6,6,12,27,42,-15,24
SC Rheindorf,2195,7,5,6,13,19,31,-12,21
FC Salzburg,2196,1,15,6,3,45,19,26,51
SK Sturm Gra,2196,2,14,3,7,38,27,11,45
Rapid Vienna,2196,3,8,10,6,35,32,3,34
LASK Linz,2196,4,9,5,10,30,31,-1,32
Mattersburg,2196,5,6,6,12,30,42,-12,24
Vienna,2196,6,6,6,12,25,41,-16,24
SC Rheindorf,2196,7,5,6,13,19,30,-11,21
FC Salzburg,2197,1,14,6,4,50,23,27,48
Rapid Vienna,2197,2,11,9,4,40,24,16,42
SK Sturm Gra,2197,3,12,4,8,34,38,-4,40
LASK Linz,2197,4,7,8,9,26,30,-4,29
Vienna,2197,5,7,5,12,25,40,-15,26
Mattersburg,2197,6,6,7,11,33,41,-8,25
SC Rheindorf,2197,7,4,7,13,18,30,-12,19
FC Salzburg,2198,1,14,8,2,43,18,25,50
SK Sturm Gra,2198,2,12,3,9,33,32,1,39
Rapid Vienna,2198,3,9,10,5,39,28,11,37
LASK Linz,2198,4,7,7,10,26,31,-5,28
Mattersburg,2198,5,6,8,10,33,42,-9,26
SC Rheindorf,2198,6,6,7,11,24,31,-7,25
Vienna,2198,7,6,5,13,25,41,-16,23
FC Salzburg,2199,1,13,8,3,43,20,23,47
SK Sturm Gra,2199,2,12,4,8,34,30,4,40
Rapid Vienna,2199,3,9,10,5,36,28,8,37
LASK Linz,2199,4,8,6,10,27,29,-2,30
Vienna,2199,5,8,5,11,29,39,-10,29
Mattersburg,2199,6,6,6,12,32,45,-13,24
SC Rheindorf,2199,7,6,5,13,20,30,-10,23
FC Salzburg,2200,1,15,7,2,47,19,28,52
SK Sturm Gra,2200,2,13,3,8,36,29,7,42
LASK Linz,2200,3,9,6,9,26,29,-3,33
Rapid Vienna,2200,4,7,11,6,34,30,4,32
Vienna,2200,5,7,5,12,30,42,-12,26
Mattersburg,2200,6,6,5,13,31,44,-13,23
SC Rheindorf,2200,7,5,7,12,20,31,-11,22
FC Salzburg,2201,1,14,8,2,45,19,26,50
SK Sturm Gra,2201,2,12,5,7,32,27,5,41
Rapid Vienna,2201,3,9,10,5,36,27,9,37
LASK Linz,2201,4,8,7,9,27,29,-2,31
Vienna,2201,5,7,5,12,25,38,-13,26
Mattersburg,2201,6,6,6,12,31,43,-12,24
SC Rheindorf,2201,7,4,7,13,18,31,-13,19
FC Salzburg,2202,1,15,6,3,48,22,26,51
SK Sturm Gra,2202,2,13,3,8,36,30,6,42
Rapid Vienna,2202,3,10,9,5,38,29,9,39
LASK Linz,2202,4,8,6,10,29,31,-2,30
Mattersburg,2202,5,6,7,11,31,39,-8,25
Vienna,2202,6,6,5,13,25,44,-19,23
SC Rheindorf,2202,7,5,6,13,16,28,-12,21
FC Salzburg,2203,1,15,6,3,48,20,28,51
SK Sturm Gra,2203,2,12,4,8,32,33,-1,40
Rapid Vienna,2203,3,10,9,5,40,27,13,39
LASK Linz,2203,4,10,5,9,30,27,3,35
Vienna,2203,5,6,6,12,27,43,-16,24
Mattersburg,2203,6,5,7,12,31,43,-12,22
SC Rheindorf,2203,7,4,7,13,18,33,-15,19
FC Salzburg,2204,1,14,7,3,46,19,27,49
Rapid Vienna,2204,2,10,10,4,42,27,15,40
SK Sturm Gra,2204,3,12,3,9,33,36,-3,39
LASK Linz,2204,4,8,7,9,29,29,0,31
Vienna,2204,5,6,6,12,27,43,-16,24
Mattersburg,2204,6,5,8,11,31,44,-13,23
SC Rheindorf,2204,7,5,7,12,22,32,-10,22
FC Salzburg,2205,1,15,6,3,45,18,27,51
SK Sturm Gra,2205,2,12,3,9,32,30,2,39
Rapid Vienna,2205,3,9,10,5,36,26,10,37
LASK Linz,2205,4,9,6,9,30,31,-1,33
Vienna,2205,5,7,5,12,25,38,-13,26
SC Rheindorf,2205,6,6,6,12,21,29,-8,24
Mattersburg,2205,7,5,6,13,29,46,-17,21
FC Salzburg,2206,1,14,6,4,43,19,24,48
SK Sturm Gra,2206,2,13,3,8,32,28,4,42
Rapid Vienna,2206,3,10,9,5,39,24,15,39
Mattersburg,2206,4,7,7,10,35,40,-5,28
LASK Linz,2206,5,7,5,12,23,35,-12,26
SC Rheindorf,2206,6,6,6,12,21,32,-11,24
Vienna,2206,7,6,6,12,26,41,-15,24
FC Salzburg,2207,1,14,8,2,47,20,27,50
SK Sturm Gra,2207,2,12,4,8,30,28,2,40
LASK Linz,2207,3,10,5,9,29,28,1,35
Rapid Vienna,2207,4,8,9,7,35,31,4,33
Mattersburg,2207,5,6,7,11,34,44,-10,25
Vienna,2207,6,6,6,12,23,38,-15,24
SC Rheindorf,2207,7,5,7,12,22,31,-9,22
FC Salzburg,2208,1,14,7,3,45,20,25,49
Rapid Vienna,2208,2,10,10,4,37,25,12,40
SK Sturm Gra,2208,3,11,4,9,33,32,1,37
LASK Linz,2208,4,9,6,9,28,28,0,33
Vienna,2208,5,6,7,11,27,41,-14,25
SC Rheindorf,2208,6,5,7,12,20,30,-10,22
Mattersburg,2208,7,5,7,12,30,44,-14,22
FC Salzburg,2209,1,14,7,3,48,21,27,49
SK Sturm Gra,2209,2,13,4,7,37,29,8,43
Rapid Vienna,2209,3,7,12,5,34,28,6,33
LASK Linz,2209,4,8,8,8,27,27,0,32
Mattersburg,2209,5,6,7,11,34,47,-13,25
Vienna,2209,6,6,6,12,26,41,-15,24
SC Rheindorf,2209,7,5,6,13,18,31,-13,21
FC Salzburg,2210,1,13,9,2,45,21,24,48
SK Sturm Gra,2210,2,12,6,6,32,27,5,42
Rapid Vienna,2210,3,8,11,5,38,28,10,35
LASK Linz,2210,4,7,7,10,25,30,-5,28
Vienna,2210,5,7,6,11,30,42,-12,27
Mattersburg,2210,6,6,7,11,30,41,-11,25
SC Rheindorf,2210,7,5,6,13,19,30,-11,21
FC Salzburg,2211,1,14,7,3,45,20,25,49
SK Sturm Gra,2211,2,13,3,8,34,29,5,42
Rapid Vienna,2211,3,8,11,5,37,29,8,35
LASK Linz,2211,4,7,6,11,24,31,-7,27
Mattersburg,2211,5,7,6,11,31,40,-9,27
SC Rheindorf,2211,6,7,5,12,22,29,-7,26
Vienna,2211,7,6,6,12,24,39,-15,24
FC Salzburg,2212,1,14,6,4,41,18,23,48
SK Sturm Gra,2212,2,12,5,7,31,28,3,41
Rapid Vienna,2212,3,9,10,5,36,25,11,37
LASK Linz,2212,4,9,5,10,28,29,-1,32
Vienna,2212,5,7,6,11,26,38,-12,27
Mattersburg,2212,6,6,7,11,30,40,-10,25
SC Rheindorf,2212,7,4,7,13,19,33,-14,19
FC Salzburg,2213,1,14,7,3,42,18,24,49
SK Sturm Gra,2213,2,12,5,7,34,26,8,41
Rapid Vienna,2213,3,7,11,6,34,28,6,32
LASK Linz,2213,4,8,7,9,28,33,-5,31
Vienna,2213,5,8,5,11,28,38,-10,29
SC Rheindorf,2213,6,5,8,11,22,31,-9,23
Mattersburg,2213,7,5,7,12,31,45,-14,22
FC Salzburg,2214,1,14,7,3,43,18,25,49
SK Sturm Gra,2214,2,13,4,7,32,27,5,43
LASK Linz,2214,3,10,6,8,29,27,2,36
Rapid Vienna,2214,4,7,11,6,33,27,6,32
Vienna,2214,5,6,6,12,25,40,-15,24
SC Rheindorf,2214,6,5,7,12,18,28,-10,22
Mattersburg,2214,7,5,7,12,31,44,-13,22
FC Salzburg,2215,1,16,6,2,48,17,31,54
SK Sturm Gra,2215,2,11,4,9,31,33,-2,37
LASK Linz,2215,3,9,6,9,27,26,1,33
Rapid Vienna,2215,4,7,11,6,35,29,6,32
SC Rheindorf,2215,5,7,6,11,22,28,-6,27
Vienna,2215,6,7,5,12,28,39,-11,26
Mattersburg,2215,7,5,6,13,28,47,-19,21
FC Salzburg,2216,1,14,6,4,43,19,24,48
SK Sturm Gra,2216,2,13,4,7,35,32,3,43
LASK Linz,2216,3,10,6,8,30,26,4,36
Rapid Vienna,2216,4,8,10,6,35,27,8,34
Mattersburg,2216,5,7,6,11,29,39,-10,27
Vienna,2216,6,7,5,12,24,38,-14,26
SC Rheindorf,2216,7,4,5,15,17,32,-15,17
FC Salzburg,2217,1,13,9,2,43,19,24,48
SK Sturm Gra,2217,2,13,5,6,35,27,8,44
Rapid Vienna,2217,3,8,10,6,36,31,5,34
LASK Linz,2217,4,8,8,8,29,28,1,32
Mattersburg,2217,5,5,9,10,29,39,-10,24
Vienna,2217,6,6,6,12,23,38,-15,24
SC Rheindorf,2217,7,4,7,13,20,33,-13,19
FC Salzburg,2218,1,14,7,3,43,17,26,49
SK Sturm Gra,2218,2,12,3,9,31,32,-1,39
LASK Linz,2218,3,10,5,9,31,29,2,35
Rapid Vienna,2218,4,8,10,6,33,27,6,34
Vienna,2218,5,8,5,11,27,38,-11,29
SC Rheindorf,2218,6,6,5,13,22,29,-7,23
Mattersburg,2218,7,6,5,13,33,48,-15,23
FC Salzburg,2219,1,15,7,2,46,18,28,52
SK Sturm Gra,2219,2,11,6,7,32,29,3,39
LASK Linz,2219,3,9,6,9,31,29,2,33
Rapid Vienna,2219,4,7,11,6,35,32,3,32
SC Rheindorf,2219,5,6,7,11,21,29,-8,25
Vienna,2219,6,6,6,12,26,41,-15,24
Mattersburg,2219,7,5,7,12,30,43,-13,22
FC Salzburg,2220,1,13,8,3,42,19,23,47
SK Sturm Gra,2220,2,12,4,8,33,28,5,40
Rapid Vienna,2220,3,9,10,5,37,27,10,37
LASK Linz,2220,4,7,6,11,25,32,-7,27
Vienna,2220,5,7,6,11,25,38,-13,27
Mattersburg,2220,6,7,5,12,30,40,-10,26
SC Rheindorf,2220,7,6,7,11,20,28,-8,25
FC Salzburg,2221,1,14,7,3,47,19,28,49
SK Sturm Gra,2221,2,13,3,8,36,31,5,42
Rapid Vienna,2221,3,8,11,5,37,30,7,35
LASK Linz,2221,4,9,5,10,26,26,0,32
Mattersburg,2221,5,7,5,12,33,46,-13,26
Vienna,2221,6,7,5,12,26,39,-13,26
SC Rheindorf,2221,7,5,6,13,20,34,-14,21
FC Salzburg,2222,1,15,6,3,45,16,29,51
SK Sturm Gra,2222,2,13,4,7,36,29,7,43
Rapid Vienna,2222,3,9,10,5,36,26,10,37
LASK Linz,2222,4,8,7,9,26,29,-3,31
Vienna,2222,5,7,5,12,24,38,-14,26
Mattersburg,2222,6,6,6,12,29,43,-14,24
SC Rheindorf,2222,7,4,6,14,18,33,-15,18
FC Salzburg,2223,1,13,8,3,42,21,21,47
Rapid Vienna,2223,2,11,9,4,41,24,17,42
SK Sturm Gra,2223,3,12,3,9,29,27,2,39
LASK Linz,2223,4,7,6,11,24,29,-5,27
SC Rheindorf,2223,5,7,5,12,21,29,-8,26
Vienna,2223,6,6,7,11,25,39,-14,25
Mattersburg,2223,7,5,8,11,30,43,-13,23
FC Salzburg,2224,1,14,8,2,42,16,26,50
SK Sturm Gra,2224,2,12,4,8,30,28,2,40
Rapid Vienna,2224,3,9,9,6,38,27,11,36
LASK Linz,2224,4,9,5,10,28,31,-3,32
Mattersburg,2224,5,7,5,12,31,43,-12,26
Vienna,2224,6,6,6,12,25,40,-15,24
SC Rheindorf,2224,7,6,5,13,22,31,-9,23
FC Salzburg,2225,1,14,7,3,47,20,27,49
Rapid Vienna,2225,2,10,10,4,38,25,13,40
SK Sturm Gra,2225,3,11,6,7,33,33,0,39
LASK Linz,2225,4,7,7,10,25,32,-7,28
Vienna,2225,5,7,5,12,27,43,-16,26
Mattersburg,2225,6,6,6,12,33,43,-10,24
SC Rheindorf,2225,7,5,7,12,21,28,-7,22
FC Salzburg,2226,1,15,7,2,45,17,28,52
SK Sturm Gra,2226,2,13,3,8,38,30,8,42
Rapid Vienna,2226,3,9,10,5,37,29,8,37
LASK Linz,2226,4,8,5,11,27,32,-5,29
Mattersburg,2226,5,7,5,12,31,39,-8,26
SC Rheindorf,2226,6,6,5,13,18,32,-14,23
Vienna,2226,7,6,5,13,23,40,-17,23
FC Salzburg,2227,1,15,7,2,43,16,27,52
SK Sturm Gra,2227,2,13,3,8,34,29,5,42
Rapid Vienna,2227,3,8,10,6,37,30,7,34
LASK Linz,2227,4,9,7,8,31,30,1,34
Vienna,2227,5,7,6,11,25,38,-13,27
Mattersburg,2227,6,5,7,12,30,43,-13,22
SC Rheindorf,2227,7,4,6,14,19,33,-14,18
FC Salzburg,2228,1,14,7,3,46,21,25,49
SK Sturm Gra,2228,2,12,5,7,31,26,5,41
LASK Linz,2228,3,9,7,8,28,27,1,34
Rapid Vienna,2228,4,8,9,7,35,30,5,33
Vienna,2228,5,8,5,11,28,37,-9,29
SC Rheindorf,2228,6,5,7,12,21,31,-10,22
Mattersburg,2228,7,5,6,13,31,48,-17,21
FC Salzburg,2229,1,12,8,4,41,20,21,44
Rapid Vienna,2229,2,11,9,4,41,26,15,42
SK Sturm Gra,2229,3,11,6,7,34,31,3,39
LASK Linz,2229,4,8,6,10,26,30,-4,30
Mattersburg,2229,5,7,5,12,31,42,-11,26
SC Rheindorf,2229,6,6,6,12,24,32,-8,24
Vienna,2229,7,6,6,12,25,41,-16,24
FC Salzburg,2230,1,15,6,3,45,19,26,51
SK Sturm Gra,2230,2,12,5,7,33,30,3,41
Rapid Vienna,2230,3,8,10,6,34,27,7,34
Vienna,2230,4,8,5,11,28,37,-9,29
LASK Linz,2230,5,7,7,10,25,30,-5,28
Mattersburg,2230,6,7,5,12,33,44,-11,26
SC Rheindorf,2230,7,5,6,13,20,31,-11,21
FC Salzburg,2231,1,15,7,2,47,18,29,52
SK Sturm Gra,2231,2,13,5,6,34,26,8,44
Rapid Vienna,2231,3,8,11,5,34,27,7,35
LASK Linz,2231,4,8,6,10,25,27,-2,30
Vienna,2231,5,7,5,12,25,41,-16,26
SC Rheindorf,2231,6,5,7,12,20,31,-11,22
Mattersburg,2231,7,5,5,14,30,45,-15,20
FC Salzburg,2232,1,15,6,3,48,18,30,51
SK Sturm Gra,2232,2,13,3,8,36,32,4,42
Rapid Vienna,2232,3,9,10,5,34,28,6,37
LASK Linz,2232,4,7,5,12,25,32,-7,26
SC Rheindorf,2232,5,6,7,11,20,26,-6,25
Mattersburg,2232,6,6,7,11,32,41,-9,25
Vienna,2232,7,6,6,12,25,43,-18,24
FC Salzburg,2233,1,15,7,2,51,18,33,52
SK Sturm Gra,2233,2,13,3,8,31,27,4,42
Rapid Vienna,2233,3,8,9,7,34,31,3,33
LASK Linz,2233,4,9,6,9,27,28,-1,33
Mattersburg,2233,5,8,5,11,36,47,-11,29
Vienna,2233,6,6,6,12,27,42,-15,24
SC Rheindorf,2233,7,4,6,14,17,30,-13,18
FC Salzburg,2234,1,15,7,2,43,15,28,52
SK Sturm Gra,2234,2,13,4,7,36,29,7,43
Rapid Vienna,2234,3,8,9,7,35,30,5,33
LASK Linz,2234,4,9,5,10,31,30,1,32
Vienna,2234,5,7,6,11,24,37,-13,27
SC Rheindorf,2234,6,5,7,12,17,29,-12,22
Mattersburg,2234,7,5,6,13,28,44,-16,21
FC Salzburg,2235,1,15,6,3,48,19,29,51
Rapid Vienna,2235,2,10,10,4,37,24,13,40
SK Sturm Gra,2235,3,12,4,8,30,29,1,40
LASK Linz,2235,4,8,5,11,26,30,-4,29
Mattersburg,2235,5,7,5,12,31,44,-13,26
Vienna,2235,6,7,5,12,26,39,-13,26
SC Rheindorf,2235,7,5,5,14,17,30,-13,20
FC Salzburg,2236,1,14,7,3,44,20,24,49
SK Sturm Gra,2236,2,12,4,8,32,30,2,40
Rapid Vienna,2236,3,8,11,5,38,29,9,35
Vienna,2236,4,8,5,11,31,39,-8,29
SC Rheindorf,2236,5,7,6,11,22,28,-6,27
LASK Linz,2236,6,7,5,12,25,31,-6,26
Mattersburg,2236,7,6,6,12,32,47,-15,24
FC Salzburg,2237,1,14,7,3,45,19,26,49
SK Sturm Gra,2237,2,12,5,7,34,30,4,41
Rapid Vienna,2237,3,8,10,6,35,31,4,34
LASK Linz,2237,4,9,6,9,31,27,4,33
Vienna,2237,5,7,6,11,28,41,-13,27
Mattersburg,2237,6,6,6,12,31,43,-12,24
SC Rheindorf,2237,7,5,6,13,18,31,-13,21
FC Salzburg,2238,1,15,7,2,45,19,26,52
SK Sturm Gra,2238,2,11,6,7,31,28,3,39
LASK Linz,2238,3,10,6,8,29,24,5,36
Rapid Vienna,2238,4,7,11,6,34,30,4,32
Vienna,2238,5,7,5,12,27,41,-14,26
Mattersburg,2238,6,6,5,13,34,46,-12,23
SC Rheindorf,2238,7,5,6,13,21,33,-12,21
FC Salzburg,2239,1,15,7,2,47,18,29,52
SK Sturm Gra,2239,2,12,5,7,35,30,5,41
Rapid Vienna,2239,3,9,9,6,36,28,8,36
LASK Linz,2239,4,8,7,9,27,28,-1,31
Vienna,2239,5,7,5,12,26,42,-16,26
Mattersburg,2239,6,6,5,13,31,44,-13,23
SC Rheindorf,2239,7,5,6,13,19,31,-12,21
FC Salzburg,2240,1,13,8,3,43,19,24,47
SK Sturm Gra,2240,2,11,6,7,30,29,1,39
Rapid Vienna,2240,3,8,12,4,37,26,11,36
LASK Linz,2240,4,7,8,9,27,29,-2,29
Mattersburg,2240,5,8,5,11,33,41,-8,29
Vienna,2240,6,7,5,12,25,39,-14,26
SC Rheindorf,2240,7,5,6,13,19,31,-12,21
FC Salzburg,2241,1,15,7,2,45,17,28,52
SK Sturm Gra,2241,2,12,5,7,30,27,3,41
Rapid Vienna,2241,3,8,12,4,35,25,10,36
LASK Linz,2241,4,8,5,11,27,32,-5,29
Mattersburg,2241,5,6,6,12,30,43,-13,24
Vienna,2241,6,6,6,12,25,40,-15,24
SC Rheindorf,2241,7,5,7,12,22,30,-8,22
FC Salzburg,2242,1,12,9,3,40,19,21,45
SK Sturm Gra,2242,2,13,3,8,35,32,3,42
Rapid Vienna,2242,3,9,10,5,36,25,11,37
LASK Linz,2242,4,8,5,11,27,33,-6,29
SC Rheindorf,2242,5,7,5,12,23,28,-5,26
Mattersburg,2242,6,6,7,11,31,41,-10,25
Vienna,2242,7,6,7,11,25,39,-14,25
FC Salzburg,2243,1,12,9,3,41,19,22,45
SK Sturm Gra,2243,2,13,5,6,32,25,7,44
Rapid Vienna,2243,3,10,9,5,35,26,9,39
LASK Linz,2243,4,7,7,10,27,30,-3,28
Vienna,2243,5,6,7,11,24,38,-14,25
Mattersburg,2243,6,5,9,10,30,40,-10,24
SC Rheindorf,2243,7,4,8,12,17,28,-11,20
FC Salzburg,2244,1,13,8,3,42,19,23,47
SK Sturm Gra,2244,2,13,4,7,36,28,8,43
Rapid Vienna,2244,3,7,12,5,33,28,5,33
Mattersburg,2244,4,8,6,10,33,38,-5,30
LASK Linz,2244,5,7,7,10,26,31,-5,28
Vienna,2244,6,6,6,12,24,39,-15,24
SC Rheindorf,2244,7,5,7,12,20,31,-11,22
SK Sturm Gra,2245,1,14,4,6,35,27,8,46
FC Salzburg,2245,2,13,6,5,44,26,18,45
Rapid Vienna,2245,3,10,10,4,38,25,13,40
LASK Linz,2245,4,9,5,10,26,28,-2,32
Vienna,2245,5,8,5,11,27,38,-11,29
Mattersburg,2245,6,5,6,13,31,44,-13,21
SC Rheindorf,2245,7,4,6,14,20,33,-13,18
FC Salzburg,2246,1,15,6,3,46,19,27,51
SK Sturm Gra,2246,2,11,5,8,31,31,0,38
Rapid Vienna,2246,3,8,12,4,36,27,9,36
LASK Linz,2246,4,9,7,8,28,25,3,34
Vienna,2246,5,7,5,12,26,40,-14,26
Mattersburg,2246,6,5,7,12,28,42,-14,22
SC Rheindorf,2246,7,4,8,12,18,29,-11,20
FC Salzburg,2247,1,15,7,2,49,20,29,52
SK Sturm Gra,2247,2,12,3,9,31,28,3,39
LASK Linz,2247,3,9,7,8,28,26,2,34
Rapid Vienna,2247,4,7,10,7,33,30,3,31
Vienna,2247,5,7,6,11,28,40,-12,27
Mattersburg,2247,6,6,6,12,31,44,-13,24
SC Rheindorf,2247,7,6,5,13,18,30,-12,23
FC Salzburg,2248,1,15,7,2,48,18,30,52
Rapid Vienna,2248,2,9,10,5,34,27,7,37
LASK Linz,2248,3,10,6,8,31,27,4,36
SK Sturm Gra,2248,4,11,3,10,31,34,-3,36
Vienna,2248,5,6,7,11,26,40,-14,25
SC Rheindorf,2248,6,6,5,13,19,28,-9,23
Mattersburg,2248,7,5,6,13,28,43,-15,21
FC Salzburg,2249,1,14,6,4,42,19,23,48
SK Sturm Gra,2249,2,14,4,6,35,26,9,46
Rapid Vienna,2249,3,10,9,5,36,28,8,39
LASK Linz,2249,4,7,6,11,25,30,-5,27
SC Rheindorf,2249,5,6,6,12,22,28,-6,24
Vienna,2249,6,6,6,12,23,38,-15,24
Mattersburg,2249,7,5,7,12,28,42,-14,22
FC Salzburg,2250,1,15,7,2,47,17,30,52
SK Sturm Gra,2250,2,11,6,7,31,31,0,39
LASK Linz,2250,3,9,7,8,28,27,1,34
Rapid Vienna,2250,4,7,11,6,33,28,5,32
Vienna,2250,5,7,6,11,26,38,-12,27
Mattersburg,2250,6,6,6,12,31,42,-11,24
SC Rheindorf,2250,7,4,7,13,19,32,-13,19
FC Salzburg,2251,1,15,7,2,48,19,29,52
SK Sturm Gra,2251,2,12,5,7,33,28,5,41
Rapid Vienna,2251,3,9,10,5,39,27,12,37
Mattersburg,2251,4,7,6,11,36,41,-5,27
LASK Linz,2251,5,7,6,11,23,31,-8,27
Vienna,2251,6,6,6,12,26,42,-16,24
SC Rheindorf,2251,7,5,6,13,17,34,-17,21
FC Salzburg,2252,1,15,6,3,48,16,32,51
SK Sturm Gra,2252,2,13,3,8,32,27,5,42
Rapid Vienna,2252,3,9,10,5,36,30,6,37
LASK Linz,2252,4,8,7,9,28,31,-3,31
Vienna,2252,5,7,5,12,25,39,-14,26
SC Rheindorf,2252,6,6,6,12,22,30,-8,24
Mattersburg,2252,7,5,5,14,30,48,-18,20
FC Salzburg,2253,1,15,6,3,47,20,27,51
SK Sturm Gra,2253,2,11,5,8,30,29,1,38
Rapid Vienna,2253,3,9,10,5,36,28,8,37
LASK Linz,2253,4,8,7,9,27,27,0,31
Mattersburg,2253,5,6,7,11,33,42,-9,25
Vienna,2253,6,6,6,12,27,43,-16,24
SC Rheindorf,2253,7,6,5,13,20,31,-11,23
FC Salzburg,2254,1,13,8,3,40,17,23,47
Rapid Vienna,2254,2,10,10,4,40,25,15,40
SK Sturm Gra,2254,3,12,4,8,33,31,2,40
LASK Linz,2254,4,8,6,10,31,34,-3,30
Vienna,2254,5,8,5,11,26,38,-12,29
Mattersburg,2254,6,7,5,12,34,42,-8,26
SC Rheindorf,2254,7,4,6,14,17,34,-17,18
FC Salzburg,2255,1,16,6,2,49,18,31,54
SK Sturm Gra,2255,2,12,4,8,30,29,1,40
LASK Linz,2255,3,10,5,9,30,26,4,35
Rapid Vienna,2255,4,8,10,6,35,29,6,34
Vienna,2255,5,7,5,12,29,39,-10,26
SC Rheindorf,2255,6,6,5,13,21,31,-10,23
Mattersburg,2255,7,5,5,14,27,49,-22,20
FC Salzburg,2256,1,15,6,3,47,17,30,51
SK Sturm Gra,2256,2,11,5,8,32,33,-1,38
LASK Linz,2256,3,10,6,8,30,27,3,36
Rapid Vienna,2256,4,8,11,5,34,26,8,35
Vienna,2256,5,7,5,12,26,40,-14,26
Mattersburg,2256,6,6,6,12,30,44,-14,24
SC Rheindorf,2256,7,4,7,13,17,29,-12,19
FC Salzburg,2257,1,14,6,4,41,19,22,48
SK Sturm Gra,2257,2,14,4,6,36,28,8,46
Rapid Vienna,2257,3,7,11,6,34,28,6,32
Vienna,2257,4,8,5,11,25,37,-12,29
LASK Linz,2257,5,7,7,10,29,32,-3,28
SC Rheindorf,2257,6,5,8,11,21,30,-9,23
Mattersburg,2257,7,5,7,12,29,41,-12,22
FC Salzburg,2258,1,13,6,5,45,19,26,45
SK Sturm Gra,2258,2,14,3,7,33,27,6,45
Rapid Vienna,2258,3,8,9,7,35,30,5,33
LASK Linz,2258,4,8,7,9,27,28,-1,31
SC Rheindorf,2258,5,7,6,11,23,29,-6,27
Vienna,2258,6,7,5,12,24,38,-14,26
Mattersburg,2258,7,6,6,12,28,44,-16,24
FC Salzburg,2259,1,16,6,2,48,16,32,54
SK Sturm Gra,2259,2,11,5,8,31,29,2,38
Rapid Vienna,2259,3,8,10,6,36,27,9,34
LASK Linz,2259,4,9,6,9,27,29,-2,33
SC Rheindorf,2259,5,6,6,12,20,29,-9,24
Vienna,2259,6,6,6,12,24,40,-16,24
Mattersburg,2259,7,5,7,12,30,46,-16,22
FC Salzburg,2260,1,13,9,2,43,17,26,48
SK Sturm Gra,2260,2,11,6,7,30,27,3,39
Rapid Vienna,2260,3,9,11,4,35,25,10,38
LASK Linz,2260,4,8,7,9,28,29,-1,31
Mattersburg,2260,5,7,6,11,33,44,-11,27
Vienna,2260,6,6,7,11,26,40,-14,25
SC Rheindorf,2260,7,4,6,14,15,28,-13,18
FC Salzburg,2261,1,12,10,2,41,18,23,46
Rapid Vienna,2261,2,9,11,4,36,26,10,38
SK Sturm Gra,2261,3,11,4,9,29,29,0,37
LASK Linz,2261,4,9,6,9,30,30,0,33
Mattersburg,2261,5,6,7,11,31,41,-10,25
Vienna,2261,6,6,7,11,24,38,-14,25
SC Rheindorf,2261,7,6,5,13,19,28,-9,23
FC Salzburg,2262,1,14,7,3,47,21,26,49
Rapid Vienna,2262,2,11,9,4,42,26,16,42
SK Sturm Gra,2262,3,13,3,8,31,27,4,42
LASK Linz,2262,4,8,5,11,31,35,-4,29
Mattersburg,2262,5,7,5,12,33,46,-13,26
Vienna,2262,6,6,6,12,27,42,-15,24
SC Rheindorf,2262,7,5,5,14,18,32,-14,20
SK Sturm Gra,2263,1,13,4,7,32,27,5,43
FC Salzburg,2263,2,12,6,6,40,23,17,42
Rapid Vienna,2263,3,10,9,5,38,27,11,39
LASK Linz,2263,4,9,6,9,30,28,2,33
Vienna,2263,5,8,5,11,28,39,-11,29
Mattersburg,2263,6,6,6,12,29,40,-11,24
SC Rheindorf,2263,7,4,8,12,17,30,-13,20
FC Salzburg,2264,1,13,8,3,41,18,23,47
Rapid Vienna,2264,2,10,10,4,38,25,13,40
SK Sturm Gra,2264,3,11,6,7,33,30,3,39
LASK Linz,2264,4,7,6,11,25,31,-6,27
Mattersburg,2264,5,7,6,11,32,40,-8,27
SC Rheindorf,2264,6,6,6,12,21,30,-9,24
Vienna,2264,7,6,6,12,26,42,-16,24
FC Salzburg,2265,1,15,7,2,47,19,28,52
SK Sturm Gra,2265,2,13,4,7,36,31,5,43
Rapid Vienna,2265,3,9,10,5,39,28,11,37
LASK Linz,2265,4,8,6,10,27,31,-4,30
Vienna,2265,5,7,5,12,24,39,-15,26
Mattersburg,2265,6,5,7,12,28,41,-13,22
SC Rheindorf,2265,7,4,7,13,18,30,-12,19
FC Salzburg,2266,1,14,8,2,45,19,26,50
SK Sturm Gra,2266,2,12,5,7,34,27,7,41
Rapid Vienna,2266,3,9,10,5,34,28,6,37
LASK Linz,2266,4,8,6,10,26,29,-3,30
Vienna,2266,5,7,5,12,26,40,-14,26
Mattersburg,2266,6,6,5,13,30,43,-13,23
SC Rheindorf,2266,7,5,7,12,19,28,-9,22
FC Salzburg,2267,1,15,7,2,44,17,27,52
SK Sturm Gra,2267,2,12,4,8,30,28,2,40
Rapid Vienna,2267,3,9,9,6,34,26,8,36
LASK Linz,2267,4,9,5,10,30,29,1,32
Mattersburg,2267,5,7,6,11,35,44,-9,27
Vienna,2267,6,7,5,12,26,40,-14,26
SC Rheindorf,2267,7,4,6,14,18,33,-15,18
FC Salzburg,2268,1,14,6,4,46,18,28,48
SK Sturm Gra,2268,2,12,4,8,31,31,0,40
Rapid Vienna,2268,3,9,9,6,34,26,8,36
LASK Linz,2268,4,9,5,10,27,29,-2,32
Vienna,2268,5,8,5,11,26,38,-12,29
Mattersburg,2268,6,6,6,12,33,45,-12,24
SC Rheindorf,2268,7,5,7,12,18,28,-10,22
FC Salzburg,2269,1,15,7,2,47,18,29,52
SK Sturm Gra,2269,2,13,3,8,35,31,4,42
Rapid Vienna,2269,3,8,9,7,35,33,2,33
LASK Linz,2269,4,9,5,10,32,30,2,32
Vienna,2269,5,7,6,11,26,39,-13,27
Mattersburg,2269,6,6,6,12,30,41,-11,24
SC Rheindorf,2269,7,5,6,13,18,31,-13,21
FC Salzburg,2270,1,15,6,3,46,20,26,51
SK Sturm Gra,2270,2,13,3,8,34,29,5,42
Rapid Vienna,2270,3,8,10,6,39,32,7,34
LASK Linz,2270,4,8,6,10,28,30,-2,30
Mattersburg,2270,5,7,6,11,33,38,-5,27
SC Rheindorf,2270,6,6,6,12,19,29,-10,24
Vienna,2270,7,6,5,13,23,44,-21,23
FC Salzburg,2271,1,15,7,2,46,19,27,52
SK Sturm Gra,2271,2,12,3,9,30,30,0,39
Rapid Vienna,2271,3,9,11,4,38,28,10,38
LASK Linz,2271,4,8,6,10,29,30,-1,30
Mattersburg,2271,5,6,6,12,30,42,-12,24
Vienna,2271,6,6,6,12,24,39,-15,24
SC Rheindorf,2271,7,6,5,13,20,29,-9,23
FC Salzburg,2272,1,15,6,3,45,17,28,51
SK Sturm Gra,2272,2,11,5,8,31,31,0,38
Rapid Vienna,2272,3,8,10,6,36,28,8,34
LASK Linz,2272,4,9,7,8,30,27,3,34
Vienna,2272,5,8,5,11,28,37,-9,29
SC Rheindorf,2272,6,5,7,12,19,30,-11,22
Mattersburg,2272,7,5,6,13,27,46,-19,21
FC Salzburg,2273,1,14,8,2,45,19,26,50
SK Sturm Gra,2273,2,13,4,7,33,29,4,43
Rapid Vienna,2273,3,9,10,5,35,26,9,37
Mattersburg,2273,4,8,5,11,37,42,-5,29
LASK Linz,2273,5,7,5,12,24,30,-6,26
SC Rheindorf,2273,6,6,5,13,22,32,-10,23
Vienna,2273,7,6,5,13,25,43,-18,23
FC Salzburg,2274,1,14,8,2,48,20,28,50
Rapid Vienna,2274,2,9,11,4,38,27,11,38
SK Sturm Gra,2274,3,11,3,10,29,31,-2,36
LASK Linz,2274,4,8,7,9,24,26,-2,31
Mattersburg,2274,5,7,6,11,32,42,-10,27
Vienna,2274,6,6,6,12,28,43,-15,24
SC Rheindorf,2274,7,5,7,12,21,31,-10,22
FC Salzburg,2275,1,14,7,3,46,19,27,49
SK Sturm Gra,2275,2,12,5,7,30,26,4,41
Rapid Vienna,2275,3,8,11,5,38,30,8,35
LASK Linz,2275,4,8,7,9,27,28,-1,31
Vienna,2275,5,8,5,11,27,39,-12,29
SC Rheindorf,2275,6,6,5,13,21,31,-10,23
Mattersburg,2275,7,5,6,13,29,45,-16,21
FC Salzburg,2276,1,15,6,3,47,18,29,51
SK Sturm Gra,2276,2,12,5,7,30,29,1,41
LASK Linz,2276,3,8,8,8,31,30,1,32
Rapid Vienna,2276,4,7,10,7,35,30,5,31
Mattersburg,2276,5,7,6,11,31,41,-10,27
Vienna,2276,6,6,6,12,25,41,-16,24
SC Rheindorf,2276,7,5,7,12,18,28,-10,22
FC Salzburg,2277,1,16,6,2,50,21,29,54
SK Sturm Gra,2277,2,12,4,8,33,31,2,40
Rapid Vienna,2277,3,9,9,6,36,28,8,36
LASK Linz,2277,4,7,7,10,28,31,-3,28
Vienna,2277,5,7,5,12,26,39,-13,26
Mattersburg,2277,6,6,6,12,32,45,-13,24
SC Rheindorf,2277,7,6,5,13,20,30,-10,23
FC Salzburg,2278,1,14,7,3,44,19,25,49
Rapid Vienna,2278,2,10,9,5,39,26,13,39
SK Sturm Gra,2278,3,12,3,9,33,31,2,39
LASK Linz,2278,4,9,6,9,31,33,-2,33
Vienna,2278,5,7,6,11,26,38,-12,27
Mattersburg,2278,6,6,6,12,31,44,-13,24
SC Rheindorf,2278,7,5,5,14,18,31,-13,20
FC Salzburg,2279,1,14,7,3,45,20,25,49
SK Sturm Gra,2279,2,13,4,7,32,27,5,43
Rapid Vienna,2279,3,8,12,4,35,26,9,36
LASK Linz,2279,4,7,6,11,27,31,-4,27
Vienna,2279,5,7,5,12,30,42,-12,26
SC Rheindorf,2279,6,6,7,11,22,28,-6,25
Mattersburg,2279,7,6,5,13,33,50,-17,23
FC Salzburg,2280,1,14,7,3,46,21,25,49
SK Sturm Gra,2280,2,11,6,7,31,29,2,39
Rapid Vienna,2280,3,9,10,5,37,26,11,37
LASK Linz,2280,4,7,6,11,23,28,-5,27
Mattersburg,2280,5,7,6,11,30,40,-10,27
Vienna,2280,6,7,6,11,27,39,-12,27
SC Rheindorf,2280,7,6,5,13,18,29,-11,23
FC Salzburg,2281,1,13,7,4,44,21,23,46
SK Sturm Gra,2281,2,13,3,8,33,32,1,42
Rapid Vienna,2281,3,8,10,6,36,30,6,34
LASK Linz,2281,4,9,6,9,28,26,2,33
Vienna,2281,5,7,6,11,27,39,-12,27
SC Rheindorf,2281,6,6,7,11,23,28,-5,25
Mattersburg,2281,7,6,5,13,31,46,-15,23
FC Salzburg,2282,1,13,6,5,39,20,19,45
SK Sturm Gra,2282,2,13,4,7,35,28,7,43
Rapid Vienna,2282,3,8,9,7,36,30,6,33
LASK Linz,2282,4,8,6,10,25,28,-3,30
Mattersburg,2282,5,8,6,10,34,40,-6,30
Vienna,2282,6,7,5,12,26,40,-14,26
SC Rheindorf,2282,7,5,8,11,21,30,-9,23
SK Sturm Gra,2283,1,14,3,7,36,31,5,45
FC Salzburg,2283,2,12,8,4,43,22,21,44
Rapid Vienna,2283,3,9,9,6,35,27,8,36
LASK Linz,2283,4,9,6,9,27,26,1,33
Mattersburg,2283,5,8,6,10,32,39,-7,30
Vienna,2283,6,6,6,12,26,41,-15,24
SC Rheindorf,2283,7,4,6,14,18,31,-13,18
FC Salzburg,2284,1,12,6,6,40,21,19,42
SK Sturm Gra,2284,2,13,3,8,32,30,2,42
Rapid Vienna,2284,3,8,9,7,33,29,4,33
LASK Linz,2284,4,9,5,10,33,31,2,32
Mattersburg,2284,5,8,6,10,35,41,-6,30
Vienna,2284,6,7,6,11,27,40,-13,27
SC Rheindorf,2284,7,7,5,12,22,30,-8,26
FC Salzburg,2285,1,13,8,3,42,21,21,47
SK Sturm Gra,2285,2,13,4,7,35,28,7,43
Rapid Vienna,2285,3,8,11,5,37,29,8,35
LASK Linz,2285,4,8,7,9,27,27,0,31
Vienna,2285,5,7,6,11,28,39,-11,27
Mattersburg,2285,6,6,6,12,31,43,-12,24
SC Rheindorf,2285,7,5,6,13,17,30,-13,21
FC Salzburg,2286,1,14,8,2,45,18,27,50
SK Sturm Gra,2286,2,11,6,7,31,30,1,39
Rapid Vienna,2286,3,8,11,5,34,27,7,35
LASK Linz,2286,4,8,7,9,27,27,0,31
Mattersburg,2286,5,7,7,10,32,40,-8,28
Vienna,2286,6,6,6,12,25,40,-15,24
SC Rheindorf,2286,7,4,7,13,19,31,-12,19
FC Salzburg,2287,1,15,6,3,46,18,28,51
SK Sturm Gra,2287,2,11,5,8,31,29,2,38
Rapid Vienna,2287,3,8,11,5,36,28,8,35
Mattersburg,2287,4,8,5,11,34,41,-7,29
LASK Linz,2287,5,7,7,10,28,33,-5,28
Vienna,2287,6,7,5,12,25,41,-16,26
SC Rheindorf,2287,7,5,7,12,18,28,-10,22
FC Salzburg,2288,1,14,6,4,46,19,27,48
SK Sturm Gra,2288,2,14,3,7,35,26,9,45
LASK Linz,2288,3,10,5,9,30,26,4,35
Rapid Vienna,2288,4,8,9,7,34,29,5,33
Mattersburg,2288,5,9,5,10,33,38,-5,32
Vienna,2288,6,6,5,13,25,44,-19,23
SC Rheindorf,2288,7,4,5,15,16,37,-21,17
FC Salzburg,2289,1,15,7,2,48,18,30,52
SK Sturm Gra,2289,2,12,3,9,31,30,1,39
Rapid Vienna,2289,3,9,10,5,35,26,9,37
LASK Linz,2289,4,8,6,10,26,28,-2,30
Mattersburg,2289,5,7,5,12,29,42,-13,26
Vienna,2289,6,6,6,12,24,39,-15,24
SC Rheindorf,2289,7,5,7,12,18,28,-10,22
FC Salzburg,2290,1,15,7,2,44,17,27,52
SK Sturm Gra,2290,2,12,4,8,35,33,2,40
Rapid Vienna,2290,3,10,9,5,37,26,11,39
LASK Linz,2290,4,8,5,11,30,32,-2,29
SC Rheindorf,2290,5,7,5,12,23,27,-4,26
Vienna,2290,6,6,5,13,23,39,-16,23
Mattersburg,2290,7,6,5,13,28,46,-18,23
FC Salzburg,2291,1,14,7,3,44,19,25,49
SK Sturm Gra,2291,2,14,3,7,34,29,5,45
Rapid Vienna,2291,3,7,12,5,37,31,6,33
LASK Linz,2291,4,7,7,10,28,31,-3,28
Vienna,2291,5,7,5,12,26,40,-14,26
SC Rheindorf,2291,6,6,6,12,21,29,-8,24
Mattersburg,2291,7,6,6,12,30,41,-11,24
FC Salzburg,2292,1,15,6,3,47,17,30,51
SK Sturm Gra,2292,2,12,4,8,31,30,1,40
Rapid Vienna,2292,3,8,10,6,40,33,7,34
LASK Linz,2292,4,7,7,10,27,30,-3,28
SC Rheindorf,2292,5,7,5,12,21,31,-10,26
Mattersburg,2292,6,7,5,12,29,40,-11,26
Vienna,2292,7,7,5,12,25,39,-14,26
FC Salzburg,2293,1,13,8,3,43,18,25,47
SK Sturm Gra,2293,2,13,4,7,36,29,7,43
Rapid Vienna,2293,3,8,9,7,34,32,2,33
LASK Linz,2293,4,9,6,9,28,28,0,33
Mattersburg,2293,5,7,6,11,32,39,-7,27
Vienna,2293,6,6,6,12,24,41,-17,24
SC Rheindorf,2293,7,5,7,12,19,29,-10,22
FC Salzburg,2294,1,14,7,3,48,21,27,49
Rapid Vienna,2294,2,10,10,4,40,27,13,40
SK Sturm Gra,2294,3,11,3,10,30,34,-4,36
LASK Linz,2294,4,8,5,11,27,30,-3,29
SC Rheindorf,2294,5,6,7,11,21,29,-8,25
Mattersburg,2294,6,6,7,11,35,46,-11,25
Vienna,2294,7,6,7,11,27,41,-14,25
FC Salzburg,2295,1,16,6,2,50,17,33,54
SK Sturm Gra,2295,2,13,3,8,33,30,3,42
Rapid Vienna,2295,3,8,10,6,35,29,6,34
LASK Linz,2295,4,9,6,9,27,28,-1,33
Mattersburg,2295,5,6,6,12,31,44,-13,24
Vienna,2295,6,6,5,13,26,42,-16,23
SC Rheindorf,2295,7,4,8,12,16,28,-12,20
FC Salzburg,2296,1,15,7,2,45,18,27,52
SK Sturm Gra,2296,2,13,3,8,30,28,2,42
Rapid Vienna,2296,3,8,10,6,35,28,7,34
LASK Linz,2296,4,8,6,10,27,29,-2,30
Vienna,2296,5,7,6,11,27,39,-12,27
SC Rheindorf,2296,6,6,5,13,20,29,-9,23
Mattersburg,2296,7,6,5,13,29,42,-13,23
FC Salzburg,2297,1,14,7,3,45,18,27,49
SK Sturm Gra,2297,2,13,4,7,31,27,4,43
Rapid Vienna,2297,3,9,10,5,35,26,9,37
LASK Linz,2297,4,8,8,8,27,27,0,32
Mattersburg,2297,5,6,7,11,31,43,-12,25
Vienna,2297,6,6,7,11,27,41,-14,25
SC Rheindorf,2297,7,4,5,15,17,31,-14,17
FC Salzburg,2298,1,13,9,2,42,18,24,48
SK Sturm Gra,2298,2,14,3,7,34,25,9,45
Rapid Vienna,2298,3,8,11,5,37,31,6,35
LASK Linz,2298,4,8,5,11,25,30,-5,29
Mattersburg,2298,5,7,6,11,30,37,-7,27
Vienna,2298,6,6,6,12,24,40,-16,24
SC Rheindorf,2298,7,5,6,13,17,28,-11,21
FC Salzburg,2299,1,13,9,2,41,17,24,48
SK Sturm Gra,2299,2,12,5,7,33,29,4,41
Rapid Vienna,2299,3,7,10,7,35,32,3,31
LASK Linz,2299,4,8,6,10,27,29,-2,30
SC Rheindorf,2299,5,7,6,11,23,28,-5,27
Mattersburg,2299,6,6,8,10,32,40,-8,26
Vienna,2299,7,6,6,12,23,39,-16,24
FC Salzburg,2300,1,13,7,4,42,19,23,46
SK Sturm Gra,2300,2,12,4,8,34,30,4,40
Rapid Vienna,2300,3,9,10,5,34,27,7,37
LASK Linz,2300,4,9,7,8,29,27,2,34
Mattersburg,2300,5,7,5,12,32,41,-9,26
Vienna,2300,6,6,6,12,24,40,-16,24
SC Rheindorf,2300,7,6,5,13,21,32,-11,23
FC Salzburg,2301,1,15,7,2,45,18,27,52
SK Sturm Gra,2301,2,12,4,8,33,29,4,40
Rapid Vienna,2301,3,7,11,6,34,30,4,32
LASK Linz,2301,4,8,7,9,27,27,0,31
Vienna,2301,5,7,5,12,29,42,-13,26
SC Rheindorf,2301,6,6,7,11,18,26,-8,25
Mattersburg,2301,7,6,5,13,31,45,-14,23
FC Salzburg,2302,1,14,8,2,43,17,26,50
SK Sturm Gra,2302,2,11,5,8,31,29,2,38
LASK Linz,2302,3,10,5,9,29,27,2,35
Rapid Vienna,2302,4,7,11,6,32,26,6,32
SC Rheindorf,2302,5,7,5,12,20,28,-8,26
Mattersburg,2302,6,6,6,12,32,45,-13,24
Vienna,2302,7,6,6,12,24,39,-15,24
FC Salzburg,2303,1,14,6,4,43,20,23,48
SK Sturm Gra,2303,2,13,5,6,36,28,8,44
Rapid Vienna,2303,3,7,10,7,34,32,2,31
LASK Linz,2303,4,8,7,9,26,28,-2,31
Mattersburg,2303,5,7,6,11,31,39,-8,27
Vienna,2303,6,7,5,12,25,39,-14,26
SC Rheindorf,2303,7,5,7,12,20,29,-9,22
FC Salzburg,2304,1,15,6,3,45,21,24,51
SK Sturm Gra,2304,2,12,4,8,34,31,3,40
Rapid Vienna,2304,3,9,10,5,37,27,10,37
LASK Linz,2304,4,9,6,9,28,28,0,33
Vienna,2304,5,7,5,12,29,39,-10,26
Mattersburg,2304,6,7,5,12,31,45,-14,26
SC Rheindorf,2304,7,4,6,14,22,35,-13,18
FC Salzburg,2305,1,15,6,3,43,18,25,51
SK Sturm Gra,2305,2,11,5,8,33,32,1,38
Rapid Vienna,2305,3,9,9,6,37,28,9,36
LASK Linz,2305,4,7,7,10,27,30,-3,28
SC Rheindorf,2305,5,7,6,11,22,29,-7,27
Vienna,2305,6,7,5,12,26,42,-16,26
Mattersburg,2305,7,6,6,12,33,42,-9,24
FC Salzburg,2306,1,13,9,2,44,20,24,48
SK Sturm Gra,2306,2,11,5,8,31,31,0,38
Rapid Vienna,2306,3,9,9,6,35,26,9,36
LASK Linz,2306,4,8,8,8,28,28,0,32
Vienna,2306,5,7,6,11,29,40,-11,27
SC Rheindorf,2306,6,6,6,12,18,26,-8,24
Mattersburg,2306,7,5,7,12,30,44,-14,22
FC Salzburg,2307,1,13,7,4,48,25,23,46
Rapid Vienna,2307,2,11,9,4,39,26,13,42
SK Sturm Gra,2307,3,12,4,8,32,29,3,40
LASK Linz,2307,4,8,5,11,26,30,-4,29
Mattersburg,2307,5,7,6,11,32,41,-9,27
Vienna,2307,6,7,6,11,27,40,-13,27
SC Rheindorf,2307,7,5,5,14,18,31,-13,20
FC Salzburg,2308,1,14,7,3,47,23,24,49
SK Sturm Gra,2308,2,13,4,7,33,28,5,43
Rapid Vienna,2308,3,7,11,6,35,32,3,32
LASK Linz,2308,4,7,8,9,27,29,-2,29
Mattersburg,2308,5,7,5,12,33,42,-9,26
Vienna,2308,6,7,5,12,27,41,-14,26
SC Rheindorf,2308,7,6,6,12,21,28,-7,24
FC Salzburg,2309,1,15,6,3,45,18,27,51
SK Sturm Gra,2309,2,13,4,7,38,27,11,43
Rapid Vienna,2309,3,9,11,4,35,25,10,38
LASK Linz,2309,4,8,6,10,26,32,-6,30
Vienna,2309,5,7,5,12,27,42,-15,26
SC Rheindorf,2309,6,6,5,13,21,32,-11,23
Mattersburg,2309,7,5,5,14,29,45,-16,20
FC Salzburg,2310,1,14,8,2,49,20,29,50
SK Sturm Gra,2310,2,13,4,7,32,28,4,43
Rapid Vienna,2310,3,7,11,6,33,27,6,32
LASK Linz,2310,4,8,6,10,26,29,-3,30
SC Rheindorf,2310,5,7,5,12,21,29,-8,26
Vienna,2310,6,7,5,12,29,42,-13,26
Mattersburg,2310,7,6,5,13,32,47,-15,23
FC Salzburg,2311,1,14,7,3,44,19,25,49
SK Sturm Gra,2311,2,14,4,6,34,25,9,46
Rapid Vienna,2311,3,8,10,6,34,30,4,34
LASK Linz,2311,4,7,8,9,25,27,-2,29
Vienna,2311,5,7,6,11,26,38,-12,27
Mattersburg,2311,6,6,6,12,29,41,-12,24
SC Rheindorf,2311,7,4,7,13,16,28,-12,19
FC Salzburg,2312,1,16,6,2,47,18,29,54
SK Sturm Gra,2312,2,12,5,7,33,28,5,41
Rapid Vienna,2312,3,7,11,6,34,29,5,32
LASK Linz,2312,4,9,5,10,26,30,-4,32
Mattersburg,2312,5,8,5,11,36,39,-3,29
Vienna,2312,6,6,5,13,25,42,-17,23
SC Rheindorf,2312,7,4,7,13,18,33,-15,19
FC Salzburg,2313,1,16,6,2,47,16,31,54
SK Sturm Gra,2313,2,13,4,7,33,26,7,43
Rapid Vienna,2313,3,8,11,5,36,27,9,35
LASK Linz,2313,4,7,6,11,24,33,-9,27
Mattersburg,2313,5,7,5,12,31,43,-12,26
Vienna,2313,6,7,5,12,25,40,-15,26
SC Rheindorf,2313,7,5,5,14,19,30,-11,20
FC Salzburg,2314,1,16,6,2,48,16,32,54
LASK Linz,2314,2,11,5,8,31,27,4,38
SK Sturm Gra,2314,3,11,3,10,29,31,-2,36
Rapid Vienna,2314,4,8,10,6,34,29,5,34
Vienna,2314,5,7,5,12,25,40,-15,26
Mattersburg,2314,6,6,5,13,30,41,-11,23
SC Rheindorf,2314,7,5,6,13,20,33,-13,21
FC Salzburg,2315,1,16,6,2,49,16,33,54
Rapid Vienna,2315,2,9,10,5,34,26,8,37
SK Sturm Gra,2315,3,11,4,9,30,30,0,37
LASK Linz,2315,4,9,7,8,26,25,1,34
Mattersburg,2315,5,7,5,12,33,43,-10,26
Vienna,2315,6,6,5,13,24,43,-19,23
SC Rheindorf,2315,7,4,7,13,17,30,-13,19
FC Salzburg,2316,1,14,6,4,45,18,27,48
SK Sturm Gra,2316,2,13,3,8,34,30,4,42
Rapid Vienna,2316,3,8,10,6,34,29,5,34
Vienna,2316,4,8,5,11,27,38,-11,29
LASK Linz,2316,5,7,7,10,28,33,-5,28
SC Rheindorf,2316,6,7,5,12,26,31,-5,26
Mattersburg,2316,7,6,6,12,30,45,-15,24
FC Salzburg,2317,1,14,7,3,42,18,24,49
SK Sturm Gra,2317,2,13,4,7,33,26,7,43
Rapid Vienna,2317,3,8,10,6,35,30,5,34
LASK Linz,2317,4,7,7,10,26,35,-9,28
Vienna,2317,5,7,6,11,25,37,-12,27
SC Rheindorf,2317,6,6,7,11,20,27,-7,25
Mattersburg,2317,7,6,5,13,34,42,-8,23
FC Salzburg,2318,1,14,6,4,45,19,26,48
SK Sturm Gra,2318,2,14,3,7,33,28,5,45
Rapid Vienna,2318,3,9,10,5,37,27,10,37
LASK Linz,2318,4,7,7,10,27,31,-4,28
Mattersburg,2318,5,6,7,11,36,45,-9,25
Vienna,2318,6,6,6,12,26,43,-17,24
SC Rheindorf,2318,7,6,5,13,21,32,-11,23
FC Salzburg,2319,1,14,6,4,44,21,23,48
SK Sturm Gra,2319,2,14,4,6,37,26,11,46
Rapid Vienna,2319,3,8,11,5,38,30,8,35
LASK Linz,2319,4,9,6,9,28,29,-1,33
Vienna,2319,5,7,5,12,25,40,-15,26
Mattersburg,2319,6,6,5,13,30,42,-12,23
SC Rheindorf,2319,7,4,7,13,18,32,-14,19
FC Salzburg,2320,1,13,7,4,42,18,24,46
SK Sturm Gra,2320,2,13,5,6,35,28,7,44
Rapid Vienna,2320,3,8,11,5,34,26,8,35
LASK Linz,2320,4,8,7,9,31,30,1,31
Mattersburg,2320,5,7,5,12,33,48,-15,26
Vienna,2320,6,7,5,12,26,41,-15,26
SC Rheindorf,2320,7,5,6,13,21,31,-10,21
FC Salzburg,2321,1,14,6,4,40,19,21,48
SK Sturm Gra,2321,2,14,3,7,31,25,6,45
Rapid Vienna,2321,3,9,9,6,36,25,11,36
LASK Linz,2321,4,9,5,10,26,27,-1,32
Vienna,2321,5,8,5,11,26,38,-12,29
Mattersburg,2321,6,7,5,12,32,41,-9,26
SC Rheindorf,2321,7,4,5,15,16,32,-16,17
FC Salzburg,2322,1,12,9,3,46,25,21,45
SK Sturm Gra,2322,2,13,4,7,36,29,7,43
Rapid Vienna,2322,3,9,10,5,39,29,10,37
LASK Linz,2322,4,8,6,10,26,29,-3,30
Vienna,2322,5,7,6,11,27,40,-13,27
Mattersburg,2322,6,6,6,12,31,43,-12,24
SC Rheindorf,2322,7,6,5,13,21,31,-10,23
FC Salzburg,2323,1,16,6,2,45,16,29,54
SK Sturm Gra,2323,2,12,4,8,30,27,3,40
Rapid Vienna,2323,3,8,10,6,34,27,7,34
LASK Linz,2323,4,7,6,11,26,30,-4,27
Mattersburg,2323,5,7,6,11,32,42,-10,27
SC Rheindorf,2323,6,6,6,12,18,28,-10,24
Vienna,2323,7,6,6,12,26,41,-15,24
FC Salzburg,2324,1,15,6,3,48,21,27,51
SK Sturm Gra,2324,2,13,4,7,34,29,5,43
Rapid Vienna,2324,3,7,10,7,33,30,3,31
LASK Linz,2324,4,8,5,11,25,30,-5,29
Vienna,2324,5,8,5,11,30,38,-8,29
Mattersburg,2324,6,7,5,12,32,46,-14,26
SC Rheindorf,2324,7,5,7,12,20,28,-8,22
FC Salzburg,2325,1,14,8,2,49,20,29,50
SK Sturm Gra,2325,2,11,6,7,31,28,3,39
LASK Linz,2325,3,10,5,9,29,28,1,35
Rapid Vienna,2325,4,7,12,5,37,30,7,33
Vienna,2325,5,7,5,12,28,41,-13,26
Mattersburg,2325,6,7,5,12,32,47,-15,26
SC Rheindorf,2325,7,4,7,13,18,30,-12,19
FC Salzburg,2326,1,14,7,3,46,19,27,49
SK Sturm Gra,2326,2,15,3,6,38,26,12,48
Rapid Vienna,2326,3,7,11,6,34,30,4,32
LASK Linz,2326,4,7,6,11,29,35,-6,27
Mattersburg,2326,5,7,6,11,31,41,-10,27
SC Rheindorf,2326,6,6,6,12,23,33,-10,24
Vienna,2326,7,6,5,13,24,41,-17,23
FC Salzburg,2327,1,15,6,3,44,18,26,51
SK Sturm Gra,2327,2,12,3,9,32,31,1,39
Rapid Vienna,2327,3,9,10,5,39,29,10,37
LASK Linz,2327,4,8,8,8,28,28,0,32
Mattersburg,2327,5,6,7,11,29,39,-10,25
Vienna,2327,6,6,6,12,24,40,-16,24
SC Rheindorf,2327,7,5,6,13,22,33,-11,21
FC Salzburg,2328,1,14,8,2,46,19,27,50
SK Sturm Gra,2328,2,11,4,9,30,31,-1,37
Rapid Vienna,2328,3,8,12,4,39,30,9,36
LASK Linz,2328,4,9,7,8,28,27,1,34
Mattersburg,2328,5,6,7,11,32,43,-11,25
SC Rheindorf,2328,6,6,5,13,23,32,-9,23
Vienna,2328,7,6,5,13,25,41,-16,23
FC Salzburg,2329,1,12,7,5,42,22,20,43
SK Sturm Gra,2329,2,12,5,7,35,29,6,41
Rapid Vienna,2329,3,10,10,4,38,25,13,40
LASK Linz,2329,4,8,5,11,26,33,-7,29
Vienna,2329,5,8,5,11,26,38,-12,29
SC Rheindorf,2329,6,7,5,12,22,30,-8,26
Mattersburg,2329,7,6,5,13,32,44,-12,23
FC Salzburg,2330,1,16,6,2,48,16,32,54
SK Sturm Gra,2330,2,12,4,8,31,28,3,40
Rapid Vienna,2330,3,9,9,6,38,28,10,36
LASK Linz,2330,4,7,6,11,25,31,-6,27
Vienna,2330,5,7,5,12,26,38,-12,26
SC Rheindorf,2330,6,6,6,12,20,30,-10,24
Mattersburg,2330,7,6,6,12,30,47,-17,24
FC Salzburg,2331,1,13,7,4,42,20,22,46
SK Sturm Gra,2331,2,13,4,7,31,27,4,43
Rapid Vienna,2331,3,10,9,5,37,26,11,39
LASK Linz,2331,4,7,7,10,25,28,-3,28
Vienna,2331,5,7,6,11,25,38,-13,27
Mattersburg,2331,6,6,7,11,31,41,-10,25
SC Rheindorf,2331,7,5,6,13,19,30,-11,21
FC Salzburg,2332,1,15,6,3,43,18,25,51
SK Sturm Gra,2332,2,13,4,7,32,27,5,43
Rapid Vienna,2332,3,9,9,6,36,27,9,36
LASK Linz,2332,4,9,5,10,29,28,1,32
SC Rheindorf,2332,5,6,6,12,18,29,-11,24
Mattersburg,2332,6,6,5,13,33,43,-10,23
Vienna,2332,7,6,5,13,26,45,-19,23
FC Salzburg,2333,1,14,6,4,42,19,23,48
SK Sturm Gra,2333,2,14,4,6,34,25,9,46
Rapid Vienna,2333,3,10,9,5,35,24,11,39
LASK Linz,2333,4,9,6,9,27,27,0,33
Vienna,2333,5,6,6,12,24,41,-17,24
Mattersburg,2333,6,5,6,13,30,43,-13,21
SC Rheindorf,2333,7,5,5,14,19,32,-13,20
FC Salzburg,2334,1,14,8,2,45,18,27,50
SK Sturm Gra,2334,2,13,5,6,33,27,6,44
Rapid Vienna,2334,3,8,11,5,33,24,9,35
LASK Linz,2334,4,8,7,9,28,29,-1,31
Vienna,2334,5,6,6,12,25,41,-16,24
SC Rheindorf,2334,6,5,7,12,20,30,-10,22
Mattersburg,2334,7,5,6,13,31,46,-15,21
FC Salzburg,2335,1,14,6,4,47,18,29,48
SK Sturm Gra,2335,2,12,3,9,30,30,0,39
Rapid Vienna,2335,3,9,10,5,37,28,9,37
LASK Linz,2335,4,9,6,9,29,28,1,33
Vienna,2335,5,7,6,11,26,39,-13,27
Mattersburg,2335,6,6,7,11,32,45,-13,25
SC Rheindorf,2335,7,5,6,13,18,31,-13,21
FC Salzburg,2336,1,15,7,2,44,16,28,52
SK Sturm Gra,2336,2,12,4,8,33,31,2,40
Rapid Vienna,2336,3,8,9,7,35,30,5,33
LASK Linz,2336,4,8,6,10,28,29,-1,30
Mattersburg,2336,5,7,6,11,34,40,-6,27
SC Rheindorf,2336,6,6,6,12,22,31,-9,24
Vienna,2336,7,6,6,12,24,43,-19,24
FC Salzburg,2337,1,15,6,3,46,20,26,51
SK Sturm Gra,2337,2,12,5,7,34,29,5,41
LASK Linz,2337,3,11,5,8,32,28,4,38
Rapid Vienna,2337,4,7,10,7,33,29,4,31
Vienna,2337,5,7,5,12,25,38,-13,26
SC Rheindorf,2337,6,6,6,12,21,27,-6,24
Mattersburg,2337,7,5,5,14,28,48,-20,20
FC Salzburg,2338,1,14,6,4,45,20,25,48
Rapid Vienna,2338,2,10,10,4,38,26,12,40
SK Sturm Gra,2338,3,12,4,8,32,29,3,40
Vienna,2338,4,8,5,11,27,38,-11,29
LASK Linz,2338,5,7,6,11,26,32,-6,27
SC Rheindorf,2338,6,7,5,12,22,28,-6,26
Mattersburg,2338,7,5,6,13,30,47,-17,21
FC Salzburg,2339,1,13,7,4,44,22,22,46
Rapid Vienna,2339,2,10,9,5,39,27,12,39
SK Sturm Gra,2339,3,11,5,8,31,33,-2,38
LASK Linz,2339,4,8,8,8,28,27,1,32
Mattersburg,2339,5,7,7,10,34,38,-4,28
Vienna,2339,6,7,5,12,28,43,-15,26
SC Rheindorf,2339,7,4,7,13,17,31,-14,19
FC Salzburg,2340,1,15,7,2,49,18,31,52
Rapid Vienna,2340,2,10,10,4,36,25,11,40
SK Sturm Gra,2340,3,11,5,8,30,31,-1,38
LASK Linz,2340,4,8,6,10,26,27,-1,30
Mattersburg,2340,5,7,6,11,33,42,-9,27
Vienna,2340,6,6,5,13,25,43,-18,23
SC Rheindorf,2340,7,4,7,13,18,31,-13,19
FC Salzburg,2341,1,14,6,4,46,22,24,48
SK Sturm Gra,2341,2,14,3,7,35,27,8,45
Rapid Vienna,2341,3,10,9,5,39,30,9,39
LASK Linz,2341,4,8,7,9,25,25,0,31
Vienna,2341,5,7,5,12,29,40,-11,26
SC Rheindorf,2341,6,5,6,13,18,31,-13,21
Mattersburg,2341,7,5,6,13,27,44,-17,21
FC Salzburg,2342,1,12,8,4,42,21,21,44
SK Sturm Gra,2342,2,13,5,6,34,28,6,44
Rapid Vienna,2342,3,9,10,5,37,28,9,37
LASK Linz,2342,4,7,9,8,24,25,-1,30
Mattersburg,2342,5,7,6,11,31,41,-10,27
Vienna,2342,6,7,6,11,26,38,-12,27
SC Rheindorf,2342,7,4,6,14,18,31,-13,18
FC Salzburg,2343,1,15,7,2,51,21,30,52
SK Sturm Gra,2343,2,14,3,7,36,30,6,45
Rapid Vienna,2343,3,7,10,7,33,28,5,31
LASK Linz,2343,4,8,5,11,27,31,-4,29
Vienna,2343,5,7,6,11,28,41,-13,27
Mattersburg,2343,6,6,6,12,32,45,-13,24
SC Rheindorf,2343,7,5,7,12,21,32,-11,22
FC Salzburg,2344,1,15,7,2,46,17,29,52
SK Sturm Gra,2344,2,13,3,8,34,30,4,42
Rapid Vienna,2344,3,10,10,4,40,27,13,40
LASK Linz,2344,4,7,5,12,26,33,-7,26
Vienna,2344,5,7,5,12,27,38,-11,26
Mattersburg,2344,6,7,5,12,30,44,-14,26
SC Rheindorf,2344,7,5,5,14,18,32,-14,20
FC Salzburg,2345,1,15,6,3,43,19,24,51
SK Sturm Gra,2345,2,14,3,7,37,27,10,45
Rapid Vienna,2345,3,8,10,6,32,27,5,34
LASK Linz,2345,4,8,6,10,26,28,-2,30
Mattersburg,2345,5,6,7,11,30,40,-10,25
Vienna,2345,6,6,6,12,24,39,-15,24
SC Rheindorf,2345,7,5,6,13,18,30,-12,21
FC Salzburg,2346,1,13,6,5,45,22,23,45
SK Sturm Gra,2346,2,12,4,8,31,31,0,40
Rapid Vienna,2346,3,9,9,6,37,30,7,36
LASK Linz,2346,4,10,6,8,29,26,3,36
Vienna,2346,5,8,5,11,29,41,-12,29
Mattersburg,2346,6,7,6,11,35,41,-6,27
SC Rheindorf,2346,7,4,6,14,18,33,-15,18
FC Salzburg,2347,1,15,6,3,45,20,25,51
SK Sturm Gra,2347,2,11,5,8,32,32,0,38
Rapid Vienna,2347,3,9,10,5,37,26,11,37
LASK Linz,2347,4,9,6,9,26,26,0,33
Mattersburg,2347,5,8,5,11,34,40,-6,29
Vienna,2347,6,6,5,13,23,41,-18,23
SC Rheindorf,2347,7,4,7,13,17,29,-12,19
FC Salzburg,2348,1,14,7,3,48,20,28,49
SK Sturm Gra,2348,2,12,4,8,32,30,2,40
LASK Linz,2348,3,10,6,8,31,27,4,36
Rapid Vienna,2348,4,8,10,6,37,31,6,34
Vienna,2348,5,6,7,11,26,40,-14,25
SC Rheindorf,2348,6,5,7,12,22,32,-10,22
Mattersburg,2348,7,5,7,12,30,46,-16,22
FC Salzburg,2349,1,15,7,2,47,17,30,52
SK Sturm Gra,2349,2,12,4,8,34,30,4,40
Rapid Vienna,2349,3,8,10,6,33,29,4,34
LASK Linz,2349,4,9,7,8,27,26,1,34
SC Rheindorf,2349,5,6,6,12,23,30,-7,24
Mattersburg,2349,6,6,5,13,32,46,-14,23
Vienna,2349,7,6,5,13,24,42,-18,23
FC Salzburg,2350,1,15,6,3,46,17,29,51
Rapid Vienna,2350,2,10,10,4,37,24,13,40
SK Sturm Gra,2350,3,11,5,8,30,32,-2,38
LASK Linz,2350,4,7,7,10,26,29,-3,28
Mattersburg,2350,5,6,7,11,30,41,-11,25
Vienna,2350,6,6,6,12,25,40,-15,24
SC Rheindorf,2350,7,6,5,13,18,29,-11,23
FC Salzburg,2351,1,14,8,2,48,21,27,50
SK Sturm Gra,2351,2,13,3,8,34,32,2,42
Rapid Vienna,2351,3,7,11,6,36,31,5,32
LASK Linz,2351,4,7,7,10,25,28,-3,28
Vienna,2351,5,7,6,11,31,40,-9,27
Mattersburg,2351,6,6,7,11,32,45,-13,25
SC Rheindorf,2351,7,6,6,12,21,30,-9,24
FC Salzburg,2352,1,15,7,2,50,17,33,52
SK Sturm Gra,2352,2,14,3,7,34,27,7,45
Rapid Vienna,2352,3,9,9,6,36,29,7,36
LASK Linz,2352,4,7,6,11,24,28,-4,27
Vienna,2352,5,7,6,11,30,40,-10,27
Mattersburg,2352,6,6,6,12,29,47,-18,24
SC Rheindorf,2352,7,5,5,14,19,34,-15,20
FC Salzburg,2353,1,12,7,5,42,22,20,43
SK Sturm Gra,2353,2,13,4,7,33,28,5,43
Rapid Vienna,2353,3,10,9,5,36,26,10,39
LASK Linz,2353,4,9,6,9,27,28,-1,33
Mattersburg,2353,5,9,5,10,36,39,-3,32
Vienna,2353,6,6,6,12,25,40,-15,24
SC Rheindorf,2353,7,4,5,15,15,31,-16,17
FC Salzburg,2354,1,13,8,3,43,19,24,47
SK Sturm Gra,2354,2,13,4,7,35,30,5,43
Rapid Vienna,2354,3,8,12,4,39,29,10,36
LASK Linz,2354,4,8,5,11,26,32,-6,29
Vienna,2354,5,6,7,11,27,41,-14,25
SC Rheindorf,2354,6,6,6,12,18,27,-9,24
Mattersburg,2354,7,6,6,12,32,42,-10,24
FC Salzburg,2355,1,14,8,2,47,18,29,50
SK Sturm Gra,2355,2,13,4,7,33,29,4,43
Rapid Vienna,2355,3,7,13,4,39,31,8,34
LASK Linz,2355,4,8,6,10,28,31,-3,30
Vienna,2355,5,6,7,11,23,37,-14,25
SC Rheindorf,2355,6,5,7,12,20,29,-9,22
Mattersburg,2355,7,5,7,12,29,44,-15,22
FC Salzburg,2356,1,14,6,4,43,20,23,48
Rapid Vienna,2356,2,11,9,4,43,25,18,42
SK Sturm Gra,2356,3,12,4,8,31,28,3,40
Vienna,2356,4,8,5,11,29,38,-9,29
LASK Linz,2356,5,7,5,12,24,32,-8,26
Mattersburg,2356,6,6,6,12,28,42,-14,24
SC Rheindorf,2356,7,5,7,12,18,31,-13,22
FC Salzburg,2357,1,14,6,4,43,19,24,48
SK Sturm Gra,2357,2,14,4,6,34,26,8,46
Rapid Vienna,2357,3,8,10,6,32,25,7,34
Mattersburg,2357,4,8,5,11,32,38,-6,29
LASK Linz,2357,5,7,6,11,24,31,-7,27
Vienna,2357,6,7,5,12,26,41,-15,26
SC Rheindorf,2357,7,5,6,13,18,29,-11,21
FC Salzburg,2358,1,16,6,2,45,15,30,54
SK Sturm Gra,2358,2,11,5,8,30,28,2,38
Rapid Vienna,2358,3,9,9,6,35,26,9,36
LASK Linz,2358,4,8,7,9,26,29,-3,31
SC Rheindorf,2358,5,6,6,12,22,29,-7,24
Mattersburg,2358,6,6,6,12,30,44,-14,24
Vienna,2358,7,6,5,13,25,42,-17,23
FC Salzburg,2359,1,14,8,2,44,18,26,50
SK Sturm Gra,2359,2,14,3,7,36,29,7,45
Rapid Vienna,2359,3,9,10,5,38,27,11,37
Mattersburg,2359,4,7,6,11,28,37,-9,27
LASK Linz,2359,5,7,5,12,25,33,-8,26
Vienna,2359,6,6,7,11,24,38,-14,25
SC Rheindorf,2359,7,5,5,14,17,30,-13,20
FC Salzburg,2360,1,14,6,4,48,23,25,48
SK Sturm Gra,2360,2,13,5,6,37,29,8,44
Rapid Vienna,2360,3,8,10,6,34,29,5,34
LASK Linz,2360,4,8,6,10,31,33,-2,30
Mattersburg,2360,5,7,5,12,36,47,-11,26
Vienna,2360,6,7,5,12,27,42,-15,26
SC Rheindorf,2360,7,5,7,12,20,30,-10,22
FC Salzburg,2361,1,15,7,2,47,19,28,52
SK Sturm Gra,2361,2,13,5,6,33,25,8,44
Rapid Vienna,2361,3,8,9,7,35,34,1,33
LASK Linz,2361,4,8,7,9,29,28,1,31
Vienna,2361,5,7,5,12,27,41,-14,26
Mattersburg,2361,6,5,7,12,28,42,-14,22
SC Rheindorf,2361,7,5,6,13,20,30,-10,21
FC Salzburg,2362,1,14,7,3,44,20,24,49
SK Sturm Gra,2362,2,12,4,8,30,30,0,40
Rapid Vienna,2362,3,9,10,5,37,24,13,37
LASK Linz,2362,4,7,7,10,23,27,-4,28
Mattersburg,2362,5,6,8,10,30,39,-9,26
SC Rheindorf,2362,6,6,6,12,20,29,-9,24
Vienna,2362,7,6,6,12,26,41,-15,24
FC Salzburg,2363,1,14,7,3,45,20,25,49
SK Sturm Gra,2363,2,12,5,7,30,29,1,41
Rapid Vienna,2363,3,8,12,4,36,27,9,36
LASK Linz,2363,4,7,8,9,27,29,-2,29
Vienna,2363,5,8,5,11,29,38,-9,29
Mattersburg,2363,6,6,6,12,30,41,-11,24
SC Rheindorf,2363,7,4,7,13,19,32,-13,19
FC Salzburg,2364,1,13,9,2,44,17,27,48
SK Sturm Gra,2364,2,12,3,9,34,34,0,39
Rapid Vienna,2364,3,8,11,5,38,31,7,35
LASK Linz,2364,4,8,6,10,27,30,-3,30
Mattersburg,2364,5,7,7,10,31,37,-6,28
Vienna,2364,6,6,7,11,23,37,-14,25
SC Rheindorf,2364,7,5,7,12,18,29,-11,22
FC Salzburg,2365,1,14,6,4,46,20,26,48
SK Sturm Gra,2365,2,14,4,6,35,27,8,46
LASK Linz,2365,3,9,7,8,30,27,3,34
Rapid Vienna,2365,4,7,10,7,33,33,0,31
Vienna,2365,5,7,6,11,25,38,-13,27
Mattersburg,2365,6,5,7,12,33,48,-15,22
SC Rheindorf,2365,7,5,6,13,23,32,-9,21
FC Salzburg,2366,1,14,6,4,46,21,25,48
SK Sturm Gra,2366,2,11,4,9,31,33,-2,37
Rapid Vienna,2366,3,9,9,6,36,27,9,36
Mattersburg,2366,4,8,6,10,33,37,-4,30
LASK Linz,2366,5,8,6,10,26,30,-4,30
Vienna,2366,6,7,5,12,24,40,-16,26
SC Rheindorf,2366,7,6,6,12,18,26,-8,24
FC Salzburg,2367,1,14,7,3,43,18,25,49
SK Sturm Gra,2367,2,12,3,9,29,28,1,39
Rapid Vienna,2367,3,9,10,5,35,30,5,37
LASK Linz,2367,4,10,5,9,32,29,3,35
Vienna,2367,5,7,6,11,25,38,-13,27
SC Rheindorf,2367,6,5,7,12,21,29,-8,22
Mattersburg,2367,7,5,6,13,32,45,-13,21
FC Salzburg,2368,1,14,6,4,45,20,25,48
SK Sturm Gra,2368,2,12,3,9,31,30,1,39
Rapid Vienna,2368,3,9,9,6,34,28,6,36
LASK Linz,2368,4,9,6,9,29,30,-1,33
Vienna,2368,5,7,6,11,28,41,-13,27
Mattersburg,2368,6,6,7,11,34,45,-11,25
SC Rheindorf,2368,7,6,5,13,22,29,-7,23
FC Salzburg,2369,1,15,6,3,46,19,27,51
SK Sturm Gra,2369,2,12,4,8,32,31,1,40
Rapid Vienna,2369,3,9,10,5,38,28,10,37
LASK Linz,2369,4,8,7,9,28,28,0,31
Mattersburg,2369,5,7,5,12,31,42,-11,26
Vienna,2369,6,6,5,13,26,43,-17,23
SC Rheindorf,2369,7,5,7,12,20,30,-10,22
FC Salzburg,2370,1,15,7,2,46,19,27,52
SK Sturm Gra,2370,2,11,4,9,33,33,0,37
Rapid Vienna,2370,3,9,9,6,36,30,6,36
LASK Linz,2370,4,9,7,8,30,27,3,34
Mattersburg,2370,5,6,6,12,30,42,-12,24
Vienna,2370,6,6,6,12,25,40,-15,24
SC Rheindorf,2370,7,5,7,12,21,30,-9,22
FC Salzburg,2371,1,14,6,4,47,21,26,48
SK Sturm Gra,2371,2,12,6,6,34,29,5,42
Rapid Vienna,2371,3,9,11,4,35,25,10,38
LASK Linz,2371,4,7,7,10,26,29,-3,28
Vienna,2371,5,7,5,12,29,42,-13,26
Mattersburg,2371,6,7,5,12,31,45,-14,26
SC Rheindorf,2371,7,4,8,12,20,31,-11,20
FC Salzburg,2372,1,16,6,2,45,17,28,54
SK Sturm Gra,2372,2,12,5,7,32,27,5,41
Rapid Vienna,2372,3,8,10,6,35,28,7,34
Mattersburg,2372,4,8,5,11,32,39,-7,29
LASK Linz,2372,5,7,5,12,24,30,-6,26
SC Rheindorf,2372,6,6,6,12,18,27,-9,24
Vienna,2372,7,6,5,13,24,42,-18,23
FC Salzburg,2373,1,15,7,2,49,17,32,52
SK Sturm Gra,2373,2,13,3,8,35,30,5,42
Rapid Vienna,2373,3,8,10,6,38,31,7,34
LASK Linz,2373,4,9,6,9,27,29,-2,33
Vienna,2373,5,7,5,12,25,42,-17,26
SC Rheindorf,2373,6,6,5,13,17,27,-10,23
Mattersburg,2373,7,5,6,13,26,41,-15,21
SK Sturm Gra,2374,1,15,3,6,36,24,12,48
FC Salzburg,2374,2,13,8,3,42,18,24,47
Rapid Vienna,2374,3,9,9,6,37,31,6,36
LASK Linz,2374,4,8,6,10,28,31,-3,30
Vienna,2374,5,7,6,11,27,39,-12,27
Mattersburg,2374,6,5,7,12,30,45,-15,22
SC Rheindorf,2374,7,4,7,13,16,28,-12,19
FC Salzburg,2375,1,15,6,3,48,18,30,51
Rapid Vienna,2375,2,9,10,5,36,29,7,37
SK Sturm Gra,2375,3,11,3,10,29,32,-3,36
LASK Linz,2375,4,8,8,8,29,29,0,32
Vienna,2375,5,7,6,11,28,40,-12,27
Mattersburg,2375,6,6,7,11,32,44,-12,25
SC Rheindorf,2375,7,5,6,13,19,29,-10,21
FC Salzburg,2376,1,14,7,3,43,19,24,49
SK Sturm Gra,2376,2,11,6,7,34,31,3,39
Rapid Vienna,2376,3,9,11,4,38,27,11,38
Vienna,2376,4,8,5,11,27,38,-11,29
LASK Linz,2376,5,7,6,11,27,34,-7,27
Mattersburg,2376,6,7,5,12,30,39,-9,26
SC Rheindorf,2376,7,5,6,13,19,30,-11,21
FC Salzburg,2377,1,13,7,4,42,20,22,46
SK Sturm Gra,2377,2,13,5,6,32,26,6,44
Rapid Vienna,2377,3,7,11,6,37,32,5,32
LASK Linz,2377,4,8,7,9,28,30,-2,31
Mattersburg,2377,5,7,7,10,32,38,-6,28
SC Rheindorf,2377,6,6,6,12,22,29,-7,24
Vienna,2377,7,6,5,13,23,41,-18,23
FC Salzburg,2378,1,16,6,2,49,17,32,54
SK Sturm Gra,2378,2,12,4,8,33,26,7,40
Rapid Vienna,2378,3,8,10,6,34,31,3,34
LASK Linz,2378,4,9,6,9,26,28,-2,33
Mattersburg,2378,5,6,6,12,32,44,-12,24
Vienna,2378,6,6,5,13,23,43,-20,23
SC Rheindorf,2378,7,5,7,12,20,28,-8,22
FC Salzburg,2379,1,13,7,4,43,20,23,46
SK Sturm Gra,2379,2,12,3,9,31,34,-3,39
LASK Linz,2379,3,10,6,8,34,25,9,36
Rapid Vienna,2379,4,9,9,6,33,27,6,36
Mattersburg,2379,5,7,6,11,30,40,-10,27
Vienna,2379,6,7,5,12,27,41,-14,26
SC Rheindorf,2379,7,5,6,13,17,28,-11,21
FC Salzburg,2380,1,15,7,2,43,16,27,52
SK Sturm Gra,2380,2,12,3,9,29,31,-2,39
LASK Linz,2380,3,9,7,8,30,25,5,34
Rapid Vienna,2380,4,8,9,7,32,28,4,33
Vienna,2380,5,7,6,11,28,40,-12,27
Mattersburg,2380,6,6,6,12,32,44,-12,24
SC Rheindorf,2380,7,5,6,13,19,29,-10,21
FC Salzburg,2381,1,15,6,3,44,18,26,51
SK Sturm Gra,2381,2,12,5,7,31,27,4,41
LASK Linz,2381,3,9,6,9,27,27,0,33
Rapid Vienna,2381,4,7,10,7,33,30,3,31
Vienna,2381,5,7,5,12,28,40,-12,26
SC Rheindorf,2381,6,6,6,12,19,29,-10,24
Mattersburg,2381,7,6,6,12,32,43,-11,24
FC Salzburg,2382,1,16,6,2,52,17,35,54
SK Sturm Gra,2382,2,12,5,7,35,31,4,41
Rapid Vienna,2382,3,8,10,6,36,33,3,34
LASK Linz,2382,4,9,6,9,33,26,7,33
Vienna,2382,5,7,5,12,25,42,-17,26
Mattersburg,2382,6,6,5,13,31,45,-14,23
SC Rheindorf,2382,7,5,5,14,18,36,-18,20
FC Salzburg,2383,1,15,6,3,45,18,27,51
SK Sturm Gra,2383,2,12,4,8,34,31,3,40
Rapid Vienna,2383,3,8,12,4,37,27,10,36
LASK Linz,2383,4,7,7,10,27,31,-4,28
Mattersburg,2383,5,7,5,12,31,45,-14,26
SC Rheindorf,2383,6,6,7,11,26,31,-5,25
Vienna,2383,7,6,5,13,23,40,-17,23
FC Salzburg,2384,1,14,8,2,50,18,32,50
SK Sturm Gra,2384,2,12,5,7,33,29,4,41
Rapid Vienna,2384,3,8,11,5,33,26,7,35
LASK Linz,2384,4,8,7,9,28,29,-1,31
Mattersburg,2384,5,7,6,11,33,47,-14,27
Vienna,2384,6,6,6,12,24,40,-16,24
SC Rheindorf,2384,7,4,7,13,16,28,-12,19
FC Salzburg,2385,1,14,7,3,46,18,28,49
SK Sturm Gra,2385,2,14,3,7,37,30,7,45
LASK Linz,2385,3,9,6,9,29,29,0,33
Rapid Vienna,2385,4,7,11,6,33,27,6,32
Vienna,2385,5,7,5,12,25,41,-16,26
Mattersburg,2385,6,6,5,13,30,44,-14,23
SC Rheindorf,2385,7,5,7,12,19,30,-11,22
FC Salzburg,2386,1,14,6,4,42,20,22,48
SK Sturm Gra,2386,2,12,4,8,30,27,3,40
Rapid Vienna,2386,3,8,11,5,34,26,8,35
LASK Linz,2386,4,8,6,10,26,28,-2,30
Vienna,2386,5,8,5,11,27,38,-11,29
Mattersburg,2386,6,7,5,12,32,40,-8,26
SC Rheindorf,2386,7,6,5,13,21,33,-12,23
FC Salzburg,2387,1,15,7,2,48,19,29,52
SK Sturm Gra,2387,2,13,4,7,35,28,7,43
LASK Linz,2387,3,9,6,9,29,30,-1,33
Rapid Vienna,2387,4,7,10,7,35,30,5,31
SC Rheindorf,2387,5,6,6,12,21,30,-9,24
Mattersburg,2387,6,6,6,12,29,42,-13,24
Vienna,2387,7,6,5,13,24,42,-18,23
FC Salzburg,2388,1,15,7,2,45,18,27,52
SK Sturm Gra,2388,2,14,3,7,34,26,8,45
Rapid Vienna,2388,3,8,10,6,34,27,7,34
LASK Linz,2388,4,9,5,10,29,31,-2,32
Vienna,2388,5,7,5,12,26,41,-15,26
Mattersburg,2388,6,6,6,12,30,40,-10,24
SC Rheindorf,2388,7,4,6,14,15,30,-15,18
FC Salzburg,2389,1,14,7,3,47,19,28,49
SK Sturm Gra,2389,2,13,3,8,33,29,4,42
Rapid Vienna,2389,3,9,9,6,35,29,6,36
LASK Linz,2389,4,9,5,10,27,27,0,32
Vienna,2389,5,7,6,11,25,37,-12,27
SC Rheindorf,2389,6,7,5,12,20,26,-6,26
Mattersburg,2389,7,5,5,14,27,47,-20,20
FC Salzburg,2390,1,15,7,2,47,16,31,52
SK Sturm Gra,2390,2,12,4,8,31,31,0,40
Rapid Vienna,2390,3,7,13,4,34,26,8,34
SC Rheindorf,2390,4,7,6,11,23,26,-3,27
LASK Linz,2390,5,7,6,11,27,34,-7,27
Mattersburg,2390,6,7,5,12,32,42,-10,26
Vienna,2390,7,6,5,13,23,42,-19,23
FC Salzburg,2391,1,14,7,3,44,20,24,49
SK Sturm Gra,2391,2,12,5,7,36,31,5,41
Rapid Vienna,2391,3,9,9,6,36,28,8,36
LASK Linz,2391,4,9,5,10,30,31,-1,32
Vienna,2391,5,8,5,11,29,41,-12,29
SC Rheindorf,2391,6,6,6,12,19,28,-9,24
Mattersburg,2391,7,5,5,14,30,45,-15,20
FC Salzburg,2392,1,14,8,2,45,19,26,50
SK Sturm Gra,2392,2,12,5,7,34,30,4,41
Rapid Vienna,2392,3,9,11,4,39,26,13,38
LASK Linz,2392,4,9,6,9,29,26,3,33
Vienna,2392,5,7,6,11,25,38,-13,27
Mattersburg,2392,6,5,5,14,29,44,-15,20
SC Rheindorf,2392,7,5,5,14,18,36,-18,20
FC Salzburg,2393,1,13,6,5,44,25,19,45
SK Sturm Gra,2393,2,14,3,7,36,26,10,45
LASK Linz,2393,3,10,5,9,31,30,1,35
Rapid Vienna,2393,4,8,10,6,35,28,7,34
Vienna,2393,5,7,5,12,27,41,-14,26
Mattersburg,2393,6,6,6,12,32,43,-11,24
SC Rheindorf,2393,7,5,7,12,18,30,-12,22
FC Salzburg,2394,1,15,7,2,44,18,26,52
SK Sturm Gra,2394,2,12,4,8,35,32,3,40
Rapid Vienna,2394,3,8,9,7,38,31,7,33
LASK Linz,2394,4,9,6,9,32,33,-1,33
Mattersburg,2394,5,7,5,12,32,41,-9,26
Vienna,2394,6,6,6,12,23,39,-16,24
SC Rheindorf,2394,7,5,7,12,22,32,-10,22
FC Salzburg,2395,1,15,6,3,45,20,25,51
SK Sturm Gra,2395,2,11,5,8,32,30,2,38
Rapid Vienna,2395,3,9,10,5,36,26,10,37
LASK Linz,2395,4,8,8,8,29,29,0,32
Mattersburg,2395,5,6,7,11,34,43,-9,25
Vienna,2395,6,6,6,12,26,41,-15,24
SC Rheindorf,2395,7,5,6,13,20,33,-13,21
FC Salzburg,2396,1,12,9,3,42,20,22,45
SK Sturm Gra,2396,2,13,4,7,34,28,6,43
LASK Linz,2396,3,10,6,8,29,26,3,36
Rapid Vienna,2396,4,7,12,5,33,27,6,33
Mattersburg,2396,5,7,6,11,32,41,-9,27
Vienna,2396,6,6,6,12,24,39,-15,24
SC Rheindorf,2396,7,4,7,13,18,31,-13,19
FC Salzburg,2397,1,14,7,3,44,18,26,49
SK Sturm Gra,2397,2,12,4,8,31,28,3,40
Rapid Vienna,2397,3,10,9,5,39,26,13,39
LASK Linz,2397,4,9,6,9,30,29,1,33
Vienna,2397,5,7,5,12,26,40,-14,26
SC Rheindorf,2397,6,5,7,12,18,30,-12,22
Mattersburg,2397,7,5,6,13,28,45,-17,21
FC Salzburg,2398,1,16,6,2,52,17,35,54
SK Sturm Gra,2398,2,13,4,7,35,32,3,43
Rapid Vienna,2398,3,8,11,5,34,27,7,35
Mattersburg,2398,4,7,6,11,31,42,-11,27
LASK Linz,2398,5,7,5,12,25,32,-7,26
Vienna,2398,6,6,5,13,25,41,-16,23
SC Rheindorf,2398,7,5,7,12,19,30,-11,22
FC Salzburg,2399,1,14,7,3,47,22,25,49
SK Sturm Gra,2399,2,12,5,7,32,28,4,41
LASK Linz,2399,3,9,6,9,26,25,1,33
Rapid Vienna,2399,4,7,11,6,33,29,4,32
Vienna,2399,5,8,5,11,27,38,-11,29
Mattersburg,2399,6,6,7,11,29,39,-10,25
SC Rheindorf,2399,7,4,7,13,16,29,-13,19
FC Salzburg,2400,1,15,6,3,47,19,28,51
SK Sturm Gra,2400,2,12,5,7,33,29,4,41
Rapid Vienna,2400,3,9,9,6,35,27,8,36
LASK Linz,2400,4,8,7,9,32,32,0,31
Mattersburg,2400,5,8,5,11,35,45,-10,29
Vienna,2400,6,6,5,13,25,41,-16,23
SC Rheindorf,2400,7,4,7,13,19,33,-14,19
FC Salzburg,2401,1,13,7,4,47,22,25,46
SK Sturm Gra,2401,2,13,4,7,36,31,5,43
LASK Linz,2401,3,10,6,8,33,29,4,36
Rapid Vienna,2401,4,7,10,7,37,34,3,31
Vienna,2401,5,8,5,11,29,41,-12,29
Mattersburg,2401,6,7,5,12,32,42,-10,26
SC Rheindorf,2401,7,5,5,14,17,32,-15,20
FC Salzburg,2402,1,14,7,3,43,18,25,49
SK Sturm Gra,2402,2,13,4,7,33,28,5,43
Rapid Vienna,2402,3,9,10,5,39,26,13,37
LASK Linz,2402,4,7,5,12,23,32,-9,26
Mattersburg,2402,5,7,5,12,29,40,-11,26
Vienna,2402,6,7,5,12,26,40,-14,26
SC Rheindorf,2402,7,6,6,12,19,28,-9,24
FC Salzburg,2403,1,14,6,4,46,17,29,48
SK Sturm Gra,2403,2,12,3,9,30,31,-1,39
Rapid Vienna,2403,3,9,9,6,36,28,8,36
LASK Linz,2403,4,9,6,9,31,29,2,33
Vienna,2403,5,8,5,11,26,37,-11,29
SC Rheindorf,2403,6,6,6,12,18,27,-9,24
Mattersburg,2403,7,5,7,12,26,44,-18,22
FC Salzburg,2404,1,14,7,3,44,20,24,49
SK Sturm Gra,2404,2,13,4,7,35,26,9,43
Rapid Vienna,2404,3,7,10,7,33,32,1,31
LASK Linz,2404,4,8,6,10,25,30,-5,30
SC Rheindorf,2404,5,7,6,11,22,27,-5,27
Vienna,2404,6,7,6,11,29,41,-12,27
Mattersburg,2404,7,5,7,12,30,42,-12,22
FC Salzburg,2405,1,15,6,3,46,18,28,51
Rapid Vienna,2405,2,9,11,4,36,26,10,38
SK Sturm Gra,2405,3,11,5,8,31,31,0,38
LASK Linz,2405,4,8,6,10,28,31,-3,30
Mattersburg,2405,5,7,6,11,33,41,-8,27
Vienna,2405,6,6,5,13,25,41,-16,23
SC Rheindorf,2405,7,5,7,12,22,33,-11,22
FC Salzburg,2406,1,13,8,3,45,21,24,47
SK Sturm Gra,2406,2,13,5,6,38,28,10,44
Rapid Vienna,2406,3,8,11,5,40,32,8,35
LASK Linz,2406,4,8,5,11,28,34,-6,29
Mattersburg,2406,5,8,5,11,32,40,-8,29
Vienna,2406,6,7,5,12,24,38,-14,26
SC Rheindorf,2406,7,5,5,14,19,33,-14,20
FC Salzburg,2407,1,14,6,4,45,23,22,48
SK Sturm Gra,2407,2,15,3,6,42,26,16,48
Rapid Vienna,2407,3,9,10,5,35,27,8,37
LASK Linz,2407,4,7,7,10,25,30,-5,28
Vienna,2407,5,7,5,12,26,43,-17,26
SC Rheindorf,2407,6,6,5,13,18,29,-11,23
Mattersburg,2407,7,5,6,13,28,41,-13,21
FC Salzburg,2408,1,14,6,4,43,19,24,48
SK Sturm Gra,2408,2,14,3,7,37,29,8,45
Rapid Vienna,2408,3,8,9,7,35,30,5,33
LASK Linz,2408,4,8,6,10,27,31,-4,30
SC Rheindorf,2408,5,7,5,12,22,27,-5,26
Vienna,2408,6,7,5,12,25,40,-15,26
Mattersburg,2408,7,6,6,12,30,43,-13,24
FC Salzburg,2409,1,13,6,5,48,26,22,45
SK Sturm Gra,2409,2,13,3,8,34,35,-1,42
Rapid Vienna,2409,3,9,10,5,42,28,14,37
LASK Linz,2409,4,8,6,10,26,30,-4,30
Vienna,2409,5,8,5,11,27,39,-12,29
SC Rheindorf,2409,6,6,6,12,21,30,-9,24
Mattersburg,2409,7,6,6,12,35,45,-10,24
FC Salzburg,2410,1,13,7,4,44,21,23,46
SK Sturm Gra,2410,2,14,4,6,34,26,8,46
Rapid Vienna,2410,3,9,9,6,36,30,6,36
LASK Linz,2410,4,8,7,9,28,28,0,31
Vienna,2410,5,7,5,12,24,40,-16,26
Mattersburg,2410,6,6,7,11,33,41,-8,25
SC Rheindorf,2410,7,5,5,14,16,29,-13,20
FC Salzburg,2411,1,15,6,3,50,21,29,51
SK Sturm Gra,2411,2,12,3,9,35,34,1,39
Rapid Vienna,2411,3,8,10,6,35,31,4,34
LASK Linz,2411,4,9,6,9,28,28,0,33
Mattersburg,2411,5,7,6,11,30,39,-9,27
SC Rheindorf,2411,6,6,6,12,21,29,-8,24
Vienna,2411,7,6,5,13,25,42,-17,23
FC Salzburg,2412,1,14,6,4,42,19,23,48
SK Sturm Gra,2412,2,12,5,7,31,26,5,41
Rapid Vienna,2412,3,9,10,5,39,29,10,37
LASK Linz,2412,4,7,8,9,27,31,-4,29
Vienna,2412,5,7,6,11,25,38,-13,27
Mattersburg,2412,6,6,7,11,31,39,-8,25
SC Rheindorf,2412,7,4,8,12,19,32,-13,20
FC Salzburg,2413,1,12,9,3,40,19,21,45
SK Sturm Gra,2413,2,13,4,7,32,26,6,43
Rapid Vienna,2413,3,9,10,5,36,24,12,37
LASK Linz,2413,4,10,6,8,28,24,4,36
Vienna,2413,5,7,6,11,25,38,-13,27
Mattersburg,2413,6,6,6,12,30,41,-11,24
SC Rheindorf,2413,7,4,5,15,16,35,-19,17
FC Salzburg,2414,1,13,9,2,42,18,24,48
SK Sturm Gra,2414,2,11,6,7,31,28,3,39
Rapid Vienna,2414,3,7,12,5,33,27,6,33
LASK Linz,2414,4,8,7,9,31,31,0,31
Mattersburg,2414,5,8,6,10,36,42,-6,30
Vienna,2414,6,6,6,12,25,41,-16,24
SC Rheindorf,2414,7,4,8,12,17,28,-11,20
FC Salzburg,2415,1,12,9,3,42,20,22,45
SK Sturm Gra,2415,2,12,6,6,32,27,5,42
LASK Linz,2415,3,10,6,8,32,26,6,36
Rapid Vienna,2415,4,7,12,5,34,27,7,33
Vienna,2415,5,8,5,11,28,40,-12,29
Mattersburg,2415,6,5,7,12,30,44,-14,22
SC Rheindorf,2415,7,4,7,13,16,30,-14,19
FC Salzburg,2416,1,15,6,3,44,18,26,51
SK Sturm Gra,2416,2,13,3,8,33,29,4,42
LASK Linz,2416,3,10,5,9,31,28,3,35
Rapid Vienna,2416,4,8,10,6,36,32,4,34
Vienna,2416,5,7,5,12,26,39,-13,26
SC Rheindorf,2416,6,5,7,12,18,28,-10,22
Mattersburg,2416,7,5,6,13,29,43,-14,21
FC Salzburg,2417,1,14,7,3,46,20,26,49
SK Sturm Gra,2417,2,13,4,7,35,28,7,43
LASK Linz,2417,3,10,5,9,32,29,3,35
Rapid Vienna,2417,4,7,10,7,33,32,1,31
Vienna,2417,5,7,6,11,25,38,-13,27
Mattersburg,2417,6,6,6,12,28,41,-13,24
SC Rheindorf,2417,7,5,6,13,19,30,-11,21
FC Salzburg,2418,1,15,6,3,49,19,30,51
SK Sturm Gra,2418,2,13,4,7,34,31,3,43
Rapid Vienna,2418,3,8,9,7,35,31,4,33
LASK Linz,2418,4,8,6,10,31,30,1,30
Vienna,2418,5,8,5,11,26,38,-12,29
Mattersburg,2418,6,7,5,12,30,42,-12,26
SC Rheindorf,2418,7,5,5,14,19,33,-14,20
FC Salzburg,2419,1,15,7,2,48,20,28,52
SK Sturm Gra,2419,2,13,4,7,34,30,4,43
Rapid Vienna,2419,3,8,10,6,36,29,7,34
LASK Linz,2419,4,8,7,9,29,29,0,31
Vienna,2419,5,6,6,12,24,40,-16,24
SC Rheindorf,2419,6,5,7,12,20,29,-9,22
Mattersburg,2419,7,5,7,12,30,44,-14,22
FC Salzburg,2420,1,13,7,4,40,18,22,46
SK Sturm Gra,2420,2,13,4,7,31,27,4,43
Rapid Vienna,2420,3,8,10,6,33,26,7,34
LASK Linz,2420,4,9,6,9,28,29,-1,33
Vienna,2420,5,7,6,11,25,38,-13,27
Mattersburg,2420,6,6,7,11,30,40,-10,25
SC Rheindorf,2420,7,5,6,13,19,28,-9,21
FC Salzburg,2421,1,14,8,2,51,20,31,50
SK Sturm Gra,2421,2,13,4,7,39,33,6,43
Rapid Vienna,2421,3,7,10,7,35,36,-1,31
LASK Linz,2421,4,8,6,10,32,32,0,30
Vienna,2421,5,7,5,12,27,43,-16,26
Mattersburg,2421,6,6,7,11,32,42,-10,25
SC Rheindorf,2421,7,6,6,12,22,32,-10,24
FC Salzburg,2422,1,15,7,2,47,17,30,52
SK Sturm Gra,2422,2,13,3,8,30,28,2,42
Rapid Vienna,2422,3,8,10,6,32,27,5,34
LASK Linz,2422,4,9,6,9,27,26,1,33
Vienna,2422,5,7,6,11,25,38,-13,27
SC Rheindorf,2422,6,6,5,13,20,28,-8,23
Mattersburg,2422,7,5,5,14,29,46,-17,20
FC Salzburg,2423,1,15,7,2,46,18,28,52
SK Sturm Gra,2423,2,13,4,7,33,29,4,43
Rapid Vienna,2423,3,9,9,6,36,29,7,36
LASK Linz,2423,4,9,6,9,27,26,1,33
Mattersburg,2423,5,7,6,11,33,41,-8,27
Vienna,2423,6,6,5,13,24,40,-16,23
SC Rheindorf,2423,7,4,5,15,17,33,-16,17
FC Salzburg,2424,1,15,6,3,47,21,26,51
SK Sturm Gra,2424,2,13,4,7,36,31,5,43
Rapid Vienna,2424,3,8,9,7,34,28,6,33
LASK Linz,2424,4,8,6,10,26,29,-3,30
Vienna,2424,5,7,5,12,28,40,-12,26
Mattersburg,2424,6,7,5,12,30,43,-13,26
SC Rheindorf,2424,7,6,5,13,21,30,-9,23
FC Salzburg,2425,1,15,7,2,47,19,28,52
SK Sturm Gra,2425,2,13,4,7,32,26,6,43
Rapid Vienna,2425,3,7,10,7,33,30,3,31
LASK Linz,2425,4,8,6,10,27,29,-2,30
Mattersburg,2425,5,7,5,12,30,41,-11,26
SC Rheindorf,2425,6,6,7,11,19,26,-7,25
Vienna,2425,7,6,5,13,24,41,-17,23
FC Salzburg,2426,1,16,6,2,50,17,33,54
SK Sturm Gra,2426,2,12,4,8,31,31,0,40
Rapid Vienna,2426,3,8,10,6,35,27,8,34
LASK Linz,2426,4,7,8,9,26,30,-4,29
Mattersburg,2426,5,7,6,11,34,43,-9,27
Vienna,2426,6,6,5,13,24,41,-17,23
SC Rheindorf,2426,7,5,7,12,20,31,-11,22
FC Salzburg,2427,1,15,6,3,44,17,27,51
SK Sturm Gra,2427,2,11,5,8,32,30,2,38
Rapid Vienna,2427,3,9,9,6,38,28,10,36
LASK Linz,2427,4,8,7,9,27,29,-2,31
Mattersburg,2427,5,7,6,11,33,41,-8,27
Vienna,2427,6,7,6,11,27,40,-13,27
SC Rheindorf,2427,7,4,7,13,21,37,-16,19
FC Salzburg,2428,1,14,7,3,45,19,26,49
SK Sturm Gra,2428,2,13,3,8,34,30,4,42
Rapid Vienna,2428,3,8,10,6,36,28,8,34
LASK Linz,2428,4,9,6,9,29,32,-3,33
Mattersburg,2428,5,6,6,12,34,43,-9,24
SC Rheindorf,2428,6,6,6,12,20,30,-10,24
Vienna,2428,7,6,6,12,24,40,-16,24
FC Salzburg,2429,1,13,8,3,41,19,22,47
SK Sturm Gra,2429,2,11,6,7,30,27,3,39
Rapid Vienna,2429,3,8,11,5,37,28,9,35
LASK Linz,2429,4,8,8,8,31,31,0,32
Vienna,2429,5,7,5,12,25,39,-14,26
Mattersburg,2429,6,6,7,11,35,44,-9,25
SC Rheindorf,2429,7,5,7,12,22,33,-11,22
FC Salzburg,2430,1,14,6,4,47,20,27,48
Rapid Vienna,2430,2,9,11,4,40,29,11,38
SK Sturm Gra,2430,3,11,4,9,30,31,-1,37
LASK Linz,2430,4,7,8,9,28,30,-2,29
SC Rheindorf,2430,5,7,6,11,21,28,-7,27
Vienna,2430,6,7,5,12,27,40,-13,26
Mattersburg,2430,7,6,6,12,30,45,-15,24
FC Salzburg,2431,1,16,6,2,47,17,30,54
SK Sturm Gra,2431,2,12,4,8,30,29,1,40
Rapid Vienna,2431,3,8,10,6,34,29,5,34
LASK Linz,2431,4,9,6,9,29,26,3,33
Vienna,2431,5,7,5,12,27,40,-13,26
SC Rheindorf,2431,6,6,5,13,17,28,-11,23
Mattersburg,2431,7,5,6,13,28,43,-15,21
FC Salzburg,2432,1,14,8,2,44,18,26,50
SK Sturm Gra,2432,2,11,6,7,28,25,3,39
Rapid Vienna,2432,3,8,11,5,33,25,8,35
LASK Linz,2432,4,8,7,9,25,27,-2,31
Vienna,2432,5,7,5,12,28,41,-13,26
Mattersburg,2432,6,6,6,12,32,44,-12,24
SC Rheindorf,2432,7,5,7,12,17,27,-10,22
FC Salzburg,2433,1,14,7,3,47,19,28,49
Rapid Vienna,2433,2,10,9,5,41,26,15,39
SK Sturm Gra,2433,3,12,3,9,29,35,-6,39
LASK Linz,2433,4,9,6,9,29,28,1,33
Vienna,2433,5,6,7,11,25,39,-14,25
SC Rheindorf,2433,6,6,6,12,22,30,-8,24
Mattersburg,2433,7,5,6,13,28,44,-16,21
FC Salzburg,2434,1,14,8,2,42,17,25,50
SK Sturm Gra,2434,2,12,4,8,31,29,2,40
Rapid Vienna,2434,3,8,10,6,33,26,7,34
LASK Linz,2434,4,8,7,9,29,31,-2,31
Mattersburg,2434,5,7,7,10,34,40,-6,28
Vienna,2434,6,6,7,11,25,39,-14,25
SC Rheindorf,2434,7,4,7,13,15,27,-12,19
FC Salzburg,2435,1,15,7,2,50,19,31,52
SK Sturm Gra,2435,2,12,4,8,35,29,6,40
Rapid Vienna,2435,3,7,12,5,34,27,7,33
LASK Linz,2435,4,8,6,10,25,30,-5,30
SC Rheindorf,2435,5,6,7,11,20,28,-8,25
Mattersburg,2435,6,6,7,11,29,40,-11,25
Vienna,2435,7,6,5,13,25,45,-20,23
FC Salzburg,2436,1,15,7,2,47,19,28,52
SK Sturm Gra,2436,2,11,5,8,33,31,2,38
Rapid Vienna,2436,3,7,12,5,34,28,6,33
LASK Linz,2436,4,8,7,9,29,30,-1,31
Mattersburg,2436,5,7,6,11,33,42,-9,27
SC Rheindorf,2436,6,6,6,12,22,31,-9,24
Vienna,2436,7,6,5,13,24,41,-17,23
FC Salzburg,2437,1,12,8,4,40,21,19,44
SK Sturm Gra,2437,2,12,6,6,32,26,6,42
Rapid Vienna,2437,3,8,10,6,34,27,7,34
LASK Linz,2437,4,8,7,9,27,27,0,31
Mattersburg,2437,5,7,7,10,35,40,-5,28
Vienna,2437,6,7,5,12,26,41,-15,26
SC Rheindorf,2437,7,5,7,12,19,31,-12,22
FC Salzburg,2438,1,13,7,4,47,19,28,46
SK Sturm Gra,2438,2,14,3,7,36,29,7,45
Rapid Vienna,2438,3,8,10,6,35,30,5,34
LASK Linz,2438,4,9,6,9,30,30,0,33
Vienna,2438,5,7,5,12,25,44,-19,26
SC Rheindorf,2438,6,6,6,12,22,30,-8,24
Mattersburg,2438,7,5,7,12,28,41,-13,22
FC Salzburg,2439,1,14,6,4,43,20,23,48
SK Sturm Gra,2439,2,13,4,7,35,29,6,43
Rapid Vienna,2439,3,9,10,5,38,27,11,37
LASK Linz,2439,4,8,7,9,28,28,0,31
Mattersburg,2439,5,7,5,12,30,43,-13,26
Vienna,2439,6,6,5,13,25,41,-16,23
SC Rheindorf,2439,7,5,7,12,19,30,-11,22
FC Salzburg,2440,1,14,8,2,47,18,29,50
SK Sturm Gra,2440,2,12,4,8,32,31,1,40
Rapid Vienna,2440,3,8,11,5,35,27,8,35
LASK Linz,2440,4,9,6,9,31,31,0,33
Vienna,2440,5,7,6,11,27,39,-12,27
Mattersburg,2440,6,6,5,13,30,44,-14,23
SC Rheindorf,2440,7,5,6,13,19,31,-12,21
FC Salzburg,2441,1,16,6,2,45,17,28,54
SK Sturm Gra,2441,2,12,5,7,32,27,5,41
Rapid Vienna,2441,3,9,9,6,36,28,8,36
LASK Linz,2441,4,8,7,9,28,27,1,31
Vienna,2441,5,6,6,12,26,41,-15,24
SC Rheindorf,2441,6,5,7,12,22,32,-10,22
Mattersburg,2441,7,5,6,13,29,46,-17,21
FC Salzburg,2442,1,15,7,2,46,18,28,52
SK Sturm Gra,2442,2,13,4,7,35,30,5,43
LASK Linz,2442,3,9,7,8,27,26,1,34
Rapid Vienna,2442,4,7,11,6,33,29,4,32
Mattersburg,2442,5,6,7,11,31,41,-10,25
Vienna,2442,6,6,5,13,23,39,-16,23
SC Rheindorf,2442,7,4,7,13,20,32,-12,19
FC Salzburg,2443,1,14,7,3,43,19,24,49
SK Sturm Gra,2443,2,12,3,9,35,34,1,39
LASK Linz,2443,3,10,5,9,30,28,2,35
Rapid Vienna,2443,4,8,10,6,35,28,7,34
Vienna,2443,5,7,5,12,26,40,-14,26
SC Rheindorf,2443,6,6,6,12,21,30,-9,24
Mattersburg,2443,7,6,6,12,29,40,-11,24
FC Salzburg,2444,1,15,7,2,45,18,27,52
SK Sturm Gra,2444,2,13,4,7,32,27,5,43
Rapid Vienna,2444,3,8,9,7,34,28,6,33
LASK Linz,2444,4,8,6,10,25,29,-4,30
Mattersburg,2444,5,8,5,11,36,41,-5,29
Vienna,2444,6,6,6,12,25,41,-16,24
SC Rheindorf,2444,7,4,7,13,17,30,-13,19
FC Salzburg,2445,1,15,6,3,51,19,32,51
SK Sturm Gra,2445,2,12,3,9,35,39,-4,39
Rapid Vienna,2445,3,9,9,6,35,28,7,36
LASK Linz,2445,4,8,6,10,30,30,0,30
Mattersburg,2445,5,7,6,11,31,42,-11,27
SC Rheindorf,2445,6,7,5,12,21,28,-7,26
Vienna,2445,7,6,5,13,23,40,-17,23
FC Salzburg,2446,1,15,7,2,46,18,28,52
SK Sturm Gra,2446,2,12,5,7,34,29,5,41
Rapid Vienna,2446,3,8,10,6,34,29,5,34
LASK Linz,2446,4,8,6,10,28,30,-2,30
Vienna,2446,5,6,7,11,25,39,-14,25
Mattersburg,2446,6,6,6,12,31,43,-12,24
SC Rheindorf,2446,7,6,5,13,19,29,-10,23
FC Salzburg,2447,1,16,6,2,48,18,30,54
SK Sturm Gra,2447,2,12,4,8,33,31,2,40
Rapid Vienna,2447,3,8,10,6,38,29,9,34
LASK Linz,2447,4,7,7,10,26,34,-8,28
Mattersburg,2447,5,7,5,12,36,43,-7,26
Vienna,2447,6,7,5,12,27,41,-14,26
SC Rheindorf,2447,7,6,5,13,19,31,-12,23
FC Salzburg,2448,1,14,8,2,44,18,26,50
SK Sturm Gra,2448,2,11,5,8,31,31,0,38
Rapid Vienna,2448,3,8,11,5,36,27,9,35
LASK Linz,2448,4,7,7,10,26,29,-3,28
Vienna,2448,5,7,6,11,25,38,-13,27
SC Rheindorf,2448,6,7,5,12,23,30,-7,26
Mattersburg,2448,7,6,6,12,29,41,-12,24
FC Salzburg,2449,1,13,8,3,41,17,24,47
SK Sturm Gra,2449,2,14,3,7,35,29,6,45
LASK Linz,2449,3,10,5,9,28,25,3,35
Rapid Vienna,2449,4,8,10,6,34,28,6,34
Vienna,2449,5,7,6,11,26,39,-13,27
Mattersburg,2449,6,7,5,12,29,40,-11,26
SC Rheindorf,2449,7,4,5,15,16,31,-15,17
FC Salzburg,2450,1,15,6,3,48,21,27,51
SK Sturm Gra,2450,2,14,3,7,35,27,8,45
Rapid Vienna,2450,3,7,9,8,35,34,1,30
LASK Linz,2450,4,8,6,10,28,30,-2,30
Mattersburg,2450,5,7,5,12,35,46,-11,26
Vienna,2450,6,7,5,12,26,40,-14,26
SC Rheindorf,2450,7,6,6,12,20,29,-9,24
FC Salzburg,2451,1,15,7,2,45,17,28,52
SK Sturm Gra,2451,2,12,5,7,30,27,3,41
Rapid Vienna,2451,3,8,11,5,34,26,8,35
LASK Linz,2451,4,7,5,12,24,30,-6,26
Mattersburg,2451,5,7,5,12,32,40,-8,26
Vienna,2451,6,7,5,12,26,42,-16,26
SC Rheindorf,2451,7,6,6,12,20,29,-9,24
FC Salzburg,2452,1,14,6,4,43,19,24,48
SK Sturm Gra,2452,2,13,3,8,33,31,2,42
Rapid Vienna,2452,3,8,10,6,38,30,8,34
LASK Linz,2452,4,9,6,9,29,28,1,33
Vienna,2452,5,7,5,12,25,39,-14,26
SC Rheindorf,2452,6,6,7,11,20,27,-7,25
Mattersburg,2452,7,5,7,12,27,41,-14,22
FC Salzburg,2453,1,14,8,2,46,19,27,50
Rapid Vienna,2453,2,9,10,5,39,29,10,37
SK Sturm Gra,2453,3,11,4,9,30,32,-2,37
LASK Linz,2453,4,9,7,8,29,28,1,34
Mattersburg,2453,5,6,7,11,33,43,-10,25
Vienna,2453,6,6,6,12,24,39,-15,24
SC Rheindorf,2453,7,5,6,13,19,30,-11,21
FC Salzburg,2454,1,15,7,2,45,16,29,52
SK Sturm Gra,2454,2,12,4,8,32,29,3,40
Rapid Vienna,2454,3,8,12,4,36,27,9,36
LASK Linz,2454,4,7,7,10,25,30,-5,28
Vienna,2454,5,7,5,12,24,39,-15,26
SC Rheindorf,2454,6,5,8,11,18,27,-9,23
Mattersburg,2454,7,5,7,12,28,40,-12,22
FC Salzburg,2455,1,15,6,3,44,16,28,51
SK Sturm Gra,2455,2,12,4,8,33,31,2,40
Rapid Vienna,2455,3,9,10,5,36,28,8,37
LASK Linz,2455,4,9,6,9,29,30,-1,33
Mattersburg,2455,5,8,5,11,34,39,-5,29
Vienna,2455,6,6,5,13,23,39,-16,23
SC Rheindorf,2455,7,4,6,14,20,36,-16,18
FC Salzburg,2456,1,14,7,3,45,20,25,49
SK Sturm Gra,2456,2,12,3,9,33,29,4,39
Rapid Vienna,2456,3,9,11,4,38,27,11,38
LASK Linz,2456,4,8,6,10,25,31,-6,30
Vienna,2456,5,7,6,11,26,39,-13,27
SC Rheindorf,2456,6,6,6,12,21,29,-8,24
Mattersburg,2456,7,6,5,13,30,43,-13,23
FC Salzburg,2457,1,15,6,3,46,20,26,51
SK Sturm Gra,2457,2,14,3,7,36,28,8,45
Rapid Vienna,2457,3,9,10,5,35,25,10,37
LASK Linz,2457,4,9,6,9,26,26,0,33
Mattersburg,2457,5,6,5,13,30,43,-13,23
Vienna,2457,6,6,5,13,25,43,-18,23
SC Rheindorf,2457,7,5,5,14,18,31,-13,20
FC Salzburg,2458,1,14,6,4,42,18,24,48
Rapid Vienna,2458,2,10,9,5,38,28,10,39
SK Sturm Gra,2458,3,11,3,10,29,33,-4,36
LASK Linz,2458,4,9,5,10,30,29,1,32
Vienna,2458,5,8,5,11,28,39,-11,29
SC Rheindorf,2458,6,7,5,12,23,28,-5,26
Mattersburg,2458,7,6,5,13,28,43,-15,23
FC Salzburg,2459,1,15,6,3,44,18,26,51
SK Sturm Gra,2459,2,12,4,8,30,27,3,40
Rapid Vienna,2459,3,7,11,6,33,27,6,32
Vienna,2459,4,8,5,11,26,37,-11,29
LASK Linz,2459,5,7,6,11,25,29,-4,27
SC Rheindorf,2459,6,7,5,12,20,29,-9,26
Mattersburg,2459,7,7,5,12,34,45,-11,26
FC Salzburg,2460,1,16,6,2,45,17,28,54
SK Sturm Gra,2460,2,13,4,7,33,28,5,43
Rapid Vienna,2460,3,8,9,7,34,28,6,33
LASK Linz,2460,4,8,6,10,27,29,-2,30
Vienna,2460,5,7,5,12,25,40,-15,26
Mattersburg,2460,6,6,6,12,30,41,-11,24
SC Rheindorf,2460,7,5,6,13,17,28,-11,21
FC Salzburg,2461,1,16,6,2,50,20,30,54
SK Sturm Gra,2461,2,13,4,7,33,28,5,43
LASK Linz,2461,3,9,5,10,26,29,-3,32
Rapid Vienna,2461,4,7,10,7,35,31,4,31
Vienna,2461,5,7,5,12,28,39,-11,26
SC Rheindorf,2461,6,6,7,11,26,32,-6,25
Mattersburg,2461,7,5,5,14,31,50,-19,20
FC Salzburg,2462,1,15,6,3,49,20,29,51
Rapid Vienna,2462,2,9,11,4,40,28,12,38
SK Sturm Gra,2462,3,11,3,10,31,36,-5,36
LASK Linz,2462,4,8,7,9,30,30,0,31
Mattersburg,2462,5,8,5,11,33,40,-7,29
Vienna,2462,6,6,5,13,24,43,-19,23
SC Rheindorf,2462,7,5,7,12,20,30,-10,22
FC Salzburg,2463,1,15,6,3,43,18,25,51
SK Sturm Gra,2463,2,11,5,8,32,31,1,38
Rapid Vienna,2463,3,7,10,7,32,28,4,31
LASK Linz,2463,4,8,7,9,26,27,-1,31
Mattersburg,2463,5,8,5,11,33,37,-4,29
Vienna,2463,6,7,5,12,25,39,-14,26
SC Rheindorf,2463,7,6,6,12,18,29,-11,24
FC Salzburg,2464,1,15,7,2,48,18,30,52
Rapid Vienna,2464,2,10,9,5,39,27,12,39
SK Sturm Gra,2464,3,11,3,10,29,35,-6,36
LASK Linz,2464,4,9,5,10,28,30,-2,32
Mattersburg,2464,5,8,6,10,34,40,-6,30
Vienna,2464,6,6,5,13,24,41,-17,23
SC Rheindorf,2464,7,5,5,14,20,31,-11,20
FC Salzburg,2465,1,16,6,2,49,17,32,54
SK Sturm Gra,2465,2,14,3,7,34,29,5,45
Rapid Vienna,2465,3,9,9,6,37,26,11,36
LASK Linz,2465,4,9,5,10,28,30,-2,32
Vienna,2465,5,7,5,12,28,41,-13,26
SC Rheindorf,2465,6,5,5,14,21,33,-12,20
Mattersburg,2465,7,5,5,14,29,50,-21,20
FC Salzburg,2466,1,13,8,3,42,18,24,47
SK Sturm Gra,2466,2,11,4,9,31,31,0,37
LASK Linz,2466,3,9,6,9,30,30,0,33
Rapid Vienna,2466,4,7,11,6,33,29,4,32
Mattersburg,2466,5,8,6,10,35,39,-4,30
Vienna,2466,6,6,7,11,24,38,-14,25
SC Rheindorf,2466,7,6,6,12,19,29,-10,24
FC Salzburg,2467,1,14,8,2,43,18,25,50
SK Sturm Gra,2467,2,14,3,7,33,25,8,45
Rapid Vienna,2467,3,9,10,5,36,26,10,37
LASK Linz,2467,4,8,5,11,26,31,-5,29
Mattersburg,2467,5,7,6,11,32,40,-8,27
Vienna,2467,6,6,6,12,25,41,-16,24
SC Rheindorf,2467,7,4,6,14,17,31,-14,18
FC Salzburg,2468,1,14,6,4,42,19,23,48
SK Sturm Gra,2468,2,12,5,7,31,27,4,41
Rapid Vienna,2468,3,9,9,6,34,26,8,36
LASK Linz,2468,4,8,6,10,26,32,-6,30
Vienna,2468,5,7,6,11,27,40,-13,27
Mattersburg,2468,6,6,7,11,35,41,-6,25
SC Rheindorf,2468,7,5,7,12,18,28,-10,22
FC Salzburg,2469,1,14,7,3,45,21,24,49
SK Sturm Gra,2469,2,13,5,6,38,30,8,44
Rapid Vienna,2469,3,9,11,4,36,25,11,38
LASK Linz,2469,4,8,6,10,27,32,-5,30
Mattersburg,2469,5,7,5,12,31,40,-9,26
Vienna,2469,6,6,5,13,25,41,-16,23
SC Rheindorf,2469,7,4,7,13,17,30,-13,19
FC Salzburg,2470,1,16,6,2,49,16,33,54
SK Sturm Gra,2470,2,11,5,8,31,29,2,38
Rapid Vienna,2470,3,8,10,6,37,31,6,34
LASK Linz,2470,4,9,6,9,28,29,-1,33
Mattersburg,2470,5,7,5,12,30,42,-12,26
Vienna,2470,6,7,5,12,27,40,-13,26
SC Rheindorf,2470,7,4,7,13,17,32,-15,19
FC Salzburg,2471,1,15,7,2,46,18,28,52
SK Sturm Gra,2471,2,11,5,8,31,29,2,38
Rapid Vienna,2471,3,8,10,6,35,29,6,34
LASK Linz,2471,4,9,7,8,26,25,1,34
Mattersburg,2471,5,7,6,11,29,40,-11,27
Vienna,2471,6,6,5,13,25,41,-16,23
SC Rheindorf,2471,7,5,6,13,18,28,-10,21
FC Salzburg,2472,1,15,6,3,46,17,29,51
SK Sturm Gra,2472,2,14,3,7,34,27,7,45
Rapid Vienna,2472,3,8,10,6,34,25,9,34
LASK Linz,2472,4,8,7,9,26,28,-2,31
Mattersburg,2472,5,6,6,12,31,43,-12,24
Vienna,2472,6,6,5,13,23,42,-19,23
SC Rheindorf,2472,7,5,7,12,19,31,-12,22
FC Salzburg,2473,1,14,6,4,43,20,23,48
SK Sturm Gra,2473,2,13,4,7,32,28,4,43
Rapid Vienna,2473,3,8,9,7,33,28,5,33
LASK Linz,2473,4,8,6,10,25,27,-2,30
Vienna,2473,5,7,6,11,27,39,-12,27
SC Rheindorf,2473,6,6,7,11,21,26,-5,25
Mattersburg,2473,7,6,6,12,30,43,-13,24
FC Salzburg,2474,1,15,6,3,43,18,25,51
SK Sturm Gra,2474,2,13,3,8,34,29,5,42
Rapid Vienna,2474,3,8,11,5,38,30,8,35
LASK Linz,2474,4,7,7,10,28,34,-6,28
Vienna,2474,5,7,5,12,25,40,-15,26
Mattersburg,2474,6,6,6,12,30,41,-11,24
SC Rheindorf,2474,7,5,8,11,24,30,-6,23
FC Salzburg,2475,1,15,7,2,47,19,28,52
Rapid Vienna,2475,2,9,11,4,37,26,11,38
SK Sturm Gra,2475,3,11,5,8,30,31,-1,38
LASK Linz,2475,4,8,7,9,26,28,-2,31
Mattersburg,2475,5,6,6,12,30,40,-10,24
Vienna,2475,6,6,6,12,25,40,-15,24
SC Rheindorf,2475,7,5,6,13,18,29,-11,21
FC Salzburg,2476,1,13,8,3,40,17,23,47
SK Sturm Gra,2476,2,12,4,8,30,28,2,40
Rapid Vienna,2476,3,9,10,5,37,27,10,37
Mattersburg,2476,4,9,5,10,35,38,-3,32
LASK Linz,2476,5,8,6,10,26,32,-6,30
Vienna,2476,6,6,6,12,25,40,-15,24
SC Rheindorf,2476,7,5,5,14,19,30,-11,20
FC Salzburg,2477,1,15,7,2,48,18,30,52
SK Sturm Gra,2477,2,12,4,8,30,30,0,40
Rapid Vienna,2477,3,7,12,5,32,26,6,33
Mattersburg,2477,4,7,6,11,33,40,-7,27
LASK Linz,2477,5,7,6,11,24,31,-7,27
SC Rheindorf,2477,6,6,7,11,20,27,-7,25
Vienna,2477,7,6,6,12,26,41,-15,24
FC Salzburg,2478,1,15,6,3,51,20,31,51
SK Sturm Gra,2478,2,12,4,8,34,29,5,40
Rapid Vienna,2478,3,8,9,7,35,32,3,33
LASK Linz,2478,4,9,5,10,29,31,-2,32
SC Rheindorf,2478,5,7,6,11,21,28,-7,27
Mattersburg,2478,6,6,6,12,35,47,-12,24
Vienna,2478,7,6,6,12,26,44,-18,24
FC Salzburg,2479,1,15,6,3,48,18,30,51
SK Sturm Gra,2479,2,11,6,7,29,27,2,39
Rapid Vienna,2479,3,9,10,5,39,24,15,37
LASK Linz,2479,4,8,6,10,25,31,-6,30
SC Rheindorf,2479,5,6,6,12,19,29,-10,24
Mattersburg,2479,6,6,6,12,31,46,-15,24
Vienna,2479,7,6,6,12,24,40,-16,24
FC Salzburg,2480,1,13,9,2,43,19,24,48
SK Sturm Gra,2480,2,13,4,7,33,29,4,43
Rapid Vienna,2480,3,7,10,7,33,30,3,31
LASK Linz,2480,4,8,6,10,28,29,-1,30
SC Rheindorf,2480,5,7,6,11,24,29,-5,27
Vienna,2480,6,7,6,11,29,40,-11,27
Mattersburg,2480,7,5,7,12,30,44,-14,22
FC Salzburg,2481,1,14,7,3,46,20,26,49
SK Sturm Gra,2481,2,13,5,6,32,26,6,44
Rapid Vienna,2481,3,9,9,6,35,28,7,36
LASK Linz,2481,4,7,7,10,26,30,-4,28
Vienna,2481,5,7,6,11,28,39,-11,27
SC Rheindorf,2481,6,5,7,12,18,27,-9,22
Mattersburg,2481,7,5,7,12,28,43,-15,22
FC Salzburg,2482,1,14,6,4,46,23,23,48
SK Sturm Gra,2482,2,13,3,8,35,32,3,42
Rapid Vienna,2482,3,9,10,5,39,29,10,37
LASK Linz,2482,4,8,6,10,28,29,-1,30
Mattersburg,2482,5,7,6,11,33,43,-10,27
SC Rheindorf,2482,6,6,6,12,18,27,-9,24
Vienna,2482,7,6,5,13,27,43,-16,23
FC Salzburg,2483,1,13,7,4,42,19,23,46
SK Sturm Gra,2483,2,14,4,6,35,27,8,46
Rapid Vienna,2483,3,8,11,5,35,27,8,35
LASK Linz,2483,4,8,7,9,27,29,-2,31
Mattersburg,2483,5,7,7,10,33,40,-7,28
Vienna,2483,6,6,6,12,24,40,-16,24
SC Rheindorf,2483,7,4,6,14,16,30,-14,18
FC Salzburg,2484,1,13,8,3,46,20,26,47
SK Sturm Gra,2484,2,12,3,9,34,36,-2,39
Rapid Vienna,2484,3,9,10,5,37,27,10,37
LASK Linz,2484,4,9,5,10,29,30,-1,32
Mattersburg,2484,5,9,5,10,36,38,-2,32
Vienna,2484,6,6,6,12,26,43,-17,24
SC Rheindorf,2484,7,5,5,14,17,31,-14,20
FC Salzburg,2485,1,16,6,2,48,16,32,54
SK Sturm Gra,2485,2,12,3,9,32,30,2,39
Rapid Vienna,2485,3,8,10,6,34,30,4,34
LASK Linz,2485,4,9,6,9,29,28,1,33
SC Rheindorf,2485,5,7,5,12,21,26,-5,26
Mattersburg,2485,6,6,5,13,31,46,-15,23
Vienna,2485,7,6,5,13,24,43,-19,23
FC Salzburg,2486,1,15,7,2,43,16,27,52
SK Sturm Gra,2486,2,11,4,9,31,31,0,37
Rapid Vienna,2486,3,8,11,5,36,28,8,35
LASK Linz,2486,4,10,5,9,30,29,1,35
Vienna,2486,5,7,5,12,28,39,-11,26
SC Rheindorf,2486,6,6,5,13,18,28,-10,23
Mattersburg,2486,7,6,5,13,29,44,-15,23
FC Salzburg,2487,1,12,10,2,40,17,23,46
SK Sturm Gra,2487,2,12,5,7,34,33,1,41
Rapid Vienna,2487,3,7,11,6,34,29,5,32
LASK Linz,2487,4,8,7,9,30,28,2,31
Mattersburg,2487,5,7,7,10,31,39,-8,28
Vienna,2487,6,6,7,11,24,38,-14,25
SC Rheindorf,2487,7,6,5,13,24,33,-9,23
FC Salzburg,2488,1,15,6,3,47,16,31,51
SK Sturm Gra,2488,2,12,5,7,31,27,4,41
Rapid Vienna,2488,3,8,11,5,35,29,6,35
LASK Linz,2488,4,9,6,9,28,28,0,33
SC Rheindorf,2488,5,6,6,12,22,29,-7,24
Mattersburg,2488,6,6,5,13,32,47,-15,23
Vienna,2488,7,6,5,13,24,43,-19,23
FC Salzburg,2489,1,15,6,3,45,19,26,51
SK Sturm Gra,2489,2,12,4,8,34,31,3,40
Rapid Vienna,2489,3,9,11,4,36,23,13,38
LASK Linz,2489,4,7,7,10,25,31,-6,28
Vienna,2489,5,7,5,12,24,39,-15,26
SC Rheindorf,2489,6,6,6,12,20,29,-9,24
Mattersburg,2489,7,5,7,12,28,40,-12,22
FC Salzburg,2490,1,14,7,3,43,18,25,49
SK Sturm Gra,2490,2,13,4,7,32,27,5,43
Rapid Vienna,2490,3,8,10,6,33,26,7,34
LASK Linz,2490,4,9,7,8,27,26,1,34
Mattersburg,2490,5,7,6,11,33,39,-6,27
Vienna,2490,6,7,5,12,25,41,-16,26
SC Rheindorf,2490,7,4,5,15,16,32,-16,17
FC Salzburg,2491,1,15,7,2,44,16,28,52
SK Sturm Gra,2491,2,13,3,8,30,26,4,42
Rapid Vienna,2491,3,8,9,7,35,28,7,33
LASK Linz,2491,4,8,5,11,24,28,-4,29
Mattersburg,2491,5,8,5,11,33,42,-9,29
Vienna,2491,6,6,6,12,26,41,-15,24
SC Rheindorf,2491,7,6,5,13,20,31,-11,23
FC Salzburg,2492,1,15,6,3,50,17,33,51
SK Sturm Gra,2492,2,14,3,7,33,26,7,45
Rapid Vienna,2492,3,8,9,7,35,33,2,33
LASK Linz,2492,4,8,5,11,26,28,-2,29
SC Rheindorf,2492,5,7,5,12,22,30,-8,26
Mattersburg,2492,6,6,6,12,29,45,-16,24
Vienna,2492,7,6,6,12,24,40,-16,24
FC Salzburg,2493,1,16,6,2,49,17,32,54
SK Sturm Gra,2493,2,12,4,8,31,30,1,40
Rapid Vienna,2493,3,9,9,6,37,28,9,36
LASK Linz,2493,4,8,6,10,28,30,-2,30
Mattersburg,2493,5,7,6,11,31,42,-11,27
Vienna,2493,6,6,6,12,28,44,-16,24
SC Rheindorf,2493,7,5,5,14,19,32,-13,20
FC Salzburg,2494,1,13,6,5,44,21,23,45
SK Sturm Gra,2494,2,12,5,7,34,33,1,41
Rapid Vienna,2494,3,9,10,5,40,30,10,37
SC Rheindorf,2494,4,7,6,11,23,28,-5,27
LASK Linz,2494,5,7,6,11,30,36,-6,27
Mattersburg,2494,6,7,6,11,33,41,-8,27
Vienna,2494,7,7,5,12,25,40,-15,26
FC Salzburg,2495,1,14,7,3,47,18,29,49
Rapid Vienna,2495,2,9,10,5,35,26,9,37
SK Sturm Gra,2495,3,11,4,9,31,32,-1,37
LASK Linz,2495,4,8,6,10,29,32,-3,30
Vienna,2495,5,7,6,11,28,39,-11,27
SC Rheindorf,2495,6,7,5,12,23,31,-8,26
Mattersburg,2495,7,6,6,12,30,45,-15,24
FC Salzburg,2496,1,14,8,2,46,17,29,50
SK Sturm Gra,2496,2,12,5,7,36,30,6,41
Rapid Vienna,2496,3,8,11,5,37,28,9,35
LASK Linz,2496,4,9,6,9,30,31,-1,33
Vienna,2496,5,6,6,12,24,42,-18,24
Mattersburg,2496,6,5,8,11,30,42,-12,23
SC Rheindorf,2496,7,4,8,12,18,31,-13,20
FC Salzburg,2497,1,13,6,5,44,21,23,45
SK Sturm Gra,2497,2,13,4,7,33,27,6,43
Rapid Vienna,2497,3,9,10,5,38,28,10,37
LASK Linz,2497,4,9,6,9,29,29,0,33
Vienna,2497,5,7,6,11,26,39,-13,27
Mattersburg,2497,6,6,6,12,30,45,-15,24
SC Rheindorf,2497,7,5,6,13,20,31,-11,21
FC Salzburg,2498,1,16,6,2,51,16,35,54
SK Sturm Gra,2498,2,13,3,8,31,27,4,42
Rapid Vienna,2498,3,8,10,6,35,28,7,34
LASK Linz,2498,4,8,8,8,26,26,0,32
Vienna,2498,5,6,6,12,25,40,-15,24
Mattersburg,2498,6,5,7,12,30,50,-20,22
SC Rheindorf,2498,7,5,6,13,17,28,-11,21
FC Salzburg,2499,1,15,6,3,47,19,28,51
SK Sturm Gra,2499,2,12,3,9,33,33,0,39
LASK Linz,2499,3,10,6,8,32,29,3,36
Rapid Vienna,2499,4,8,10,6,36,30,6,34
Mattersburg,2499,5,7,5,12,32,44,-12,26
Vienna,2499,6,6,5,13,23,40,-17,23
SC Rheindorf,2499,7,5,7,12,20,28,-8,22
FC Salzburg,2500,1,14,7,3,43,18,25,49
SK Sturm Gra,2500,2,14,3,7,33,26,7,45
Rapid Vienna,2500,3,9,10,5,38,29,9,37
LASK Linz,2500,4,9,5,10,31,33,-2,32
Vienna,2500,5,7,6,11,25,38,-13,27
SC Rheindorf,2500,6,5,6,13,21,32,-11,21
Mattersburg,2500,7,5,5,14,29,44,-15,20
FC Salzburg,2501,1,14,8,2,48,17,31,50
SK Sturm Gra,2501,2,13,3,8,32,29,3,42
Rapid Vienna,2501,3,8,11,5,37,28,9,35
LASK Linz,2501,4,7,6,11,28,32,-4,27
Mattersburg,2501,5,7,6,11,29,42,-13,27
SC Rheindorf,2501,6,6,6,12,18,29,-11,24
Vienna,2501,7,6,6,12,24,39,-15,24
FC Salzburg,2502,1,15,7,2,43,16,27,52
SK Sturm Gra,2502,2,12,4,8,33,30,3,40
Rapid Vienna,2502,3,7,11,6,35,29,6,32
LASK Linz,2502,4,9,5,10,28,29,-1,32
Mattersburg,2502,5,7,5,12,30,40,-10,26
Vienna,2502,6,7,5,12,25,38,-13,26
SC Rheindorf,2502,7,6,5,13,19,31,-12,23
FC Salzburg,2503,1,14,6,4,41,18,23,48
Rapid Vienna,2503,2,11,9,4,42,26,16,42
SK Sturm Gra,2503,3,12,3,9,31,33,-2,39
LASK Linz,2503,4,9,5,10,28,30,-2,32
SC Rheindorf,2503,5,6,6,12,23,30,-7,24
Vienna,2503,6,6,6,12,24,40,-16,24
Mattersburg,2503,7,5,7,12,28,40,-12,22
FC Salzburg,2504,1,13,8,3,45,21,24,47
Rapid Vienna,2504,2,10,10,4,43,31,12,40
SK Sturm Gra,2504,3,11,4,9,31,34,-3,37
LASK Linz,2504,4,9,5,10,29,29,0,32
Mattersburg,2504,5,8,5,11,32,37,-5,29
Vienna,2504,6,7,6,11,26,39,-13,27
SC Rheindorf,2504,7,4,6,14,21,36,-15,18
FC Salzburg,2505,1,15,7,2,49,19,30,52
SK Sturm Gra,2505,2,14,4,6,35,27,8,46
Rapid Vienna,2505,3,7,10,7,36,33,3,31
Mattersburg,2505,4,8,5,11,33,41,-8,29
LASK Linz,2505,5,7,7,10,25,29,-4,28
Vienna,2505,6,6,5,13,26,42,-16,23
SC Rheindorf,2505,7,5,6,13,19,32,-13,21
FC Salzburg,2506,1,15,6,3,43,17,26,51
SK Sturm Gra,2506,2,12,6,6,32,27,5,42
Rapid Vienna,2506,3,9,10,5,36,26,10,37
LASK Linz,2506,4,7,7,10,25,29,-4,28
Vienna,2506,5,7,5,12,25,39,-14,26
Mattersburg,2506,6,6,6,12,30,41,-11,24
SC Rheindorf,2506,7,5,6,13,18,30,-12,21
FC Salzburg,2507,1,14,6,4,42,18,24,48
SK Sturm Gra,2507,2,12,4,8,34,29,5,40
Rapid Vienna,2507,3,9,10,5,37,28,9,37
LASK Linz,2507,4,8,6,10,26,30,-4,30
Vienna,2507,5,8,5,11,27,37,-10,29
Mattersburg,2507,6,6,6,12,28,42,-14,24
SC Rheindorf,2507,7,4,9,11,19,29,-10,21
FC Salzburg,2508,1,14,7,3,47,22,25,49
SK Sturm Gra,2508,2,13,4,7,33,28,5,43
Rapid Vienna,2508,3,8,10,6,36,30,6,34
LASK Linz,2508,4,9,5,10,29,29,0,32
Vienna,2508,5,8,5,11,29,40,-11,29
Mattersburg,2508,6,6,5,13,31,43,-12,23
SC Rheindorf,2508,7,5,6,13,17,30,-13,21
FC Salzburg,2509,1,15,7,2,47,18,29,52
SK Sturm Gra,2509,2,12,3,9,36,32,4,39
LASK Linz,2509,3,10,6,8,31,28,3,36
Rapid Vienna,2509,4,8,11,5,40,32,8,35
Mattersburg,2509,5,7,5,12,34,45,-11,26
Vienna,2509,6,6,5,13,27,45,-18,23
SC Rheindorf,2509,7,5,5,14,19,34,-15,20
FC Salzburg,2510,1,13,6,5,39,19,20,45
SK Sturm Gra,2510,2,14,3,7,33,27,6,45
Rapid Vienna,2510,3,9,9,6,35,26,9,36
LASK Linz,2510,4,8,6,10,26,30,-4,30
Mattersburg,2510,5,8,5,11,34,40,-6,29
Vienna,2510,6,7,5,12,25,38,-13,26
SC Rheindorf,2510,7,5,6,13,20,32,-12,21
FC Salzburg,2511,1,15,6,3,47,20,27,51
SK Sturm Gra,2511,2,12,4,8,30,29,1,40
Rapid Vienna,2511,3,7,10,7,34,31,3,31
LASK Linz,2511,4,8,6,10,28,30,-2,30
SC Rheindorf,2511,5,8,5,11,26,27,-1,29
Vienna,2511,6,8,5,11,28,37,-9,29
Mattersburg,2511,7,5,6,13,28,47,-19,21
FC Salzburg,2512,1,15,7,2,48,16,32,52
SK Sturm Gra,2512,2,13,4,7,33,25,8,43
Rapid Vienna,2512,3,9,10,5,39,27,12,37
LASK Linz,2512,4,8,6,10,24,30,-6,30
Vienna,2512,5,6,6,12,25,41,-16,24
SC Rheindorf,2512,6,6,5,13,19,31,-12,23
Mattersburg,2512,7,5,6,13,28,46,-18,21
FC Salzburg,2513,1,15,7,2,49,19,30,52
SK Sturm Gra,2513,2,12,5,7,32,27,5,41
Rapid Vienna,2513,3,8,11,5,39,31,8,35
LASK Linz,2513,4,8,7,9,26,28,-2,31
Mattersburg,2513,5,7,6,11,31,43,-12,27
Vienna,2513,6,6,6,12,25,40,-15,24
SC Rheindorf,2513,7,4,6,14,18,32,-14,18
FC Salzburg,2514,1,13,7,4,43,22,21,46
Rapid Vienna,2514,2,10,10,4,38,24,14,40
SK Sturm Gra,2514,3,12,4,8,31,28,3,40
LASK Linz,2514,4,7,7,10,24,30,-6,28
Mattersburg,2514,5,7,7,10,31,38,-7,28
SC Rheindorf,2514,6,5,8,11,17,25,-8,23
Vienna,2514,7,6,5,13,25,42,-17,23
FC Salzburg,2515,1,14,7,3,47,21,26,49
SK Sturm Gra,2515,2,12,4,8,31,30,1,40
LASK Linz,2515,3,11,5,8,29,25,4,38
Rapid Vienna,2515,4,8,10,6,35,28,7,34
Vienna,2515,5,7,5,12,26,39,-13,26
Mattersburg,2515,6,6,5,13,30,43,-13,23
SC Rheindorf,2515,7,5,6,13,16,28,-12,21
FC Salzburg,2516,1,14,6,4,46,21,25,48
Rapid Vienna,2516,2,10,10,4,40,26,14,40
SK Sturm Gra,2516,3,11,4,9,30,32,-2,37
LASK Linz,2516,4,9,7,8,26,25,1,34
Mattersburg,2516,5,7,6,11,30,38,-8,27
Vienna,2516,6,6,5,13,26,44,-18,23
SC Rheindorf,2516,7,5,6,13,19,31,-12,21
FC Salzburg,2517,1,15,6,3,52,21,31,51
SK Sturm Gra,2517,2,13,4,7,33,26,7,43
Rapid Vienna,2517,3,9,9,6,37,29,8,36
LASK Linz,2517,4,8,7,9,28,30,-2,31
Mattersburg,2517,5,7,6,11,33,47,-14,27
Vienna,2517,6,6,5,13,25,43,-18,23
SC Rheindorf,2517,7,4,7,13,19,31,-12,19
FC Salzburg,2518,1,13,6,5,42,21,21,45
SK Sturm Gra,2518,2,14,3,7,36,28,8,45
Rapid Vienna,2518,3,7,10,7,32,28,4,31
LASK Linz,2518,4,8,6,10,27,32,-5,30
Mattersburg,2518,5,8,5,11,33,39,-6,29
SC Rheindorf,2518,6,7,5,12,21,28,-7,26
Vienna,2518,7,7,5,12,24,39,-15,26
FC Salzburg,2519,1,14,7,3,46,18,28,49
SK Sturm Gra,2519,2,13,4,7,35,31,4,43
Rapid Vienna,2519,3,9,9,6,39,29,10,36
LASK Linz,2519,4,7,8,9,28,32,-4,29
Vienna,2519,5,7,6,11,26,39,-13,27
SC Rheindorf,2519,6,6,6,12,20,27,-7,24
Mattersburg,2519,7,5,6,13,31,49,-18,21
FC Salzburg,2520,1,14,6,4,45,21,24,48
SK Sturm Gra,2520,2,14,4,6,36,27,9,46
Rapid Vienna,2520,3,9,10,5,35,27,8,37
LASK Linz,2520,4,7,6,11,26,33,-7,27
Vienna,2520,5,7,5,12,29,42,-13,26
Mattersburg,2520,6,6,6,12,35,46,-11,24
SC Rheindorf,2520,7,5,7,12,20,30,-10,22
FC Salzburg,2521,1,16,6,2,46,17,29,54
SK Sturm Gra,2521,2,12,3,9,30,31,-1,39
Rapid Vienna,2521,3,9,9,6,35,27,8,36
LASK Linz,2521,4,8,6,10,25,28,-3,30
Mattersburg,2521,5,7,5,12,32,43,-11,26
Vienna,2521,6,7,5,12,28,40,-12,26
SC Rheindorf,2521,7,5,6,13,18,28,-10,21
FC Salzburg,2522,1,14,7,3,43,18,25,49
SK Sturm Gra,2522,2,12,4,8,35,30,5,40
Rapid Vienna,2522,3,9,10,5,35,29,6,37
LASK Linz,2522,4,7,7,10,26,31,-5,28
Mattersburg,2522,5,6,8,10,30,38,-8,26
SC Rheindorf,2522,6,6,6,12,20,26,-6,24
Vienna,2522,7,6,6,12,24,41,-17,24
FC Salzburg,2523,1,15,7,2,46,18,28,52
SK Sturm Gra,2523,2,13,4,7,33,28,5,43
Rapid Vienna,2523,3,7,12,5,37,31,6,33
LASK Linz,2523,4,9,6,9,33,29,4,33
Vienna,2523,5,6,6,12,25,42,-17,24
Mattersburg,2523,6,5,7,12,29,44,-15,22
SC Rheindorf,2523,7,4,8,12,18,29,-11,20
FC Salzburg,2524,1,15,7,2,44,17,27,52
SK Sturm Gra,2524,2,11,5,8,30,28,2,38
Rapid Vienna,2524,3,9,10,5,37,28,9,37
LASK Linz,2524,4,8,6,10,29,30,-1,30
Vienna,2524,5,7,6,11,26,39,-13,27
SC Rheindorf,2524,6,5,8,11,20,29,-9,23
Mattersburg,2524,7,5,6,13,30,45,-15,21
FC Salzburg,2525,1,13,7,4,45,21,24,46
SK Sturm Gra,2525,2,12,5,7,33,29,4,41
Rapid Vienna,2525,3,10,10,4,40,28,12,40
LASK Linz,2525,4,9,5,10,28,31,-3,32
Vienna,2525,5,7,6,11,27,40,-13,27
Mattersburg,2525,6,6,6,12,32,44,-12,24
SC Rheindorf,2525,7,4,7,13,18,30,-12,19
FC Salzburg,2526,1,14,8,2,43,18,25,50
SK Sturm Gra,2526,2,12,5,7,33,27,6,41
Rapid Vienna,2526,3,9,10,5,38,27,11,37
LASK Linz,2526,4,8,7,9,30,32,-2,31
Vienna,2526,5,7,5,12,25,39,-14,26
SC Rheindorf,2526,6,6,6,12,23,33,-10,24
Mattersburg,2526,7,5,5,14,33,49,-16,20
FC Salzburg,2527,1,13,8,3,40,17,23,47
SK Sturm Gra,2527,2,13,5,6,35,25,10,44
Rapid Vienna,2527,3,9,10,5,37,27,10,37
LASK Linz,2527,4,7,7,10,27,33,-6,28
Vienna,2527,5,7,5,12,28,40,-12,26
Mattersburg,2527,6,6,6,12,29,43,-14,24
SC Rheindorf,2527,7,5,7,12,19,30,-11,22
FC Salzburg,2528,1,13,9,2,43,18,25,48
SK Sturm Gra,2528,2,13,3,8,32,28,4,42
Rapid Vienna,2528,3,8,10,6,35,27,8,34
Mattersburg,2528,4,7,7,10,33,39,-6,28
SC Rheindorf,2528,5,7,6,11,23,30,-7,27
LASK Linz,2528,6,7,5,12,26,33,-7,26
Vienna,2528,7,6,6,12,24,41,-17,24
FC Salzburg,2529,1,13,8,3,45,19,26,47
SK Sturm Gra,2529,2,13,4,7,34,27,7,43
Rapid Vienna,2529,3,9,10,5,36,29,7,37
LASK Linz,2529,4,8,7,9,25,27,-2,31
Vienna,2529,5,6,7,11,25,39,-14,25
SC Rheindorf,2529,6,6,6,12,20,27,-7,24
Mattersburg,2529,7,5,6,13,28,45,-17,21
FC Salzburg,2530,1,15,6,3,50,20,30,51
SK Sturm Gra,2530,2,13,4,7,38,32,6,43
Rapid Vienna,2530,3,9,9,6,38,31,7,36
LASK Linz,2530,4,9,6,9,30,25,5,33
Mattersburg,2530,5,6,6,12,29,45,-16,24
Vienna,2530,6,6,5,13,25,44,-19,23
SC Rheindorf,2530,7,5,6,13,20,33,-13,21
FC Salzburg,2531,1,16,6,2,51,18,33,54
SK Sturm Gra,2531,2,13,3,8,34,30,4,42
Rapid Vienna,2531,3,8,10,6,34,28,6,34
LASK Linz,2531,4,7,6,11,24,29,-5,27
SC Rheindorf,2531,5,7,5,12,22,30,-8,26
Mattersburg,2531,6,7,5,12,31,42,-11,26
Vienna,2531,7,6,5,13,26,45,-19,23
FC Salzburg,2532,1,15,6,3,44,22,22,51
SK Sturm Gra,2532,2,12,4,8,30,28,2,40
Rapid Vienna,2532,3,8,10,6,32,25,7,34
LASK Linz,2532,4,7,8,9,24,27,-3,29
Vienna,2532,5,8,5,11,30,37,-7,29
SC Rheindorf,2532,6,7,5,12,21,26,-5,26
Mattersburg,2532,7,5,6,13,27,43,-16,21
FC Salzburg,2533,1,16,6,2,50,18,32,54
SK Sturm Gra,2533,2,13,4,7,32,29,3,43
Rapid Vienna,2533,3,8,10,6,38,30,8,34
LASK Linz,2533,4,8,5,11,28,35,-7,29
Mattersburg,2533,5,7,6,11,33,41,-8,27
Vienna,2533,6,6,5,13,23,41,-18,23
SC Rheindorf,2533,7,5,6,13,21,31,-10,21
FC Salzburg,2534,1,15,7,2,48,17,31,52
SK Sturm Gra,2534,2,13,4,7,34,28,6,43
Rapid Vienna,2534,3,8,9,7,35,30,5,33
Mattersburg,2534,4,7,7,10,36,38,-2,28
LASK Linz,2534,5,7,5,12,24,33,-9,26
SC Rheindorf,2534,6,6,7,11,18,26,-8,25
Vienna,2534,7,6,5,13,23,46,-23,23
FC Salzburg,2535,1,13,8,3,43,18,25,47
SK Sturm Gra,2535,2,13,3,8,32,30,2,42
Rapid Vienna,2535,3,8,9,7,33,29,4,33
LASK Linz,2535,4,8,6,10,27,28,-1,30
Vienna,2535,5,7,6,11,27,40,-13,27
SC Rheindorf,2535,6,7,5,12,20,29,-9,26
Mattersburg,2535,7,6,7,11,31,39,-8,25
FC Salzburg,2536,1,13,8,3,44,21,23,47
SK Sturm Gra,2536,2,11,5,8,29,29,0,38
Rapid Vienna,2536,3,9,10,5,38,28,10,37
LASK Linz,2536,4,8,8,8,31,30,1,32
Vienna,2536,5,6,7,11,29,43,-14,25
SC Rheindorf,2536,6,5,8,11,19,27,-8,23
Mattersburg,2536,7,5,8,11,32,44,-12,23
FC Salzburg,2537,1,13,7,4,42,18,24,46
SK Sturm Gra,2537,2,13,4,7,32,28,4,43
Rapid Vienna,2537,3,10,9,5,35,24,11,39
LASK Linz,2537,4,8,6,10,27,29,-2,30
Vienna,2537,5,7,6,11,26,38,-12,27
SC Rheindorf,2537,6,6,6,12,20,29,-9,24
Mattersburg,2537,7,5,6,13,26,42,-16,21
FC Salzburg,2538,1,15,6,3,44,20,24,51
SK Sturm Gra,2538,2,13,3,8,34,28,6,42
Rapid Vienna,2538,3,10,9,5,40,26,14,39
LASK Linz,2538,4,7,5,12,26,33,-7,26
Mattersburg,2538,5,6,7,11,31,41,-10,25
SC Rheindorf,2538,6,6,6,12,18,30,-12,24
Vienna,2538,7,6,6,12,25,40,-15,24
FC Salzburg,2539,1,14,7,3,44,19,25,49
SK Sturm Gra,2539,2,13,3,8,32,28,4,42
Rapid Vienna,2539,3,9,10,5,37,29,8,37
LASK Linz,2539,4,8,5,11,27,32,-5,29
Mattersburg,2539,5,7,5,12,33,42,-9,26
Vienna,2539,6,7,5,12,27,42,-15,26
SC Rheindorf,2539,7,6,5,13,20,28,-8,23
FC Salzburg,2540,1,13,8,3,40,17,23,47
SK Sturm Gra,2540,2,11,6,7,30,27,3,39
Rapid Vienna,2540,3,7,12,5,33,26,7,33
LASK Linz,2540,4,9,6,9,27,27,0,33
Vienna,2540,5,7,6,11,26,39,-13,27
Mattersburg,2540,6,6,7,11,28,39,-11,25
SC Rheindorf,2540,7,5,7,12,18,27,-9,22
FC Salzburg,2541,1,13,8,3,43,20,23,47
SK Sturm Gra,2541,2,13,3,8,34,31,3,42
LASK Linz,2541,3,10,5,9,29,28,1,35
Rapid Vienna,2541,4,8,10,6,33,26,7,34
Vienna,2541,5,8,5,11,26,38,-12,29
SC Rheindorf,2541,6,6,5,13,23,30,-7,23
Mattersburg,2541,7,5,6,13,29,44,-15,21
FC Salzburg,2542,1,13,7,4,44,19,25,46
SK Sturm Gra,2542,2,12,6,6,35,30,5,42
Rapid Vienna,2542,3,9,10,5,34,26,8,37
LASK Linz,2542,4,9,5,10,32,32,0,32
Vienna,2542,5,8,5,11,28,38,-10,29
SC Rheindorf,2542,6,5,7,12,20,29,-9,22
Mattersburg,2542,7,5,6,13,28,47,-19,21
FC Salzburg,2543,1,15,7,2,46,18,28,52
SK Sturm Gra,2543,2,12,3,9,35,34,1,39
Rapid Vienna,2543,3,9,9,6,35,28,7,36
LASK Linz,2543,4,8,7,9,29,29,0,31
Vienna,2543,5,7,5,12,25,40,-15,26
Mattersburg,2543,6,6,7,11,30,40,-10,25
SC Rheindorf,2543,7,5,6,13,19,30,-11,21
FC Salzburg,2544,1,14,8,2,46,17,29,50
SK Sturm Gra,2544,2,14,3,7,35,28,7,45
Rapid Vienna,2544,3,8,11,5,35,28,7,35
LASK Linz,2544,4,7,6,11,25,37,-12,27
Mattersburg,2544,5,6,7,11,33,41,-8,25
Vienna,2544,6,6,7,11,25,39,-14,25
SC Rheindorf,2544,7,5,6,13,20,29,-9,21
FC Salzburg,2545,1,16,6,2,47,16,31,54
SK Sturm Gra,2545,2,12,5,7,32,30,2,41
LASK Linz,2545,3,9,6,9,30,31,-1,33
Rapid Vienna,2545,4,7,11,6,32,28,4,32
Mattersburg,2545,5,7,6,11,36,40,-4,27
Vienna,2545,6,6,5,13,25,43,-18,23
SC Rheindorf,2545,7,4,7,13,21,35,-14,19
FC Salzburg,2546,1,13,8,3,43,17,26,47
SK Sturm Gra,2546,2,13,5,6,33,26,7,44
Rapid Vienna,2546,3,8,11,5,35,26,9,35
LASK Linz,2546,4,8,6,10,25,27,-2,30
Vienna,2546,5,7,6,11,28,38,-10,27
SC Rheindorf,2546,6,6,5,13,18,29,-11,23
Mattersburg,2546,7,6,5,13,28,47,-19,23
FC Salzburg,2547,1,14,6,4,45,20,25,48
SK Sturm Gra,2547,2,13,4,7,36,28,8,43
Rapid Vienna,2547,3,9,10,5,34,27,7,37
LASK Linz,2547,4,7,9,8,28,29,-1,30
Mattersburg,2547,5,7,6,11,34,42,-8,27
Vienna,2547,6,7,5,12,25,41,-16,26
SC Rheindorf,2547,7,4,6,14,17,32,-15,18
FC Salzburg,2548,1,16,6,2,53,18,35,54
SK Sturm Gra,2548,2,13,3,8,36,29,7,42
Rapid Vienna,2548,3,8,9,7,35,34,1,33
LASK Linz,2548,4,8,6,10,29,30,-1,30
Mattersburg,2548,5,7,6,11,36,43,-7,27
Vienna,2548,6,6,5,13,25,47,-22,23
SC Rheindorf,2548,7,5,7,12,18,31,-13,22
FC Salzburg,2549,1,13,7,4,46,23,23,46
SK Sturm Gra,2549,2,12,4,8,31,29,2,40
Rapid Vienna,2549,3,10,9,5,37,25,12,39
LASK Linz,2549,4,8,6,10,26,29,-3,30
Mattersburg,2549,5,7,6,11,34,45,-11,27
Vienna,2549,6,7,6,11,29,40,-11,27
SC Rheindorf,2549,7,5,6,13,19,31,-12,21
FC Salzburg,2550,1,14,7,3,42,16,26,49
SK Sturm Gra,2550,2,13,4,7,33,27,6,43
Rapid Vienna,2550,3,10,9,5,38,27,11,39
LASK Linz,2550,4,8,6,10,28,31,-3,30
Mattersburg,2550,5,8,5,11,36,40,-4,29
Vienna,2550,6,6,5,13,23,44,-21,23
SC Rheindorf,2550,7,4,6,14,22,37,-15,18
FC Salzburg,2551,1,16,6,2,50,17,33,54
Rapid Vienna,2551,2,10,9,5,39,28,11,39
SK Sturm Gra,2551,3,12,3,9,31,32,-1,39
LASK Linz,2551,4,7,6,11,24,29,-5,27
Mattersburg,2551,5,7,5,12,30,42,-12,26
Vienna,2551,6,7,5,12,26,40,-14,26
SC Rheindorf,2551,7,5,6,13,18,30,-12,21
FC Salzburg,2552,1,15,7,2,45,18,27,52
SK Sturm Gra,2552,2,13,4,7,37,31,6,43
Rapid Vienna,2552,3,8,11,5,41,31,10,35
LASK Linz,2552,4,8,7,9,27,29,-2,31
Vienna,2552,5,7,5,12,27,40,-13,26
SC Rheindorf,2552,6,5,7,12,21,33,-12,22
Mattersburg,2552,7,5,5,14,30,46,-16,20
FC Salzburg,2553,1,13,7,4,42,20,22,46
SK Sturm Gra,2553,2,13,3,8,34,30,4,42
Rapid Vienna,2553,3,8,12,4,34,25,9,36
Vienna,2553,4,8,5,11,27,39,-12,29
LASK Linz,2553,5,7,7,10,28,32,-4,28
Mattersburg,2553,6,6,6,12,33,44,-11,24
SC Rheindorf,2553,7,5,8,11,22,30,-8,23
FC Salzburg,2554,1,16,6,2,47,16,31,54
SK Sturm Gra,2554,2,12,4,8,31,29,2,40
Rapid Vienna,2554,3,8,10,6,32,26,6,34
LASK Linz,2554,4,8,6,10,30,31,-1,30
Vienna,2554,5,7,5,12,26,38,-12,26
SC Rheindorf,2554,6,6,6,12,19,28,-9,24
Mattersburg,2554,7,6,5,13,29,46,-17,23
FC Salzburg,2555,1,14,6,4,44,20,24,48
Rapid Vienna,2555,2,10,9,5,38,26,12,39
SK Sturm Gra,2555,3,11,5,8,30,31,-1,38
LASK Linz,2555,4,8,7,9,24,25,-1,31
Vienna,2555,5,8,5,11,29,37,-8,29
Mattersburg,2555,6,6,6,12,30,43,-13,24
SC Rheindorf,2555,7,5,6,13,17,30,-13,21
FC Salzburg,2556,1,14,7,3,45,19,26,49
SK Sturm Gra,2556,2,12,5,7,31,29,2,41
Rapid Vienna,2556,3,10,10,4,39,24,15,40
LASK Linz,2556,4,7,7,10,27,31,-4,28
Vienna,2556,5,7,6,11,25,38,-13,27
Mattersburg,2556,6,7,5,12,32,42,-10,26
SC Rheindorf,2556,7,4,6,14,16,32,-16,18
FC Salzburg,2557,1,15,7,2,47,15,32,52
SK Sturm Gra,2557,2,12,5,7,31,28,3,41
Rapid Vienna,2557,3,8,11,5,33,26,7,35
LASK Linz,2557,4,9,6,9,30,27,3,33
Vienna,2557,5,7,5,12,28,41,-13,26
Mattersburg,2557,6,6,5,13,29,46,-17,23
SC Rheindorf,2557,7,5,5,14,18,33,-15,20
FC Salzburg,2558,1,13,9,2,47,23,24,48
SK Sturm Gra,2558,2,12,4,8,34,31,3,40
LASK Linz,2558,3,10,6,8,30,27,3,36
Rapid Vienna,2558,4,7,11,6,36,31,5,32
Vienna,2558,5,7,6,11,29,40,-11,27
SC Rheindorf,2558,6,5,8,11,21,30,-9,23
Mattersburg,2558,7,5,6,13,32,47,-15,21
FC Salzburg,2559,1,16,6,2,54,18,36,54
SK Sturm Gra,2559,2,12,3,9,33,38,-5,39
LASK Linz,2559,3,10,5,9,30,27,3,35
Rapid Vienna,2559,4,8,9,7,36,32,4,33
Mattersburg,2559,5,7,6,11,32,42,-10,27
Vienna,2559,6,6,6,12,25,41,-16,24
SC Rheindorf,2559,7,5,5,14,21,33,-12,20
FC Salzburg,2560,1,15,7,2,44,16,28,52
SK Sturm Gra,2560,2,12,3,9,31,29,2,39
LASK Linz,2560,3,10,6,8,28,25,3,36
Rapid Vienna,2560,4,8,9,7,36,31,5,33
Mattersburg,2560,5,6,6,12,30,42,-12,24
Vienna,2560,6,6,6,12,24,40,-16,24
SC Rheindorf,2560,7,5,7,12,21,31,-10,22
FC Salzburg,2561,1,15,6,3,47,21,26,51
SK Sturm Gra,2561,2,12,3,9,30,32,-2,39
LASK Linz,2561,3,10,5,9,30,31,-1,35
Rapid Vienna,2561,4,8,9,7,37,29,8,33
Mattersburg,2561,5,8,6,10,37,40,-3,30
Vienna,2561,6,6,6,12,26,41,-15,24
SC Rheindorf,2561,7,5,5,14,16,29,-13,20
FC Salzburg,2562,1,15,7,2,45,15,30,52
SK Sturm Gra,2562,2,12,5,7,31,27,4,41
Rapid Vienna,2562,3,8,10,6,36,32,4,34
LASK Linz,2562,4,9,7,8,32,28,4,34
Vienna,2562,5,6,6,12,24,39,-15,24
Mattersburg,2562,6,5,8,11,29,40,-11,23
SC Rheindorf,2562,7,5,5,14,20,36,-16,20
FC Salzburg,2563,1,16,6,2,52,17,35,54
SK Sturm Gra,2563,2,12,4,8,30,28,2,40
Rapid Vienna,2563,3,8,10,6,35,29,6,34
LASK Linz,2563,4,9,5,10,26,28,-2,32
Mattersburg,2563,5,7,6,11,32,43,-11,27
Vienna,2563,6,6,6,12,25,42,-17,24
SC Rheindorf,2563,7,5,5,14,17,30,-13,20
FC Salzburg,2564,1,13,8,3,43,20,23,47
SK Sturm Gra,2564,2,13,3,8,32,28,4,42
Rapid Vienna,2564,3,9,9,6,33,25,8,36
LASK Linz,2564,4,10,6,8,31,26,5,36
Mattersburg,2564,5,7,6,11,35,44,-9,27
Vienna,2564,6,6,6,12,26,43,-17,24
SC Rheindorf,2564,7,4,6,14,16,30,-14,18
FC Salzburg,2565,1,12,9,3,42,23,19,45
SK Sturm Gra,2565,2,12,5,7,32,27,5,41
Rapid Vienna,2565,3,9,9,6,36,25,11,36
LASK Linz,2565,4,9,6,9,28,29,-1,33
Mattersburg,2565,5,6,7,11,30,40,-10,25
Vienna,2565,6,6,7,11,25,39,-14,25
SC Rheindorf,2565,7,5,7,12,18,28,-10,22
FC Salzburg,2566,1,14,6,4,44,22,22,48
SK Sturm Gra,2566,2,14,3,7,38,28,10,45
Rapid Vienna,2566,3,8,9,7,36,34,2,33
LASK Linz,2566,4,9,6,9,30,28,2,33
Vienna,2566,5,7,5,12,26,41,-15,26
Mattersburg,2566,6,6,6,12,30,41,-11,24
SC Rheindorf,2566,7,6,5,13,20,30,-10,23
FC Salzburg,2567,1,13,8,3,43,20,23,47
SK Sturm Gra,2567,2,13,5,6,36,26,10,44
Rapid Vienna,2567,3,8,11,5,34,26,8,35
LASK Linz,2567,4,9,5,10,30,31,-1,32
Mattersburg,2567,5,7,6,11,37,43,-6,27
Vienna,2567,6,7,5,12,28,41,-13,26
SC Rheindorf,2567,7,4,6,14,17,38,-21,18
FC Salzburg,2568,1,14,7,3,44,17,27,49
SK Sturm Gra,2568,2,12,5,7,34,32,2,41
Rapid Vienna,2568,3,7,9,8,35,31,4,30
LASK Linz,2568,4,8,6,10,26,29,-3,30
Vienna,2568,5,8,5,11,28,40,-12,29
SC Rheindorf,2568,6,7,5,12,26,34,-8,26
Mattersburg,2568,7,7,5,12,35,45,-10,26
FC Salzburg,2569,1,13,9,2,43,19,24,48
SK Sturm Gra,2569,2,12,3,9,31,30,1,39
Rapid Vienna,2569,3,8,11,5,37,29,8,35
LASK Linz,2569,4,10,5,9,30,29,1,35
Mattersburg,2569,5,8,6,10,34,38,-4,30
Vienna,2569,6,6,6,12,23,38,-15,24
SC Rheindorf,2569,7,4,6,14,16,31,-15,18
FC Salzburg,2570,1,14,7,3,46,20,26,49
SK Sturm Gra,2570,2,11,5,8,31,30,1,38
Rapid Vienna,2570,3,9,10,5,36,27,9,37
LASK Linz,2570,4,8,7,9,26,27,-1,31
Mattersburg,2570,5,8,5,11,35,40,-5,29
Vienna,2570,6,7,6,11,26,39,-13,27
SC Rheindorf,2570,7,4,6,14,17,34,-17,18
FC Salzburg,2571,1,14,7,3,45,20,25,49
Rapid Vienna,2571,2,9,10,5,35,27,8,37
SK Sturm Gra,2571,3,11,4,9,30,31,-1,37
LASK Linz,2571,4,8,7,9,27,28,-1,31
Mattersburg,2571,5,7,6,11,32,41,-9,27
SC Rheindorf,2571,6,6,6,12,21,28,-7,24
Vienna,2571,7,6,6,12,26,41,-15,24
FC Salzburg,2572,1,15,6,3,46,19,27,51
SK Sturm Gra,2572,2,12,4,8,30,32,-2,40
Rapid Vienna,2572,3,8,10,6,36,27,9,34
LASK Linz,2572,4,9,6,9,30,28,2,33
SC Rheindorf,2572,5,7,6,11,23,27,-4,27
Vienna,2572,6,7,5,12,27,41,-14,26
Mattersburg,2572,7,5,5,14,30,48,-18,20
FC Salzburg,2573,1,14,7,3,46,21,25,49
SK Sturm Gra,2573,2,13,4,7,33,29,4,43
Rapid Vienna,2573,3,8,10,6,36,29,7,34
LASK Linz,2573,4,8,6,10,28,32,-4,30
SC Rheindorf,2573,5,7,5,12,22,27,-5,26
Mattersburg,2573,6,6,6,12,35,46,-11,24
Vienna,2573,7,6,6,12,28,44,-16,24
FC Salzburg,2574,1,14,7,3,44,17,27,49
SK Sturm Gra,2574,2,11,5,8,32,33,-1,38
Rapid Vienna,2574,3,8,11,5,36,29,7,35
LASK Linz,2574,4,8,7,9,26,28,-2,31
Vienna,2574,5,8,5,11,26,37,-11,29
SC Rheindorf,2574,6,6,6,12,20,29,-9,24
Mattersburg,2574,7,6,5,13,30,41,-11,23
FC Salzburg,2575,1,14,7,3,50,18,32,49
SK Sturm Gra,2575,2,12,4,8,32,29,3,40
Rapid Vienna,2575,3,9,9,6,37,29,8,36
LASK Linz,2575,4,9,5,10,26,28,-2,32
SC Rheindorf,2575,5,7,5,12,21,27,-6,26
Vienna,2575,6,6,6,12,25,42,-17,24
Mattersburg,2575,7,6,6,12,30,48,-18,24
FC Salzburg,2576,1,14,6,4,44,21,23,48
Rapid Vienna,2576,2,10,10,4,38,25,13,40
SK Sturm Gra,2576,3,11,6,7,29,27,2,39
LASK Linz,2576,4,9,6,9,29,29,0,33
Vienna,2576,5,7,5,12,25,39,-14,26
Mattersburg,2576,6,6,5,13,28,41,-13,23
SC Rheindorf,2576,7,5,6,13,19,30,-11,21
FC Salzburg,2577,1,14,8,2,46,17,29,50
SK Sturm Gra,2577,2,12,4,8,32,30,2,40
Rapid Vienna,2577,3,8,11,5,38,29,9,35
LASK Linz,2577,4,9,6,9,30,30,0,33
Mattersburg,2577,5,7,7,10,30,37,-7,28
Vienna,2577,6,6,5,13,25,45,-20,23
SC Rheindorf,2577,7,4,7,13,17,30,-13,19
FC Salzburg,2578,1,15,6,3,51,18,33,51
SK Sturm Gra,2578,2,13,3,8,32,30,2,42
Rapid Vienna,2578,3,8,11,5,36,30,6,35
LASK Linz,2578,4,7,6,11,25,30,-5,27
Mattersburg,2578,5,7,6,11,29,42,-13,27
SC Rheindorf,2578,6,6,7,11,21,27,-6,25
Vienna,2578,7,6,5,13,24,41,-17,23
FC Salzburg,2579,1,15,7,2,48,19,29,52
SK Sturm Gra,2579,2,13,3,8,34,30,4,42
Rapid Vienna,2579,3,8,9,7,38,31,7,33
LASK Linz,2579,4,8,6,10,28,32,-4,30
Mattersburg,2579,5,7,7,10,32,39,-7,28
Vienna,2579,6,6,6,12,26,42,-16,24
SC Rheindorf,2579,7,5,6,13,19,32,-13,21
FC Salzburg,2580,1,16,6,2,54,19,35,54
SK Sturm Gra,2580,2,12,3,9,30,30,0,39
Rapid Vienna,2580,3,8,10,6,36,32,4,34
LASK Linz,2580,4,8,7,9,27,29,-2,31
Vienna,2580,5,7,5,12,28,41,-13,26
SC Rheindorf,2580,6,6,6,12,18,28,-10,24
Mattersburg,2580,7,6,5,13,31,45,-14,23
FC Salzburg,2581,1,14,7,3,44,19,25,49
SK Sturm Gra,2581,2,12,4,8,31,28,3,40
Rapid Vienna,2581,3,8,12,4,36,27,9,36
LASK Linz,2581,4,9,5,10,31,30,1,32
Vienna,2581,5,8,5,11,28,39,-11,29
SC Rheindorf,2581,6,5,7,12,21,32,-11,22
Mattersburg,2581,7,5,6,13,30,46,-16,21
FC Salzburg,2582,1,15,7,2,48,20,28,52
SK Sturm Gra,2582,2,13,4,7,34,27,7,43
Rapid Vienna,2582,3,9,10,5,38,29,9,37
LASK Linz,2582,4,7,6,11,27,36,-9,27
Vienna,2582,5,7,5,12,28,40,-12,26
Mattersburg,2582,6,6,6,12,33,46,-13,24
SC Rheindorf,2582,7,5,6,13,18,28,-10,21
FC Salzburg,2583,1,16,6,2,46,18,28,54
Rapid Vienna,2583,2,10,9,5,37,25,12,39
SK Sturm Gra,2583,3,12,3,9,31,30,1,39
LASK Linz,2583,4,9,5,10,27,30,-3,32
Vienna,2583,5,7,5,12,26,40,-14,26
Mattersburg,2583,6,6,6,12,31,41,-10,24
SC Rheindorf,2583,7,4,6,14,20,34,-14,18
FC Salzburg,2584,1,13,8,3,43,19,24,47
SK Sturm Gra,2584,2,12,4,8,34,30,4,40
Rapid Vienna,2584,3,9,9,6,35,29,6,36
LASK Linz,2584,4,8,5,11,29,33,-4,29
Mattersburg,2584,5,7,6,11,32,40,-8,27
Vienna,2584,6,7,6,11,27,40,-13,27
SC Rheindorf,2584,7,6,6,12,22,31,-9,24
FC Salzburg,2585,1,15,7,2,48,19,29,52
Rapid Vienna,2585,2,9,11,4,37,27,10,38
SK Sturm Gra,2585,3,11,4,9,30,30,0,37
LASK Linz,2585,4,9,6,9,29,30,-1,33
Vienna,2585,5,7,5,12,27,41,-14,26
SC Rheindorf,2585,6,6,6,12,20,27,-7,24
Mattersburg,2585,7,5,5,14,29,46,-17,20
FC Salzburg,2586,1,15,6,3,47,21,26,51
Rapid Vienna,2586,2,10,9,5,35,24,11,39
SK Sturm Gra,2586,3,12,3,9,32,31,1,39
Vienna,2586,4,8,5,11,31,42,-11,29
LASK Linz,2586,5,7,7,10,28,31,-3,28
SC Rheindorf,2586,6,5,7,12,20,30,-10,22
Mattersburg,2586,7,5,7,12,31,45,-14,22
FC Salzburg,2587,1,14,8,2,45,17,28,50
SK Sturm Gra,2587,2,14,4,6,33,26,7,46
Rapid Vienna,2587,3,8,10,6,36,30,6,34
Mattersburg,2587,4,8,5,11,36,38,-2,29
LASK Linz,2587,5,7,6,11,25,29,-4,27
Vienna,2587,6,6,6,12,24,40,-16,24
SC Rheindorf,2587,7,5,5,14,16,35,-19,20
FC Salzburg,2588,1,14,7,3,47,20,27,49
SK Sturm Gra,2588,2,12,4,8,32,31,1,40
Rapid Vienna,2588,3,9,11,4,38,28,10,38
Mattersburg,2588,4,8,5,11,38,42,-4,29
LASK Linz,2588,5,7,5,12,25,33,-8,26
SC Rheindorf,2588,6,6,6,12,20,30,-10,24
Vienna,2588,7,6,6,12,27,43,-16,24
FC Salzburg,2589,1,13,9,2,42,17,25,48
SK Sturm Gra,2589,2,12,3,9,29,28,1,39
LASK Linz,2589,3,9,6,9,29,28,1,33
Rapid Vienna,2589,4,7,11,6,32,27,5,32
Mattersburg,2589,5,7,7,10,32,40,-8,28
Vienna,2589,6,6,7,11,26,40,-14,25
SC Rheindorf,2589,7,5,7,12,21,31,-10,22
FC Salzburg,2590,1,16,6,2,51,19,32,54
SK Sturm Gra,2590,2,13,4,7,33,31,2,43
Rapid Vienna,2590,3,8,10,6,35,27,8,34
LASK Linz,2590,4,7,6,11,23,29,-6,27
Mattersburg,2590,5,6,7,11,28,39,-11,25
SC Rheindorf,2590,6,5,8,11,21,29,-8,23
Vienna,2590,7,6,5,13,25,42,-17,23
FC Salzburg,2591,1,15,7,2,45,15,30,52
SK Sturm Gra,2591,2,14,4,6,38,28,10,46
LASK Linz,2591,3,9,6,9,28,29,-1,33
Rapid Vienna,2591,4,7,11,6,36,33,3,32
Mattersburg,2591,5,6,6,12,32,44,-12,24
Vienna,2591,6,6,5,13,23,41,-18,23
SC Rheindorf,2591,7,4,7,13,21,33,-12,19
FC Salzburg,2592,1,14,6,4,43,20,23,48
SK Sturm Gra,2592,2,12,3,9,31,28,3,39
Rapid Vienna,2592,3,9,9,6,35,28,7,36
LASK Linz,2592,4,9,5,10,27,30,-3,32
Vienna,2592,5,7,6,11,26,39,-13,27
SC Rheindorf,2592,6,7,5,12,23,28,-5,26
Mattersburg,2592,7,6,6,12,29,41,-12,24
FC Salzburg,2593,1,14,8,2,46,20,26,50
SK Sturm Gra,2593,2,12,4,8,32,30,2,40
Rapid Vienna,2593,3,8,10,6,37,28,9,34
LASK Linz,2593,4,7,7,10,24,30,-6,28
SC Rheindorf,2593,5,7,6,11,21,26,-5,27
Mattersburg,2593,6,6,8,10,28,37,-9,26
Vienna,2593,7,6,5,13,24,41,-17,23
FC Salzburg,2594,1,15,7,2,50,17,33,52
SK Sturm Gra,2594,2,14,3,7,33,30,3,45
Rapid Vienna,2594,3,8,9,7,34,30,4,33
LASK Linz,2594,4,9,5,10,28,31,-3,32
Mattersburg,2594,5,7,6,11,34,42,-8,27
Vienna,2594,6,6,7,11,25,39,-14,25
SC Rheindorf,2594,7,4,5,15,15,30,-15,17
FC Salzburg,2595,1,16,6,2,50,17,33,54
Rapid Vienna,2595,2,10,9,5,39,32,7,39
SK Sturm Gra,2595,3,11,4,9,30,31,-1,37
LASK Linz,2595,4,8,6,10,27,28,-1,30
Vienna,2595,5,7,5,12,26,41,-15,26
SC Rheindorf,2595,6,6,5,13,20,29,-9,23
Mattersburg,2595,7,6,5,13,29,43,-14,23
FC Salzburg,2596,1,13,9,2,42,18,24,48
Rapid Vienna,2596,2,10,10,4,42,31,11,40
SK Sturm Gra,2596,3,12,4,8,34,32,2,40
Mattersburg,2596,4,7,6,11,33,39,-6,27
SC Rheindorf,2596,5,7,5,12,25,31,-6,26
LASK Linz,2596,6,7,5,12,26,33,-7,26
Vienna,2596,7,6,5,13,24,42,-18,23
FC Salzburg,2597,1,14,8,2,51,24,27,50
SK Sturm Gra,2597,2,13,3,8,32,30,2,42
LASK Linz,2597,3,10,5,9,29,27,2,35
Rapid Vienna,2597,4,7,10,7,32,28,4,31
Vienna,2597,5,7,6,11,29,41,-12,27
SC Rheindorf,2597,6,6,6,12,19,28,-9,24
Mattersburg,2597,7,5,6,13,32,46,-14,21
FC Salzburg,2598,1,15,7,2,47,16,31,52
SK Sturm Gra,2598,2,13,4,7,31,28,3,43
Rapid Vienna,2598,3,8,9,7,35,28,7,33
LASK Linz,2598,4,9,6,9,29,29,0,33
Mattersburg,2598,5,8,5,11,36,43,-7,29
Vienna,2598,6,6,5,13,24,41,-17,23
SC Rheindorf,2598,7,4,6,14,16,33,-17,18
FC Salzburg,2599,1,15,7,2,43,16,27,52
Rapid Vienna,2599,2,9,10,5,35,27,8,37
SK Sturm Gra,2599,3,11,4,9,31,31,0,37
LASK Linz,2599,4,8,7,9,27,30,-3,31
Mattersburg,2599,5,8,5,11,35,40,-5,29
Vienna,2599,6,6,5,13,26,43,-17,23
SC Rheindorf,2599,7,5,6,13,19,29,-10,21
FC Salzburg,2600,1,15,6,3,43,17,26,51
SK Sturm Gra,2600,2,14,4,6,35,27,8,46
Rapid Vienna,2600,3,7,11,6,33,28,5,32
LASK Linz,2600,4,8,6,10,26,29,-3,30
Mattersburg,2600,5,7,5,12,30,40,-10,26
Vienna,2600,6,6,5,13,25,42,-17,23
SC Rheindorf,2600,7,5,7,12,17,26,-9,22
FC Salzburg,2601,1,14,7,3,41,17,24,49
SK Sturm Gra,2601,2,14,3,7,35,27,8,45
Rapid Vienna,2601,3,7,12,5,33,28,5,33
LASK Linz,2601,4,7,7,10,27,32,-5,28
Mattersburg,2601,5,7,5,12,36,41,-5,26
Vienna,2601,6,7,5,12,25,41,-16,26
SC Rheindorf,2601,7,5,7,12,20,31,-11,22
FC Salzburg,2602,1,15,7,2,48,18,30,52
Rapid Vienna,2602,2,9,10,5,35,25,10,37
SK Sturm Gra,2602,3,11,4,9,29,29,0,37
LASK Linz,2602,4,8,7,9,27,30,-3,31
Mattersburg,2602,5,7,6,11,33,42,-9,27
Vienna,2602,6,6,6,12,25,40,-15,24
SC Rheindorf,2602,7,5,6,13,18,31,-13,21
FC Salzburg,2603,1,14,8,2,47,18,29,50
SK Sturm Gra,2603,2,14,3,7,35,26,9,45
Rapid Vienna,2603,3,9,10,5,38,28,10,37
Vienna,2603,4,7,6,11,27,40,-13,27
LASK Linz,2603,5,7,5,12,26,36,-10,26
Mattersburg,2603,6,7,5,12,34,47,-13,26
SC Rheindorf,2603,7,5,5,14,18,30,-12,20
FC Salzburg,2604,1,15,7,2,46,18,28,52
SK Sturm Gra,2604,2,13,3,8,33,29,4,42
Rapid Vienna,2604,3,9,10,5,38,28,10,37
LASK Linz,2604,4,8,5,11,26,32,-6,29
SC Rheindorf,2604,5,6,6,12,22,29,-7,24
Mattersburg,2604,6,6,6,12,30,43,-13,24
Vienna,2604,7,6,5,13,24,40,-16,23
SK Sturm Gra,2605,1,14,4,6,36,28,8,46
FC Salzburg,2605,2,13,6,5,44,21,23,45
Rapid Vienna,2605,3,8,10,6,34,30,4,34
LASK Linz,2605,4,7,6,11,26,31,-5,27
Mattersburg,2605,5,7,6,11,30,40,-10,27
Vienna,2605,6,7,5,12,27,41,-14,26
SC Rheindorf,2605,7,6,7,11,21,27,-6,25
FC Salzburg,2606,1,14,6,4,48,22,26,48
SK Sturm Gra,2606,2,12,4,8,33,31,2,40
Rapid Vienna,2606,3,8,11,5,39,32,7,35
LASK Linz,2606,4,7,7,10,26,32,-6,28
Mattersburg,2606,5,7,6,11,31,40,-9,27
Vienna,2606,6,7,6,11,26,38,-12,27
SC Rheindorf,2606,7,6,6,12,19,27,-8,24
FC Salzburg,2607,1,13,8,3,41,21,20,47
SK Sturm Gra,2607,2,12,5,7,32,29,3,41
Rapid Vienna,2607,3,10,9,5,40,25,15,39
LASK Linz,2607,4,8,7,9,27,28,-1,31
Mattersburg,2607,5,7,6,11,31,40,-9,27
Vienna,2607,6,6,7,11,23,37,-14,25
SC Rheindorf,2607,7,4,6,14,15,29,-14,18
FC Salzburg,2608,1,14,8,2,43,17,26,50
SK Sturm Gra,2608,2,11,4,9,29,31,-2,37
Rapid Vienna,2608,3,8,10,6,35,28,7,34
LASK Linz,2608,4,9,6,9,26,26,0,33
SC Rheindorf,2608,5,8,5,11,26,28,-2,29
Vienna,2608,6,6,7,11,27,41,-14,25
Mattersburg,2608,7,5,6,13,29,44,-15,21
FC Salzburg,2609,1,14,7,3,46,17,29,49
SK Sturm Gra,2609,2,14,3,7,34,29,5,45
Rapid Vienna,2609,3,8,12,4,35,25,10,36
LASK Linz,2609,4,8,7,9,29,30,-1,31
Mattersburg,2609,5,6,7,11,32,46,-14,25
Vienna,2609,6,6,6,12,26,42,-16,24
SC Rheindorf,2609,7,4,6,14,16,29,-13,18
FC Salzburg,2610,1,14,7,3,47,21,26,49
SK Sturm Gra,2610,2,12,5,7,31,26,5,41
Rapid Vienna,2610,3,10,10,4,39,27,12,40
LASK Linz,2610,4,8,7,9,26,27,-1,31
Mattersburg,2610,5,7,6,11,31,41,-10,27
Vienna,2610,6,6,5,13,25,42,-17,23
SC Rheindorf,2610,7,4,6,14,19,34,-15,18
FC Salzburg,2611,1,14,7,3,45,20,25,49
SK Sturm Gra,2611,2,12,4,8,33,30,3,40
Rapid Vienna,2611,3,9,9,6,37,28,9,36
LASK Linz,2611,4,9,5,10,31,31,0,32
SC Rheindorf,2611,5,7,5,12,20,29,-9,26
Mattersburg,2611,6,7,5,12,33,43,-10,26
Vienna,2611,7,6,5,13,27,45,-18,23
FC Salzburg,2612,1,14,8,2,48,18,30,50
SK Sturm Gra,2612,2,13,4,7,34,30,4,43
Rapid Vienna,2612,3,8,11,5,34,26,8,35
Mattersburg,2612,4,8,5,11,32,39,-7,29
LASK Linz,2612,5,7,5,12,25,35,-10,26
Vienna,2612,6,6,6,12,25,40,-15,24
SC Rheindorf,2612,7,5,7,12,19,29,-10,22
FC Salzburg,2613,1,14,6,4,45,20,25,48
SK Sturm Gra,2613,2,12,4,8,32,30,2,40
Rapid Vienna,2613,3,9,10,5,38,27,11,37
SC Rheindorf,2613,4,8,5,11,22,27,-5,29
LASK Linz,2613,5,7,6,11,25,33,-8,27
Mattersburg,2613,6,7,6,11,31,40,-9,27
Vienna,2613,7,6,5,13,25,41,-16,23
FC Salzburg,2614,1,16,6,2,50,18,32,54
SK Sturm Gra,2614,2,12,3,9,31,29,2,39
Rapid Vienna,2614,3,9,9,6,36,29,7,36
LASK Linz,2614,4,10,6,8,33,29,4,36
Vienna,2614,5,7,5,12,25,42,-17,26
Mattersburg,2614,6,6,6,12,30,42,-12,24
SC Rheindorf,2614,7,4,5,15,17,33,-16,17
FC Salzburg,2615,1,15,7,2,48,17,31,52
SK Sturm Gra,2615,2,12,4,8,32,31,1,40
Rapid Vienna,2615,3,8,9,7,34,29,5,33
LASK Linz,2615,4,8,7,9,26,27,-1,31
SC Rheindorf,2615,5,7,6,11,21,27,-6,27
Vienna,2615,6,7,6,11,28,41,-13,27
Mattersburg,2615,7,5,5,14,29,46,-17,20
FC Salzburg,2616,1,15,7,2,48,19,29,52
Rapid Vienna,2616,2,9,11,4,37,26,11,38
SK Sturm Gra,2616,3,11,5,8,30,29,1,38
LASK Linz,2616,4,9,6,9,29,30,-1,33
Vienna,2616,5,7,5,12,25,40,-15,26
Mattersburg,2616,6,5,7,12,30,43,-13,22
SC Rheindorf,2616,7,4,7,13,19,31,-12,19
FC Salzburg,2617,1,14,7,3,45,18,27,49
Rapid Vienna,2617,2,9,10,5,37,28,9,37
SK Sturm Gra,2617,3,11,3,10,31,31,0,36
LASK Linz,2617,4,9,7,8,26,25,1,34
Vienna,2617,5,7,5,12,27,42,-15,26
Mattersburg,2617,6,6,7,11,31,42,-11,25
SC Rheindorf,2617,7,5,7,12,18,29,-11,22
FC Salzburg,2618,1,14,7,3,46,20,26,49
SK Sturm Gra,2618,2,12,4,8,33,32,1,40
LASK Linz,2618,3,10,6,8,29,27,2,36
Rapid Vienna,2618,4,7,11,6,35,30,5,32
Vienna,2618,5,8,5,11,28,39,-11,29
SC Rheindorf,2618,6,5,7,12,22,31,-9,22
Mattersburg,2618,7,5,6,13,31,45,-14,21
FC Salzburg,2619,1,15,6,3,43,17,26,51
SK Sturm Gra,2619,2,12,3,9,31,31,0,39
Rapid Vienna,2619,3,9,9,6,36,27,9,36
LASK Linz,2619,4,10,6,8,29,27,2,36
Vienna,2619,5,7,6,11,26,38,-12,27
Mattersburg,2619,6,6,6,12,30,42,-12,24
SC Rheindorf,2619,7,4,6,14,19,32,-13,18
FC Salzburg,2620,1,15,7,2,45,18,27,52
SK Sturm Gra,2620,2,13,5,6,32,26,6,44
Rapid Vienna,2620,3,8,11,5,34,26,8,35
LASK Linz,2620,4,7,6,11,27,32,-5,27
Mattersburg,2620,5,7,6,11,35,42,-7,27
Vienna,2620,6,6,5,13,26,44,-18,23
SC Rheindorf,2620,7,4,8,12,20,31,-11,20
FC Salzburg,2621,1,15,6,3,44,17,27,51
SK Sturm Gra,2621,2,13,3,8,33,27,6,42
LASK Linz,2621,3,9,5,10,25,26,-1,32
Rapid Vienna,2621,4,7,10,7,31,30,1,31
Vienna,2621,5,7,5,12,25,38,-13,26
SC Rheindorf,2621,6,6,7,11,18,26,-8,25
Mattersburg,2621,7,6,6,12,29,41,-12,24
FC Salzburg,2622,1,15,7,2,47,18,29,52
Rapid Vienna,2622,2,9,10,5,36,28,8,37
SK Sturm Gra,2622,3,11,4,9,32,33,-1,37
LASK Linz,2622,4,7,6,11,26,30,-4,27
SC Rheindorf,2622,5,7,6,11,23,28,-5,27
Vienna,2622,6,7,5,12,26,40,-14,26
Mattersburg,2622,7,6,6,12,30,43,-13,24
FC Salzburg,2623,1,14,6,4,48,23,25,48
SK Sturm Gra,2623,2,12,4,8,35,32,3,40
LASK Linz,2623,3,11,5,8,31,27,4,38
Rapid Vienna,2623,4,9,9,6,38,29,9,36
Vienna,2623,5,7,5,12,26,41,-15,26
Mattersburg,2623,6,6,6,12,31,44,-13,24
SC Rheindorf,2623,7,4,7,13,18,31,-13,19
FC Salzburg,2624,1,14,7,3,45,21,24,49
Rapid Vienna,2624,2,10,10,4,38,26,12,40
SK Sturm Gra,2624,3,11,4,9,29,30,-1,37
LASK Linz,2624,4,7,7,10,27,30,-3,28
Mattersburg,2624,5,7,6,11,33,44,-11,27
Vienna,2624,6,7,6,11,29,40,-11,27
SC Rheindorf,2624,7,5,6,13,19,29,-10,21
FC Salzburg,2625,1,16,6,2,46,16,30,54
SK Sturm Gra,2625,2,14,3,7,33,25,8,45
Rapid Vienna,2625,3,8,9,7,33,28,5,33
LASK Linz,2625,4,7,6,11,25,31,-6,27
Vienna,2625,5,7,5,12,26,40,-14,26
Mattersburg,2625,6,6,6,12,29,42,-13,24
SC Rheindorf,2625,7,6,5,13,18,28,-10,23
FC Salzburg,2626,1,13,6,5,42,21,21,45
SK Sturm Gra,2626,2,13,3,8,35,26,9,42
Rapid Vienna,2626,3,8,11,5,34,30,4,35
Mattersburg,2626,4,8,5,11,34,42,-8,29
Vienna,2626,5,8,5,11,28,40,-12,29
LASK Linz,2626,6,7,6,11,25,31,-6,27
SC Rheindorf,2626,7,6,6,12,19,27,-8,24
FC Salzburg,2627,1,16,6,2,45,15,30,54
SK Sturm Gra,2627,2,12,4,8,30,27,3,40
Rapid Vienna,2627,3,9,10,5,35,27,8,37
LASK Linz,2627,4,7,7,10,25,28,-3,28
Vienna,2627,5,7,5,12,27,40,-13,26
Mattersburg,2627,6,6,6,12,31,44,-13,24
SC Rheindorf,2627,7,5,6,13,16,28,-12,21
FC Salzburg,2628,1,15,7,2,42,16,26,52
SK Sturm Gra,2628,2,11,5,8,29,29,0,38
LASK Linz,2628,3,10,6,8,29,24,5,36
Rapid Vienna,2628,4,7,10,7,32,28,4,31
Mattersburg,2628,5,7,6,11,32,39,-7,27
Vienna,2628,6,6,6,12,24,41,-17,24
SC Rheindorf,2628,7,5,6,13,19,30,-11,21
FC Salzburg,2629,1,15,6,3,45,17,28,51
SK Sturm Gra,2629,2,11,5,8,32,30,2,38
Rapid Vienna,2629,3,8,10,6,38,31,7,34
LASK Linz,2629,4,9,7,8,30,29,1,34
Vienna,2629,5,7,5,12,26,43,-17,26
Mattersburg,2629,6,6,6,12,29,40,-11,24
SC Rheindorf,2629,7,6,5,13,21,31,-10,23
FC Salzburg,2630,1,15,7,2,44,16,28,52
SK Sturm Gra,2630,2,14,3,7,34,28,6,45
Rapid Vienna,2630,3,8,9,7,36,29,7,33
LASK Linz,2630,4,8,6,10,27,29,-2,30
Mattersburg,2630,5,6,7,11,30,40,-10,25
SC Rheindorf,2630,6,6,5,13,19,32,-13,23
Vienna,2630,7,6,5,13,25,41,-16,23
FC Salzburg,2631,1,15,6,3,46,20,26,51
SK Sturm Gra,2631,2,14,3,7,33,27,6,45
LASK Linz,2631,3,9,6,9,29,27,2,33
Rapid Vienna,2631,4,7,10,7,35,32,3,31
Vienna,2631,5,7,5,12,25,39,-14,26
Mattersburg,2631,6,6,5,13,33,44,-11,23
SC Rheindorf,2631,7,5,7,12,19,31,-12,22
FC Salzburg,2632,1,14,6,4,46,20,26,48
SK Sturm Gra,2632,2,12,5,7,34,29,5,41
LASK Linz,2632,3,9,5,10,30,32,-2,32
Rapid Vienna,2632,4,7,10,7,36,32,4,31
Mattersburg,2632,5,8,5,11,37,44,-7,29
Vienna,2632,6,7,5,12,25,40,-15,26
SC Rheindorf,2632,7,6,6,12,20,31,-11,24
FC Salzburg,2633,1,14,8,2,45,18,27,50
SK Sturm Gra,2633,2,13,4,7,31,26,5,43
Rapid Vienna,2633,3,9,9,6,35,26,9,36
LASK Linz,2633,4,10,5,9,30,26,4,35
Mattersburg,2633,5,6,7,11,31,40,-9,25
Vienna,2633,6,6,5,13,25,44,-19,23
SC Rheindorf,2633,7,4,6,14,16,33,-17,18
FC Salzburg,2634,1,13,8,3,41,20,21,47
SK Sturm Gra,2634,2,12,4,8,31,28,3,40
Rapid Vienna,2634,3,9,11,4,39,27,12,38
LASK Linz,2634,4,9,7,8,28,27,1,34
Vienna,2634,5,7,6,11,26,37,-11,27
Mattersburg,2634,6,5,7,12,29,42,-13,22
SC Rheindorf,2634,7,5,5,14,19,32,-13,20
FC Salzburg,2635,1,14,7,3,48,20,28,49
SK Sturm Gra,2635,2,12,4,8,37,33,4,40
LASK Linz,2635,3,10,5,9,32,29,3,35
Rapid Vienna,2635,4,8,9,7,32,29,3,33
SC Rheindorf,2635,5,7,5,12,20,27,-7,26
Mattersburg,2635,6,6,6,12,31,46,-15,24
Vienna,2635,7,6,6,12,26,42,-16,24
FC Salzburg,2636,1,16,6,2,47,16,31,54
Rapid Vienna,2636,2,10,9,5,37,25,12,39
SK Sturm Gra,2636,3,12,3,9,33,32,1,39
LASK Linz,2636,4,8,7,9,28,30,-2,31
Mattersburg,2636,5,6,7,11,31,42,-11,25
Vienna,2636,6,6,5,13,23,41,-18,23
SC Rheindorf,2636,7,4,7,13,16,29,-13,19
FC Salzburg,2637,1,13,8,3,47,22,25,47
SK Sturm Gra,2637,2,11,5,8,31,31,0,38
Rapid Vienna,2637,3,8,11,5,34,27,7,35
LASK Linz,2637,4,9,7,8,28,25,3,34
Vienna,2637,5,7,6,11,26,39,-13,27
SC Rheindorf,2637,6,6,6,12,18,26,-8,24
Mattersburg,2637,7,5,7,12,28,42,-14,22
FC Salzburg,2638,1,15,7,2,50,21,29,52
SK Sturm Gra,2638,2,14,3,7,36,28,8,45
Rapid Vienna,2638,3,7,10,7,33,28,5,31
LASK Linz,2638,4,8,6,10,28,32,-4,30
Mattersburg,2638,5,5,9,10,33,43,-10,24
Vienna,2638,6,6,6,12,24,42,-18,24
SC Rheindorf,2638,7,5,7,12,20,30,-10,22
FC Salzburg,2639,1,14,7,3,46,22,24,49
Rapid Vienna,2639,2,10,10,4,39,23,16,40
SK Sturm Gra,2639,3,12,4,8,32,31,1,40
LASK Linz,2639,4,7,8,9,23,25,-2,29
Vienna,2639,5,7,5,12,25,41,-16,26
SC Rheindorf,2639,6,6,6,12,18,27,-9,24
Mattersburg,2639,7,5,6,13,27,41,-14,21
FC Salzburg,2640,1,15,6,3,46,18,28,51
SK Sturm Gra,2640,2,12,3,9,29,29,0,39
Rapid Vienna,2640,3,8,9,7,33,27,6,33
LASK Linz,2640,4,9,6,9,28,27,1,33
SC Rheindorf,2640,5,7,5,12,21,30,-9,26
Mattersburg,2640,6,6,7,11,32,42,-10,25
Vienna,2640,7,6,6,12,25,41,-16,24
FC Salzburg,2641,1,14,8,2,43,16,27,50
SK Sturm Gra,2641,2,12,5,7,31,28,3,41
Rapid Vienna,2641,3,8,10,6,33,27,6,34
LASK Linz,2641,4,9,6,9,30,28,2,33
Mattersburg,2641,5,7,5,12,32,44,-12,26
Vienna,2641,6,6,6,12,25,40,-15,24
SC Rheindorf,2641,7,5,6,13,18,29,-11,21
FC Salzburg,2642,1,15,6,3,49,21,28,51
SK Sturm Gra,2642,2,13,3,8,31,28,3,42
Rapid Vienna,2642,3,9,11,4,36,24,12,38
LASK Linz,2642,4,8,7,9,29,29,0,31
Vienna,2642,5,7,5,12,27,43,-16,26
SC Rheindorf,2642,6,5,7,12,20,27,-7,22
Mattersburg,2642,7,5,5,14,31,51,-20,20
FC Salzburg,2643,1,15,6,3,48,17,31,51
SK Sturm Gra,2643,2,12,4,8,34,33,1,40
Rapid Vienna,2643,3,10,9,5,41,29,12,39
LASK Linz,2643,4,8,6,10,29,31,-2,30
Mattersburg,2643,5,7,6,11,32,40,-8,27
Vienna,2643,6,6,6,12,24,42,-18,24
SC Rheindorf,2643,7,5,5,14,20,36,-16,20
FC Salzburg,2644,1,15,7,2,50,17,33,52
SK Sturm Gra,2644,2,11,4,9,29,34,-5,37
Rapid Vienna,2644,3,8,11,5,36,29,7,35
LASK Linz,2644,4,7,8,9,27,29,-2,29
SC Rheindorf,2644,5,7,6,11,21,28,-7,27
Vienna,2644,6,7,5,12,26,40,-14,26
Mattersburg,2644,7,5,7,12,32,44,-12,22
FC Salzburg,2645,1,16,6,2,47,19,28,54
SK Sturm Gra,2645,2,12,3,9,31,29,2,39
Rapid Vienna,2645,3,9,10,5,36,27,9,37
LASK Linz,2645,4,9,7,8,29,28,1,34
Mattersburg,2645,5,6,6,12,32,43,-11,24
Vienna,2645,6,6,5,13,25,43,-18,23
SC Rheindorf,2645,7,5,5,14,20,31,-11,20
FC Salzburg,2646,1,15,6,3,50,19,31,51
SK Sturm Gra,2646,2,12,3,9,32,30,2,39
Rapid Vienna,2646,3,9,9,6,34,27,7,36
LASK Linz,2646,4,9,5,10,30,32,-2,32
Vienna,2646,5,8,5,11,27,39,-12,29
SC Rheindorf,2646,6,7,5,12,20,29,-9,26
Mattersburg,2646,7,5,5,14,29,46,-17,20
FC Salzburg,2647,1,14,6,4,45,20,25,48
SK Sturm Gra,2647,2,14,3,7,32,29,3,45
Rapid Vienna,2647,3,10,9,5,38,27,11,39
LASK Linz,2647,4,8,5,11,27,30,-3,29
Mattersburg,2647,5,7,6,11,31,43,-12,27
Vienna,2647,6,6,5,13,25,41,-16,23
SC Rheindorf,2647,7,5,6,13,21,29,-8,21
FC Salzburg,2648,1,15,6,3,47,18,29,51
SK Sturm Gra,2648,2,13,4,7,31,27,4,43
Rapid Vienna,2648,3,8,9,7,35,30,5,33
LASK Linz,2648,4,8,6,10,25,30,-5,30
SC Rheindorf,2648,5,7,6,11,24,28,-4,27
Mattersburg,2648,6,6,6,12,31,42,-11,24
Vienna,2648,7,6,5,13,25,43,-18,23
FC Salzburg,2649,1,14,8,2,44,17,27,50
SK Sturm Gra,2649,2,12,5,7,33,29,4,41
Rapid Vienna,2649,3,9,9,6,35,27,8,36
LASK Linz,2649,4,7,6,11,28,32,-4,27
Vienna,2649,5,7,6,11,27,39,-12,27
SC Rheindorf,2649,6,7,5,12,21,30,-9,26
Mattersburg,2649,7,6,5,13,32,46,-14,23
FC Salzburg,2650,1,14,6,4,41,20,21,48
SK Sturm Gra,2650,2,13,5,6,35,27,8,44
Rapid Vienna,2650,3,9,10,5,35,26,9,37
LASK Linz,2650,4,7,8,9,26,28,-2,29
Mattersburg,2650,5,7,6,11,33,41,-8,27
Vienna,2650,6,6,5,13,24,41,-17,23
SC Rheindorf,2650,7,5,6,13,18,29,-11,21
FC Salzburg,2651,1,14,8,2,45,17,28,50
SK Sturm Gra,2651,2,12,4,8,35,30,5,40
Rapid Vienna,2651,3,7,12,5,35,29,6,33
LASK Linz,2651,4,9,6,9,31,29,2,33
SC Rheindorf,2651,5,6,7,11,23,28,-5,25
Mattersburg,2651,6,6,6,12,30,47,-17,24
Vienna,2651,7,6,5,13,25,44,-19,23
FC Salzburg,2652,1,15,7,2,49,16,33,52
SK Sturm Gra,2652,2,13,3,8,31,28,3,42
Rapid Vienna,2652,3,8,11,5,34,26,8,35
LASK Linz,2652,4,8,6,10,25,27,-2,30
Vienna,2652,5,7,5,12,27,41,-14,26
Mattersburg,2652,6,6,6,12,31,48,-17,24
SC Rheindorf,2652,7,4,8,12,18,29,-11,20
FC Salzburg,2653,1,13,8,3,42,19,23,47
SK Sturm Gra,2653,2,12,5,7,32,28,4,41
Rapid Vienna,2653,3,9,11,4,37,26,11,38
LASK Linz,2653,4,7,6,11,25,30,-5,27
Vienna,2653,5,7,6,11,26,39,-13,27
Mattersburg,2653,6,6,7,11,30,40,-10,25
SC Rheindorf,2653,7,4,9,11,19,29,-10,21
FC Salzburg,2654,1,15,6,3,44,17,27,51
SK Sturm Gra,2654,2,14,3,7,34,27,7,45
Rapid Vienna,2654,3,8,10,6,37,31,6,34
LASK Linz,2654,4,9,6,9,33,29,4,33
Mattersburg,2654,5,6,6,12,31,43,-12,24
Vienna,2654,6,6,5,13,26,43,-17,23
SC Rheindorf,2654,7,5,6,13,17,32,-15,21
FC Salzburg,2655,1,16,6,2,51,18,33,54
SK Sturm Gra,2655,2,11,4,9,32,34,-2,37
Rapid Vienna,2655,3,8,11,5,35,29,6,35
LASK Linz,2655,4,9,5,10,27,29,-2,32
SC Rheindorf,2655,5,6,7,11,20,27,-7,25
Mattersburg,2655,6,6,6,12,28,40,-12,24
Vienna,2655,7,6,5,13,25,41,-16,23
FC Salzburg,2656,1,14,7,3,44,17,27,49
SK Sturm Gra,2656,2,11,5,8,31,32,-1,38
Rapid Vienna,2656,3,9,10,5,38,29,9,37
LASK Linz,2656,4,8,6,10,28,33,-5,30
Vienna,2656,5,7,6,11,24,37,-13,27
SC Rheindorf,2656,6,6,7,11,20,28,-8,25
Mattersburg,2656,7,6,5,13,30,39,-9,23
FC Salzburg,2657,1,12,9,3,41,19,22,45
SK Sturm Gra,2657,2,13,5,6,34,27,7,44
Rapid Vienna,2657,3,8,11,5,33,25,8,35
LASK Linz,2657,4,8,6,10,27,28,-1,30
Mattersburg,2657,5,8,6,10,34,40,-6,30
Vienna,2657,6,6,6,12,26,41,-15,24
SC Rheindorf,2657,7,5,5,14,18,33,-15,20
FC Salzburg,2658,1,15,6,3,47,21,26,51
SK Sturm Gra,2658,2,12,4,8,31,29,2,40
Rapid Vienna,2658,3,9,9,6,38,27,11,36
LASK Linz,2658,4,8,6,10,26,31,-5,30
SC Rheindorf,2658,5,7,5,12,20,27,-7,26
Vienna,2658,6,7,5,12,30,42,-12,26
Mattersburg,2658,7,6,5,13,29,44,-15,23
FC Salzburg,2659,1,13,9,2,40,16,24,48
SK Sturm Gra,2659,2,12,5,7,32,30,2,41
LASK Linz,2659,3,10,6,8,32,26,6,36
Rapid Vienna,2659,4,7,11,6,35,30,5,32
Mattersburg,2659,5,6,7,11,28,38,-10,25
Vienna,2659,6,6,6,12,23,38,-15,24
SC Rheindorf,2659,7,4,8,12,17,29,-12,20
FC Salzburg,2660,1,13,8,3,46,18,28,47
SK Sturm Gra,2660,2,14,4,6,33,26,7,46
Rapid Vienna,2660,3,9,10,5,37,26,11,37
LASK Linz,2660,4,7,8,9,26,28,-2,29
Mattersburg,2660,5,7,6,11,29,43,-14,27
Vienna,2660,6,6,6,12,24,39,-15,24
SC Rheindorf,2660,7,4,6,14,18,33,-15,18
FC Salzburg,2661,1,15,7,2,44,18,26,52
SK Sturm Gra,2661,2,12,6,6,32,27,5,42
Rapid Vienna,2661,3,8,10,6,35,25,10,34
LASK Linz,2661,4,7,6,11,25,35,-10,27
Mattersburg,2661,5,6,7,11,31,40,-9,25
SC Rheindorf,2661,6,6,6,12,21,28,-7,24
Vienna,2661,7,6,6,12,23,38,-15,24
FC Salzburg,2662,1,13,8,3,45,20,25,47
SK Sturm Gra,2662,2,12,5,7,33,29,4,41
Rapid Vienna,2662,3,9,10,5,36,27,9,37
LASK Linz,2662,4,8,6,10,27,32,-5,30
Mattersburg,2662,5,7,6,11,35,40,-5,27
Vienna,2662,6,7,5,12,24,40,-16,26
SC Rheindorf,2662,7,4,8,12,18,30,-12,20
FC Salzburg,2663,1,15,6,3,46,18,28,51
SK Sturm Gra,2663,2,14,3,7,33,28,5,45
Rapid Vienna,2663,3,9,9,6,35,27,8,36
LASK Linz,2663,4,8,5,11,26,30,-4,29
Mattersburg,2663,5,7,5,12,33,42,-9,26
Vienna,2663,6,7,5,12,26,40,-14,26
SC Rheindorf,2663,7,5,5,14,17,31,-14,20
FC Salzburg,2664,1,13,7,4,45,24,21,46
SK Sturm Gra,2664,2,13,4,7,32,27,5,43
Rapid Vienna,2664,3,9,10,5,38,28,10,37
Mattersburg,2664,4,8,5,11,35,41,-6,29
LASK Linz,2664,5,7,6,11,25,29,-4,27
Vienna,2664,6,7,5,12,27,41,-14,26
SC Rheindorf,2664,7,6,5,13,18,30,-12,23
FC Salzburg,2665,1,15,7,2,44,16,28,52
SK Sturm Gra,2665,2,12,5,7,31,27,4,41
Rapid Vienna,2665,3,8,9,7,36,29,7,33
LASK Linz,2665,4,8,6,10,26,30,-4,30
SC Rheindorf,2665,5,7,5,12,19,28,-9,26
Vienna,2665,6,7,5,12,28,42,-14,26
Mattersburg,2665,7,6,5,13,30,42,-12,23
FC Salzburg,2666,1,16,6,2,45,15,30,54
SK Sturm Gra,2666,2,11,5,8,32,30,2,38
Rapid Vienna,2666,3,7,11,6,35,33,2,32
LASK Linz,2666,4,8,6,10,29,28,1,30
SC Rheindorf,2666,5,7,6,11,22,29,-7,27
Mattersburg,2666,6,7,5,12,32,42,-10,26
Vienna,2666,7,6,5,13,24,42,-18,23
FC Salzburg,2667,1,16,6,2,46,16,30,54
SK Sturm Gra,2667,2,12,4,8,30,29,1,40
Rapid Vienna,2667,3,9,9,6,36,28,8,36
LASK Linz,2667,4,8,6,10,24,27,-3,30
Mattersburg,2667,5,8,5,11,37,41,-4,29
Vienna,2667,6,6,5,13,25,41,-16,23
SC Rheindorf,2667,7,4,7,13,17,33,-16,19
FC Salzburg,2668,1,14,8,2,46,20,26,50
SK Sturm Gra,2668,2,12,5,7,31,27,4,41
Rapid Vienna,2668,3,8,10,6,37,30,7,34
LASK Linz,2668,4,8,5,11,27,30,-3,29
Vienna,2668,5,7,6,11,26,39,-13,27
Mattersburg,2668,6,7,5,12,33,42,-9,26
SC Rheindorf,2668,7,6,5,13,17,29,-12,23
FC Salzburg,2669,1,13,6,5,42,25,17,45
SK Sturm Gra,2669,2,12,3,9,31,29,2,39
Rapid Vienna,2669,3,8,10,6,36,29,7,34
LASK Linz,2669,4,9,7,8,27,26,1,34
Mattersburg,2669,5,8,6,10,38,37,1,30
Vienna,2669,6,7,5,12,25,41,-16,26
SC Rheindorf,2669,7,5,7,12,17,29,-12,22
FC Salzburg,2670,1,14,6,4,41,18,23,48
SK Sturm Gra,2670,2,13,5,6,34,26,8,44
Rapid Vienna,2670,3,8,10,6,35,27,8,34
LASK Linz,2670,4,9,7,8,32,28,4,34
Vienna,2670,5,7,6,11,25,38,-13,27
Mattersburg,2670,6,6,6,12,31,44,-13,24
SC Rheindorf,2670,7,4,6,14,18,35,-17,18
FC Salzburg,2671,1,14,7,3,44,19,25,49
SK Sturm Gra,2671,2,14,3,7,33,26,7,45
Rapid Vienna,2671,3,8,10,6,35,29,6,34
LASK Linz,2671,4,9,5,10,28,29,-1,32
Mattersburg,2671,5,7,7,10,33,41,-8,28
Vienna,2671,6,6,6,12,25,41,-16,24
SC Rheindorf,2671,7,4,6,14,19,32,-13,18
FC Salzburg,2672,1,14,8,2,42,17,25,50
SK Sturm Gra,2672,2,13,5,6,35,27,8,44
Rapid Vienna,2672,3,8,12,4,36,26,10,36
LASK Linz,2672,4,7,6,11,26,32,-6,27
SC Rheindorf,2672,5,6,6,12,22,32,-10,24
Vienna,2672,6,6,6,12,26,41,-15,24
Mattersburg,2672,7,5,7,12,30,42,-12,22
FC Salzburg,2673,1,15,6,3,47,17,30,51
SK Sturm Gra,2673,2,13,4,7,32,28,4,43
Rapid Vienna,2673,3,9,10,5,36,26,10,37
LASK Linz,2673,4,8,7,9,25,26,-1,31
Mattersburg,2673,5,6,6,12,28,41,-13,24
Vienna,2673,6,6,6,12,24,42,-18,24
SC Rheindorf,2673,7,5,5,14,17,29,-12,20
FC Salzburg,2674,1,16,6,2,43,16,27,54
SK Sturm Gra,2674,2,13,4,7,33,26,7,43
Rapid Vienna,2674,3,9,9,6,37,29,8,36
LASK Linz,2674,4,7,5,12,26,34,-8,26
Vienna,2674,5,7,5,12,27,41,-14,26
SC Rheindorf,2674,6,6,6,12,20,29,-9,24
Mattersburg,2674,7,6,5,13,33,44,-11,23
FC Salzburg,2675,1,15,7,2,46,18,28,52
SK Sturm Gra,2675,2,13,3,8,34,29,5,42
Rapid Vienna,2675,3,9,9,6,35,29,6,36
LASK Linz,2675,4,7,6,11,24,28,-4,27
Vienna,2675,5,7,6,11,27,38,-11,27
Mattersburg,2675,6,6,6,12,29,44,-15,24
SC Rheindorf,2675,7,5,7,12,19,28,-9,22
FC Salzburg,2676,1,12,9,3,40,21,19,45
SK Sturm Gra,2676,2,12,6,6,35,27,8,42
Rapid Vienna,2676,3,7,12,5,32,28,4,33
LASK Linz,2676,4,7,9,8,29,30,-1,30
Vienna,2676,5,8,5,11,33,38,-5,29
Mattersburg,2676,6,6,7,11,33,46,-13,25
SC Rheindorf,2676,7,4,8,12,19,31,-12,20
FC Salzburg,2677,1,15,6,3,46,19,27,51
SK Sturm Gra,2677,2,13,4,7,33,28,5,43
Rapid Vienna,2677,3,8,10,6,35,26,9,34
Mattersburg,2677,4,8,5,11,33,42,-9,29
LASK Linz,2677,5,7,7,10,24,28,-4,28
Vienna,2677,6,7,5,12,25,39,-14,26
SC Rheindorf,2677,7,4,7,13,19,33,-14,19
FC Salzburg,2678,1,16,6,2,49,17,32,54
SK Sturm Gra,2678,2,13,3,8,33,31,2,42
Rapid Vienna,2678,3,8,10,6,34,28,6,34
LASK Linz,2678,4,8,8,8,27,27,0,32
Vienna,2678,5,6,6,12,26,42,-16,24
Mattersburg,2678,6,5,7,12,29,42,-13,22
SC Rheindorf,2678,7,5,6,13,17,28,-11,21
FC Salzburg,2679,1,14,8,2,49,21,28,50
Rapid Vienna,2679,2,9,10,5,39,29,10,37
SK Sturm Gra,2679,3,11,3,10,30,33,-3,36
LASK Linz,2679,4,9,5,10,26,29,-3,32
Vienna,2679,5,7,5,12,27,42,-15,26
Mattersburg,2679,6,6,7,11,30,40,-10,25
SC Rheindorf,2679,7,6,6,12,22,29,-7,24
FC Salzburg,2680,1,15,6,3,49,21,28,51
SK Sturm Gra,2680,2,13,3,8,36,30,6,42
Rapid Vienna,2680,3,8,9,7,37,33,4,33
LASK Linz,2680,4,9,5,10,28,31,-3,32
Mattersburg,2680,5,7,5,12,30,42,-12,26
Vienna,2680,6,7,5,12,25,39,-14,26
SC Rheindorf,2680,7,6,5,13,22,31,-9,23
FC Salzburg,2681,1,13,8,3,40,17,23,47
SK Sturm Gra,2681,2,13,4,7,32,28,4,43
Rapid Vienna,2681,3,10,10,4,38,23,15,40
LASK Linz,2681,4,7,7,10,25,30,-5,28
Vienna,2681,5,7,6,11,27,38,-11,27
Mattersburg,2681,6,6,6,12,29,43,-14,24
SC Rheindorf,2681,7,4,7,13,17,29,-12,19
FC Salzburg,2682,1,13,9,2,45,19,26,48
SK Sturm Gra,2682,2,12,4,8,30,29,1,40
Rapid Vienna,2682,3,8,12,4,37,27,10,36
LASK Linz,2682,4,8,7,9,26,28,-2,31
Vienna,2682,5,6,7,11,25,39,-14,25
Mattersburg,2682,6,5,8,11,29,40,-11,23
SC Rheindorf,2682,7,5,7,12,18,28,-10,22
FC Salzburg,2683,1,15,6,3,48,22,26,51
SK Sturm Gra,2683,2,13,3,8,33,31,2,42
Rapid Vienna,2683,3,8,11,5,37,28,9,35
LASK Linz,2683,4,7,6,11,25,29,-4,27
SC Rheindorf,2683,5,7,6,11,21,27,-6,27
Mattersburg,2683,6,6,6,12,30,42,-12,24
Vienna,2683,7,6,6,12,26,41,-15,24
FC Salzburg,2684,1,14,6,4,44,22,22,48
SK Sturm Gra,2684,2,12,3,9,36,33,3,39
Rapid Vienna,2684,3,9,10,5,39,30,9,37
LASK Linz,2684,4,9,7,8,30,28,2,34
Vienna,2684,5,7,5,12,25,40,-15,26
Mattersburg,2684,6,6,6,12,32,42,-10,24
SC Rheindorf,2684,7,5,7,12,22,33,-11,22
FC Salzburg,2685,1,13,8,3,42,20,22,47
SK Sturm Gra,2685,2,13,4,7,35,29,6,43
Rapid Vienna,2685,3,9,9,6,37,30,7,36
Mattersburg,2685,4,7,7,10,34,41,-7,28
LASK Linz,2685,5,7,5,12,26,34,-8,26
Vienna,2685,6,6,7,11,27,41,-14,25
SC Rheindorf,2685,7,6,6,12,24,30,-6,24
FC Salzburg,2686,1,15,6,3,47,21,26,51
SK Sturm Gra,2686,2,13,3,8,33,29,4,42
LASK Linz,2686,3,10,6,8,31,28,3,36
Rapid Vienna,2686,4,8,9,7,34,28,6,33
Mattersburg,2686,5,6,6,12,30,43,-13,24
Vienna,2686,6,6,5,13,24,40,-16,23
SC Rheindorf,2686,7,5,7,12,18,28,-10,22
FC Salzburg,2687,1,16,6,2,47,17,30,54
SK Sturm Gra,2687,2,13,4,7,33,26,7,43
Rapid Vienna,2687,3,7,11,6,33,27,6,32
Mattersburg,2687,4,7,6,11,35,42,-7,27
LASK Linz,2687,5,7,6,11,23,32,-9,27
Vienna,2687,6,6,6,12,25,41,-16,24
SC Rheindorf,2687,7,6,5,13,20,31,-11,23
FC Salzburg,2688,1,14,7,3,47,20,27,49
Rapid Vienna,2688,2,9,11,4,39,27,12,38
SK Sturm Gra,2688,3,11,5,8,30,29,1,38
LASK Linz,2688,4,9,7,8,29,26,3,34
Vienna,2688,5,7,5,12,28,41,-13,26
SC Rheindorf,2688,6,6,6,12,21,31,-10,24
Mattersburg,2688,7,5,5,14,26,46,-20,20
FC Salzburg,2689,1,16,6,2,50,16,34,54
SK Sturm Gra,2689,2,12,4,8,32,31,1,40
LASK Linz,2689,3,9,6,9,27,26,1,33
Rapid Vienna,2689,4,7,10,7,33,29,4,31
Mattersburg,2689,5,7,5,12,32,44,-12,26
SC Rheindorf,2689,6,6,6,12,18,28,-10,24
Vienna,2689,7,6,5,13,24,42,-18,23
FC Salzburg,2690,1,14,6,4,45,21,24,48
SK Sturm Gra,2690,2,14,4,6,34,25,9,46
Rapid Vienna,2690,3,8,10,6,34,27,7,34
LASK Linz,2690,4,8,6,10,24,26,-2,30
Mattersburg,2690,5,7,6,11,30,42,-12,27
Vienna,2690,6,6,5,13,25,41,-16,23
SC Rheindorf,2690,7,5,7,12,19,29,-10,22
FC Salzburg,2691,1,14,7,3,44,20,24,49
Rapid Vienna,2691,2,10,9,5,41,28,13,39
SK Sturm Gra,2691,3,12,3,9,31,32,-1,39
LASK Linz,2691,4,8,6,10,29,31,-2,30
Mattersburg,2691,5,8,6,10,33,40,-7,30
Vienna,2691,6,6,5,13,26,42,-16,23
SC Rheindorf,2691,7,5,6,13,17,28,-11,21
FC Salzburg,2692,1,14,7,3,44,21,23,49
SK Sturm Gra,2692,2,13,4,7,34,28,6,43
Rapid Vienna,2692,3,9,11,4,37,26,11,38
Mattersburg,2692,4,7,7,10,33,39,-6,28
LASK Linz,2692,5,7,5,12,28,34,-6,26
Vienna,2692,6,6,6,12,24,40,-16,24
SC Rheindorf,2692,7,5,6,13,23,35,-12,21
FC Salzburg,2693,1,14,8,2,43,16,27,50
SK Sturm Gra,2693,2,12,4,8,30,27,3,40
Rapid Vienna,2693,3,8,11,5,37,26,11,35
LASK Linz,2693,4,7,8,9,24,30,-6,29
Mattersburg,2693,5,6,7,11,28,39,-11,25
Vienna,2693,6,6,6,12,23,39,-16,24
SC Rheindorf,2693,7,5,8,11,18,26,-8,23
FC Salzburg,2694,1,14,6,4,48,22,26,48
SK Sturm Gra,2694,2,14,4,6,38,27,11,46
Rapid Vienna,2694,3,9,9,6,39,32,7,36
LASK Linz,2694,4,9,6,9,32,34,-2,33
Vienna,2694,5,7,5,12,27,38,-11,26
Mattersburg,2694,6,6,6,12,33,47,-14,24
SC Rheindorf,2694,7,4,6,14,18,35,-17,18
FC Salzburg,2695,1,16,6,2,50,18,32,54
SK Sturm Gra,2695,2,14,3,7,40,28,12,45
Rapid Vienna,2695,3,8,10,6,37,33,4,34
LASK Linz,2695,4,8,6,10,26,32,-6,30
Mattersburg,2695,5,6,6,12,30,44,-14,24
Vienna,2695,6,6,6,12,25,40,-15,24
SC Rheindorf,2695,7,5,5,14,23,36,-13,20
FC Salzburg,2696,1,14,8,2,45,18,27,50
SK Sturm Gra,2696,2,13,4,7,32,28,4,43
Rapid Vienna,2696,3,8,11,5,37,27,10,35
LASK Linz,2696,4,10,5,9,33,30,3,35
Vienna,2696,5,7,6,11,28,41,-13,27
Mattersburg,2696,6,6,5,13,32,46,-14,23
SC Rheindorf,2696,7,4,5,15,16,33,-17,17
FC Salzburg,2697,1,14,7,3,46,20,26,49
SK Sturm Gra,2697,2,11,5,8,31,31,0,38
Rapid Vienna,2697,3,8,10,6,36,31,5,34
LASK Linz,2697,4,8,8,8,29,27,2,32
Vienna,2697,5,7,5,12,26,41,-15,26
Mattersburg,2697,6,6,7,11,33,43,-10,25
SC Rheindorf,2697,7,5,8,11,23,31,-8,23
FC Salzburg,2698,1,15,7,2,46,18,28,52
SK Sturm Gra,2698,2,12,5,7,32,28,4,41
LASK Linz,2698,3,9,7,8,33,30,3,34
Rapid Vienna,2698,4,7,9,8,36,36,0,30
Mattersburg,2698,5,6,7,11,32,42,-10,25
SC Rheindorf,2698,6,5,8,11,19,27,-8,23
Vienna,2698,7,6,5,13,24,41,-17,23
FC Salzburg,2699,1,15,6,3,42,17,25,51
SK Sturm Gra,2699,2,13,4,7,31,26,5,43
Rapid Vienna,2699,3,8,11,5,38,30,8,35
Mattersburg,2699,4,9,5,10,35,40,-5,32
LASK Linz,2699,5,8,5,11,28,31,-3,29
Vienna,2699,6,6,5,13,25,41,-16,23
SC Rheindorf,2699,7,4,6,14,17,31,-14,18
FC Salzburg,2700,1,14,7,3,48,20,28,49
SK Sturm Gra,2700,2,12,5,7,31,27,4,41
Rapid Vienna,2700,3,8,10,6,34,28,6,34
LASK Linz,2700,4,9,6,9,29,27,2,33
Vienna,2700,5,6,7,11,24,38,-14,25
SC Rheindorf,2700,6,6,6,12,18,28,-10,24
Mattersburg,2700,7,5,7,12,29,45,-16,22
FC Salzburg,2701,1,14,6,4,46,22,24,48
Rapid Vienna,2701,2,10,9,5,36,24,12,39
SK Sturm Gra,2701,3,12,3,9,32,35,-3,39
LASK Linz,2701,4,10,5,9,33,27,6,35
Vienna,2701,5,8,5,11,26,37,-11,29
Mattersburg,2701,6,6,5,13,32,45,-13,23
SC Rheindorf,2701,7,5,5,14,19,34,-15,20
FC Salzburg,2702,1,15,6,3,47,20,27,51
SK Sturm Gra,2702,2,13,4,7,36,29,7,43
LASK Linz,2702,3,8,8,8,29,29,0,32
Rapid Vienna,2702,4,7,10,7,34,30,4,31
Mattersburg,2702,5,7,5,12,34,47,-13,26
SC Rheindorf,2702,6,6,6,12,20,29,-9,24
Vienna,2702,7,6,5,13,24,40,-16,23
FC Salzburg,2703,1,15,7,2,49,21,28,52
SK Sturm Gra,2703,2,12,3,9,35,31,4,39
Rapid Vienna,2703,3,9,9,6,37,30,7,36
LASK Linz,2703,4,8,5,11,25,31,-6,29
Vienna,2703,5,7,6,11,28,40,-12,27
Mattersburg,2703,6,7,5,12,32,43,-11,26
SC Rheindorf,2703,7,6,5,13,22,32,-10,23
FC Salzburg,2704,1,15,7,2,47,17,30,52
SK Sturm Gra,2704,2,11,4,9,29,32,-3,37
Rapid Vienna,2704,3,8,11,5,35,27,8,35
LASK Linz,2704,4,10,5,9,28,26,2,35
Vienna,2704,5,7,5,12,25,39,-14,26
SC Rheindorf,2704,6,6,6,12,21,28,-7,24
Mattersburg,2704,7,5,6,13,30,46,-16,21
FC Salzburg,2705,1,14,7,3,46,19,27,49
SK Sturm Gra,2705,2,15,3,6,35,25,10,48
Rapid Vienna,2705,3,8,9,7,35,30,5,33
LASK Linz,2705,4,7,5,12,26,32,-6,26
Vienna,2705,5,7,5,12,24,41,-17,26
Mattersburg,2705,6,6,7,11,32,42,-10,25
SC Rheindorf,2705,7,6,6,12,22,31,-9,24
FC Salzburg,2706,1,16,6,2,49,17,32,54
Rapid Vienna,2706,2,10,9,5,40,29,11,39
SK Sturm Gra,2706,3,11,4,9,31,33,-2,37
LASK Linz,2706,4,8,6,10,27,29,-2,30
SC Rheindorf,2706,5,6,6,12,20,29,-9,24
Vienna,2706,6,6,6,12,23,38,-15,24
Mattersburg,2706,7,5,7,12,29,44,-15,22
FC Salzburg,2707,1,13,8,3,46,20,26,47
SK Sturm Gra,2707,2,13,4,7,34,30,4,43
Rapid Vienna,2707,3,8,12,4,35,25,10,36
LASK Linz,2707,4,8,6,10,25,27,-2,30
Vienna,2707,5,7,6,11,27,40,-13,27
Mattersburg,2707,6,5,8,11,30,42,-12,23
SC Rheindorf,2707,7,5,6,13,18,31,-13,21
FC Salzburg,2708,1,13,8,3,44,18,26,47
SK Sturm Gra,2708,2,12,6,6,31,25,6,42
Rapid Vienna,2708,3,8,12,4,34,25,9,36
Mattersburg,2708,4,8,5,11,33,41,-8,29
LASK Linz,2708,5,7,7,10,24,29,-5,28
Vienna,2708,6,6,6,12,26,42,-16,24
SC Rheindorf,2708,7,5,6,13,17,29,-12,21
FC Salzburg,2709,1,15,7,2,46,18,28,52
SK Sturm Gra,2709,2,12,4,8,31,29,2,40
Rapid Vienna,2709,3,7,10,7,35,31,4,31
LASK Linz,2709,4,7,8,9,24,26,-2,29
SC Rheindorf,2709,5,8,5,11,23,27,-4,29
Mattersburg,2709,6,6,7,11,28,40,-12,25
Vienna,2709,7,6,5,13,24,40,-16,23
FC Salzburg,2710,1,14,7,3,46,22,24,49
Rapid Vienna,2710,2,10,10,4,39,27,12,40
SK Sturm Gra,2710,3,12,4,8,33,28,5,40
LASK Linz,2710,4,8,5,11,26,32,-6,29
Vienna,2710,5,7,5,12,27,41,-14,26
SC Rheindorf,2710,6,6,6,12,19,27,-8,24
Mattersburg,2710,7,6,5,13,31,44,-13,23
FC Salzburg,2711,1,16,6,2,49,18,31,54
SK Sturm Gra,2711,2,13,3,8,33,29,4,42
Rapid Vienna,2711,3,8,9,7,36,31,5,33
LASK Linz,2711,4,9,6,9,29,28,1,33
Mattersburg,2711,5,6,6,12,29,42,-13,24
SC Rheindorf,2711,6,6,5,13,21,32,-11,23
Vienna,2711,7,6,5,13,25,42,-17,23
FC Salzburg,2712,1,14,6,4,45,21,24,48
SK Sturm Gra,2712,2,13,4,7,33,27,6,43
Rapid Vienna,2712,3,9,9,6,36,30,6,36
LASK Linz,2712,4,8,6,10,26,28,-2,30
Mattersburg,2712,5,7,6,11,33,41,-8,27
Vienna,2712,6,7,5,12,27,43,-16,26
SC Rheindorf,2712,7,5,6,13,20,30,-10,21
FC Salzburg,2713,1,14,7,3,46,20,26,49
SK Sturm Gra,2713,2,13,3,8,34,29,5,42
Rapid Vienna,2713,3,9,10,5,35,28,7,37
LASK Linz,2713,4,8,5,11,26,30,-4,29
Vienna,2713,5,6,7,11,27,41,-14,25
SC Rheindorf,2713,6,6,6,12,20,28,-8,24
Mattersburg,2713,7,6,6,12,32,44,-12,24
FC Salzburg,2714,1,14,8,2,41,15,26,50
SK Sturm Gra,2714,2,12,4,8,31,28,3,40
Rapid Vienna,2714,3,9,10,5,35,26,9,37
LASK Linz,2714,4,9,5,10,26,27,-1,32
Mattersburg,2714,5,6,6,12,30,42,-12,24
Vienna,2714,6,6,6,12,25,40,-15,24
SC Rheindorf,2714,7,6,5,13,19,29,-10,23
FC Salzburg,2715,1,13,6,5,42,21,21,45
SK Sturm Gra,2715,2,12,5,7,34,28,6,41
Rapid Vienna,2715,3,10,10,4,36,25,11,40
LASK Linz,2715,4,7,7,10,26,32,-6,28
Mattersburg,2715,5,7,7,10,36,44,-8,28
Vienna,2715,6,7,5,12,27,40,-13,26
SC Rheindorf,2715,7,4,8,12,18,29,-11,20
FC Salzburg,2716,1,14,8,2,46,20,26,50
SK Sturm Gra,2716,2,11,5,8,31,31,0,38
Rapid Vienna,2716,3,7,13,4,34,26,8,34
LASK Linz,2716,4,7,7,10,27,30,-3,28
SC Rheindorf,2716,5,7,6,11,22,25,-3,27
Mattersburg,2716,6,7,5,12,30,43,-13,26
Vienna,2716,7,6,6,12,24,39,-15,24
FC Salzburg,2717,1,14,7,3,43,19,24,49
SK Sturm Gra,2717,2,11,4,9,29,29,0,37
LASK Linz,2717,3,9,6,9,34,30,4,33
Rapid Vienna,2717,4,7,12,5,33,30,3,33
Mattersburg,2717,5,7,7,10,33,41,-8,28
SC Rheindorf,2717,6,6,6,12,21,29,-8,24
Vienna,2717,7,6,6,12,28,43,-15,24
FC Salzburg,2718,1,13,7,4,44,21,23,46
SK Sturm Gra,2718,2,12,4,8,30,28,2,40
LASK Linz,2718,3,10,6,8,28,25,3,36
Rapid Vienna,2718,4,8,11,5,35,27,8,35
Mattersburg,2718,5,7,6,11,33,41,-8,27
Vienna,2718,6,6,5,13,25,44,-19,23
SC Rheindorf,2718,7,5,7,12,19,28,-9,22
FC Salzburg,2719,1,15,7,2,45,18,27,52
SK Sturm Gra,2719,2,13,3,8,35,29,6,42
LASK Linz,2719,3,10,5,9,30,27,3,35
Rapid Vienna,2719,4,8,10,6,37,30,7,34
Mattersburg,2719,5,7,6,11,32,41,-9,27
Vienna,2719,6,6,6,12,24,39,-15,24
SC Rheindorf,2719,7,4,5,15,18,37,-19,17
FC Salzburg,2720,1,14,7,3,46,20,26,49
SK Sturm Gra,2720,2,12,5,7,33,31,2,41
Rapid Vienna,2720,3,8,11,5,35,29,6,35
LASK Linz,2720,4,9,6,9,31,28,3,33
Vienna,2720,5,7,6,11,28,38,-10,27
Mattersburg,2720,6,6,6,12,29,42,-13,24
SC Rheindorf,2720,7,4,7,13,19,33,-14,19
FC Salzburg,2721,1,14,7,3,47,21,26,49
SK Sturm Gra,2721,2,13,4,7,33,30,3,43
Rapid Vienna,2721,3,9,10,5,38,28,10,37
LASK Linz,2721,4,8,5,11,30,34,-4,29
Mattersburg,2721,5,8,5,11,32,40,-8,29
Vienna,2721,6,6,6,12,25,40,-15,24
SC Rheindorf,2721,7,4,7,13,20,32,-12,19
FC Salzburg,2722,1,14,6,4,44,23,21,48
SK Sturm Gra,2722,2,12,3,9,36,33,3,39
Rapid Vienna,2722,3,8,10,6,34,27,7,34
LASK Linz,2722,4,9,7,8,27,26,1,34
Vienna,2722,5,8,5,11,27,38,-11,29
Mattersburg,2722,6,6,6,12,31,41,-10,24
SC Rheindorf,2722,7,5,7,12,19,30,-11,22
FC Salzburg,2723,1,15,6,3,48,18,30,51
SK Sturm Gra,2723,2,12,4,8,32,27,5,40
Rapid Vienna,2723,3,10,9,5,39,30,9,39
LASK Linz,2723,4,8,6,10,25,30,-5,30
Vienna,2723,5,7,5,12,25,39,-14,26
Mattersburg,2723,6,6,6,12,30,44,-14,24
SC Rheindorf,2723,7,4,8,12,17,28,-11,20
FC Salzburg,2724,1,15,6,3,49,19,30,51
SK Sturm Gra,2724,2,13,4,7,35,30,5,43
Rapid Vienna,2724,3,10,9,5,39,27,12,39
Mattersburg,2724,4,8,5,11,34,44,-10,29
LASK Linz,2724,5,7,5,12,25,30,-5,26
Vienna,2724,6,6,5,13,24,43,-19,23
SC Rheindorf,2724,7,5,6,13,19,32,-13,21
FC Salzburg,2725,1,15,6,3,45,20,25,51
SK Sturm Gra,2725,2,12,4,8,31,28,3,40
LASK Linz,2725,3,10,6,8,29,27,2,36
Rapid Vienna,2725,4,7,11,6,32,26,6,32
Mattersburg,2725,5,8,6,10,33,39,-6,30
Vienna,2725,6,6,5,13,24,40,-16,23
SC Rheindorf,2725,7,4,6,14,17,31,-14,18
FC Salzburg,2726,1,15,6,3,45,17,28,51
SK Sturm Gra,2726,2,12,4,8,31,29,2,40
Rapid Vienna,2726,3,9,10,5,36,26,10,37
LASK Linz,2726,4,8,5,11,27,36,-9,29
SC Rheindorf,2726,5,7,5,12,24,29,-5,26
Vienna,2726,6,7,5,12,26,40,-14,26
Mattersburg,2726,7,6,5,13,31,43,-12,23
FC Salzburg,2727,1,15,6,3,46,18,28,51
SK Sturm Gra,2727,2,14,4,6,35,26,9,46
Rapid Vienna,2727,3,9,9,6,34,27,7,36
LASK Linz,2727,4,8,5,11,26,29,-3,29
Vienna,2727,5,7,5,12,25,40,-15,26
SC Rheindorf,2727,6,6,6,12,21,28,-7,24
Mattersburg,2727,7,5,5,14,27,46,-19,20
FC Salzburg,2728,1,13,7,4,44,21,23,46
SK Sturm Gra,2728,2,13,5,6,35,29,6,44
Rapid Vienna,2728,3,8,12,4,37,27,10,36
LASK Linz,2728,4,8,5,11,27,30,-3,29
Vienna,2728,5,8,5,11,26,37,-11,29
SC Rheindorf,2728,6,6,7,11,19,27,-8,25
Mattersburg,2728,7,5,5,14,29,46,-17,20
FC Salzburg,2729,1,12,7,5,41,22,19,43
SK Sturm Gra,2729,2,13,4,7,32,26,6,43
LASK Linz,2729,3,10,6,8,28,25,3,36
Rapid Vienna,2729,4,8,10,6,33,26,7,34
Vienna,2729,5,7,6,11,27,39,-12,27
Mattersburg,2729,6,7,5,12,31,41,-10,26
SC Rheindorf,2729,7,4,8,12,16,29,-13,20
FC Salzburg,2730,1,15,7,2,49,21,28,52
SK Sturm Gra,2730,2,12,4,8,33,29,4,40
LASK Linz,2730,3,10,5,9,29,29,0,35
Rapid Vienna,2730,4,7,9,8,34,32,2,30
SC Rheindorf,2730,5,8,5,11,23,27,-4,29
Vienna,2730,6,7,5,12,25,40,-15,26
Mattersburg,2730,7,5,5,14,29,44,-15,20
FC Salzburg,2731,1,14,6,4,48,21,27,48
SK Sturm Gra,2731,2,13,3,8,34,27,7,42
Rapid Vienna,2731,3,9,10,5,36,30,6,37
LASK Linz,2731,4,8,7,9,28,28,0,31
Mattersburg,2731,5,7,6,11,34,44,-10,27
Vienna,2731,6,7,5,12,28,43,-15,26
SC Rheindorf,2731,7,5,5,14,17,32,-15,20
FC Salzburg,2732,1,14,7,3,43,19,24,49
SK Sturm Gra,2732,2,13,4,7,36,31,5,43
Rapid Vienna,2732,3,8,11,5,35,29,6,35
Mattersburg,2732,4,8,5,11,31,38,-7,29
LASK Linz,2732,5,7,7,10,27,31,-4,28
SC Rheindorf,2732,6,6,5,13,24,30,-6,23
Vienna,2732,7,6,5,13,23,41,-18,23
FC Salzburg,2733,1,14,7,3,43,18,25,49
SK Sturm Gra,2733,2,12,4,8,33,29,4,40
Rapid Vienna,2733,3,9,10,5,37,28,9,37
LASK Linz,2733,4,9,7,8,27,26,1,34
Vienna,2733,5,6,6,12,26,41,-15,24
Mattersburg,2733,6,5,8,11,33,45,-12,23
SC Rheindorf,2733,7,5,6,13,22,34,-12,21
FC Salzburg,2734,1,15,6,3,48,20,28,51
SK Sturm Gra,2734,2,13,4,7,33,30,3,43
Rapid Vienna,2734,3,9,9,6,38,30,8,36
LASK Linz,2734,4,9,6,9,27,26,1,33
Mattersburg,2734,5,7,6,11,32,40,-8,27
Vienna,2734,6,6,5,13,24,42,-18,23
SC Rheindorf,2734,7,4,6,14,18,32,-14,18
FC Salzburg,2735,1,15,7,2,50,18,32,52
SK Sturm Gra,2735,2,13,3,8,31,30,1,42
Rapid Vienna,2735,3,8,11,5,36,30,6,35
LASK Linz,2735,4,7,8,9,24,26,-2,29
Vienna,2735,5,7,6,11,26,39,-13,27
Mattersburg,2735,6,6,6,12,30,42,-12,24
SC Rheindorf,2735,7,4,7,13,17,29,-12,19
FC Salzburg,2736,1,14,7,3,43,17,26,49
SK Sturm Gra,2736,2,13,4,7,33,27,6,43
Rapid Vienna,2736,3,8,11,5,34,26,8,35
Vienna,2736,4,8,5,11,29,37,-8,29
LASK Linz,2736,5,7,7,10,25,30,-5,28
Mattersburg,2736,6,6,5,13,28,45,-17,23
SC Rheindorf,2736,7,5,7,12,18,28,-10,22
FC Salzburg,2737,1,16,6,2,47,18,29,54
SK Sturm Gra,2737,2,12,4,8,30,28,2,40
Rapid Vienna,2737,3,9,9,6,35,27,8,36
Mattersburg,2737,4,8,5,11,36,41,-5,29
LASK Linz,2737,5,7,6,11,26,33,-7,27
SC Rheindorf,2737,6,6,5,13,20,30,-10,23
Vienna,2737,7,6,5,13,27,44,-17,23
FC Salzburg,2738,1,14,7,3,44,18,26,49
SK Sturm Gra,2738,2,12,5,7,31,29,2,41
Rapid Vienna,2738,3,9,10,5,39,29,10,37
LASK Linz,2738,4,7,7,10,28,32,-4,28
Mattersburg,2738,5,7,5,12,32,41,-9,26
Vienna,2738,6,7,5,12,25,39,-14,26
SC Rheindorf,2738,7,5,7,12,22,33,-11,22
FC Salzburg,2739,1,15,7,2,48,20,28,52
SK Sturm Gra,2739,2,13,3,8,32,29,3,42
Rapid Vienna,2739,3,8,9,7,37,29,8,33
LASK Linz,2739,4,9,5,10,30,31,-1,32
SC Rheindorf,2739,5,6,6,12,22,32,-10,24
Mattersburg,2739,6,6,6,12,32,44,-12,24
Vienna,2739,7,6,6,12,26,42,-16,24
FC Salzburg,2740,1,15,7,2,50,18,32,52
SK Sturm Gra,2740,2,12,5,7,32,29,3,41
Rapid Vienna,2740,3,7,11,6,37,35,2,32
LASK Linz,2740,4,8,6,10,30,29,1,30
Vienna,2740,5,7,6,11,26,39,-13,27
Mattersburg,2740,6,6,6,12,30,45,-15,24
SC Rheindorf,2740,7,5,7,12,20,30,-10,22
FC Salzburg,2741,1,14,7,3,46,20,26,49
SK Sturm Gra,2741,2,14,4,6,33,26,7,46
Rapid Vienna,2741,3,7,11,6,34,30,4,32
LASK Linz,2741,4,7,8,9,26,28,-2,29
Vienna,2741,5,7,5,12,25,39,-14,26
Mattersburg,2741,6,6,6,12,29,40,-11,24
SC Rheindorf,2741,7,5,7,12,19,29,-10,22
FC Salzburg,2742,1,16,6,2,46,18,28,54
SK Sturm Gra,2742,2,11,6,7,32,30,2,39
Rapid Vienna,2742,3,8,11,5,35,25,10,35
LASK Linz,2742,4,7,7,10,26,30,-4,28
Mattersburg,2742,5,7,6,11,33,42,-9,27
Vienna,2742,6,6,5,13,25,41,-16,23
SC Rheindorf,2742,7,5,7,12,19,30,-11,22
FC Salzburg,2743,1,16,6,2,52,16,36,54
SK Sturm Gra,2743,2,13,4,7,35,31,4,43
Rapid Vienna,2743,3,7,11,6,33,31,2,32
LASK Linz,2743,4,7,6,11,25,35,-10,27
Vienna,2743,5,7,5,12,25,39,-14,26
SC Rheindorf,2743,6,6,7,11,24,29,-5,25
Mattersburg,2743,7,6,5,13,29,42,-13,23
FC Salzburg,2744,1,12,8,4,41,22,19,44
SK Sturm Gra,2744,2,12,5,7,31,29,2,41
Rapid Vienna,2744,3,10,10,4,43,25,18,40
Vienna,2744,4,8,5,11,28,38,-10,29
LASK Linz,2744,5,7,7,10,24,28,-4,28
Mattersburg,2744,6,5,8,11,27,40,-13,23
SC Rheindorf,2744,7,5,7,12,21,33,-12,22
FC Salzburg,2745,1,15,6,3,44,17,27,51
SK Sturm Gra,2745,2,14,3,7,35,27,8,45
Rapid Vienna,2745,3,9,9,6,37,30,7,36
LASK Linz,2745,4,8,6,10,25,28,-3,30
Vienna,2745,5,7,5,12,26,40,-14,26
Mattersburg,2745,6,5,7,12,28,42,-14,22
SC Rheindorf,2745,7,5,6,13,20,31,-11,21
FC Salzburg,2746,1,15,6,3,49,20,29,51
SK Sturm Gra,2746,2,12,4,8,36,32,4,40
Rapid Vienna,2746,3,9,9,6,37,29,8,36
LASK Linz,2746,4,10,5,9,27,26,1,35
SC Rheindorf,2746,5,6,6,12,24,31,-7,24
Mattersburg,2746,6,6,5,13,30,47,-17,23
Vienna,2746,7,6,5,13,23,41,-18,23
FC Salzburg,2747,1,13,9,2,45,21,24,48
SK Sturm Gra,2747,2,11,4,9,32,31,1,37
Rapid Vienna,2747,3,8,12,4,35,26,9,36
LASK Linz,2747,4,9,6,9,30,30,0,33
Vienna,2747,5,7,6,11,29,42,-13,27
Mattersburg,2747,6,6,7,11,34,44,-10,25
SC Rheindorf,2747,7,4,8,12,17,28,-11,20
FC Salzburg,2748,1,14,8,2,46,20,26,50
SK Sturm Gra,2748,2,14,3,7,35,28,7,45
Rapid Vienna,2748,3,9,9,6,36,29,7,36
LASK Linz,2748,4,8,6,10,28,29,-1,30
Vienna,2748,5,6,7,11,25,39,-14,25
Mattersburg,2748,6,5,8,11,30,43,-13,23
SC Rheindorf,2748,7,4,7,13,17,29,-12,19
FC Salzburg,2749,1,14,6,4,44,20,24,48
Rapid Vienna,2749,2,9,10,5,36,26,10,37
SK Sturm Gra,2749,3,11,4,9,31,32,-1,37
LASK Linz,2749,4,8,7,9,30,32,-2,31
Mattersburg,2749,5,7,7,10,34,41,-7,28
SC Rheindorf,2749,6,6,6,12,20,28,-8,24
Vienna,2749,7,6,6,12,25,41,-16,24
FC Salzburg,2750,1,15,7,2,45,18,27,52
Rapid Vienna,2750,2,10,9,5,40,29,11,39
SK Sturm Gra,2750,3,12,3,9,31,30,1,39
LASK Linz,2750,4,8,5,11,30,35,-5,29
SC Rheindorf,2750,5,6,6,12,24,30,-6,24
Vienna,2750,6,6,6,12,24,40,-16,24
Mattersburg,2750,7,5,8,11,30,42,-12,23
SK Sturm Gra,2751,1,15,3,6,35,24,11,48
FC Salzburg,2751,2,13,7,4,43,20,23,46
Rapid Vienna,2751,3,8,11,5,34,28,6,35
LASK Linz,2751,4,8,5,11,25,30,-5,29
Vienna,2751,5,8,5,11,26,38,-12,29
Mattersburg,2751,6,7,5,12,34,44,-10,26
SC Rheindorf,2751,7,4,6,14,17,30,-13,18
FC Salzburg,2752,1,12,8,4,41,21,20,44
SK Sturm Gra,2752,2,12,5,7,33,29,4,41
Rapid Vienna,2752,3,10,10,4,41,28,13,40
Mattersburg,2752,4,9,5,10,39,41,-2,32
LASK Linz,2752,5,7,7,10,30,35,-5,28
Vienna,2752,6,7,5,12,25,40,-15,26
SC Rheindorf,2752,7,4,6,14,19,34,-15,18
FC Salzburg,2753,1,14,8,2,41,16,25,50
SK Sturm Gra,2753,2,13,3,8,33,30,3,42
Rapid Vienna,2753,3,9,11,4,37,25,12,38
LASK Linz,2753,4,8,7,9,29,31,-2,31
Mattersburg,2753,5,6,7,11,31,41,-10,25
Vienna,2753,6,6,7,11,25,39,-14,25
SC Rheindorf,2753,7,4,5,15,17,31,-14,17
FC Salzburg,2754,1,15,7,2,45,18,27,52
SK Sturm Gra,2754,2,14,4,6,34,27,7,46
Rapid Vienna,2754,3,8,10,6,36,29,7,34
LASK Linz,2754,4,8,7,9,27,28,-1,31
Vienna,2754,5,6,6,12,23,38,-15,24
Mattersburg,2754,6,5,8,11,33,44,-11,23
SC Rheindorf,2754,7,4,6,14,20,34,-14,18
FC Salzburg,2755,1,12,8,4,40,20,20,44
SK Sturm Gra,2755,2,12,4,8,32,34,-2,40
Rapid Vienna,2755,3,9,9,6,37,26,11,36
Mattersburg,2755,4,9,5,10,36,38,-2,32
LASK Linz,2755,5,9,5,10,29,33,-4,32
Vienna,2755,6,6,6,12,25,40,-15,24
SC Rheindorf,2755,7,6,5,13,21,29,-8,23
FC Salzburg,2756,1,15,7,2,49,16,33,52
SK Sturm Gra,2756,2,12,4,8,32,33,-1,40
Rapid Vienna,2756,3,8,10,6,34,29,5,34
LASK Linz,2756,4,9,7,8,27,25,2,34
Vienna,2756,5,7,5,12,25,41,-16,26
SC Rheindorf,2756,6,6,5,13,24,29,-5,23
Mattersburg,2756,7,5,6,13,27,45,-18,21
FC Salzburg,2757,1,13,8,3,44,20,24,47
SK Sturm Gra,2757,2,12,4,8,31,27,4,40
Rapid Vienna,2757,3,9,10,5,37,27,10,37
LASK Linz,2757,4,9,6,9,28,28,0,33
Mattersburg,2757,5,7,5,12,34,45,-11,26
Vienna,2757,6,6,6,12,26,42,-16,24
SC Rheindorf,2757,7,6,5,13,19,30,-11,23
FC Salzburg,2758,1,16,6,2,45,16,29,54
SK Sturm Gra,2758,2,12,3,9,31,30,1,39
Rapid Vienna,2758,3,8,9,7,33,29,4,33
LASK Linz,2758,4,9,6,9,29,29,0,33
Vienna,2758,5,7,5,12,26,40,-14,26
SC Rheindorf,2758,6,6,6,12,20,27,-7,24
Mattersburg,2758,7,6,5,13,29,42,-13,23
FC Salzburg,2759,1,13,8,3,43,22,21,47
SK Sturm Gra,2759,2,13,3,8,32,27,5,42
Rapid Vienna,2759,3,10,10,4,40,28,12,40
LASK Linz,2759,4,7,6,11,28,32,-4,27
SC Rheindorf,2759,5,7,5,12,21,29,-8,26
Mattersburg,2759,6,6,6,12,30,40,-10,24
Vienna,2759,7,6,6,12,24,40,-16,24
FC Salzburg,2760,1,13,7,4,40,20,20,46
SK Sturm Gra,2760,2,11,5,8,31,29,2,38
Rapid Vienna,2760,3,9,10,5,36,25,11,37
LASK Linz,2760,4,10,5,9,30,30,0,35
Vienna,2760,5,8,5,11,27,37,-10,29
Mattersburg,2760,6,6,5,13,29,43,-14,23
SC Rheindorf,2760,7,5,7,12,22,31,-9,22
FC Salzburg,2761,1,15,7,2,51,19,32,52
SK Sturm Gra,2761,2,14,4,6,34,26,8,46
Rapid Vienna,2761,3,8,9,7,34,31,3,33
LASK Linz,2761,4,8,7,9,26,27,-1,31
Vienna,2761,5,7,5,12,27,43,-16,26
SC Rheindorf,2761,6,5,6,13,18,29,-11,21
Mattersburg,2761,7,5,6,13,27,42,-15,21
FC Salzburg,2762,1,16,6,2,53,17,36,54
SK Sturm Gra,2762,2,12,4,8,33,33,0,40
LASK Linz,2762,3,9,6,9,31,28,3,33
Rapid Vienna,2762,4,7,9,8,34,34,0,30
SC Rheindorf,2762,5,7,6,11,21,26,-5,27
Mattersburg,2762,6,6,6,12,30,48,-18,24
Vienna,2762,7,6,5,13,25,41,-16,23
FC Salzburg,2763,1,15,7,2,46,17,29,52
SK Sturm Gra,2763,2,12,4,8,33,31,2,40
Rapid Vienna,2763,3,7,11,6,33,29,4,32
LASK Linz,2763,4,8,7,9,28,28,0,31
Mattersburg,2763,5,8,5,11,34,41,-7,29
Vienna,2763,6,6,6,12,25,40,-15,24
SC Rheindorf,2763,7,4,8,12,19,32,-13,20
FC Salzburg,2764,1,14,7,3,46,19,27,49
SK Sturm Gra,2764,2,13,3,8,30,28,2,42
Rapid Vienna,2764,3,8,10,6,34,27,7,34
LASK Linz,2764,4,8,6,10,28,29,-1,30
Mattersburg,2764,5,7,7,10,35,39,-4,28
Vienna,2764,6,7,6,11,27,40,-13,27
SC Rheindorf,2764,7,5,5,14,17,35,-18,20
FC Salzburg,2765,1,13,9,2,44,19,25,48
SK Sturm Gra,2765,2,12,6,6,32,27,5,42
Rapid Vienna,2765,3,8,10,6,36,29,7,34
LASK Linz,2765,4,8,6,10,27,29,-2,30
Vienna,2765,5,7,6,11,29,41,-12,27
SC Rheindorf,2765,6,6,6,12,21,30,-9,24
Mattersburg,2765,7,6,5,13,31,45,-14,23
FC Salzburg,2766,1,15,6,3,43,18,25,51
SK Sturm Gra,2766,2,13,3,8,34,29,5,42
Rapid Vienna,2766,3,10,9,5,38,26,12,39
LASK Linz,2766,4,8,5,11,24,29,-5,29
Mattersburg,2766,5,7,5,12,33,43,-10,26
Vienna,2766,6,7,5,12,27,40,-13,26
SC Rheindorf,2766,7,5,5,14,18,32,-14,20
FC Salzburg,2767,1,13,8,3,44,18,26,47
Rapid Vienna,2767,2,10,10,4,39,25,14,40
SK Sturm Gra,2767,3,11,5,8,31,31,0,38
LASK Linz,2767,4,8,7,9,29,29,0,31
Vienna,2767,5,6,7,11,23,37,-14,25
Mattersburg,2767,6,6,6,12,29,45,-16,24
SC Rheindorf,2767,7,5,7,12,20,30,-10,22
FC Salzburg,2768,1,15,7,2,52,18,34,52
SK Sturm Gra,2768,2,13,4,7,33,30,3,43
Rapid Vienna,2768,3,7,10,7,33,31,2,31
LASK Linz,2768,4,8,6,10,27,27,0,30
Vienna,2768,5,7,6,11,27,40,-13,27
Mattersburg,2768,6,6,6,12,30,45,-15,24
SC Rheindorf,2768,7,5,7,12,18,29,-11,22
FC Salzburg,2769,1,15,6,3,44,20,24,51
SK Sturm Gra,2769,2,14,3,7,38,29,9,45
Rapid Vienna,2769,3,9,9,6,38,29,9,36
LASK Linz,2769,4,9,6,9,28,28,0,33
Vienna,2769,5,7,5,12,29,42,-13,26
SC Rheindorf,2769,6,5,6,13,24,36,-12,21
Mattersburg,2769,7,5,5,14,31,48,-17,20
FC Salzburg,2770,1,14,6,4,48,21,27,48
Rapid Vienna,2770,2,10,10,4,39,26,13,40
SK Sturm Gra,2770,3,12,4,8,30,29,1,40
LASK Linz,2770,4,8,7,9,30,29,1,31
Vienna,2770,5,7,5,12,27,43,-16,26
SC Rheindorf,2770,6,6,5,13,19,31,-12,23
Mattersburg,2770,7,6,5,13,28,42,-14,23
FC Salzburg,2771,1,13,9,2,43,19,24,48
SK Sturm Gra,2771,2,12,5,7,31,29,2,41
Rapid Vienna,2771,3,8,11,5,35,26,9,35
LASK Linz,2771,4,9,6,9,33,29,4,33
Mattersburg,2771,5,6,7,11,33,46,-13,25
Vienna,2771,6,6,6,12,26,41,-15,24
SC Rheindorf,2771,7,4,8,12,19,30,-11,20
FC Salzburg,2772,1,14,6,4,43,20,23,48
SK Sturm Gra,2772,2,12,3,9,32,31,1,39
LASK Linz,2772,3,10,5,9,29,26,3,35
Rapid Vienna,2772,4,7,10,7,33,29,4,31
Vienna,2772,5,8,5,11,27,38,-11,29
Mattersburg,2772,6,7,5,12,31,41,-10,26
SC Rheindorf,2772,7,6,6,12,19,29,-10,24
FC Salzburg,2773,1,14,6,4,45,21,24,48
SK Sturm Gra,2773,2,13,4,7,33,27,6,43
Rapid Vienna,2773,3,9,10,5,35,25,10,37
LASK Linz,2773,4,8,7,9,26,29,-3,31
Mattersburg,2773,5,7,5,12,34,43,-9,26
Vienna,2773,6,7,5,12,27,41,-14,26
SC Rheindorf,2773,7,5,5,14,17,31,-14,20
FC Salzburg,2774,1,14,8,2,46,17,29,50
SK Sturm Gra,2774,2,13,4,7,32,30,2,43
Rapid Vienna,2774,3,7,12,5,36,29,7,33
LASK Linz,2774,4,7,7,10,25,29,-4,28
Vienna,2774,5,7,6,11,26,39,-13,27
Mattersburg,2774,6,7,5,12,32,43,-11,26
SC Rheindorf,2774,7,5,6,13,22,32,-10,21
FC Salzburg,2775,1,16,6,2,45,16,29,54
SK Sturm Gra,2775,2,13,3,8,34,31,3,42
Rapid Vienna,2775,3,8,11,5,36,29,7,35
LASK Linz,2775,4,8,6,10,31,33,-2,30
Mattersburg,2775,5,7,5,12,31,42,-11,26
Vienna,2775,6,7,5,12,26,39,-13,26
SC Rheindorf,2775,7,4,6,14,19,32,-13,18
FC Salzburg,2776,1,15,7,2,46,17,29,52
SK Sturm Gra,2776,2,11,6,7,29,28,1,39
LASK Linz,2776,3,9,6,9,31,28,3,33
Rapid Vienna,2776,4,7,10,7,32,32,0,31
Mattersburg,2776,5,6,7,11,31,40,-9,25
Vienna,2776,6,6,6,12,25,41,-16,24
SC Rheindorf,2776,7,5,8,11,20,28,-8,23
FC Salzburg,2777,1,14,7,3,44,19,25,49
SK Sturm Gra,2777,2,13,3,8,30,28,2,42
Rapid Vienna,2777,3,9,10,5,38,26,12,37
LASK Linz,2777,4,9,7,8,28,26,2,34
Vienna,2777,5,7,6,11,27,39,-12,27
Mattersburg,2777,6,5,6,13,29,44,-15,21
SC Rheindorf,2777,7,4,7,13,18,32,-14,19
FC Salzburg,2778,1,13,7,4,45,22,23,46
SK Sturm Gra,2778,2,12,3,9,30,30,0,39
Rapid Vienna,2778,3,9,10,5,35,25,10,37
LASK Linz,2778,4,10,5,9,29,26,3,35
Vienna,2778,5,7,5,12,29,44,-15,26
SC Rheindorf,2778,6,6,6,12,18,26,-8,24
Mattersburg,2778,7,6,6,12,32,45,-13,24
FC Salzburg,2779,1,15,7,2,48,19,29,52
SK Sturm Gra,2779,2,12,5,7,34,31,3,41
Rapid Vienna,2779,3,9,10,5,38,28,10,37
LASK Linz,2779,4,7,7,10,25,29,-4,28
Vienna,2779,5,6,7,11,26,40,-14,25
Mattersburg,2779,6,6,6,12,32,45,-13,24
SC Rheindorf,2779,7,5,6,13,19,30,-11,21
FC Salzburg,2780,1,15,6,3,48,18,30,51
SK Sturm Gra,2780,2,13,3,8,36,29,7,42
Rapid Vienna,2780,3,9,10,5,37,27,10,37
LASK Linz,2780,4,8,6,10,26,32,-6,30
Vienna,2780,5,7,5,12,25,41,-16,26
SC Rheindorf,2780,6,6,5,13,20,31,-11,23
Mattersburg,2780,7,6,5,13,30,44,-14,23
FC Salzburg,2781,1,13,9,2,43,19,24,48
SK Sturm Gra,2781,2,12,4,8,34,32,2,40
Rapid Vienna,2781,3,9,11,4,37,25,12,38
LASK Linz,2781,4,7,7,10,27,31,-4,28
Mattersburg,2781,5,6,8,10,32,40,-8,26
Vienna,2781,6,6,7,11,23,37,-14,25
SC Rheindorf,2781,7,5,6,13,19,31,-12,21
FC Salzburg,2782,1,14,7,3,44,19,25,49
Rapid Vienna,2782,2,10,10,4,37,24,13,40
SK Sturm Gra,2782,3,11,4,9,29,30,-1,37
LASK Linz,2782,4,7,8,9,25,27,-2,29
Vienna,2782,5,6,7,11,26,40,-14,25
SC Rheindorf,2782,6,6,6,12,19,28,-9,24
Mattersburg,2782,7,5,8,11,32,44,-12,23
FC Salzburg,2783,1,14,7,3,43,19,24,49
SK Sturm Gra,2783,2,12,4,8,31,28,3,40
Rapid Vienna,2783,3,8,10,6,34,27,7,34
LASK Linz,2783,4,7,8,9,27,31,-4,29
Vienna,2783,5,7,6,11,30,40,-10,27
Mattersburg,2783,6,7,5,12,33,42,-9,26
SC Rheindorf,2783,7,6,6,12,18,29,-11,24
FC Salzburg,2784,1,16,6,2,50,16,34,54
SK Sturm Gra,2784,2,12,5,7,32,29,3,41
Rapid Vienna,2784,3,8,10,6,34,31,3,34
LASK Linz,2784,4,9,6,9,28,27,1,33
Mattersburg,2784,5,6,6,12,31,43,-12,24
Vienna,2784,6,6,6,12,24,41,-17,24
SC Rheindorf,2784,7,5,5,14,17,29,-12,20
FC Salzburg,2785,1,14,8,2,46,18,28,50
SK Sturm Gra,2785,2,12,4,8,30,30,0,40
Rapid Vienna,2785,3,7,12,5,35,28,7,33
LASK Linz,2785,4,8,8,8,27,27,0,32
Vienna,2785,5,7,6,11,27,39,-12,27
Mattersburg,2785,6,6,5,13,29,42,-13,23
SC Rheindorf,2785,7,5,7,12,19,29,-10,22
FC Salzburg,2786,1,16,6,2,47,18,29,54
SK Sturm Gra,2786,2,14,3,7,37,29,8,45
LASK Linz,2786,3,9,5,10,26,29,-3,32
Rapid Vienna,2786,4,7,9,8,32,29,3,30
Vienna,2786,5,7,5,12,26,39,-13,26
SC Rheindorf,2786,6,6,6,12,21,29,-8,24
Mattersburg,2786,7,5,6,13,28,44,-16,21
FC Salzburg,2787,1,16,6,2,50,16,34,54
SK Sturm Gra,2787,2,13,4,7,32,28,4,43
Rapid Vienna,2787,3,8,10,6,35,27,8,34
LASK Linz,2787,4,8,6,10,28,29,-1,30
Vienna,2787,5,7,5,12,25,39,-14,26
Mattersburg,2787,6,6,6,12,29,46,-17,24
SC Rheindorf,2787,7,5,5,14,17,31,-14,20
FC Salzburg,2788,1,15,6,3,47,18,29,51
SK Sturm Gra,2788,2,14,3,7,35,28,7,45
Rapid Vienna,2788,3,8,9,7,34,29,5,33
LASK Linz,2788,4,8,6,10,32,34,-2,30
Vienna,2788,5,7,5,12,27,38,-11,26
SC Rheindorf,2788,6,6,6,12,20,30,-10,24
Mattersburg,2788,7,6,5,13,31,49,-18,23
FC Salzburg,2789,1,15,7,2,45,17,28,52
SK Sturm Gra,2789,2,11,5,8,32,31,1,38
LASK Linz,2789,3,10,6,8,32,30,2,36
Rapid Vienna,2789,4,8,11,5,37,29,8,35
Vienna,2789,5,7,6,11,25,37,-12,27
SC Rheindorf,2789,6,5,6,13,19,29,-10,21
Mattersburg,2789,7,5,5,14,29,46,-17,20
FC Salzburg,2790,1,14,7,3,43,20,23,49
SK Sturm Gra,2790,2,13,4,7,33,26,7,43
Rapid Vienna,2790,3,9,10,5,37,28,9,37
LASK Linz,2790,4,7,6,11,27,32,-5,27
Vienna,2790,5,7,6,11,25,38,-13,27
Mattersburg,2790,6,7,5,12,32,42,-10,26
SC Rheindorf,2790,7,5,6,13,20,31,-11,21
FC Salzburg,2791,1,15,7,2,47,19,28,52
SK Sturm Gra,2791,2,12,5,7,32,27,5,41
Rapid Vienna,2791,3,8,9,7,37,30,7,33
LASK Linz,2791,4,8,7,9,25,29,-4,31
Mattersburg,2791,5,7,5,12,32,42,-10,26
SC Rheindorf,2791,6,6,6,12,20,30,-10,24
Vienna,2791,7,6,5,13,24,40,-16,23
FC Salzburg,2792,1,14,8,2,46,21,25,50
SK Sturm Gra,2792,2,12,5,7,32,28,4,41
Rapid Vienna,2792,3,9,11,4,38,27,11,38
LASK Linz,2792,4,7,6,11,26,30,-4,27
Mattersburg,2792,5,6,7,11,31,41,-10,25
Vienna,2792,6,6,6,12,26,41,-15,24
SC Rheindorf,2792,7,6,5,13,20,31,-11,23
FC Salzburg,2793,1,14,6,4,43,20,23,48
Rapid Vienna,2793,2,10,10,4,40,27,13,40
SK Sturm Gra,2793,3,12,4,8,34,31,3,40
LASK Linz,2793,4,8,8,8,32,32,0,32
Vienna,2793,5,8,5,11,27,37,-10,29
Mattersburg,2793,6,6,5,13,30,43,-13,23
SC Rheindorf,2793,7,4,6,14,19,35,-16,18
FC Salzburg,2794,1,15,7,2,45,18,27,52
SK Sturm Gra,2794,2,11,3,10,32,35,-3,36
Rapid Vienna,2794,3,8,10,6,35,29,6,34
LASK Linz,2794,4,9,6,9,31,29,2,33
Vienna,2794,5,7,6,11,26,39,-13,27
SC Rheindorf,2794,6,6,6,12,18,26,-8,24
Mattersburg,2794,7,6,6,12,30,41,-11,24
FC Salzburg,2795,1,15,7,2,44,17,27,52
SK Sturm Gra,2795,2,11,6,7,32,30,2,39
LASK Linz,2795,3,9,7,8,30,29,1,34
Rapid Vienna,2795,4,7,12,5,37,30,7,33
Mattersburg,2795,5,7,5,12,32,41,-9,26
Vienna,2795,6,6,6,12,24,40,-16,24
SC Rheindorf,2795,7,4,7,13,20,32,-12,19
FC Salzburg,2796,1,15,7,2,46,15,31,52
SK Sturm Gra,2796,2,13,4,7,31,28,3,43
Rapid Vienna,2796,3,8,9,7,33,28,5,33
LASK Linz,2796,4,8,5,11,26,29,-3,29
Vienna,2796,5,7,6,11,26,38,-12,27
SC Rheindorf,2796,6,6,6,12,20,29,-9,24
Mattersburg,2796,7,6,5,13,31,46,-15,23
FC Salzburg,2797,1,14,8,2,45,20,25,50
SK Sturm Gra,2797,2,13,4,7,34,29,5,43
LASK Linz,2797,3,9,6,9,30,30,0,33
Rapid Vienna,2797,4,7,10,7,35,31,4,31
Vienna,2797,5,7,5,12,24,38,-14,26
Mattersburg,2797,6,6,6,12,31,42,-11,24
SC Rheindorf,2797,7,5,7,12,19,28,-9,22
FC Salzburg,2798,1,15,6,3,46,19,27,51
SK Sturm Gra,2798,2,12,4,8,32,31,1,40
Rapid Vienna,2798,3,10,9,5,37,26,11,39
Vienna,2798,4,8,5,11,29,38,-9,29
LASK Linz,2798,5,7,6,11,26,33,-7,27
SC Rheindorf,2798,6,6,5,13,20,30,-10,23
Mattersburg,2798,7,6,5,13,31,44,-13,23
FC Salzburg,2799,1,14,6,4,44,19,25,48
SK Sturm Gra,2799,2,13,5,6,34,28,6,44
LASK Linz,2799,3,10,6,8,31,27,4,36
Rapid Vienna,2799,4,8,10,6,34,27,7,34
Vienna,2799,5,7,5,12,27,39,-12,26
SC Rheindorf,2799,6,5,7,12,21,33,-12,22
Mattersburg,2799,7,5,5,14,27,45,-18,20
FC Salzburg,2800,1,13,9,2,43,18,25,48
SK Sturm Gra,2800,2,12,4,8,31,30,1,40
Rapid Vienna,2800,3,9,10,5,40,27,13,37
LASK Linz,2800,4,9,5,10,30,30,0,32
Vienna,2800,5,7,6,11,27,39,-12,27
Mattersburg,2800,6,7,5,12,33,42,-9,26
SC Rheindorf,2800,7,5,5,14,17,35,-18,20
FC Salzburg,2801,1,15,6,3,45,18,27,51
SK Sturm Gra,2801,2,11,6,7,32,29,3,39
Rapid Vienna,2801,3,9,10,5,38,29,9,37
LASK Linz,2801,4,9,6,9,29,28,1,33
Vienna,2801,5,7,5,12,27,39,-12,26
Mattersburg,2801,6,6,5,13,29,46,-17,23
SC Rheindorf,2801,7,5,6,13,18,29,-11,21
FC Salzburg,2802,1,12,9,3,41,19,22,45
SK Sturm Gra,2802,2,12,5,7,31,28,3,41
Rapid Vienna,2802,3,9,10,5,35,26,9,37
Mattersburg,2802,4,8,6,10,31,38,-7,30
LASK Linz,2802,5,7,7,10,26,29,-3,28
Vienna,2802,6,6,6,12,24,39,-15,24
SC Rheindorf,2802,7,6,5,13,19,28,-9,23
FC Salzburg,2803,1,13,7,4,39,19,20,46
Rapid Vienna,2803,2,10,10,4,38,24,14,40
SK Sturm Gra,2803,3,11,4,9,29,30,-1,37
LASK Linz,2803,4,8,7,9,26,29,-3,31
Vienna,2803,5,7,6,11,25,37,-12,27
SC Rheindorf,2803,6,5,8,11,20,27,-7,23
Mattersburg,2803,7,5,8,11,28,39,-11,23
FC Salzburg,2804,1,14,8,2,46,19,27,50
SK Sturm Gra,2804,2,12,5,7,34,28,6,41
Rapid Vienna,2804,3,8,10,6,34,29,5,34
LASK Linz,2804,4,8,7,9,25,27,-2,31
Mattersburg,2804,5,7,5,12,32,42,-10,26
Vienna,2804,6,6,6,12,25,41,-16,24
SC Rheindorf,2804,7,6,5,13,18,28,-10,23
FC Salzburg,2805,1,14,7,3,46,19,27,49
SK Sturm Gra,2805,2,12,4,8,30,28,2,40
Rapid Vienna,2805,3,7,11,6,34,31,3,32
LASK Linz,2805,4,9,5,10,29,32,-3,32
Mattersburg,2805,5,8,5,11,34,40,-6,29
Vienna,2805,6,7,5,12,26,43,-17,26
SC Rheindorf,2805,7,6,5,13,21,27,-6,23
FC Salzburg,2806,1,14,6,4,44,19,25,48
SK Sturm Gra,2806,2,12,5,7,31,27,4,41
Rapid Vienna,2806,3,9,10,5,35,26,9,37
LASK Linz,2806,4,8,6,10,27,30,-3,30
Vienna,2806,5,7,5,12,26,44,-18,26
Mattersburg,2806,6,6,7,11,32,39,-7,25
SC Rheindorf,2806,7,5,7,12,19,29,-10,22
FC Salzburg,2807,1,15,7,2,48,22,26,52
Rapid Vienna,2807,2,10,9,5,39,28,11,39
SK Sturm Gra,2807,3,11,4,9,29,29,0,37
LASK Linz,2807,4,8,7,9,28,28,0,31
Vienna,2807,5,6,7,11,27,41,-14,25
SC Rheindorf,2807,6,6,5,13,22,33,-11,23
Mattersburg,2807,7,5,7,12,31,43,-12,22
FC Salzburg,2808,1,15,7,2,49,18,31,52
SK Sturm Gra,2808,2,13,4,7,36,29,7,43
Rapid Vienna,2808,3,8,10,6,35,27,8,34
LASK Linz,2808,4,8,5,11,28,32,-4,29
Vienna,2808,5,7,5,12,27,43,-16,26
SC Rheindorf,2808,6,6,6,12,18,27,-9,24
Mattersburg,2808,7,6,5,13,28,45,-17,23
FC Salzburg,2809,1,13,8,3,43,20,23,47
Rapid Vienna,2809,2,11,9,4,40,26,14,42
SK Sturm Gra,2809,3,12,4,8,33,31,2,40
LASK Linz,2809,4,10,5,9,30,28,2,35
Vienna,2809,5,7,5,12,25,38,-13,26
Mattersburg,2809,6,5,7,12,28,41,-13,22
SC Rheindorf,2809,7,4,6,14,18,33,-15,18
FC Salzburg,2810,1,15,7,2,45,18,27,52
SK Sturm Gra,2810,2,12,6,6,33,27,6,42
Rapid Vienna,2810,3,8,9,7,34,29,5,33
LASK Linz,2810,4,8,6,10,29,31,-2,30
SC Rheindorf,2810,5,6,6,12,19,27,-8,24
Mattersburg,2810,6,6,6,12,30,43,-13,24
Vienna,2810,7,6,6,12,25,40,-15,24
FC Salzburg,2811,1,14,6,4,44,22,22,48
SK Sturm Gra,2811,2,13,4,7,34,27,7,43
Rapid Vienna,2811,3,9,9,6,38,30,8,36
LASK Linz,2811,4,10,5,9,28,27,1,35
Vienna,2811,5,7,6,11,27,39,-12,27
SC Rheindorf,2811,6,5,6,13,22,31,-9,21
Mattersburg,2811,7,5,6,13,29,46,-17,21
FC Salzburg,2812,1,15,7,2,42,16,26,52
SK Sturm Gra,2812,2,14,3,7,33,26,7,45
Rapid Vienna,2812,3,7,11,6,34,28,6,32
LASK Linz,2812,4,7,7,10,25,28,-3,28
Mattersburg,2812,5,6,7,11,32,42,-10,25
Vienna,2812,6,6,7,11,27,41,-14,25
SC Rheindorf,2812,7,4,8,12,17,29,-12,20
FC Salzburg,2813,1,14,8,2,44,17,27,50
SK Sturm Gra,2813,2,12,5,7,31,28,3,41
Rapid Vienna,2813,3,8,12,4,35,26,9,36
Vienna,2813,4,7,6,11,29,40,-11,27
LASK Linz,2813,5,7,5,12,25,32,-7,26
Mattersburg,2813,6,7,5,12,32,44,-12,26
SC Rheindorf,2813,7,5,7,12,21,30,-9,22
FC Salzburg,2814,1,16,6,2,48,19,29,54
Rapid Vienna,2814,2,9,10,5,37,26,11,37
SK Sturm Gra,2814,3,11,3,10,29,30,-1,36
LASK Linz,2814,4,9,5,10,28,30,-2,32
Mattersburg,2814,5,8,5,11,35,41,-6,29
Vienna,2814,6,6,5,13,26,43,-17,23
SC Rheindorf,2814,7,5,6,13,17,31,-14,21
FC Salzburg,2815,1,14,7,3,42,17,25,49
SK Sturm Gra,2815,2,12,5,7,32,29,3,41
Rapid Vienna,2815,3,8,10,6,36,29,7,34
LASK Linz,2815,4,7,9,8,27,28,-1,30
Vienna,2815,5,7,5,12,24,38,-14,26
Mattersburg,2815,6,6,7,11,29,39,-10,25
SC Rheindorf,2815,7,5,7,12,21,31,-10,22
FC Salzburg,2816,1,15,7,2,45,19,26,52
SK Sturm Gra,2816,2,12,5,7,32,28,4,41
Rapid Vienna,2816,3,7,10,7,32,27,5,31
LASK Linz,2816,4,7,8,9,25,28,-3,29
SC Rheindorf,2816,5,7,6,11,23,28,-5,27
Mattersburg,2816,6,6,7,11,29,40,-11,25
Vienna,2816,7,6,5,13,24,40,-16,23
FC Salzburg,2817,1,13,7,4,40,18,22,46
SK Sturm Gra,2817,2,14,3,7,39,27,12,45
Rapid Vienna,2817,3,8,11,5,36,28,8,35
LASK Linz,2817,4,9,6,9,28,30,-2,33
Mattersburg,2817,5,8,5,11,32,39,-7,29
Vienna,2817,6,6,5,13,24,41,-17,23
SC Rheindorf,2817,7,4,7,13,16,32,-16,19
FC Salzburg,2818,1,15,6,3,43,19,24,51
SK Sturm Gra,2818,2,12,4,8,34,32,2,40
Rapid Vienna,2818,3,8,10,6,37,30,7,34
LASK Linz,2818,4,8,6,10,29,30,-1,30
Mattersburg,2818,5,7,6,11,31,39,-8,27
SC Rheindorf,2818,6,7,5,12,20,28,-8,26
Vienna,2818,7,6,5,13,25,41,-16,23
FC Salzburg,2819,1,14,7,3,49,20,29,49
SK Sturm Gra,2819,2,13,3,8,35,32,3,42
Rapid Vienna,2819,3,9,9,6,36,28,8,36
LASK Linz,2819,4,8,6,10,27,31,-4,30
Vienna,2819,5,7,6,11,28,41,-13,27
SC Rheindorf,2819,6,6,6,12,24,30,-6,24
Mattersburg,2819,7,6,5,13,30,47,-17,23
FC Salzburg,2820,1,15,7,2,49,18,31,52
SK Sturm Gra,2820,2,12,5,7,33,30,3,41
Rapid Vienna,2820,3,9,9,6,36,30,6,36
LASK Linz,2820,4,7,7,10,27,33,-6,28
Vienna,2820,5,7,5,12,26,40,-14,26
Mattersburg,2820,6,6,6,12,33,43,-10,24
SC Rheindorf,2820,7,6,5,13,23,33,-10,23
FC Salzburg,2821,1,14,7,3,47,23,24,49
SK Sturm Gra,2821,2,13,4,7,35,31,4,43
Rapid Vienna,2821,3,7,11,6,39,34,5,32
LASK Linz,2821,4,7,7,10,28,32,-4,28
SC Rheindorf,2821,5,7,6,11,23,27,-4,27
Vienna,2821,6,7,5,12,26,40,-14,26
Mattersburg,2821,7,5,8,11,31,42,-11,23
FC Salzburg,2822,1,15,6,3,44,18,26,51
SK Sturm Gra,2822,2,12,3,9,32,33,-1,39
LASK Linz,2822,3,10,5,9,28,26,2,35
Rapid Vienna,2822,4,8,9,7,35,29,6,33
Mattersburg,2822,5,8,5,11,34,42,-8,29
Vienna,2822,6,7,5,12,26,39,-13,26
SC Rheindorf,2822,7,5,5,14,20,32,-12,20
FC Salzburg,2823,1,15,7,2,50,19,31,52
SK Sturm Gra,2823,2,12,4,8,34,30,4,40
Rapid Vienna,2823,3,9,9,6,38,28,10,36
LASK Linz,2823,4,8,8,8,31,31,0,32
Mattersburg,2823,5,6,7,11,31,44,-13,25
Vienna,2823,6,6,6,12,25,40,-15,24
SC Rheindorf,2823,7,4,7,13,17,34,-17,19
FC Salzburg,2824,1,14,6,4,40,17,23,48
SK Sturm Gra,2824,2,13,3,8,34,29,5,42
Rapid Vienna,2824,3,9,9,6,36,27,9,36
LASK Linz,2824,4,9,5,10,28,30,-2,32
Mattersburg,2824,5,7,6,11,32,41,-9,27
Vienna,2824,6,7,6,11,25,38,-13,27
SC Rheindorf,2824,7,5,5,14,20,33,-13,20
FC Salzburg,2825,1,14,7,3,44,19,25,49
SK Sturm Gra,2825,2,13,4,7,38,31,7,43
Rapid Vienna,2825,3,9,9,6,39,32,7,36
LASK Linz,2825,4,9,5,10,30,32,-2,32
Vienna,2825,5,8,5,11,30,39,-9,29
Mattersburg,2825,6,6,6,12,33,46,-13,24
SC Rheindorf,2825,7,4,6,14,21,36,-15,18
FC Salzburg,2826,1,16,6,2,50,16,34,54
SK Sturm Gra,2826,2,14,3,7,33,29,4,45
Rapid Vienna,2826,3,8,9,7,35,32,3,33
LASK Linz,2826,4,8,5,11,28,29,-1,29
Mattersburg,2826,5,8,5,11,32,39,-7,29
Vienna,2826,6,6,5,13,23,39,-16,23
SC Rheindorf,2826,7,5,5,14,16,33,-17,20
FC Salzburg,2827,1,13,9,2,45,20,25,48
SK Sturm Gra,2827,2,13,3,8,32,29,3,42
Rapid Vienna,2827,3,7,11,6,32,28,4,32
LASK Linz,2827,4,8,5,11,28,29,-1,29
Mattersburg,2827,5,6,8,10,29,38,-9,26
SC Rheindorf,2827,6,6,7,11,19,27,-8,25
Vienna,2827,7,6,7,11,25,39,-14,25
FC Salzburg,2828,1,15,7,2,50,21,29,52
SK Sturm Gra,2828,2,13,4,7,33,30,3,43
Rapid Vienna,2828,3,8,11,5,36,29,7,35
LASK Linz,2828,4,8,5,11,26,28,-2,29
Mattersburg,2828,5,7,6,11,32,41,-9,27
Vienna,2828,6,6,6,12,25,40,-15,24
SC Rheindorf,2828,7,4,7,13,16,29,-13,19
FC Salzburg,2829,1,13,9,2,45,20,25,48
SK Sturm Gra,2829,2,13,4,7,36,29,7,43
Rapid Vienna,2829,3,10,10,4,36,25,11,40
LASK Linz,2829,4,8,5,11,27,32,-5,29
Vienna,2829,5,6,7,11,26,40,-14,25
SC Rheindorf,2829,6,6,5,13,19,29,-10,23
Mattersburg,2829,7,5,6,13,29,43,-14,21
FC Salzburg,2830,1,15,7,2,45,17,28,52
SK Sturm Gra,2830,2,12,5,7,30,27,3,41
Rapid Vienna,2830,3,8,11,5,33,25,8,35
LASK Linz,2830,4,7,7,10,28,34,-6,28
Vienna,2830,5,7,6,11,26,39,-13,27
Mattersburg,2830,6,7,5,12,33,40,-7,26
SC Rheindorf,2830,7,5,5,14,18,31,-13,20
FC Salzburg,2831,1,12,8,4,40,19,21,44
SK Sturm Gra,2831,2,12,4,8,31,27,4,40
Rapid Vienna,2831,3,9,10,5,39,29,10,37
LASK Linz,2831,4,9,6,9,28,29,-1,33
Mattersburg,2831,5,7,6,11,35,41,-6,27
Vienna,2831,6,7,5,12,25,39,-14,26
SC Rheindorf,2831,7,6,5,13,21,35,-14,23
FC Salzburg,2832,1,12,9,3,42,21,21,45
SK Sturm Gra,2832,2,12,6,6,33,28,5,42
Rapid Vienna,2832,3,9,10,5,39,29,10,37
LASK Linz,2832,4,8,8,8,31,31,0,32
Mattersburg,2832,5,6,7,11,31,40,-9,25
Vienna,2832,6,6,7,11,24,38,-14,25
SC Rheindorf,2832,7,4,7,13,17,30,-13,19
FC Salzburg,2833,1,15,6,3,42,17,25,51
SK Sturm Gra,2833,2,11,6,7,33,30,3,39
Rapid Vienna,2833,3,8,11,5,36,26,10,35
Vienna,2833,4,8,5,11,25,37,-12,29
LASK Linz,2833,5,7,7,10,28,34,-6,28
SC Rheindorf,2833,6,6,7,11,24,31,-7,25
Mattersburg,2833,7,5,6,13,31,44,-13,21
FC Salzburg,2834,1,15,6,3,45,18,27,51
SK Sturm Gra,2834,2,12,3,9,30,29,1,39
Rapid Vienna,2834,3,9,10,5,35,27,8,37
LASK Linz,2834,4,7,8,9,26,28,-2,29
Vienna,2834,5,7,5,12,26,40,-14,26
Mattersburg,2834,6,6,7,11,29,39,-10,25
SC Rheindorf,2834,7,5,7,12,17,27,-10,22
FC Salzburg,2835,1,14,7,3,43,19,24,49
SK Sturm Gra,2835,2,12,6,6,32,27,5,42
Rapid Vienna,2835,3,9,9,6,39,31,8,36
LASK Linz,2835,4,8,7,9,28,29,-1,31
Vienna,2835,5,8,5,11,26,37,-11,29
SC Rheindorf,2835,6,5,7,12,21,30,-9,22
Mattersburg,2835,7,5,5,14,28,44,-16,20
FC Salzburg,2836,1,14,8,2,46,18,28,50
SK Sturm Gra,2836,2,12,6,6,32,27,5,42
Rapid Vienna,2836,3,8,10,6,36,32,4,34
LASK Linz,2836,4,8,6,10,28,29,-1,30
Mattersburg,2836,5,7,6,11,34,39,-5,27
Vienna,2836,6,7,5,12,25,40,-15,26
SC Rheindorf,2836,7,4,7,13,18,34,-16,19
FC Salzburg,2837,1,14,7,3,44,18,26,49
Rapid Vienna,2837,2,10,10,4,37,24,13,40
SK Sturm Gra,2837,3,12,4,8,34,33,1,40
LASK Linz,2837,4,8,5,11,28,33,-5,29
Mattersburg,2837,5,7,5,12,32,42,-10,26
Vienna,2837,6,6,6,12,25,40,-15,24
SC Rheindorf,2837,7,6,5,13,19,29,-10,23
FC Salzburg,2838,1,14,7,3,47,17,30,49
SK Sturm Gra,2838,2,13,4,7,32,30,2,43
Rapid Vienna,2838,3,8,11,5,36,28,8,35
Mattersburg,2838,4,8,5,11,33,43,-10,29
LASK Linz,2838,5,7,5,12,24,29,-5,26
Vienna,2838,6,7,5,12,26,40,-14,26
SC Rheindorf,2838,7,5,7,12,21,32,-11,22
FC Salzburg,2839,1,14,6,4,45,19,26,48
SK Sturm Gra,2839,2,12,4,8,32,31,1,40
Rapid Vienna,2839,3,9,10,5,36,28,8,37
LASK Linz,2839,4,8,6,10,29,29,0,30
Vienna,2839,5,7,6,11,27,40,-13,27
SC Rheindorf,2839,6,6,7,11,21,26,-5,25
Mattersburg,2839,7,5,7,12,28,45,-17,22
FC Salzburg,2840,1,16,6,2,50,21,29,54
SK Sturm Gra,2840,2,12,3,9,35,34,1,39
Rapid Vienna,2840,3,8,9,7,35,29,6,33
LASK Linz,2840,4,8,7,9,26,29,-3,31
SC Rheindorf,2840,5,7,6,11,22,27,-5,27
Vienna,2840,6,7,5,12,25,39,-14,26
Mattersburg,2840,7,5,6,13,30,44,-14,21
FC Salzburg,2841,1,15,7,2,44,15,29,52
SK Sturm Gra,2841,2,12,4,8,33,29,4,40
Rapid Vienna,2841,3,8,11,5,35,29,6,35
LASK Linz,2841,4,8,6,10,26,31,-5,30
Vienna,2841,5,7,6,11,27,38,-11,27
Mattersburg,2841,6,6,6,12,29,41,-12,24
SC Rheindorf,2841,7,5,6,13,19,30,-11,21
FC Salzburg,2842,1,14,8,2,48,17,31,50
SK Sturm Gra,2842,2,14,4,6,32,25,7,46
Rapid Vienna,2842,3,8,10,6,32,25,7,34
LASK Linz,2842,4,8,6,10,27,29,-2,30
Mattersburg,2842,5,7,6,11,31,43,-12,27
Vienna,2842,6,6,6,12,26,44,-18,24
SC Rheindorf,2842,7,4,6,14,17,30,-13,18
FC Salzburg,2843,1,15,6,3,45,18,27,51
SK Sturm Gra,2843,2,11,4,9,31,30,1,37
LASK Linz,2843,3,10,5,9,29,27,2,35
Rapid Vienna,2843,4,8,10,6,35,29,6,34
Mattersburg,2843,5,7,5,12,32,44,-12,26
Vienna,2843,6,7,5,12,25,40,-15,26
SC Rheindorf,2843,7,5,7,12,21,30,-9,22
FC Salzburg,2844,1,13,9,2,44,19,25,48
SK Sturm Gra,2844,2,11,4,9,30,31,-1,37
Rapid Vienna,2844,3,7,13,4,34,26,8,34
LASK Linz,2844,4,8,6,10,26,31,-5,30
SC Rheindorf,2844,5,7,6,11,24,28,-4,27
Vienna,2844,6,7,6,11,27,40,-13,27
Mattersburg,2844,7,6,6,12,30,40,-10,24
FC Salzburg,2845,1,13,8,3,46,23,23,47
SK Sturm Gra,2845,2,11,7,6,32,28,4,40
Rapid Vienna,2845,3,9,11,4,39,27,12,38
LASK Linz,2845,4,7,8,9,25,28,-3,29
Vienna,2845,5,7,6,11,28,39,-11,27
SC Rheindorf,2845,6,6,6,12,21,29,-8,24
Mattersburg,2845,7,5,6,13,30,47,-17,21
FC Salzburg,2846,1,16,6,2,51,18,33,54
SK Sturm Gra,2846,2,11,4,9,32,33,-1,37
LASK Linz,2846,3,9,7,8,28,26,2,34
Rapid Vienna,2846,4,8,9,7,35,30,5,33
Mattersburg,2846,5,6,7,11,28,40,-12,25
Vienna,2846,6,6,6,12,24,40,-16,24
SC Rheindorf,2846,7,6,5,13,19,30,-11,23
FC Salzburg,2847,1,15,6,3,45,19,26,51
SK Sturm Gra,2847,2,12,4,8,31,28,3,40
Rapid Vienna,2847,3,10,9,5,38,29,9,39
LASK Linz,2847,4,8,6,10,27,29,-2,30
Mattersburg,2847,5,7,6,11,33,42,-9,27
Vienna,2847,6,6,6,12,24,39,-15,24
SC Rheindorf,2847,7,5,5,14,18,30,-12,20
FC Salzburg,2848,1,14,7,3,46,19,27,49
SK Sturm Gra,2848,2,12,4,8,33,30,3,40
Rapid Vienna,2848,3,9,9,6,37,27,10,36
LASK Linz,2848,4,9,6,9,28,27,1,33
Mattersburg,2848,5,7,6,11,31,42,-11,27
Vienna,2848,6,6,7,11,25,39,-14,25
SC Rheindorf,2848,7,5,5,14,18,34,-16,20
FC Salzburg,2849,1,14,8,2,44,16,28,50
Rapid Vienna,2849,2,10,9,5,35,25,10,39
SK Sturm Gra,2849,3,12,3,9,30,32,-2,39
LASK Linz,2849,4,8,6,10,28,29,-1,30
Vienna,2849,5,7,6,11,25,38,-13,27
Mattersburg,2849,6,5,8,11,30,41,-11,23
SC Rheindorf,2849,7,5,6,13,20,31,-11,21
FC Salzburg,2850,1,15,7,2,49,18,31,52
SK Sturm Gra,2850,2,13,4,7,32,28,4,43
LASK Linz,2850,3,10,5,9,29,27,2,35
Rapid Vienna,2850,4,7,11,6,34,29,5,32
Vienna,2850,5,7,5,12,26,41,-15,26
SC Rheindorf,2850,6,6,5,13,18,28,-10,23
Mattersburg,2850,7,5,5,14,29,46,-17,20
FC Salzburg,2851,1,15,7,2,45,17,28,52
SK Sturm Gra,2851,2,13,4,7,37,29,8,43
Rapid Vienna,2851,3,8,10,6,37,31,6,34
LASK Linz,2851,4,9,5,10,30,32,-2,32
Vienna,2851,5,6,7,11,24,38,-14,25
Mattersburg,2851,6,5,7,12,27,42,-15,22
SC Rheindorf,2851,7,5,6,13,18,29,-11,21
FC Salzburg,2852,1,13,9,2,44,19,25,48
SK Sturm Gra,2852,2,11,6,7,31,29,2,39
Rapid Vienna,2852,3,8,12,4,36,24,12,36
LASK Linz,2852,4,8,6,10,27,31,-4,30
Mattersburg,2852,5,7,6,11,33,42,-9,27
Vienna,2852,6,7,5,12,26,41,-15,26
SC Rheindorf,2852,7,4,8,12,18,29,-11,20
FC Salzburg,2853,1,15,6,3,44,18,26,51
SK Sturm Gra,2853,2,11,4,9,29,28,1,37
Rapid Vienna,2853,3,8,11,5,33,25,8,35
LASK Linz,2853,4,9,7,8,28,27,1,34
Vienna,2853,5,7,5,12,26,41,-15,26
Mattersburg,2853,6,6,6,12,31,41,-10,24
SC Rheindorf,2853,7,6,5,13,19,30,-11,23
FC Salzburg,2854,1,13,8,3,41,17,24,47
SK Sturm Gra,2854,2,12,6,6,32,26,6,42
Rapid Vienna,2854,3,9,9,6,36,29,7,36
LASK Linz,2854,4,8,7,9,26,28,-2,31
SC Rheindorf,2854,5,6,6,12,24,30,-6,24
Mattersburg,2854,6,6,6,12,28,42,-14,24
Vienna,2854,7,6,6,12,23,38,-15,24
FC Salzburg,2855,1,14,6,4,43,19,24,48
SK Sturm Gra,2855,2,12,5,7,32,28,4,41
Rapid Vienna,2855,3,9,11,4,35,25,10,38
LASK Linz,2855,4,8,5,11,27,31,-4,29
Vienna,2855,5,8,5,11,27,39,-12,29
Mattersburg,2855,6,7,5,12,29,39,-10,26
SC Rheindorf,2855,7,4,7,13,15,27,-12,19
FC Salzburg,2856,1,13,7,4,42,22,20,46
SK Sturm Gra,2856,2,12,5,7,34,29,5,41
Rapid Vienna,2856,3,9,10,5,39,27,12,37
LASK Linz,2856,4,8,7,9,27,29,-2,31
Vienna,2856,5,7,5,12,27,39,-12,26
SC Rheindorf,2856,6,6,6,12,20,30,-10,24
Mattersburg,2856,7,5,8,11,28,41,-13,23
FC Salzburg,2857,1,15,6,3,47,19,28,51
SK Sturm Gra,2857,2,14,3,7,34,26,8,45
Rapid Vienna,2857,3,10,9,5,38,26,12,39
LASK Linz,2857,4,8,5,11,25,31,-6,29
Mattersburg,2857,5,7,5,12,35,43,-8,26
Vienna,2857,6,7,5,12,27,41,-14,26
SC Rheindorf,2857,7,4,5,15,16,36,-20,17
FC Salzburg,2858,1,14,7,3,45,19,26,49
SK Sturm Gra,2858,2,12,4,8,34,31,3,40
LASK Linz,2858,3,9,6,9,32,29,3,33
Rapid Vienna,2858,4,7,10,7,31,32,-1,31
SC Rheindorf,2858,5,8,5,11,23,25,-2,29
Vienna,2858,6,7,5,12,26,41,-15,26
Mattersburg,2858,7,6,5,13,30,44,-14,23
SK Sturm Gra,2859,1,15,3,6,37,28,9,48
FC Salzburg,2859,2,13,8,3,44,21,23,47
Rapid Vienna,2859,3,7,11,6,35,31,4,32
LASK Linz,2859,4,8,5,11,28,31,-3,29
Vienna,2859,5,7,5,12,27,40,-13,26
Mattersburg,2859,6,6,7,11,31,42,-11,25
SC Rheindorf,2859,7,5,7,12,22,31,-9,22
FC Salzburg,2860,1,14,7,3,47,21,26,49
SK Sturm Gra,2860,2,12,5,7,36,32,4,41
Rapid Vienna,2860,3,8,9,7,34,30,4,33
LASK Linz,2860,4,9,6,9,28,27,1,33
Vienna,2860,5,8,5,11,30,38,-8,29
SC Rheindorf,2860,6,5,8,11,21,30,-9,23
Mattersburg,2860,7,5,6,13,28,46,-18,21
FC Salzburg,2861,1,13,7,4,43,19,24,46
SK Sturm Gra,2861,2,12,3,9,32,32,0,39
Rapid Vienna,2861,3,9,10,5,34,25,9,37
LASK Linz,2861,4,8,6,10,26,30,-4,30
Vienna,2861,5,8,5,11,28,39,-11,29
SC Rheindorf,2861,6,7,5,12,22,28,-6,26
Mattersburg,2861,7,6,6,12,27,39,-12,24
FC Salzburg,2862,1,16,6,2,52,18,34,54
SK Sturm Gra,2862,2,12,5,7,35,29,6,41
Rapid Vienna,2862,3,8,10,6,36,31,5,34
LASK Linz,2862,4,8,7,9,27,27,0,31
Mattersburg,2862,5,7,6,11,34,42,-8,27
Vienna,2862,6,6,5,13,25,48,-23,23
SC Rheindorf,2862,7,4,7,13,18,32,-14,19
FC Salzburg,2863,1,15,7,2,45,18,27,52
SK Sturm Gra,2863,2,14,3,7,34,27,7,45
Rapid Vienna,2863,3,9,10,5,37,28,9,37
LASK Linz,2863,4,7,5,12,27,33,-6,26
Mattersburg,2863,5,7,5,12,32,43,-11,26
Vienna,2863,6,7,5,12,27,40,-13,26
SC Rheindorf,2863,7,5,5,14,19,32,-13,20
FC Salzburg,2864,1,15,6,3,44,18,26,51
SK Sturm Gra,2864,2,12,4,8,33,32,1,40
LASK Linz,2864,3,9,6,9,32,31,1,33
Rapid Vienna,2864,4,7,9,8,34,38,-4,30
SC Rheindorf,2864,5,7,5,12,27,30,-3,26
Mattersburg,2864,6,7,5,12,35,42,-7,26
Vienna,2864,7,7,5,12,25,39,-14,26
FC Salzburg,2865,1,14,8,2,45,18,27,50
SK Sturm Gra,2865,2,13,4,7,36,29,7,43
Rapid Vienna,2865,3,8,10,6,36,30,6,34
LASK Linz,2865,4,8,7,9,26,30,-4,31
Mattersburg,2865,5,8,5,11,36,41,-5,29
Vienna,2865,6,6,6,12,26,41,-15,24
SC Rheindorf,2865,7,4,6,14,17,33,-16,18
FC Salzburg,2866,1,15,6,3,45,17,28,51
SK Sturm Gra,2866,2,14,3,7,36,29,7,45
Rapid Vienna,2866,3,8,9,7,35,31,4,33
LASK Linz,2866,4,9,6,9,30,28,2,33
Vienna,2866,5,7,5,12,27,41,-14,26
Mattersburg,2866,6,6,6,12,30,43,-13,24
SC Rheindorf,2866,7,5,5,14,19,33,-14,20
FC Salzburg,2867,1,15,7,2,48,18,30,52
Rapid Vienna,2867,2,9,10,5,34,25,9,37
SK Sturm Gra,2867,3,11,3,10,29,31,-2,36
LASK Linz,2867,4,9,7,8,25,24,1,34
Vienna,2867,5,7,5,12,25,40,-15,26
Mattersburg,2867,6,5,8,11,30,41,-11,23
SC Rheindorf,2867,7,5,6,13,19,31,-12,21
FC Salzburg,2868,1,13,7,4,42,20,22,46
SK Sturm Gra,2868,2,12,4,8,32,29,3,40
Rapid Vienna,2868,3,9,10,5,35,24,11,37
Vienna,2868,4,8,5,11,31,40,-9,29
LASK Linz,2868,5,7,7,10,26,32,-6,28
SC Rheindorf,2868,6,7,6,11,20,26,-6,27
Mattersburg,2868,7,5,7,12,29,44,-15,22
FC Salzburg,2869,1,15,7,2,51,18,33,52
SK Sturm Gra,2869,2,12,5,7,31,30,1,41
Rapid Vienna,2869,3,8,10,6,37,29,8,34
LASK Linz,2869,4,9,6,9,28,28,0,33
Vienna,2869,5,7,6,11,26,39,-13,27
SC Rheindorf,2869,6,6,5,13,19,30,-11,23
Mattersburg,2869,7,5,5,14,28,46,-18,20
FC Salzburg,2870,1,14,7,3,46,16,30,49
SK Sturm Gra,2870,2,11,6,7,30,27,3,39
Rapid Vienna,2870,3,9,10,5,35,26,9,37
LASK Linz,2870,4,8,6,10,27,28,-1,30
Mattersburg,2870,5,7,6,11,32,44,-12,27
Vienna,2870,6,6,6,12,25,42,-17,24
SC Rheindorf,2870,7,6,5,13,19,31,-12,23
FC Salzburg,2871,1,15,7,2,43,16,27,52
SK Sturm Gra,2871,2,12,5,7,33,28,5,41
Rapid Vienna,2871,3,8,11,5,34,27,7,35
LASK Linz,2871,4,9,6,9,27,26,1,33
Vienna,2871,5,7,5,12,28,41,-13,26
Mattersburg,2871,6,6,6,12,30,43,-13,24
SC Rheindorf,2871,7,4,6,14,16,30,-14,18
FC Salzburg,2872,1,15,6,3,46,18,28,51
SK Sturm Gra,2872,2,12,3,9,31,31,0,39
Rapid Vienna,2872,3,9,9,6,36,27,9,36
LASK Linz,2872,4,8,5,11,26,31,-5,29
SC Rheindorf,2872,5,7,5,12,20,29,-9,26
Mattersburg,2872,6,7,5,12,33,44,-11,26
Vienna,2872,7,7,5,12,28,40,-12,26
FC Salzburg,2873,1,15,7,2,45,18,27,52
SK Sturm Gra,2873,2,12,5,7,33,28,5,41
Rapid Vienna,2873,3,9,9,6,34,26,8,36
LASK Linz,2873,4,9,6,9,28,28,0,33
Mattersburg,2873,5,7,6,11,33,41,-8,27
Vienna,2873,6,6,5,13,23,39,-16,23
SC Rheindorf,2873,7,4,6,14,17,33,-16,18
FC Salzburg,2874,1,15,7,2,49,16,33,52
SK Sturm Gra,2874,2,13,3,8,33,34,-1,42
Rapid Vienna,2874,3,8,11,5,33,25,8,35
LASK Linz,2874,4,8,5,11,28,32,-4,29
SC Rheindorf,2874,5,7,6,11,22,27,-5,27
Vienna,2874,6,7,5,12,27,43,-16,26
Mattersburg,2874,7,5,5,14,30,45,-15,20
FC Salzburg,2875,1,14,7,3,44,20,24,49
SK Sturm Gra,2875,2,12,4,8,34,30,4,40
Rapid Vienna,2875,3,10,9,5,39,28,11,39
LASK Linz,2875,4,7,6,11,29,34,-5,27
Vienna,2875,5,7,6,11,28,38,-10,27
Mattersburg,2875,6,7,5,12,32,45,-13,26
SC Rheindorf,2875,7,6,5,13,22,33,-11,23
FC Salzburg,2876,1,14,6,4,43,18,25,48
Rapid Vienna,2876,2,10,10,4,38,25,13,40
SK Sturm Gra,2876,3,12,3,9,31,29,2,39
LASK Linz,2876,4,9,6,9,28,29,-1,33
Mattersburg,2876,5,7,6,11,33,41,-8,27
Vienna,2876,6,7,5,12,25,41,-16,26
SC Rheindorf,2876,7,4,6,14,18,33,-15,18
FC Salzburg,2877,1,15,6,3,43,17,26,51
SK Sturm Gra,2877,2,13,4,7,32,27,5,43
Rapid Vienna,2877,3,9,9,6,38,28,10,36
LASK Linz,2877,4,8,5,11,28,31,-3,29
Mattersburg,2877,5,8,5,11,35,41,-6,29
Vienna,2877,6,7,5,12,25,40,-15,26
SC Rheindorf,2877,7,4,6,14,20,37,-17,18
FC Salzburg,2878,1,12,7,5,41,22,19,43
SK Sturm Gra,2878,2,12,6,6,36,29,7,42
Rapid Vienna,2878,3,10,10,4,37,24,13,40
Vienna,2878,4,8,5,11,28,37,-9,29
LASK Linz,2878,5,7,6,11,28,35,-7,27
Mattersburg,2878,6,7,6,11,32,41,-9,27
SC Rheindorf,2878,7,5,6,13,16,30,-14,21
FC Salzburg,2879,1,16,6,2,47,18,29,54
SK Sturm Gra,2879,2,13,4,7,31,27,4,43
Rapid Vienna,2879,3,8,10,6,35,26,9,34
LASK Linz,2879,4,7,7,10,25,30,-5,28
SC Rheindorf,2879,5,6,6,12,20,30,-10,24
Vienna,2879,6,6,6,12,25,40,-15,24
Mattersburg,2879,7,5,7,12,31,43,-12,22
FC Salzburg,2880,1,14,8,2,46,18,28,50
SK Sturm Gra,2880,2,11,3,10,29,31,-2,36
Rapid Vienna,2880,3,8,9,7,36,31,5,33
LASK Linz,2880,4,9,6,9,27,31,-4,33
Mattersburg,2880,5,8,6,10,36,39,-3,30
SC Rheindorf,2880,6,6,6,12,19,28,-9,24
Vienna,2880,7,6,6,12,25,40,-15,24
FC Salzburg,2881,1,15,6,3,44,16,28,51
SK Sturm Gra,2881,2,13,4,7,35,29,6,43
LASK Linz,2881,3,10,6,8,29,24,5,36
Rapid Vienna,2881,4,7,9,8,33,29,4,30
Vienna,2881,5,7,5,12,25,39,-14,26
Mattersburg,2881,6,6,6,12,29,44,-15,24
SC Rheindorf,2881,7,5,6,13,18,32,-14,21
FC Salzburg,2882,1,13,8,3,42,18,24,47
SK Sturm Gra,2882,2,13,4,7,31,26,5,43
Rapid Vienna,2882,3,8,11,5,33,25,8,35
LASK Linz,2882,4,9,7,8,29,26,3,34
Vienna,2882,5,7,5,12,27,42,-15,26
Mattersburg,2882,6,5,8,11,31,42,-11,23
SC Rheindorf,2882,7,4,7,13,16,30,-14,19
FC Salzburg,2883,1,15,6,3,47,20,27,51
SK Sturm Gra,2883,2,13,4,7,39,30,9,43
Rapid Vienna,2883,3,8,11,5,35,29,6,35
LASK Linz,2883,4,9,6,9,26,27,-1,33
Vienna,2883,5,7,5,12,26,40,-14,26
Mattersburg,2883,6,6,5,13,29,44,-15,23
SC Rheindorf,2883,7,4,7,13,18,30,-12,19
FC Salzburg,2884,1,15,7,2,44,17,27,52
SK Sturm Gra,2884,2,14,3,7,36,27,9,45
Rapid Vienna,2884,3,8,9,7,35,32,3,33
LASK Linz,2884,4,7,6,11,28,37,-9,27
Mattersburg,2884,5,6,8,10,34,41,-7,26
Vienna,2884,6,6,6,12,26,41,-15,24
SC Rheindorf,2884,7,5,7,12,21,29,-8,22
FC Salzburg,2885,1,14,7,3,46,20,26,49
SK Sturm Gra,2885,2,12,5,7,33,29,4,41
Rapid Vienna,2885,3,10,9,5,36,25,11,39
Mattersburg,2885,4,8,5,11,35,40,-5,29
LASK Linz,2885,5,7,6,11,25,30,-5,27
Vienna,2885,6,7,5,12,26,42,-16,26
SC Rheindorf,2885,7,5,5,14,18,33,-15,20
FC Salzburg,2886,1,14,7,3,45,19,26,49
SK Sturm Gra,2886,2,12,3,9,31,31,0,39
Rapid Vienna,2886,3,9,11,4,37,27,10,38
LASK Linz,2886,4,8,6,10,29,31,-2,30
Mattersburg,2886,5,7,5,12,33,42,-9,26
SC Rheindorf,2886,6,6,6,12,23,33,-10,24
Vienna,2886,7,6,6,12,24,39,-15,24
SK Sturm Gra,2887,1,14,4,6,34,26,8,46
FC Salzburg,2887,2,12,7,5,39,21,18,43
Rapid Vienna,2887,3,8,10,6,37,29,8,34
Vienna,2887,4,8,5,11,27,39,-12,29
LASK Linz,2887,5,7,7,10,25,28,-3,28
Mattersburg,2887,6,7,6,11,32,40,-8,27
SC Rheindorf,2887,7,6,5,13,19,30,-11,23
FC Salzburg,2888,1,14,6,4,43,21,22,48
SK Sturm Gra,2888,2,13,4,7,34,28,6,43
Rapid Vienna,2888,3,9,10,5,40,28,12,37
LASK Linz,2888,4,8,6,10,27,31,-4,30
Vienna,2888,5,8,5,11,29,37,-8,29
SC Rheindorf,2888,6,6,6,12,21,31,-10,24
Mattersburg,2888,7,5,5,14,29,47,-18,20
FC Salzburg,2889,1,14,8,2,44,18,26,50
SK Sturm Gra,2889,2,13,5,6,34,26,8,44
Rapid Vienna,2889,3,8,12,4,37,28,9,36
LASK Linz,2889,4,7,5,12,26,32,-6,26
Mattersburg,2889,5,7,5,12,32,43,-11,26
Vienna,2889,6,7,5,12,29,41,-12,26
SC Rheindorf,2889,7,5,6,13,19,33,-14,21
FC Salzburg,2890,1,14,7,3,43,18,25,49
SK Sturm Gra,2890,2,13,4,7,37,26,11,43
Rapid Vienna,2890,3,9,9,6,35,33,2,36
LASK Linz,2890,4,8,6,10,26,30,-4,30
Vienna,2890,5,7,6,11,26,39,-13,27
Mattersburg,2890,6,6,6,12,31,42,-11,24
SC Rheindorf,2890,7,5,6,13,20,30,-10,21
FC Salzburg,2891,1,14,6,4,46,20,26,48
SK Sturm Gra,2891,2,12,4,8,32,31,1,40
LASK Linz,2891,3,10,6,8,29,26,3,36
Rapid Vienna,2891,4,8,10,6,36,30,6,34
Vienna,2891,5,8,5,11,27,39,-12,29
SC Rheindorf,2891,6,6,6,12,20,29,-9,24
Mattersburg,2891,7,5,5,14,27,42,-15,20
FC Salzburg,2892,1,14,6,4,44,20,24,48
Rapid Vienna,2892,2,11,9,4,38,26,12,42
SK Sturm Gra,2892,3,13,3,8,33,31,2,42
Mattersburg,2892,4,9,5,10,42,39,3,32
LASK Linz,2892,5,7,5,12,25,34,-9,26
Vienna,2892,6,6,5,13,25,42,-17,23
SC Rheindorf,2892,7,5,5,14,19,34,-15,20
FC Salzburg,2893,1,13,9,2,43,19,24,48
SK Sturm Gra,2893,2,12,6,6,32,25,7,42
Rapid Vienna,2893,3,7,12,5,36,29,7,33
LASK Linz,2893,4,9,6,9,31,29,2,33
Mattersburg,2893,5,6,8,10,34,42,-8,26
Vienna,2893,6,6,6,12,27,42,-15,24
SC Rheindorf,2893,7,4,7,13,16,33,-17,19
FC Salzburg,2894,1,15,7,2,47,17,30,52
SK Sturm Gra,2894,2,13,5,6,34,27,7,44
Rapid Vienna,2894,3,9,9,6,39,30,9,36
LASK Linz,2894,4,8,5,11,26,29,-3,29
Mattersburg,2894,5,6,6,12,29,42,-13,24
Vienna,2894,6,6,6,12,24,40,-16,24
SC Rheindorf,2894,7,5,6,13,17,31,-14,21
FC Salzburg,2895,1,15,7,2,48,16,32,52
SK Sturm Gra,2895,2,13,3,8,33,31,2,42
Rapid Vienna,2895,3,9,9,6,35,27,8,36
LASK Linz,2895,4,7,5,12,25,33,-8,26
Mattersburg,2895,5,6,7,11,32,44,-12,25
Vienna,2895,6,6,7,11,26,40,-14,25
SC Rheindorf,2895,7,6,6,12,20,28,-8,24
FC Salzburg,2896,1,13,7,4,41,19,22,46
SK Sturm Gra,2896,2,12,4,8,31,28,3,40
Rapid Vienna,2896,3,8,11,5,33,26,7,35
LASK Linz,2896,4,8,6,10,27,30,-3,30
Mattersburg,2896,5,7,7,10,30,38,-8,28
Vienna,2896,6,7,6,11,25,37,-12,27
SC Rheindorf,2896,7,5,7,12,19,28,-9,22
FC Salzburg,2897,1,14,7,3,46,22,24,49
SK Sturm Gra,2897,2,12,4,8,31,28,3,40
Rapid Vienna,2897,3,8,10,6,37,30,7,34
LASK Linz,2897,4,9,6,9,33,30,3,33
Vienna,2897,5,7,5,12,26,41,-15,26
Mattersburg,2897,6,6,6,12,34,45,-11,24
SC Rheindorf,2897,7,6,6,12,20,31,-11,24
FC Salzburg,2898,1,14,7,3,44,16,28,49
SK Sturm Gra,2898,2,13,4,7,32,26,6,43
LASK Linz,2898,3,10,6,8,27,24,3,36
Rapid Vienna,2898,4,8,11,5,33,26,7,35
Vienna,2898,5,7,5,12,24,39,-15,26
SC Rheindorf,2898,6,5,6,13,20,31,-11,21
Mattersburg,2898,7,5,5,14,28,46,-18,20
FC Salzburg,2899,1,13,8,3,44,19,25,47
SK Sturm Gra,2899,2,13,4,7,37,28,9,43
Rapid Vienna,2899,3,10,10,4,38,27,11,40
LASK Linz,2899,4,7,7,10,25,31,-6,28
Mattersburg,2899,5,6,8,10,30,38,-8,26
Vienna,2899,6,6,5,13,23,42,-19,23
SC Rheindorf,2899,7,4,8,12,17,29,-12,20
FC Salzburg,2900,1,14,7,3,43,17,26,49
Rapid Vienna,2900,2,10,10,4,37,24,13,40
SK Sturm Gra,2900,3,11,3,10,29,31,-2,36
LASK Linz,2900,4,10,5,9,32,32,0,35
Vienna,2900,5,7,6,11,25,38,-13,27
SC Rheindorf,2900,6,6,5,13,19,29,-10,23
Mattersburg,2900,7,5,6,13,31,45,-14,21
FC Salzburg,2901,1,14,7,3,46,21,25,49
SK Sturm Gra,2901,2,12,4,8,33,30,3,40
Rapid Vienna,2901,3,9,9,6,36,26,10,36
LASK Linz,2901,4,9,5,10,30,32,-2,32
SC Rheindorf,2901,5,6,7,11,21,29,-8,25
Mattersburg,2901,6,6,6,12,32,45,-13,24
Vienna,2901,7,6,6,12,24,39,-15,24
FC Salzburg,2902,1,15,6,3,46,19,27,51
SK Sturm Gra,2902,2,13,3,8,34,30,4,42
Rapid Vienna,2902,3,8,10,6,34,27,7,34
LASK Linz,2902,4,9,6,9,31,28,3,33
SC Rheindorf,2902,5,7,5,12,19,27,-8,26
Vienna,2902,6,7,5,12,25,40,-15,26
Mattersburg,2902,7,5,5,14,28,46,-18,20
FC Salzburg,2903,1,14,7,3,44,17,27,49
SK Sturm Gra,2903,2,12,5,7,33,29,4,41
Rapid Vienna,2903,3,10,10,4,36,25,11,40
LASK Linz,2903,4,8,8,8,28,28,0,32
Mattersburg,2903,5,6,5,13,27,43,-16,23
Vienna,2903,6,6,5,13,24,40,-16,23
SC Rheindorf,2903,7,5,6,13,19,29,-10,21
FC Salzburg,2904,1,16,6,2,48,15,33,54
SK Sturm Gra,2904,2,13,4,7,34,30,4,43
Rapid Vienna,2904,3,9,10,5,36,26,10,37
LASK Linz,2904,4,7,6,11,26,31,-5,27
Mattersburg,2904,5,6,6,12,29,44,-15,24
SC Rheindorf,2904,6,6,5,13,19,28,-9,23
Vienna,2904,7,6,5,13,23,41,-18,23
FC Salzburg,2905,1,15,6,3,46,20,26,51
SK Sturm Gra,2905,2,12,4,8,33,30,3,40
Rapid Vienna,2905,3,8,11,5,36,28,8,35
Mattersburg,2905,4,8,5,11,33,40,-7,29
LASK Linz,2905,5,8,5,11,25,32,-7,29
SC Rheindorf,2905,6,6,6,12,22,28,-6,24
Vienna,2905,7,6,5,13,23,40,-17,23
FC Salzburg,2906,1,16,6,2,46,16,30,54
SK Sturm Gra,2906,2,14,3,7,34,28,6,45
Rapid Vienna,2906,3,7,10,7,32,30,2,31
LASK Linz,2906,4,8,7,9,28,30,-2,31
Vienna,2906,5,7,5,12,26,41,-15,26
Mattersburg,2906,6,6,5,13,34,46,-12,23
SC Rheindorf,2906,7,5,6,13,22,31,-9,21
FC Salzburg,2907,1,16,6,2,46,15,31,54
SK Sturm Gra,2907,2,11,4,9,32,31,1,37
Rapid Vienna,2907,3,8,11,5,35,27,8,35
LASK Linz,2907,4,8,8,8,26,26,0,32
Vienna,2907,5,7,5,12,28,43,-15,26
SC Rheindorf,2907,6,5,7,12,19,29,-10,22
Mattersburg,2907,7,5,7,12,29,44,-15,22
FC Salzburg,2908,1,13,7,4,46,20,26,46
Rapid Vienna,2908,2,10,9,5,38,27,11,39
SK Sturm Gra,2908,3,12,3,9,31,31,0,39
LASK Linz,2908,4,8,6,10,25,26,-1,30
Mattersburg,2908,5,7,6,11,32,46,-14,27
Vienna,2908,6,6,7,11,25,39,-14,25
SC Rheindorf,2908,7,6,6,12,25,33,-8,24
FC Salzburg,2909,1,14,7,3,46,20,26,49
SK Sturm Gra,2909,2,12,5,7,34,31,3,41
Rapid Vienna,2909,3,8,12,4,37,28,9,36
LASK Linz,2909,4,8,6,10,30,30,0,30
Mattersburg,2909,5,7,5,12,32,41,-9,26
Vienna,2909,6,7,5,12,26,41,-15,26
SC Rheindorf,2909,7,5,6,13,20,34,-14,21
FC Salzburg,2910,1,16,6,2,47,17,30,54
SK Sturm Gra,2910,2,11,5,8,30,28,2,38
Rapid Vienna,2910,3,7,12,5,32,26,6,33
LASK Linz,2910,4,8,7,9,27,28,-1,31
SC Rheindorf,2910,5,7,6,11,20,27,-7,27
Mattersburg,2910,6,6,5,13,33,45,-12,23
Vienna,2910,7,6,5,13,25,43,-18,23
FC Salzburg,2911,1,13,7,4,43,21,22,46
SK Sturm Gra,2911,2,14,4,6,33,26,7,46
Rapid Vienna,2911,3,7,13,4,35,27,8,34
LASK Linz,2911,4,8,6,10,27,29,-2,30
Mattersburg,2911,5,7,5,12,33,43,-10,26
Vienna,2911,6,7,5,12,28,41,-13,26
SC Rheindorf,2911,7,5,6,13,19,31,-12,21
SK Sturm Gra,2912,1,15,3,6,39,27,12,48
FC Salzburg,2912,2,13,7,4,43,23,20,46
Rapid Vienna,2912,3,8,10,6,38,30,8,34
LASK Linz,2912,4,9,5,10,28,31,-3,32
Mattersburg,2912,5,8,5,11,31,38,-7,29
Vienna,2912,6,7,5,12,25,38,-13,26
SC Rheindorf,2912,7,4,5,15,18,35,-17,17
FC Salzburg,2913,1,13,9,2,43,19,24,48
SK Sturm Gra,2913,2,13,3,8,32,29,3,42
Rapid Vienna,2913,3,8,12,4,34,24,10,36
LASK Linz,2913,4,8,6,10,28,30,-2,30
Mattersburg,2913,5,8,6,10,36,39,-3,30
Vienna,2913,6,6,6,12,26,43,-17,24
SC Rheindorf,2913,7,4,6,14,17,32,-15,18
FC Salzburg,2914,1,14,7,3,47,18,29,49
SK Sturm Gra,2914,2,13,4,7,33,27,6,43
Rapid Vienna,2914,3,9,9,6,36,31,5,36
LASK Linz,2914,4,10,5,9,30,29,1,35
Vienna,2914,5,8,5,11,29,39,-10,29
Mattersburg,2914,6,6,5,13,34,47,-13,23
SC Rheindorf,2914,7,4,5,15,18,36,-18,17
FC Salzburg,2915,1,15,6,3,45,19,26,51
SK Sturm Gra,2915,2,12,3,9,31,28,3,39
LASK Linz,2915,3,10,5,9,28,29,-1,35
Rapid Vienna,2915,4,8,10,6,33,27,6,34
Vienna,2915,5,7,5,12,26,39,-13,26
SC Rheindorf,2915,6,6,6,12,21,28,-7,24
Mattersburg,2915,7,6,5,13,28,42,-14,23
FC Salzburg,2916,1,14,6,4,41,18,23,48
SK Sturm Gra,2916,2,13,4,7,35,25,10,43
Rapid Vienna,2916,3,9,10,5,36,29,7,37
LASK Linz,2916,4,8,7,9,25,26,-1,31
Vienna,2916,5,7,6,11,26,39,-13,27
SC Rheindorf,2916,6,5,7,12,17,30,-13,22
Mattersburg,2916,7,5,6,13,27,40,-13,21
FC Salzburg,2917,1,15,6,3,47,20,27,51
Rapid Vienna,2917,2,9,11,4,38,26,12,38
SK Sturm Gra,2917,3,11,4,9,31,32,-1,37
LASK Linz,2917,4,8,6,10,27,30,-3,30
Vienna,2917,5,7,5,12,27,40,-13,26
SC Rheindorf,2917,6,6,6,12,21,29,-8,24
Mattersburg,2917,7,6,6,12,31,45,-14,24
FC Salzburg,2918,1,15,6,3,46,18,28,51
SK Sturm Gra,2918,2,12,5,7,32,29,3,41
Rapid Vienna,2918,3,9,9,6,36,28,8,36
LASK Linz,2918,4,8,7,9,26,28,-2,31
Vienna,2918,5,7,5,12,26,39,-13,26
SC Rheindorf,2918,6,6,6,12,22,28,-6,24
Mattersburg,2918,7,5,6,13,28,46,-18,21
FC Salzburg,2919,1,14,6,4,45,21,24,48
SK Sturm Gra,2919,2,13,4,7,34,31,3,43
Rapid Vienna,2919,3,9,10,5,39,26,13,37
LASK Linz,2919,4,8,6,10,27,31,-4,30
Mattersburg,2919,5,7,5,12,31,41,-10,26
Vienna,2919,6,7,5,12,25,39,-14,26
SC Rheindorf,2919,7,5,6,13,17,29,-12,21
FC Salzburg,2920,1,15,6,3,52,16,36,51
SK Sturm Gra,2920,2,12,5,7,32,32,0,41
LASK Linz,2920,3,8,7,9,28,27,1,31
Rapid Vienna,2920,4,7,10,7,33,34,-1,31
Vienna,2920,5,8,5,11,26,38,-12,29
Mattersburg,2920,6,6,6,12,29,43,-14,24
SC Rheindorf,2920,7,5,7,12,20,30,-10,22
FC Salzburg,2921,1,14,6,4,44,19,25,48
Rapid Vienna,2921,2,11,9,4,38,25,13,42
SK Sturm Gra,2921,3,12,5,7,32,28,4,41
LASK Linz,2921,4,8,7,9,30,29,1,31
Mattersburg,2921,5,7,6,11,35,44,-9,27
Vienna,2921,6,6,5,13,24,41,-17,23
SC Rheindorf,2921,7,4,6,14,16,33,-17,18
FC Salzburg,2922,1,15,7,2,48,17,31,52
SK Sturm Gra,2922,2,11,4,9,30,34,-4,37
Rapid Vienna,2922,3,8,11,5,37,28,9,35
LASK Linz,2922,4,9,6,9,27,30,-3,33
Vienna,2922,5,7,6,11,27,39,-12,27
Mattersburg,2922,6,6,5,13,31,45,-14,23
SC Rheindorf,2922,7,5,7,12,23,30,-7,22
FC Salzburg,2923,1,15,6,3,45,16,29,51
Rapid Vienna,2923,2,11,9,4,40,26,14,42
SK Sturm Gra,2923,3,12,4,8,33,29,4,40
LASK Linz,2923,4,8,7,9,27,29,-2,31
Mattersburg,2923,5,6,7,11,30,43,-13,25
Vienna,2923,6,6,6,12,24,40,-16,24
SC Rheindorf,2923,7,4,5,15,20,36,-16,17
FC Salzburg,2924,1,15,7,2,47,19,28,52
SK Sturm Gra,2924,2,14,3,7,34,26,8,45
Rapid Vienna,2924,3,8,10,6,37,29,8,34
LASK Linz,2924,4,8,7,9,28,30,-2,31
Vienna,2924,5,7,5,12,26,40,-14,26
Mattersburg,2924,6,5,7,12,28,42,-14,22
SC Rheindorf,2924,7,4,7,13,18,32,-14,19
FC Salzburg,2925,1,14,7,3,46,22,24,49
SK Sturm Gra,2925,2,12,6,6,33,27,6,42
Rapid Vienna,2925,3,8,10,6,34,28,6,34
Mattersburg,2925,4,7,6,11,35,43,-8,27
Vienna,2925,5,7,6,11,26,38,-12,27
LASK Linz,2925,6,7,5,12,23,29,-6,26
SC Rheindorf,2925,7,6,6,12,22,32,-10,24
FC Salzburg,2926,1,14,8,2,47,18,29,50
SK Sturm Gra,2926,2,12,4,8,32,29,3,40
Rapid Vienna,2926,3,9,9,6,34,28,6,36
LASK Linz,2926,4,10,5,9,28,27,1,35
Mattersburg,2926,5,6,7,11,31,40,-9,25
Vienna,2926,6,6,6,12,25,42,-17,24
SC Rheindorf,2926,7,5,5,14,18,31,-13,20
FC Salzburg,2927,1,13,8,3,45,19,26,47
Rapid Vienna,2927,2,11,9,4,39,26,13,42
SK Sturm Gra,2927,3,12,4,8,33,29,4,40
Mattersburg,2927,4,7,7,10,32,38,-6,28
LASK Linz,2927,5,7,6,11,23,32,-9,27
SC Rheindorf,2927,6,6,5,13,21,29,-8,23
Vienna,2927,7,6,5,13,24,44,-20,23
FC Salzburg,2928,1,15,6,3,46,17,29,51
SK Sturm Gra,2928,2,12,4,8,33,29,4,40
Rapid Vienna,2928,3,9,9,6,35,29,6,36
LASK Linz,2928,4,10,5,9,30,29,1,35
Mattersburg,2928,5,7,5,12,30,42,-12,26
Vienna,2928,6,7,5,12,26,41,-15,26
SC Rheindorf,2928,7,4,6,14,18,31,-13,18
FC Salzburg,2929,1,14,7,3,44,17,27,49
SK Sturm Gra,2929,2,12,6,6,33,28,5,42
Rapid Vienna,2929,3,7,13,4,35,27,8,34
Mattersburg,2929,4,8,5,11,31,40,-9,29
LASK Linz,2929,5,7,7,10,27,30,-3,28
Vienna,2929,6,6,5,13,25,43,-18,23
SC Rheindorf,2929,7,5,7,12,18,28,-10,22
FC Salzburg,2930,1,14,6,4,43,19,24,48
SK Sturm Gra,2930,2,13,3,8,32,29,3,42
Rapid Vienna,2930,3,10,9,5,35,24,11,39
LASK Linz,2930,4,8,6,10,26,29,-3,30
Vienna,2930,5,7,5,12,25,40,-15,26
Mattersburg,2930,6,6,7,11,32,41,-9,25
SC Rheindorf,2930,7,5,6,13,18,29,-11,21
FC Salzburg,2931,1,16,6,2,47,16,31,54
SK Sturm Gra,2931,2,13,3,8,31,27,4,42
Rapid Vienna,2931,3,7,10,7,31,27,4,31
LASK Linz,2931,4,8,5,11,24,28,-4,29
SC Rheindorf,2931,5,7,6,11,19,25,-6,27
Vienna,2931,6,7,5,12,27,39,-12,26
Mattersburg,2931,7,6,5,13,27,44,-17,23
FC Salzburg,2932,1,14,6,4,43,21,22,48
Rapid Vienna,2932,2,10,10,4,42,24,18,40
SK Sturm Gra,2932,3,12,3,9,31,30,1,39
LASK Linz,2932,4,8,7,9,26,26,0,31
Vienna,2932,5,7,5,12,25,39,-14,26
Mattersburg,2932,6,6,6,12,31,48,-17,24
SC Rheindorf,2932,7,6,5,13,24,34,-10,23
FC Salzburg,2933,1,15,6,3,47,17,30,51
SK Sturm Gra,2933,2,12,4,8,34,31,3,40
Rapid Vienna,2933,3,10,9,5,40,27,13,39
LASK Linz,2933,4,9,6,9,27,30,-3,33
Vienna,2933,5,6,6,12,26,42,-16,24
Mattersburg,2933,6,5,7,12,29,44,-15,22
SC Rheindorf,2933,7,5,6,13,19,31,-12,21
FC Salzburg,2934,1,14,6,4,45,18,27,48
SK Sturm Gra,2934,2,12,3,9,35,30,5,39
Rapid Vienna,2934,3,9,9,6,36,30,6,36
LASK Linz,2934,4,10,5,9,31,29,2,35
Vienna,2934,5,8,5,11,26,37,-11,29
Mattersburg,2934,6,7,5,12,30,45,-15,26
SC Rheindorf,2934,7,5,5,14,19,33,-14,20
FC Salzburg,2935,1,15,6,3,48,19,29,51
SK Sturm Gra,2935,2,12,5,7,33,30,3,41
Rapid Vienna,2935,3,7,10,7,34,32,2,31
LASK Linz,2935,4,8,6,10,29,31,-2,30
Vienna,2935,5,8,5,11,32,40,-8,29
Mattersburg,2935,6,7,5,12,32,46,-14,26
SC Rheindorf,2935,7,6,5,13,22,32,-10,23
FC Salzburg,2936,1,15,6,3,42,18,24,51
SK Sturm Gra,2936,2,12,5,7,31,28,3,41
Rapid Vienna,2936,3,8,10,6,34,27,7,34
LASK Linz,2936,4,9,6,9,28,27,1,33
Vienna,2936,5,7,5,12,26,38,-12,26
Mattersburg,2936,6,6,6,12,28,40,-12,24
SC Rheindorf,2936,7,4,8,12,16,27,-11,20
FC Salzburg,2937,1,16,6,2,48,20,28,54
SK Sturm Gra,2937,2,11,5,8,30,29,1,38
Rapid Vienna,2937,3,9,10,5,37,28,9,37
LASK Linz,2937,4,7,8,9,25,27,-2,29
Mattersburg,2937,5,6,7,11,32,41,-9,25
Vienna,2937,6,6,6,12,25,40,-15,24
SC Rheindorf,2937,7,5,6,13,18,30,-12,21
FC Salzburg,2938,1,16,6,2,46,17,29,54
SK Sturm Gra,2938,2,11,5,8,31,30,1,38
Rapid Vienna,2938,3,7,10,7,35,30,5,31
LASK Linz,2938,4,8,6,10,27,33,-6,30
Mattersburg,2938,5,7,5,12,36,42,-6,26
SC Rheindorf,2938,6,7,5,12,20,28,-8,26
Vienna,2938,7,7,5,12,26,41,-15,26
FC Salzburg,2939,1,14,7,3,43,19,24,49
SK Sturm Gra,2939,2,13,3,8,39,30,9,42
Rapid Vienna,2939,3,7,11,6,34,32,2,32
LASK Linz,2939,4,9,5,10,33,35,-2,32
Vienna,2939,5,7,6,11,26,39,-13,27
Mattersburg,2939,6,6,7,11,29,38,-9,25
SC Rheindorf,2939,7,5,7,12,19,30,-11,22
FC Salzburg,2940,1,15,7,2,49,18,31,52
SK Sturm Gra,2940,2,12,5,7,30,26,4,41
Rapid Vienna,2940,3,8,11,5,34,27,7,35
LASK Linz,2940,4,9,6,9,27,28,-1,33
Mattersburg,2940,5,6,6,12,31,41,-10,24
Vienna,2940,6,6,5,13,23,44,-21,23
SC Rheindorf,2940,7,5,6,13,20,30,-10,21
FC Salzburg,2941,1,14,7,3,44,19,25,49
SK Sturm Gra,2941,2,12,4,8,30,27,3,40
Rapid Vienna,2941,3,9,11,4,34,24,10,38
LASK Linz,2941,4,8,5,11,27,29,-2,29
Vienna,2941,5,8,5,11,29,39,-10,29
SC Rheindorf,2941,6,5,8,11,19,28,-9,23
Mattersburg,2941,7,5,6,13,28,45,-17,21
FC Salzburg,2942,1,15,6,3,48,21,27,51
SK Sturm Gra,2942,2,13,4,7,32,27,5,43
Rapid Vienna,2942,3,9,9,6,34,27,7,36
LASK Linz,2942,4,8,6,10,27,29,-2,30
Mattersburg,2942,5,7,5,12,35,42,-7,26
SC Rheindorf,2942,6,6,5,13,19,31,-12,23
Vienna,2942,7,6,5,13,26,44,-18,23
FC Salzburg,2943,1,13,7,4,43,21,22,46
SK Sturm Gra,2943,2,14,3,7,35,29,6,45
Rapid Vienna,2943,3,10,10,4,40,27,13,40
LASK Linz,2943,4,8,5,11,27,30,-3,29
Vienna,2943,5,7,6,11,26,38,-12,27
SC Rheindorf,2943,6,5,7,12,19,29,-10,22
Mattersburg,2943,7,5,6,13,29,45,-16,21
FC Salzburg,2944,1,15,7,2,43,17,26,52
SK Sturm Gra,2944,2,13,3,8,33,29,4,42
Rapid Vienna,2944,3,8,9,7,35,29,6,33
LASK Linz,2944,4,9,5,10,27,28,-1,32
Mattersburg,2944,5,6,7,11,31,41,-10,25
Vienna,2944,6,6,7,11,25,39,-14,25
SC Rheindorf,2944,7,5,6,13,19,30,-11,21
FC Salzburg,2945,1,14,7,3,43,17,26,49
SK Sturm Gra,2945,2,12,4,8,31,29,2,40
Rapid Vienna,2945,3,9,10,5,38,27,11,37
Mattersburg,2945,4,7,6,11,33,40,-7,27
LASK Linz,2945,5,7,6,11,26,33,-7,27
Vienna,2945,6,7,5,12,25,41,-16,26
SC Rheindorf,2945,7,6,6,12,22,31,-9,24
FC Salzburg,2946,1,13,7,4,42,20,22,46
SK Sturm Gra,2946,2,13,3,8,35,31,4,42
Rapid Vienna,2946,3,8,10,6,35,29,6,34
Mattersburg,2946,4,9,5,10,35,38,-3,32
LASK Linz,2946,5,9,5,10,29,32,-3,32
Vienna,2946,6,6,6,12,24,39,-15,24
SC Rheindorf,2946,7,5,6,13,20,31,-11,21
FC Salzburg,2947,1,16,6,2,50,19,31,54
SK Sturm Gra,2947,2,12,4,8,29,28,1,40
Rapid Vienna,2947,3,9,10,5,36,28,8,37
LASK Linz,2947,4,7,7,10,23,27,-4,28
Vienna,2947,5,7,5,12,25,39,-14,26
Mattersburg,2947,6,6,6,12,31,42,-11,24
SC Rheindorf,2947,7,4,8,12,18,29,-11,20
FC Salzburg,2948,1,15,6,3,42,17,25,51
SK Sturm Gra,2948,2,12,4,8,31,28,3,40
Rapid Vienna,2948,3,8,10,6,36,29,7,34
Mattersburg,2948,4,9,5,10,31,37,-6,32
LASK Linz,2948,5,8,7,9,27,28,-1,31
Vienna,2948,6,6,5,13,23,39,-16,23
SC Rheindorf,2948,7,4,7,13,18,30,-12,19
FC Salzburg,2949,1,13,9,2,44,19,25,48
SK Sturm Gra,2949,2,12,4,8,32,29,3,40
Rapid Vienna,2949,3,9,9,6,35,27,8,36
LASK Linz,2949,4,9,6,9,27,27,0,33
Mattersburg,2949,5,7,6,11,31,42,-11,27
Vienna,2949,6,7,6,11,27,38,-11,27
SC Rheindorf,2949,7,4,6,14,17,31,-14,18
FC Salzburg,2950,1,15,6,3,45,19,26,51
SK Sturm Gra,2950,2,12,4,8,34,31,3,40
Rapid Vienna,2950,3,8,9,7,35,29,6,33
LASK Linz,2950,4,8,7,9,28,30,-2,31
Mattersburg,2950,5,7,5,12,32,42,-10,26
Vienna,2950,6,7,5,12,25,39,-14,26
SC Rheindorf,2950,7,6,6,12,19,28,-9,24
FC Salzburg,2951,1,15,6,3,46,20,26,51
SK Sturm Gra,2951,2,15,3,6,34,24,10,48
Rapid Vienna,2951,3,8,9,7,37,33,4,33
LASK Linz,2951,4,8,5,11,27,32,-5,29
Mattersburg,2951,5,7,6,11,33,41,-8,27
Vienna,2951,6,6,6,12,24,39,-15,24
SC Rheindorf,2951,7,5,5,14,18,30,-12,20
FC Salzburg,2952,1,16,6,2,49,18,31,54
SK Sturm Gra,2952,2,12,3,9,33,34,-1,39
Rapid Vienna,2952,3,9,9,6,36,27,9,36
LASK Linz,2952,4,9,6,9,28,27,1,33
Vienna,2952,5,7,5,12,29,40,-11,26
Mattersburg,2952,6,6,6,12,31,46,-15,24
SC Rheindorf,2952,7,4,7,13,19,33,-14,19
FC Salzburg,2953,1,16,6,2,48,16,32,54
SK Sturm Gra,2953,2,12,4,8,32,30,2,40
Rapid Vienna,2953,3,8,9,7,39,33,6,33
LASK Linz,2953,4,9,6,9,31,29,2,33
SC Rheindorf,2953,5,6,6,12,20,30,-10,24
Mattersburg,2953,6,6,6,12,29,41,-12,24
Vienna,2953,7,6,5,13,24,44,-20,23
FC Salzburg,2954,1,14,7,3,49,21,28,49
Rapid Vienna,2954,2,10,10,4,35,24,11,40
SK Sturm Gra,2954,3,12,4,8,34,30,4,40
LASK Linz,2954,4,9,5,10,26,29,-3,32
Vienna,2954,5,7,5,12,27,40,-13,26
Mattersburg,2954,6,7,5,12,31,45,-14,26
SC Rheindorf,2954,7,4,6,14,17,30,-13,18
FC Salzburg,2955,1,14,7,3,45,20,25,49
SK Sturm Gra,2955,2,13,3,8,33,30,3,42
Rapid Vienna,2955,3,9,9,6,40,32,8,36
LASK Linz,2955,4,8,6,10,28,28,0,30
Vienna,2955,5,7,6,11,26,39,-13,27
Mattersburg,2955,6,7,5,12,29,38,-9,26
SC Rheindorf,2955,7,5,6,13,20,34,-14,21
FC Salzburg,2956,1,15,6,3,47,19,28,51
SK Sturm Gra,2956,2,13,4,7,32,28,4,43
Rapid Vienna,2956,3,10,9,5,36,26,10,39
LASK Linz,2956,4,8,6,10,26,27,-1,30
Mattersburg,2956,5,6,6,12,29,41,-12,24
Vienna,2956,6,6,6,12,24,39,-15,24
SC Rheindorf,2956,7,5,5,14,17,31,-14,20
FC Salzburg,2957,1,14,6,4,44,21,23,48
SK Sturm Gra,2957,2,11,5,8,33,32,1,38
Rapid Vienna,2957,3,8,11,5,37,28,9,35
LASK Linz,2957,4,7,9,8,27,28,-1,30
Vienna,2957,5,7,6,11,27,40,-13,27
Mattersburg,2957,6,6,8,10,31,40,-9,26
SC Rheindorf,2957,7,5,7,12,19,29,-10,22
FC Salzburg,2958,1,15,7,2,44,17,27,52
SK Sturm Gra,2958,2,12,5,7,31,28,3,41
Rapid Vienna,2958,3,7,12,5,32,25,7,33
LASK Linz,2958,4,8,6,10,25,27,-2,30
Mattersburg,2958,5,7,6,11,32,42,-10,27
Vienna,2958,6,7,5,12,26,39,-13,26
SC Rheindorf,2958,7,4,7,13,16,28,-12,19
FC Salzburg,2959,1,14,8,2,46,20,26,50
SK Sturm Gra,2959,2,13,3,8,34,29,5,42
Rapid Vienna,2959,3,9,11,4,37,26,11,38
LASK Linz,2959,4,7,7,10,26,31,-5,28
Mattersburg,2959,5,6,7,11,30,40,-10,25
SC Rheindorf,2959,6,6,5,13,19,29,-10,23
Vienna,2959,7,6,5,13,24,41,-17,23
FC Salzburg,2960,1,14,6,4,45,21,24,48
SK Sturm Gra,2960,2,12,3,9,30,31,-1,39
Rapid Vienna,2960,3,9,9,6,38,29,9,36
LASK Linz,2960,4,8,5,11,27,34,-7,29
Vienna,2960,5,8,5,11,27,39,-12,29
Mattersburg,2960,6,7,6,11,35,40,-5,27
SC Rheindorf,2960,7,6,6,12,20,28,-8,24
FC Salzburg,2961,1,13,8,3,44,22,22,47
Rapid Vienna,2961,2,11,9,4,38,24,14,42
SK Sturm Gra,2961,3,11,4,9,32,31,1,37
LASK Linz,2961,4,10,5,9,29,26,3,35
Mattersburg,2961,5,7,5,12,32,41,-9,26
Vienna,2961,6,6,6,12,24,40,-16,24
SC Rheindorf,2961,7,5,5,14,16,31,-15,20
FC Salzburg,2962,1,14,7,3,45,22,23,49
SK Sturm Gra,2962,2,13,5,6,37,27,10,44
Rapid Vienna,2962,3,9,11,4,41,27,14,38
LASK Linz,2962,4,7,7,10,25,30,-5,28
Mattersburg,2962,5,7,6,11,30,41,-11,27
Vienna,2962,6,6,5,13,24,40,-16,23
SC Rheindorf,2962,7,5,5,14,18,33,-15,20
FC Salzburg,2963,1,16,6,2,49,15,34,54
SK Sturm Gra,2963,2,13,4,7,32,28,4,43
LASK Linz,2963,3,9,6,9,26,27,-1,33
Rapid Vienna,2963,4,7,9,8,31,28,3,30
Mattersburg,2963,5,7,6,11,34,43,-9,27
Vienna,2963,6,6,6,12,26,43,-17,24
SC Rheindorf,2963,7,5,5,14,17,31,-14,20
FC Salzburg,2964,1,14,7,3,45,20,25,49
SK Sturm Gra,2964,2,13,3,8,37,29,8,42
Rapid Vienna,2964,3,8,11,5,34,26,8,35
LASK Linz,2964,4,8,7,9,27,30,-3,31
Vienna,2964,5,6,7,11,24,38,-14,25
Mattersburg,2964,6,6,6,12,30,43,-13,24
SC Rheindorf,2964,7,5,7,12,19,30,-11,22
FC Salzburg,2965,1,12,8,4,39,18,21,44
SK Sturm Gra,2965,2,12,4,8,32,30,2,40
Rapid Vienna,2965,3,10,9,5,37,25,12,39
LASK Linz,2965,4,8,6,10,30,31,-1,30
Mattersburg,2965,5,6,8,10,30,39,-9,26
Vienna,2965,6,7,5,12,24,38,-14,26
SC Rheindorf,2965,7,6,6,12,19,30,-11,24
FC Salzburg,2966,1,14,7,3,45,19,26,49
SK Sturm Gra,2966,2,12,4,8,32,30,2,40
Rapid Vienna,2966,3,9,10,5,40,26,14,37
LASK Linz,2966,4,8,6,10,27,32,-5,30
Vienna,2966,5,7,6,11,27,38,-11,27
SC Rheindorf,2966,6,5,8,11,16,25,-9,23
Mattersburg,2966,7,6,5,13,27,44,-17,23
FC Salzburg,2967,1,15,6,3,44,20,24,51
SK Sturm Gra,2967,2,12,4,8,31,29,2,40
Rapid Vienna,2967,3,9,11,4,36,24,12,38
LASK Linz,2967,4,8,7,9,27,28,-1,31
Mattersburg,2967,5,7,6,11,35,42,-7,27
Vienna,2967,6,6,5,13,26,43,-17,23
SC Rheindorf,2967,7,4,7,13,17,30,-13,19
FC Salzburg,2968,1,15,6,3,47,18,29,51
SK Sturm Gra,2968,2,13,3,8,34,32,2,42
LASK Linz,2968,3,9,7,8,29,28,1,34
Rapid Vienna,2968,4,8,9,7,37,32,5,33
Mattersburg,2968,5,7,6,11,33,42,-9,27
Vienna,2968,6,7,5,12,28,41,-13,26
SC Rheindorf,2968,7,4,6,14,16,31,-15,18
FC Salzburg,2969,1,15,6,3,50,19,31,51
SK Sturm Gra,2969,2,13,4,7,36,29,7,43
Rapid Vienna,2969,3,9,9,6,37,31,6,36
Mattersburg,2969,4,8,5,11,32,38,-6,29
LASK Linz,2969,5,7,5,12,24,32,-8,26
Vienna,2969,6,7,5,12,24,42,-18,26
SC Rheindorf,2969,7,5,6,13,18,30,-12,21
FC Salzburg,2970,1,15,6,3,50,20,30,51
SK Sturm Gra,2970,2,12,3,9,31,32,-1,39
Rapid Vienna,2970,3,9,11,4,39,28,11,38
LASK Linz,2970,4,9,6,9,27,26,1,33
Mattersburg,2970,5,6,6,12,30,45,-15,24
Vienna,2970,6,6,5,13,27,44,-17,23
SC Rheindorf,2970,7,5,7,12,20,29,-9,22
FC Salzburg,2971,1,15,7,2,45,19,26,52
SK Sturm Gra,2971,2,13,3,8,36,31,5,42
LASK Linz,2971,3,9,5,10,27,29,-2,32
Rapid Vienna,2971,4,7,10,7,33,29,4,31
Vienna,2971,5,7,6,11,26,39,-13,27
Mattersburg,2971,6,7,5,12,31,41,-10,26
SC Rheindorf,2971,7,5,6,13,18,28,-10,21
FC Salzburg,2972,1,13,7,4,42,20,22,46
SK Sturm Gra,2972,2,12,6,6,32,27,5,42
Rapid Vienna,2972,3,8,10,6,34,27,7,34
LASK Linz,2972,4,8,5,11,27,30,-3,29
Mattersburg,2972,5,7,6,11,32,43,-11,27
Vienna,2972,6,7,6,11,26,39,-13,27
SC Rheindorf,2972,7,6,6,12,20,27,-7,24
FC Salzburg,2973,1,14,8,2,44,18,26,50
SK Sturm Gra,2973,2,14,3,7,34,27,7,45
Rapid Vienna,2973,3,8,11,5,36,28,8,35
LASK Linz,2973,4,8,5,11,29,32,-3,29
Vienna,2973,5,7,6,11,25,38,-13,27
Mattersburg,2973,6,6,5,13,32,44,-12,23
SC Rheindorf,2973,7,5,6,13,18,31,-13,21
FC Salzburg,2974,1,16,6,2,49,17,32,54
SK Sturm Gra,2974,2,11,5,8,31,31,0,38
Rapid Vienna,2974,3,9,9,6,38,29,9,36
LASK Linz,2974,4,9,6,9,27,26,1,33
Mattersburg,2974,5,8,5,11,32,40,-8,29
Vienna,2974,6,6,5,13,24,43,-19,23
SC Rheindorf,2974,7,4,6,14,17,32,-15,18
FC Salzburg,2975,1,14,7,3,44,20,24,49
SK Sturm Gra,2975,2,13,4,7,34,27,7,43
Rapid Vienna,2975,3,8,9,7,33,29,4,33
LASK Linz,2975,4,8,6,10,26,30,-4,30
SC Rheindorf,2975,5,7,6,11,21,26,-5,27
Vienna,2975,6,7,5,12,26,39,-13,26
Mattersburg,2975,7,6,5,13,30,43,-13,23
FC Salzburg,2976,1,14,7,3,43,17,26,49
SK Sturm Gra,2976,2,13,4,7,33,26,7,43
Rapid Vienna,2976,3,7,11,6,34,31,3,32
LASK Linz,2976,4,8,7,9,28,29,-1,31
Vienna,2976,5,7,6,11,26,39,-13,27
Mattersburg,2976,6,6,7,11,30,42,-12,25
SC Rheindorf,2976,7,5,6,13,18,28,-10,21
FC Salzburg,2977,1,14,7,3,50,23,27,49
SK Sturm Gra,2977,2,11,4,9,31,30,1,37
Rapid Vienna,2977,3,8,10,6,35,29,6,34
LASK Linz,2977,4,9,7,8,29,28,1,34
Vienna,2977,5,7,6,11,27,39,-12,27
SC Rheindorf,2977,6,6,6,12,21,29,-8,24
Mattersburg,2977,7,6,6,12,31,46,-15,24
FC Salzburg,2978,1,14,8,2,42,16,26,50
SK Sturm Gra,2978,2,13,3,8,34,29,5,42
Rapid Vienna,2978,3,9,10,5,39,31,8,37
LASK Linz,2978,4,9,6,9,28,26,2,33
Vienna,2978,5,7,6,11,24,37,-13,27
Mattersburg,2978,6,5,6,13,27,43,-16,21
SC Rheindorf,2978,7,5,5,14,22,34,-12,20
FC Salzburg,2979,1,14,6,4,44,21,23,48
SK Sturm Gra,2979,2,13,4,7,37,32,5,43
Rapid Vienna,2979,3,9,9,6,36,30,6,36
LASK Linz,2979,4,9,6,9,32,31,1,33
Vienna,2979,5,7,5,12,27,41,-14,26
SC Rheindorf,2979,6,6,5,13,20,30,-10,23
Mattersburg,2979,7,6,5,13,30,41,-11,23
FC Salzburg,2980,1,15,7,2,44,18,26,52
Rapid Vienna,2980,2,10,9,5,39,25,14,39
SK Sturm Gra,2980,3,12,3,9,33,32,1,39
LASK Linz,2980,4,7,5,12,26,32,-6,26
SC Rheindorf,2980,5,7,5,12,21,31,-10,26
Mattersburg,2980,6,6,7,11,31,41,-10,25
Vienna,2980,7,6,6,12,25,40,-15,24
FC Salzburg,2981,1,14,6,4,43,20,23,48
SK Sturm Gra,2981,2,12,4,8,32,31,1,40
Rapid Vienna,2981,3,8,9,7,35,29,6,33
LASK Linz,2981,4,8,6,10,27,33,-6,30
Vienna,2981,5,8,5,11,27,38,-11,29
Mattersburg,2981,6,7,6,11,31,38,-7,27
SC Rheindorf,2981,7,6,6,12,22,28,-6,24
FC Salzburg,2982,1,15,6,3,45,18,27,51
SK Sturm Gra,2982,2,13,3,8,31,27,4,42
Rapid Vienna,2982,3,9,9,6,36,28,8,36
LASK Linz,2982,4,8,7,9,28,30,-2,31
Vienna,2982,5,6,6,12,24,40,-16,24
Mattersburg,2982,6,5,8,11,31,43,-12,23
SC Rheindorf,2982,7,5,7,12,20,29,-9,22
FC Salzburg,2983,1,15,7,2,47,17,30,52
SK Sturm Gra,2983,2,12,3,9,35,33,2,39
Rapid Vienna,2983,3,9,10,5,37,28,9,37
LASK Linz,2983,4,8,6,10,27,30,-3,30
Vienna,2983,5,6,7,11,23,37,-14,25
SC Rheindorf,2983,6,6,6,12,22,31,-9,24
Mattersburg,2983,7,5,7,12,27,42,-15,22
FC Salzburg,2984,1,15,6,3,47,18,29,51
Rapid Vienna,2984,2,9,10,5,34,25,9,37
SK Sturm Gra,2984,3,11,3,10,33,35,-2,36
LASK Linz,2984,4,9,5,10,28,30,-2,32
SC Rheindorf,2984,5,6,7,11,24,30,-6,25
Mattersburg,2984,6,6,7,11,31,44,-13,25
Vienna,2984,7,6,6,12,26,41,-15,24
FC Salzburg,2985,1,13,7,4,43,22,21,46
SK Sturm Gra,2985,2,13,3,8,33,29,4,42
Rapid Vienna,2985,3,10,9,5,39,27,12,39
LASK Linz,2985,4,7,7,10,24,27,-3,28
Vienna,2985,5,7,6,11,27,40,-13,27
Mattersburg,2985,6,6,8,10,34,43,-9,26
SC Rheindorf,2985,7,5,6,13,20,32,-12,21
FC Salzburg,2986,1,14,7,3,42,19,23,49
SK Sturm Gra,2986,2,12,6,6,33,28,5,42
Rapid Vienna,2986,3,8,11,5,37,27,10,35
LASK Linz,2986,4,8,7,9,25,28,-3,31
Mattersburg,2986,5,7,5,12,32,41,-9,26
Vienna,2986,6,6,5,13,25,41,-16,23
SC Rheindorf,2986,7,5,7,12,19,29,-10,22
SK Sturm Gra,2987,1,15,3,6,39,25,14,48
FC Salzburg,2987,2,12,6,6,41,23,18,42
Rapid Vienna,2987,3,8,11,5,33,28,5,35
LASK Linz,2987,4,8,7,9,25,26,-1,31
Mattersburg,2987,5,8,6,10,33,39,-6,30
Vienna,2987,6,7,5,12,28,43,-15,26
SC Rheindorf,2987,7,4,6,14,18,33,-15,18
FC Salzburg,2988,1,13,7,4,40,19,21,46
Rapid Vienna,2988,2,10,10,4,37,25,12,40
SK Sturm Gra,2988,3,12,4,8,32,29,3,40
LASK Linz,2988,4,8,7,9,27,29,-2,31
Mattersburg,2988,5,7,5,12,31,39,-8,26
Vienna,2988,6,7,5,12,24,38,-14,26
SC Rheindorf,2988,7,5,6,13,18,30,-12,21
FC Salzburg,2989,1,15,6,3,46,21,25,51
SK Sturm Gra,2989,2,14,3,7,36,28,8,45
Rapid Vienna,2989,3,8,10,6,34,27,7,34
LASK Linz,2989,4,8,5,11,28,31,-3,29
Mattersburg,2989,5,7,5,12,32,43,-11,26
Vienna,2989,6,7,5,12,25,40,-15,26
SC Rheindorf,2989,7,5,6,13,18,29,-11,21
FC Salzburg,2990,1,13,6,5,42,23,19,45
SK Sturm Gra,2990,2,13,4,7,35,30,5,43
Rapid Vienna,2990,3,11,9,4,40,25,15,42
Vienna,2990,4,8,5,11,27,39,-12,29
LASK Linz,2990,5,7,6,11,26,32,-6,27
Mattersburg,2990,6,7,5,12,34,43,-9,26
SC Rheindorf,2990,7,4,7,13,19,31,-12,19
FC Salzburg,2991,1,13,8,3,44,20,24,47
SK Sturm Gra,2991,2,14,4,6,39,29,10,46
Rapid Vienna,2991,3,7,10,7,36,34,2,31
LASK Linz,2991,4,8,7,9,27,28,-1,31
Mattersburg,2991,5,7,6,11,33,40,-7,27
SC Rheindorf,2991,6,6,6,12,21,30,-9,24
Vienna,2991,7,6,5,13,23,42,-19,23
FC Salzburg,2992,1,15,7,2,47,18,29,52
SK Sturm Gra,2992,2,12,5,7,32,27,5,41
Rapid Vienna,2992,3,7,11,6,32,26,6,32
LASK Linz,2992,4,8,7,9,26,29,-3,31
Mattersburg,2992,5,7,5,12,32,44,-12,26
SC Rheindorf,2992,6,6,6,12,21,29,-8,24
Vienna,2992,7,6,5,13,24,41,-17,23
FC Salzburg,2993,1,16,6,2,46,17,29,54
SK Sturm Gra,2993,2,12,4,8,30,26,4,40
Rapid Vienna,2993,3,9,9,6,36,29,7,36
LASK Linz,2993,4,8,7,9,28,28,0,31
Mattersburg,2993,5,6,6,12,32,43,-11,24
SC Rheindorf,2993,6,6,5,13,20,32,-12,23
Vienna,2993,7,6,5,13,25,42,-17,23
FC Salzburg,2994,1,14,8,2,43,18,25,50
SK Sturm Gra,2994,2,12,4,8,31,30,1,40
Rapid Vienna,2994,3,8,10,6,38,31,7,34
LASK Linz,2994,4,8,5,11,26,30,-4,29
SC Rheindorf,2994,5,7,5,12,24,30,-6,26
Mattersburg,2994,6,7,5,12,32,43,-11,26
Vienna,2994,7,7,5,12,27,39,-12,26
FC Salzburg,2995,1,14,6,4,46,17,29,48
SK Sturm Gra,2995,2,13,3,8,32,28,4,42
Rapid Vienna,2995,3,10,10,4,38,27,11,40
LASK Linz,2995,4,7,7,10,27,30,-3,28
SC Rheindorf,2995,5,7,5,12,19,27,-8,26
Mattersburg,2995,6,6,6,12,31,43,-12,24
Vienna,2995,7,6,5,13,23,44,-21,23
FC Salzburg,2996,1,13,8,3,48,24,24,47
SK Sturm Gra,2996,2,12,5,7,33,29,4,41
Rapid Vienna,2996,3,8,12,4,35,26,9,36
LASK Linz,2996,4,7,6,11,26,31,-5,27
Vienna,2996,5,7,6,11,28,41,-13,27
Mattersburg,2996,6,7,5,12,33,41,-8,26
SC Rheindorf,2996,7,6,6,12,19,30,-11,24
FC Salzburg,2997,1,14,7,3,42,19,23,49
SK Sturm Gra,2997,2,12,5,7,36,30,6,41
LASK Linz,2997,3,10,6,8,33,27,6,36
Rapid Vienna,2997,4,8,11,5,34,27,7,35
Vienna,2997,5,7,5,12,25,39,-14,26
Mattersburg,2997,6,5,6,13,27,41,-14,21
SC Rheindorf,2997,7,5,6,13,17,31,-14,21
FC Salzburg,2998,1,14,8,2,44,17,27,50
SK Sturm Gra,2998,2,11,6,7,31,28,3,39
Rapid Vienna,2998,3,8,11,5,36,28,8,35
LASK Linz,2998,4,7,8,9,26,28,-2,29
Vienna,2998,5,7,6,11,26,38,-12,27
SC Rheindorf,2998,6,5,8,11,19,28,-9,23
Mattersburg,2998,7,5,7,12,30,45,-15,22
FC Salzburg,2999,1,14,7,3,46,19,27,49
SK Sturm Gra,2999,2,13,5,6,33,26,7,44
Rapid Vienna,2999,3,9,10,5,36,28,8,37
LASK Linz,2999,4,7,6,11,24,29,-5,27
SC Rheindorf,2999,5,6,7,11,21,28,-7,25
Mattersburg,2999,6,6,6,12,30,40,-10,24
Vienna,2999,7,6,5,13,25,45,-20,23
FC Salzburg,3000,1,14,8,2,45,19,26,50
SK Sturm Gra,3000,2,12,5,7,34,30,4,41
Rapid Vienna,3000,3,7,9,8,35,32,3,30
LASK Linz,3000,4,8,6,10,29,30,-1,30
SC Rheindorf,3000,5,7,6,11,22,29,-7,27
Mattersburg,3000,6,7,6,11,30,40,-10,27
Vienna,3000,7,6,6,12,24,39,-15,24
FC Salzburg,3001,1,15,6,3,49,21,28,51
SK Sturm Gra,3001,2,13,3,8,32,32,0,42
LASK Linz,3001,3,9,6,9,30,29,1,33
Rapid Vienna,3001,4,7,9,8,34,32,2,30
Vienna,3001,5,7,5,12,26,40,-14,26
SC Rheindorf,3001,6,6,7,11,22,28,-6,25
Mattersburg,3001,7,6,6,12,31,42,-11,24
FC Salzburg,3002,1,13,8,3,43,20,23,47
SK Sturm Gra,3002,2,12,4,8,33,30,3,40
Rapid Vienna,3002,3,9,11,4,40,27,13,38
LASK Linz,3002,4,8,5,11,27,32,-5,29
Mattersburg,3002,5,7,6,11,35,41,-6,27
Vienna,3002,6,7,5,12,26,42,-16,26
SC Rheindorf,3002,7,6,5,13,20,32,-12,23
FC Salzburg,3003,1,14,6,4,43,23,20,48
SK Sturm Gra,3003,2,12,5,7,32,28,4,41
Rapid Vienna,3003,3,10,10,4,43,27,16,40
LASK Linz,3003,4,8,7,9,27,27,0,31
Vienna,3003,5,6,6,12,27,42,-15,24
SC Rheindorf,3003,6,5,8,11,19,28,-9,23
Mattersburg,3003,7,5,6,13,29,45,-16,21
FC Salzburg,3004,1,14,6,4,43,20,23,48
SK Sturm Gra,3004,2,12,5,7,33,28,5,41
Rapid Vienna,3004,3,9,10,5,37,28,9,37
LASK Linz,3004,4,10,6,8,28,25,3,36
Vienna,3004,5,8,5,11,27,38,-11,29
Mattersburg,3004,6,5,6,13,29,42,-13,21
SC Rheindorf,3004,7,4,6,14,16,32,-16,18
FC Salzburg,3005,1,14,8,2,44,19,25,50
SK Sturm Gra,3005,2,11,5,8,33,31,2,38
LASK Linz,3005,3,9,7,8,31,26,5,34
Rapid Vienna,3005,4,7,12,5,35,29,6,33
SC Rheindorf,3005,5,6,6,12,19,27,-8,24
Mattersburg,3005,6,6,6,12,28,43,-15,24
Vienna,3005,7,6,6,12,24,39,-15,24
FC Salzburg,3006,1,15,6,3,46,17,29,51
SK Sturm Gra,3006,2,12,4,8,31,29,2,40
Rapid Vienna,3006,3,9,9,6,34,29,5,36
LASK Linz,3006,4,9,6,9,31,27,4,33
Vienna,3006,5,7,5,12,25,39,-14,26
Mattersburg,3006,6,6,5,13,29,45,-16,23
SC Rheindorf,3006,7,5,7,12,17,27,-10,22
FC Salzburg,3007,1,16,6,2,49,18,31,54
SK Sturm Gra,3007,2,11,5,8,33,31,2,38
Rapid Vienna,3007,3,9,10,5,37,28,9,37
LASK Linz,3007,4,8,6,10,26,30,-4,30
Mattersburg,3007,5,7,6,11,31,41,-10,27
Vienna,3007,6,6,5,13,25,42,-17,23
SC Rheindorf,3007,7,4,8,12,18,29,-11,20
FC Salzburg,3008,1,14,6,4,44,19,25,48
Rapid Vienna,3008,2,10,10,4,38,27,11,40
SK Sturm Gra,3008,3,11,5,8,32,31,1,38
LASK Linz,3008,4,7,8,9,27,32,-5,29
Mattersburg,3008,5,7,6,11,36,43,-7,27
Vienna,3008,6,7,6,11,26,38,-12,27
SC Rheindorf,3008,7,4,7,13,17,30,-13,19
FC Salzburg,3009,1,15,6,3,44,17,27,51
SK Sturm Gra,3009,2,13,4,7,34,27,7,43
Rapid Vienna,3009,3,8,11,5,33,26,7,35
LASK Linz,3009,4,7,7,10,25,30,-5,28
Mattersburg,3009,5,7,6,11,31,40,-9,27
Vienna,3009,6,6,6,12,24,40,-16,24
SC Rheindorf,3009,7,4,8,12,18,29,-11,20
FC Salzburg,3010,1,14,7,3,47,22,25,49
Rapid Vienna,3010,2,9,11,4,35,25,10,38
SK Sturm Gra,3010,3,11,5,8,35,35,0,38
LASK Linz,3010,4,8,6,10,29,31,-2,30
Vienna,3010,5,7,6,11,27,40,-13,27
Mattersburg,3010,6,6,6,12,29,40,-11,24
SC Rheindorf,3010,7,5,7,12,21,30,-9,22
FC Salzburg,3011,1,15,7,2,53,17,36,52
SK Sturm Gra,3011,2,11,4,9,30,31,-1,37
Rapid Vienna,3011,3,8,10,6,34,27,7,34
LASK Linz,3011,4,8,7,9,25,28,-3,31
Mattersburg,3011,5,7,5,12,33,47,-14,26
Vienna,3011,6,7,5,12,28,43,-15,26
SC Rheindorf,3011,7,6,6,12,17,27,-10,24
FC Salzburg,3012,1,15,7,2,47,18,29,52
SK Sturm Gra,3012,2,12,4,8,33,31,2,40
Rapid Vienna,3012,3,7,10,7,31,28,3,31
LASK Linz,3012,4,8,7,9,29,27,2,31
Vienna,3012,5,7,6,11,27,40,-13,27
SC Rheindorf,3012,6,7,5,12,21,29,-8,26
Mattersburg,3012,7,6,5,13,31,46,-15,23
FC Salzburg,3013,1,13,7,4,40,18,22,46
SK Sturm Gra,3013,2,14,3,7,32,28,4,45
Rapid Vienna,3013,3,8,11,5,35,27,8,35
LASK Linz,3013,4,8,8,8,29,27,2,32
Vienna,3013,5,7,6,11,25,38,-13,27
Mattersburg,3013,6,6,7,11,30,40,-10,25
SC Rheindorf,3013,7,4,6,14,17,30,-13,18
FC Salzburg,3014,1,14,6,4,44,18,26,48
SK Sturm Gra,3014,2,14,4,6,35,26,9,46
Rapid Vienna,3014,3,8,10,6,36,31,5,34
LASK Linz,3014,4,9,5,10,26,30,-4,32
Vienna,3014,5,8,5,11,27,38,-11,29
Mattersburg,3014,6,6,5,13,28,42,-14,23
SC Rheindorf,3014,7,5,5,14,20,31,-11,20
FC Salzburg,3015,1,15,6,3,44,17,27,51
Rapid Vienna,3015,2,10,9,5,37,28,9,39
SK Sturm Gra,3015,3,11,4,9,30,29,1,37
LASK Linz,3015,4,8,6,10,28,30,-2,30
Mattersburg,3015,5,8,5,11,35,40,-5,29
Vienna,3015,6,7,5,12,24,40,-16,26
SC Rheindorf,3015,7,4,7,13,17,31,-14,19
FC Salzburg,3016,1,14,7,3,46,19,27,49
SK Sturm Gra,3016,2,11,5,8,30,30,0,38
Rapid Vienna,3016,3,8,11,5,36,29,7,35
LASK Linz,3016,4,9,5,10,31,32,-1,32
Mattersburg,3016,5,7,5,12,30,42,-12,26
Vienna,3016,6,7,5,12,27,40,-13,26
SC Rheindorf,3016,7,6,6,12,21,29,-8,24
FC Salzburg,3017,1,16,6,2,50,17,33,54
SK Sturm Gra,3017,2,11,4,9,28,28,0,37
LASK Linz,3017,3,9,6,9,27,29,-2,33
Rapid Vienna,3017,4,7,11,6,33,29,4,32
Vienna,3017,5,7,5,12,26,39,-13,26
SC Rheindorf,3017,6,6,7,11,20,26,-6,25
Mattersburg,3017,7,5,7,12,29,45,-16,22
FC Salzburg,3018,1,13,9,2,45,19,26,48
SK Sturm Gra,3018,2,12,4,8,29,28,1,40
Rapid Vienna,3018,3,8,11,5,35,26,9,35
LASK Linz,3018,4,8,7,9,26,27,-1,31
Mattersburg,3018,5,7,7,10,29,37,-8,28
Vienna,3018,6,6,6,12,24,39,-15,24
SC Rheindorf,3018,7,5,6,13,18,30,-12,21
FC Salzburg,3019,1,13,9,2,42,18,24,48
SK Sturm Gra,3019,2,13,4,7,31,28,3,43
LASK Linz,3019,3,11,5,8,35,27,8,38
Rapid Vienna,3019,4,8,10,6,36,30,6,34
Vienna,3019,5,7,5,12,25,39,-14,26
Mattersburg,3019,6,5,7,12,28,40,-12,22
SC Rheindorf,3019,7,4,6,14,17,32,-15,18
FC Salzburg,3020,1,16,6,2,48,18,30,54
SK Sturm Gra,3020,2,12,3,9,34,32,2,39
Rapid Vienna,3020,3,8,9,7,35,32,3,33
LASK Linz,3020,4,9,6,9,30,30,0,33
Mattersburg,3020,5,7,5,12,32,42,-10,26
Vienna,3020,6,7,5,12,26,41,-15,26
SC Rheindorf,3020,7,5,6,13,21,31,-10,21
FC Salzburg,3021,1,14,7,3,47,20,27,49
SK Sturm Gra,3021,2,12,4,8,32,31,1,40
Rapid Vienna,3021,3,8,11,5,35,28,7,35
LASK Linz,3021,4,8,6,10,28,31,-3,30
Vienna,3021,5,8,5,11,28,40,-12,29
Mattersburg,3021,6,7,5,12,31,42,-11,26
SC Rheindorf,3021,7,5,6,13,22,31,-9,21
FC Salzburg,3022,1,15,7,2,45,18,27,52
SK Sturm Gra,3022,2,12,3,9,34,32,2,39
Rapid Vienna,3022,3,9,10,5,38,29,9,37
LASK Linz,3022,4,9,5,10,30,31,-1,32
Mattersburg,3022,5,7,5,12,33,44,-11,26
Vienna,3022,6,6,6,12,25,40,-15,24
SC Rheindorf,3022,7,5,6,13,17,28,-11,21
FC Salzburg,3023,1,14,6,4,43,20,23,48
SK Sturm Gra,3023,2,13,4,7,34,29,5,43
Rapid Vienna,3023,3,10,9,5,36,24,12,39
LASK Linz,3023,4,7,7,10,26,29,-3,28
Vienna,3023,5,7,6,11,25,38,-13,27
SC Rheindorf,3023,6,6,5,13,19,30,-11,23
Mattersburg,3023,7,5,7,12,29,42,-13,22
FC Salzburg,3024,1,14,8,2,43,17,26,50
SK Sturm Gra,3024,2,13,4,7,33,28,5,43
Rapid Vienna,3024,3,9,11,4,37,27,10,38
LASK Linz,3024,4,8,6,10,27,29,-2,30
Vienna,3024,5,7,5,12,26,41,-15,26
SC Rheindorf,3024,6,6,5,13,19,28,-9,23
Mattersburg,3024,7,5,5,14,27,42,-15,20
FC Salzburg,3025,1,15,6,3,48,23,25,51
SK Sturm Gra,3025,2,14,3,7,36,30,6,45
LASK Linz,3025,3,9,5,10,32,31,1,32
Rapid Vienna,3025,4,7,10,7,35,32,3,31
Vienna,3025,5,7,5,12,25,40,-15,26
Mattersburg,3025,6,6,6,12,31,42,-11,24
SC Rheindorf,3025,7,5,7,12,20,29,-9,22
FC Salzburg,3026,1,15,7,2,48,17,31,52
SK Sturm Gra,3026,2,12,5,7,31,30,1,41
Rapid Vienna,3026,3,8,10,6,35,26,9,34
LASK Linz,3026,4,7,6,11,26,33,-7,27
SC Rheindorf,3026,5,7,6,11,20,27,-7,27
Vienna,3026,6,7,5,12,26,39,-13,26
Mattersburg,3026,7,5,7,12,29,43,-14,22
FC Salzburg,3027,1,15,7,2,45,16,29,52
SK Sturm Gra,3027,2,14,3,7,33,28,5,45
Rapid Vienna,3027,3,8,9,7,35,29,6,33
Vienna,3027,4,7,6,11,28,40,-12,27
LASK Linz,3027,5,7,5,12,24,31,-7,26
Mattersburg,3027,6,7,5,12,31,44,-13,26
SC Rheindorf,3027,7,6,5,13,21,29,-8,23
FC Salzburg,3028,1,14,7,3,49,20,29,49
SK Sturm Gra,3028,2,11,4,9,28,33,-5,37
Rapid Vienna,3028,3,8,11,5,35,27,8,35
LASK Linz,3028,4,8,6,10,27,34,-7,30
SC Rheindorf,3028,5,7,6,11,25,28,-3,27
Mattersburg,3028,6,7,6,11,36,43,-7,27
Vienna,3028,7,6,6,12,24,39,-15,24
FC Salzburg,3029,1,13,8,3,44,20,24,47
Rapid Vienna,3029,2,9,10,5,34,26,8,37
SK Sturm Gra,3029,3,11,4,9,31,31,0,37
LASK Linz,3029,4,9,7,8,27,25,2,34
Mattersburg,3029,5,7,7,10,32,40,-8,28
Vienna,3029,6,6,6,12,25,40,-15,24
SC Rheindorf,3029,7,5,6,13,18,29,-11,21
FC Salzburg,3030,1,13,7,4,41,18,23,46
Rapid Vienna,3030,2,11,9,4,38,25,13,42
SK Sturm Gra,3030,3,11,6,7,30,27,3,39
LASK Linz,3030,4,7,7,10,25,31,-6,28
Vienna,3030,5,7,6,11,25,38,-13,27
Mattersburg,3030,6,6,6,12,32,41,-9,24
SC Rheindorf,3030,7,5,7,12,18,29,-11,22
FC Salzburg,3031,1,15,6,3,45,17,28,51
SK Sturm Gra,3031,2,13,4,7,33,28,5,43
Rapid Vienna,3031,3,8,11,5,36,28,8,35
LASK Linz,3031,4,7,7,10,27,33,-6,28
Mattersburg,3031,5,6,7,11,30,40,-10,25
Vienna,3031,6,6,6,12,25,42,-17,24
SC Rheindorf,3031,7,6,5,13,22,30,-8,23
FC Salzburg,3032,1,16,6,2,52,18,34,54
SK Sturm Gra,3032,2,12,3,9,31,31,0,39
LASK Linz,3032,3,10,5,9,27,29,-2,35
Rapid Vienna,3032,4,8,9,7,35,29,6,33
Mattersburg,3032,5,7,6,11,34,44,-10,27
Vienna,3032,6,6,6,12,26,43,-17,24
SC Rheindorf,3032,7,5,5,14,18,29,-11,20
FC Salzburg,3033,1,13,9,2,43,17,26,48
SK Sturm Gra,3033,2,13,4,7,32,26,6,43
Rapid Vienna,3033,3,7,11,6,33,28,5,32
LASK Linz,3033,4,8,6,10,26,29,-3,30
Vienna,3033,5,7,6,11,28,39,-11,27
SC Rheindorf,3033,6,6,6,12,18,27,-9,24
Mattersburg,3033,7,6,6,12,31,45,-14,24
FC Salzburg,3034,1,13,7,4,42,21,21,46
SK Sturm Gra,3034,2,14,4,6,36,25,11,46
Rapid Vienna,3034,3,7,11,6,34,29,5,32
LASK Linz,3034,4,7,6,11,23,30,-7,27
Mattersburg,3034,5,7,6,11,30,40,-10,27
Vienna,3034,6,7,5,12,27,40,-13,26
SC Rheindorf,3034,7,6,7,11,21,28,-7,25
FC Salzburg,3035,1,12,10,2,40,17,23,46
SK Sturm Gra,3035,2,14,4,6,38,28,10,46
LASK Linz,3035,3,9,5,10,28,33,-5,32
Rapid Vienna,3035,4,7,10,7,34,29,5,31
Mattersburg,3035,5,7,6,11,31,39,-8,27
Vienna,3035,6,6,6,12,23,38,-15,24
SC Rheindorf,3035,7,6,5,13,19,29,-10,23
FC Salzburg,3036,1,14,7,3,44,19,25,49
SK Sturm Gra,3036,2,12,4,8,33,32,1,40
Rapid Vienna,3036,3,9,10,5,36,27,9,37
LASK Linz,3036,4,9,6,9,28,27,1,33
Mattersburg,3036,5,7,6,11,35,41,-6,27
Vienna,3036,6,6,5,13,24,42,-18,23
SC Rheindorf,3036,7,5,6,13,19,31,-12,21
FC Salzburg,3037,1,16,6,2,50,18,32,54
SK Sturm Gra,3037,2,12,4,8,32,30,2,40
Rapid Vienna,3037,3,7,10,7,33,31,2,31
LASK Linz,3037,4,8,6,10,28,30,-2,30
Vienna,3037,5,7,5,12,26,40,-14,26
SC Rheindorf,3037,6,6,7,11,19,27,-8,25
Mattersburg,3037,7,6,6,12,29,41,-12,24
FC Salzburg,3038,1,15,7,2,45,16,29,52
SK Sturm Gra,3038,2,13,4,7,36,28,8,43
Rapid Vienna,3038,3,7,10,7,37,35,2,31
LASK Linz,3038,4,8,5,11,27,33,-6,29
Mattersburg,3038,5,7,6,11,35,42,-7,27
SC Rheindorf,3038,6,6,7,11,21,29,-8,25
Vienna,3038,7,6,5,13,24,42,-18,23
FC Salzburg,3039,1,14,7,3,44,17,27,49
SK Sturm Gra,3039,2,13,4,7,34,28,6,43
Rapid Vienna,3039,3,9,11,4,35,24,11,38
LASK Linz,3039,4,7,7,10,27,31,-4,28
Vienna,3039,5,7,6,11,26,39,-13,27
Mattersburg,3039,6,6,6,12,29,43,-14,24
SC Rheindorf,3039,7,4,7,13,20,33,-13,19
FC Salzburg,3040,1,15,6,3,48,20,28,51
SK Sturm Gra,3040,2,13,3,8,32,28,4,42
Rapid Vienna,3040,3,9,9,6,35,28,7,36
LASK Linz,3040,4,9,5,10,29,30,-1,32
Mattersburg,3040,5,8,5,11,38,41,-3,29
Vienna,3040,6,6,5,13,24,44,-20,23
SC Rheindorf,3040,7,5,5,14,18,33,-15,20
FC Salzburg,3041,1,14,7,3,44,17,27,49
SK Sturm Gra,3041,2,12,4,8,33,30,3,40
Rapid Vienna,3041,3,10,9,5,37,26,11,39
Vienna,3041,4,8,5,11,28,37,-9,29
LASK Linz,3041,5,7,5,12,25,32,-7,26
SC Rheindorf,3041,6,6,6,12,20,29,-9,24
Mattersburg,3041,7,6,6,12,27,43,-16,24
FC Salzburg,3042,1,14,8,2,45,17,28,50
Rapid Vienna,3042,2,10,9,5,38,27,11,39
SK Sturm Gra,3042,3,11,5,8,28,26,2,38
LASK Linz,3042,4,7,6,11,23,30,-7,27
Vienna,3042,5,7,6,11,25,38,-13,27
SC Rheindorf,3042,6,7,5,12,20,30,-10,26
Mattersburg,3042,7,6,5,13,30,41,-11,23
FC Salzburg,3043,1,14,7,3,46,20,26,49
SK Sturm Gra,3043,2,12,4,8,33,32,1,40
Rapid Vienna,3043,3,7,12,5,34,27,7,33
LASK Linz,3043,4,9,5,10,26,30,-4,32
Vienna,3043,5,8,5,11,28,39,-11,29
SC Rheindorf,3043,6,6,6,12,22,28,-6,24
Mattersburg,3043,7,6,5,13,28,41,-13,23
FC Salzburg,3044,1,14,8,2,45,20,25,50
Rapid Vienna,3044,2,9,10,5,39,28,11,37
SK Sturm Gra,3044,3,11,4,9,32,33,-1,37
LASK Linz,3044,4,8,7,9,29,31,-2,31
SC Rheindorf,3044,5,6,7,11,22,29,-7,25
Mattersburg,3044,6,6,6,12,32,43,-11,24
Vienna,3044,7,6,6,12,26,41,-15,24
FC Salzburg,3045,1,14,7,3,45,19,26,49
SK Sturm Gra,3045,2,14,3,7,36,29,7,45
LASK Linz,3045,3,10,5,9,28,28,0,35
Rapid Vienna,3045,4,8,10,6,39,31,8,34
Mattersburg,3045,5,6,7,11,28,39,-11,25
Vienna,3045,6,6,5,13,24,42,-18,23
SC Rheindorf,3045,7,4,7,13,18,30,-12,19
FC Salzburg,3046,1,15,7,2,49,19,30,52
SK Sturm Gra,3046,2,12,3,9,31,32,-1,39
Rapid Vienna,3046,3,8,11,5,35,28,7,35
LASK Linz,3046,4,9,5,10,32,30,2,32
SC Rheindorf,3046,5,6,6,12,22,29,-7,24
Mattersburg,3046,6,6,6,12,30,44,-14,24
Vienna,3046,7,6,6,12,24,41,-17,24
FC Salzburg,3047,1,14,6,4,44,22,22,48
SK Sturm Gra,3047,2,14,4,6,37,28,9,46
Rapid Vienna,3047,3,9,10,5,37,27,10,37
Mattersburg,3047,4,7,6,11,33,42,-9,27
LASK Linz,3047,5,7,5,12,26,33,-7,26
Vienna,3047,6,6,6,12,28,43,-15,24
SC Rheindorf,3047,7,5,7,12,22,32,-10,22
FC Salzburg,3048,1,15,7,2,50,19,31,52
Rapid Vienna,3048,2,9,11,4,35,24,11,38
SK Sturm Gra,3048,3,11,5,8,30,31,-1,38
LASK Linz,3048,4,7,7,10,23,28,-5,28
Mattersburg,3048,5,7,5,12,33,46,-13,26
Vienna,3048,6,7,5,12,30,43,-13,26
SC Rheindorf,3048,7,5,6,13,19,29,-10,21
FC Salzburg,3049,1,14,7,3,44,18,26,49
LASK Linz,3049,2,11,5,8,31,27,4,38
SK Sturm Gra,3049,3,11,5,8,31,30,1,38
Rapid Vienna,3049,4,8,10,6,37,31,6,34
Vienna,3049,5,7,6,11,24,37,-13,27
Mattersburg,3049,6,6,7,11,30,40,-10,25
SC Rheindorf,3049,7,4,6,14,19,33,-14,18
FC Salzburg,3050,1,14,8,2,43,17,26,50
SK Sturm Gra,3050,2,11,6,7,29,27,2,39
Rapid Vienna,3050,3,8,11,5,34,27,7,35
LASK Linz,3050,4,8,8,8,29,28,1,32
Mattersburg,3050,5,7,6,11,31,39,-8,27
Vienna,3050,6,6,5,13,25,42,-17,23
SC Rheindorf,3050,7,5,6,13,18,29,-11,21
FC Salzburg,3051,1,15,6,3,47,18,29,51
SK Sturm Gra,3051,2,12,4,8,32,29,3,40
Rapid Vienna,3051,3,9,10,5,38,28,10,37
LASK Linz,3051,4,8,5,11,27,30,-3,29
Mattersburg,3051,5,8,5,11,32,43,-11,29
SC Rheindorf,3051,6,6,5,13,17,28,-11,23
Vienna,3051,7,6,5,13,24,41,-17,23
FC Salzburg,3052,1,14,7,3,47,23,24,49
SK Sturm Gra,3052,2,12,4,8,33,30,3,40
LASK Linz,3052,3,10,6,8,31,27,4,36
Rapid Vienna,3052,4,8,9,7,35,31,4,33
Vienna,3052,5,8,5,11,28,38,-10,29
Mattersburg,3052,6,6,6,12,30,43,-13,24
SC Rheindorf,3052,7,5,5,14,19,31,-12,20
FC Salzburg,3053,1,13,8,3,42,18,24,47
SK Sturm Gra,3053,2,14,4,6,37,26,11,46
Rapid Vienna,3053,3,9,10,5,37,28,9,37
LASK Linz,3053,4,8,5,11,27,32,-5,29
Mattersburg,3053,5,7,5,12,30,40,-10,26
Vienna,3053,6,7,5,12,24,39,-15,26
SC Rheindorf,3053,7,5,5,14,16,30,-14,20
FC Salzburg,3054,1,13,8,3,41,17,24,47
SK Sturm Gra,3054,2,12,3,9,32,31,1,39
Rapid Vienna,3054,3,9,11,4,35,23,12,38
LASK Linz,3054,4,9,6,9,30,30,0,33
Vienna,3054,5,7,6,11,27,39,-12,27
SC Rheindorf,3054,6,6,5,13,20,31,-11,23
Mattersburg,3054,7,6,5,13,32,46,-14,23
FC Salzburg,3055,1,16,6,2,51,17,34,54
SK Sturm Gra,3055,2,11,5,8,33,33,0,38
LASK Linz,3055,3,9,7,8,29,27,2,34
Rapid Vienna,3055,4,8,9,7,37,31,6,33
Vienna,3055,5,7,5,12,26,43,-17,26
SC Rheindorf,3055,6,5,7,12,20,31,-11,22
Mattersburg,3055,7,5,7,12,30,44,-14,22
FC Salzburg,3056,1,15,6,3,47,19,28,51
SK Sturm Gra,3056,2,12,4,8,32,30,2,40
Rapid Vienna,3056,3,9,9,6,39,31,8,36
LASK Linz,3056,4,8,7,9,28,27,1,31
Mattersburg,3056,5,7,6,11,36,45,-9,27
Vienna,3056,6,7,5,12,27,41,-14,26
SC Rheindorf,3056,7,4,7,13,21,37,-16,19
FC Salzburg,3057,1,15,6,3,51,21,30,51
SK Sturm Gra,3057,2,12,4,8,34,30,4,40
Rapid Vienna,3057,3,8,11,5,36,29,7,35
LASK Linz,3057,4,8,6,10,29,28,1,30
SC Rheindorf,3057,5,7,5,12,22,30,-8,26
Mattersburg,3057,6,6,6,12,32,47,-15,24
Vienna,3057,7,6,6,12,25,44,-19,24
FC Salzburg,3058,1,13,7,4,39,18,21,46
SK Sturm Gra,3058,2,12,5,7,34,28,6,41
Rapid Vienna,3058,3,9,10,5,39,29,10,37
LASK Linz,3058,4,8,6,10,27,32,-5,30
Vienna,3058,5,8,5,11,27,39,-12,29
Mattersburg,3058,6,7,5,12,33,42,-9,26
SC Rheindorf,3058,7,5,6,13,21,32,-11,21
FC Salzburg,3059,1,14,7,3,43,17,26,49
SK Sturm Gra,3059,2,12,5,7,35,29,6,41
Rapid Vienna,3059,3,10,10,4,37,26,11,40
LASK Linz,3059,4,8,6,10,27,32,-5,30
Mattersburg,3059,5,6,6,12,30,42,-12,24
Vienna,3059,6,6,6,12,24,39,-15,24
SC Rheindorf,3059,7,5,6,13,18,29,-11,21
FC Salzburg,3060,1,14,6,4,46,21,25,48
SK Sturm Gra,3060,2,14,3,7,37,31,6,45
Rapid Vienna,3060,3,9,10,5,37,28,9,37
LASK Linz,3060,4,7,7,10,25,29,-4,28
Mattersburg,3060,5,7,6,11,31,41,-10,27
SC Rheindorf,3060,6,6,5,13,21,31,-10,23
Vienna,3060,7,6,5,13,24,40,-16,23
FC Salzburg,3061,1,15,6,3,46,19,27,51
Rapid Vienna,3061,2,10,10,4,37,25,12,40
SK Sturm Gra,3061,3,11,4,9,31,32,-1,37
LASK Linz,3061,4,9,5,10,26,27,-1,32
Mattersburg,3061,5,6,7,11,31,40,-9,25
Vienna,3061,6,6,6,12,24,39,-15,24
SC Rheindorf,3061,7,5,6,13,18,31,-13,21
FC Salzburg,3062,1,15,6,3,48,18,30,51
SK Sturm Gra,3062,2,14,3,7,34,28,6,45
Rapid Vienna,3062,3,8,9,7,34,30,4,33
LASK Linz,3062,4,8,5,11,25,30,-5,29
Vienna,3062,5,7,6,11,28,41,-13,27
Mattersburg,3062,6,6,7,11,32,43,-11,25
SC Rheindorf,3062,7,5,6,13,18,29,-11,21
FC Salzburg,3063,1,15,6,3,45,19,26,51
SK Sturm Gra,3063,2,12,3,9,35,30,5,39
Rapid Vienna,3063,3,9,9,6,35,27,8,36
LASK Linz,3063,4,8,5,11,27,33,-6,29
Vienna,3063,5,8,5,11,28,40,-12,29
Mattersburg,3063,6,7,5,12,37,46,-9,26
SC Rheindorf,3063,7,6,5,13,22,34,-12,23
FC Salzburg,3064,1,14,8,2,45,17,28,50
SK Sturm Gra,3064,2,14,3,7,34,28,6,45
Rapid Vienna,3064,3,8,10,6,35,27,8,34
LASK Linz,3064,4,9,5,10,29,31,-2,32
Mattersburg,3064,5,6,7,11,32,41,-9,25
Vienna,3064,6,6,5,13,24,44,-20,23
SC Rheindorf,3064,7,5,6,13,19,30,-11,21
FC Salzburg,3065,1,15,7,2,48,19,29,52
SK Sturm Gra,3065,2,12,4,8,31,30,1,40
Rapid Vienna,3065,3,7,11,6,34,30,4,32
LASK Linz,3065,4,9,5,10,30,30,0,32
Vienna,3065,5,7,6,11,24,37,-13,27
Mattersburg,3065,6,7,5,12,30,42,-12,26
SC Rheindorf,3065,7,5,6,13,19,28,-9,21
FC Salzburg,3066,1,13,9,2,44,19,25,48
Rapid Vienna,3066,2,10,10,4,39,28,11,40
SK Sturm Gra,3066,3,11,3,10,30,32,-2,36
LASK Linz,3066,4,9,5,10,29,28,1,32
SC Rheindorf,3066,5,7,5,12,22,29,-7,26
Vienna,3066,6,6,7,11,26,40,-14,25
Mattersburg,3066,7,5,7,12,29,43,-14,22
FC Salzburg,3067,1,14,6,4,46,22,24,48
SK Sturm Gra,3067,2,12,4,8,32,28,4,40
Rapid Vienna,3067,3,9,9,6,36,28,8,36
LASK Linz,3067,4,8,5,11,28,32,-4,29
Mattersburg,3067,5,7,6,11,31,42,-11,27
Vienna,3067,6,7,5,12,28,42,-14,26
SC Rheindorf,3067,7,6,7,11,20,27,-7,25
FC Salzburg,3068,1,13,7,4,44,21,23,46
SK Sturm Gra,3068,2,13,4,7,35,34,1,43
Rapid Vienna,3068,3,9,10,5,39,28,11,37
Mattersburg,3068,4,7,6,11,31,38,-7,27
LASK Linz,3068,5,7,5,12,26,33,-7,26
Vienna,3068,6,7,5,12,25,38,-13,26
SC Rheindorf,3068,7,6,7,11,17,25,-8,25
FC Salzburg,3069,1,14,7,3,46,20,26,49
SK Sturm Gra,3069,2,13,4,7,33,28,5,43
Rapid Vienna,3069,3,8,10,6,35,27,8,34
LASK Linz,3069,4,9,6,9,28,28,0,33
SC Rheindorf,3069,5,6,6,12,20,30,-10,24
Mattersburg,3069,6,6,6,12,29,42,-13,24
Vienna,3069,7,6,5,13,26,42,-16,23
FC Salzburg,3070,1,14,7,3,45,18,27,49
SK Sturm Gra,3070,2,12,4,8,33,31,2,40
Rapid Vienna,3070,3,9,9,6,34,30,4,36
LASK Linz,3070,4,8,8,8,31,28,3,32
Mattersburg,3070,5,7,6,11,35,45,-10,27
Vienna,3070,6,6,6,12,25,40,-15,24
SC Rheindorf,3070,7,5,6,13,22,33,-11,21
FC Salzburg,3071,1,14,7,3,43,18,25,49
SK Sturm Gra,3071,2,15,3,6,34,25,9,48
Rapid Vienna,3071,3,8,10,6,37,26,11,34
LASK Linz,3071,4,8,7,9,29,30,-1,31
Mattersburg,3071,5,6,7,11,30,40,-10,25
Vienna,3071,6,6,7,11,24,38,-14,25
SC Rheindorf,3071,7,4,5,15,17,37,-20,17
FC Salzburg,3072,1,14,7,3,41,18,23,49
SK Sturm Gra,3072,2,12,4,8,30,28,2,40
Rapid Vienna,3072,3,8,10,6,34,28,6,34
LASK Linz,3072,4,9,5,10,28,28,0,32
SC Rheindorf,3072,5,8,5,11,21,25,-4,29
Mattersburg,3072,6,6,6,12,28,39,-11,24
Vienna,3072,7,6,5,13,23,39,-16,23
FC Salzburg,3073,1,14,8,2,44,18,26,50
Rapid Vienna,3073,2,10,10,4,36,24,12,40
SK Sturm Gra,3073,3,11,5,8,31,29,2,38
LASK Linz,3073,4,9,6,9,28,27,1,33
Vienna,3073,5,7,5,12,26,40,-14,26
SC Rheindorf,3073,6,5,6,13,18,31,-13,21
Mattersburg,3073,7,5,6,13,28,42,-14,21
FC Salzburg,3074,1,16,6,2,51,18,33,54
SK Sturm Gra,3074,2,13,3,8,32,29,3,42
LASK Linz,3074,3,10,5,9,29,28,1,35
Rapid Vienna,3074,4,8,9,7,37,30,7,33
Vienna,3074,5,7,5,12,26,42,-16,26
Mattersburg,3074,6,6,5,13,28,42,-14,23
SC Rheindorf,3074,7,5,5,14,16,30,-14,20
FC Salzburg,3075,1,13,9,2,44,20,24,48
SK Sturm Gra,3075,2,12,4,8,32,29,3,40
LASK Linz,3075,3,9,7,8,28,26,2,34
Rapid Vienna,3075,4,7,12,5,34,27,7,33
Vienna,3075,5,7,6,11,28,38,-10,27
Mattersburg,3075,6,6,7,11,30,43,-13,25
SC Rheindorf,3075,7,4,7,13,16,29,-13,19
FC Salzburg,3076,1,13,8,3,43,18,25,47
SK Sturm Gra,3076,2,13,4,7,34,28,6,43
Rapid Vienna,3076,3,8,11,5,34,26,8,35
LASK Linz,3076,4,7,7,10,26,32,-6,28
Vienna,3076,5,7,5,12,25,40,-15,26
SC Rheindorf,3076,6,6,7,11,22,28,-6,25
Mattersburg,3076,7,5,8,11,29,41,-12,23
FC Salzburg,3077,1,13,8,3,41,18,23,47
SK Sturm Gra,3077,2,12,4,8,32,30,2,40
Rapid Vienna,3077,3,8,11,5,37,29,8,35
LASK Linz,3077,4,9,6,9,32,29,3,33
Vienna,3077,5,7,5,12,25,39,-14,26
SC Rheindorf,3077,6,6,6,12,22,31,-9,24
Mattersburg,3077,7,6,6,12,30,43,-13,24
FC Salzburg,3078,1,14,6,4,44,23,21,48
SK Sturm Gra,3078,2,12,3,9,32,30,2,39
Rapid Vienna,3078,3,8,9,7,36,32,4,33
LASK Linz,3078,4,9,6,9,27,27,0,33
Mattersburg,3078,5,7,6,11,36,38,-2,27
SC Rheindorf,3078,6,7,5,12,23,33,-10,26
Vienna,3078,7,7,5,12,28,43,-15,26
FC Salzburg,3079,1,13,7,4,45,23,22,46
SK Sturm Gra,3079,2,11,5,8,33,31,2,38
Rapid Vienna,3079,3,9,10,5,38,29,9,37
LASK Linz,3079,4,9,5,10,27,28,-1,32
SC Rheindorf,3079,5,7,5,12,21,28,-7,26
Mattersburg,3079,6,7,5,12,30,42,-12,26
Vienna,3079,7,7,5,12,27,40,-13,26
FC Salzburg,3080,1,13,7,4,40,20,20,46
SK Sturm Gra,3080,2,12,6,6,32,27,5,42
Rapid Vienna,3080,3,10,10,4,39,25,14,40
LASK Linz,3080,4,9,6,9,28,28,0,33
Mattersburg,3080,5,7,5,12,31,40,-9,26
Vienna,3080,6,6,6,12,25,40,-15,24
SC Rheindorf,3080,7,4,6,14,17,32,-15,18
FC Salzburg,3081,1,15,7,2,44,16,28,52
SK Sturm Gra,3081,2,11,5,8,31,29,2,38
Rapid Vienna,3081,3,9,10,5,34,25,9,37
LASK Linz,3081,4,8,6,10,26,28,-2,30
Mattersburg,3081,5,7,5,12,32,41,-9,26
Vienna,3081,6,7,5,12,25,40,-15,26
SC Rheindorf,3081,7,5,6,13,18,31,-13,21
FC Salzburg,3082,1,14,8,2,42,16,26,50
SK Sturm Gra,3082,2,13,3,8,32,29,3,42
Rapid Vienna,3082,3,8,11,5,34,27,7,35
LASK Linz,3082,4,8,6,10,25,26,-1,30
Vienna,3082,5,7,5,12,26,40,-14,26
Mattersburg,3082,6,5,8,11,29,40,-11,23
SC Rheindorf,3082,7,5,7,12,18,28,-10,22
FC Salzburg,3083,1,13,8,3,40,17,23,47
Rapid Vienna,3083,2,11,9,4,43,27,16,42
SK Sturm Gra,3083,3,11,6,7,32,29,3,39
LASK Linz,3083,4,8,6,10,28,32,-4,30
Vienna,3083,5,7,6,11,25,38,-13,27
Mattersburg,3083,6,6,5,13,30,41,-11,23
SC Rheindorf,3083,7,5,6,13,20,34,-14,21
FC Salzburg,3084,1,14,6,4,42,18,24,48
SK Sturm Gra,3084,2,12,3,9,33,31,2,39
Rapid Vienna,3084,3,9,10,5,38,29,9,37
LASK Linz,3084,4,9,7,8,29,28,1,34
Vienna,3084,5,7,5,12,26,38,-12,26
Mattersburg,3084,6,6,7,11,30,42,-12,25
SC Rheindorf,3084,7,5,6,13,18,30,-12,21
FC Salzburg,3085,1,14,7,3,45,19,26,49
SK Sturm Gra,3085,2,14,4,6,45,27,18,46
Rapid Vienna,3085,3,8,9,7,37,35,2,33
Mattersburg,3085,4,8,6,10,34,40,-6,30
LASK Linz,3085,5,8,5,11,27,33,-6,29
Vienna,3085,6,6,6,12,25,41,-16,24
SC Rheindorf,3085,7,5,5,14,17,35,-18,20
FC Salzburg,3086,1,14,7,3,42,17,25,49
SK Sturm Gra,3086,2,13,3,8,33,27,6,42
Rapid Vienna,3086,3,8,9,7,33,29,4,33
LASK Linz,3086,4,9,5,10,30,31,-1,32
Mattersburg,3086,5,7,6,11,30,39,-9,27
Vienna,3086,6,6,7,11,24,38,-14,25
SC Rheindorf,3086,7,6,5,13,18,29,-11,23
FC Salzburg,3087,1,15,6,3,45,18,27,51
SK Sturm Gra,3087,2,14,3,7,33,27,6,45
Rapid Vienna,3087,3,9,10,5,35,26,9,37
LASK Linz,3087,4,7,6,11,26,32,-6,27
SC Rheindorf,3087,5,6,6,12,19,27,-8,24
Mattersburg,3087,6,6,6,12,30,41,-11,24
Vienna,3087,7,6,5,13,24,41,-17,23
FC Salzburg,3088,1,15,7,2,50,21,29,52
SK Sturm Gra,3088,2,14,3,7,36,28,8,45
Rapid Vienna,3088,3,9,10,5,36,27,9,37
LASK Linz,3088,4,8,5,11,26,31,-5,29
Vienna,3088,5,7,5,12,26,42,-16,26
Mattersburg,3088,6,6,6,12,31,42,-11,24
SC Rheindorf,3088,7,4,6,14,18,32,-14,18
FC Salzburg,3089,1,15,7,2,45,16,29,52
SK Sturm Gra,3089,2,12,3,9,30,29,1,39
LASK Linz,3089,3,10,5,9,31,29,2,35
Rapid Vienna,3089,4,8,9,7,34,28,6,33
SC Rheindorf,3089,5,7,5,12,20,26,-6,26
Vienna,3089,6,6,6,12,23,41,-18,24
Mattersburg,3089,7,5,7,12,27,41,-14,22
FC Salzburg,3090,1,15,6,3,49,19,30,51
SK Sturm Gra,3090,2,11,4,9,33,37,-4,37
Rapid Vienna,3090,3,9,9,6,39,28,11,36
LASK Linz,3090,4,8,7,9,27,28,-1,31
Mattersburg,3090,5,8,5,11,30,39,-9,29
Vienna,3090,6,7,5,12,26,41,-15,26
SC Rheindorf,3090,7,5,6,13,18,30,-12,21
FC Salzburg,3091,1,15,6,3,44,19,25,51
SK Sturm Gra,3091,2,12,4,8,35,33,2,40
Rapid Vienna,3091,3,10,9,5,42,28,14,39
LASK Linz,3091,4,8,6,10,28,32,-4,30
Vienna,3091,5,7,6,11,27,38,-11,27
Mattersburg,3091,6,5,8,11,29,40,-11,23
SC Rheindorf,3091,7,4,7,13,16,31,-15,19
FC Salzburg,3092,1,15,7,2,47,15,32,52
SK Sturm Gra,3092,2,12,4,8,32,28,4,40
LASK Linz,3092,3,9,5,10,29,31,-2,32
Rapid Vienna,3092,4,7,10,7,37,34,3,31
SC Rheindorf,3092,5,7,6,11,21,26,-5,27
Mattersburg,3092,6,6,6,12,29,44,-15,24
Vienna,3092,7,6,6,12,24,41,-17,24
FC Salzburg,3093,1,12,8,4,40,19,21,44
SK Sturm Gra,3093,2,13,4,7,36,29,7,43
Rapid Vienna,3093,3,8,11,5,36,26,10,35
LASK Linz,3093,4,8,6,10,27,32,-5,30
Vienna,3093,5,8,5,11,27,39,-12,29
Mattersburg,3093,6,6,7,11,32,42,-10,25
SC Rheindorf,3093,7,6,5,13,20,31,-11,23
FC Salzburg,3094,1,14,7,3,42,19,23,49
SK Sturm Gra,3094,2,13,4,7,37,30,7,43
Rapid Vienna,3094,3,9,9,6,36,29,7,36
LASK Linz,3094,4,9,5,10,30,32,-2,32
Mattersburg,3094,5,8,5,11,32,39,-7,29
Vienna,3094,6,7,5,12,27,40,-13,26
SC Rheindorf,3094,7,4,5,15,19,34,-15,17
FC Salzburg,3095,1,14,7,3,44,19,25,49
SK Sturm Gra,3095,2,12,3,9,34,32,2,39
LASK Linz,3095,3,11,5,8,31,27,4,38
Rapid Vienna,3095,4,8,9,7,35,30,5,33
Vienna,3095,5,7,6,11,26,39,-13,27
Mattersburg,3095,6,7,5,12,31,42,-11,26
SC Rheindorf,3095,7,5,5,14,20,32,-12,20
FC Salzburg,3096,1,15,7,2,46,18,28,52
SK Sturm Gra,3096,2,13,3,8,36,32,4,42
Rapid Vienna,3096,3,9,9,6,35,29,6,36
LASK Linz,3096,4,7,6,11,28,32,-4,27
SC Rheindorf,3096,5,7,5,12,22,29,-7,26
Vienna,3096,6,6,7,11,25,39,-14,25
Mattersburg,3096,7,5,7,12,29,42,-13,22
FC Salzburg,3097,1,13,7,4,46,21,25,46
SK Sturm Gra,3097,2,14,4,6,36,26,10,46
Rapid Vienna,3097,3,8,11,5,37,29,8,35
LASK Linz,3097,4,9,5,10,29,31,-2,32
Mattersburg,3097,5,7,5,12,31,45,-14,26
Vienna,3097,6,7,5,12,28,42,-14,26
SC Rheindorf,3097,7,4,7,13,16,29,-13,19
FC Salzburg,3098,1,16,6,2,45,15,30,54
SK Sturm Gra,3098,2,13,4,7,33,27,6,43
Rapid Vienna,3098,3,8,10,6,34,28,6,34
LASK Linz,3098,4,8,5,11,25,30,-5,29
SC Rheindorf,3098,5,7,5,12,21,28,-7,26
Vienna,3098,6,7,5,12,26,41,-15,26
Mattersburg,3098,7,5,5,14,28,43,-15,20
FC Salzburg,3099,1,14,8,2,47,20,27,50
SK Sturm Gra,3099,2,13,4,7,34,27,7,43
Rapid Vienna,3099,3,9,11,4,40,27,13,38
LASK Linz,3099,4,8,5,11,29,34,-5,29
Vienna,3099,5,7,6,11,24,37,-13,27
Mattersburg,3099,6,6,5,13,32,45,-13,23
SC Rheindorf,3099,7,5,5,14,20,36,-16,20
FC Salzburg,3100,1,15,6,3,51,23,28,51
SK Sturm Gra,3100,2,13,3,8,34,31,3,42
Rapid Vienna,3100,3,10,9,5,43,28,15,39
LASK Linz,3100,4,8,6,10,29,34,-5,30
Mattersburg,3100,5,7,5,12,36,47,-11,26
Vienna,3100,6,7,5,12,29,42,-13,26
SC Rheindorf,3100,7,4,6,14,20,37,-17,18
FC Salzburg,3101,1,16,6,2,52,18,34,54
SK Sturm Gra,3101,2,13,4,7,34,31,3,43
Rapid Vienna,3101,3,7,9,8,37,36,1,30
LASK Linz,3101,4,8,6,10,28,31,-3,30
SC Rheindorf,3101,5,7,5,12,23,29,-6,26
Mattersburg,3101,6,7,5,12,33,45,-12,26
Vienna,3101,7,6,5,13,24,41,-17,23
FC Salzburg,3102,1,14,7,3,49,19,30,49
SK Sturm Gra,3102,2,14,4,6,34,26,8,46
Rapid Vienna,3102,3,8,9,7,36,31,5,33
LASK Linz,3102,4,8,5,11,28,33,-5,29
Mattersburg,3102,5,6,7,11,34,46,-12,25
Vienna,3102,6,6,7,11,26,40,-14,25
SC Rheindorf,3102,7,5,7,12,21,33,-12,22
FC Salzburg,3103,1,15,6,3,44,17,27,51
SK Sturm Gra,3103,2,13,4,7,36,31,5,43
Rapid Vienna,3103,3,9,10,5,37,28,9,37
LASK Linz,3103,4,9,6,9,28,27,1,33
Vienna,3103,5,6,6,12,25,40,-15,24
Mattersburg,3103,6,5,8,11,33,44,-11,23
SC Rheindorf,3103,7,4,6,14,20,36,-16,18
FC Salzburg,3104,1,16,6,2,49,17,32,54
SK Sturm Gra,3104,2,11,6,7,30,30,0,39
Rapid Vienna,3104,3,8,10,6,34,28,6,34
LASK Linz,3104,4,8,7,9,28,29,-1,31
Mattersburg,3104,5,6,7,11,34,44,-10,25
Vienna,3104,6,6,5,13,25,42,-17,23
SC Rheindorf,3104,7,5,7,12,20,30,-10,22
FC Salzburg,3105,1,15,7,2,48,17,31,52
SK Sturm Gra,3105,2,13,4,7,34,29,5,43
Rapid Vienna,3105,3,7,11,6,37,33,4,32
LASK Linz,3105,4,9,5,10,28,30,-2,32
SC Rheindorf,3105,5,6,6,12,21,30,-9,24
Vienna,3105,6,6,6,12,25,41,-16,24
Mattersburg,3105,7,6,5,13,29,42,-13,23
FC Salzburg,3106,1,16,6,2,46,17,29,54
SK Sturm Gra,3106,2,14,3,7,40,29,11,45
Rapid Vienna,3106,3,8,9,7,37,34,3,33
LASK Linz,3106,4,8,5,11,27,33,-6,29
Vienna,3106,5,7,5,12,25,39,-14,26
SC Rheindorf,3106,6,6,5,13,21,32,-11,23
Mattersburg,3106,7,6,5,13,29,41,-12,23
FC Salzburg,3107,1,14,7,3,46,20,26,49
SK Sturm Gra,3107,2,15,3,6,37,28,9,48
Rapid Vienna,3107,3,8,10,6,36,28,8,34
LASK Linz,3107,4,8,6,10,28,30,-2,30
Vienna,3107,5,7,5,12,28,43,-15,26
Mattersburg,3107,6,6,7,11,32,42,-10,25
SC Rheindorf,3107,7,4,6,14,18,34,-16,18
FC Salzburg,3108,1,14,8,2,46,17,29,50
SK Sturm Gra,3108,2,13,3,8,34,28,6,42
LASK Linz,3108,3,9,6,9,33,29,4,33
Rapid Vienna,3108,4,7,11,6,36,31,5,32
Mattersburg,3108,5,7,6,11,28,41,-13,27
Vienna,3108,6,6,6,12,23,38,-15,24
SC Rheindorf,3108,7,5,6,13,17,33,-16,21
FC Salzburg,3109,1,16,6,2,50,17,33,54
SK Sturm Gra,3109,2,13,3,8,32,30,2,42
Rapid Vienna,3109,3,7,10,7,33,28,5,31
SC Rheindorf,3109,4,8,5,11,22,28,-6,29
LASK Linz,3109,5,7,6,11,23,27,-4,27
Mattersburg,3109,6,7,5,12,33,44,-11,26
Vienna,3109,7,6,5,13,25,44,-19,23
FC Salzburg,3110,1,14,8,2,47,18,29,50
SK Sturm Gra,3110,2,13,4,7,36,31,5,43
Rapid Vienna,3110,3,8,10,6,37,30,7,34
LASK Linz,3110,4,8,5,11,27,32,-5,29
Vienna,3110,5,7,6,11,26,38,-12,27
Mattersburg,3110,6,7,5,12,29,42,-13,26
SC Rheindorf,3110,7,5,6,13,19,30,-11,21
FC Salzburg,3111,1,13,8,3,42,18,24,47
SK Sturm Gra,3111,2,14,4,6,37,26,11,46
Rapid Vienna,3111,3,8,10,6,32,27,5,34
LASK Linz,3111,4,8,6,10,27,30,-3,30
Mattersburg,3111,5,6,7,11,32,41,-9,25
Vienna,3111,6,6,7,11,25,39,-14,25
SC Rheindorf,3111,7,5,6,13,19,33,-14,21
FC Salzburg,3112,1,15,6,3,44,17,27,51
SK Sturm Gra,3112,2,12,4,8,31,31,0,40
LASK Linz,3112,3,9,7,8,30,26,4,34
Rapid Vienna,3112,4,7,9,8,33,30,3,30
Mattersburg,3112,5,7,7,10,33,40,-7,28
SC Rheindorf,3112,6,6,6,12,20,30,-10,24
Vienna,3112,7,6,5,13,24,41,-17,23
FC Salzburg,3113,1,14,8,2,51,21,30,50
SK Sturm Gra,3113,2,13,4,7,32,29,3,43
Rapid Vienna,3113,3,9,11,4,37,26,11,38
LASK Linz,3113,4,8,6,10,26,28,-2,30
Mattersburg,3113,5,7,6,11,33,41,-8,27
Vienna,3113,6,6,5,13,24,43,-19,23
SC Rheindorf,3113,7,4,6,14,17,32,-15,18
FC Salzburg,3114,1,15,6,3,48,19,29,51
SK Sturm Gra,3114,2,13,5,6,38,30,8,44
Rapid Vienna,3114,3,9,10,5,38,27,11,37
LASK Linz,3114,4,7,7,10,27,33,-6,28
Vienna,3114,5,7,5,12,28,41,-13,26
Mattersburg,3114,6,6,6,12,32,47,-15,24
SC Rheindorf,3114,7,4,7,13,22,36,-14,19
FC Salzburg,3115,1,14,7,3,43,17,26,49
SK Sturm Gra,3115,2,13,3,8,32,30,2,42
Rapid Vienna,3115,3,9,10,5,36,25,11,37
LASK Linz,3115,4,9,6,9,31,30,1,33
Vienna,3115,5,7,5,12,26,40,-14,26
Mattersburg,3115,6,6,6,12,33,44,-11,24
SC Rheindorf,3115,7,5,5,14,17,32,-15,20
FC Salzburg,3116,1,14,8,2,47,20,27,50
SK Sturm Gra,3116,2,12,4,8,36,31,5,40
Rapid Vienna,3116,3,9,11,4,39,29,10,38
LASK Linz,3116,4,7,7,10,26,31,-5,28
Vienna,3116,5,7,6,11,26,39,-13,27
Mattersburg,3116,6,6,6,12,30,43,-13,24
SC Rheindorf,3116,7,4,8,12,19,30,-11,20
FC Salzburg,3117,1,14,6,4,40,17,23,48
SK Sturm Gra,3117,2,12,4,8,32,29,3,40
Rapid Vienna,3117,3,9,9,6,36,28,8,36
LASK Linz,3117,4,10,5,9,32,29,3,35
Vienna,3117,5,8,5,11,25,37,-12,29
SC Rheindorf,3117,6,5,7,12,21,32,-11,22
Mattersburg,3117,7,5,6,13,27,41,-14,21
FC Salzburg,3118,1,15,6,3,43,17,26,51
SK Sturm Gra,3118,2,11,3,10,29,32,-3,36
Rapid Vienna,3118,3,8,11,5,35,25,10,35
LASK Linz,3118,4,9,6,9,27,27,0,33
Vienna,3118,5,8,5,11,27,39,-12,29
SC Rheindorf,3118,6,6,7,11,21,29,-8,25
Mattersburg,3118,7,5,6,13,29,42,-13,21
FC Salzburg,3119,1,14,7,3,45,21,24,49
SK Sturm Gra,3119,2,12,3,9,34,31,3,39
Rapid Vienna,3119,3,9,10,5,38,27,11,37
LASK Linz,3119,4,7,8,9,25,28,-3,29
Mattersburg,3119,5,6,8,10,30,39,-9,26
Vienna,3119,6,6,7,11,26,40,-14,25
SC Rheindorf,3119,7,5,7,12,20,32,-12,22
FC Salzburg,3120,1,16,6,2,49,17,32,54
SK Sturm Gra,3120,2,11,5,8,31,30,1,38
Rapid Vienna,3120,3,9,9,6,35,28,7,36
LASK Linz,3120,4,9,7,8,27,26,1,34
Vienna,3120,5,7,5,12,25,40,-15,26
Mattersburg,3120,6,6,6,12,30,43,-13,24
SC Rheindorf,3120,7,4,6,14,19,32,-13,18
FC Salzburg,3121,1,14,6,4,44,20,24,48
SK Sturm Gra,3121,2,14,3,7,34,27,7,45
Rapid Vienna,3121,3,8,10,6,34,28,6,34
LASK Linz,3121,4,8,6,10,25,28,-3,30
Mattersburg,3121,5,8,5,11,34,39,-5,29
Vienna,3121,6,7,5,12,26,40,-14,26
SC Rheindorf,3121,7,5,5,14,19,34,-15,20
FC Salzburg,3122,1,14,6,4,42,18,24,48
SK Sturm Gra,3122,2,14,3,7,35,28,7,45
Rapid Vienna,3122,3,8,11,5,37,30,7,35
LASK Linz,3122,4,7,7,10,27,31,-4,28
SC Rheindorf,3122,5,7,6,11,23,29,-6,27
Vienna,3122,6,7,5,12,24,38,-14,26
Mattersburg,3122,7,5,6,13,29,43,-14,21
FC Salzburg,3123,1,15,6,3,41,16,25,51
SK Sturm Gra,3123,2,14,3,7,36,29,7,45
Rapid Vienna,3123,3,9,10,5,39,29,10,37
LASK Linz,3123,4,7,7,10,26,29,-3,28
Vienna,3123,5,7,5,12,26,38,-12,26
Mattersburg,3123,6,6,6,12,28,41,-13,24
SC Rheindorf,3123,7,4,7,13,18,32,-14,19
FC Salzburg,3124,1,15,7,2,52,17,35,52
SK Sturm Gra,3124,2,12,4,8,30,31,-1,40
LASK Linz,3124,3,10,6,8,31,28,3,36
Rapid Vienna,3124,4,8,11,5,38,30,8,35
Mattersburg,3124,5,6,6,12,32,44,-12,24
Vienna,3124,6,6,6,12,26,46,-20,24
SC Rheindorf,3124,7,4,6,14,18,31,-13,18
FC Salzburg,3125,1,15,7,2,45,19,26,52
SK Sturm Gra,3125,2,12,4,8,32,29,3,40
LASK Linz,3125,3,10,6,8,33,28,5,36
Rapid Vienna,3125,4,8,10,6,38,29,9,34
Vienna,3125,5,6,6,12,25,40,-15,24
Mattersburg,3125,6,5,7,12,29,43,-14,22
SC Rheindorf,3125,7,5,6,13,18,32,-14,21
FC Salzburg,3126,1,16,6,2,48,16,32,54
Rapid Vienna,3126,2,10,9,5,39,26,13,39
SK Sturm Gra,3126,3,12,3,9,30,29,1,39
LASK Linz,3126,4,7,6,11,26,31,-5,27
Vienna,3126,5,7,5,12,26,43,-17,26
SC Rheindorf,3126,6,6,6,12,19,29,-10,24
Mattersburg,3126,7,5,7,12,30,44,-14,22
FC Salzburg,3127,1,14,7,3,45,19,26,49
SK Sturm Gra,3127,2,12,4,8,31,29,2,40
Rapid Vienna,3127,3,9,10,5,35,27,8,37
LASK Linz,3127,4,8,6,10,27,29,-2,30
SC Rheindorf,3127,5,6,7,11,21,27,-6,25
Mattersburg,3127,6,6,7,11,32,41,-9,25
Vienna,3127,7,6,5,13,24,43,-19,23
FC Salzburg,3128,1,14,7,3,51,21,30,49
SK Sturm Gra,3128,2,12,4,8,32,33,-1,40
Rapid Vienna,3128,3,9,11,4,41,29,12,38
LASK Linz,3128,4,8,6,10,29,29,0,30
Vienna,3128,5,7,5,12,26,41,-15,26
SC Rheindorf,3128,6,6,6,12,19,27,-8,24
Mattersburg,3128,7,6,5,13,28,46,-18,23
FC Salzburg,3129,1,15,7,2,47,16,31,52
SK Sturm Gra,3129,2,13,5,6,34,28,6,44
LASK Linz,3129,3,8,7,9,27,28,-1,31
Rapid Vienna,3129,4,7,9,8,33,31,2,30
Mattersburg,3129,5,7,6,11,31,42,-11,27
Vienna,3129,6,6,6,12,24,41,-17,24
SC Rheindorf,3129,7,5,6,13,19,29,-10,21
FC Salzburg,3130,1,14,7,3,45,18,27,49
SK Sturm Gra,3130,2,13,4,7,35,30,5,43
Rapid Vienna,3130,3,8,11,5,35,27,8,35
Vienna,3130,4,8,5,11,29,39,-10,29
LASK Linz,3130,5,7,7,10,27,31,-4,28
Mattersburg,3130,6,6,6,12,29,44,-15,24
SC Rheindorf,3130,7,4,8,12,19,30,-11,20
FC Salzburg,3131,1,14,6,4,50,20,30,48
SK Sturm Gra,3131,2,14,4,6,34,26,8,46
Rapid Vienna,3131,3,10,9,5,43,32,11,39
Mattersburg,3131,4,8,5,11,32,44,-12,29
LASK Linz,3131,5,7,5,12,26,34,-8,26
Vienna,3131,6,6,5,13,24,42,-18,23
SC Rheindorf,3131,7,5,6,13,18,29,-11,21
FC Salzburg,3132,1,15,7,2,46,20,26,52
SK Sturm Gra,3132,2,12,4,8,36,32,4,40
Rapid Vienna,3132,3,8,11,5,35,26,9,35
LASK Linz,3132,4,8,6,10,27,31,-4,30
Mattersburg,3132,5,8,5,11,31,37,-6,29
Vienna,3132,6,6,5,13,24,40,-16,23
SC Rheindorf,3132,7,5,6,13,17,30,-13,21
FC Salzburg,3133,1,14,8,2,44,17,27,50
LASK Linz,3133,2,10,6,8,32,29,3,36
SK Sturm Gra,3133,3,11,3,10,31,33,-2,36
Rapid Vienna,3133,4,8,11,5,37,29,8,35
Vienna,3133,5,7,5,12,27,41,-14,26
SC Rheindorf,3133,6,6,7,11,22,29,-7,25
Mattersburg,3133,7,5,6,13,29,44,-15,21
FC Salzburg,3134,1,14,7,3,44,18,26,49
SK Sturm Gra,3134,2,12,4,8,30,28,2,40
Rapid Vienna,3134,3,9,10,5,35,25,10,37
LASK Linz,3134,4,10,5,9,28,26,2,35
Vienna,3134,5,7,5,12,25,41,-16,26
Mattersburg,3134,6,6,5,13,30,41,-11,23
SC Rheindorf,3134,7,5,6,13,17,30,-13,21
FC Salzburg,3135,1,15,6,3,45,19,26,51
SK Sturm Gra,3135,2,13,4,7,38,30,8,43
Rapid Vienna,3135,3,9,9,6,35,28,7,36
LASK Linz,3135,4,8,7,9,28,27,1,31
Mattersburg,3135,5,7,6,11,29,40,-11,27
Vienna,3135,6,6,6,12,24,40,-16,24
SC Rheindorf,3135,7,4,6,14,18,33,-15,18
FC Salzburg,3136,1,15,6,3,46,18,28,51
Rapid Vienna,3136,2,10,10,4,37,24,13,40
SK Sturm Gra,3136,3,11,5,8,29,29,0,38
LASK Linz,3136,4,7,7,10,25,28,-3,28
Vienna,3136,5,7,5,12,25,39,-14,26
SC Rheindorf,3136,6,6,7,11,20,28,-8,25
Mattersburg,3136,7,5,6,13,29,45,-16,21
FC Salzburg,3137,1,15,6,3,45,18,27,51
SK Sturm Gra,3137,2,12,4,8,32,30,2,40
Rapid Vienna,3137,3,10,9,5,38,28,10,39
LASK Linz,3137,4,9,6,9,29,29,0,33
Vienna,3137,5,7,5,12,27,41,-14,26
Mattersburg,3137,6,6,5,13,34,45,-11,23
SC Rheindorf,3137,7,4,7,13,20,34,-14,19
FC Salzburg,3138,1,14,8,2,45,17,28,50
SK Sturm Gra,3138,2,14,4,6,38,28,10,46
Rapid Vienna,3138,3,8,9,7,34,29,5,33
LASK Linz,3138,4,8,5,11,26,32,-6,29
Vienna,3138,5,7,5,12,26,42,-16,26
Mattersburg,3138,6,6,7,11,29,39,-10,25
SC Rheindorf,3138,7,5,6,13,18,29,-11,21
FC Salzburg,3139,1,15,7,2,47,16,31,52
SK Sturm Gra,3139,2,12,4,8,31,29,2,40
LASK Linz,3139,3,9,7,8,29,27,2,34
Rapid Vienna,3139,4,8,9,7,35,29,6,33
Vienna,3139,5,7,5,12,26,43,-17,26
Mattersburg,3139,6,6,6,12,33,42,-9,24
SC Rheindorf,3139,7,5,6,13,17,32,-15,21
FC Salzburg,3140,1,15,7,2,49,15,34,52
Rapid Vienna,3140,2,9,10,5,36,27,9,37
SK Sturm Gra,3140,3,11,4,9,31,37,-6,37
LASK Linz,3140,4,9,5,10,27,31,-4,32
SC Rheindorf,3140,5,7,5,12,23,28,-5,26
Vienna,3140,6,7,5,12,25,39,-14,26
Mattersburg,3140,7,5,6,13,27,41,-14,21
FC Salzburg,3141,1,15,7,2,45,17,28,52
SK Sturm Gra,3141,2,12,5,7,37,31,6,41
Rapid Vienna,3141,3,7,11,6,38,32,6,32
LASK Linz,3141,4,9,5,10,29,34,-5,32
SC Rheindorf,3141,5,6,7,11,24,29,-5,25
Vienna,3141,6,6,6,12,24,42,-18,24
Mattersburg,3141,7,6,5,13,32,44,-12,23
FC Salzburg,3142,1,13,7,4,43,22,21,46
SK Sturm Gra,3142,2,14,3,7,34,28,6,45
Rapid Vienna,3142,3,10,9,5,37,28,9,39
LASK Linz,3142,4,9,6,9,29,27,2,33
Mattersburg,3142,5,6,7,11,30,40,-10,25
Vienna,3142,6,6,7,11,25,39,-14,25
SC Rheindorf,3142,7,4,5,15,17,31,-14,17
FC Salzburg,3143,1,14,7,3,44,19,25,49
SK Sturm Gra,3143,2,12,3,9,32,29,3,39
LASK Linz,3143,3,10,5,9,32,30,2,35
Rapid Vienna,3143,4,7,11,6,33,29,4,32
Mattersburg,3143,5,7,6,11,33,41,-8,27
Vienna,3143,6,7,6,11,26,39,-13,27
SC Rheindorf,3143,7,5,6,13,18,31,-13,21
FC Salzburg,3144,1,15,7,2,46,16,30,52
SK Sturm Gra,3144,2,13,3,8,32,30,2,42
Rapid Vienna,3144,3,9,9,6,36,31,5,36
LASK Linz,3144,4,8,6,10,31,29,2,30
Vienna,3144,5,6,7,11,26,40,-14,25
Mattersburg,3144,6,6,6,12,32,47,-15,24
SC Rheindorf,3144,7,5,6,13,20,30,-10,21
FC Salzburg,3145,1,13,8,3,43,18,25,47
SK Sturm Gra,3145,2,13,3,8,31,27,4,42
Rapid Vienna,3145,3,8,12,4,33,24,9,36
LASK Linz,3145,4,7,6,11,25,29,-4,27
Mattersburg,3145,5,7,6,11,36,45,-9,27
Vienna,3145,6,6,7,11,27,41,-14,25
SC Rheindorf,3145,7,6,6,12,19,30,-11,24
FC Salzburg,3146,1,16,6,2,49,16,33,54
SK Sturm Gra,3146,2,13,4,7,32,26,6,43
LASK Linz,3146,3,10,5,9,30,28,2,35
Rapid Vienna,3146,4,8,9,7,32,28,4,33
Vienna,3146,5,7,5,12,26,42,-16,26
Mattersburg,3146,6,6,5,13,29,45,-16,23
SC Rheindorf,3146,7,4,6,14,16,29,-13,18
FC Salzburg,3147,1,14,8,2,44,17,27,50
SK Sturm Gra,3147,2,12,3,9,31,30,1,39
Rapid Vienna,3147,3,9,10,5,37,27,10,37
LASK Linz,3147,4,9,5,10,28,29,-1,32
Mattersburg,3147,5,7,7,10,32,39,-7,28
Vienna,3147,6,6,6,12,24,41,-17,24
SC Rheindorf,3147,7,5,5,14,22,35,-13,20
FC Salzburg,3148,1,14,6,4,48,23,25,48
SK Sturm Gra,3148,2,13,3,8,34,35,-1,42
Rapid Vienna,3148,3,8,9,7,35,29,6,33
LASK Linz,3148,4,9,5,10,26,27,-1,32
Mattersburg,3148,5,8,5,11,38,40,-2,29
Vienna,3148,6,7,5,12,26,41,-15,26
SC Rheindorf,3148,7,6,5,13,17,29,-12,23
FC Salzburg,3149,1,15,7,2,50,17,33,52
SK Sturm Gra,3149,2,14,4,6,35,27,8,46
Rapid Vienna,3149,3,7,10,7,33,31,2,31
LASK Linz,3149,4,7,7,10,26,32,-6,28
SC Rheindorf,3149,5,7,5,12,21,26,-5,26
Vienna,3149,6,7,5,12,26,44,-18,26
Mattersburg,3149,7,5,6,13,29,43,-14,21
FC Salzburg,3150,1,14,7,3,43,20,23,49
SK Sturm Gra,3150,2,11,4,9,33,34,-1,37
LASK Linz,3150,3,10,6,8,32,27,5,36
Rapid Vienna,3150,4,8,11,5,36,28,8,35
Vienna,3150,5,8,5,11,27,37,-10,29
SC Rheindorf,3150,6,4,9,11,20,30,-10,21
Mattersburg,3150,7,5,6,13,27,42,-15,21
FC Salzburg,3151,1,15,6,3,44,19,25,51
SK Sturm Gra,3151,2,14,3,7,37,29,8,45
LASK Linz,3151,3,9,6,9,28,27,1,33
Rapid Vienna,3151,4,7,10,7,33,31,2,31
Vienna,3151,5,8,5,11,27,37,-10,29
Mattersburg,3151,6,6,6,12,29,41,-12,24
SC Rheindorf,3151,7,4,6,14,17,31,-14,18
FC Salzburg,3152,1,13,7,4,44,21,23,46
SK Sturm Gra,3152,2,12,4,8,31,28,3,40
Rapid Vienna,3152,3,8,11,5,36,29,7,35
LASK Linz,3152,4,9,5,10,29,32,-3,32
Mattersburg,3152,5,8,5,11,33,41,-8,29
Vienna,3152,6,7,5,12,27,41,-14,26
SC Rheindorf,3152,7,5,7,12,23,31,-8,22
FC Salzburg,3153,1,15,7,2,42,15,27,52
SK Sturm Gra,3153,2,12,3,9,29,30,-1,39
Rapid Vienna,3153,3,8,10,6,34,26,8,34
LASK Linz,3153,4,9,5,10,29,29,0,32
Mattersburg,3153,5,8,5,11,33,39,-6,29
SC Rheindorf,3153,6,6,5,13,20,32,-12,23
Vienna,3153,7,6,5,13,23,39,-16,23
FC Salzburg,3154,1,15,6,3,46,18,28,51
Rapid Vienna,3154,2,10,10,4,36,24,12,40
SK Sturm Gra,3154,3,12,3,9,31,29,2,39
Mattersburg,3154,4,8,5,11,36,39,-3,29
LASK Linz,3154,5,7,6,11,27,35,-8,27
Vienna,3154,6,6,5,13,23,44,-21,23
SC Rheindorf,3154,7,5,7,12,18,28,-10,22
FC Salzburg,3155,1,16,6,2,46,16,30,54
LASK Linz,3155,2,11,5,8,29,26,3,38
SK Sturm Gra,3155,3,11,4,9,29,30,-1,37
Rapid Vienna,3155,4,8,10,6,33,26,7,34
Mattersburg,3155,5,6,6,12,28,40,-12,24
Vienna,3155,6,6,6,12,23,40,-17,24
SC Rheindorf,3155,7,5,5,14,18,28,-10,20
FC Salzburg,3156,1,13,8,3,47,21,26,47
SK Sturm Gra,3156,2,13,3,8,32,31,1,42
Rapid Vienna,3156,3,9,10,5,39,30,9,37
LASK Linz,3156,4,8,5,11,27,29,-2,29
Vienna,3156,5,8,5,11,31,40,-9,29
SC Rheindorf,3156,6,6,6,12,20,29,-9,24
Mattersburg,3156,7,5,7,12,31,47,-16,22
FC Salzburg,3157,1,14,7,3,46,21,25,49
SK Sturm Gra,3157,2,12,4,8,34,32,2,40
Rapid Vienna,3157,3,9,11,4,37,26,11,38
LASK Linz,3157,4,9,6,9,32,31,1,33
Mattersburg,3157,5,7,7,10,32,40,-8,28
Vienna,3157,6,6,5,13,25,41,-16,23
SC Rheindorf,3157,7,4,6,14,17,32,-15,18
FC Salzburg,3158,1,14,7,3,44,19,25,49
SK Sturm Gra,3158,2,13,3,8,37,27,10,42
Rapid Vienna,3158,3,9,9,6,36,30,6,36
Vienna,3158,4,8,5,11,28,38,-10,29
Mattersburg,3158,5,7,6,11,31,41,-10,27
LASK Linz,3158,6,7,6,11,27,37,-10,27
SC Rheindorf,3158,7,5,6,13,20,31,-11,21
FC Salzburg,3159,1,16,6,2,48,17,31,54
SK Sturm Gra,3159,2,12,5,7,32,30,2,41
Rapid Vienna,3159,3,9,10,5,35,27,8,37
LASK Linz,3159,4,7,7,10,29,32,-3,28
Mattersburg,3159,5,7,5,12,33,42,-9,26
Vienna,3159,6,7,5,12,25,39,-14,26
SC Rheindorf,3159,7,4,6,14,18,33,-15,18
FC Salzburg,3160,1,14,8,2,43,18,25,50
SK Sturm Gra,3160,2,13,5,6,35,29,6,44
Rapid Vienna,3160,3,9,9,6,37,26,11,36
Mattersburg,3160,4,8,5,11,37,42,-5,29
LASK Linz,3160,5,7,6,11,26,34,-8,27
Vienna,3160,6,6,6,12,27,42,-15,24
SC Rheindorf,3160,7,5,5,14,18,32,-14,20
FC Salzburg,3161,1,16,6,2,46,15,31,54
SK Sturm Gra,3161,2,13,4,7,32,27,5,43
Rapid Vienna,3161,3,9,9,6,35,26,9,36
LASK Linz,3161,4,8,5,11,26,31,-5,29
Mattersburg,3161,5,7,5,12,30,40,-10,26
Vienna,3161,6,7,5,12,25,41,-16,26
SC Rheindorf,3161,7,4,6,14,16,30,-14,18
FC Salzburg,3162,1,15,6,3,49,19,30,51
SK Sturm Gra,3162,2,12,4,8,32,29,3,40
Rapid Vienna,3162,3,9,9,6,35,31,4,36
LASK Linz,3162,4,10,5,9,30,28,2,35
Vienna,3162,5,7,5,12,27,40,-13,26
Mattersburg,3162,6,6,6,12,32,45,-13,24
SC Rheindorf,3162,7,4,7,13,18,31,-13,19
FC Salzburg,3163,1,15,7,2,43,16,27,52
SK Sturm Gra,3163,2,12,5,7,33,29,4,41
LASK Linz,3163,3,9,6,9,30,29,1,33
Rapid Vienna,3163,4,7,10,7,34,32,2,31
Vienna,3163,5,7,5,12,25,40,-15,26
Mattersburg,3163,6,6,6,12,31,42,-11,24
SC Rheindorf,3163,7,5,7,12,21,29,-8,22
FC Salzburg,3164,1,14,8,2,44,17,27,50
SK Sturm Gra,3164,2,12,4,8,36,29,7,40
LASK Linz,3164,3,10,5,9,32,28,4,35
Rapid Vienna,3164,4,8,9,7,35,34,1,33
Vienna,3164,5,7,5,12,27,40,-13,26
Mattersburg,3164,6,6,6,12,31,47,-16,24
SC Rheindorf,3164,7,6,5,13,21,31,-10,23
FC Salzburg,3165,1,14,7,3,46,22,24,49
SK Sturm Gra,3165,2,12,4,8,31,30,1,40
Rapid Vienna,3165,3,9,10,5,35,24,11,37
LASK Linz,3165,4,9,5,10,27,27,0,32
Mattersburg,3165,5,7,7,10,35,42,-7,28
Vienna,3165,6,6,6,12,26,41,-15,24
SC Rheindorf,3165,7,4,7,13,16,30,-14,19
FC Salzburg,3166,1,14,8,2,44,18,26,50
SK Sturm Gra,3166,2,11,5,8,29,28,1,38
Rapid Vienna,3166,3,7,12,5,32,26,6,33
LASK Linz,3166,4,8,7,9,29,29,0,31
Vienna,3166,5,7,6,11,28,40,-12,27
Mattersburg,3166,6,7,5,12,35,43,-8,26
SC Rheindorf,3166,7,5,7,12,18,31,-13,22
FC Salzburg,3167,1,15,6,3,47,20,27,51
SK Sturm Gra,3167,2,14,3,7,33,26,7,45
Rapid Vienna,3167,3,9,10,5,36,26,10,37
LASK Linz,3167,4,7,7,10,24,27,-3,28
Vienna,3167,5,7,5,12,29,44,-15,26
SC Rheindorf,3167,6,6,5,13,19,30,-11,23
Mattersburg,3167,7,5,6,13,29,44,-15,21
FC Salzburg,3168,1,14,6,4,45,20,25,48
SK Sturm Gra,3168,2,13,4,7,33,28,5,43
Rapid Vienna,3168,3,9,9,6,35,28,7,36
LASK Linz,3168,4,8,7,9,26,26,0,31
SC Rheindorf,3168,5,6,7,11,18,26,-8,25
Vienna,3168,6,6,6,12,26,42,-16,24
Mattersburg,3168,7,5,7,12,28,41,-13,22
FC Salzburg,3169,1,15,7,2,46,19,27,52
SK Sturm Gra,3169,2,11,5,8,31,32,-1,38
Rapid Vienna,3169,3,8,10,6,36,30,6,34
LASK Linz,3169,4,8,5,11,28,30,-2,29
SC Rheindorf,3169,5,8,5,11,22,26,-4,29
Mattersburg,3169,6,7,5,12,35,43,-8,26
Vienna,3169,7,6,5,13,24,42,-18,23
FC Salzburg,3170,1,14,8,2,44,15,29,50
SK Sturm Gra,3170,2,12,3,9,31,31,0,39
Rapid Vienna,3170,3,8,11,5,34,26,8,35
LASK Linz,3170,4,9,5,10,27,27,0,32
Mattersburg,3170,5,7,6,11,34,42,-8,27
Vienna,3170,6,7,5,12,27,44,-17,26
SC Rheindorf,3170,7,5,6,13,17,29,-12,21
FC Salzburg,3171,1,13,6,5,40,20,20,45
SK Sturm Gra,3171,2,12,3,9,32,30,2,39
Rapid Vienna,3171,3,9,10,5,39,28,11,37
LASK Linz,3171,4,9,6,9,27,27,0,33
Mattersburg,3171,5,7,6,11,30,40,-10,27
Vienna,3171,6,7,5,12,24,38,-14,26
SC Rheindorf,3171,7,6,6,12,23,32,-9,24
FC Salzburg,3172,1,16,6,2,50,17,33,54
SK Sturm Gra,3172,2,13,3,8,34,31,3,42
Rapid Vienna,3172,3,8,9,7,36,31,5,33
LASK Linz,3172,4,7,6,11,25,32,-7,27
SC Rheindorf,3172,5,7,5,12,23,30,-7,26
Vienna,3172,6,7,5,12,25,41,-16,26
Mattersburg,3172,7,6,6,12,30,41,-11,24
SK Sturm Gra,3173,1,15,3,6,37,25,12,48
FC Salzburg,3173,2,13,6,5,41,23,18,45
Rapid Vienna,3173,3,8,9,7,34,29,5,33
LASK Linz,3173,4,9,5,10,25,29,-4,32
Mattersburg,3173,5,8,5,11,33,38,-5,29
Vienna,3173,6,7,5,12,27,41,-14,26
SC Rheindorf,3173,7,5,5,14,17,29,-12,20
FC Salzburg,3174,1,15,7,2,50,18,32,52
LASK Linz,3174,2,11,5,8,32,27,5,38
SK Sturm Gra,3174,3,11,4,9,31,35,-4,37
Rapid Vienna,3174,4,8,11,5,37,30,7,35
SC Rheindorf,3174,5,6,5,13,22,29,-7,23
Mattersburg,3174,6,6,5,13,30,43,-13,23
Vienna,3174,7,6,5,13,24,44,-20,23
FC Salzburg,3175,1,15,7,2,45,18,27,52
SK Sturm Gra,3175,2,13,3,8,34,27,7,42
Rapid Vienna,3175,3,8,10,6,36,30,6,34
LASK Linz,3175,4,9,5,10,31,33,-2,32
SC Rheindorf,3175,5,6,6,12,20,29,-9,24
Vienna,3175,6,6,6,12,24,39,-15,24
Mattersburg,3175,7,5,7,12,30,44,-14,22
FC Salzburg,3176,1,14,8,2,43,17,26,50
SK Sturm Gra,3176,2,13,5,6,30,24,6,44
Rapid Vienna,3176,3,8,11,5,35,27,8,35
LASK Linz,3176,4,7,6,11,24,31,-7,27
Vienna,3176,5,7,6,11,26,39,-13,27
Mattersburg,3176,6,6,6,12,31,41,-10,24
SC Rheindorf,3176,7,5,6,13,19,29,-10,21
SK Sturm Gra,3177,1,14,3,7,35,29,6,45
FC Salzburg,3177,2,12,7,5,41,22,19,43
Rapid Vienna,3177,3,9,11,4,37,25,12,38
LASK Linz,3177,4,8,6,10,26,27,-1,30
Vienna,3177,5,8,5,11,30,39,-9,29
Mattersburg,3177,6,7,5,12,33,46,-13,26
SC Rheindorf,3177,7,5,5,14,20,34,-14,20
FC Salzburg,3178,1,14,6,4,43,20,23,48
SK Sturm Gra,3178,2,12,4,8,35,34,1,40
Rapid Vienna,3178,3,8,10,6,37,30,7,34
LASK Linz,3178,4,7,8,9,26,30,-4,29
Mattersburg,3178,5,7,6,11,31,42,-11,27
SC Rheindorf,3178,6,7,5,12,26,30,-4,26
Vienna,3178,7,7,5,12,28,40,-12,26
FC Salzburg,3179,1,15,7,2,44,17,27,52
SK Sturm Gra,3179,2,12,6,6,33,28,5,42
Rapid Vienna,3179,3,9,9,6,38,29,9,36
LASK Linz,3179,4,8,7,9,32,31,1,31
Mattersburg,3179,5,6,6,12,31,44,-13,24
Vienna,3179,6,6,5,13,25,42,-17,23
SC Rheindorf,3179,7,4,8,12,19,31,-12,20
FC Salzburg,3180,1,15,7,2,47,18,29,52
SK Sturm Gra,3180,2,13,4,7,34,29,5,43
Rapid Vienna,3180,3,9,9,6,37,29,8,36
LASK Linz,3180,4,7,6,11,27,33,-6,27
Vienna,3180,5,7,5,12,25,40,-15,26
SC Rheindorf,3180,6,6,6,12,24,33,-9,24
Mattersburg,3180,7,6,5,13,32,44,-12,23
FC Salzburg,3181,1,13,8,3,42,20,22,47
SK Sturm Gra,3181,2,14,4,6,34,27,7,46
Rapid Vienna,3181,3,8,10,6,35,27,8,34
LASK Linz,3181,4,8,6,10,25,28,-3,30
Mattersburg,3181,5,6,7,11,33,42,-9,25
Vienna,3181,6,6,6,12,26,41,-15,24
SC Rheindorf,3181,7,5,7,12,19,29,-10,22
FC Salzburg,3182,1,14,7,3,45,19,26,49
SK Sturm Gra,3182,2,12,3,9,32,30,2,39
Rapid Vienna,3182,3,9,10,5,34,25,9,37
LASK Linz,3182,4,8,6,10,25,30,-5,30
Vienna,3182,5,7,6,11,26,37,-11,27
Mattersburg,3182,6,6,7,11,30,41,-11,25
SC Rheindorf,3182,7,6,5,13,20,30,-10,23
FC Salzburg,3183,1,16,6,2,52,17,35,54
SK Sturm Gra,3183,2,12,4,8,34,32,2,40
Rapid Vienna,3183,3,10,9,5,37,26,11,39
LASK Linz,3183,4,8,6,10,30,34,-4,30
Mattersburg,3183,5,8,5,11,33,42,-9,29
Vienna,3183,6,6,5,13,26,46,-20,23
SC Rheindorf,3183,7,4,5,15,18,33,-15,17
FC Salzburg,3184,1,15,7,2,45,16,29,52
SK Sturm Gra,3184,2,12,5,7,32,28,4,41
Rapid Vienna,3184,3,9,11,4,39,24,15,38
LASK Linz,3184,4,8,5,11,26,33,-7,29
Vienna,3184,5,7,5,12,26,42,-16,26
Mattersburg,3184,6,6,6,12,31,42,-11,24
SC Rheindorf,3184,7,4,7,13,19,33,-14,19
FC Salzburg,3185,1,13,7,4,39,18,21,46
SK Sturm Gra,3185,2,12,3,9,32,30,2,39
Rapid Vienna,3185,3,9,10,5,36,28,8,37
LASK Linz,3185,4,10,6,8,29,25,4,36
Vienna,3185,5,7,6,11,25,38,-13,27
Mattersburg,3185,6,6,5,13,29,41,-12,23
SC Rheindorf,3185,7,5,7,12,19,29,-10,22
FC Salzburg,3186,1,14,8,2,45,18,27,50
SK Sturm Gra,3186,2,13,3,8,32,29,3,42
Rapid Vienna,3186,3,8,10,6,37,29,8,34
LASK Linz,3186,4,9,5,10,25,26,-1,32
Mattersburg,3186,5,6,7,11,29,39,-10,25
SC Rheindorf,3186,6,6,6,12,19,29,-10,24
Vienna,3186,7,6,5,13,24,41,-17,23
FC Salzburg,3187,1,15,6,3,44,17,27,51
SK Sturm Gra,3187,2,13,3,8,32,31,1,42
Rapid Vienna,3187,3,9,9,6,35,26,9,36
LASK Linz,3187,4,8,5,11,28,30,-2,29
Mattersburg,3187,5,7,5,12,35,45,-10,26
Vienna,3187,6,7,5,12,27,41,-14,26
SC Rheindorf,3187,7,6,5,13,20,31,-11,23
FC Salzburg,3188,1,13,7,4,45,20,25,46
SK Sturm Gra,3188,2,13,5,6,34,27,7,44
Rapid Vienna,3188,3,8,9,7,36,36,0,33
LASK Linz,3188,4,8,7,9,32,31,1,31
Mattersburg,3188,5,7,7,10,33,41,-8,28
Vienna,3188,6,7,6,11,25,38,-13,27
SC Rheindorf,3188,7,4,7,13,17,29,-12,19
FC Salzburg,3189,1,15,7,2,48,16,32,52
SK Sturm Gra,3189,2,13,4,7,32,29,3,43
Rapid Vienna,3189,3,8,9,7,37,29,8,33
LASK Linz,3189,4,8,6,10,28,30,-2,30
Vienna,3189,5,7,5,12,25,40,-15,26
Mattersburg,3189,6,6,6,12,29,44,-15,24
SC Rheindorf,3189,7,6,5,13,20,31,-11,23
FC Salzburg,3190,1,15,6,3,47,17,30,51
SK Sturm Gra,3190,2,13,4,7,33,27,6,43
Rapid Vienna,3190,3,8,9,7,36,30,6,33
LASK Linz,3190,4,9,6,9,29,30,-1,33
Mattersburg,3190,5,7,5,12,32,47,-15,26
Vienna,3190,6,6,5,13,24,41,-17,23
SC Rheindorf,3190,7,5,7,12,19,28,-9,22
FC Salzburg,3191,1,15,6,3,47,17,30,51
SK Sturm Gra,3191,2,13,4,7,33,28,5,43
LASK Linz,3191,3,9,6,9,27,26,1,33
Rapid Vienna,3191,4,7,10,7,35,32,3,31
Mattersburg,3191,5,7,6,11,30,38,-8,27
Vienna,3191,6,6,5,13,23,44,-21,23
SC Rheindorf,3191,7,5,7,12,17,27,-10,22
FC Salzburg,3192,1,16,6,2,45,17,28,54
SK Sturm Gra,3192,2,14,3,7,37,29,8,45
LASK Linz,3192,3,10,5,9,28,28,0,35
Rapid Vienna,3192,4,7,9,8,31,28,3,30
Vienna,3192,5,7,5,12,25,39,-14,26
SC Rheindorf,3192,6,5,6,13,20,31,-11,21
Mattersburg,3192,7,5,6,13,28,42,-14,21
FC Salzburg,3193,1,15,6,3,42,17,25,51
SK Sturm Gra,3193,2,14,3,7,35,27,8,45
Rapid Vienna,3193,3,7,10,7,33,30,3,31
Mattersburg,3193,4,8,6,10,33,38,-5,30
LASK Linz,3193,5,8,5,11,29,32,-3,29
Vienna,3193,6,6,5,13,23,41,-18,23
SC Rheindorf,3193,7,5,7,12,18,28,-10,22
FC Salzburg,3194,1,16,6,2,45,17,28,54
SK Sturm Gra,3194,2,12,3,9,35,31,4,39
Rapid Vienna,3194,3,8,10,6,35,30,5,34
LASK Linz,3194,4,9,6,9,29,28,1,33
Mattersburg,3194,5,8,5,11,33,40,-7,29
Vienna,3194,6,6,5,13,24,42,-18,23
SC Rheindorf,3194,7,5,5,14,20,33,-13,20
FC Salzburg,3195,1,15,7,2,48,17,31,52
SK Sturm Gra,3195,2,12,6,6,35,29,6,42
Rapid Vienna,3195,3,8,10,6,37,31,6,34
LASK Linz,3195,4,8,6,10,29,31,-2,30
Mattersburg,3195,5,6,7,11,30,45,-15,25
Vienna,3195,6,6,6,12,26,41,-15,24
SC Rheindorf,3195,7,4,8,12,19,30,-11,20
FC Salzburg,3196,1,14,6,4,46,20,26,48
SK Sturm Gra,3196,2,12,4,8,31,30,1,40
Rapid Vienna,3196,3,8,10,6,32,27,5,34
Mattersburg,3196,4,8,6,10,33,39,-6,30
LASK Linz,3196,5,7,8,9,24,26,-2,29
SC Rheindorf,3196,6,7,5,12,22,28,-6,26
Vienna,3196,7,6,5,13,26,44,-18,23
FC Salzburg,3197,1,13,8,3,41,18,23,47
SK Sturm Gra,3197,2,12,3,9,30,30,0,39
LASK Linz,3197,3,10,5,9,29,28,1,35
Rapid Vienna,3197,4,8,10,6,35,28,7,34
Vienna,3197,5,7,6,11,25,38,-13,27
SC Rheindorf,3197,6,6,6,12,24,32,-8,24
Mattersburg,3197,7,6,6,12,33,43,-10,24
FC Salzburg,3198,1,15,6,3,47,20,27,51
SK Sturm Gra,3198,2,11,4,9,31,33,-2,37
LASK Linz,3198,3,9,6,9,29,27,2,33
Rapid Vienna,3198,4,7,11,6,37,31,6,32
Vienna,3198,5,8,5,11,29,39,-10,29
SC Rheindorf,3198,6,6,6,12,23,33,-10,24
Mattersburg,3198,7,6,6,12,33,46,-13,24
FC Salzburg,3199,1,15,6,3,46,21,25,51
SK Sturm Gra,3199,2,12,4,8,34,31,3,40
Rapid Vienna,3199,3,9,10,5,36,26,10,37
LASK Linz,3199,4,8,7,9,26,28,-2,31
Vienna,3199,5,7,5,12,28,42,-14,26
SC Rheindorf,3199,6,5,7,12,22,31,-9,22
Mattersburg,3199,7,5,7,12,29,42,-13,22
FC Salzburg,3200,1,15,6,3,44,20,24,51
SK Sturm Gra,3200,2,13,3,8,31,28,3,42
Rapid Vienna,3200,3,10,9,5,38,26,12,39
LASK Linz,3200,4,7,6,11,24,32,-8,27
Mattersburg,3200,5,7,6,11,32,41,-9,27
SC Rheindorf,3200,6,6,5,13,23,29,-6,23
Vienna,3200,7,6,5,13,24,40,-16,23
FC Salzburg,3201,1,15,7,2,47,16,31,52
SK Sturm Gra,3201,2,13,3,8,34,30,4,42
Rapid Vienna,3201,3,9,9,6,36,30,6,36
LASK Linz,3201,4,9,6,9,31,28,3,33
Mattersburg,3201,5,5,9,10,31,41,-10,24
Vienna,3201,6,6,6,12,25,45,-20,24
SC Rheindorf,3201,7,4,6,14,18,32,-14,18
FC Salzburg,3202,1,16,6,2,51,16,35,54
SK Sturm Gra,3202,2,12,3,9,30,33,-3,39
Rapid Vienna,3202,3,8,9,7,37,30,7,33
LASK Linz,3202,4,9,6,9,31,29,2,33
Vienna,3202,5,7,5,12,28,44,-16,26
Mattersburg,3202,6,6,6,12,33,46,-13,24
SC Rheindorf,3202,7,6,5,13,21,33,-12,23
FC Salzburg,3203,1,13,8,3,45,23,22,47
SK Sturm Gra,3203,2,12,5,7,32,29,3,41
Rapid Vienna,3203,3,10,9,5,39,28,11,39
LASK Linz,3203,4,10,5,9,28,25,3,35
Vienna,3203,5,7,5,12,29,39,-10,26
Mattersburg,3203,6,5,7,12,29,45,-16,22
SC Rheindorf,3203,7,4,7,13,18,31,-13,19
FC Salzburg,3204,1,16,6,2,46,17,29,54
SK Sturm Gra,3204,2,13,3,8,32,28,4,42
Rapid Vienna,3204,3,9,9,6,35,27,8,36
LASK Linz,3204,4,8,5,11,29,33,-4,29
Mattersburg,3204,5,6,7,11,31,41,-10,25
Vienna,3204,6,6,6,12,24,40,-16,24
SC Rheindorf,3204,7,5,6,13,17,28,-11,21
FC Salzburg,3205,1,14,7,3,45,19,26,49
SK Sturm Gra,3205,2,12,6,6,33,28,5,42
Rapid Vienna,3205,3,8,11,5,37,30,7,35
LASK Linz,3205,4,8,7,9,27,30,-3,31
Mattersburg,3205,5,7,6,11,32,39,-7,27
Vienna,3205,6,6,6,12,23,38,-15,24
SC Rheindorf,3205,7,4,7,13,17,30,-13,19
FC Salzburg,3206,1,15,6,3,43,16,27,51
SK Sturm Gra,3206,2,12,5,7,33,30,3,41
Rapid Vienna,3206,3,10,10,4,36,25,11,40
Mattersburg,3206,4,7,6,11,29,38,-9,27
LASK Linz,3206,5,7,5,12,26,31,-5,26
Vienna,3206,6,6,6,12,23,39,-16,24
SC Rheindorf,3206,7,5,6,13,18,29,-11,21
FC Salzburg,3207,1,15,7,2,46,18,28,52
SK Sturm Gra,3207,2,12,3,9,35,33,2,39
Rapid Vienna,3207,3,9,10,5,37,29,8,37
LASK Linz,3207,4,8,5,11,29,32,-3,29
Vienna,3207,5,7,6,11,29,39,-10,27
SC Rheindorf,3207,6,6,7,11,23,29,-6,25
Mattersburg,3207,7,5,6,13,29,48,-19,21
FC Salzburg,3208,1,15,7,2,48,18,30,52
SK Sturm Gra,3208,2,13,3,8,32,27,5,42
Rapid Vienna,3208,3,8,11,5,35,26,9,35
LASK Linz,3208,4,7,7,10,26,31,-5,28
Vienna,3208,5,7,5,12,25,40,-15,26
Mattersburg,3208,6,6,6,12,29,43,-14,24
SC Rheindorf,3208,7,5,7,12,18,28,-10,22
SK Sturm Gra,3209,1,15,3,6,38,27,11,48
FC Salzburg,3209,2,13,6,5,43,23,20,45
Rapid Vienna,3209,3,9,10,5,39,29,10,37
LASK Linz,3209,4,7,8,9,27,30,-3,29
Mattersburg,3209,5,7,6,11,31,39,-8,27
Vienna,3209,6,7,5,12,25,40,-15,26
SC Rheindorf,3209,7,4,6,14,17,32,-15,18
FC Salzburg,3210,1,13,7,4,42,22,20,46
SK Sturm Gra,3210,2,13,4,7,34,29,5,43
Rapid Vienna,3210,3,10,9,5,38,27,11,39
LASK Linz,3210,4,8,7,9,28,30,-2,31
Mattersburg,3210,5,7,7,10,35,38,-3,28
Vienna,3210,6,6,6,12,25,43,-18,24
SC Rheindorf,3210,7,4,6,14,18,31,-13,18
FC Salzburg,3211,1,15,7,2,48,19,29,52
SK Sturm Gra,3211,2,12,4,8,37,34,3,40
Rapid Vienna,3211,3,7,12,5,37,32,5,33
LASK Linz,3211,4,8,8,8,26,26,0,32
SC Rheindorf,3211,5,6,6,12,19,28,-9,24
Mattersburg,3211,6,6,6,12,30,42,-12,24
Vienna,3211,7,6,5,13,26,42,-16,23
FC Salzburg,3212,1,14,7,3,49,20,29,49
SK Sturm Gra,3212,2,15,3,6,39,27,12,48
Rapid Vienna,3212,3,9,9,6,41,31,10,36
LASK Linz,3212,4,9,5,10,31,29,2,32
Vienna,3212,5,6,7,11,24,38,-14,25
Mattersburg,3212,6,5,7,12,29,46,-17,22
SC Rheindorf,3212,7,4,6,14,18,40,-22,18
FC Salzburg,3213,1,14,6,4,51,23,28,48
Rapid Vienna,3213,2,10,10,4,39,27,12,40
SK Sturm Gra,3213,3,11,5,8,29,31,-2,38
LASK Linz,3213,4,8,7,9,27,29,-2,31
Mattersburg,3213,5,7,6,11,37,45,-8,27
Vienna,3213,6,7,5,12,25,41,-16,26
SC Rheindorf,3213,7,4,7,13,19,31,-12,19
FC Salzburg,3214,1,16,6,2,46,18,28,54
SK Sturm Gra,3214,2,11,4,9,29,30,-1,37
LASK Linz,3214,3,10,5,9,30,28,2,35
Rapid Vienna,3214,4,8,9,7,35,29,6,33
Mattersburg,3214,5,7,6,11,32,41,-9,27
Vienna,3214,6,6,5,13,25,41,-16,23
SC Rheindorf,3214,7,5,7,12,20,30,-10,22
FC Salzburg,3215,1,13,8,3,41,18,23,47
SK Sturm Gra,3215,2,11,6,7,29,27,2,39
Rapid Vienna,3215,3,8,11,5,35,27,8,35
LASK Linz,3215,4,7,6,11,24,28,-4,27
Mattersburg,3215,5,7,6,11,33,43,-10,27
Vienna,3215,6,7,6,11,27,39,-12,27
SC Rheindorf,3215,7,6,7,11,20,27,-7,25
FC Salzburg,3216,1,14,7,3,42,18,24,49
SK Sturm Gra,3216,2,13,4,7,32,27,5,43
Rapid Vienna,3216,3,9,11,4,37,26,11,38
LASK Linz,3216,4,8,6,10,26,27,-1,30
Vienna,3216,5,7,6,11,26,39,-13,27
Mattersburg,3216,6,6,5,13,28,42,-14,23
SC Rheindorf,3216,7,5,5,14,16,28,-12,20
FC Salzburg,3217,1,14,7,3,44,19,25,49
SK Sturm Gra,3217,2,13,3,8,33,28,5,42
Rapid Vienna,3217,3,8,12,4,35,26,9,36
Vienna,3217,4,8,5,11,27,39,-12,29
LASK Linz,3217,5,7,7,10,24,28,-4,28
Mattersburg,3217,6,7,5,12,31,42,-11,26
SC Rheindorf,3217,7,4,7,13,17,29,-12,19
FC Salzburg,3218,1,13,9,2,44,20,24,48
SK Sturm Gra,3218,2,13,4,7,36,28,8,43
Rapid Vienna,3218,3,8,11,5,36,26,10,35
Mattersburg,3218,4,8,6,10,36,41,-5,30
LASK Linz,3218,5,7,7,10,27,33,-6,28
Vienna,3218,6,6,6,12,25,40,-15,24
SC Rheindorf,3218,7,4,7,13,18,34,-16,19
FC Salzburg,3219,1,14,7,3,45,17,28,49
Rapid Vienna,3219,2,10,10,4,35,24,11,40
SK Sturm Gra,3219,3,12,4,8,33,31,2,40
LASK Linz,3219,4,8,5,11,28,31,-3,29
Mattersburg,3219,5,7,6,11,33,41,-8,27
Vienna,3219,6,7,5,12,25,42,-17,26
SC Rheindorf,3219,7,5,5,14,20,33,-13,20
FC Salzburg,3220,1,15,6,3,46,20,26,51
SK Sturm Gra,3220,2,12,5,7,35,28,7,41
Rapid Vienna,3220,3,8,9,7,35,33,2,33
LASK Linz,3220,4,9,6,9,29,29,0,33
Vienna,3220,5,8,5,11,29,38,-9,29
Mattersburg,3220,6,7,5,12,32,45,-13,26
SC Rheindorf,3220,7,4,6,14,19,32,-13,18
FC Salzburg,3221,1,15,7,2,45,16,29,52
SK Sturm Gra,3221,2,12,3,9,34,31,3,39
Rapid Vienna,3221,3,8,9,7,34,32,2,33
LASK Linz,3221,4,9,6,9,26,26,0,33
Mattersburg,3221,5,6,8,10,33,38,-5,26
SC Rheindorf,3221,6,6,6,12,22,30,-8,24
Vienna,3221,7,6,5,13,23,44,-21,23
FC Salzburg,3222,1,14,6,4,46,20,26,48
SK Sturm Gra,3222,2,13,4,7,33,28,5,43
Rapid Vienna,3222,3,8,11,5,37,30,7,35
LASK Linz,3222,4,9,6,9,29,30,-1,33
Vienna,3222,5,8,5,11,29,39,-10,29
Mattersburg,3222,6,6,5,13,33,48,-15,23
SC Rheindorf,3222,7,5,5,14,20,32,-12,20
FC Salzburg,3223,1,13,7,4,44,19,25,46
SK Sturm Gra,3223,2,12,4,8,31,34,-3,40
Rapid Vienna,3223,3,9,10,5,37,27,10,37
LASK Linz,3223,4,9,7,8,29,26,3,34
Vienna,3223,5,8,5,11,26,38,-12,29
Mattersburg,3223,6,6,6,12,30,41,-11,24
SC Rheindorf,3223,7,5,5,14,20,32,-12,20
FC Salzburg,3224,1,15,7,2,47,19,28,52
SK Sturm Gra,3224,2,13,3,8,36,30,6,42
Rapid Vienna,3224,3,8,10,6,33,28,5,34
Mattersburg,3224,4,8,6,10,35,39,-4,30
LASK Linz,3224,5,7,6,11,23,29,-6,27
Vienna,3224,6,6,5,13,25,43,-18,23
SC Rheindorf,3224,7,5,7,12,19,30,-11,22
FC Salzburg,3225,1,14,7,3,41,16,25,49
SK Sturm Gra,3225,2,13,3,8,31,28,3,42
Rapid Vienna,3225,3,8,12,4,35,25,10,36
LASK Linz,3225,4,8,6,10,25,27,-2,30
Mattersburg,3225,5,8,6,10,32,39,-7,30
Vienna,3225,6,6,6,12,25,41,-16,24
SC Rheindorf,3225,7,4,6,14,16,29,-13,18
FC Salzburg,3226,1,16,6,2,45,16,29,54
Rapid Vienna,3226,2,10,9,5,37,25,12,39
SK Sturm Gra,3226,3,12,3,9,29,30,-1,39
LASK Linz,3226,4,8,7,9,27,28,-1,31
Vienna,3226,5,7,5,12,25,38,-13,26
Mattersburg,3226,6,6,6,12,33,45,-12,24
SC Rheindorf,3226,7,4,6,14,17,31,-14,18
FC Salzburg,3227,1,13,7,4,40,20,20,46
SK Sturm Gra,3227,2,12,4,8,31,28,3,40
Rapid Vienna,3227,3,8,10,6,36,29,7,34
LASK Linz,3227,4,7,8,9,26,29,-3,29
Mattersburg,3227,5,8,5,11,35,42,-7,29
Vienna,3227,6,7,6,11,26,37,-11,27
SC Rheindorf,3227,7,6,6,12,20,29,-9,24
FC Salzburg,3228,1,16,6,2,51,17,34,54
SK Sturm Gra,3228,2,11,4,9,31,34,-3,37
LASK Linz,3228,3,9,6,9,29,27,2,33
Rapid Vienna,3228,4,7,10,7,35,33,2,31
Vienna,3228,5,7,5,12,26,40,-14,26
SC Rheindorf,3228,6,6,7,11,20,27,-7,25
Mattersburg,3228,7,6,6,12,28,42,-14,24
FC Salzburg,3229,1,14,7,3,44,20,24,49
SK Sturm Gra,3229,2,13,4,7,30,25,5,43
Rapid Vienna,3229,3,9,9,6,36,29,7,36
LASK Linz,3229,4,8,7,9,29,28,1,31
Mattersburg,3229,5,7,6,11,36,40,-4,27
Vienna,3229,6,6,5,13,27,45,-18,23
SC Rheindorf,3229,7,5,6,13,20,35,-15,21
FC Salzburg,3230,1,15,6,3,44,18,26,51
SK Sturm Gra,3230,2,12,4,8,31,30,1,40
Rapid Vienna,3230,3,9,9,6,34,30,4,36
LASK Linz,3230,4,9,6,9,32,28,4,33
Mattersburg,3230,5,7,6,11,33,39,-6,27
Vienna,3230,6,6,6,12,25,41,-16,24
SC Rheindorf,3230,7,5,5,14,19,32,-13,20
FC Salzburg,3231,1,15,6,3,49,22,27,51
SK Sturm Gra,3231,2,12,5,7,35,33,2,41
LASK Linz,3231,3,10,6,8,36,29,7,36
Rapid Vienna,3231,4,8,9,7,38,33,5,33
Vienna,3231,5,8,5,11,29,41,-12,29
Mattersburg,3231,6,6,5,13,32,45,-13,23
SC Rheindorf,3231,7,4,6,14,19,35,-16,18
FC Salzburg,3232,1,13,7,4,44,22,22,46
SK Sturm Gra,3232,2,12,5,7,32,27,5,41
LASK Linz,3232,3,11,5,8,33,24,9,38
Rapid Vienna,3232,4,9,10,5,37,31,6,37
Vienna,3232,5,7,6,11,27,38,-11,27
Mattersburg,3232,6,5,6,13,31,50,-19,21
SC Rheindorf,3232,7,4,7,13,19,31,-12,19
FC Salzburg,3233,1,14,8,2,47,20,27,50
SK Sturm Gra,3233,2,13,3,8,34,30,4,42
Rapid Vienna,3233,3,10,10,4,44,28,16,40
LASK Linz,3233,4,8,5,11,28,35,-7,29
Mattersburg,3233,5,7,6,11,30,42,-12,27
Vienna,3233,6,7,5,12,27,39,-12,26
SC Rheindorf,3233,7,4,5,15,17,33,-16,17
FC Salzburg,3234,1,16,6,2,54,21,33,54
SK Sturm Gra,3234,2,12,4,8,32,33,-1,40
Rapid Vienna,3234,3,8,11,5,39,29,10,35
LASK Linz,3234,4,7,7,10,25,29,-4,28
Mattersburg,3234,5,6,7,11,34,44,-10,25
Vienna,3234,6,6,6,12,27,42,-15,24
SC Rheindorf,3234,7,6,5,13,20,33,-13,23
FC Salzburg,3235,1,14,7,3,45,22,23,49
SK Sturm Gra,3235,2,12,5,7,32,28,4,41
Rapid Vienna,3235,3,9,9,6,39,28,11,36
LASK Linz,3235,4,9,6,9,26,28,-2,33
Mattersburg,3235,5,7,7,10,33,36,-3,28
Vienna,3235,6,6,6,12,24,40,-16,24
SC Rheindorf,3235,7,4,6,14,17,34,-17,18
FC Salzburg,3236,1,15,7,2,45,16,29,52
Rapid Vienna,3236,2,9,10,5,37,27,10,37
SK Sturm Gra,3236,3,11,4,9,28,32,-4,37
LASK Linz,3236,4,9,7,8,28,26,2,34
Vienna,3236,5,7,5,12,24,38,-14,26
SC Rheindorf,3236,6,5,7,12,18,27,-9,22
Mattersburg,3236,7,5,6,13,26,40,-14,21
FC Salzburg,3237,1,12,8,4,44,23,21,44
SK Sturm Gra,3237,2,13,5,6,38,29,9,44
Rapid Vienna,3237,3,9,11,4,39,27,12,38
Vienna,3237,4,8,5,11,28,40,-12,29
Mattersburg,3237,5,7,5,12,32,40,-8,26
LASK Linz,3237,6,7,5,12,26,36,-10,26
SC Rheindorf,3237,7,6,5,13,22,34,-12,23
FC Salzburg,3238,1,15,7,2,47,17,30,52
Rapid Vienna,3238,2,10,9,5,37,28,9,39
SK Sturm Gra,3238,3,11,5,8,28,27,1,38
Mattersburg,3238,4,8,6,10,33,38,-5,30
LASK Linz,3238,5,7,7,10,26,31,-5,28
Vienna,3238,6,6,5,13,24,41,-17,23
SC Rheindorf,3238,7,4,7,13,21,34,-13,19
FC Salzburg,3239,1,15,7,2,48,20,28,52
SK Sturm Gra,3239,2,11,5,8,31,29,2,38
Rapid Vienna,3239,3,8,11,5,37,29,8,35
LASK Linz,3239,4,9,5,10,26,28,-2,32
Mattersburg,3239,5,7,5,12,32,41,-9,26
Vienna,3239,6,7,5,12,27,42,-15,26
SC Rheindorf,3239,7,5,6,13,19,31,-12,21
FC Salzburg,3240,1,15,7,2,52,20,32,52
SK Sturm Gra,3240,2,13,4,7,37,31,6,43
Rapid Vienna,3240,3,8,11,5,39,32,7,35
LASK Linz,3240,4,8,5,11,28,32,-4,29
Mattersburg,3240,5,7,5,12,32,43,-11,26
Vienna,3240,6,7,5,12,27,44,-17,26
SC Rheindorf,3240,7,4,7,13,20,33,-13,19
FC Salzburg,3241,1,15,7,2,46,18,28,52
SK Sturm Gra,3241,2,12,4,8,33,33,0,40
Rapid Vienna,3241,3,10,9,5,39,26,13,39
LASK Linz,3241,4,9,6,9,28,29,-1,33
Vienna,3241,5,7,5,12,28,41,-13,26
Mattersburg,3241,6,5,6,13,29,45,-16,21
SC Rheindorf,3241,7,5,5,14,18,29,-11,20
FC Salzburg,3242,1,14,7,3,46,21,25,49
SK Sturm Gra,3242,2,12,6,6,33,27,6,42
Rapid Vienna,3242,3,8,10,6,36,27,9,34
LASK Linz,3242,4,8,6,10,27,31,-4,30
Vienna,3242,5,8,5,11,29,40,-11,29
Mattersburg,3242,6,7,5,12,30,42,-12,26
SC Rheindorf,3242,7,4,7,13,18,31,-13,19
FC Salzburg,3243,1,13,8,3,41,19,22,47
SK Sturm Gra,3243,2,13,3,8,33,28,5,42
Rapid Vienna,3243,3,8,10,6,35,30,5,34
LASK Linz,3243,4,8,7,9,28,27,1,31
Vienna,3243,5,8,5,11,28,39,-11,29
Mattersburg,3243,6,5,8,11,28,39,-11,23
SC Rheindorf,3243,7,5,7,12,18,29,-11,22
FC Salzburg,3244,1,15,7,2,45,18,27,52
SK Sturm Gra,3244,2,12,5,7,31,28,3,41
LASK Linz,3244,3,9,6,9,31,29,2,33
Rapid Vienna,3244,4,7,9,8,33,31,2,30
Vienna,3244,5,7,5,12,27,39,-12,26
SC Rheindorf,3244,6,6,7,11,21,28,-7,25
Mattersburg,3244,7,6,5,13,29,44,-15,23
FC Salzburg,3245,1,14,7,3,42,16,26,49
SK Sturm Gra,3245,2,13,5,6,35,29,6,44
Rapid Vienna,3245,3,8,11,5,36,28,8,35
LASK Linz,3245,4,8,6,10,26,28,-2,30
Mattersburg,3245,5,7,5,12,31,41,-10,26
Vienna,3245,6,7,5,12,25,39,-14,26
SC Rheindorf,3245,7,4,7,13,17,31,-14,19
FC Salzburg,3246,1,15,6,3,46,18,28,51
SK Sturm Gra,3246,2,12,5,7,33,31,2,41
Rapid Vienna,3246,3,9,10,5,37,28,9,37
LASK Linz,3246,4,8,5,11,26,28,-2,29
Vienna,3246,5,7,5,12,25,40,-15,26
SC Rheindorf,3246,6,6,6,12,20,30,-10,24
Mattersburg,3246,7,6,5,13,28,40,-12,23
FC Salzburg,3247,1,15,6,3,44,18,26,51
SK Sturm Gra,3247,2,13,4,7,34,27,7,43
Rapid Vienna,3247,3,9,9,6,34,26,8,36
LASK Linz,3247,4,8,7,9,25,28,-3,31
Vienna,3247,5,7,5,12,28,40,-12,26
Mattersburg,3247,6,5,7,12,29,44,-15,22
SC Rheindorf,3247,7,4,8,12,16,27,-11,20
FC Salzburg,3248,1,14,7,3,45,17,28,49
SK Sturm Gra,3248,2,13,5,6,35,27,8,44
Rapid Vienna,3248,3,8,10,6,34,31,3,34
LASK Linz,3248,4,8,7,9,29,31,-2,31
Vienna,3248,5,7,6,11,27,38,-11,27
Mattersburg,3248,6,6,5,13,30,44,-14,23
SC Rheindorf,3248,7,5,6,13,21,33,-12,21
FC Salzburg,3249,1,12,7,5,41,23,18,43
Rapid Vienna,3249,2,11,9,4,40,25,15,42
SK Sturm Gra,3249,3,12,4,8,30,29,1,40
LASK Linz,3249,4,8,7,9,29,28,1,31
Vienna,3249,5,7,6,11,27,40,-13,27
Mattersburg,3249,6,6,7,11,29,40,-11,25
SC Rheindorf,3249,7,5,6,13,18,29,-11,21
FC Salzburg,3250,1,13,8,3,44,20,24,47
SK Sturm Gra,3250,2,12,5,7,30,27,3,41
Rapid Vienna,3250,3,7,12,5,33,26,7,33
LASK Linz,3250,4,8,6,10,27,29,-2,30
Vienna,3250,5,8,5,11,27,38,-11,29
SC Rheindorf,3250,6,7,5,12,21,27,-6,26
Mattersburg,3250,7,6,5,13,30,45,-15,23
FC Salzburg,3251,1,15,7,2,46,18,28,52
SK Sturm Gra,3251,2,13,4,7,34,29,5,43
LASK Linz,3251,3,9,7,8,30,28,2,34
Rapid Vienna,3251,4,7,9,8,33,32,1,30
Mattersburg,3251,5,7,6,11,33,39,-6,27
Vienna,3251,6,6,5,13,24,43,-19,23
SC Rheindorf,3251,7,5,6,13,18,29,-11,21
FC Salzburg,3252,1,15,7,2,51,17,34,52
SK Sturm Gra,3252,2,12,5,7,33,31,2,41
Rapid Vienna,3252,3,8,11,5,33,25,8,35
LASK Linz,3252,4,8,6,10,27,30,-3,30
Vienna,3252,5,7,5,12,29,42,-13,26
Mattersburg,3252,6,6,6,12,31,48,-17,24
SC Rheindorf,3252,7,5,6,13,19,30,-11,21
FC Salzburg,3253,1,16,6,2,50,19,31,54
SK Sturm Gra,3253,2,12,3,9,33,32,1,39
Rapid Vienna,3253,3,9,10,5,38,29,9,37
LASK Linz,3253,4,9,6,9,30,29,1,33
Vienna,3253,5,7,5,12,30,42,-12,26
SC Rheindorf,3253,6,6,5,13,19,31,-12,23
Mattersburg,3253,7,5,5,14,28,46,-18,20
FC Salzburg,3254,1,15,7,2,49,21,28,52
SK Sturm Gra,3254,2,13,4,7,39,32,7,43
LASK Linz,3254,3,10,6,8,32,26,6,36
Rapid Vienna,3254,4,8,9,7,34,32,2,33
Mattersburg,3254,5,7,5,12,33,46,-13,26
Vienna,3254,6,6,6,12,27,42,-15,24
SC Rheindorf,3254,7,4,5,15,18,33,-15,17
FC Salzburg,3255,1,14,8,2,46,17,29,50
SK Sturm Gra,3255,2,13,3,8,32,28,4,42
Rapid Vienna,3255,3,8,10,6,33,27,6,34
LASK Linz,3255,4,8,7,9,27,28,-1,31
Vienna,3255,5,7,6,11,27,39,-12,27
Mattersburg,3255,6,6,6,12,31,44,-13,24
SC Rheindorf,3255,7,5,6,13,17,30,-13,21
FC Salzburg,3256,1,15,6,3,47,19,28,51
SK Sturm Gra,3256,2,13,3,8,33,29,4,42
Rapid Vienna,3256,3,9,9,6,38,29,9,36
LASK Linz,3256,4,8,6,10,30,34,-4,30
Vienna,3256,5,7,5,12,28,40,-12,26
SC Rheindorf,3256,6,6,7,11,20,28,-8,25
Mattersburg,3256,7,5,6,13,28,45,-17,21
FC Salzburg,3257,1,14,6,4,44,21,23,48
SK Sturm Gra,3257,2,12,3,9,31,32,-1,39
Rapid Vienna,3257,3,9,10,5,38,27,11,37
LASK Linz,3257,4,8,7,9,27,28,-1,31
Vienna,3257,5,8,5,11,29,38,-9,29
SC Rheindorf,3257,6,6,7,11,22,26,-4,25
Mattersburg,3257,7,5,6,13,29,48,-19,21
FC Salzburg,3258,1,14,8,2,47,19,28,50
SK Sturm Gra,3258,2,12,5,7,34,30,4,41
Rapid Vienna,3258,3,8,11,5,35,26,9,35
LASK Linz,3258,4,8,7,9,26,28,-2,31
Vienna,3258,5,7,6,11,26,38,-12,27
Mattersburg,3258,6,6,6,12,30,43,-13,24
SC Rheindorf,3258,7,4,7,13,16,30,-14,19
FC Salzburg,3259,1,13,7,4,42,21,21,46
SK Sturm Gra,3259,2,13,4,7,36,30,6,43
Rapid Vienna,3259,3,7,13,4,35,27,8,34
LASK Linz,3259,4,7,7,10,26,29,-3,28
Vienna,3259,5,7,6,11,28,39,-11,27
Mattersburg,3259,6,6,7,11,29,39,-10,25
SC Rheindorf,3259,7,6,6,12,18,29,-11,24
FC Salzburg,3260,1,14,7,3,42,17,25,49
SK Sturm Gra,3260,2,12,4,8,29,27,2,40
Rapid Vienna,3260,3,9,9,6,34,28,6,36
LASK Linz,3260,4,8,6,10,27,29,-2,30
Mattersburg,3260,5,7,6,11,32,39,-7,27
Vienna,3260,6,7,6,11,26,38,-12,27
SC Rheindorf,3260,7,5,6,13,18,30,-12,21
FC Salzburg,3261,1,13,7,4,42,23,19,46
Rapid Vienna,3261,2,11,9,4,44,27,17,42
SK Sturm Gra,3261,3,12,3,9,34,30,4,39
LASK Linz,3261,4,9,5,10,29,34,-5,32
Vienna,3261,5,8,5,11,27,38,-11,29
SC Rheindorf,3261,6,6,5,13,19,28,-9,23
Mattersburg,3261,7,5,6,13,28,43,-15,21
FC Salzburg,3262,1,14,8,2,45,19,26,50
SK Sturm Gra,3262,2,12,5,7,35,30,5,41
Rapid Vienna,3262,3,9,9,6,37,29,8,36
LASK Linz,3262,4,8,6,10,27,30,-3,30
Mattersburg,3262,5,7,6,11,32,40,-8,27
Vienna,3262,6,7,5,12,27,41,-14,26
SC Rheindorf,3262,7,5,5,14,18,32,-14,20
FC Salzburg,3263,1,15,7,2,47,18,29,52
SK Sturm Gra,3263,2,11,4,9,32,33,-1,37
Rapid Vienna,3263,3,8,11,5,34,25,9,35
SC Rheindorf,3263,4,8,5,11,22,27,-5,29
LASK Linz,3263,5,7,7,10,26,30,-4,28
Mattersburg,3263,6,6,6,12,30,43,-13,24
Vienna,3263,7,6,6,12,25,40,-15,24
FC Salzburg,3264,1,14,7,3,46,24,22,49
SK Sturm Gra,3264,2,12,5,7,32,27,5,41
Rapid Vienna,3264,3,8,11,5,36,27,9,35
LASK Linz,3264,4,8,7,9,26,28,-2,31
Vienna,3264,5,7,6,11,29,41,-12,27
Mattersburg,3264,6,6,7,11,32,41,-9,25
SC Rheindorf,3264,7,4,7,13,19,32,-13,19
FC Salzburg,3265,1,15,7,2,46,19,27,52
SK Sturm Gra,3265,2,12,3,9,34,33,1,39
Rapid Vienna,3265,3,9,10,5,38,28,10,37
LASK Linz,3265,4,10,6,8,29,27,2,36
Vienna,3265,5,7,5,12,26,40,-14,26
Mattersburg,3265,6,5,7,12,30,42,-12,22
SC Rheindorf,3265,7,4,6,14,21,35,-14,18
FC Salzburg,3266,1,15,6,3,48,19,29,51
SK Sturm Gra,3266,2,14,3,7,35,30,5,45
Rapid Vienna,3266,3,8,10,6,35,28,7,34
LASK Linz,3266,4,7,7,10,25,30,-5,28
Mattersburg,3266,5,7,6,11,33,41,-8,27
Vienna,3266,6,7,5,12,26,42,-16,26
SC Rheindorf,3266,7,4,7,13,18,30,-12,19
FC Salzburg,3267,1,13,9,2,42,18,24,48
SK Sturm Gra,3267,2,13,4,7,38,29,9,43
LASK Linz,3267,3,9,6,9,31,30,1,33
Rapid Vienna,3267,4,7,11,6,34,32,2,32
Vienna,3267,5,7,6,11,26,39,-13,27
Mattersburg,3267,6,6,5,13,29,42,-13,23
SC Rheindorf,3267,7,5,7,12,18,28,-10,22
FC Salzburg,3268,1,16,6,2,46,18,28,54
SK Sturm Gra,3268,2,12,4,8,35,30,5,40
LASK Linz,3268,3,9,6,9,27,29,-2,33
Rapid Vienna,3268,4,7,9,8,33,33,0,30
Mattersburg,3268,5,7,5,12,32,40,-8,26
Vienna,3268,6,7,5,12,26,40,-14,26
SC Rheindorf,3268,7,5,7,12,19,28,-9,22
FC Salzburg,3269,1,14,8,2,43,17,26,50
SK Sturm Gra,3269,2,13,4,7,32,26,6,43
LASK Linz,3269,3,9,5,10,30,28,2,32
Rapid Vienna,3269,4,7,10,7,31,26,5,31
SC Rheindorf,3269,5,6,7,11,20,28,-8,25
Vienna,3269,6,6,6,12,25,40,-15,24
Mattersburg,3269,7,6,6,12,30,46,-16,24
FC Salzburg,3270,1,14,7,3,45,17,28,49
SK Sturm Gra,3270,2,13,4,7,30,25,5,43
Rapid Vienna,3270,3,7,11,6,33,32,1,32
Vienna,3270,4,8,5,11,29,38,-9,29
LASK Linz,3270,5,7,7,10,25,28,-3,28
Mattersburg,3270,6,7,6,11,30,40,-10,27
SC Rheindorf,3270,7,4,8,12,17,29,-12,20
FC Salzburg,3271,1,15,7,2,46,17,29,52
SK Sturm Gra,3271,2,13,4,7,33,26,7,43
Rapid Vienna,3271,3,9,10,5,38,30,8,37
LASK Linz,3271,4,8,5,11,27,32,-5,29
Vienna,3271,5,6,6,12,24,41,-17,24
SC Rheindorf,3271,6,5,7,12,22,30,-8,22
Mattersburg,3271,7,5,7,12,31,45,-14,22
FC Salzburg,3272,1,16,6,2,52,17,35,54
SK Sturm Gra,3272,2,13,3,8,33,30,3,42
LASK Linz,3272,3,10,5,9,27,26,1,35
Rapid Vienna,3272,4,8,9,7,32,28,4,33
Vienna,3272,5,6,6,12,26,43,-17,24
SC Rheindorf,3272,6,6,5,13,19,31,-12,23
Mattersburg,3272,7,5,6,13,29,43,-14,21
FC Salzburg,3273,1,13,8,3,44,19,25,47
SK Sturm Gra,3273,2,14,4,6,33,24,9,46
Rapid Vienna,3273,3,8,9,7,33,29,4,33
LASK Linz,3273,4,9,6,9,26,26,0,33
Vienna,3273,5,7,6,11,26,39,-13,27
Mattersburg,3273,6,6,8,10,31,39,-8,26
SC Rheindorf,3273,7,4,5,15,15,32,-17,17
FC Salzburg,3274,1,14,6,4,48,21,27,48
Rapid Vienna,3274,2,10,10,4,40,28,12,40
SK Sturm Gra,3274,3,11,4,9,36,38,-2,37
Vienna,3274,4,8,5,11,26,38,-12,29
LASK Linz,3274,5,7,7,10,26,31,-5,28
SC Rheindorf,3274,6,7,5,12,21,27,-6,26
Mattersburg,3274,7,6,5,13,31,45,-14,23
FC Salzburg,3275,1,14,7,3,43,18,25,49
SK Sturm Gra,3275,2,13,4,7,33,29,4,43
Rapid Vienna,3275,3,7,10,7,34,29,5,31
LASK Linz,3275,4,8,6,10,25,29,-4,30
Vienna,3275,5,7,6,11,27,39,-12,27
Mattersburg,3275,6,6,7,11,29,39,-10,25
SC Rheindorf,3275,7,6,6,12,22,30,-8,24
FC Salzburg,3276,1,16,6,2,49,20,29,54
SK Sturm Gra,3276,2,11,5,8,30,29,1,38
LASK Linz,3276,3,10,6,8,30,27,3,36
Rapid Vienna,3276,4,8,11,5,37,30,7,35
Vienna,3276,5,7,5,12,25,38,-13,26
SC Rheindorf,3276,6,5,6,13,17,29,-12,21
Mattersburg,3276,7,5,5,14,30,45,-15,20
FC Salzburg,3277,1,15,7,2,45,16,29,52
SK Sturm Gra,3277,2,12,5,7,33,27,6,41
Rapid Vienna,3277,3,7,12,5,33,27,6,33
LASK Linz,3277,4,8,6,10,27,31,-4,30
Mattersburg,3277,5,7,5,12,31,42,-11,26
Vienna,3277,6,7,5,12,26,41,-15,26
SC Rheindorf,3277,7,5,6,13,17,28,-11,21
FC Salzburg,3278,1,14,8,2,43,18,25,50
SK Sturm Gra,3278,2,12,3,9,35,33,2,39
Rapid Vienna,3278,3,8,10,6,35,27,8,34
LASK Linz,3278,4,9,6,9,27,30,-3,33
SC Rheindorf,3278,5,7,5,12,21,27,-6,26
Vienna,3278,6,7,5,12,25,39,-14,26
Mattersburg,3278,7,5,7,12,28,40,-12,22
FC Salzburg,3279,1,14,8,2,50,20,30,50
SK Sturm Gra,3279,2,11,7,6,32,28,4,40
Rapid Vienna,3279,3,8,10,6,38,31,7,34
LASK Linz,3279,4,8,7,9,28,30,-2,31
Vienna,3279,5,7,6,11,30,41,-11,27
Mattersburg,3279,6,7,5,12,33,47,-14,26
SC Rheindorf,3279,7,4,7,13,20,34,-14,19
FC Salzburg,3280,1,15,7,2,46,16,30,52
SK Sturm Gra,3280,2,11,6,7,34,31,3,39
LASK Linz,3280,3,9,7,8,29,27,2,34
Rapid Vienna,3280,4,7,12,5,37,32,5,33
Vienna,3280,5,6,6,12,27,43,-16,24
SC Rheindorf,3280,6,5,7,12,20,30,-10,22
Mattersburg,3280,7,5,7,12,33,47,-14,22
FC Salzburg,3281,1,14,8,2,43,18,25,50
SK Sturm Gra,3281,2,13,5,6,32,25,7,44
Rapid Vienna,3281,3,8,10,6,33,27,6,34
LASK Linz,3281,4,8,6,10,26,28,-2,30
Vienna,3281,5,7,5,12,24,38,-14,26
Mattersburg,3281,6,6,6,12,32,41,-9,24
SC Rheindorf,3281,7,5,6,13,16,29,-13,21
FC Salzburg,3282,1,13,9,2,44,19,25,48
SK Sturm Gra,3282,2,14,4,6,34,26,8,46
Rapid Vienna,3282,3,8,10,6,39,28,11,34
LASK Linz,3282,4,8,6,10,29,31,-2,30
Vienna,3282,5,7,5,12,28,40,-12,26
Mattersburg,3282,6,6,7,11,30,43,-13,25
SC Rheindorf,3282,7,5,5,14,18,35,-17,20
FC Salzburg,3283,1,13,9,2,45,19,26,48
SK Sturm Gra,3283,2,11,3,10,29,36,-7,36
Rapid Vienna,3283,3,8,11,5,36,28,8,35
LASK Linz,3283,4,9,6,9,29,28,1,33
Mattersburg,3283,5,7,6,11,31,41,-10,27
Vienna,3283,6,7,6,11,27,38,-11,27
SC Rheindorf,3283,7,5,7,12,20,27,-7,22
FC Salzburg,3284,1,15,7,2,46,17,29,52
Rapid Vienna,3284,2,9,10,5,36,27,9,37
SK Sturm Gra,3284,3,11,4,9,31,34,-3,37
LASK Linz,3284,4,7,8,9,27,29,-2,29
Vienna,3284,5,7,5,12,25,40,-15,26
Mattersburg,3284,6,6,7,11,29,39,-10,25
SC Rheindorf,3284,7,6,5,13,19,27,-8,23
FC Salzburg,3285,1,15,6,3,48,19,29,51
SK Sturm Gra,3285,2,12,4,8,34,31,3,40
Rapid Vienna,3285,3,9,9,6,37,28,9,36
LASK Linz,3285,4,9,7,8,26,25,1,34
Vienna,3285,5,7,5,12,26,40,-14,26
SC Rheindorf,3285,6,5,7,12,18,28,-10,22
Mattersburg,3285,7,5,6,13,27,45,-18,21
FC Salzburg,3286,1,13,9,2,41,17,24,48
SK Sturm Gra,3286,2,11,6,7,31,28,3,39
Rapid Vienna,3286,3,8,11,5,32,24,8,35
LASK Linz,3286,4,9,7,8,30,29,1,34
Vienna,3286,5,7,6,11,25,38,-13,27
Mattersburg,3286,6,5,7,12,28,40,-12,22
SC Rheindorf,3286,7,5,6,13,19,30,-11,21
FC Salzburg,3287,1,13,8,3,43,19,24,47
SK Sturm Gra,3287,2,13,3,8,31,27,4,42
Rapid Vienna,3287,3,9,11,4,36,23,13,38
LASK Linz,3287,4,9,6,9,26,26,0,33
Mattersburg,3287,5,8,5,11,31,41,-10,29
Vienna,3287,6,6,6,12,26,41,-15,24
SC Rheindorf,3287,7,4,5,15,17,33,-16,17
FC Salzburg,3288,1,15,6,3,43,17,26,51
SK Sturm Gra,3288,2,11,5,8,29,30,-1,38
LASK Linz,3288,3,9,7,8,29,27,2,34
Rapid Vienna,3288,4,7,12,5,34,27,7,33
Mattersburg,3288,5,7,5,12,29,42,-13,26
SC Rheindorf,3288,6,6,6,12,26,30,-4,24
Vienna,3288,7,6,5,13,23,40,-17,23
FC Salzburg,3289,1,14,8,2,46,16,30,50
Rapid Vienna,3289,2,9,11,4,36,24,12,38
SK Sturm Gra,3289,3,11,4,9,29,32,-3,37
LASK Linz,3289,4,9,6,9,26,26,0,33
Mattersburg,3289,5,7,5,12,32,44,-12,26
Vienna,3289,6,6,5,13,23,41,-18,23
SC Rheindorf,3289,7,5,7,12,20,29,-9,22
FC Salzburg,3290,1,16,6,2,48,17,31,54
SK Sturm Gra,3290,2,12,4,8,31,30,1,40
Rapid Vienna,3290,3,9,10,5,35,26,9,37
LASK Linz,3290,4,7,7,10,27,30,-3,28
Vienna,3290,5,7,5,12,25,41,-16,26
Mattersburg,3290,6,6,5,13,31,43,-12,23
SC Rheindorf,3290,7,5,7,12,19,29,-10,22
FC Salzburg,3291,1,15,6,3,47,18,29,51
SK Sturm Gra,3291,2,11,6,7,32,30,2,39
Rapid Vienna,3291,3,8,10,6,36,29,7,34
LASK Linz,3291,4,9,6,9,27,27,0,33
Vienna,3291,5,7,6,11,25,38,-13,27
SC Rheindorf,3291,6,6,6,12,22,29,-7,24
Mattersburg,3291,7,5,6,13,30,48,-18,21
FC Salzburg,3292,1,15,7,2,47,16,31,52
SK Sturm Gra,3292,2,12,5,7,32,31,1,41
Rapid Vienna,3292,3,7,13,4,33,25,8,34
LASK Linz,3292,4,8,7,9,27,29,-2,31
Mattersburg,3292,5,6,6,12,30,42,-12,24
Vienna,3292,6,6,5,13,24,42,-18,23
SC Rheindorf,3292,7,5,7,12,21,29,-8,22
FC Salzburg,3293,1,15,7,2,53,16,37,52
SK Sturm Gra,3293,2,12,3,9,32,30,2,39
Rapid Vienna,3293,3,9,10,5,36,24,12,37
LASK Linz,3293,4,9,6,9,29,29,0,33
Mattersburg,3293,5,7,6,11,34,48,-14,27
Vienna,3293,6,6,5,13,26,48,-22,23
SC Rheindorf,3293,7,4,7,13,19,34,-15,19
FC Salzburg,3294,1,15,6,3,46,18,28,51
SK Sturm Gra,3294,2,13,3,8,32,29,3,42
Rapid Vienna,3294,3,8,9,7,34,28,6,33
LASK Linz,3294,4,8,6,10,24,26,-2,30
Mattersburg,3294,5,7,6,11,32,41,-9,27
Vienna,3294,6,7,5,12,24,40,-16,26
SC Rheindorf,3294,7,5,7,12,18,28,-10,22
FC Salzburg,3295,1,15,6,3,44,19,25,51
SK Sturm Gra,3295,2,13,3,8,30,27,3,42
Rapid Vienna,3295,3,9,9,6,34,25,9,36
LASK Linz,3295,4,9,5,10,25,26,-1,32
Mattersburg,3295,5,6,7,11,30,41,-11,25
Vienna,3295,6,6,6,12,26,41,-15,24
SC Rheindorf,3295,7,5,6,13,17,27,-10,21
FC Salzburg,3296,1,14,7,3,42,18,24,49
SK Sturm Gra,3296,2,14,4,6,34,25,9,46
Rapid Vienna,3296,3,9,10,5,37,27,10,37
LASK Linz,3296,4,8,6,10,25,29,-4,30
Mattersburg,3296,5,8,5,11,32,39,-7,29
Vienna,3296,6,6,5,13,24,40,-16,23
SC Rheindorf,3296,7,4,5,15,16,32,-16,17
FC Salzburg,3297,1,15,6,3,52,19,33,51
SK Sturm Gra,3297,2,14,3,7,32,30,2,45
Rapid Vienna,3297,3,8,10,6,36,32,4,34
Mattersburg,3297,4,9,5,10,34,38,-4,32
LASK Linz,3297,5,7,5,12,24,32,-8,26
Vienna,3297,6,6,5,13,26,43,-17,23
SC Rheindorf,3297,7,5,6,13,20,30,-10,21
FC Salzburg,3298,1,14,7,3,45,19,26,49
SK Sturm Gra,3298,2,14,4,6,36,26,10,46
Rapid Vienna,3298,3,9,10,5,38,28,10,37
LASK Linz,3298,4,7,7,10,26,30,-4,28
Mattersburg,3298,5,7,6,11,31,41,-10,27
Vienna,3298,6,6,5,13,24,42,-18,23
SC Rheindorf,3298,7,4,7,13,18,32,-14,19
FC Salzburg,3299,1,15,7,2,48,17,31,52
SK Sturm Gra,3299,2,13,5,6,33,27,6,44
LASK Linz,3299,3,10,5,9,32,26,6,35
Rapid Vienna,3299,4,7,9,8,32,34,-2,30
SC Rheindorf,3299,5,6,6,12,18,29,-11,24
Vienna,3299,6,6,6,12,23,39,-16,24
Mattersburg,3299,7,5,6,13,28,42,-14,21
FC Salzburg,3300,1,14,7,3,44,20,24,49
SK Sturm Gra,3300,2,13,4,7,34,26,8,43
Rapid Vienna,3300,3,8,10,6,39,30,9,34
LASK Linz,3300,4,8,7,9,27,28,-1,31
Vienna,3300,5,7,5,12,25,41,-16,26
Mattersburg,3300,6,6,6,12,31,40,-9,24
SC Rheindorf,3300,7,6,5,13,21,36,-15,23
FC Salzburg,3301,1,15,7,2,44,18,26,52
SK Sturm Gra,3301,2,12,5,7,32,27,5,41
Rapid Vienna,3301,3,9,10,5,38,27,11,37
LASK Linz,3301,4,7,6,11,24,31,-7,27
Vienna,3301,5,6,7,11,26,40,-14,25
Mattersburg,3301,6,5,8,11,31,42,-11,23
SC Rheindorf,3301,7,5,7,12,20,30,-10,22
FC Salzburg,3302,1,14,7,3,44,19,25,49
SK Sturm Gra,3302,2,12,4,8,32,30,2,40
Rapid Vienna,3302,3,9,9,6,36,28,8,36
LASK Linz,3302,4,9,5,10,28,28,0,32
Vienna,3302,5,7,6,11,27,39,-12,27
Mattersburg,3302,6,7,5,12,30,42,-12,26
SC Rheindorf,3302,7,5,6,13,23,34,-11,21
FC Salzburg,3303,1,14,7,3,45,21,24,49
SK Sturm Gra,3303,2,12,5,7,33,30,3,41
Rapid Vienna,3303,3,9,11,4,38,26,12,38
LASK Linz,3303,4,8,6,10,25,29,-4,30
Vienna,3303,5,7,5,12,27,40,-13,26
Mattersburg,3303,6,6,6,12,30,41,-11,24
SC Rheindorf,3303,7,4,8,12,20,31,-11,20
FC Salzburg,3304,1,14,7,3,45,18,27,49
SK Sturm Gra,3304,2,13,4,7,33,26,7,43
Rapid Vienna,3304,3,8,10,6,34,27,7,34
LASK Linz,3304,4,9,6,9,28,27,1,33
Mattersburg,3304,5,8,5,11,31,40,-9,29
Vienna,3304,6,7,5,12,26,40,-14,26
SC Rheindorf,3304,7,4,5,15,16,35,-19,17
FC Salzburg,3305,1,15,7,2,42,16,26,52
SK Sturm Gra,3305,2,11,4,9,30,29,1,37
Rapid Vienna,3305,3,8,10,6,35,29,6,34
LASK Linz,3305,4,8,6,10,25,27,-2,30
SC Rheindorf,3305,5,8,5,11,21,26,-5,29
Mattersburg,3305,6,6,6,12,31,40,-9,24
Vienna,3305,7,6,6,12,23,40,-17,24
FC Salzburg,3306,1,13,8,3,44,20,24,47
SK Sturm Gra,3306,2,12,4,8,32,29,3,40
Rapid Vienna,3306,3,8,12,4,34,25,9,36
LASK Linz,3306,4,8,6,10,27,30,-3,30
Mattersburg,3306,5,8,5,11,36,40,-4,29
Vienna,3306,6,7,5,12,25,40,-15,26
SC Rheindorf,3306,7,5,6,13,18,32,-14,21
FC Salzburg,3307,1,15,6,3,49,21,28,51
SK Sturm Gra,3307,2,12,3,9,31,32,-1,39
Rapid Vienna,3307,3,9,10,5,39,27,12,37
LASK Linz,3307,4,9,6,9,29,29,0,33
SC Rheindorf,3307,5,7,5,12,21,29,-8,26
Mattersburg,3307,6,6,5,13,32,43,-11,23
Vienna,3307,7,6,5,13,25,45,-20,23
FC Salzburg,3308,1,15,7,2,46,16,30,52
SK Sturm Gra,3308,2,12,4,8,31,31,0,40
Rapid Vienna,3308,3,8,10,6,38,29,9,34
LASK Linz,3308,4,8,6,10,28,32,-4,30
SC Rheindorf,3308,5,7,5,12,25,30,-5,26
Mattersburg,3308,6,6,6,12,30,44,-14,24
Vienna,3308,7,6,6,12,23,39,-16,24
FC Salzburg,3309,1,14,7,3,44,18,26,49
SK Sturm Gra,3309,2,13,5,6,34,27,7,44
Rapid Vienna,3309,3,7,9,8,34,32,2,30
LASK Linz,3309,4,8,5,11,26,29,-3,29
SC Rheindorf,3309,5,7,6,11,22,28,-6,27
Mattersburg,3309,6,7,5,12,30,42,-12,26
Vienna,3309,7,7,5,12,24,38,-14,26
FC Salzburg,3310,1,14,7,3,45,19,26,49
SK Sturm Gra,3310,2,13,3,8,32,31,1,42
Rapid Vienna,3310,3,8,10,6,33,26,7,34
LASK Linz,3310,4,8,6,10,27,29,-2,30
SC Rheindorf,3310,5,7,5,12,20,28,-8,26
Vienna,3310,6,7,5,12,25,39,-14,26
Mattersburg,3310,7,6,6,12,33,43,-10,24
FC Salzburg,3311,1,13,8,3,43,19,24,47
SK Sturm Gra,3311,2,13,5,6,33,26,7,44
Rapid Vienna,3311,3,8,10,6,36,28,8,34
LASK Linz,3311,4,8,5,11,26,30,-4,29
Vienna,3311,5,7,6,11,25,38,-13,27
SC Rheindorf,3311,6,6,6,12,19,29,-10,24
Mattersburg,3311,7,6,6,12,32,44,-12,24
FC Salzburg,3312,1,15,7,2,46,15,31,52
SK Sturm Gra,3312,2,14,3,7,39,27,12,45
Rapid Vienna,3312,3,8,11,5,36,29,7,35
LASK Linz,3312,4,7,8,9,25,29,-4,29
Mattersburg,3312,5,7,6,11,30,42,-12,27
Vienna,3312,6,6,5,13,24,41,-17,23
SC Rheindorf,3312,7,4,6,14,16,33,-17,18
FC Salzburg,3313,1,15,6,3,46,17,29,51
SK Sturm Gra,3313,2,13,4,7,35,27,8,43
Rapid Vienna,3313,3,8,11,5,37,31,6,35
LASK Linz,3313,4,7,7,10,26,31,-5,28
Mattersburg,3313,5,7,5,12,30,43,-13,26
SC Rheindorf,3313,6,6,6,12,23,30,-7,24
Vienna,3313,7,6,5,13,23,41,-18,23
FC Salzburg,3314,1,15,6,3,46,18,28,51
SK Sturm Gra,3314,2,12,4,8,34,33,1,40
Rapid Vienna,3314,3,9,10,5,34,25,9,37
LASK Linz,3314,4,7,9,8,25,26,-1,30
Vienna,3314,5,7,5,12,24,38,-14,26
Mattersburg,3314,6,6,6,12,31,41,-10,24
SC Rheindorf,3314,7,5,6,13,19,32,-13,21
FC Salzburg,3315,1,14,7,3,50,21,29,49
SK Sturm Gra,3315,2,12,5,7,33,30,3,41
Rapid Vienna,3315,3,8,10,6,33,27,6,34
LASK Linz,3315,4,8,6,10,27,31,-4,30
Vienna,3315,5,8,5,11,27,38,-11,29
Mattersburg,3315,6,7,5,12,35,48,-13,26
SC Rheindorf,3315,7,5,6,13,21,31,-10,21
FC Salzburg,3316,1,14,8,2,45,18,27,50
SK Sturm Gra,3316,2,13,5,6,35,28,7,44
Rapid Vienna,3316,3,9,9,6,33,26,7,36
LASK Linz,3316,4,7,7,10,26,30,-4,28
Vienna,3316,5,7,5,12,27,41,-14,26
SC Rheindorf,3316,6,5,7,12,21,31,-10,22
Mattersburg,3316,7,5,7,12,31,44,-13,22
FC Salzburg,3317,1,15,7,2,47,18,29,52
SK Sturm Gra,3317,2,12,5,7,33,29,4,41
Rapid Vienna,3317,3,8,11,5,36,28,8,35
LASK Linz,3317,4,7,6,11,24,31,-7,27
Vienna,3317,5,7,6,11,27,38,-11,27
SC Rheindorf,3317,6,6,6,12,20,28,-8,24
Mattersburg,3317,7,6,5,13,29,44,-15,23
FC Salzburg,3318,1,13,7,4,43,20,23,46
SK Sturm Gra,3318,2,11,5,8,31,29,2,38
Rapid Vienna,3318,3,9,10,5,35,27,8,37
LASK Linz,3318,4,9,5,10,27,27,0,32
Vienna,3318,5,7,6,11,26,39,-13,27
Mattersburg,3318,6,6,7,11,30,41,-11,25
SC Rheindorf,3318,7,6,6,12,21,30,-9,24
FC Salzburg,3319,1,15,6,3,45,18,27,51
SK Sturm Gra,3319,2,13,3,8,33,28,5,42
LASK Linz,3319,3,9,6,9,29,30,-1,33
Rapid Vienna,3319,4,7,10,7,33,32,1,31
SC Rheindorf,3319,5,6,7,11,22,28,-6,25
Mattersburg,3319,6,6,6,12,33,43,-10,24
Vienna,3319,7,6,6,12,26,42,-16,24
FC Salzburg,3320,1,14,7,3,46,21,25,49
SK Sturm Gra,3320,2,14,3,7,33,28,5,45
Rapid Vienna,3320,3,9,10,5,38,27,11,37
LASK Linz,3320,4,8,6,10,27,29,-2,30
Vienna,3320,5,6,6,12,27,43,-16,24
Mattersburg,3320,6,6,5,13,31,42,-11,23
SC Rheindorf,3320,7,6,5,13,17,29,-12,23
FC Salzburg,3321,1,15,6,3,47,19,28,51
Rapid Vienna,3321,2,11,9,4,42,26,16,42
SK Sturm Gra,3321,3,13,3,8,35,29,6,42
LASK Linz,3321,4,7,6,11,27,36,-9,27
Vienna,3321,5,6,6,12,25,40,-15,24
Mattersburg,3321,6,5,8,11,29,43,-14,23
SC Rheindorf,3321,7,5,6,13,18,30,-12,21
FC Salzburg,3322,1,13,9,2,49,23,26,48
SK Sturm Gra,3322,2,13,4,7,35,28,7,43
Rapid Vienna,3322,3,9,10,5,34,26,8,37
LASK Linz,3322,4,8,5,11,25,30,-5,29
Mattersburg,3322,5,7,6,11,34,42,-8,27
Vienna,3322,6,7,5,12,29,44,-15,26
SC Rheindorf,3322,7,5,5,14,17,30,-13,20
FC Salzburg,3323,1,15,7,2,47,20,27,52
SK Sturm Gra,3323,2,11,4,9,32,35,-3,37
Rapid Vienna,3323,3,8,10,6,36,29,7,34
LASK Linz,3323,4,9,6,9,31,29,2,33
Vienna,3323,5,7,6,11,27,39,-12,27
SC Rheindorf,3323,6,6,6,12,25,32,-7,24
Mattersburg,3323,7,5,7,12,31,45,-14,22
FC Salzburg,3324,1,14,7,3,46,19,27,49
SK Sturm Gra,3324,2,12,5,7,36,27,9,41
Rapid Vienna,3324,3,10,10,4,38,25,13,40
Mattersburg,3324,4,8,5,11,33,43,-10,29
LASK Linz,3324,5,7,5,12,24,35,-11,26
SC Rheindorf,3324,6,6,5,13,17,29,-12,23
Vienna,3324,7,6,5,13,26,42,-16,23
FC Salzburg,3325,1,14,8,2,42,17,25,50
SK Sturm Gra,3325,2,12,3,9,30,27,3,39
Rapid Vienna,3325,3,9,10,5,36,25,11,37
LASK Linz,3325,4,9,6,9,27,27,0,33
Mattersburg,3325,5,7,6,11,32,40,-8,27
Vienna,3325,6,6,5,13,23,39,-16,23
SC Rheindorf,3325,7,5,6,13,18,33,-15,21
FC Salzburg,3326,1,15,7,2,45,18,27,52
SK Sturm Gra,3326,2,12,4,8,32,29,3,40
Rapid Vienna,3326,3,9,9,6,36,27,9,36
Mattersburg,3326,4,8,6,10,34,39,-5,30
LASK Linz,3326,5,7,6,11,23,28,-5,27
Vienna,3326,6,6,5,13,23,40,-17,23
SC Rheindorf,3326,7,5,7,12,18,30,-12,22
FC Salzburg,3327,1,15,7,2,47,18,29,52
SK Sturm Gra,3327,2,13,3,8,31,29,2,42
Rapid Vienna,3327,3,9,10,5,36,27,9,37
LASK Linz,3327,4,8,6,10,26,28,-2,30
Vienna,3327,5,7,6,11,28,40,-12,27
Mattersburg,3327,6,6,6,12,29,42,-13,24
SC Rheindorf,3327,7,4,6,14,16,29,-13,18
FC Salzburg,3328,1,14,6,4,47,21,26,48
Rapid Vienna,3328,2,10,10,4,40,25,15,40
SK Sturm Gra,3328,3,12,4,8,32,29,3,40
LASK Linz,3328,4,8,5,11,26,30,-4,29
Vienna,3328,5,8,5,11,28,39,-11,29
SC Rheindorf,3328,6,6,5,13,19,32,-13,23
Mattersburg,3328,7,6,5,13,28,44,-16,23
FC Salzburg,3329,1,14,8,2,45,18,27,50
SK Sturm Gra,3329,2,12,6,6,34,29,5,42
Rapid Vienna,3329,3,8,10,6,34,28,6,34
LASK Linz,3329,4,7,8,9,27,30,-3,29
Vienna,3329,5,7,6,11,26,39,-13,27
SC Rheindorf,3329,6,6,6,12,21,28,-7,24
Mattersburg,3329,7,5,6,13,30,45,-15,21
FC Salzburg,3330,1,14,7,3,43,20,23,49
SK Sturm Gra,3330,2,11,5,8,32,31,1,38
LASK Linz,3330,3,10,6,8,32,26,6,36
Rapid Vienna,3330,4,8,11,5,35,29,6,35
SC Rheindorf,3330,5,6,6,12,21,29,-8,24
Vienna,3330,6,6,6,12,26,42,-16,24
Mattersburg,3330,7,6,5,13,30,42,-12,23
FC Salzburg,3331,1,16,6,2,49,19,30,54
SK Sturm Gra,3331,2,12,4,8,31,28,3,40
Rapid Vienna,3331,3,9,9,6,39,29,10,36
LASK Linz,3331,4,10,5,9,29,27,2,35
Mattersburg,3331,5,6,5,13,27,43,-16,23
Vienna,3331,6,6,5,13,25,42,-17,23
SC Rheindorf,3331,7,5,6,13,21,33,-12,21
FC Salzburg,3332,1,14,8,2,46,17,29,50
SK Sturm Gra,3332,2,11,5,8,31,30,1,38
LASK Linz,3332,3,10,6,8,32,28,4,36
Rapid Vienna,3332,4,8,10,6,34,28,6,34
Vienna,3332,5,7,6,11,27,40,-13,27
SC Rheindorf,3332,6,6,6,12,19,28,-9,24
Mattersburg,3332,7,5,5,14,31,49,-18,20
FC Salzburg,3333,1,14,8,2,44,18,26,50
SK Sturm Gra,3333,2,12,5,7,33,28,5,41
Rapid Vienna,3333,3,8,11,5,34,25,9,35
LASK Linz,3333,4,10,5,9,30,29,1,35
Mattersburg,3333,5,6,5,13,29,41,-12,23
Vienna,3333,6,6,5,13,25,42,-17,23
SC Rheindorf,3333,7,5,7,12,18,30,-12,22
FC Salzburg,3334,1,16,6,2,48,15,33,54
SK Sturm Gra,3334,2,13,3,8,32,31,1,42
LASK Linz,3334,3,10,5,9,28,26,2,35
Rapid Vienna,3334,4,7,10,7,34,30,4,31
SC Rheindorf,3334,5,6,6,12,22,29,-7,24
Vienna,3334,6,6,6,12,24,41,-17,24
Mattersburg,3334,7,5,6,13,28,44,-16,21
FC Salzburg,3335,1,14,7,3,44,18,26,49
Rapid Vienna,3335,2,11,9,4,37,23,14,42
SK Sturm Gra,3335,3,12,3,9,29,29,0,39
LASK Linz,3335,4,9,6,9,27,28,-1,33
Vienna,3335,5,7,6,11,25,38,-13,27
Mattersburg,3335,6,6,5,13,30,41,-11,23
SC Rheindorf,3335,7,4,6,14,16,31,-15,18
FC Salzburg,3336,1,15,6,3,49,18,31,51
SK Sturm Gra,3336,2,13,3,8,34,30,4,42
Rapid Vienna,3336,3,8,9,7,34,30,4,33
LASK Linz,3336,4,8,6,10,27,34,-7,30
Vienna,3336,5,8,5,11,26,38,-12,29
SC Rheindorf,3336,6,7,6,11,26,27,-1,27
Mattersburg,3336,7,5,5,14,27,46,-19,20
FC Salzburg,3337,1,15,7,2,51,22,29,52
SK Sturm Gra,3337,2,13,5,6,37,30,7,44
Rapid Vienna,3337,3,9,9,6,38,31,7,36
LASK Linz,3337,4,8,6,10,30,31,-1,30
Vienna,3337,5,7,5,12,27,40,-13,26
SC Rheindorf,3337,6,5,6,13,21,32,-11,21
Mattersburg,3337,7,5,6,13,32,50,-18,21
FC Salzburg,3338,1,13,9,2,47,21,26,48
SK Sturm Gra,3338,2,12,5,7,33,30,3,41
Rapid Vienna,3338,3,8,12,4,36,26,10,36
LASK Linz,3338,4,9,6,9,30,30,0,33
Mattersburg,3338,5,8,5,11,35,43,-8,29
Vienna,3338,6,6,6,12,27,42,-15,24
SC Rheindorf,3338,7,4,5,15,16,32,-16,17
FC Salzburg,3339,1,16,6,2,50,16,34,54
SK Sturm Gra,3339,2,12,4,8,32,29,3,40
Rapid Vienna,3339,3,9,9,6,36,31,5,36
LASK Linz,3339,4,7,5,12,26,33,-7,26
Mattersburg,3339,5,7,5,12,31,42,-11,26
Vienna,3339,6,7,5,12,27,44,-17,26
SC Rheindorf,3339,7,6,6,12,21,28,-7,24
FC Salzburg,3340,1,13,8,3,44,20,24,47
SK Sturm Gra,3340,2,14,3,7,36,29,7,45
Rapid Vienna,3340,3,8,11,5,36,28,8,35
LASK Linz,3340,4,8,6,10,29,32,-3,30
Vienna,3340,5,7,6,11,26,39,-13,27
Mattersburg,3340,6,5,8,11,30,41,-11,23
SC Rheindorf,3340,7,5,6,13,17,29,-12,21
FC Salzburg,3341,1,15,6,3,45,18,27,51
Rapid Vienna,3341,2,10,9,5,39,28,11,39
SK Sturm Gra,3341,3,11,5,8,31,30,1,38
LASK Linz,3341,4,8,6,10,27,31,-4,30
Vienna,3341,5,7,5,12,26,40,-14,26
SC Rheindorf,3341,6,6,7,11,23,29,-6,25
Mattersburg,3341,7,5,6,13,29,44,-15,21
FC Salzburg,3342,1,15,6,3,49,19,30,51
SK Sturm Gra,3342,2,11,5,8,30,29,1,38
LASK Linz,3342,3,10,6,8,30,25,5,36
Rapid Vienna,3342,4,8,11,5,33,25,8,35
SC Rheindorf,3342,5,5,8,11,18,25,-7,23
Mattersburg,3342,6,6,5,13,31,48,-17,23
Vienna,3342,7,6,5,13,24,44,-20,23
FC Salzburg,3343,1,15,6,3,46,17,29,51
SK Sturm Gra,3343,2,13,3,8,32,27,5,42
Rapid Vienna,3343,3,7,11,6,34,29,5,32
LASK Linz,3343,4,7,7,10,26,31,-5,28
Vienna,3343,5,7,6,11,26,39,-13,27
SC Rheindorf,3343,6,6,7,11,22,29,-7,25
Mattersburg,3343,7,5,8,11,30,44,-14,23
FC Salzburg,3344,1,15,6,3,43,17,26,51
SK Sturm Gra,3344,2,14,3,7,36,29,7,45
Rapid Vienna,3344,3,10,9,5,37,26,11,39
LASK Linz,3344,4,7,6,11,25,30,-5,27
Mattersburg,3344,5,7,6,11,34,41,-7,27
Vienna,3344,6,6,6,12,24,40,-16,24
SC Rheindorf,3344,7,4,6,14,19,35,-16,18
FC Salzburg,3345,1,13,8,3,47,21,26,47
SK Sturm Gra,3345,2,13,5,6,32,25,7,44
Rapid Vienna,3345,3,9,10,5,36,27,9,37
LASK Linz,3345,4,8,6,10,25,28,-3,30
Vienna,3345,5,7,6,11,29,42,-13,27
SC Rheindorf,3345,6,5,7,12,20,30,-10,22
Mattersburg,3345,7,5,6,13,28,44,-16,21
FC Salzburg,3346,1,14,8,2,44,17,27,50
SK Sturm Gra,3346,2,13,3,8,32,28,4,42
Rapid Vienna,3346,3,8,10,6,35,28,7,34
LASK Linz,3346,4,7,7,10,25,32,-7,28
Mattersburg,3346,5,6,8,10,31,39,-8,26
SC Rheindorf,3346,6,6,6,12,22,29,-7,24
Vienna,3346,7,6,6,12,24,40,-16,24
FC Salzburg,3347,1,14,7,3,50,20,30,49
SK Sturm Gra,3347,2,13,4,7,32,28,4,43
Rapid Vienna,3347,3,8,11,5,35,27,8,35
LASK Linz,3347,4,8,5,11,26,30,-4,29
Mattersburg,3347,5,7,6,11,31,43,-12,27
Vienna,3347,6,6,6,12,26,43,-17,24
SC Rheindorf,3347,7,5,7,12,20,29,-9,22
FC Salzburg,3348,1,15,7,2,44,17,27,52
SK Sturm Gra,3348,2,13,4,7,30,26,4,43
Rapid Vienna,3348,3,7,9,8,34,30,4,30
LASK Linz,3348,4,8,5,11,25,28,-3,29
SC Rheindorf,3348,5,7,6,11,21,27,-6,27
Vienna,3348,6,7,6,11,25,38,-13,27
Mattersburg,3348,7,6,5,13,30,43,-13,23
FC Salzburg,3349,1,14,7,3,45,20,25,49
SK Sturm Gra,3349,2,12,4,8,32,29,3,40
Rapid Vienna,3349,3,8,10,6,33,27,6,34
LASK Linz,3349,4,9,7,8,29,27,2,34
Vienna,3349,5,7,6,11,26,38,-12,27
SC Rheindorf,3349,6,5,8,11,19,28,-9,23
Mattersburg,3349,7,5,6,13,30,45,-15,21
FC Salzburg,3350,1,13,8,3,45,22,23,47
SK Sturm Gra,3350,2,12,5,7,33,27,6,41
Rapid Vienna,3350,3,10,10,4,37,25,12,40
Mattersburg,3350,4,8,6,10,34,39,-5,30
LASK Linz,3350,5,7,7,10,25,28,-3,28
Vienna,3350,6,6,5,13,24,44,-20,23
SC Rheindorf,3350,7,4,7,13,17,30,-13,19
FC Salzburg,3351,1,16,6,2,47,15,32,54
SK Sturm Gra,3351,2,13,4,7,32,25,7,43
Rapid Vienna,3351,3,8,9,7,33,27,6,33
LASK Linz,3351,4,8,6,10,26,28,-2,30
Mattersburg,3351,5,8,5,11,32,41,-9,29
Vienna,3351,6,6,5,13,23,41,-18,23
SC Rheindorf,3351,7,5,5,14,17,33,-16,20
FC Salzburg,3352,1,14,7,3,44,20,24,49
SK Sturm Gra,3352,2,12,5,7,30,25,5,41
Rapid Vienna,3352,3,9,9,6,36,28,8,36
LASK Linz,3352,4,10,6,8,31,27,4,36
Vienna,3352,5,7,6,11,26,38,-12,27
Mattersburg,3352,6,5,7,12,29,43,-14,22
SC Rheindorf,3352,7,4,6,14,18,33,-15,18
FC Salzburg,3353,1,15,6,3,45,18,27,51
SK Sturm Gra,3353,2,13,4,7,35,29,6,43
Rapid Vienna,3353,3,7,10,7,33,31,2,31
LASK Linz,3353,4,7,9,8,26,27,-1,30
SC Rheindorf,3353,5,6,7,11,20,26,-6,25
Mattersburg,3353,6,6,7,11,29,41,-12,25
Vienna,3353,7,6,5,13,24,40,-16,23
FC Salzburg,3354,1,15,6,3,45,16,29,51
SK Sturm Gra,3354,2,13,3,8,31,28,3,42
Rapid Vienna,3354,3,8,10,6,33,26,7,34
LASK Linz,3354,4,9,6,9,28,27,1,33
SC Rheindorf,3354,5,6,6,12,22,27,-5,24
Vienna,3354,6,6,6,12,23,39,-16,24
Mattersburg,3354,7,5,7,12,27,46,-19,22
FC Salzburg,3355,1,14,8,2,45,17,28,50
SK Sturm Gra,3355,2,12,5,7,32,29,3,41
Rapid Vienna,3355,3,8,11,5,40,26,14,35
LASK Linz,3355,4,9,6,9,31,29,2,33
Vienna,3355,5,7,6,11,24,37,-13,27
Mattersburg,3355,6,6,5,13,31,47,-16,23
SC Rheindorf,3355,7,5,5,14,20,38,-18,20
FC Salzburg,3356,1,14,8,2,45,19,26,50
SK Sturm Gra,3356,2,12,4,8,33,31,2,40
Rapid Vienna,3356,3,8,12,4,37,27,10,36
LASK Linz,3356,4,7,7,10,27,30,-3,28
Mattersburg,3356,5,7,6,11,36,43,-7,27
SC Rheindorf,3356,6,6,6,12,21,30,-9,24
Vienna,3356,7,6,5,13,24,43,-19,23
FC Salzburg,3357,1,15,7,2,49,18,31,52
Rapid Vienna,3357,2,9,11,4,35,25,10,38
SK Sturm Gra,3357,3,11,5,8,28,30,-2,38
LASK Linz,3357,4,9,6,9,28,27,1,33
Vienna,3357,5,7,5,12,27,41,-14,26
SC Rheindorf,3357,6,6,5,13,19,29,-10,23
Mattersburg,3357,7,5,5,14,28,44,-16,20
FC Salzburg,3358,1,14,8,2,46,17,29,50
SK Sturm Gra,3358,2,13,4,7,30,25,5,43
Rapid Vienna,3358,3,7,11,6,32,27,5,32
LASK Linz,3358,4,8,7,9,27,28,-1,31
Mattersburg,3358,5,7,5,12,31,44,-13,26
Vienna,3358,6,6,6,12,24,39,-15,24
SC Rheindorf,3358,7,5,7,12,20,30,-10,22
FC Salzburg,3359,1,13,8,3,44,20,24,47
SK Sturm Gra,3359,2,12,5,7,35,31,4,41
Rapid Vienna,3359,3,8,11,5,34,26,8,35
Mattersburg,3359,4,8,6,10,33,38,-5,30
LASK Linz,3359,5,8,5,11,26,32,-6,29
Vienna,3359,6,6,6,12,24,40,-16,24
SC Rheindorf,3359,7,6,5,13,21,30,-9,23
FC Salzburg,3360,1,14,7,3,44,20,24,49
SK Sturm Gra,3360,2,12,3,9,32,32,0,39
Rapid Vienna,3360,3,9,11,4,38,27,11,38
LASK Linz,3360,4,8,7,9,27,27,0,31
Mattersburg,3360,5,6,7,11,31,41,-10,25
SC Rheindorf,3360,6,6,6,12,20,29,-9,24
Vienna,3360,7,6,5,13,24,40,-16,23
FC Salzburg,3361,1,15,6,3,47,18,29,51
SK Sturm Gra,3361,2,12,5,7,33,28,5,41
Rapid Vienna,3361,3,9,11,4,34,24,10,38
LASK Linz,3361,4,8,7,9,30,31,-1,31
Vienna,3361,5,7,5,12,28,39,-11,26
Mattersburg,3361,6,6,6,12,33,50,-17,24
SC Rheindorf,3361,7,4,6,14,18,33,-15,18
FC Salzburg,3362,1,15,7,2,45,19,26,52
SK Sturm Gra,3362,2,12,4,8,33,31,2,40
Rapid Vienna,3362,3,9,10,5,38,26,12,37
LASK Linz,3362,4,8,7,9,29,31,-2,31
Vienna,3362,5,6,6,12,25,40,-15,24
Mattersburg,3362,6,5,8,11,32,43,-11,23
SC Rheindorf,3362,7,5,6,13,20,32,-12,21
FC Salzburg,3363,1,13,8,3,44,18,26,47
SK Sturm Gra,3363,2,13,3,8,31,29,2,42
Rapid Vienna,3363,3,8,11,5,36,27,9,35
LASK Linz,3363,4,8,7,9,29,29,0,31
SC Rheindorf,3363,5,7,5,12,23,31,-8,26
Mattersburg,3363,6,6,6,12,32,46,-14,24
Vienna,3363,7,6,6,12,24,39,-15,24
FC Salzburg,3364,1,14,7,3,47,21,26,49
SK Sturm Gra,3364,2,13,3,8,32,30,2,42
LASK Linz,3364,3,9,6,9,28,25,3,33
Rapid Vienna,3364,4,7,10,7,35,33,2,31
Vienna,3364,5,7,6,11,27,40,-13,27
Mattersburg,3364,6,6,8,10,30,39,-9,26
SC Rheindorf,3364,7,5,6,13,17,28,-11,21
FC Salzburg,3365,1,15,6,3,45,20,25,51
SK Sturm Gra,3365,2,14,3,7,38,25,13,45
LASK Linz,3365,3,9,5,10,28,33,-5,32
Rapid Vienna,3365,4,7,9,8,32,30,2,30
Mattersburg,3365,5,8,5,11,34,43,-9,29
Vienna,3365,6,7,5,12,27,40,-13,26
SC Rheindorf,3365,7,5,5,14,18,31,-13,20
FC Salzburg,3366,1,12,6,6,38,21,17,42
SK Sturm Gra,3366,2,13,3,8,32,28,4,42
Rapid Vienna,3366,3,10,10,4,42,29,13,40
LASK Linz,3366,4,8,7,9,29,30,-1,31
Vienna,3366,5,8,5,11,28,37,-9,29
Mattersburg,3366,6,6,7,11,28,41,-13,25
SC Rheindorf,3366,7,5,6,13,20,31,-11,21
FC Salzburg,3367,1,16,6,2,51,17,34,54
SK Sturm Gra,3367,2,14,3,7,33,26,7,45
LASK Linz,3367,3,9,6,9,28,26,2,33
Rapid Vienna,3367,4,7,10,7,34,33,1,31
Vienna,3367,5,6,6,12,24,39,-15,24
SC Rheindorf,3367,6,5,7,12,19,29,-10,22
Mattersburg,3367,7,5,6,13,28,47,-19,21
FC Salzburg,3368,1,14,8,2,43,15,28,50
Rapid Vienna,3368,2,10,9,5,36,28,8,39
SK Sturm Gra,3368,3,11,5,8,31,29,2,38
LASK Linz,3368,4,8,5,11,28,31,-3,29
Mattersburg,3368,5,6,7,11,29,39,-10,25
SC Rheindorf,3368,6,6,6,12,19,28,-9,24
Vienna,3368,7,6,6,12,24,40,-16,24
FC Salzburg,3369,1,15,6,3,49,21,28,51
SK Sturm Gra,3369,2,13,4,7,36,29,7,43
Rapid Vienna,3369,3,9,9,6,38,30,8,36
LASK Linz,3369,4,8,5,11,27,33,-6,29
Vienna,3369,5,7,5,12,28,40,-12,26
Mattersburg,3369,6,7,5,12,31,45,-14,26
SC Rheindorf,3369,7,5,6,13,20,31,-11,21
FC Salzburg,3370,1,15,7,2,53,17,36,52
SK Sturm Gra,3370,2,12,3,9,34,34,0,39
Rapid Vienna,3370,3,9,10,5,39,31,8,37
LASK Linz,3370,4,8,6,10,30,38,-8,30
Mattersburg,3370,5,7,6,11,36,44,-8,27
Vienna,3370,6,6,6,12,24,40,-16,24
SC Rheindorf,3370,7,5,6,13,19,31,-12,21
FC Salzburg,3371,1,13,9,2,44,17,27,48
SK Sturm Gra,3371,2,12,6,6,32,27,5,42
LASK Linz,3371,3,9,6,9,30,28,2,33
Rapid Vienna,3371,4,7,10,7,33,30,3,31
Mattersburg,3371,5,7,6,11,31,39,-8,27
SC Rheindorf,3371,6,6,6,12,18,28,-10,24
Vienna,3371,7,6,5,13,23,42,-19,23
FC Salzburg,3372,1,15,6,3,46,17,29,51
SK Sturm Gra,3372,2,12,4,8,33,30,3,40
Rapid Vienna,3372,3,7,12,5,33,28,5,33
LASK Linz,3372,4,9,6,9,27,29,-2,33
Vienna,3372,5,8,5,11,26,37,-11,29
SC Rheindorf,3372,6,5,7,12,18,28,-10,22
Mattersburg,3372,7,5,6,13,29,43,-14,21
FC Salzburg,3373,1,14,6,4,49,23,26,48
SK Sturm Gra,3373,2,13,4,7,36,31,5,43
Rapid Vienna,3373,3,9,9,6,34,28,6,36
Mattersburg,3373,4,9,5,10,35,36,-1,32
LASK Linz,3373,5,8,5,11,26,32,-6,29
Vienna,3373,6,6,5,13,24,42,-18,23
SC Rheindorf,3373,7,5,6,13,17,29,-12,21
FC Salzburg,3374,1,15,7,2,46,18,28,52
SK Sturm Gra,3374,2,13,3,8,34,30,4,42
Rapid Vienna,3374,3,8,10,6,35,31,4,34
LASK Linz,3374,4,9,5,10,28,27,1,32
Vienna,3374,5,7,6,11,28,40,-12,27
Mattersburg,3374,6,6,5,13,30,44,-14,23
SC Rheindorf,3374,7,5,6,13,19,30,-11,21
FC Salzburg,3375,1,14,8,2,44,17,27,50
SK Sturm Gra,3375,2,12,4,8,31,29,2,40
Rapid Vienna,3375,3,8,11,5,34,27,7,35
LASK Linz,3375,4,10,5,9,28,27,1,35
Vienna,3375,5,7,6,11,26,37,-11,27
Mattersburg,3375,6,6,5,13,29,44,-15,23
SC Rheindorf,3375,7,5,5,14,20,31,-11,20
FC Salzburg,3376,1,14,7,3,43,19,24,49
SK Sturm Gra,3376,2,13,4,7,32,27,5,43
Rapid Vienna,3376,3,9,9,6,38,27,11,36
LASK Linz,3376,4,9,6,9,29,29,0,33
Vienna,3376,5,7,6,11,27,40,-13,27
Mattersburg,3376,6,5,8,11,29,40,-11,23
SC Rheindorf,3376,7,4,6,14,18,34,-16,18
FC Salzburg,3377,1,15,6,3,50,19,31,51
SK Sturm Gra,3377,2,12,3,9,30,34,-4,39
Rapid Vienna,3377,3,8,10,6,40,33,7,34
LASK Linz,3377,4,9,6,9,34,31,3,33
Vienna,3377,5,7,5,12,25,43,-18,26
SC Rheindorf,3377,6,6,7,11,24,30,-6,25
Mattersburg,3377,7,6,5,13,33,46,-13,23
FC Salzburg,3378,1,14,8,2,44,17,27,50
SK Sturm Gra,3378,2,13,4,7,33,27,6,43
Rapid Vienna,3378,3,9,10,5,36,27,9,37
LASK Linz,3378,4,8,5,11,28,30,-2,29
SC Rheindorf,3378,5,7,5,12,22,30,-8,26
Mattersburg,3378,6,6,5,13,29,44,-15,23
Vienna,3378,7,6,5,13,23,40,-17,23
FC Salzburg,3379,1,15,7,2,48,21,27,52
SK Sturm Gra,3379,2,12,3,9,33,33,0,39
Rapid Vienna,3379,3,9,9,6,39,29,10,36
LASK Linz,3379,4,8,6,10,26,30,-4,30
Mattersburg,3379,5,6,7,11,30,40,-10,25
Vienna,3379,6,6,7,11,25,39,-14,25
SC Rheindorf,3379,7,6,5,13,20,29,-9,23
SK Sturm Gra,3380,1,14,4,6,35,26,9,46
FC Salzburg,3380,2,12,9,3,41,22,19,45
Rapid Vienna,3380,3,10,9,5,40,25,15,39
LASK Linz,3380,4,8,5,11,27,30,-3,29
Mattersburg,3380,5,6,7,11,29,40,-11,25
Vienna,3380,6,6,7,11,23,37,-14,25
SC Rheindorf,3380,7,5,5,14,19,34,-15,20
FC Salzburg,3381,1,13,7,4,42,22,20,46
SK Sturm Gra,3381,2,12,5,7,35,31,4,41
Rapid Vienna,3381,3,8,12,4,39,28,11,36
LASK Linz,3381,4,8,6,10,28,32,-4,30
Vienna,3381,5,8,5,11,26,38,-12,29
Mattersburg,3381,6,7,5,12,36,41,-5,26
SC Rheindorf,3381,7,5,6,13,19,33,-14,21
FC Salzburg,3382,1,14,8,2,44,16,28,50
SK Sturm Gra,3382,2,12,4,8,35,32,3,40
Rapid Vienna,3382,3,9,11,4,37,26,11,38
LASK Linz,3382,4,7,7,10,27,32,-5,28
Vienna,3382,5,7,6,11,26,38,-12,27
SC Rheindorf,3382,6,6,6,12,22,32,-10,24
Mattersburg,3382,7,5,6,13,28,43,-15,21
FC Salzburg,3383,1,13,7,4,40,19,21,46
Rapid Vienna,3383,2,10,9,5,37,26,11,39
SK Sturm Gra,3383,3,11,5,8,31,29,2,38
Mattersburg,3383,4,8,5,11,30,38,-8,29
LASK Linz,3383,5,7,6,11,25,30,-5,27
SC Rheindorf,3383,6,7,5,12,22,30,-8,26
Vienna,3383,7,7,5,12,26,39,-13,26
FC Salzburg,3384,1,15,7,2,43,15,28,52
SK Sturm Gra,3384,2,11,6,7,31,28,3,39
Rapid Vienna,3384,3,9,10,5,41,26,15,37
Mattersburg,3384,4,8,5,11,35,40,-5,29
LASK Linz,3384,5,7,6,11,27,35,-8,27
SC Rheindorf,3384,6,6,5,13,19,34,-15,23
Vienna,3384,7,6,5,13,23,41,-18,23
FC Salzburg,3385,1,15,7,2,47,16,31,52
SK Sturm Gra,3385,2,12,4,8,31,28,3,40
Rapid Vienna,3385,3,9,11,4,42,29,13,38
LASK Linz,3385,4,8,6,10,30,35,-5,30
Vienna,3385,5,7,5,12,24,40,-16,26
SC Rheindorf,3385,6,6,5,13,22,33,-11,23
Mattersburg,3385,7,5,6,13,28,43,-15,21
FC Salzburg,3386,1,15,7,2,46,17,29,52
SK Sturm Gra,3386,2,13,4,7,32,29,3,43
Rapid Vienna,3386,3,7,12,5,34,27,7,33
LASK Linz,3386,4,7,8,9,28,30,-2,29
Mattersburg,3386,5,7,6,11,33,42,-9,27
Vienna,3386,6,6,6,12,26,42,-16,24
SC Rheindorf,3386,7,4,7,13,18,30,-12,19
FC Salzburg,3387,1,13,7,4,43,23,20,46
SK Sturm Gra,3387,2,13,5,6,35,26,9,44
Rapid Vienna,3387,3,10,10,4,36,24,12,40
LASK Linz,3387,4,7,7,10,23,26,-3,28
Vienna,3387,5,7,5,12,27,40,-13,26
Mattersburg,3387,6,6,6,12,30,42,-12,24
SC Rheindorf,3387,7,5,6,13,18,31,-13,21
FC Salzburg,3388,1,13,7,4,42,20,22,46
SK Sturm Gra,3388,2,13,5,6,36,28,8,44
Rapid Vienna,3388,3,7,11,6,31,27,4,32
Mattersburg,3388,4,9,5,10,35,40,-5,32
LASK Linz,3388,5,8,6,10,27,31,-4,30
Vienna,3388,6,6,5,13,25,41,-16,23
SC Rheindorf,3388,7,5,7,12,22,31,-9,22
FC Salzburg,3389,1,14,8,2,44,17,27,50
SK Sturm Gra,3389,2,12,4,8,32,29,3,40
Rapid Vienna,3389,3,7,12,5,37,30,7,33
LASK Linz,3389,4,8,7,9,28,32,-4,31
Vienna,3389,5,7,5,12,26,41,-15,26
Mattersburg,3389,6,6,6,12,33,42,-9,24
SC Rheindorf,3389,7,5,8,11,23,32,-9,23
FC Salzburg,3390,1,16,6,2,49,18,31,54
Rapid Vienna,3390,2,10,9,5,36,27,9,39
SK Sturm Gra,3390,3,12,3,9,31,29,2,39
LASK Linz,3390,4,8,6,10,27,29,-2,30
Mattersburg,3390,5,7,6,11,35,43,-8,27
Vienna,3390,6,6,5,13,25,43,-18,23
SC Rheindorf,3390,7,5,5,14,18,32,-14,20
FC Salzburg,3391,1,14,7,3,45,18,27,49
SK Sturm Gra,3391,2,14,3,7,33,28,5,45
Rapid Vienna,3391,3,9,10,5,35,26,9,37
LASK Linz,3391,4,8,5,11,26,30,-4,29
Mattersburg,3391,5,6,6,12,30,42,-12,24
Vienna,3391,6,6,6,12,24,40,-16,24
SC Rheindorf,3391,7,5,7,12,20,29,-9,22
FC Salzburg,3392,1,16,6,2,47,16,31,54
SK Sturm Gra,3392,2,11,5,8,30,31,-1,38
Rapid Vienna,3392,3,7,11,6,34,28,6,32
LASK Linz,3392,4,8,8,8,29,27,2,32
SC Rheindorf,3392,5,6,7,11,19,26,-7,25
Mattersburg,3392,6,6,6,12,31,46,-15,24
Vienna,3392,7,6,5,13,25,41,-16,23
FC Salzburg,3393,1,15,6,3,48,17,31,51
SK Sturm Gra,3393,2,13,3,8,34,30,4,42
Rapid Vienna,3393,3,8,10,6,33,30,3,34
LASK Linz,3393,4,9,5,10,29,30,-1,32
Vienna,3393,5,7,5,12,26,43,-17,26
SC Rheindorf,3393,6,6,6,12,22,29,-7,24
Mattersburg,3393,7,6,5,13,31,44,-13,23
FC Salzburg,3394,1,15,7,2,45,18,27,52
SK Sturm Gra,3394,2,12,4,8,33,30,3,40
Rapid Vienna,3394,3,9,10,5,39,28,11,37
LASK Linz,3394,4,10,5,9,27,28,-1,35
Vienna,3394,5,7,5,12,25,38,-13,26
Mattersburg,3394,6,6,5,13,29,42,-13,23
SC Rheindorf,3394,7,4,6,14,17,31,-14,18
FC Salzburg,3395,1,14,7,3,48,21,27,49
SK Sturm Gra,3395,2,12,3,9,35,34,1,39
Rapid Vienna,3395,3,9,9,6,39,31,8,36
LASK Linz,3395,4,10,5,9,27,28,-1,35
Mattersburg,3395,5,7,5,12,31,42,-11,26
Vienna,3395,6,6,6,12,24,39,-15,24
SC Rheindorf,3395,7,6,5,13,22,31,-9,23
FC Salzburg,3396,1,14,7,3,43,19,24,49
SK Sturm Gra,3396,2,12,6,6,30,25,5,42
Rapid Vienna,3396,3,10,10,4,38,25,13,40
LASK Linz,3396,4,7,8,9,26,29,-3,29
Vienna,3396,5,7,5,12,27,40,-13,26
Mattersburg,3396,6,6,6,12,30,42,-12,24
SC Rheindorf,3396,7,4,6,14,17,31,-14,18
FC Salzburg,3397,1,15,7,2,52,18,34,52
SK Sturm Gra,3397,2,14,4,6,34,26,8,46
Rapid Vienna,3397,3,9,9,6,38,29,9,36
LASK Linz,3397,4,9,5,10,28,27,1,32
Vienna,3397,5,7,5,12,27,40,-13,26
SC Rheindorf,3397,6,5,5,14,19,34,-15,20
Mattersburg,3397,7,5,5,14,28,52,-24,20
FC Salzburg,3398,1,15,7,2,45,17,28,52
Rapid Vienna,3398,2,10,10,4,38,26,12,40
SK Sturm Gra,3398,3,11,4,9,30,31,-1,37
LASK Linz,3398,4,8,6,10,26,28,-2,30
Vienna,3398,5,7,5,12,24,39,-15,26
Mattersburg,3398,6,6,5,13,31,42,-11,23
SC Rheindorf,3398,7,6,5,13,20,31,-11,23
FC Salzburg,3399,1,14,7,3,42,16,26,49
SK Sturm Gra,3399,2,12,4,8,30,28,2,40
LASK Linz,3399,3,10,6,8,27,25,2,36
Rapid Vienna,3399,4,7,10,7,31,26,5,31
Vienna,3399,5,7,5,12,25,40,-15,26
SC Rheindorf,3399,6,6,6,12,19,28,-9,24
Mattersburg,3399,7,6,6,12,30,41,-11,24
FC Salzburg,3400,1,13,8,3,43,20,23,47
SK Sturm Gra,3400,2,14,3,7,33,27,6,45
Rapid Vienna,3400,3,9,11,4,38,26,12,38
LASK Linz,3400,4,8,6,10,26,28,-2,30
Mattersburg,3400,5,7,5,12,31,41,-10,26
Vienna,3400,6,6,6,12,26,42,-16,24
SC Rheindorf,3400,7,5,5,14,18,31,-13,20
FC Salzburg,3401,1,14,7,3,45,19,26,49
SK Sturm Gra,3401,2,12,4,8,32,30,2,40
Rapid Vienna,3401,3,10,9,5,39,28,11,39
Mattersburg,3401,4,8,6,10,33,39,-6,30
LASK Linz,3401,5,7,6,11,26,30,-4,27
SC Rheindorf,3401,6,6,5,13,19,30,-11,23
Vienna,3401,7,6,5,13,24,42,-18,23
FC Salzburg,3402,1,13,6,5,41,20,21,45
SK Sturm Gra,3402,2,14,3,7,34,28,6,45
Rapid Vienna,3402,3,10,10,4,39,24,15,40
LASK Linz,3402,4,8,6,10,26,28,-2,30
Vienna,3402,5,8,5,11,29,39,-10,29
SC Rheindorf,3402,6,5,6,13,20,34,-14,21
Mattersburg,3402,7,5,6,13,31,47,-16,21
FC Salzburg,3403,1,16,6,2,55,17,38,54
Rapid Vienna,3403,2,10,9,5,39,29,10,39
SK Sturm Gra,3403,3,11,5,8,31,31,0,38
Mattersburg,3403,4,8,5,11,37,47,-10,29
LASK Linz,3403,5,7,6,11,24,38,-14,27
Vienna,3403,6,6,5,13,25,42,-17,23
SC Rheindorf,3403,7,5,6,13,24,31,-7,21
FC Salzburg,3404,1,16,6,2,47,17,30,54
SK Sturm Gra,3404,2,12,4,8,31,29,2,40
Rapid Vienna,3404,3,8,10,6,35,32,3,34
LASK Linz,3404,4,8,7,9,28,28,0,31
Vienna,3404,5,7,5,12,27,41,-14,26
Mattersburg,3404,6,6,6,12,35,45,-10,24
SC Rheindorf,3404,7,5,6,13,22,33,-11,21
FC Salzburg,3405,1,13,8,3,41,16,25,47
SK Sturm Gra,3405,2,13,4,7,32,28,4,43
Rapid Vienna,3405,3,8,11,5,33,25,8,35
LASK Linz,3405,4,8,6,10,27,29,-2,30
Vienna,3405,5,7,6,11,25,37,-12,27
Mattersburg,3405,6,7,5,12,29,41,-12,26
SC Rheindorf,3405,7,5,6,13,20,31,-11,21
FC Salzburg,3406,1,15,7,2,46,18,28,52
SK Sturm Gra,3406,2,13,3,8,34,32,2,42
Rapid Vienna,3406,3,8,11,5,38,27,11,35
LASK Linz,3406,4,8,6,10,29,30,-1,30
Mattersburg,3406,5,6,6,12,28,40,-12,24
Vienna,3406,6,6,6,12,25,42,-17,24
SC Rheindorf,3406,7,6,5,13,23,34,-11,23
FC Salzburg,3407,1,15,7,2,45,18,27,52
SK Sturm Gra,3407,2,11,5,8,30,29,1,38
Rapid Vienna,3407,3,9,10,5,42,29,13,37
LASK Linz,3407,4,9,6,9,27,27,0,33
Vienna,3407,5,7,5,12,27,39,-12,26
Mattersburg,3407,6,6,5,13,28,43,-15,23
SC Rheindorf,3407,7,5,6,13,17,31,-14,21
FC Salzburg,3408,1,14,6,4,47,20,27,48
Rapid Vienna,3408,2,9,11,4,35,24,11,38
SK Sturm Gra,3408,3,11,5,8,31,31,0,38
LASK Linz,3408,4,10,5,9,29,28,1,35
Vienna,3408,5,8,5,11,28,38,-10,29
Mattersburg,3408,6,6,5,13,28,45,-17,23
SC Rheindorf,3408,7,4,7,13,20,32,-12,19
FC Salzburg,3409,1,14,8,2,45,20,25,50
SK Sturm Gra,3409,2,13,4,7,34,27,7,43
Rapid Vienna,3409,3,7,11,6,34,30,4,32
LASK Linz,3409,4,9,5,10,26,28,-2,32
SC Rheindorf,3409,5,6,7,11,19,26,-7,25
Vienna,3409,6,6,6,12,25,40,-15,24
Mattersburg,3409,7,6,5,13,28,40,-12,23
FC Salzburg,3410,1,14,8,2,45,16,29,50
SK Sturm Gra,3410,2,12,6,6,31,26,5,42
Rapid Vienna,3410,3,7,11,6,31,25,6,32
LASK Linz,3410,4,8,7,9,25,27,-2,31
Vienna,3410,5,7,5,12,24,39,-15,26
Mattersburg,3410,6,6,6,12,30,43,-13,24
SC Rheindorf,3410,7,5,7,12,18,28,-10,22
FC Salzburg,3411,1,14,6,4,43,20,23,48
Rapid Vienna,3411,2,11,9,4,37,23,14,42
SK Sturm Gra,3411,3,12,5,7,32,28,4,41
LASK Linz,3411,4,7,7,10,27,30,-3,28
Mattersburg,3411,5,7,5,12,31,42,-11,26
Vienna,3411,6,7,5,12,25,40,-15,26
SC Rheindorf,3411,7,4,7,13,19,31,-12,19
FC Salzburg,3412,1,15,7,2,51,21,30,52
SK Sturm Gra,3412,2,12,4,8,31,30,1,40
Rapid Vienna,3412,3,8,11,5,38,30,8,35
Mattersburg,3412,4,7,7,10,35,42,-7,28
LASK Linz,3412,5,7,6,11,28,32,-4,27
Vienna,3412,6,6,6,12,25,42,-17,24
SC Rheindorf,3412,7,5,7,12,17,28,-11,22
FC Salzburg,3413,1,14,8,2,46,20,26,50
SK Sturm Gra,3413,2,13,4,7,33,27,6,43
Rapid Vienna,3413,3,10,9,5,39,28,11,39
LASK Linz,3413,4,8,5,11,26,35,-9,29
Vienna,3413,5,7,5,12,26,41,-15,26
Mattersburg,3413,6,5,7,12,31,43,-12,22
SC Rheindorf,3413,7,5,6,13,20,27,-7,21
FC Salzburg,3414,1,13,6,5,41,24,17,45
SK Sturm Gra,3414,2,14,3,7,37,28,9,45
Rapid Vienna,3414,3,9,10,5,41,26,15,37
LASK Linz,3414,4,9,6,9,29,29,0,33
Mattersburg,3414,5,8,5,11,33,40,-7,29
Vienna,3414,6,7,5,12,24,38,-14,26
SC Rheindorf,3414,7,4,5,15,17,37,-20,17
FC Salzburg,3415,1,14,8,2,48,23,25,50
SK Sturm Gra,3415,2,13,4,7,34,30,4,43
Rapid Vienna,3415,3,8,9,7,36,30,6,33
SC Rheindorf,3415,4,8,5,11,23,28,-5,29
LASK Linz,3415,5,7,5,12,25,30,-5,26
Vienna,3415,6,6,7,11,27,41,-14,25
Mattersburg,3415,7,6,6,12,32,43,-11,24
FC Salzburg,3416,1,14,7,3,50,19,31,49
SK Sturm Gra,3416,2,12,4,8,32,32,0,40
Rapid Vienna,3416,3,8,11,5,34,29,5,35
LASK Linz,3416,4,8,6,10,30,31,-1,30
SC Rheindorf,3416,5,6,7,11,19,27,-8,25
Mattersburg,3416,6,6,7,11,30,42,-12,25
Vienna,3416,7,6,6,12,25,40,-15,24
SK Sturm Gra,3417,1,15,3,6,38,27,11,48
FC Salzburg,3417,2,13,7,4,43,21,22,46
Rapid Vienna,3417,3,8,10,6,34,29,5,34
LASK Linz,3417,4,8,6,10,29,30,-1,30
Vienna,3417,5,7,6,11,26,39,-13,27
Mattersburg,3417,6,6,7,11,35,45,-10,25
SC Rheindorf,3417,7,4,7,13,18,32,-14,19
FC Salzburg,3418,1,16,6,2,50,17,33,54
SK Sturm Gra,3418,2,13,3,8,32,30,2,42
Rapid Vienna,3418,3,8,10,6,33,26,7,34
LASK Linz,3418,4,7,6,11,27,32,-5,27
Mattersburg,3418,5,7,6,11,34,44,-10,27
Vienna,3418,6,6,6,12,24,42,-18,24
SC Rheindorf,3418,7,6,5,13,20,29,-9,23
FC Salzburg,3419,1,15,6,3,44,18,26,51
SK Sturm Gra,3419,2,12,3,9,31,30,1,39
LASK Linz,3419,3,10,5,9,32,26,6,35
Rapid Vienna,3419,4,8,9,7,35,33,2,33
Mattersburg,3419,5,7,6,11,32,41,-9,27
Vienna,3419,6,7,6,11,28,39,-11,27
SC Rheindorf,3419,7,5,5,14,17,32,-15,20
FC Salzburg,3420,1,13,9,2,43,18,25,48
SK Sturm Gra,3420,2,13,4,7,34,29,5,43
Rapid Vienna,3420,3,8,12,4,35,26,9,36
LASK Linz,3420,4,7,6,11,27,34,-7,27
Vienna,3420,5,7,6,11,27,40,-13,27
Mattersburg,3420,6,5,8,11,32,43,-11,23
SC Rheindorf,3420,7,5,7,12,23,31,-8,22
FC Salzburg,3421,1,14,7,3,43,19,24,49
SK Sturm Gra,3421,2,12,5,7,31,27,4,41
Rapid Vienna,3421,3,7,11,6,34,28,6,32
LASK Linz,3421,4,8,8,8,28,28,0,32
Vienna,3421,5,7,6,11,27,38,-11,27
Mattersburg,3421,6,6,6,12,32,44,-12,24
SC Rheindorf,3421,7,6,5,13,20,31,-11,23
FC Salzburg,3422,1,13,8,3,42,19,23,47
SK Sturm Gra,3422,2,13,4,7,35,29,6,43
Rapid Vienna,3422,3,7,11,6,33,29,4,32
LASK Linz,3422,4,8,7,9,26,27,-1,31
Vienna,3422,5,8,5,11,29,38,-9,29
Mattersburg,3422,6,7,6,11,32,42,-10,27
SC Rheindorf,3422,7,5,5,14,17,30,-13,20
FC Salzburg,3423,1,14,7,3,44,20,24,49
SK Sturm Gra,3423,2,13,4,7,34,27,7,43
LASK Linz,3423,3,9,5,10,29,26,3,32
Rapid Vienna,3423,4,7,10,7,32,31,1,31
Vienna,3423,5,8,5,11,29,39,-10,29
SC Rheindorf,3423,6,6,6,12,18,28,-10,24
Mattersburg,3423,7,6,5,13,30,45,-15,23
FC Salzburg,3424,1,15,6,3,42,17,25,51
SK Sturm Gra,3424,2,13,3,8,33,27,6,42
Rapid Vienna,3424,3,8,10,6,35,30,5,34
SC Rheindorf,3424,4,7,6,11,21,27,-6,27
Mattersburg,3424,5,7,5,12,34,42,-8,26
LASK Linz,3424,6,7,5,12,25,33,-8,26
Vienna,3424,7,7,5,12,25,39,-14,26
FC Salzburg,3425,1,14,8,2,47,17,30,50
SK Sturm Gra,3425,2,12,4,8,35,32,3,40
LASK Linz,3425,3,9,7,8,30,28,2,34
Rapid Vienna,3425,4,7,12,5,38,33,5,33
Mattersburg,3425,5,6,6,12,32,44,-12,24
Vienna,3425,6,6,6,12,24,42,-18,24
SC Rheindorf,3425,7,5,7,12,20,30,-10,22
FC Salzburg,3426,1,16,6,2,44,15,29,54
SK Sturm Gra,3426,2,12,3,9,31,29,2,39
Rapid Vienna,3426,3,9,9,6,34,26,8,36
LASK Linz,3426,4,9,6,9,27,27,0,33
Mattersburg,3426,5,6,7,11,29,40,-11,25
Vienna,3426,6,6,6,12,23,38,-15,24
SC Rheindorf,3426,7,5,5,14,18,31,-13,20
FC Salzburg,3427,1,14,8,2,49,17,32,50
SK Sturm Gra,3427,2,13,3,8,33,34,-1,42
Rapid Vienna,3427,3,9,11,4,40,29,11,38
LASK Linz,3427,4,8,6,10,29,31,-2,30
Vienna,3427,5,7,6,11,25,38,-13,27
Mattersburg,3427,6,6,5,13,32,47,-15,23
SC Rheindorf,3427,7,4,7,13,19,31,-12,19
FC Salzburg,3428,1,16,6,2,49,16,33,54
SK Sturm Gra,3428,2,12,4,8,33,32,1,40
Rapid Vienna,3428,3,10,9,5,42,30,12,39
LASK Linz,3428,4,7,7,10,26,32,-6,28
Vienna,3428,5,6,6,12,25,41,-16,24
SC Rheindorf,3428,6,6,5,13,23,35,-12,23
Mattersburg,3428,7,5,7,12,31,43,-12,22
FC Salzburg,3429,1,14,7,3,46,20,26,49
SK Sturm Gra,3429,2,12,5,7,34,30,4,41
Rapid Vienna,3429,3,8,11,5,37,28,9,35
SC Rheindorf,3429,4,7,6,11,22,27,-5,27
Vienna,3429,5,7,6,11,28,40,-12,27
LASK Linz,3429,6,7,5,12,24,32,-8,26
Mattersburg,3429,7,6,6,12,32,46,-14,24
FC Salzburg,3430,1,13,7,4,42,19,23,46
Rapid Vienna,3430,2,10,10,4,40,27,13,40
SK Sturm Gra,3430,3,12,3,9,30,30,0,39
LASK Linz,3430,4,9,6,9,30,30,0,33
Mattersburg,3430,5,7,6,11,38,41,-3,27
Vienna,3430,6,7,5,12,26,40,-14,26
SC Rheindorf,3430,7,5,5,14,18,37,-19,20
FC Salzburg,3431,1,14,7,3,44,18,26,49
Rapid Vienna,3431,2,10,9,5,40,27,13,39
SK Sturm Gra,3431,3,12,3,9,34,33,1,39
LASK Linz,3431,4,8,6,10,25,29,-4,30
Vienna,3431,5,7,6,11,24,37,-13,27
Mattersburg,3431,6,6,6,12,30,40,-10,24
SC Rheindorf,3431,7,6,5,13,21,34,-13,23
FC Salzburg,3432,1,15,6,3,44,20,24,51
SK Sturm Gra,3432,2,13,3,8,32,29,3,42
LASK Linz,3432,3,10,5,9,28,26,2,35
Rapid Vienna,3432,4,8,10,6,36,28,8,34
SC Rheindorf,3432,5,6,6,12,20,27,-7,24
Vienna,3432,6,6,6,12,25,40,-15,24
Mattersburg,3432,7,5,6,13,28,43,-15,21
FC Salzburg,3433,1,15,6,3,46,21,25,51
Rapid Vienna,3433,2,10,10,4,40,26,14,40
SK Sturm Gra,3433,3,11,5,8,30,32,-2,38
LASK Linz,3433,4,8,6,10,26,28,-2,30
Mattersburg,3433,5,7,5,12,32,42,-10,26
Vienna,3433,6,7,5,12,26,39,-13,26
SC Rheindorf,3433,7,5,5,14,18,30,-12,20
FC Salzburg,3434,1,16,6,2,48,18,30,54
SK Sturm Gra,3434,2,12,3,9,31,30,1,39
Rapid Vienna,3434,3,9,10,5,37,26,11,37
LASK Linz,3434,4,9,7,8,28,26,2,34
Mattersburg,3434,5,7,6,11,31,39,-8,27
Vienna,3434,6,6,5,13,25,41,-16,23
SC Rheindorf,3434,7,4,5,15,17,37,-20,17
FC Salzburg,3435,1,13,7,4,44,23,21,46
SK Sturm Gra,3435,2,14,3,7,32,26,6,45
Rapid Vienna,3435,3,10,9,5,37,26,11,39
LASK Linz,3435,4,9,5,10,27,28,-1,32
Mattersburg,3435,5,7,5,12,32,42,-10,26
Vienna,3435,6,6,6,12,27,42,-15,24
SC Rheindorf,3435,7,5,5,14,17,29,-12,20
FC Salzburg,3436,1,14,8,2,45,18,27,50
SK Sturm Gra,3436,2,13,3,8,31,30,1,42
Rapid Vienna,3436,3,9,10,5,38,28,10,37
LASK Linz,3436,4,8,6,10,29,31,-2,30
Mattersburg,3436,5,7,6,11,31,39,-8,27
Vienna,3436,6,7,5,12,25,39,-14,26
SC Rheindorf,3436,7,4,6,14,19,33,-14,18
FC Salzburg,3437,1,14,8,2,46,19,27,50
SK Sturm Gra,3437,2,12,4,8,32,32,0,40
Rapid Vienna,3437,3,8,10,6,37,31,6,34
LASK Linz,3437,4,8,6,10,27,29,-2,30
Mattersburg,3437,5,8,6,10,31,37,-6,30
Vienna,3437,6,6,5,13,26,44,-18,23
SC Rheindorf,3437,7,5,7,12,24,31,-7,22
FC Salzburg,3438,1,14,8,2,41,16,25,50
SK Sturm Gra,3438,2,13,3,8,33,26,7,42
Rapid Vienna,3438,3,9,9,6,35,28,7,36
LASK Linz,3438,4,10,5,9,29,27,2,35
Mattersburg,3438,5,7,6,11,33,41,-8,27
Vienna,3438,6,6,6,12,26,41,-15,24
SC Rheindorf,3438,7,4,5,15,15,33,-18,17
FC Salzburg,3439,1,14,7,3,45,20,25,49
SK Sturm Gra,3439,2,12,5,7,32,28,4,41
Rapid Vienna,3439,3,9,10,5,36,27,9,37
LASK Linz,3439,4,9,6,9,29,28,1,33
Mattersburg,3439,5,6,7,11,29,39,-10,25
Vienna,3439,6,6,6,12,25,40,-15,24
SC Rheindorf,3439,7,4,7,13,18,32,-14,19
FC Salzburg,3440,1,14,6,4,48,23,25,48
SK Sturm Gra,3440,2,11,4,9,32,36,-4,37
Rapid Vienna,3440,3,9,9,6,39,30,9,36
LASK Linz,3440,4,9,7,8,32,27,5,34
Vienna,3440,5,8,5,11,28,40,-12,29
Mattersburg,3440,6,6,6,12,31,43,-12,24
SC Rheindorf,3440,7,6,5,13,21,32,-11,23
FC Salzburg,3441,1,15,6,3,46,18,28,51
SK Sturm Gra,3441,2,11,4,9,29,33,-4,37
Rapid Vienna,3441,3,9,9,6,38,29,9,36
LASK Linz,3441,4,8,6,10,28,29,-1,30
Mattersburg,3441,5,8,5,11,30,38,-8,29
SC Rheindorf,3441,6,7,5,12,19,27,-8,26
Vienna,3441,7,6,5,13,26,42,-16,23
FC Salzburg,3442,1,13,9,2,44,20,24,48
SK Sturm Gra,3442,2,11,4,9,30,33,-3,37
Rapid Vienna,3442,3,9,9,6,39,29,10,36
LASK Linz,3442,4,10,5,9,28,26,2,35
Mattersburg,3442,5,8,6,10,34,40,-6,30
Vienna,3442,6,6,6,12,26,41,-15,24
SC Rheindorf,3442,7,5,5,14,20,32,-12,20
FC Salzburg,3443,1,13,6,5,44,24,20,45
SK Sturm Gra,3443,2,13,3,8,34,29,5,42
Rapid Vienna,3443,3,10,9,5,40,27,13,39
LASK Linz,3443,4,9,5,10,27,27,0,32
Vienna,3443,5,8,5,11,25,37,-12,29
Mattersburg,3443,6,7,5,12,32,43,-11,26
SC Rheindorf,3443,7,5,5,14,18,33,-15,20
FC Salzburg,3444,1,15,6,3,44,17,27,51
Rapid Vienna,3444,2,11,9,4,39,26,13,42
SK Sturm Gra,3444,3,12,3,9,34,31,3,39
LASK Linz,3444,4,8,5,11,24,30,-6,29
SC Rheindorf,3444,5,7,5,12,20,27,-7,26
Vienna,3444,6,7,5,12,26,40,-14,26
Mattersburg,3444,7,5,5,14,26,42,-16,20
FC Salzburg,3445,1,13,8,3,39,16,23,47
SK Sturm Gra,3445,2,12,5,7,33,29,4,41
Rapid Vienna,3445,3,8,12,4,36,27,9,36
LASK Linz,3445,4,9,6,9,26,26,0,33
Vienna,3445,5,6,7,11,24,38,-14,25
Mattersburg,3445,6,5,8,11,29,40,-11,23
SC Rheindorf,3445,7,4,8,12,18,29,-11,20
FC Salzburg,3446,1,15,6,3,48,17,31,51
SK Sturm Gra,3446,2,13,4,7,35,31,4,43
Rapid Vienna,3446,3,9,9,6,37,30,7,36
LASK Linz,3446,4,8,6,10,28,30,-2,30
Vienna,3446,5,7,5,12,28,40,-12,26
Mattersburg,3446,6,7,5,12,33,46,-13,26
SC Rheindorf,3446,7,4,7,13,17,32,-15,19
FC Salzburg,3447,1,14,8,2,42,17,25,50
SK Sturm Gra,3447,2,14,3,7,35,28,7,45
Rapid Vienna,3447,3,9,10,5,37,24,13,37
LASK Linz,3447,4,8,6,10,30,35,-5,30
Mattersburg,3447,5,7,5,12,33,43,-10,26
Vienna,3447,6,6,6,12,24,40,-16,24
SC Rheindorf,3447,7,4,6,14,18,32,-14,18
FC Salzburg,3448,1,14,8,2,43,17,26,50
SK Sturm Gra,3448,2,12,4,8,30,27,3,40
Rapid Vienna,3448,3,8,11,5,33,26,7,35
LASK Linz,3448,4,8,7,9,26,27,-1,31
Vienna,3448,5,7,6,11,27,40,-13,27
Mattersburg,3448,6,7,5,12,30,39,-9,26
SC Rheindorf,3448,7,4,7,13,17,30,-13,19
FC Salzburg,3449,1,14,8,2,48,21,27,50
SK Sturm Gra,3449,2,11,4,9,32,33,-1,37
Rapid Vienna,3449,3,8,11,5,36,28,8,35
LASK Linz,3449,4,9,7,8,30,28,2,34
Vienna,3449,5,7,6,11,30,39,-9,27
Mattersburg,3449,6,6,6,12,31,46,-15,24
SC Rheindorf,3449,7,5,6,13,20,32,-12,21
FC Salzburg,3450,1,15,7,2,45,17,28,52
SK Sturm Gra,3450,2,11,3,10,30,35,-5,36
Rapid Vienna,3450,3,8,11,5,37,27,10,35
LASK Linz,3450,4,9,6,9,29,28,1,33
Vienna,3450,5,7,5,12,27,41,-14,26
SC Rheindorf,3450,6,6,7,11,22,28,-6,25
Mattersburg,3450,7,5,7,12,29,43,-14,22
FC Salzburg,3451,1,14,8,2,43,17,26,50
SK Sturm Gra,3451,2,12,4,8,33,28,5,40
Rapid Vienna,3451,3,8,11,5,36,29,7,35
LASK Linz,3451,4,7,7,10,27,30,-3,28
Vienna,3451,5,7,6,11,24,37,-13,27
SC Rheindorf,3451,6,6,6,12,19,29,-10,24
Mattersburg,3451,7,6,6,12,28,40,-12,24
FC Salzburg,3452,1,15,6,3,47,19,28,51
Rapid Vienna,3452,2,9,11,4,37,26,11,38
SK Sturm Gra,3452,3,11,5,8,30,32,-2,38
LASK Linz,3452,4,9,6,9,29,26,3,33
Mattersburg,3452,5,7,6,11,31,37,-6,27
Vienna,3452,6,6,5,13,24,41,-17,23
SC Rheindorf,3452,7,4,7,13,18,35,-17,19
FC Salzburg,3453,1,15,7,2,45,17,28,52
SK Sturm Gra,3453,2,12,6,6,31,26,5,42
Rapid Vienna,3453,3,8,10,6,32,26,6,34
LASK Linz,3453,4,8,6,10,26,28,-2,30
Vienna,3453,5,7,5,12,27,40,-13,26
Mattersburg,3453,6,6,6,12,33,45,-12,24
SC Rheindorf,3453,7,5,6,13,18,30,-12,21
FC Salzburg,3454,1,13,8,3,42,18,24,47
SK Sturm Gra,3454,2,14,4,6,36,26,10,46
Rapid Vienna,3454,3,9,10,5,34,25,9,37
LASK Linz,3454,4,7,6,11,26,32,-6,27
Mattersburg,3454,5,6,7,11,29,39,-10,25
Vienna,3454,6,6,7,11,23,37,-14,25
SC Rheindorf,3454,7,5,6,13,19,32,-13,21
FC Salzburg,3455,1,14,7,3,43,18,25,49
SK Sturm Gra,3455,2,12,3,9,30,29,1,39
Rapid Vienna,3455,3,9,10,5,35,27,8,37
LASK Linz,3455,4,9,6,9,27,29,-2,33
Mattersburg,3455,5,7,6,11,31,37,-6,27
Vienna,3455,6,7,6,11,25,38,-13,27
SC Rheindorf,3455,7,4,6,14,16,29,-13,18
FC Salzburg,3456,1,15,7,2,45,17,28,52
SK Sturm Gra,3456,2,12,4,8,31,28,3,40
Rapid Vienna,3456,3,10,9,5,39,27,12,39
LASK Linz,3456,4,8,6,10,26,28,-2,30
Mattersburg,3456,5,6,7,11,31,41,-10,25
Vienna,3456,6,6,6,12,25,41,-16,24
SC Rheindorf,3456,7,4,7,13,17,32,-15,19
FC Salzburg,3457,1,14,7,3,45,22,23,49
SK Sturm Gra,3457,2,13,5,6,37,31,6,44
Rapid Vienna,3457,3,8,9,7,36,31,5,33
LASK Linz,3457,4,8,6,10,28,30,-2,30
Mattersburg,3457,5,7,7,10,32,38,-6,28
Vienna,3457,6,6,5,13,24,41,-17,23
SC Rheindorf,3457,7,5,7,12,21,30,-9,22
FC Salzburg,3458,1,15,6,3,43,20,23,51
Rapid Vienna,3458,2,10,10,4,38,25,13,40
SK Sturm Gra,3458,3,12,4,8,32,27,5,40
LASK Linz,3458,4,9,5,10,26,29,-3,32
Mattersburg,3458,5,6,6,12,28,39,-11,24
Vienna,3458,6,6,6,12,24,39,-15,24
SC Rheindorf,3458,7,5,5,14,18,30,-12,20
FC Salzburg,3459,1,16,6,2,46,16,30,54
SK Sturm Gra,3459,2,12,4,8,32,30,2,40
Rapid Vienna,3459,3,8,10,6,39,33,6,34
LASK Linz,3459,4,7,6,11,27,31,-4,27
Vienna,3459,5,7,5,12,26,39,-13,26
SC Rheindorf,3459,6,6,7,11,22,29,-7,25
Mattersburg,3459,7,6,6,12,29,43,-14,24
FC Salzburg,3460,1,14,7,3,43,17,26,49
SK Sturm Gra,3460,2,12,4,8,30,27,3,40
LASK Linz,3460,3,10,6,8,31,25,6,36
Rapid Vienna,3460,4,8,11,5,34,25,9,35
Mattersburg,3460,5,7,5,12,32,45,-13,26
Vienna,3460,6,7,5,12,28,41,-13,26
SC Rheindorf,3460,7,4,6,14,16,34,-18,18
FC Salzburg,3461,1,15,7,2,48,19,29,52
Rapid Vienna,3461,2,10,9,5,39,27,12,39
SK Sturm Gra,3461,3,11,3,10,31,33,-2,36
LASK Linz,3461,4,8,5,11,25,31,-6,29
Vienna,3461,5,7,6,11,26,39,-13,27
SC Rheindorf,3461,6,6,6,12,20,28,-8,24
Mattersburg,3461,7,6,6,12,31,43,-12,24
FC Salzburg,3462,1,14,8,2,43,17,26,50
SK Sturm Gra,3462,2,12,4,8,34,30,4,40
Rapid Vienna,3462,3,8,12,4,36,27,9,36
LASK Linz,3462,4,7,7,10,27,33,-6,28
Mattersburg,3462,5,6,7,11,33,41,-8,25
Vienna,3462,6,6,6,12,24,40,-16,24
SC Rheindorf,3462,7,5,8,11,19,28,-9,23
FC Salzburg,3463,1,13,8,3,44,20,24,47
SK Sturm Gra,3463,2,13,5,6,34,28,6,44
Rapid Vienna,3463,3,10,9,5,37,27,10,39
LASK Linz,3463,4,9,6,9,28,27,1,33
Mattersburg,3463,5,7,6,11,32,40,-8,27
Vienna,3463,6,6,5,13,23,41,-18,23
SC Rheindorf,3463,7,4,5,15,19,34,-15,17
FC Salzburg,3464,1,16,6,2,45,15,30,54
SK Sturm Gra,3464,2,12,4,8,32,30,2,40
Rapid Vienna,3464,3,8,10,6,36,29,7,34
LASK Linz,3464,4,8,7,9,27,28,-1,31
Vienna,3464,5,7,5,12,26,40,-14,26
Mattersburg,3464,6,5,7,12,31,45,-14,22
SC Rheindorf,3464,7,4,9,11,21,31,-10,21
FC Salzburg,3465,1,14,7,3,42,18,24,49
SK Sturm Gra,3465,2,12,5,7,29,26,3,41
Rapid Vienna,3465,3,9,10,5,39,26,13,37
LASK Linz,3465,4,9,5,10,27,31,-4,32
Mattersburg,3465,5,8,6,10,34,38,-4,30
Vienna,3465,6,6,5,13,23,42,-19,23
SC Rheindorf,3465,7,4,6,14,19,32,-13,18
FC Salzburg,3466,1,14,8,2,52,20,32,50
SK Sturm Gra,3466,2,13,4,7,36,30,6,43
Rapid Vienna,3466,3,9,9,6,37,34,3,36
LASK Linz,3466,4,8,6,10,26,29,-3,30
Vienna,3466,5,7,6,11,27,39,-12,27
Mattersburg,3466,6,5,7,12,28,42,-14,22
SC Rheindorf,3466,7,5,6,13,20,32,-12,21
FC Salzburg,3467,1,15,7,2,46,19,27,52
SK Sturm Gra,3467,2,12,3,9,30,30,0,39
LASK Linz,3467,3,11,5,8,32,25,7,38
Rapid Vienna,3467,4,7,10,7,32,30,2,31
SC Rheindorf,3467,5,7,5,12,20,27,-7,26
Vienna,3467,6,7,5,12,27,39,-12,26
Mattersburg,3467,7,5,5,14,27,44,-17,20
FC Salzburg,3468,1,15,6,3,48,18,30,51
Rapid Vienna,3468,2,10,9,5,38,28,10,39
SK Sturm Gra,3468,3,11,3,10,31,31,0,36
LASK Linz,3468,4,9,6,9,31,29,2,33
Vienna,3468,5,7,5,12,28,39,-11,26
SC Rheindorf,3468,6,6,6,12,19,29,-10,24
Mattersburg,3468,7,5,7,12,29,50,-21,22
FC Salzburg,3469,1,13,7,4,42,22,20,46
Rapid Vienna,3469,2,9,10,5,35,26,9,37
LASK Linz,3469,3,10,6,8,31,29,2,36
SK Sturm Gra,3469,4,11,3,10,29,32,-3,36
Vienna,3469,5,8,5,11,29,39,-10,29
Mattersburg,3469,6,7,6,11,36,42,-6,27
SC Rheindorf,3469,7,5,5,14,19,31,-12,20
FC Salzburg,3470,1,15,6,3,47,17,30,51
SK Sturm Gra,3470,2,13,4,7,31,26,5,43
Rapid Vienna,3470,3,8,11,5,36,31,5,35
LASK Linz,3470,4,9,7,8,28,27,1,34
Vienna,3470,5,7,5,12,27,43,-16,26
Mattersburg,3470,6,6,5,13,30,42,-12,23
SC Rheindorf,3470,7,4,6,14,18,31,-13,18
FC Salzburg,3471,1,15,6,3,43,17,26,51
SK Sturm Gra,3471,2,13,4,7,34,27,7,43
Rapid Vienna,3471,3,9,9,6,36,30,6,36
LASK Linz,3471,4,8,6,10,26,31,-5,30
Vienna,3471,5,8,5,11,29,38,-9,29
Mattersburg,3471,6,6,5,13,31,44,-13,23
SC Rheindorf,3471,7,5,5,14,18,30,-12,20
FC Salzburg,3472,1,14,6,4,43,20,23,48
SK Sturm Gra,3472,2,14,3,7,35,30,5,45
LASK Linz,3472,3,9,6,9,31,26,5,33
Rapid Vienna,3472,4,7,9,8,34,35,-1,30
Mattersburg,3472,5,6,8,10,31,39,-8,26
SC Rheindorf,3472,6,6,6,12,20,29,-9,24
Vienna,3472,7,6,6,12,24,39,-15,24
FC Salzburg,3473,1,14,8,2,41,16,25,50
SK Sturm Gra,3473,2,13,4,7,35,27,8,43
Rapid Vienna,3473,3,9,9,6,35,27,8,36
LASK Linz,3473,4,8,5,11,26,29,-3,29
Vienna,3473,5,7,6,11,27,39,-12,27
Mattersburg,3473,6,7,5,12,32,42,-10,26
SC Rheindorf,3473,7,5,5,14,18,34,-16,20
FC Salzburg,3474,1,13,8,3,42,19,23,47
SK Sturm Gra,3474,2,12,5,7,32,29,3,41
LASK Linz,3474,3,10,5,9,29,30,-1,35
Rapid Vienna,3474,4,8,9,7,35,28,7,33
Mattersburg,3474,5,8,5,11,35,40,-5,29
Vienna,3474,6,7,6,11,26,39,-13,27
SC Rheindorf,3474,7,4,6,14,16,30,-14,18
FC Salzburg,3475,1,14,6,4,46,22,24,48
SK Sturm Gra,3475,2,13,3,8,31,27,4,42
Rapid Vienna,3475,3,9,9,6,35,28,7,36
LASK Linz,3475,4,8,5,11,26,28,-2,29
Mattersburg,3475,5,8,5,11,32,39,-7,29
Vienna,3475,6,7,5,12,26,41,-15,26
SC Rheindorf,3475,7,6,5,13,17,28,-11,23
FC Salzburg,3476,1,15,7,2,47,19,28,52
SK Sturm Gra,3476,2,13,4,7,36,29,7,43
Rapid Vienna,3476,3,8,10,6,35,30,5,34
LASK Linz,3476,4,9,6,9,29,28,1,33
Vienna,3476,5,6,6,12,27,43,-16,24
SC Rheindorf,3476,6,6,5,13,20,31,-11,23
Mattersburg,3476,7,5,6,13,28,42,-14,21
FC Salzburg,3477,1,13,8,3,43,21,22,47
SK Sturm Gra,3477,2,14,4,6,34,25,9,46
Rapid Vienna,3477,3,8,10,6,37,30,7,34
LASK Linz,3477,4,8,6,10,30,32,-2,30
Mattersburg,3477,5,7,6,11,33,39,-6,27
Vienna,3477,6,6,6,12,25,42,-17,24
SC Rheindorf,3477,7,5,6,13,19,32,-13,21
FC Salzburg,3478,1,15,6,3,47,19,28,51
Rapid Vienna,3478,2,11,9,4,40,25,15,42
SK Sturm Gra,3478,3,12,3,9,31,34,-3,39
LASK Linz,3478,4,9,5,10,29,29,0,32
Vienna,3478,5,6,6,12,26,41,-15,24
SC Rheindorf,3478,6,6,5,13,18,29,-11,23
Mattersburg,3478,7,5,6,13,30,44,-14,21
FC Salzburg,3479,1,14,6,4,45,22,23,48
SK Sturm Gra,3479,2,14,3,7,37,31,6,45
Rapid Vienna,3479,3,10,9,5,38,27,11,39
Mattersburg,3479,4,8,5,11,35,38,-3,29
LASK Linz,3479,5,7,5,12,24,34,-10,26
SC Rheindorf,3479,6,6,5,13,22,32,-10,23
Vienna,3479,7,6,5,13,26,43,-17,23
FC Salzburg,3480,1,16,6,2,44,15,29,54
SK Sturm Gra,3480,2,13,3,8,31,27,4,42
Rapid Vienna,3480,3,8,11,5,35,28,7,35
LASK Linz,3480,4,8,7,9,28,27,1,31
Vienna,3480,5,7,5,12,26,41,-15,26
Mattersburg,3480,6,5,6,13,31,44,-13,21
SC Rheindorf,3480,7,5,6,13,19,32,-13,21
FC Salzburg,3481,1,13,7,4,41,18,23,46
SK Sturm Gra,3481,2,13,5,6,35,25,10,44
Rapid Vienna,3481,3,9,9,6,36,27,9,36
LASK Linz,3481,4,8,6,10,27,33,-6,30
Mattersburg,3481,5,7,5,12,32,43,-11,26
Vienna,3481,6,7,5,12,25,39,-14,26
SC Rheindorf,3481,7,5,7,12,19,30,-11,22
FC Salzburg,3482,1,15,6,3,44,18,26,51
SK Sturm Gra,3482,2,13,3,8,32,30,2,42
Rapid Vienna,3482,3,8,9,7,34,31,3,33
LASK Linz,3482,4,8,6,10,28,28,0,30
Mattersburg,3482,5,7,5,12,34,43,-9,26
Vienna,3482,6,7,5,12,26,43,-17,26
SC Rheindorf,3482,7,6,6,12,22,27,-5,24
FC Salzburg,3483,1,14,6,4,42,19,23,48
Rapid Vienna,3483,2,11,9,4,39,26,13,42
SK Sturm Gra,3483,3,12,3,9,31,30,1,39
LASK Linz,3483,4,8,6,10,29,30,-1,30
Vienna,3483,5,8,5,11,26,37,-11,29
Mattersburg,3483,6,6,6,12,30,43,-13,24
SC Rheindorf,3483,7,5,5,14,18,30,-12,20
FC Salzburg,3484,1,14,7,3,44,21,23,49
Rapid Vienna,3484,2,9,11,4,36,24,12,38
SK Sturm Gra,3484,3,11,5,8,30,30,0,38
LASK Linz,3484,4,9,7,8,28,25,3,34
Mattersburg,3484,5,6,6,12,31,43,-12,24
Vienna,3484,6,6,5,13,26,42,-16,23
SC Rheindorf,3484,7,5,7,12,18,28,-10,22
FC Salzburg,3485,1,15,7,2,49,18,31,52
SK Sturm Gra,3485,2,14,3,7,34,29,5,45
Rapid Vienna,3485,3,7,10,7,34,32,2,31
LASK Linz,3485,4,8,5,11,27,29,-2,29
Vienna,3485,5,6,7,11,27,41,-14,25
SC Rheindorf,3485,6,6,6,12,18,28,-10,24
Mattersburg,3485,7,6,6,12,30,42,-12,24
FC Salzburg,3486,1,13,7,4,42,19,23,46
SK Sturm Gra,3486,2,12,5,7,34,30,4,41
Rapid Vienna,3486,3,8,10,6,36,30,6,34
LASK Linz,3486,4,8,7,9,27,27,0,31
SC Rheindorf,3486,5,8,5,11,28,31,-3,29
Vienna,3486,6,8,5,11,27,38,-11,29
Mattersburg,3486,7,5,5,14,29,48,-19,20
FC Salzburg,3487,1,15,7,2,45,17,28,52
SK Sturm Gra,3487,2,12,4,8,32,30,2,40
LASK Linz,3487,3,9,7,8,30,29,1,34
Rapid Vienna,3487,4,7,10,7,35,30,5,31
Mattersburg,3487,5,6,8,10,32,41,-9,26
Vienna,3487,6,6,6,12,24,40,-16,24
SC Rheindorf,3487,7,5,6,13,22,33,-11,21
FC Salzburg,3488,1,15,6,3,49,18,31,51
SK Sturm Gra,3488,2,13,3,8,33,32,1,42
Rapid Vienna,3488,3,9,9,6,39,28,11,36
LASK Linz,3488,4,8,6,10,29,32,-3,30
Mattersburg,3488,5,6,7,11,30,41,-11,25
SC Rheindorf,3488,6,6,6,12,21,30,-9,24
Vienna,3488,7,6,5,13,25,45,-20,23
FC Salzburg,3489,1,14,7,3,46,21,25,49
SK Sturm Gra,3489,2,12,3,9,35,33,2,39
Rapid Vienna,3489,3,9,9,6,39,32,7,36
LASK Linz,3489,4,9,6,9,28,28,0,33
Vienna,3489,5,7,6,11,27,39,-12,27
Mattersburg,3489,6,6,7,11,29,39,-10,25
SC Rheindorf,3489,7,5,6,13,18,30,-12,21
FC Salzburg,3490,1,13,9,2,44,20,24,48
SK Sturm Gra,3490,2,12,4,8,31,29,2,40
Rapid Vienna,3490,3,9,10,5,36,27,9,37
LASK Linz,3490,4,10,5,9,30,28,2,35
Vienna,3490,5,7,6,11,27,39,-12,27
Mattersburg,3490,6,6,6,12,29,41,-12,24
SC Rheindorf,3490,7,4,6,14,17,30,-13,18
FC Salzburg,3491,1,14,6,4,45,18,27,48
SK Sturm Gra,3491,2,13,4,7,31,30,1,43
Rapid Vienna,3491,3,9,9,6,37,27,10,36
LASK Linz,3491,4,9,6,9,27,27,0,33
Mattersburg,3491,5,6,6,12,28,39,-11,24
Vienna,3491,6,6,6,12,24,39,-15,24
SC Rheindorf,3491,7,6,5,13,19,31,-12,23
FC Salzburg,3492,1,15,6,3,46,19,27,51
SK Sturm Gra,3492,2,13,3,8,31,28,3,42
LASK Linz,3492,3,10,6,8,30,25,5,36
Rapid Vienna,3492,4,7,10,7,33,29,4,31
Vienna,3492,5,7,5,12,26,39,-13,26
SC Rheindorf,3492,6,6,6,12,22,28,-6,24
Mattersburg,3492,7,5,6,13,27,47,-20,21
FC Salzburg,3493,1,15,7,2,47,17,30,52
SK Sturm Gra,3493,2,13,4,7,34,29,5,43
LASK Linz,3493,3,10,5,9,30,27,3,35
Rapid Vienna,3493,4,8,10,6,35,30,5,34
Vienna,3493,5,7,5,12,26,39,-13,26
Mattersburg,3493,6,5,6,13,28,44,-16,21
SC Rheindorf,3493,7,5,5,14,17,31,-14,20
FC Salzburg,3494,1,15,7,2,46,17,29,52
SK Sturm Gra,3494,2,12,5,7,30,27,3,41
Rapid Vienna,3494,3,7,10,7,33,28,5,31
LASK Linz,3494,4,8,6,10,25,28,-3,30
Mattersburg,3494,5,7,5,12,32,41,-9,26
Vienna,3494,6,7,5,12,25,40,-15,26
SC Rheindorf,3494,7,6,6,12,18,28,-10,24
FC Salzburg,3495,1,13,8,3,44,17,27,47
SK Sturm Gra,3495,2,13,4,7,31,26,5,43
Rapid Vienna,3495,3,7,10,7,35,30,5,31
LASK Linz,3495,4,8,6,10,27,30,-3,30
Mattersburg,3495,5,7,6,11,34,43,-9,27
SC Rheindorf,3495,6,7,5,12,20,30,-10,26
Vienna,3495,7,7,5,12,26,41,-15,26
FC Salzburg,3496,1,16,6,2,47,17,30,54
SK Sturm Gra,3496,2,11,4,9,28,30,-2,37
Rapid Vienna,3496,3,8,11,5,33,25,8,35
LASK Linz,3496,4,9,6,9,27,26,1,33
Mattersburg,3496,5,8,5,11,30,38,-8,29
Vienna,3496,6,6,5,13,24,41,-17,23
SC Rheindorf,3496,7,5,5,14,18,30,-12,20
FC Salzburg,3497,1,14,7,3,46,21,25,49
SK Sturm Gra,3497,2,13,4,7,34,30,4,43
Rapid Vienna,3497,3,9,9,6,38,28,10,36
LASK Linz,3497,4,8,6,10,26,28,-2,30
Mattersburg,3497,5,6,7,11,33,43,-10,25
Vienna,3497,6,6,7,11,27,41,-14,25
SC Rheindorf,3497,7,4,8,12,18,31,-13,20
FC Salzburg,3498,1,13,8,3,45,24,21,47
SK Sturm Gra,3498,2,12,5,7,36,30,6,41
Rapid Vienna,3498,3,8,10,6,36,30,6,34
LASK Linz,3498,4,9,6,9,30,29,1,33
Vienna,3498,5,7,5,12,26,39,-13,26
SC Rheindorf,3498,6,6,6,12,20,30,-10,24
Mattersburg,3498,7,6,6,12,29,40,-11,24
FC Salzburg,3499,1,15,7,2,47,20,27,52
SK Sturm Gra,3499,2,12,4,8,32,33,-1,40
LASK Linz,3499,3,10,5,9,32,26,6,35
Rapid Vienna,3499,4,8,9,7,32,28,4,33
Vienna,3499,5,6,7,11,28,42,-14,25
Mattersburg,3499,6,6,6,12,32,40,-8,24
SC Rheindorf,3499,7,5,6,13,19,33,-14,21
FC Salzburg,3500,1,14,7,3,47,18,29,49
SK Sturm Gra,3500,2,12,6,6,31,25,6,42
Rapid Vienna,3500,3,8,9,7,36,33,3,33
LASK Linz,3500,4,7,7,10,25,28,-3,28
Mattersburg,3500,5,7,7,10,31,37,-6,28
SC Rheindorf,3500,6,6,6,12,19,30,-11,24
Vienna,3500,7,6,6,12,25,43,-18,24
FC Salzburg,3501,1,16,6,2,46,16,30,54
SK Sturm Gra,3501,2,12,4,8,30,30,0,40
Rapid Vienna,3501,3,8,9,7,33,27,6,33
LASK Linz,3501,4,8,7,9,26,27,-1,31
Mattersburg,3501,5,7,6,11,32,39,-7,27
Vienna,3501,6,6,5,13,23,41,-18,23
SC Rheindorf,3501,7,5,7,12,19,29,-10,22
FC Salzburg,3502,1,15,7,2,45,19,26,52
SK Sturm Gra,3502,2,12,4,8,31,29,2,40
Rapid Vienna,3502,3,8,12,4,36,27,9,36
LASK Linz,3502,4,8,7,9,27,27,0,31
Vienna,3502,5,7,5,12,26,39,-13,26
Mattersburg,3502,6,6,6,12,29,41,-12,24
SC Rheindorf,3502,7,5,5,14,19,31,-12,20
FC Salzburg,3503,1,14,7,3,45,17,28,49
SK Sturm Gra,3503,2,11,6,7,31,29,2,39
Rapid Vienna,3503,3,8,12,4,35,26,9,36
LASK Linz,3503,4,7,7,10,26,30,-4,28
Vienna,3503,5,7,5,12,25,40,-15,26
SC Rheindorf,3503,6,6,7,11,19,26,-7,25
Mattersburg,3503,7,6,6,12,30,43,-13,24
FC Salzburg,3504,1,13,8,3,39,16,23,47
SK Sturm Gra,3504,2,11,5,8,30,30,0,38
Rapid Vienna,3504,3,8,11,5,36,27,9,35
LASK Linz,3504,4,8,6,10,29,32,-3,30
Vienna,3504,5,8,5,11,26,37,-11,29
Mattersburg,3504,6,7,5,12,31,40,-9,26
SC Rheindorf,3504,7,6,6,12,20,29,-9,24
FC Salzburg,3505,1,14,7,3,44,19,25,49
Rapid Vienna,3505,2,11,9,4,42,27,15,42
SK Sturm Gra,3505,3,11,3,10,31,32,-1,36
LASK Linz,3505,4,8,7,9,28,29,-1,31
Vienna,3505,5,7,5,12,24,40,-16,26
SC Rheindorf,3505,6,6,6,12,19,29,-10,24
Mattersburg,3505,7,5,7,12,30,42,-12,22
FC Salzburg,3506,1,13,7,4,46,23,23,46
SK Sturm Gra,3506,2,12,4,8,35,34,1,40
LASK Linz,3506,3,9,7,8,31,25,6,34
Rapid Vienna,3506,4,7,11,6,35,32,3,32
SC Rheindorf,3506,5,7,6,11,21,27,-6,27
Vienna,3506,6,7,5,12,25,40,-15,26
Mattersburg,3506,7,6,6,12,30,42,-12,24
FC Salzburg,3507,1,15,7,2,44,17,27,52
SK Sturm Gra,3507,2,12,4,8,30,27,3,40
Rapid Vienna,3507,3,9,10,5,37,30,7,37
LASK Linz,3507,4,7,7,10,26,30,-4,28
Mattersburg,3507,5,7,6,11,34,42,-8,27
Vienna,3507,6,6,5,13,24,41,-17,23
SC Rheindorf,3507,7,5,7,12,22,30,-8,22
FC Salzburg,3508,1,13,8,3,41,18,23,47
SK Sturm Gra,3508,2,14,4,6,32,25,7,46
Rapid Vienna,3508,3,7,12,5,33,26,7,33
LASK Linz,3508,4,7,7,10,27,31,-4,28
Vienna,3508,5,7,6,11,29,41,-12,27
SC Rheindorf,3508,6,6,6,12,21,29,-8,24
Mattersburg,3508,7,5,7,12,32,45,-13,22
FC Salzburg,3509,1,15,7,2,43,17,26,52
SK Sturm Gra,3509,2,13,5,6,34,26,8,44
Rapid Vienna,3509,3,8,10,6,35,28,7,34
LASK Linz,3509,4,8,6,10,27,28,-1,30
Mattersburg,3509,5,7,5,12,32,41,-9,26
Vienna,3509,6,7,5,12,26,40,-14,26
SC Rheindorf,3509,7,4,6,14,16,33,-17,18
FC Salzburg,3510,1,14,7,3,45,19,26,49
SK Sturm Gra,3510,2,14,3,7,39,28,11,45
Rapid Vienna,3510,3,9,9,6,39,31,8,36
LASK Linz,3510,4,8,5,11,26,36,-10,29
Vienna,3510,5,7,6,11,27,39,-12,27
SC Rheindorf,3510,6,6,5,13,19,30,-11,23
Mattersburg,3510,7,6,5,13,33,45,-12,23
FC Salzburg,3511,1,14,7,3,46,20,26,49
SK Sturm Gra,3511,2,12,5,7,33,29,4,41
Rapid Vienna,3511,3,8,9,7,38,34,4,33
LASK Linz,3511,4,9,6,9,28,28,0,33
Mattersburg,3511,5,7,6,11,32,40,-8,27
Vienna,3511,6,6,7,11,26,40,-14,25
SC Rheindorf,3511,7,5,6,13,18,30,-12,21
FC Salzburg,3512,1,13,8,3,44,19,25,47
SK Sturm Gra,3512,2,13,4,7,36,28,8,43
Rapid Vienna,3512,3,8,9,7,33,32,1,33
LASK Linz,3512,4,9,6,9,26,26,0,33
Mattersburg,3512,5,7,6,11,30,39,-9,27
Vienna,3512,6,6,6,12,25,40,-15,24
SC Rheindorf,3512,7,6,5,13,21,31,-10,23
FC Salzburg,3513,1,15,7,2,46,16,30,52
SK Sturm Gra,3513,2,12,4,8,30,27,3,40
LASK Linz,3513,3,9,7,8,32,30,2,34
Rapid Vienna,3513,4,7,12,5,33,26,7,33
Mattersburg,3513,5,6,6,12,32,43,-11,24
Vienna,3513,6,6,6,12,25,44,-19,24
SC Rheindorf,3513,7,5,6,13,19,31,-12,21
FC Salzburg,3514,1,16,6,2,53,20,33,54
SK Sturm Gra,3514,2,11,5,8,34,32,2,38
LASK Linz,3514,3,9,6,9,34,30,4,33
Rapid Vienna,3514,4,7,10,7,33,37,-4,31
Mattersburg,3514,5,7,5,12,33,43,-10,26
Vienna,3514,6,7,5,12,30,46,-16,26
SC Rheindorf,3514,7,5,7,12,20,29,-9,22
FC Salzburg,3515,1,15,7,2,43,15,28,52
SK Sturm Gra,3515,2,13,3,8,32,28,4,42
Rapid Vienna,3515,3,8,10,6,37,29,8,34
LASK Linz,3515,4,9,6,9,27,27,0,33
Vienna,3515,5,7,5,12,25,39,-14,26
Mattersburg,3515,6,6,7,11,29,39,-10,25
SC Rheindorf,3515,7,4,6,14,15,31,-16,18
FC Salzburg,3516,1,14,7,3,47,20,27,49
SK Sturm Gra,3516,2,11,6,7,33,32,1,39
Rapid Vienna,3516,3,8,11,5,33,27,6,35
Mattersburg,3516,4,8,5,11,32,42,-10,29
LASK Linz,3516,5,7,7,10,27,30,-3,28
Vienna,3516,6,7,5,12,26,39,-13,26
SC Rheindorf,3516,7,6,5,13,22,30,-8,23
FC Salzburg,3517,1,14,6,4,46,18,28,48
SK Sturm Gra,3517,2,13,3,8,34,29,5,42
Rapid Vienna,3517,3,10,10,4,35,24,11,40
LASK Linz,3517,4,8,6,10,26,29,-3,30
SC Rheindorf,3517,5,6,6,12,18,27,-9,24
Mattersburg,3517,6,6,6,12,29,42,-13,24
Vienna,3517,7,6,5,13,24,43,-19,23
FC Salzburg,3518,1,15,7,2,46,17,29,52
SK Sturm Gra,3518,2,13,4,7,36,32,4,43
Rapid Vienna,3518,3,8,10,6,37,30,7,34
LASK Linz,3518,4,9,7,8,28,26,2,34
Vienna,3518,5,7,5,12,26,40,-14,26
Mattersburg,3518,6,6,6,12,29,42,-13,24
SC Rheindorf,3518,7,4,5,15,16,31,-15,17
FC Salzburg,3519,1,14,7,3,46,20,26,49
SK Sturm Gra,3519,2,11,6,7,31,28,3,39
Rapid Vienna,3519,3,9,10,5,35,27,8,37
LASK Linz,3519,4,8,8,8,27,26,1,32
Vienna,3519,5,7,5,12,29,40,-11,26
SC Rheindorf,3519,6,6,7,11,21,28,-7,25
Mattersburg,3519,7,5,5,14,28,48,-20,20
FC Salzburg,3520,1,14,7,3,45,21,24,49
SK Sturm Gra,3520,2,12,6,6,33,27,6,42
Rapid Vienna,3520,3,8,11,5,34,25,9,35
LASK Linz,3520,4,8,6,10,27,31,-4,30
Mattersburg,3520,5,6,7,11,33,42,-9,25
Vienna,3520,6,6,6,12,27,42,-15,24
SC Rheindorf,3520,7,5,7,12,18,29,-11,22
FC Salzburg,3521,1,15,7,2,45,15,30,52
SK Sturm Gra,3521,2,12,5,7,31,28,3,41
Rapid Vienna,3521,3,9,11,4,34,24,10,38
LASK Linz,3521,4,8,7,9,27,28,-1,31
Mattersburg,3521,5,6,6,12,31,43,-12,24
Vienna,3521,6,6,5,13,23,41,-18,23
SC Rheindorf,3521,7,4,7,13,17,29,-12,19
FC Salzburg,3522,1,12,8,4,41,22,19,44
SK Sturm Gra,3522,2,12,5,7,34,30,4,41
Rapid Vienna,3522,3,8,11,5,35,27,8,35
Mattersburg,3522,4,8,6,10,34,40,-6,30
LASK Linz,3522,5,7,8,9,24,27,-3,29
Vienna,3522,6,7,5,12,28,40,-12,26
SC Rheindorf,3522,7,5,7,12,21,31,-10,22
FC Salzburg,3523,1,15,7,2,51,22,29,52
SK Sturm Gra,3523,2,12,5,7,32,29,3,41
Rapid Vienna,3523,3,9,10,5,39,28,11,37
Mattersburg,3523,4,8,5,11,33,41,-8,29
LASK Linz,3523,5,7,6,11,26,31,-5,27
Vienna,3523,6,6,5,13,23,42,-19,23
SC Rheindorf,3523,7,4,8,12,18,29,-11,20
FC Salzburg,3524,1,14,7,3,43,19,24,49
SK Sturm Gra,3524,2,12,4,8,31,29,2,40
Rapid Vienna,3524,3,8,10,6,36,29,7,34
LASK Linz,3524,4,9,6,9,31,29,2,33
SC Rheindorf,3524,5,7,5,12,21,29,-8,26
Vienna,3524,6,7,5,12,25,41,-16,26
Mattersburg,3524,7,6,5,13,32,43,-11,23
FC Salzburg,3525,1,16,6,2,48,19,29,54
SK Sturm Gra,3525,2,13,3,8,35,31,4,42
Rapid Vienna,3525,3,9,10,5,37,29,8,37
LASK Linz,3525,4,8,5,11,28,31,-3,29
Mattersburg,3525,5,7,6,11,33,41,-8,27
Vienna,3525,6,6,6,12,24,39,-15,24
SC Rheindorf,3525,7,4,6,14,16,31,-15,18
FC Salzburg,3526,1,15,6,3,47,20,27,51
SK Sturm Gra,3526,2,12,4,8,32,30,2,40
Rapid Vienna,3526,3,9,10,5,38,27,11,37
Mattersburg,3526,4,8,5,11,35,40,-5,29
LASK Linz,3526,5,7,6,11,29,35,-6,27
SC Rheindorf,3526,6,6,6,12,22,33,-11,24
Vienna,3526,7,6,5,13,23,41,-18,23
FC Salzburg,3527,1,16,6,2,46,16,30,54
SK Sturm Gra,3527,2,11,3,10,29,32,-3,36
Rapid Vienna,3527,3,8,11,5,34,26,8,35
LASK Linz,3527,4,9,6,9,30,28,2,33
Mattersburg,3527,5,7,5,12,28,39,-11,26
SC Rheindorf,3527,6,6,6,12,22,30,-8,24
Vienna,3527,7,6,5,13,24,42,-18,23
FC Salzburg,3528,1,15,6,3,47,18,29,51
SK Sturm Gra,3528,2,12,5,7,33,30,3,41
Rapid Vienna,3528,3,9,11,4,37,27,10,38
LASK Linz,3528,4,7,6,11,26,32,-6,27
Mattersburg,3528,5,7,6,11,30,39,-9,27
Vienna,3528,6,6,5,13,25,43,-18,23
SC Rheindorf,3528,7,5,7,12,18,27,-9,22
FC Salzburg,3529,1,13,6,5,42,23,19,45
Rapid Vienna,3529,2,10,10,4,39,24,15,40
SK Sturm Gra,3529,3,11,4,9,31,32,-1,37
LASK Linz,3529,4,8,6,10,29,33,-4,30
Mattersburg,3529,5,7,7,10,33,39,-6,28
Vienna,3529,6,7,6,11,28,41,-13,27
SC Rheindorf,3529,7,5,7,12,18,28,-10,22
FC Salzburg,3530,1,12,7,5,39,19,20,43
SK Sturm Gra,3530,2,13,4,7,34,28,6,43
Rapid Vienna,3530,3,7,11,6,33,27,6,32
Mattersburg,3530,4,9,5,10,37,40,-3,32
LASK Linz,3530,5,9,5,10,25,30,-5,32
Vienna,3530,6,7,5,12,25,39,-14,26
SC Rheindorf,3530,7,6,5,13,20,30,-10,23
FC Salzburg,3531,1,14,7,3,47,21,26,49
SK Sturm Gra,3531,2,12,4,8,31,29,2,40
Rapid Vienna,3531,3,7,12,5,34,28,6,33
LASK Linz,3531,4,9,6,9,32,29,3,33
Vienna,3531,5,7,6,11,27,40,-13,27
Mattersburg,3531,6,6,6,12,31,44,-13,24
SC Rheindorf,3531,7,5,7,12,18,29,-11,22
FC Salzburg,3532,1,15,6,3,47,19,28,51
SK Sturm Gra,3532,2,13,4,7,33,30,3,43
Rapid Vienna,3532,3,9,10,5,36,28,8,37
LASK Linz,3532,4,7,7,10,26,29,-3,28
Mattersburg,3532,5,6,7,11,29,39,-10,25
Vienna,3532,6,6,5,13,24,40,-16,23
SC Rheindorf,3532,7,5,7,12,19,29,-10,22
FC Salzburg,3533,1,14,8,2,43,17,26,50
SK Sturm Gra,3533,2,12,6,6,33,28,5,42
Rapid Vienna,3533,3,7,12,5,34,27,7,33
LASK Linz,3533,4,8,6,10,28,33,-5,30
Mattersburg,3533,5,6,7,11,35,42,-7,25
Vienna,3533,6,6,6,12,25,41,-16,24
SC Rheindorf,3533,7,4,9,11,17,27,-10,21
FC Salzburg,3534,1,15,7,2,52,18,34,52
SK Sturm Gra,3534,2,12,4,8,33,34,-1,40
Rapid Vienna,3534,3,8,11,5,39,34,5,35
LASK Linz,3534,4,8,6,10,30,31,-1,30
SC Rheindorf,3534,5,6,6,12,24,33,-9,24
Vienna,3534,6,6,6,12,26,42,-16,24
Mattersburg,3534,7,5,8,11,27,39,-12,23
FC Salzburg,3535,1,15,6,3,52,21,31,51
SK Sturm Gra,3535,2,12,4,8,33,32,1,40
Rapid Vienna,3535,3,9,9,6,34,27,7,36
LASK Linz,3535,4,8,7,9,28,29,-1,31
Vienna,3535,5,8,5,11,28,40,-12,29
Mattersburg,3535,6,5,7,12,31,45,-14,22
SC Rheindorf,3535,7,5,6,13,21,33,-12,21
FC Salzburg,3536,1,14,7,3,44,21,23,49
Rapid Vienna,3536,2,9,10,5,40,28,12,37
SK Sturm Gra,3536,3,11,4,9,30,30,0,37
LASK Linz,3536,4,9,6,9,29,29,0,33
Vienna,3536,5,7,5,12,25,39,-14,26
Mattersburg,3536,6,6,7,11,31,40,-9,25
SC Rheindorf,3536,7,5,7,12,18,30,-12,22
FC Salzburg,3537,1,14,6,4,45,21,24,48
SK Sturm Gra,3537,2,12,4,8,31,29,2,40
Rapid Vienna,3537,3,10,9,5,38,28,10,39
LASK Linz,3537,4,9,5,10,30,30,0,32
Vienna,3537,5,8,5,11,27,37,-10,29
Mattersburg,3537,6,7,5,12,31,43,-12,26
SC Rheindorf,3537,7,4,6,14,19,33,-14,18
FC Salzburg,3538,1,14,6,4,45,19,26,48
SK Sturm Gra,3538,2,12,4,8,32,30,2,40
Rapid Vienna,3538,3,9,10,5,38,28,10,37
LASK Linz,3538,4,10,5,9,29,27,2,35
Mattersburg,3538,5,7,6,11,29,39,-10,27
Vienna,3538,6,6,6,12,25,42,-17,24
SC Rheindorf,3538,7,5,5,14,16,29,-13,20
FC Salzburg,3539,1,14,7,3,45,20,25,49
SK Sturm Gra,3539,2,11,5,8,35,35,0,38
Rapid Vienna,3539,3,8,12,4,37,27,10,36
LASK Linz,3539,4,9,6,9,28,27,1,33
Mattersburg,3539,5,7,6,11,33,39,-6,27
Vienna,3539,6,6,5,13,24,41,-17,23
SC Rheindorf,3539,7,5,7,12,20,33,-13,22
FC Salzburg,3540,1,15,6,3,50,18,32,51
SK Sturm Gra,3540,2,11,5,8,29,30,-1,38
Rapid Vienna,3540,3,9,10,5,35,26,9,37
LASK Linz,3540,4,8,6,10,26,31,-5,30
Vienna,3540,5,8,5,11,27,38,-11,29
SC Rheindorf,3540,6,5,8,11,21,28,-7,23
Mattersburg,3540,7,5,6,13,32,49,-17,21
FC Salzburg,3541,1,14,6,4,45,20,25,48
SK Sturm Gra,3541,2,13,4,7,34,29,5,43
Rapid Vienna,3541,3,10,9,5,40,28,12,39
LASK Linz,3541,4,8,6,10,29,30,-1,30
Vienna,3541,5,6,6,12,23,39,-16,24
Mattersburg,3541,6,5,8,11,26,40,-14,23
SC Rheindorf,3541,7,5,7,12,18,29,-11,22
FC Salzburg,3542,1,14,6,4,48,22,26,48
SK Sturm Gra,3542,2,13,3,8,34,31,3,42
Rapid Vienna,3542,3,10,9,5,38,28,10,39
LASK Linz,3542,4,8,7,9,28,31,-3,31
Mattersburg,3542,5,7,7,10,34,41,-7,28
Vienna,3542,6,6,5,13,25,42,-17,23
SC Rheindorf,3542,7,4,7,13,20,32,-12,19
FC Salzburg,3543,1,15,6,3,49,20,29,51
SK Sturm Gra,3543,2,12,4,8,38,33,5,40
Rapid Vienna,3543,3,8,10,6,36,29,7,34
LASK Linz,3543,4,8,5,11,26,34,-8,29
Vienna,3543,5,8,5,11,28,39,-11,29
Mattersburg,3543,6,7,5,12,34,46,-12,26
SC Rheindorf,3543,7,5,7,12,20,30,-10,22
FC Salzburg,3544,1,15,7,2,44,17,27,52
SK Sturm Gra,3544,2,12,3,9,33,30,3,39
Rapid Vienna,3544,3,9,11,4,38,25,13,38
LASK Linz,3544,4,7,7,10,25,32,-7,28
Mattersburg,3544,5,7,6,11,34,40,-6,27
Vienna,3544,6,6,5,13,25,44,-19,23
SC Rheindorf,3544,7,5,7,12,19,30,-11,22
FC Salzburg,3545,1,14,7,3,45,20,25,49
SK Sturm Gra,3545,2,12,6,6,32,26,6,42
Rapid Vienna,3545,3,9,9,6,37,29,8,36
LASK Linz,3545,4,8,6,10,27,28,-1,30
Mattersburg,3545,5,7,5,12,32,44,-12,26
SC Rheindorf,3545,6,6,6,12,21,30,-9,24
Vienna,3545,7,6,5,13,26,43,-17,23
FC Salzburg,3546,1,16,6,2,49,17,32,54
SK Sturm Gra,3546,2,12,4,8,31,30,1,40
LASK Linz,3546,3,9,6,9,27,28,-1,33
Rapid Vienna,3546,4,7,10,7,33,28,5,31
SC Rheindorf,3546,5,6,6,12,19,28,-9,24
Mattersburg,3546,6,6,6,12,29,41,-12,24
Vienna,3546,7,6,6,12,24,40,-16,24
FC Salzburg,3547,1,15,6,3,46,17,29,51
SK Sturm Gra,3547,2,12,5,7,34,32,2,41
Rapid Vienna,3547,3,8,10,6,36,28,8,34
LASK Linz,3547,4,8,5,11,26,30,-4,29
Vienna,3547,5,8,5,11,26,38,-12,29
Mattersburg,3547,6,7,5,12,32,42,-10,26
SC Rheindorf,3547,7,5,6,13,18,31,-13,21
FC Salzburg,3548,1,16,6,2,45,16,29,54
SK Sturm Gra,3548,2,11,6,7,31,28,3,39
Rapid Vienna,3548,3,8,10,6,33,25,8,34
LASK Linz,3548,4,8,6,10,26,28,-2,30
Mattersburg,3548,5,7,5,12,31,41,-10,26
SC Rheindorf,3548,6,6,6,12,19,29,-10,24
Vienna,3548,7,6,5,13,23,41,-18,23
FC Salzburg,3549,1,15,6,3,44,17,27,51
SK Sturm Gra,3549,2,13,3,8,31,29,2,42
Rapid Vienna,3549,3,9,9,6,37,27,10,36
LASK Linz,3549,4,10,6,8,31,25,6,36
Mattersburg,3549,5,6,7,11,32,44,-12,25
Vienna,3549,6,6,5,13,26,42,-16,23
SC Rheindorf,3549,7,4,6,14,18,35,-17,18
FC Salzburg,3550,1,16,6,2,44,16,28,54
SK Sturm Gra,3550,2,13,3,8,32,29,3,42
Rapid Vienna,3550,3,8,10,6,36,29,7,34
LASK Linz,3550,4,9,6,9,30,29,1,33
Mattersburg,3550,5,7,6,11,33,40,-7,27
Vienna,3550,6,6,5,13,26,44,-18,23
SC Rheindorf,3550,7,4,6,14,17,31,-14,18
FC Salzburg,3551,1,14,8,2,44,18,26,50
SK Sturm Gra,3551,2,12,5,7,32,29,3,41
LASK Linz,3551,3,9,7,8,31,28,3,34
Rapid Vienna,3551,4,7,11,6,35,29,6,32
Mattersburg,3551,5,7,6,11,33,42,-9,27
Vienna,3551,6,6,6,12,24,40,-16,24
SC Rheindorf,3551,7,4,7,13,21,34,-13,19
FC Salzburg,3552,1,14,6,4,45,21,24,48
Rapid Vienna,3552,2,10,10,4,38,23,15,40
SK Sturm Gra,3552,3,12,4,8,30,30,0,40
LASK Linz,3552,4,9,5,10,26,26,0,32
Vienna,3552,5,8,5,11,29,38,-9,29
Mattersburg,3552,6,6,5,13,29,46,-17,23
SC Rheindorf,3552,7,5,5,14,19,32,-13,20
FC Salzburg,3553,1,13,7,4,40,19,21,46
SK Sturm Gra,3553,2,14,3,7,35,27,8,45
LASK Linz,3553,3,10,5,9,27,26,1,35
Rapid Vienna,3553,4,8,9,7,33,27,6,33
Vienna,3553,5,7,6,11,26,38,-12,27
Mattersburg,3553,6,6,7,11,31,39,-8,25
SC Rheindorf,3553,7,5,5,14,16,32,-16,20
FC Salzburg,3554,1,14,7,3,42,19,23,49
SK Sturm Gra,3554,2,12,4,8,30,27,3,40
LASK Linz,3554,3,9,6,9,27,27,0,33
Rapid Vienna,3554,4,7,11,6,36,30,6,32
Mattersburg,3554,5,8,6,10,34,39,-5,30
Vienna,3554,6,6,6,12,25,41,-16,24
SC Rheindorf,3554,7,4,8,12,20,31,-11,20
FC Salzburg,3555,1,15,7,2,46,16,30,52
SK Sturm Gra,3555,2,13,5,6,32,25,7,44
Rapid Vienna,3555,3,8,10,6,33,28,5,34
LASK Linz,3555,4,9,6,9,29,27,2,33
Mattersburg,3555,5,7,6,11,29,41,-12,27
Vienna,3555,6,6,5,13,23,40,-17,23
SC Rheindorf,3555,7,4,5,15,17,32,-15,17
FC Salzburg,3556,1,15,7,2,45,17,28,52
SK Sturm Gra,3556,2,12,4,8,32,30,2,40
Rapid Vienna,3556,3,9,9,6,37,30,7,36
LASK Linz,3556,4,8,5,11,27,31,-4,29
Mattersburg,3556,5,6,7,11,30,42,-12,25
SC Rheindorf,3556,6,6,6,12,22,28,-6,24
Vienna,3556,7,6,6,12,23,38,-15,24
FC Salzburg,3557,1,14,6,4,48,23,25,48
SK Sturm Gra,3557,2,11,6,7,30,29,1,39
LASK Linz,3557,3,9,6,9,28,25,3,33
Rapid Vienna,3557,4,7,10,7,35,34,1,31
Vienna,3557,5,8,5,11,30,40,-10,29
Mattersburg,3557,6,7,5,12,31,41,-10,26
SC Rheindorf,3557,7,6,6,12,17,27,-10,24
FC Salzburg,3558,1,14,7,3,46,20,26,49
SK Sturm Gra,3558,2,12,4,8,31,28,3,40
Rapid Vienna,3558,3,9,10,5,38,29,9,37
LASK Linz,3558,4,8,6,10,28,30,-2,30
SC Rheindorf,3558,5,7,6,11,21,28,-7,27
Vienna,3558,6,7,6,11,28,40,-12,27
Mattersburg,3558,7,5,5,14,31,48,-17,20
FC Salzburg,3559,1,14,7,3,45,21,24,49
SK Sturm Gra,3559,2,14,3,7,36,28,8,45
Rapid Vienna,3559,3,7,9,8,31,29,2,30
LASK Linz,3559,4,8,5,11,26,30,-4,29
Vienna,3559,5,7,6,11,25,38,-13,27
SC Rheindorf,3559,6,7,5,12,20,27,-7,26
Mattersburg,3559,7,7,5,12,31,41,-10,26
FC Salzburg,3560,1,14,8,2,44,18,26,50
SK Sturm Gra,3560,2,13,3,8,35,31,4,42
Rapid Vienna,3560,3,9,10,5,37,26,11,37
SC Rheindorf,3560,4,7,5,12,23,29,-6,26
LASK Linz,3560,5,7,5,12,26,34,-8,26
Vienna,3560,6,7,5,12,24,38,-14,26
Mattersburg,3560,7,6,6,12,29,42,-13,24
FC Salzburg,3561,1,14,6,4,44,21,23,48
SK Sturm Gra,3561,2,14,3,7,34,27,7,45
Rapid Vienna,3561,3,9,10,5,34,27,7,37
LASK Linz,3561,4,7,6,11,25,30,-5,27
Vienna,3561,5,7,6,11,27,38,-11,27
Mattersburg,3561,6,6,6,12,30,41,-11,24
SC Rheindorf,3561,7,6,5,13,18,28,-10,23
FC Salzburg,3562,1,13,9,2,44,20,24,48
SK Sturm Gra,3562,2,13,4,7,34,28,6,43
LASK Linz,3562,3,10,6,8,31,26,5,36
Rapid Vienna,3562,4,8,10,6,36,28,8,34
Vienna,3562,5,7,6,11,29,40,-11,27
Mattersburg,3562,6,6,5,13,30,44,-14,23
SC Rheindorf,3562,7,4,6,14,16,34,-18,18
FC Salzburg,3563,1,15,6,3,47,21,26,51
SK Sturm Gra,3563,2,13,4,7,35,30,5,43
Rapid Vienna,3563,3,9,9,6,36,28,8,36
LASK Linz,3563,4,9,6,9,27,26,1,33
Mattersburg,3563,5,7,5,12,34,41,-7,26
Vienna,3563,6,6,5,13,24,43,-19,23
SC Rheindorf,3563,7,4,7,13,17,31,-14,19
FC Salzburg,3564,1,15,7,2,45,16,29,52
SK Sturm Gra,3564,2,12,4,8,34,31,3,40
LASK Linz,3564,3,10,6,8,30,27,3,36
Rapid Vienna,3564,4,7,9,8,33,32,1,30
Vienna,3564,5,6,7,11,24,38,-14,25
SC Rheindorf,3564,6,6,6,12,20,28,-8,24
Mattersburg,3564,7,5,7,12,28,42,-14,22
FC Salzburg,3565,1,14,8,2,42,16,26,50
SK Sturm Gra,3565,2,13,5,6,35,29,6,44
Rapid Vienna,3565,3,7,11,6,34,29,5,32
LASK Linz,3565,4,8,7,9,27,30,-3,31
Mattersburg,3565,5,7,5,12,31,39,-8,26
Vienna,3565,6,7,5,12,24,39,-15,26
SC Rheindorf,3565,7,5,5,14,18,29,-11,20
FC Salzburg,3566,1,14,6,4,43,20,23,48
SK Sturm Gra,3566,2,12,4,8,30,28,2,40
Rapid Vienna,3566,3,9,9,6,36,27,9,36
LASK Linz,3566,4,9,6,9,28,28,0,33
Vienna,3566,5,7,6,11,27,40,-13,27
Mattersburg,3566,6,6,7,11,34,44,-10,25
SC Rheindorf,3566,7,5,6,13,20,31,-11,21
FC Salzburg,3567,1,14,8,2,47,18,29,50
SK Sturm Gra,3567,2,14,3,7,35,30,5,45
LASK Linz,3567,3,10,5,9,30,25,5,35
Rapid Vienna,3567,4,7,10,7,31,32,-1,31
Mattersburg,3567,5,6,7,11,32,41,-9,25
Vienna,3567,6,6,6,12,26,41,-15,24
SC Rheindorf,3567,7,5,5,14,18,32,-14,20
FC Salzburg,3568,1,14,7,3,45,19,26,49
SK Sturm Gra,3568,2,11,6,7,32,30,2,39
Rapid Vienna,3568,3,8,12,4,36,26,10,36
LASK Linz,3568,4,7,7,10,25,28,-3,28
Mattersburg,3568,5,7,5,12,32,39,-7,26
Vienna,3568,6,7,5,12,26,44,-18,26
SC Rheindorf,3568,7,6,6,12,19,29,-10,24
FC Salzburg,3569,1,15,6,3,54,21,33,51
SK Sturm Gra,3569,2,12,4,8,32,31,1,40
LASK Linz,3569,3,9,5,10,28,29,-1,32
Rapid Vienna,3569,4,7,10,7,32,29,3,31
Mattersburg,3569,5,8,6,10,35,39,-4,30
SC Rheindorf,3569,6,6,6,12,20,30,-10,24
Vienna,3569,7,6,5,13,24,46,-22,23
FC Salzburg,3570,1,15,6,3,44,17,27,51
SK Sturm Gra,3570,2,12,3,9,31,29,2,39
Rapid Vienna,3570,3,9,9,6,37,29,8,36
LASK Linz,3570,4,8,5,11,25,29,-4,29
SC Rheindorf,3570,5,7,6,11,21,27,-6,27
Mattersburg,3570,6,6,7,11,30,41,-11,25
Vienna,3570,7,6,6,12,24,40,-16,24
FC Salzburg,3571,1,15,7,2,48,17,31,52
SK Sturm Gra,3571,2,12,4,8,31,31,0,40
LASK Linz,3571,3,10,6,8,31,26,5,36
Rapid Vienna,3571,4,7,10,7,35,32,3,31
SC Rheindorf,3571,5,6,7,11,20,28,-8,25
Mattersburg,3571,6,6,5,13,29,43,-14,23
Vienna,3571,7,6,5,13,24,41,-17,23
FC Salzburg,3572,1,14,8,2,44,19,25,50
SK Sturm Gra,3572,2,11,6,7,31,29,2,39
Rapid Vienna,3572,3,8,11,5,35,27,8,35
LASK Linz,3572,4,8,8,8,26,26,0,32
Vienna,3572,5,7,5,12,27,41,-14,26
SC Rheindorf,3572,6,6,6,12,20,27,-7,24
Mattersburg,3572,7,5,6,13,31,45,-14,21
FC Salzburg,3573,1,15,7,2,49,17,32,52
SK Sturm Gra,3573,2,14,3,7,34,28,6,45
Rapid Vienna,3573,3,8,10,6,33,28,5,34
LASK Linz,3573,4,9,5,10,27,28,-1,32
Vienna,3573,5,6,6,12,27,46,-19,24
SC Rheindorf,3573,6,6,5,13,19,29,-10,23
Mattersburg,3573,7,5,6,13,32,45,-13,21
FC Salzburg,3574,1,14,7,3,46,21,25,49
Rapid Vienna,3574,2,9,10,5,36,25,11,37
SK Sturm Gra,3574,3,11,3,10,31,35,-4,36
LASK Linz,3574,4,9,5,10,30,30,0,32
Vienna,3574,5,7,6,11,26,37,-11,27
Mattersburg,3574,6,7,5,12,34,45,-11,26
SC Rheindorf,3574,7,6,6,12,17,27,-10,24
FC Salzburg,3575,1,15,6,3,48,20,28,51
SK Sturm Gra,3575,2,12,5,7,35,32,3,41
Rapid Vienna,3575,3,8,10,6,35,30,5,34
LASK Linz,3575,4,8,8,8,30,30,0,32
Mattersburg,3575,5,8,5,11,36,43,-7,29
Vienna,3575,6,6,5,13,25,41,-16,23
SC Rheindorf,3575,7,4,7,13,19,32,-13,19
FC Salzburg,3576,1,14,7,3,45,18,27,49
SK Sturm Gra,3576,2,13,3,8,37,30,7,42
Rapid Vienna,3576,3,9,9,6,38,30,8,36
LASK Linz,3576,4,9,6,9,26,27,-1,33
SC Rheindorf,3576,5,6,6,12,18,30,-12,24
Vienna,3576,6,6,6,12,24,41,-17,24
Mattersburg,3576,7,5,7,12,28,40,-12,22
FC Salzburg,3577,1,15,7,2,46,19,27,52
SK Sturm Gra,3577,2,11,6,7,32,29,3,39
Rapid Vienna,3577,3,8,11,5,38,29,9,35
LASK Linz,3577,4,8,8,8,29,29,0,32
Mattersburg,3577,5,7,5,12,32,43,-11,26
Vienna,3577,6,6,6,12,27,42,-15,24
SC Rheindorf,3577,7,4,7,13,17,30,-13,19
FC Salzburg,3578,1,16,6,2,53,18,35,54
SK Sturm Gra,3578,2,12,4,8,30,30,0,40
LASK Linz,3578,3,9,6,9,28,27,1,33
Rapid Vienna,3578,4,7,11,6,34,31,3,32
Mattersburg,3578,5,6,6,12,31,44,-13,24
Vienna,3578,6,6,6,12,25,41,-16,24
SC Rheindorf,3578,7,5,7,12,19,29,-10,22
FC Salzburg,3579,1,16,6,2,48,17,31,54
SK Sturm Gra,3579,2,13,4,7,34,29,5,43
Rapid Vienna,3579,3,8,11,5,37,29,8,35
LASK Linz,3579,4,7,6,11,26,32,-6,27
Vienna,3579,5,7,5,12,24,39,-15,26
Mattersburg,3579,6,6,6,12,30,42,-12,24
SC Rheindorf,3579,7,4,8,12,18,29,-11,20
FC Salzburg,3580,1,13,8,3,41,18,23,47
SK Sturm Gra,3580,2,12,4,8,33,28,5,40
LASK Linz,3580,3,10,6,8,28,25,3,36
Rapid Vienna,3580,4,7,10,7,31,29,2,31
Mattersburg,3580,5,7,7,10,33,41,-8,28
SC Rheindorf,3580,6,6,6,12,20,29,-9,24
Vienna,3580,7,6,5,13,25,41,-16,23
FC Salzburg,3581,1,15,6,3,45,17,28,51
Rapid Vienna,3581,2,9,10,5,34,24,10,37
SK Sturm Gra,3581,3,11,4,9,30,32,-2,37
LASK Linz,3581,4,8,6,10,25,27,-2,30
SC Rheindorf,3581,5,7,6,11,19,26,-7,27
Mattersburg,3581,6,6,6,12,29,40,-11,24
Vienna,3581,7,6,6,12,24,40,-16,24
FC Salzburg,3582,1,15,7,2,49,18,31,52
SK Sturm Gra,3582,2,12,5,7,32,29,3,41
Rapid Vienna,3582,3,7,12,5,33,29,4,33
LASK Linz,3582,4,8,8,8,30,29,1,32
Vienna,3582,5,7,6,11,27,38,-11,27
SC Rheindorf,3582,6,5,7,12,19,30,-11,22
Mattersburg,3582,7,5,5,14,30,47,-17,20
FC Salzburg,3583,1,14,7,3,44,17,27,49
SK Sturm Gra,3583,2,13,4,7,34,26,8,43
Rapid Vienna,3583,3,9,10,5,35,28,7,37
LASK Linz,3583,4,10,6,8,29,27,2,36
Vienna,3583,5,6,5,13,25,41,-16,23
Mattersburg,3583,6,6,5,13,30,48,-18,23
SC Rheindorf,3583,7,5,5,14,21,31,-10,20
FC Salzburg,3584,1,16,6,2,52,18,34,54
SK Sturm Gra,3584,2,12,4,8,30,32,-2,40
Rapid Vienna,3584,3,8,11,5,39,29,10,35
LASK Linz,3584,4,8,7,9,28,28,0,31
Vienna,3584,5,7,5,12,28,41,-13,26
Mattersburg,3584,6,6,5,13,31,49,-18,23
SC Rheindorf,3584,7,5,6,13,21,32,-11,21
FC Salzburg,3585,1,13,8,3,41,17,24,47
SK Sturm Gra,3585,2,13,4,7,35,29,6,43
Rapid Vienna,3585,3,9,9,6,35,31,4,36
LASK Linz,3585,4,9,5,10,31,29,2,32
Mattersburg,3585,5,7,6,11,32,42,-10,27
Vienna,3585,6,7,5,12,27,41,-14,26
SC Rheindorf,3585,7,5,5,14,19,31,-12,20
FC Salzburg,3586,1,14,7,3,44,20,24,49
SK Sturm Gra,3586,2,12,3,9,30,32,-2,39
Rapid Vienna,3586,3,9,10,5,36,26,10,37
LASK Linz,3586,4,8,7,9,32,29,3,31
Mattersburg,3586,5,6,8,10,33,42,-9,26
Vienna,3586,6,6,7,11,25,39,-14,25
SC Rheindorf,3586,7,4,8,12,18,30,-12,20
FC Salzburg,3587,1,13,6,5,42,21,21,45
SK Sturm Gra,3587,2,13,4,7,32,28,4,43
Rapid Vienna,3587,3,8,10,6,37,32,5,34
LASK Linz,3587,4,9,5,10,30,30,0,32
SC Rheindorf,3587,5,8,5,11,26,30,-4,29
Vienna,3587,6,7,5,12,25,39,-14,26
Mattersburg,3587,7,6,5,13,32,44,-12,23
FC Salzburg,3588,1,15,7,2,47,17,30,52
SK Sturm Gra,3588,2,11,5,8,30,32,-2,38
LASK Linz,3588,3,10,6,8,28,24,4,36
Rapid Vienna,3588,4,8,9,7,33,27,6,33
SC Rheindorf,3588,5,7,5,12,23,27,-4,26
Vienna,3588,6,7,5,12,24,38,-14,26
Mattersburg,3588,7,5,5,14,27,47,-20,20
FC Salzburg,3589,1,14,7,3,44,19,25,49
SK Sturm Gra,3589,2,14,4,6,36,27,9,46
Rapid Vienna,3589,3,8,10,6,34,27,7,34
LASK Linz,3589,4,7,7,10,27,33,-6,28
Mattersburg,3589,5,7,5,12,30,39,-9,26
Vienna,3589,6,7,5,12,25,40,-15,26
SC Rheindorf,3589,7,5,6,13,18,29,-11,21
FC Salzburg,3590,1,13,7,4,43,21,22,46
SK Sturm Gra,3590,2,13,4,7,35,30,5,43
Rapid Vienna,3590,3,9,11,4,35,25,10,38
LASK Linz,3590,4,8,5,11,26,30,-4,29
Vienna,3590,5,8,5,11,28,40,-12,29
Mattersburg,3590,6,6,5,13,30,41,-11,23
SC Rheindorf,3590,7,5,7,12,21,31,-10,22
FC Salzburg,3591,1,15,6,3,46,17,29,51
SK Sturm Gra,3591,2,13,4,7,34,31,3,43
Rapid Vienna,3591,3,9,9,6,37,29,8,36
LASK Linz,3591,4,7,8,9,26,29,-3,29
Vienna,3591,5,8,5,11,28,38,-10,29
SC Rheindorf,3591,6,5,6,13,19,29,-10,21
Mattersburg,3591,7,5,6,13,28,45,-17,21
FC Salzburg,3592,1,15,6,3,45,19,26,51
SK Sturm Gra,3592,2,11,4,9,32,34,-2,37
Rapid Vienna,3592,3,8,11,5,35,27,8,35
LASK Linz,3592,4,9,5,10,27,30,-3,32
Mattersburg,3592,5,7,6,11,33,40,-7,27
SC Rheindorf,3592,6,6,7,11,24,28,-4,25
Vienna,3592,7,6,5,13,24,42,-18,23
FC Salzburg,3593,1,15,7,2,45,18,27,52
SK Sturm Gra,3593,2,12,3,9,29,30,-1,39
Rapid Vienna,3593,3,8,10,6,33,26,7,34
LASK Linz,3593,4,9,7,8,30,27,3,34
Mattersburg,3593,5,7,5,12,30,40,-10,26
Vienna,3593,6,6,6,12,24,39,-15,24
SC Rheindorf,3593,7,5,6,13,18,29,-11,21
FC Salzburg,3594,1,16,6,2,50,17,33,54
SK Sturm Gra,3594,2,13,3,8,34,29,5,42
LASK Linz,3594,3,9,7,8,31,29,2,34
Rapid Vienna,3594,4,7,10,7,31,27,4,31
Mattersburg,3594,5,6,7,11,30,41,-11,25
Vienna,3594,6,6,6,12,23,43,-20,24
SC Rheindorf,3594,7,5,5,14,19,32,-13,20
FC Salzburg,3595,1,15,7,2,47,17,30,52
SK Sturm Gra,3595,2,12,4,8,31,29,2,40
Rapid Vienna,3595,3,8,10,6,37,30,7,34
LASK Linz,3595,4,9,6,9,30,30,0,33
Vienna,3595,5,7,5,12,26,42,-16,26
Mattersburg,3595,6,6,6,12,34,44,-10,24
SC Rheindorf,3595,7,5,6,13,18,31,-13,21
FC Salzburg,3596,1,14,6,4,44,21,23,48
SK Sturm Gra,3596,2,13,3,8,34,31,3,42
Rapid Vienna,3596,3,9,10,5,37,28,9,37
LASK Linz,3596,4,8,6,10,29,31,-2,30
Vienna,3596,5,8,5,11,27,37,-10,29
SC Rheindorf,3596,6,7,5,12,22,29,-7,26
Mattersburg,3596,7,5,5,14,29,45,-16,20
FC Salzburg,3597,1,15,6,3,44,19,25,51
Rapid Vienna,3597,2,9,11,4,42,31,11,38
SK Sturm Gra,3597,3,11,5,8,35,34,1,38
LASK Linz,3597,4,7,7,10,28,31,-3,28
Vienna,3597,5,7,5,12,25,38,-13,26
SC Rheindorf,3597,6,6,6,12,21,29,-8,24
Mattersburg,3597,7,6,6,12,30,43,-13,24
FC Salzburg,3598,1,16,6,2,49,19,30,54
SK Sturm Gra,3598,2,12,4,8,33,32,1,40
LASK Linz,3598,3,9,6,9,30,31,-1,33
Rapid Vienna,3598,4,7,11,6,33,28,5,32
Mattersburg,3598,5,7,5,12,34,43,-9,26
Vienna,3598,6,7,5,12,27,40,-13,26
SC Rheindorf,3598,7,4,7,13,17,30,-13,19
FC Salzburg,3599,1,13,8,3,44,20,24,47
SK Sturm Gra,3599,2,12,5,7,33,29,4,41
Rapid Vienna,3599,3,9,9,6,35,29,6,36
LASK Linz,3599,4,9,6,9,26,26,0,33
Vienna,3599,5,7,6,11,24,37,-13,27
Mattersburg,3599,6,6,5,13,28,41,-13,23
SC Rheindorf,3599,7,5,7,12,20,28,-8,22
FC Salzburg,3600,1,14,8,2,46,18,28,50
Rapid Vienna,3600,2,10,10,4,38,27,11,40
SK Sturm Gra,3600,3,11,3,10,31,31,0,36
LASK Linz,3600,4,9,6,9,32,31,1,33
Mattersburg,3600,5,6,8,10,31,40,-9,26
Vienna,3600,6,6,6,12,24,42,-18,24
SC Rheindorf,3600,7,5,5,14,17,30,-13,20
FC Salzburg,3601,1,13,8,3,42,20,22,47
SK Sturm Gra,3601,2,14,4,6,32,24,8,46
Rapid Vienna,3601,3,8,11,5,37,28,9,35
LASK Linz,3601,4,7,6,11,27,32,-5,27
Vienna,3601,5,7,6,11,29,39,-10,27
Mattersburg,3601,6,7,5,12,34,46,-12,26
SC Rheindorf,3601,7,5,6,13,19,31,-12,21
FC Salzburg,3602,1,15,6,3,48,16,32,51
SK Sturm Gra,3602,2,12,5,7,33,30,3,41
Rapid Vienna,3602,3,9,10,5,36,25,11,37
LASK Linz,3602,4,9,5,10,26,27,-1,32
Vienna,3602,5,7,5,12,25,40,-15,26
Mattersburg,3602,6,6,5,13,28,45,-17,23
SC Rheindorf,3602,7,5,6,13,19,32,-13,21
FC Salzburg,3603,1,14,7,3,47,17,30,49
SK Sturm Gra,3603,2,12,3,9,32,32,0,39
Rapid Vienna,3603,3,8,10,6,33,27,6,34
LASK Linz,3603,4,9,6,9,26,26,0,33
Vienna,3603,5,8,5,11,26,37,-11,29
Mattersburg,3603,6,6,6,12,29,44,-15,24
SC Rheindorf,3603,7,6,5,13,20,30,-10,23
FC Salzburg,3604,1,15,6,3,44,17,27,51
SK Sturm Gra,3604,2,13,4,7,32,29,3,43
Rapid Vienna,3604,3,8,10,6,34,28,6,34
LASK Linz,3604,4,8,6,10,28,29,-1,30
SC Rheindorf,3604,5,6,7,11,22,28,-6,25
Vienna,3604,6,6,6,12,28,44,-16,24
Mattersburg,3604,7,5,7,12,32,45,-13,22
FC Salzburg,3605,1,14,7,3,48,20,28,49
SK Sturm Gra,3605,2,13,4,7,32,26,6,43
Rapid Vienna,3605,3,8,11,5,36,28,8,35
LASK Linz,3605,4,7,7,10,25,28,-3,28
Mattersburg,3605,5,7,6,11,30,44,-14,27
SC Rheindorf,3605,6,5,8,11,19,28,-9,23
Vienna,3605,7,6,5,13,25,41,-16,23
FC Salzburg,3606,1,15,7,2,45,19,26,52
SK Sturm Gra,3606,2,12,3,9,29,28,1,39
LASK Linz,3606,3,10,5,9,28,29,-1,35
Rapid Vienna,3606,4,8,10,6,35,28,7,34
Vienna,3606,5,7,5,12,27,41,-14,26
SC Rheindorf,3606,6,6,6,12,24,29,-5,24
Mattersburg,3606,7,5,6,13,32,46,-14,21
FC Salzburg,3607,1,15,7,2,44,15,29,52
SK Sturm Gra,3607,2,12,5,7,31,28,3,41
Rapid Vienna,3607,3,8,11,5,35,26,9,35
LASK Linz,3607,4,8,7,9,26,27,-1,31
Mattersburg,3607,5,7,5,12,31,39,-8,26
Vienna,3607,6,7,5,12,25,41,-16,26
SC Rheindorf,3607,7,4,6,14,15,31,-16,18
FC Salzburg,3608,1,13,6,5,43,20,23,45
Rapid Vienna,3608,2,10,9,5,36,28,8,39
SK Sturm Gra,3608,3,12,3,9,31,31,0,39
LASK Linz,3608,4,9,6,9,27,26,1,33
Mattersburg,3608,5,8,5,11,33,41,-8,29
Vienna,3608,6,7,5,12,27,40,-13,26
SC Rheindorf,3608,7,5,6,13,19,30,-11,21
FC Salzburg,3609,1,14,6,4,45,19,26,48
Rapid Vienna,3609,2,10,9,5,37,26,11,39
SK Sturm Gra,3609,3,12,3,9,30,30,0,39
LASK Linz,3609,4,9,5,10,28,28,0,32
Mattersburg,3609,5,9,5,10,34,37,-3,32
Vienna,3609,6,6,5,13,24,42,-18,23
SC Rheindorf,3609,7,5,5,14,17,33,-16,20
FC Salzburg,3610,1,14,7,3,45,21,24,49
SK Sturm Gra,3610,2,13,4,7,32,28,4,43
Rapid Vienna,3610,3,8,10,6,37,28,9,34
LASK Linz,3610,4,7,6,11,23,29,-6,27
Vienna,3610,5,7,6,11,28,39,-11,27
Mattersburg,3610,6,6,7,11,29,41,-12,25
SC Rheindorf,3610,7,6,6,12,22,30,-8,24
FC Salzburg,3611,1,14,7,3,47,19,28,49
SK Sturm Gra,3611,2,15,3,6,37,25,12,48
Rapid Vienna,3611,3,9,10,5,36,28,8,37
LASK Linz,3611,4,8,5,11,26,31,-5,29
Mattersburg,3611,5,6,7,11,28,41,-13,25
Vienna,3611,6,6,6,12,25,41,-16,24
SC Rheindorf,3611,7,4,6,14,15,29,-14,18
FC Salzburg,3612,1,16,6,2,49,16,33,54
SK Sturm Gra,3612,2,12,3,9,33,32,1,39
Rapid Vienna,3612,3,9,10,5,37,31,6,37
LASK Linz,3612,4,8,6,10,29,31,-2,30
Vienna,3612,5,7,5,12,25,39,-14,26
SC Rheindorf,3612,6,6,5,13,19,30,-11,23
Mattersburg,3612,7,6,5,13,30,43,-13,23
FC Salzburg,3613,1,14,8,2,41,15,26,50
SK Sturm Gra,3613,2,12,5,7,31,26,5,41
Rapid Vienna,3613,3,8,10,6,36,26,10,34
LASK Linz,3613,4,8,6,10,24,28,-4,30
Mattersburg,3613,5,6,7,11,30,39,-9,25
SC Rheindorf,3613,6,6,6,12,17,29,-12,24
Vienna,3613,7,6,6,12,25,41,-16,24
FC Salzburg,3614,1,15,7,2,47,19,28,52
SK Sturm Gra,3614,2,12,4,8,34,30,4,40
Rapid Vienna,3614,3,7,11,6,34,30,4,32
LASK Linz,3614,4,8,8,8,30,30,0,32
Vienna,3614,5,7,5,12,26,41,-15,26
Mattersburg,3614,6,6,6,12,30,42,-12,24
SC Rheindorf,3614,7,6,5,13,21,30,-9,23
FC Salzburg,3615,1,15,7,2,43,15,28,52
SK Sturm Gra,3615,2,11,5,8,31,31,0,38
LASK Linz,3615,3,10,6,8,31,28,3,36
Rapid Vienna,3615,4,8,10,6,34,28,6,34
Vienna,3615,5,7,5,12,24,38,-14,26
SC Rheindorf,3615,6,5,7,12,20,30,-10,22
Mattersburg,3615,7,5,6,13,28,41,-13,21
FC Salzburg,3616,1,15,7,2,46,19,27,52
SK Sturm Gra,3616,2,12,5,7,30,26,4,41
Rapid Vienna,3616,3,8,11,5,33,25,8,35
LASK Linz,3616,4,8,7,9,25,27,-2,31
Vienna,3616,5,6,7,11,27,41,-14,25
Mattersburg,3616,6,6,6,12,30,41,-11,24
SC Rheindorf,3616,7,4,7,13,16,28,-12,19
FC Salzburg,3617,1,14,6,4,44,21,23,48
SK Sturm Gra,3617,2,13,3,8,32,30,2,42
Rapid Vienna,3617,3,10,10,4,40,26,14,40
LASK Linz,3617,4,8,6,10,28,32,-4,30
Vienna,3617,5,8,5,11,30,39,-9,29
SC Rheindorf,3617,6,6,5,13,22,31,-9,23
Mattersburg,3617,7,5,5,14,31,48,-17,20
FC Salzburg,3618,1,15,7,2,47,18,29,52
SK Sturm Gra,3618,2,12,5,7,31,27,4,41
LASK Linz,3618,3,9,7,8,30,25,5,34
Rapid Vienna,3618,4,8,9,7,32,29,3,33
Mattersburg,3618,5,7,5,12,29,43,-14,26
Vienna,3618,6,6,6,12,25,40,-15,24
SC Rheindorf,3618,7,4,7,13,17,29,-12,19
FC Salzburg,3619,1,14,6,4,46,21,25,48
SK Sturm Gra,3619,2,13,5,6,36,28,8,44
Rapid Vienna,3619,3,9,11,4,39,28,11,38
LASK Linz,3619,4,8,6,10,30,35,-5,30
Mattersburg,3619,5,7,5,12,35,45,-10,26
Vienna,3619,6,6,5,13,23,42,-19,23
SC Rheindorf,3619,7,5,6,13,18,28,-10,21
FC Salzburg,3620,1,13,7,4,45,21,24,46
Rapid Vienna,3620,2,10,10,4,39,26,13,40
SK Sturm Gra,3620,3,11,6,7,34,31,3,39
LASK Linz,3620,4,9,5,10,27,28,-1,32
Vienna,3620,5,8,5,11,27,37,-10,29
Mattersburg,3620,6,6,5,13,31,45,-14,23
SC Rheindorf,3620,7,5,6,13,21,36,-15,21
FC Salzburg,3621,1,15,7,2,48,18,30,52
SK Sturm Gra,3621,2,13,4,7,30,26,4,43
Rapid Vienna,3621,3,9,10,5,37,26,11,37
LASK Linz,3621,4,8,6,10,27,28,-1,30
Mattersburg,3621,5,6,7,11,30,42,-12,25
Vienna,3621,6,6,5,13,24,43,-19,23
SC Rheindorf,3621,7,4,7,13,17,30,-13,19
FC Salzburg,3622,1,15,6,3,45,18,27,51
SK Sturm Gra,3622,2,12,4,8,32,30,2,40
LASK Linz,3622,3,10,6,8,34,26,8,36
Rapid Vienna,3622,4,9,9,6,37,31,6,36
Mattersburg,3622,5,6,6,12,29,44,-15,24
Vienna,3622,6,6,6,12,24,39,-15,24
SC Rheindorf,3622,7,5,5,14,20,33,-13,20
FC Salzburg,3623,1,15,6,3,46,18,28,51
SK Sturm Gra,3623,2,13,3,8,33,28,5,42
Rapid Vienna,3623,3,9,9,6,35,29,6,36
LASK Linz,3623,4,8,7,9,26,28,-2,31
Vienna,3623,5,7,5,12,25,39,-14,26
Mattersburg,3623,6,6,6,12,28,41,-13,24
SC Rheindorf,3623,7,5,6,13,19,29,-10,21
FC Salzburg,3624,1,14,7,3,46,21,25,49
SK Sturm Gra,3624,2,13,4,7,35,30,5,43
Rapid Vienna,3624,3,9,10,5,37,28,9,37
LASK Linz,3624,4,8,5,11,29,33,-4,29
Vienna,3624,5,7,6,11,27,40,-13,27
Mattersburg,3624,6,6,5,13,32,43,-11,23
SC Rheindorf,3624,7,5,7,12,18,29,-11,22
FC Salzburg,3625,1,15,6,3,45,18,27,51
SK Sturm Gra,3625,2,13,4,7,34,29,5,43
Rapid Vienna,3625,3,8,10,6,36,31,5,34
LASK Linz,3625,4,9,5,10,28,29,-1,32
Vienna,3625,5,8,5,11,30,37,-7,29
SC Rheindorf,3625,6,6,5,13,21,29,-8,23
Mattersburg,3625,7,5,5,14,27,48,-21,20
FC Salzburg,3626,1,15,6,3,49,19,30,51
SK Sturm Gra,3626,2,13,3,8,32,29,3,42
LASK Linz,3626,3,10,6,8,31,28,3,36
Rapid Vienna,3626,4,7,11,6,33,28,5,32
Mattersburg,3626,5,6,6,12,33,48,-15,24
Vienna,3626,6,6,5,13,25,42,-17,23
SC Rheindorf,3626,7,5,7,12,22,31,-9,22
FC Salzburg,3627,1,15,7,2,46,18,28,52
SK Sturm Gra,3627,2,11,4,9,30,30,0,37
Rapid Vienna,3627,3,9,9,6,36,29,7,36
LASK Linz,3627,4,8,7,9,28,29,-1,31
Mattersburg,3627,5,8,5,11,34,41,-7,29
Vienna,3627,6,6,6,12,24,39,-15,24
SC Rheindorf,3627,7,5,6,13,20,32,-12,21
FC Salzburg,3628,1,16,6,2,49,19,30,54
SK Sturm Gra,3628,2,14,3,7,32,28,4,45
Rapid Vienna,3628,3,8,9,7,34,27,7,33
LASK Linz,3628,4,9,6,9,28,28,0,33
Vienna,3628,5,7,5,12,26,40,-14,26
Mattersburg,3628,6,6,6,12,30,42,-12,24
SC Rheindorf,3628,7,4,5,15,17,32,-15,17
FC Salzburg,3629,1,15,7,2,45,18,27,52
SK Sturm Gra,3629,2,13,4,7,34,26,8,43
Rapid Vienna,3629,3,9,10,5,35,26,9,37
LASK Linz,3629,4,7,5,12,25,33,-8,26
Mattersburg,3629,5,7,5,12,30,40,-10,26
SC Rheindorf,3629,6,6,6,12,18,27,-9,24
Vienna,3629,7,6,5,13,24,41,-17,23
FC Salzburg,3630,1,13,6,5,42,20,22,45
Rapid Vienna,3630,2,10,10,4,40,27,13,40
SK Sturm Gra,3630,3,11,5,8,31,30,1,38
LASK Linz,3630,4,9,6,9,27,27,0,33
Vienna,3630,5,7,6,11,25,38,-13,27
Mattersburg,3630,6,6,6,12,29,40,-11,24
SC Rheindorf,3630,7,6,5,13,17,29,-12,23
FC Salzburg,3631,1,13,6,5,40,19,21,45
SK Sturm Gra,3631,2,12,3,9,31,31,0,39
Rapid Vienna,3631,3,9,10,5,35,27,8,37
LASK Linz,3631,4,10,5,9,30,26,4,35
Vienna,3631,5,8,5,11,28,39,-11,29
Mattersburg,3631,6,7,6,11,30,40,-10,27
SC Rheindorf,3631,7,4,7,13,17,29,-12,19
FC Salzburg,3632,1,14,7,3,44,18,26,49
SK Sturm Gra,3632,2,13,4,7,35,30,5,43
Rapid Vienna,3632,3,8,11,5,34,26,8,35
LASK Linz,3632,4,8,6,10,24,26,-2,30
Mattersburg,3632,5,6,6,12,30,40,-10,24
SC Rheindorf,3632,6,6,6,12,17,28,-11,24
Vienna,3632,7,6,6,12,26,42,-16,24
FC Salzburg,3633,1,15,7,2,46,16,30,52
SK Sturm Gra,3633,2,13,3,8,34,32,2,42
Rapid Vienna,3633,3,10,9,5,37,26,11,39
LASK Linz,3633,4,7,6,11,26,31,-5,27
Vienna,3633,5,6,6,12,25,40,-15,24
Mattersburg,3633,6,5,8,11,28,39,-11,23
SC Rheindorf,3633,7,6,5,13,18,30,-12,23
FC Salzburg,3634,1,15,7,2,50,19,31,52
SK Sturm Gra,3634,2,13,4,7,34,29,5,43
Rapid Vienna,3634,3,8,11,5,36,31,5,35
LASK Linz,3634,4,9,6,9,29,29,0,33
Vienna,3634,5,7,5,12,28,41,-13,26
Mattersburg,3634,6,5,6,13,29,45,-16,21
SC Rheindorf,3634,7,4,7,13,19,31,-12,19
FC Salzburg,3635,1,15,6,3,44,17,27,51
SK Sturm Gra,3635,2,14,3,7,33,26,7,45
Rapid Vienna,3635,3,8,9,7,33,30,3,33
LASK Linz,3635,4,8,6,10,26,27,-1,30
SC Rheindorf,3635,5,6,6,12,18,27,-9,24
Mattersburg,3635,6,6,6,12,29,40,-11,24
Vienna,3635,7,6,6,12,24,40,-16,24
FC Salzburg,3636,1,16,6,2,46,17,29,54
SK Sturm Gra,3636,2,11,5,8,32,30,2,38
Rapid Vienna,3636,3,8,11,5,34,27,7,35
LASK Linz,3636,4,7,8,9,29,33,-4,29
SC Rheindorf,3636,5,6,7,11,24,28,-4,25
Mattersburg,3636,6,6,6,12,32,45,-13,24
Vienna,3636,7,6,5,13,24,41,-17,23
FC Salzburg,3637,1,15,7,2,49,18,31,52
LASK Linz,3637,2,11,5,8,29,25,4,38
SK Sturm Gra,3637,3,11,4,9,31,32,-1,37
Rapid Vienna,3637,4,9,9,6,38,30,8,36
Vienna,3637,5,7,5,12,27,41,-14,26
SC Rheindorf,3637,6,6,5,13,23,32,-9,23
Mattersburg,3637,7,5,5,14,29,48,-19,20
FC Salzburg,3638,1,15,6,3,47,20,27,51
SK Sturm Gra,3638,2,14,3,7,36,28,8,45
Rapid Vienna,3638,3,8,10,6,37,30,7,34
LASK Linz,3638,4,8,7,9,26,30,-4,31
Mattersburg,3638,5,7,5,12,30,38,-8,26
Vienna,3638,6,7,5,12,26,41,-15,26
SC Rheindorf,3638,7,4,6,14,17,32,-15,18
FC Salzburg,3639,1,13,9,2,45,20,25,48
SK Sturm Gra,3639,2,12,5,7,31,29,2,41
Rapid Vienna,3639,3,10,10,4,38,25,13,40
Vienna,3639,4,7,6,11,28,41,-13,27
LASK Linz,3639,5,7,5,12,26,33,-7,26
SC Rheindorf,3639,6,6,6,12,19,27,-8,24
Mattersburg,3639,7,6,5,13,29,41,-12,23
FC Salzburg,3640,1,12,8,4,40,19,21,44
SK Sturm Gra,3640,2,12,5,7,30,26,4,41
Rapid Vienna,3640,3,8,11,5,34,27,7,35
LASK Linz,3640,4,10,5,9,28,26,2,35
Mattersburg,3640,5,7,6,11,32,43,-11,27
Vienna,3640,6,7,5,12,26,40,-14,26
SC Rheindorf,3640,7,5,6,13,20,29,-9,21
FC Salzburg,3641,1,15,7,2,42,16,26,52
SK Sturm Gra,3641,2,13,3,8,32,29,3,42
Rapid Vienna,3641,3,9,9,6,37,28,9,36
LASK Linz,3641,4,10,5,9,31,29,2,35
Vienna,3641,5,6,7,11,24,38,-14,25
Mattersburg,3641,6,5,7,12,30,42,-12,22
SC Rheindorf,3641,7,4,6,14,18,32,-14,18
FC Salzburg,3642,1,13,8,3,44,21,23,47
SK Sturm Gra,3642,2,13,4,7,36,30,6,43
Rapid Vienna,3642,3,10,10,4,40,28,12,40
LASK Linz,3642,4,8,6,10,25,28,-3,30
Mattersburg,3642,5,7,6,11,32,41,-9,27
Vienna,3642,6,6,6,12,25,40,-15,24
SC Rheindorf,3642,7,4,6,14,21,35,-14,18
FC Salzburg,3643,1,15,7,2,48,21,27,52
SK Sturm Gra,3643,2,12,5,7,30,27,3,41
Rapid Vienna,3643,3,8,11,5,36,28,8,35
LASK Linz,3643,4,8,7,9,26,27,-1,31
Mattersburg,3643,5,7,5,12,31,41,-10,26
Vienna,3643,6,6,6,12,25,40,-15,24
SC Rheindorf,3643,7,4,7,13,17,29,-12,19
FC Salzburg,3644,1,15,7,2,48,16,32,52
SK Sturm Gra,3644,2,13,3,8,32,27,5,42
Rapid Vienna,3644,3,8,11,5,35,28,7,35
LASK Linz,3644,4,7,7,10,25,28,-3,28
Vienna,3644,5,7,5,12,25,43,-18,26
Mattersburg,3644,6,6,6,12,31,44,-13,24
SC Rheindorf,3644,7,6,5,13,19,29,-10,23
FC Salzburg,3645,1,14,6,4,45,20,25,48
SK Sturm Gra,3645,2,14,3,7,33,27,6,45
Rapid Vienna,3645,3,9,9,6,37,30,7,36
LASK Linz,3645,4,8,5,11,26,31,-5,29
Mattersburg,3645,5,7,7,10,32,38,-6,28
Vienna,3645,6,6,6,12,26,42,-16,24
SC Rheindorf,3645,7,5,6,13,19,30,-11,21
FC Salzburg,3646,1,15,7,2,50,18,32,52
SK Sturm Gra,3646,2,11,5,8,32,34,-2,38
Rapid Vienna,3646,3,8,12,4,35,25,10,36
LASK Linz,3646,4,9,6,9,29,26,3,33
Mattersburg,3646,5,7,5,12,30,42,-12,26
Vienna,3646,6,7,5,12,26,43,-17,26
SC Rheindorf,3646,7,4,6,14,19,33,-14,18
FC Salzburg,3647,1,13,7,4,45,23,22,46
SK Sturm Gra,3647,2,12,5,7,34,31,3,41
Rapid Vienna,3647,3,8,11,5,33,27,6,35
LASK Linz,3647,4,9,6,9,30,28,2,33
Vienna,3647,5,7,6,11,29,40,-11,27
SC Rheindorf,3647,6,6,6,12,22,30,-8,24
Mattersburg,3647,7,5,7,12,34,48,-14,22
FC Salzburg,3648,1,14,8,2,46,16,30,50
SK Sturm Gra,3648,2,12,5,7,35,31,4,41
Rapid Vienna,3648,3,10,10,4,37,25,12,40
LASK Linz,3648,4,7,5,12,27,37,-10,26
Mattersburg,3648,5,6,7,11,34,44,-10,25
Vienna,3648,6,6,6,12,24,41,-17,24
SC Rheindorf,3648,7,5,7,12,22,31,-9,22
FC Salzburg,3649,1,15,7,2,44,15,29,52
SK Sturm Gra,3649,2,14,4,6,32,25,7,46
LASK Linz,3649,3,9,6,9,31,29,2,33
Rapid Vienna,3649,4,7,9,8,31,29,2,30
Mattersburg,3649,5,6,6,12,29,43,-14,24
Vienna,3649,6,6,5,13,23,39,-16,23
SC Rheindorf,3649,7,5,7,12,17,27,-10,22
FC Salzburg,3650,1,15,6,3,47,17,30,51
SK Sturm Gra,3650,2,13,3,8,32,28,4,42
Rapid Vienna,3650,3,9,9,6,37,31,6,36
Mattersburg,3650,4,7,6,11,33,41,-8,27
LASK Linz,3650,5,7,6,11,23,31,-8,27
SC Rheindorf,3650,6,6,6,12,21,29,-8,24
Vienna,3650,7,6,6,12,24,40,-16,24
FC Salzburg,3651,1,14,7,3,46,21,25,49
SK Sturm Gra,3651,2,12,4,8,36,34,2,40
Rapid Vienna,3651,3,9,10,5,35,27,8,37
LASK Linz,3651,4,7,8,9,26,30,-4,29
Mattersburg,3651,5,7,6,11,34,41,-7,27
SC Rheindorf,3651,6,6,6,12,20,28,-8,24
Vienna,3651,7,6,5,13,27,43,-16,23
FC Salzburg,3652,1,14,8,2,43,17,26,50
SK Sturm Gra,3652,2,13,3,8,33,28,5,42
LASK Linz,3652,3,10,5,9,29,27,2,35
Rapid Vienna,3652,4,7,11,6,36,31,5,32
Vienna,3652,5,7,5,12,24,39,-15,26
Mattersburg,3652,6,6,6,12,30,42,-12,24
SC Rheindorf,3652,7,5,6,13,20,31,-11,21
FC Salzburg,3653,1,15,6,3,42,17,25,51
SK Sturm Gra,3653,2,13,3,8,33,28,5,42
Rapid Vienna,3653,3,9,9,6,34,27,7,36
LASK Linz,3653,4,8,7,9,27,28,-1,31
Mattersburg,3653,5,6,7,11,31,40,-9,25
Vienna,3653,6,6,5,13,23,41,-18,23
SC Rheindorf,3653,7,5,7,12,19,28,-9,22
FC Salzburg,3654,1,16,6,2,50,16,34,54
SK Sturm Gra,3654,2,13,4,7,37,27,10,43
Rapid Vienna,3654,3,8,10,6,33,32,1,34
LASK Linz,3654,4,7,8,9,26,31,-5,29
Vienna,3654,5,6,6,12,23,38,-15,24
Mattersburg,3654,6,5,8,11,30,44,-14,23
SC Rheindorf,3654,7,4,8,12,17,28,-11,20
FC Salzburg,3655,1,15,7,2,47,18,29,52
SK Sturm Gra,3655,2,14,3,7,36,28,8,45
Rapid Vienna,3655,3,8,10,6,34,30,4,34
LASK Linz,3655,4,8,7,9,30,30,0,31
Vienna,3655,5,6,6,12,26,41,-15,24
Mattersburg,3655,6,6,5,13,31,46,-15,23
SC Rheindorf,3655,7,5,6,13,19,30,-11,21
FC Salzburg,3656,1,15,6,3,46,20,26,51
SK Sturm Gra,3656,2,12,4,8,31,28,3,40
Rapid Vienna,3656,3,9,9,6,36,28,8,36
LASK Linz,3656,4,7,7,10,26,31,-5,28
Mattersburg,3656,5,7,6,11,35,43,-8,27
SC Rheindorf,3656,6,6,7,11,21,27,-6,25
Vienna,3656,7,6,5,13,26,44,-18,23
FC Salzburg,3657,1,15,7,2,46,18,28,52
SK Sturm Gra,3657,2,13,4,7,35,27,8,43
Rapid Vienna,3657,3,7,11,6,31,28,3,32
LASK Linz,3657,4,8,6,10,28,30,-2,30
Mattersburg,3657,5,8,5,11,35,41,-6,29
Vienna,3657,6,6,5,13,23,40,-17,23
SC Rheindorf,3657,7,5,6,13,16,30,-14,21
FC Salzburg,3658,1,15,7,2,50,20,30,52
SK Sturm Gra,3658,2,12,4,8,35,31,4,40
Rapid Vienna,3658,3,7,12,5,33,26,7,33
LASK Linz,3658,4,9,6,9,31,31,0,33
Mattersburg,3658,5,6,7,11,34,46,-12,25
Vienna,3658,6,6,6,12,26,41,-15,24
SC Rheindorf,3658,7,5,6,13,18,32,-14,21
FC Salzburg,3659,1,15,6,3,47,20,27,51
SK Sturm Gra,3659,2,13,4,7,33,28,5,43
Rapid Vienna,3659,3,9,10,5,35,26,9,37
LASK Linz,3659,4,7,6,11,26,31,-5,27
Vienna,3659,5,7,5,12,27,41,-14,26
Mattersburg,3659,6,6,6,12,32,44,-12,24
SC Rheindorf,3659,7,5,7,12,17,27,-10,22
FC Salzburg,3660,1,13,7,4,41,19,22,46
SK Sturm Gra,3660,2,13,3,8,34,30,4,42
Rapid Vienna,3660,3,10,9,5,38,27,11,39
LASK Linz,3660,4,8,6,10,27,31,-4,30
Mattersburg,3660,5,7,6,11,33,42,-9,27
Vienna,3660,6,6,6,12,24,41,-17,24
SC Rheindorf,3660,7,6,5,13,20,27,-7,23
FC Salzburg,3661,1,15,7,2,46,16,30,52
Rapid Vienna,3661,2,9,11,4,37,26,11,38
SK Sturm Gra,3661,3,11,3,10,30,32,-2,36
LASK Linz,3661,4,8,6,10,26,29,-3,30
Mattersburg,3661,5,7,6,11,35,45,-10,27
SC Rheindorf,3661,6,6,6,12,21,29,-8,24
Vienna,3661,7,6,5,13,24,42,-18,23
FC Salzburg,3662,1,15,7,2,51,19,32,52
SK Sturm Gra,3662,2,11,6,7,33,30,3,39
LASK Linz,3662,3,10,5,9,31,27,4,35
Rapid Vienna,3662,4,8,10,6,36,31,5,34
Mattersburg,3662,5,7,5,12,30,42,-12,26
Vienna,3662,6,7,5,12,26,43,-17,26
SC Rheindorf,3662,7,4,6,14,19,34,-15,18
FC Salzburg,3663,1,14,8,2,47,19,28,50
SK Sturm Gra,3663,2,13,4,7,37,31,6,43
Rapid Vienna,3663,3,9,9,6,38,30,8,36
LASK Linz,3663,4,8,5,11,27,31,-4,29
SC Rheindorf,3663,5,6,6,12,19,29,-10,24
Vienna,3663,6,6,6,12,25,42,-17,24
Mattersburg,3663,7,5,8,11,31,42,-11,23
FC Salzburg,3664,1,15,6,3,49,17,32,51
SK Sturm Gra,3664,2,14,3,7,36,31,5,45
Rapid Vienna,3664,3,8,9,7,34,30,4,33
LASK Linz,3664,4,8,7,9,26,26,0,31
Vienna,3664,5,7,5,12,26,40,-14,26
SC Rheindorf,3664,6,6,6,12,23,31,-8,24
Mattersburg,3664,7,5,6,13,26,45,-19,21
FC Salzburg,3665,1,15,6,3,43,18,25,51
Rapid Vienna,3665,2,10,10,4,37,24,13,40
SK Sturm Gra,3665,3,11,5,8,28,26,2,38
LASK Linz,3665,4,8,7,9,28,29,-1,31
Vienna,3665,5,7,5,12,25,40,-15,26
SC Rheindorf,3665,6,5,7,12,19,28,-9,22
Mattersburg,3665,7,5,6,13,27,42,-15,21
FC Salzburg,3666,1,14,7,3,43,17,26,49
Rapid Vienna,3666,2,10,10,4,37,24,13,40
SK Sturm Gra,3666,3,11,3,10,29,34,-5,36
LASK Linz,3666,4,9,5,10,28,28,0,32
Mattersburg,3666,5,8,5,11,32,40,-8,29
Vienna,3666,6,7,5,12,25,39,-14,26
SC Rheindorf,3666,7,5,5,14,18,30,-12,20
FC Salzburg,3667,1,15,7,2,51,16,35,52
SK Sturm Gra,3667,2,13,3,8,36,31,5,42
Rapid Vienna,3667,3,7,12,5,34,28,6,33
LASK Linz,3667,4,7,6,11,27,34,-7,27
SC Rheindorf,3667,5,7,6,11,24,31,-7,27
Mattersburg,3667,6,7,5,12,32,45,-13,26
Vienna,3667,7,6,5,13,24,43,-19,23
FC Salzburg,3668,1,14,8,2,47,20,27,50
SK Sturm Gra,3668,2,11,4,9,31,35,-4,37
Rapid Vienna,3668,3,8,11,5,35,27,8,35
LASK Linz,3668,4,9,5,10,30,32,-2,32
Mattersburg,3668,5,7,6,11,32,41,-9,27
SC Rheindorf,3668,6,7,5,12,24,28,-4,26
Vienna,3668,7,6,5,13,26,42,-16,23
FC Salzburg,3669,1,14,7,3,48,21,27,49
SK Sturm Gra,3669,2,14,3,7,36,30,6,45
Rapid Vienna,3669,3,8,9,7,36,31,5,33
LASK Linz,3669,4,8,6,10,27,29,-2,30
Vienna,3669,5,8,5,11,27,39,-12,29
SC Rheindorf,3669,6,6,6,12,19,29,-10,24
Mattersburg,3669,7,5,6,13,30,44,-14,21
FC Salzburg,3670,1,13,7,4,45,22,23,46
Rapid Vienna,3670,2,9,11,4,38,27,11,38
SK Sturm Gra,3670,3,11,4,9,31,31,0,37
LASK Linz,3670,4,9,6,9,28,27,1,33
Vienna,3670,5,7,6,11,30,41,-11,27
Mattersburg,3670,6,7,5,12,31,43,-12,26
SC Rheindorf,3670,7,6,5,13,20,32,-12,23
FC Salzburg,3671,1,15,6,3,44,18,26,51
SK Sturm Gra,3671,2,14,3,7,33,27,6,45
Rapid Vienna,3671,3,9,9,6,35,25,10,36
LASK Linz,3671,4,8,5,11,25,30,-5,29
Vienna,3671,5,7,5,12,27,40,-13,26
SC Rheindorf,3671,6,6,5,13,17,27,-10,23
Mattersburg,3671,7,6,5,13,30,44,-14,23
FC Salzburg,3672,1,15,6,3,44,19,25,51
Rapid Vienna,3672,2,9,10,5,38,28,10,37
SK Sturm Gra,3672,3,11,4,9,35,36,-1,37
LASK Linz,3672,4,9,6,9,29,28,1,33
SC Rheindorf,3672,5,6,7,11,22,29,-7,25
Vienna,3672,6,6,6,12,26,41,-15,24
Mattersburg,3672,7,5,7,12,30,43,-13,22
FC Salzburg,3673,1,13,7,4,42,20,22,46
SK Sturm Gra,3673,2,14,3,7,33,30,3,45
Rapid Vienna,3673,3,9,9,6,39,29,10,36
LASK Linz,3673,4,9,6,9,31,29,2,33
Mattersburg,3673,5,6,6,12,31,43,-12,24
Vienna,3673,6,6,6,12,25,40,-15,24
SC Rheindorf,3673,7,5,7,12,17,27,-10,22
FC Salzburg,3674,1,14,7,3,45,20,25,49
SK Sturm Gra,3674,2,13,4,7,34,27,7,43
Rapid Vienna,3674,3,8,10,6,32,26,6,34
LASK Linz,3674,4,9,6,9,27,27,0,33
Vienna,3674,5,7,6,11,26,39,-13,27
Mattersburg,3674,6,6,5,13,28,42,-14,23
SC Rheindorf,3674,7,5,6,13,17,28,-11,21
FC Salzburg,3675,1,13,9,2,43,19,24,48
SK Sturm Gra,3675,2,12,4,8,33,30,3,40
Rapid Vienna,3675,3,8,11,5,34,26,8,35
Mattersburg,3675,4,8,6,10,34,39,-5,30
LASK Linz,3675,5,7,7,10,26,30,-4,28
Vienna,3675,6,6,6,12,24,40,-16,24
SC Rheindorf,3675,7,6,5,13,20,30,-10,23
FC Salzburg,3676,1,14,7,3,44,19,25,49
SK Sturm Gra,3676,2,13,5,6,33,25,8,44
Rapid Vienna,3676,3,8,9,7,33,29,4,33
SC Rheindorf,3676,4,7,6,11,20,26,-6,27
LASK Linz,3676,5,7,5,12,25,31,-6,26
Mattersburg,3676,6,7,5,12,31,42,-11,26
Vienna,3676,7,7,5,12,26,40,-14,26
FC Salzburg,3677,1,15,6,3,48,19,29,51
SK Sturm Gra,3677,2,11,5,8,33,33,0,38
Rapid Vienna,3677,3,8,11,5,34,29,5,35
LASK Linz,3677,4,9,7,8,30,27,3,34
Vienna,3677,5,7,5,12,27,40,-13,26
Mattersburg,3677,6,6,6,12,29,41,-12,24
SC Rheindorf,3677,7,5,6,13,19,31,-12,21
FC Salzburg,3678,1,14,7,3,42,18,24,49
SK Sturm Gra,3678,2,12,4,8,33,30,3,40
LASK Linz,3678,3,9,7,8,28,27,1,34
Rapid Vienna,3678,4,8,9,7,34,27,7,33
Mattersburg,3678,5,6,8,10,32,41,-9,26
Vienna,3678,6,6,6,12,24,40,-16,24
SC Rheindorf,3678,7,6,5,13,20,30,-10,23
FC Salzburg,3679,1,15,6,3,48,18,30,51
SK Sturm Gra,3679,2,14,3,7,32,26,6,45
LASK Linz,3679,3,9,6,9,28,28,0,33
Rapid Vienna,3679,4,7,11,6,32,28,4,32
Vienna,3679,5,6,6,12,25,41,-16,24
SC Rheindorf,3679,6,5,7,12,17,27,-10,22
Mattersburg,3679,7,5,7,12,32,46,-14,22
FC Salzburg,3680,1,13,8,3,43,20,23,47
SK Sturm Gra,3680,2,12,4,8,35,31,4,40
LASK Linz,3680,3,10,5,9,28,30,-2,35
Rapid Vienna,3680,4,8,10,6,36,27,9,34
Vienna,3680,5,7,6,11,26,39,-13,27
Mattersburg,3680,6,6,7,11,30,41,-11,25
SC Rheindorf,3680,7,5,6,13,21,31,-10,21
FC Salzburg,3681,1,16,6,2,51,16,35,54
SK Sturm Gra,3681,2,13,4,7,35,31,4,43
Rapid Vienna,3681,3,7,10,7,35,33,2,31
LASK Linz,3681,4,8,6,10,30,34,-4,30
Mattersburg,3681,5,7,6,11,34,45,-11,27
SC Rheindorf,3681,6,6,5,13,21,30,-9,23
Vienna,3681,7,6,5,13,24,41,-17,23
FC Salzburg,3682,1,14,8,2,45,19,26,50
SK Sturm Gra,3682,2,13,4,7,32,26,6,43
Rapid Vienna,3682,3,8,10,6,33,27,6,34
LASK Linz,3682,4,7,7,10,25,30,-5,28
Mattersburg,3682,5,6,8,10,32,40,-8,26
Vienna,3682,6,6,7,11,25,39,-14,25
SC Rheindorf,3682,7,4,8,12,16,27,-11,20
FC Salzburg,3683,1,15,7,2,44,17,27,52
Rapid Vienna,3683,2,9,10,5,35,26,9,37
SK Sturm Gra,3683,3,11,4,9,31,30,1,37
LASK Linz,3683,4,9,5,10,25,27,-2,32
SC Rheindorf,3683,5,7,5,12,21,28,-7,26
Vienna,3683,6,6,6,12,23,38,-15,24
Mattersburg,3683,7,6,5,13,29,42,-13,23
FC Salzburg,3684,1,13,6,5,46,23,23,45
SK Sturm Gra,3684,2,12,3,9,32,33,-1,39
Rapid Vienna,3684,3,8,10,6,34,27,7,34
LASK Linz,3684,4,8,7,9,28,29,-1,31
Mattersburg,3684,5,8,6,10,34,40,-6,30
Vienna,3684,6,7,5,12,26,40,-14,26
SC Rheindorf,3684,7,6,7,11,18,26,-8,25
FC Salzburg,3685,1,16,6,2,46,15,31,54
SK Sturm Gra,3685,2,13,4,7,33,28,5,43
Rapid Vienna,3685,3,8,9,7,33,29,4,33
LASK Linz,3685,4,8,5,11,28,31,-3,29
Mattersburg,3685,5,7,6,11,31,41,-10,27
Vienna,3685,6,6,6,12,24,41,-17,24
SC Rheindorf,3685,7,5,6,13,21,31,-10,21
FC Salzburg,3686,1,14,7,3,44,21,23,49
SK Sturm Gra,3686,2,14,3,7,37,28,9,45
Rapid Vienna,3686,3,8,10,6,34,29,5,34
LASK Linz,3686,4,8,7,9,27,27,0,31
Vienna,3686,5,6,7,11,25,39,-14,25
Mattersburg,3686,6,6,6,12,30,42,-12,24
SC Rheindorf,3686,7,5,6,13,19,30,-11,21
FC Salzburg,3687,1,13,8,3,41,16,25,47
SK Sturm Gra,3687,2,11,6,7,31,29,2,39
Rapid Vienna,3687,3,9,11,4,37,25,12,38
LASK Linz,3687,4,8,5,11,25,30,-5,29
Vienna,3687,5,8,5,11,28,37,-9,29
Mattersburg,3687,6,7,5,12,34,44,-10,26
SC Rheindorf,3687,7,5,6,13,20,35,-15,21
FC Salzburg,3688,1,15,6,3,45,20,25,51
SK Sturm Gra,3688,2,12,4,8,31,27,4,40
LASK Linz,3688,3,11,5,8,29,26,3,38
Rapid Vienna,3688,4,8,9,7,33,28,5,33
Vienna,3688,5,7,5,12,27,41,-14,26
Mattersburg,3688,6,6,5,13,34,47,-13,23
SC Rheindorf,3688,7,5,6,13,23,33,-10,21
FC Salzburg,3689,1,13,7,4,41,21,20,46
SK Sturm Gra,3689,2,12,4,8,32,32,0,40
Rapid Vienna,3689,3,9,10,5,39,30,9,37
Mattersburg,3689,4,9,5,10,41,38,3,32
LASK Linz,3689,5,8,7,9,30,31,-1,31
Vienna,3689,6,6,6,12,25,40,-15,24
SC Rheindorf,3689,7,4,7,13,19,35,-16,19
FC Salzburg,3690,1,14,8,2,43,16,27,50
SK Sturm Gra,3690,2,13,5,6,33,27,6,44
Rapid Vienna,3690,3,9,9,6,40,27,13,36
LASK Linz,3690,4,9,6,9,30,29,1,33
Vienna,3690,5,6,6,12,24,41,-17,24
Mattersburg,3690,6,5,7,12,29,44,-15,22
SC Rheindorf,3690,7,5,5,14,21,36,-15,20
FC Salzburg,3691,1,12,9,3,45,23,22,45
SK Sturm Gra,3691,2,11,6,7,33,32,1,39
Rapid Vienna,3691,3,9,11,4,36,25,11,38
LASK Linz,3691,4,8,7,9,25,26,-1,31
Vienna,3691,5,8,5,11,30,39,-9,29
Mattersburg,3691,6,6,7,11,32,45,-13,25
SC Rheindorf,3691,7,5,5,14,18,29,-11,20
FC Salzburg,3692,1,16,6,2,47,18,29,54
SK Sturm Gra,3692,2,11,5,8,31,30,1,38
Rapid Vienna,3692,3,8,10,6,34,27,7,34
LASK Linz,3692,4,9,6,9,27,27,0,33
Vienna,3692,5,7,5,12,25,39,-14,26
Mattersburg,3692,6,6,6,12,31,42,-11,24
SC Rheindorf,3692,7,4,8,12,18,30,-12,20
FC Salzburg,3693,1,14,8,2,45,19,26,50
SK Sturm Gra,3693,2,11,4,9,30,33,-3,37
LASK Linz,3693,3,10,6,8,33,27,6,36
Rapid Vienna,3693,4,7,11,6,35,31,4,32
SC Rheindorf,3693,5,7,5,12,21,28,-7,26
Mattersburg,3693,6,6,6,12,33,42,-9,24
Vienna,3693,7,6,6,12,26,43,-17,24
FC Salzburg,3694,1,13,7,4,41,21,20,46
SK Sturm Gra,3694,2,13,4,7,34,28,6,43
Rapid Vienna,3694,3,10,10,4,38,27,11,40
LASK Linz,3694,4,8,6,10,26,29,-3,30
Mattersburg,3694,5,7,6,11,33,38,-5,27
Vienna,3694,6,6,7,11,25,39,-14,25
SC Rheindorf,3694,7,4,6,14,15,30,-15,18
FC Salzburg,3695,1,13,9,2,43,19,24,48
SK Sturm Gra,3695,2,11,7,6,37,33,4,40
Rapid Vienna,3695,3,8,11,5,38,28,10,35
LASK Linz,3695,4,9,6,9,31,32,-1,33
Mattersburg,3695,5,7,7,10,35,42,-7,28
Vienna,3695,6,6,6,12,27,42,-15,24
SC Rheindorf,3695,7,4,6,14,18,33,-15,18
FC Salzburg,3696,1,14,7,3,45,20,25,49
SK Sturm Gra,3696,2,14,3,7,41,29,12,45
Rapid Vienna,3696,3,9,10,5,38,27,11,37
LASK Linz,3696,4,9,5,10,28,31,-3,32
Vienna,3696,5,7,6,11,27,40,-13,27
Mattersburg,3696,6,6,6,12,32,43,-11,24
SC Rheindorf,3696,7,4,5,15,17,38,-21,17
FC Salzburg,3697,1,16,6,2,45,17,28,54
SK Sturm Gra,3697,2,14,3,7,37,26,11,45
Rapid Vienna,3697,3,8,10,6,34,26,8,34
LASK Linz,3697,4,7,7,10,24,31,-7,28
Mattersburg,3697,5,6,6,12,29,41,-12,24
SC Rheindorf,3697,6,6,5,13,19,31,-12,23
Vienna,3697,7,6,5,13,25,41,-16,23
FC Salzburg,3698,1,14,6,4,44,23,21,48
SK Sturm Gra,3698,2,14,3,7,37,26,11,45
Rapid Vienna,3698,3,8,10,6,34,27,7,34
LASK Linz,3698,4,8,7,9,27,30,-3,31
SC Rheindorf,3698,5,6,7,11,19,26,-7,25
Vienna,3698,6,6,6,12,24,39,-15,24
Mattersburg,3698,7,5,7,12,29,43,-14,22
FC Salzburg,3699,1,14,7,3,45,19,26,49
SK Sturm Gra,3699,2,12,4,8,33,30,3,40
Rapid Vienna,3699,3,9,9,6,35,27,8,36
LASK Linz,3699,4,9,6,9,31,29,2,33
Mattersburg,3699,5,7,5,12,32,45,-13,26
Vienna,3699,6,7,5,12,28,43,-15,26
SC Rheindorf,3699,7,5,6,13,20,31,-11,21
FC Salzburg,3700,1,15,7,2,44,17,27,52
SK Sturm Gra,3700,2,12,4,8,34,33,1,40
Rapid Vienna,3700,3,8,10,6,35,28,7,34
LASK Linz,3700,4,8,6,10,28,30,-2,30
Mattersburg,3700,5,8,5,11,33,39,-6,29
Vienna,3700,6,6,5,13,23,42,-19,23
SC Rheindorf,3700,7,5,7,12,22,30,-8,22
FC Salzburg,3701,1,14,7,3,48,19,29,49
SK Sturm Gra,3701,2,13,4,7,34,28,6,43
Rapid Vienna,3701,3,7,11,6,35,33,2,32
LASK Linz,3701,4,8,7,9,31,29,2,31
Vienna,3701,5,8,5,11,27,39,-12,29
Mattersburg,3701,6,6,6,12,32,45,-13,24
SC Rheindorf,3701,7,5,6,13,20,34,-14,21
FC Salzburg,3702,1,13,7,4,40,20,20,46
SK Sturm Gra,3702,2,12,5,7,31,29,2,41
Rapid Vienna,3702,3,8,11,5,36,27,9,35
Mattersburg,3702,4,8,5,11,31,38,-7,29
LASK Linz,3702,5,7,7,10,25,29,-4,28
Vienna,3702,6,7,5,12,25,38,-13,26
SC Rheindorf,3702,7,6,6,12,21,28,-7,24
FC Salzburg,3703,1,14,8,2,42,17,25,50
SK Sturm Gra,3703,2,13,4,7,34,29,5,43
Rapid Vienna,3703,3,9,9,6,36,27,9,36
LASK Linz,3703,4,9,5,10,29,31,-2,32
Mattersburg,3703,5,6,8,10,33,40,-7,26
Vienna,3703,6,6,6,12,25,40,-15,24
SC Rheindorf,3703,7,4,6,14,20,35,-15,18
FC Salzburg,3704,1,15,7,2,46,17,29,52
SK Sturm Gra,3704,2,13,4,7,33,26,7,43
LASK Linz,3704,3,9,6,9,29,30,-1,33
Rapid Vienna,3704,4,7,9,8,35,32,3,30
Vienna,3704,5,7,6,11,26,39,-13,27
Mattersburg,3704,6,7,5,12,33,44,-11,26
SC Rheindorf,3704,7,5,5,14,19,33,-14,20
FC Salzburg,3705,1,14,8,2,43,18,25,50
SK Sturm Gra,3705,2,12,5,7,33,29,4,41
Rapid Vienna,3705,3,7,12,5,34,27,7,33
LASK Linz,3705,4,7,7,10,27,30,-3,28
SC Rheindorf,3705,5,7,5,12,20,28,-8,26
Vienna,3705,6,7,5,12,27,41,-14,26
Mattersburg,3705,7,6,6,12,32,43,-11,24
FC Salzburg,3706,1,14,7,3,42,18,24,49
SK Sturm Gra,3706,2,12,4,8,34,32,2,40
Rapid Vienna,3706,3,8,11,5,33,25,8,35
LASK Linz,3706,4,9,6,9,27,26,1,33
Mattersburg,3706,5,6,8,10,31,39,-8,26
Vienna,3706,6,6,6,12,24,39,-15,24
SC Rheindorf,3706,7,5,6,13,19,31,-12,21
FC Salzburg,3707,1,15,7,2,48,17,31,52
SK Sturm Gra,3707,2,13,4,7,31,26,5,43
Rapid Vienna,3707,3,8,10,6,36,29,7,34
LASK Linz,3707,4,8,7,9,28,29,-1,31
Vienna,3707,5,6,6,12,24,39,-15,24
Mattersburg,3707,6,6,6,12,30,46,-16,24
SC Rheindorf,3707,7,4,8,12,18,29,-11,20
FC Salzburg,3708,1,14,6,4,47,21,26,48
SK Sturm Gra,3708,2,11,5,8,34,34,0,38
Rapid Vienna,3708,3,8,11,5,35,29,6,35
LASK Linz,3708,4,7,9,8,28,29,-1,30
Vienna,3708,5,8,5,11,28,39,-11,29
Mattersburg,3708,6,6,6,12,31,42,-11,24
SC Rheindorf,3708,7,5,8,11,19,28,-9,23
FC Salzburg,3709,1,14,7,3,41,17,24,49
SK Sturm Gra,3709,2,15,3,6,34,26,8,48
Rapid Vienna,3709,3,8,9,7,33,27,6,33
LASK Linz,3709,4,8,5,11,29,29,0,29
Mattersburg,3709,5,6,8,10,32,41,-9,26
Vienna,3709,6,6,6,12,25,40,-15,24
SC Rheindorf,3709,7,5,6,13,17,31,-14,21
FC Salzburg,3710,1,13,7,4,41,21,20,46
Rapid Vienna,3710,2,10,10,4,39,25,14,40
SK Sturm Gra,3710,3,12,4,8,29,28,1,40
LASK Linz,3710,4,8,5,11,24,29,-5,29
Mattersburg,3710,5,8,5,11,32,39,-7,29
Vienna,3710,6,7,5,12,27,40,-13,26
SC Rheindorf,3710,7,5,6,13,18,28,-10,21
FC Salzburg,3711,1,14,8,2,50,18,32,50
SK Sturm Gra,3711,2,13,4,7,33,27,6,43
Rapid Vienna,3711,3,8,10,6,34,30,4,34
LASK Linz,3711,4,9,5,10,26,27,-1,32
Mattersburg,3711,5,7,7,10,31,39,-8,28
Vienna,3711,6,6,5,13,23,43,-20,23
SC Rheindorf,3711,7,4,7,13,16,29,-13,19
FC Salzburg,3712,1,14,7,3,49,18,31,49
SK Sturm Gra,3712,2,12,5,7,35,30,5,41
LASK Linz,3712,3,10,6,8,33,29,4,36
Rapid Vienna,3712,4,8,9,7,35,32,3,33
Mattersburg,3712,5,6,6,12,33,49,-16,24
Vienna,3712,6,6,6,12,26,42,-16,24
SC Rheindorf,3712,7,6,5,13,22,33,-11,23
FC Salzburg,3713,1,15,7,2,53,16,37,52
SK Sturm Gra,3713,2,11,6,7,31,30,1,39
Rapid Vienna,3713,3,8,12,4,39,29,10,36
LASK Linz,3713,4,7,7,10,31,35,-4,28
SC Rheindorf,3713,5,6,7,11,23,31,-8,25
Vienna,3713,6,6,6,12,24,41,-17,24
Mattersburg,3713,7,5,7,12,29,48,-19,22
FC Salzburg,3714,1,14,7,3,43,18,25,49
SK Sturm Gra,3714,2,14,4,6,37,25,12,46
Rapid Vienna,3714,3,8,10,6,35,28,7,34
Mattersburg,3714,4,8,5,11,35,42,-7,29
LASK Linz,3714,5,7,6,11,25,29,-4,27
SC Rheindorf,3714,6,6,5,13,23,36,-13,23
Vienna,3714,7,6,5,13,25,45,-20,23
FC Salzburg,3715,1,14,7,3,43,18,25,49
SK Sturm Gra,3715,2,14,3,7,32,27,5,45
Rapid Vienna,3715,3,7,12,5,34,27,7,33
LASK Linz,3715,4,7,8,9,25,27,-2,29
SC Rheindorf,3715,5,6,7,11,20,27,-7,25
Vienna,3715,6,6,6,12,24,39,-15,24
Mattersburg,3715,7,5,7,12,29,42,-13,22
FC Salzburg,3716,1,15,6,3,52,18,34,51
SK Sturm Gra,3716,2,12,4,8,33,30,3,40
Rapid Vienna,3716,3,9,10,5,37,27,10,37
LASK Linz,3716,4,8,6,10,25,28,-3,30
Vienna,3716,5,7,5,12,27,42,-15,26
Mattersburg,3716,6,6,6,12,29,48,-19,24
SC Rheindorf,3716,7,4,9,11,17,27,-10,21
FC Salzburg,3717,1,14,8,2,43,16,27,50
SK Sturm Gra,3717,2,12,3,9,32,29,3,39
Rapid Vienna,3717,3,9,11,4,35,25,10,38
Mattersburg,3717,4,7,6,11,32,42,-10,27
LASK Linz,3717,5,7,5,12,25,33,-8,26
SC Rheindorf,3717,6,6,7,11,19,26,-7,25
Vienna,3717,7,6,6,12,24,39,-15,24
FC Salzburg,3718,1,15,7,2,46,18,28,52
SK Sturm Gra,3718,2,12,3,9,32,32,0,39
Rapid Vienna,3718,3,9,10,5,36,26,10,37
LASK Linz,3718,4,8,6,10,25,28,-3,30
Vienna,3718,5,7,6,11,27,40,-13,27
Mattersburg,3718,6,6,6,12,30,41,-11,24
SC Rheindorf,3718,7,5,6,13,19,30,-11,21
FC Salzburg,3719,1,14,7,3,46,21,25,49
SK Sturm Gra,3719,2,12,5,7,33,29,4,41
Rapid Vienna,3719,3,10,10,4,36,25,11,40
LASK Linz,3719,4,7,6,11,25,30,-5,27
Mattersburg,3719,5,6,7,11,30,40,-10,25
SC Rheindorf,3719,6,6,6,12,22,30,-8,24
Vienna,3719,7,6,5,13,25,42,-17,23
FC Salzburg,3720,1,14,7,3,44,20,24,49
SK Sturm Gra,3720,2,14,3,7,34,28,6,45
Rapid Vienna,3720,3,8,10,6,35,28,7,34
LASK Linz,3720,4,9,6,9,29,30,-1,33
Mattersburg,3720,5,8,5,11,36,41,-5,29
Vienna,3720,6,6,5,13,23,41,-18,23
SC Rheindorf,3720,7,4,6,14,17,30,-13,18
FC Salzburg,3721,1,12,9,3,41,19,22,45
SK Sturm Gra,3721,2,12,5,7,33,28,5,41
Rapid Vienna,3721,3,9,11,4,35,24,11,38
Mattersburg,3721,4,8,5,11,35,40,-5,29
LASK Linz,3721,5,7,5,12,23,33,-10,26
SC Rheindorf,3721,6,6,7,11,20,28,-8,25
Vienna,3721,7,6,6,12,24,39,-15,24
FC Salzburg,3722,1,15,7,2,45,16,29,52
SK Sturm Gra,3722,2,12,5,7,35,30,5,41
LASK Linz,3722,3,10,6,8,32,28,4,36
Rapid Vienna,3722,4,7,11,6,33,28,5,32
Mattersburg,3722,5,6,6,12,28,41,-13,24
Vienna,3722,6,6,5,13,23,40,-17,23
SC Rheindorf,3722,7,5,6,13,20,33,-13,21
FC Salzburg,3723,1,15,7,2,44,18,26,52
SK Sturm Gra,3723,2,12,4,8,32,30,2,40
Rapid Vienna,3723,3,7,12,5,34,27,7,33
LASK Linz,3723,4,9,6,9,29,29,0,33
SC Rheindorf,3723,5,6,6,12,23,30,-7,24
Mattersburg,3723,6,6,6,12,35,47,-12,24
Vienna,3723,7,6,5,13,26,42,-16,23
FC Salzburg,3724,1,16,6,2,48,17,31,54
SK Sturm Gra,3724,2,13,4,7,33,26,7,43
Rapid Vienna,3724,3,7,11,6,34,28,6,32
Mattersburg,3724,4,8,5,11,34,44,-10,29
LASK Linz,3724,5,7,6,11,25,32,-7,27
Vienna,3724,6,6,5,13,25,41,-16,23
SC Rheindorf,3724,7,5,7,12,19,30,-11,22
FC Salzburg,3725,1,13,9,2,43,16,27,48
SK Sturm Gra,3725,2,12,3,9,31,32,-1,39
Rapid Vienna,3725,3,9,10,5,37,30,7,37
LASK Linz,3725,4,9,5,10,33,30,3,32
Vienna,3725,5,7,6,11,25,38,-13,27
SC Rheindorf,3725,6,6,6,12,21,30,-9,24
Mattersburg,3725,7,5,7,12,29,43,-14,22
FC Salzburg,3726,1,15,7,2,50,20,30,52
SK Sturm Gra,3726,2,13,3,8,32,32,0,42
Rapid Vienna,3726,3,8,10,6,36,29,7,34
LASK Linz,3726,4,9,6,9,29,26,3,33
Mattersburg,3726,5,7,6,11,34,46,-12,27
Vienna,3726,6,6,5,13,23,39,-16,23
SC Rheindorf,3726,7,4,7,13,19,31,-12,19
FC Salzburg,3727,1,14,7,3,43,19,24,49
SK Sturm Gra,3727,2,12,3,9,34,31,3,39
LASK Linz,3727,3,9,7,8,27,26,1,34
Rapid Vienna,3727,4,8,9,7,33,27,6,33
Vienna,3727,5,7,6,11,26,39,-13,27
Mattersburg,3727,6,6,7,11,29,39,-10,25
SC Rheindorf,3727,7,5,7,12,16,27,-11,22
FC Salzburg,3728,1,14,8,2,52,23,29,50
SK Sturm Gra,3728,2,13,5,6,35,28,7,44
LASK Linz,3728,3,9,7,8,25,24,1,34
Rapid Vienna,3728,4,7,11,6,33,32,1,32
Mattersburg,3728,5,6,6,12,28,39,-11,24
Vienna,3728,6,6,6,12,27,42,-15,24
SC Rheindorf,3728,7,4,7,13,16,28,-12,19
FC Salzburg,3729,1,14,7,3,43,18,25,49
SK Sturm Gra,3729,2,13,4,7,35,31,4,43
Rapid Vienna,3729,3,9,11,4,39,26,13,38
LASK Linz,3729,4,7,7,10,28,31,-3,28
SC Rheindorf,3729,5,6,6,12,18,28,-10,24
Vienna,3729,6,6,6,12,24,39,-15,24
Mattersburg,3729,7,5,7,12,28,42,-14,22
FC Salzburg,3730,1,14,6,4,48,22,26,48
SK Sturm Gra,3730,2,15,3,6,36,27,9,48
Rapid Vienna,3730,3,9,9,6,38,28,10,36
LASK Linz,3730,4,9,5,10,27,29,-2,32
Mattersburg,3730,5,7,5,12,31,40,-9,26
Vienna,3730,6,6,5,13,25,44,-19,23
SC Rheindorf,3730,7,5,5,14,17,32,-15,20
SK Sturm Gra,3731,1,14,4,6,39,29,10,46
FC Salzburg,3731,2,12,7,5,40,20,20,43
Rapid Vienna,3731,3,9,11,4,37,26,11,38
LASK Linz,3731,4,8,7,9,28,31,-3,31
Mattersburg,3731,5,7,7,10,31,37,-6,28
Vienna,3731,6,7,5,12,24,38,-14,26
SC Rheindorf,3731,7,4,5,15,17,35,-18,17
FC Salzburg,3732,1,15,6,3,49,21,28,51
SK Sturm Gra,3732,2,13,3,8,34,30,4,42
Rapid Vienna,3732,3,9,9,6,38,31,7,36
LASK Linz,3732,4,9,6,9,29,29,0,33
Mattersburg,3732,5,7,5,12,29,41,-12,26
Vienna,3732,6,7,5,12,25,39,-14,26
SC Rheindorf,3732,7,4,6,14,17,30,-13,18
FC Salzburg,3733,1,16,6,2,48,17,31,54
SK Sturm Gra,3733,2,12,4,8,31,31,0,40
Rapid Vienna,3733,3,9,9,6,37,30,7,36
LASK Linz,3733,4,8,7,9,27,28,-1,31
Mattersburg,3733,5,6,6,12,30,40,-10,24
Vienna,3733,6,6,5,13,24,43,-19,23
SC Rheindorf,3733,7,5,7,12,21,29,-8,22
FC Salzburg,3734,1,16,6,2,51,16,35,54
SK Sturm Gra,3734,2,11,4,9,30,33,-3,37
Rapid Vienna,3734,3,8,10,6,35,26,9,34
LASK Linz,3734,4,9,7,8,30,27,3,34
Vienna,3734,5,7,5,12,27,39,-12,26
SC Rheindorf,3734,6,6,6,12,20,29,-9,24
Mattersburg,3734,7,5,6,13,29,52,-23,21
FC Salzburg,3735,1,13,6,5,42,22,20,45
SK Sturm Gra,3735,2,14,3,7,39,28,11,45
Rapid Vienna,3735,3,10,9,5,38,30,8,39
LASK Linz,3735,4,10,5,9,32,30,2,35
Vienna,3735,5,7,5,12,25,38,-13,26
Mattersburg,3735,6,6,5,13,30,43,-13,23
SC Rheindorf,3735,7,5,5,14,20,35,-15,20
SK Sturm Gra,3736,1,14,4,6,38,28,10,46
FC Salzburg,3736,2,13,6,5,42,22,20,45
Rapid Vienna,3736,3,9,11,4,37,27,10,38
LASK Linz,3736,4,9,6,9,28,29,-1,33
Vienna,3736,5,7,6,11,25,38,-13,27
Mattersburg,3736,6,5,7,12,29,41,-12,22
SC Rheindorf,3736,7,4,6,14,18,32,-14,18
FC Salzburg,3737,1,14,7,3,43,18,25,49
SK Sturm Gra,3737,2,13,5,6,33,27,6,44
Rapid Vienna,3737,3,8,12,4,36,26,10,36
LASK Linz,3737,4,9,7,8,29,27,2,34
Vienna,3737,5,6,6,12,25,40,-15,24
Mattersburg,3737,6,5,7,12,30,43,-13,22
SC Rheindorf,3737,7,4,6,14,16,31,-15,18
FC Salzburg,3738,1,13,7,4,43,21,22,46
SK Sturm Gra,3738,2,11,5,8,34,32,2,38
Rapid Vienna,3738,3,9,10,5,36,28,8,37
LASK Linz,3738,4,10,5,9,30,28,2,35
Mattersburg,3738,5,7,5,12,30,39,-9,26
Vienna,3738,6,7,5,12,25,40,-15,26
SC Rheindorf,3738,7,6,5,13,17,27,-10,23
FC Salzburg,3739,1,15,7,2,48,18,30,52
SK Sturm Gra,3739,2,12,5,7,31,27,4,41
Rapid Vienna,3739,3,8,9,7,34,29,5,33
LASK Linz,3739,4,8,6,10,28,30,-2,30
SC Rheindorf,3739,5,7,5,12,18,26,-8,26
Mattersburg,3739,6,6,6,12,29,41,-12,24
Vienna,3739,7,6,6,12,24,41,-17,24
FC Salzburg,3740,1,15,6,3,48,17,31,51
SK Sturm Gra,3740,2,12,4,8,30,28,2,40
Rapid Vienna,3740,3,9,10,5,36,27,9,37
LASK Linz,3740,4,9,7,8,30,26,4,34
Mattersburg,3740,5,6,6,12,33,48,-15,24
Vienna,3740,6,6,6,12,24,41,-17,24
SC Rheindorf,3740,7,5,5,14,18,32,-14,20
FC Salzburg,3741,1,16,6,2,45,15,30,54
SK Sturm Gra,3741,2,12,3,9,30,31,-1,39
LASK Linz,3741,3,10,5,9,33,26,7,35
Rapid Vienna,3741,4,8,9,7,34,29,5,33
Mattersburg,3741,5,7,5,12,32,42,-10,26
SC Rheindorf,3741,6,6,5,13,17,29,-12,23
Vienna,3741,7,6,5,13,23,42,-19,23
FC Salzburg,3742,1,14,8,2,49,21,28,50
SK Sturm Gra,3742,2,11,6,7,31,31,0,39
Rapid Vienna,3742,3,7,12,5,35,28,7,33
LASK Linz,3742,4,8,8,8,25,25,0,32
Vienna,3742,5,7,6,11,25,38,-13,27
Mattersburg,3742,6,6,6,12,34,44,-10,24
SC Rheindorf,3742,7,5,6,13,21,33,-12,21
FC Salzburg,3743,1,14,7,3,43,20,23,49
SK Sturm Gra,3743,2,12,4,8,33,29,4,40
Rapid Vienna,3743,3,7,12,5,35,28,7,33
LASK Linz,3743,4,8,6,10,28,31,-3,30
Vienna,3743,5,8,5,11,26,37,-11,29
SC Rheindorf,3743,6,7,6,11,21,26,-5,27
Mattersburg,3743,7,5,6,13,30,45,-15,21
FC Salzburg,3744,1,15,6,3,47,18,29,51
SK Sturm Gra,3744,2,12,4,8,30,31,-1,40
Rapid Vienna,3744,3,9,9,6,42,33,9,36
LASK Linz,3744,4,9,5,10,29,31,-2,32
Mattersburg,3744,5,7,6,11,31,39,-8,27
Vienna,3744,6,6,6,12,25,41,-16,24
SC Rheindorf,3744,7,5,6,13,19,30,-11,21
FC Salzburg,3745,1,15,6,3,47,21,26,51
Rapid Vienna,3745,2,10,10,4,40,25,15,40
SK Sturm Gra,3745,3,12,4,8,31,31,0,40
LASK Linz,3745,4,8,5,11,26,31,-5,29
Vienna,3745,5,7,5,12,24,39,-15,26
Mattersburg,3745,6,6,5,13,30,42,-12,23
SC Rheindorf,3745,7,5,7,12,19,28,-9,22
FC Salzburg,3746,1,14,6,4,46,22,24,48
SK Sturm Gra,3746,2,12,6,6,31,26,5,42
Rapid Vienna,3746,3,10,10,4,43,26,17,40
LASK Linz,3746,4,7,8,9,26,30,-4,29
Mattersburg,3746,5,7,6,11,31,40,-9,27
Vienna,3746,6,6,5,13,23,42,-19,23
SC Rheindorf,3746,7,4,7,13,17,31,-14,19
FC Salzburg,3747,1,15,7,2,45,18,27,52
SK Sturm Gra,3747,2,11,6,7,32,30,2,39
Rapid Vienna,3747,3,8,11,5,34,26,8,35
LASK Linz,3747,4,7,8,9,25,28,-3,29
Mattersburg,3747,5,7,6,11,34,43,-9,27
Vienna,3747,6,7,5,12,26,38,-12,26
SC Rheindorf,3747,7,4,7,13,18,31,-13,19
FC Salzburg,3748,1,16,6,2,50,17,33,54
SK Sturm Gra,3748,2,13,3,8,33,29,4,42
Rapid Vienna,3748,3,8,10,6,35,30,5,34
LASK Linz,3748,4,7,6,11,26,30,-4,27
Mattersburg,3748,5,7,6,11,34,43,-9,27
Vienna,3748,6,6,6,12,26,42,-16,24
SC Rheindorf,3748,7,6,5,13,19,32,-13,23
FC Salzburg,3749,1,15,7,2,49,18,31,52
SK Sturm Gra,3749,2,13,3,8,34,30,4,42
Rapid Vienna,3749,3,8,10,6,35,30,5,34
LASK Linz,3749,4,9,6,9,30,29,1,33
Vienna,3749,5,7,5,12,27,42,-15,26
Mattersburg,3749,6,6,6,12,33,45,-12,24
SC Rheindorf,3749,7,5,5,14,17,31,-14,20
FC Salzburg,3750,1,14,8,2,46,18,28,50
SK Sturm Gra,3750,2,12,5,7,33,27,6,41
Rapid Vienna,3750,3,8,10,6,35,31,4,34
LASK Linz,3750,4,9,6,9,27,27,0,33
Vienna,3750,5,7,6,11,27,38,-11,27
Mattersburg,3750,6,6,6,12,27,42,-15,24
SC Rheindorf,3750,7,4,7,13,15,27,-12,19
FC Salzburg,3751,1,16,6,2,49,21,28,54
SK Sturm Gra,3751,2,13,4,7,36,28,8,43
Rapid Vienna,3751,3,8,10,6,34,27,7,34
LASK Linz,3751,4,7,7,10,25,31,-6,28
Vienna,3751,5,7,5,12,29,43,-14,26
Mattersburg,3751,6,6,6,12,36,47,-11,24
SC Rheindorf,3751,7,5,6,13,22,34,-12,21
FC Salzburg,3752,1,12,9,3,40,18,22,45
SK Sturm Gra,3752,2,13,4,7,33,25,8,43
Rapid Vienna,3752,3,9,9,6,36,27,9,36
LASK Linz,3752,4,9,5,10,30,33,-3,32
Vienna,3752,5,7,6,11,26,38,-12,27
Mattersburg,3752,6,6,6,12,30,43,-13,24
SC Rheindorf,3752,7,6,5,13,20,31,-11,23
SK Sturm Gra,3753,1,14,4,6,34,25,9,46
FC Salzburg,3753,2,12,7,5,40,20,20,43
Rapid Vienna,3753,3,10,9,5,38,27,11,39
LASK Linz,3753,4,8,6,10,28,33,-5,30
Mattersburg,3753,5,7,6,11,34,43,-9,27
Vienna,3753,6,7,6,11,26,38,-12,27
SC Rheindorf,3753,7,4,6,14,19,33,-14,18
FC Salzburg,3754,1,15,7,2,49,18,31,52
SK Sturm Gra,3754,2,12,4,8,30,28,2,40
Rapid Vienna,3754,3,8,9,7,32,29,3,33
LASK Linz,3754,4,8,5,11,26,31,-5,29
Mattersburg,3754,5,7,6,11,31,42,-11,27
Vienna,3754,6,7,5,12,29,42,-13,26
SC Rheindorf,3754,7,6,6,12,19,26,-7,24
FC Salzburg,3755,1,15,6,3,44,19,25,51
Rapid Vienna,3755,2,10,9,5,38,27,11,39
SK Sturm Gra,3755,3,12,3,9,33,30,3,39
LASK Linz,3755,4,8,5,11,31,35,-4,29
Mattersburg,3755,5,7,6,11,34,42,-8,27
Vienna,3755,6,6,6,12,24,39,-15,24
SC Rheindorf,3755,7,6,5,13,20,32,-12,23
FC Salzburg,3756,1,13,7,4,40,19,21,46
SK Sturm Gra,3756,2,13,4,7,34,27,7,43
Rapid Vienna,3756,3,9,11,4,37,26,11,38
LASK Linz,3756,4,7,8,9,26,30,-4,29
Mattersburg,3756,5,7,6,11,32,40,-8,27
Vienna,3756,6,7,5,12,25,40,-15,26
SC Rheindorf,3756,7,4,7,13,19,31,-12,19
FC Salzburg,3757,1,15,6,3,44,19,25,51
SK Sturm Gra,3757,2,12,3,9,29,29,0,39
LASK Linz,3757,3,10,5,9,31,29,2,35
Rapid Vienna,3757,4,8,9,7,36,30,6,33
Mattersburg,3757,5,7,6,11,31,39,-8,27
Vienna,3757,6,7,5,12,26,40,-14,26
SC Rheindorf,3757,7,5,6,13,16,27,-11,21
FC Salzburg,3758,1,15,7,2,50,18,32,52
SK Sturm Gra,3758,2,12,4,8,33,27,6,40
Rapid Vienna,3758,3,9,10,5,35,27,8,37
LASK Linz,3758,4,10,5,9,30,29,1,35
Vienna,3758,5,7,5,12,24,42,-18,26
Mattersburg,3758,6,6,5,13,31,44,-13,23
SC Rheindorf,3758,7,4,6,14,17,33,-16,18
FC Salzburg,3759,1,15,6,3,47,19,28,51
SK Sturm Gra,3759,2,12,3,9,31,33,-2,39
Rapid Vienna,3759,3,7,11,6,33,28,5,32
LASK Linz,3759,4,8,8,8,27,26,1,32
Vienna,3759,5,7,5,12,27,41,-14,26
Mattersburg,3759,6,6,7,11,31,41,-10,25
SC Rheindorf,3759,7,5,8,11,21,29,-8,23
FC Salzburg,3760,1,14,7,3,43,17,26,49
SK Sturm Gra,3760,2,12,5,7,31,28,3,41
Rapid Vienna,3760,3,7,12,5,36,29,7,33
LASK Linz,3760,4,9,6,9,28,27,1,33
SC Rheindorf,3760,5,7,6,11,22,28,-6,27
Mattersburg,3760,6,6,5,13,31,44,-13,23
Vienna,3760,7,6,5,13,24,42,-18,23
FC Salzburg,3761,1,15,7,2,48,16,32,52
SK Sturm Gra,3761,2,12,3,9,31,32,-1,39
Rapid Vienna,3761,3,8,10,6,35,28,7,34
LASK Linz,3761,4,9,5,10,26,26,0,32
SC Rheindorf,3761,5,7,5,12,19,27,-8,26
Mattersburg,3761,6,6,6,12,30,44,-14,24
Vienna,3761,7,6,6,12,25,41,-16,24
FC Salzburg,3762,1,15,7,2,49,18,31,52
SK Sturm Gra,3762,2,13,4,7,32,31,1,43
Rapid Vienna,3762,3,8,10,6,35,28,7,34
LASK Linz,3762,4,9,6,9,27,25,2,33
Vienna,3762,5,7,6,11,30,40,-10,27
Mattersburg,3762,6,6,5,13,32,46,-14,23
SC Rheindorf,3762,7,4,6,14,17,34,-17,18
FC Salzburg,3763,1,14,7,3,45,19,26,49
SK Sturm Gra,3763,2,12,5,7,31,27,4,41
Rapid Vienna,3763,3,10,9,5,37,24,13,39
LASK Linz,3763,4,7,8,9,24,27,-3,29
Vienna,3763,5,7,6,11,29,42,-13,27
Mattersburg,3763,6,6,6,12,32,45,-13,24
SC Rheindorf,3763,7,4,7,13,15,29,-14,19
FC Salzburg,3764,1,15,7,2,45,16,29,52
SK Sturm Gra,3764,2,13,5,6,31,25,6,44
LASK Linz,3764,3,9,7,8,27,24,3,34
Rapid Vienna,3764,4,8,9,7,35,29,6,33
Vienna,3764,5,7,5,12,25,41,-16,26
SC Rheindorf,3764,6,5,6,13,19,32,-13,21
Mattersburg,3764,7,5,5,14,29,44,-15,20
FC Salzburg,3765,1,15,7,2,54,19,35,52
SK Sturm Gra,3765,2,11,5,8,33,33,0,38
Rapid Vienna,3765,3,7,12,5,36,29,7,33
Mattersburg,3765,4,8,5,11,32,47,-15,29
LASK Linz,3765,5,7,7,10,29,35,-6,28
SC Rheindorf,3765,6,6,6,12,24,30,-6,24
Vienna,3765,7,6,6,12,26,41,-15,24
FC Salzburg,3766,1,15,7,2,47,20,27,52
SK Sturm Gra,3766,2,12,4,8,31,26,5,40
Rapid Vienna,3766,3,8,9,7,35,30,5,33
LASK Linz,3766,4,9,5,10,28,31,-3,32
SC Rheindorf,3766,5,7,6,11,21,27,-6,27
Vienna,3766,6,7,5,12,26,39,-13,26
Mattersburg,3766,7,5,6,13,30,45,-15,21
FC Salzburg,3767,1,13,7,4,41,19,22,46
SK Sturm Gra,3767,2,11,6,7,30,29,1,39
Rapid Vienna,3767,3,9,10,5,36,25,11,37
LASK Linz,3767,4,10,5,9,30,25,5,35
Vienna,3767,5,7,6,11,27,40,-13,27
Mattersburg,3767,6,6,6,12,30,42,-12,24
SC Rheindorf,3767,7,5,6,13,18,32,-14,21
FC Salzburg,3768,1,15,7,2,45,17,28,52
SK Sturm Gra,3768,2,13,5,6,34,27,7,44
LASK Linz,3768,3,10,5,9,29,26,3,35
Rapid Vienna,3768,4,8,10,6,35,28,7,34
Mattersburg,3768,5,6,5,13,30,43,-13,23
Vienna,3768,6,6,5,13,23,41,-18,23
SC Rheindorf,3768,7,5,5,14,20,34,-14,20
FC Salzburg,3769,1,13,8,3,44,20,24,47
SK Sturm Gra,3769,2,13,4,7,32,27,5,43
Rapid Vienna,3769,3,9,10,5,39,26,13,37
LASK Linz,3769,4,8,7,9,26,28,-2,31
Vienna,3769,5,8,5,11,28,38,-10,29
Mattersburg,3769,6,6,6,12,30,42,-12,24
SC Rheindorf,3769,7,4,6,14,16,34,-18,18
FC Salzburg,3770,1,14,7,3,45,18,27,49
SK Sturm Gra,3770,2,14,3,7,36,27,9,45
Rapid Vienna,3770,3,9,10,5,37,29,8,37
LASK Linz,3770,4,9,5,10,28,29,-1,32
Vienna,3770,5,7,5,12,27,44,-17,26
Mattersburg,3770,6,6,6,12,30,41,-11,24
SC Rheindorf,3770,7,4,6,14,17,32,-15,18
FC Salzburg,3771,1,16,6,2,47,17,30,54
SK Sturm Gra,3771,2,11,5,8,34,33,1,38
LASK Linz,3771,3,9,7,8,34,29,5,34
Rapid Vienna,3771,4,7,11,6,38,36,2,32
Vienna,3771,5,6,6,12,24,39,-15,24
Mattersburg,3771,6,5,8,11,30,42,-12,23
SC Rheindorf,3771,7,5,7,12,21,32,-11,22
FC Salzburg,3772,1,15,7,2,48,19,29,52
SK Sturm Gra,3772,2,14,3,7,33,29,4,45
Rapid Vienna,3772,3,8,10,6,36,29,7,34
LASK Linz,3772,4,9,6,9,28,27,1,33
Vienna,3772,5,7,5,12,26,40,-14,26
Mattersburg,3772,6,6,6,12,31,43,-12,24
SC Rheindorf,3772,7,4,5,15,20,35,-15,17
FC Salzburg,3773,1,15,6,3,43,18,25,51
SK Sturm Gra,3773,2,12,5,7,32,28,4,41
Rapid Vienna,3773,3,7,11,6,34,28,6,32
LASK Linz,3773,4,7,8,9,26,28,-2,29
SC Rheindorf,3773,5,7,5,12,22,30,-8,26
Vienna,3773,6,7,5,12,25,39,-14,26
Mattersburg,3773,7,6,6,12,31,42,-11,24
FC Salzburg,3774,1,15,7,2,49,18,31,52
SK Sturm Gra,3774,2,13,4,7,34,33,1,43
Rapid Vienna,3774,3,8,11,5,39,28,11,35
LASK Linz,3774,4,7,8,9,26,28,-2,29
Vienna,3774,5,7,6,11,27,39,-12,27
Mattersburg,3774,6,5,7,12,28,42,-14,22
SC Rheindorf,3774,7,4,7,13,19,34,-15,19
FC Salzburg,3775,1,14,7,3,46,20,26,49
SK Sturm Gra,3775,2,12,5,7,33,29,4,41
Rapid Vienna,3775,3,10,9,5,38,30,8,39
LASK Linz,3775,4,7,7,10,25,29,-4,28
Mattersburg,3775,5,6,7,11,32,43,-11,25
Vienna,3775,6,6,6,12,25,40,-15,24
SC Rheindorf,3775,7,5,7,12,20,28,-8,22
FC Salzburg,3776,1,15,7,2,46,17,29,52
SK Sturm Gra,3776,2,12,3,9,31,29,2,39
Rapid Vienna,3776,3,9,10,5,34,26,8,37
LASK Linz,3776,4,8,6,10,27,29,-2,30
Vienna,3776,5,7,6,11,27,40,-13,27
Mattersburg,3776,6,6,6,12,29,42,-13,24
SC Rheindorf,3776,7,5,6,13,18,29,-11,21
FC Salzburg,3777,1,15,7,2,50,20,30,52
SK Sturm Gra,3777,2,12,5,7,36,30,6,41
Rapid Vienna,3777,3,8,9,7,36,34,2,33
LASK Linz,3777,4,7,7,10,26,30,-4,28
Vienna,3777,5,7,5,12,28,42,-14,26
SC Rheindorf,3777,6,6,7,11,21,28,-7,25
Mattersburg,3777,7,6,6,12,30,43,-13,24
FC Salzburg,3778,1,14,6,4,44,19,25,48
SK Sturm Gra,3778,2,12,5,7,34,29,5,41
Rapid Vienna,3778,3,10,9,5,39,27,12,39
LASK Linz,3778,4,8,6,10,27,30,-3,30
Mattersburg,3778,5,8,6,10,34,40,-6,30
Vienna,3778,6,6,6,12,25,41,-16,24
SC Rheindorf,3778,7,4,6,14,17,34,-17,18
FC Salzburg,3779,1,15,6,3,45,18,27,51
SK Sturm Gra,3779,2,13,4,7,36,27,9,43
Rapid Vienna,3779,3,7,9,8,32,31,1,30
LASK Linz,3779,4,8,5,11,25,30,-5,29
Vienna,3779,5,8,5,11,26,37,-11,29
Mattersburg,3779,6,7,5,12,29,42,-13,26
SC Rheindorf,3779,7,6,6,12,19,27,-8,24
FC Salzburg,3780,1,15,6,3,46,18,28,51
SK Sturm Gra,3780,2,11,6,7,31,30,1,39
Rapid Vienna,3780,3,9,10,5,42,28,14,37
LASK Linz,3780,4,8,8,8,28,28,0,32
Mattersburg,3780,5,6,7,11,32,41,-9,25
Vienna,3780,6,6,5,13,23,43,-20,23
SC Rheindorf,3780,7,4,8,12,19,33,-14,20
FC Salzburg,3781,1,15,6,3,45,20,25,51
Rapid Vienna,3781,2,10,9,5,38,24,14,39
SK Sturm Gra,3781,3,12,3,9,30,32,-2,39
LASK Linz,3781,4,9,6,9,28,27,1,33
Vienna,3781,5,7,5,12,26,40,-14,26
Mattersburg,3781,6,6,5,13,31,44,-13,23
SC Rheindorf,3781,7,5,6,13,19,30,-11,21
FC Salzburg,3782,1,15,7,2,47,19,28,52
SK Sturm Gra,3782,2,12,5,7,36,31,5,41
LASK Linz,3782,3,10,5,9,28,28,0,35
Rapid Vienna,3782,4,7,11,6,34,28,6,32
Mattersburg,3782,5,7,5,12,33,41,-8,26
Vienna,3782,6,6,6,12,26,42,-16,24
SC Rheindorf,3782,7,4,7,13,16,31,-15,19
FC Salzburg,3783,1,14,6,4,43,21,22,48
SK Sturm Gra,3783,2,12,5,7,34,29,5,41
Rapid Vienna,3783,3,8,11,5,35,26,9,35
Vienna,3783,4,8,5,11,28,38,-10,29
LASK Linz,3783,5,7,6,11,25,32,-7,27
Mattersburg,3783,6,7,5,12,31,43,-12,26
SC Rheindorf,3783,7,6,6,12,24,31,-7,24
FC Salzburg,3784,1,15,7,2,44,15,29,52
SK Sturm Gra,3784,2,12,5,7,30,26,4,41
Rapid Vienna,3784,3,8,11,5,34,26,8,35
LASK Linz,3784,4,8,8,8,28,28,0,32
Vienna,3784,5,7,6,11,26,38,-12,27
Mattersburg,3784,6,6,5,13,31,45,-14,23
SC Rheindorf,3784,7,4,6,14,17,32,-15,18
FC Salzburg,3785,1,14,8,2,43,17,26,50
SK Sturm Gra,3785,2,12,5,7,36,28,8,41
Rapid Vienna,3785,3,8,10,6,33,31,2,34
LASK Linz,3785,4,8,6,10,29,30,-1,30
Mattersburg,3785,5,7,5,12,30,40,-10,26
SC Rheindorf,3785,6,6,6,12,19,29,-10,24
Vienna,3785,7,6,6,12,24,39,-15,24
FC Salzburg,3786,1,15,6,3,44,17,27,51
SK Sturm Gra,3786,2,12,3,9,33,31,2,39
Rapid Vienna,3786,3,9,9,6,38,28,10,36
LASK Linz,3786,4,8,6,10,27,33,-6,30
Vienna,3786,5,8,5,11,27,39,-12,29
SC Rheindorf,3786,6,7,5,12,19,27,-8,26
Mattersburg,3786,7,5,6,13,30,43,-13,21
FC Salzburg,3787,1,15,6,3,45,21,24,51
SK Sturm Gra,3787,2,13,3,8,37,30,7,42
Rapid Vienna,3787,3,8,9,7,35,30,5,33
LASK Linz,3787,4,8,6,10,28,32,-4,30
Vienna,3787,5,8,5,11,28,39,-11,29
SC Rheindorf,3787,6,6,6,12,19,28,-9,24
Mattersburg,3787,7,5,7,12,28,40,-12,22
FC Salzburg,3788,1,16,6,2,45,15,30,54
SK Sturm Gra,3788,2,13,4,7,33,27,6,43
Rapid Vienna,3788,3,8,9,7,36,30,6,33
LASK Linz,3788,4,8,7,9,28,28,0,31
Vienna,3788,5,7,5,12,25,38,-13,26
SC Rheindorf,3788,6,6,5,13,19,31,-12,23
Mattersburg,3788,7,5,6,13,27,44,-17,21
FC Salzburg,3789,1,15,7,2,46,17,29,52
SK Sturm Gra,3789,2,12,4,8,30,26,4,40
Rapid Vienna,3789,3,9,10,5,38,30,8,37
LASK Linz,3789,4,7,6,11,25,33,-8,27
Mattersburg,3789,5,7,5,12,34,45,-11,26
Vienna,3789,6,7,5,12,27,40,-13,26
SC Rheindorf,3789,7,5,7,12,19,28,-9,22
FC Salzburg,3790,1,14,7,3,44,16,28,49
SK Sturm Gra,3790,2,14,4,6,34,26,8,46
Rapid Vienna,3790,3,9,10,5,35,25,10,37
LASK Linz,3790,4,8,7,9,26,28,-2,31
Vienna,3790,5,6,6,12,24,43,-19,24
SC Rheindorf,3790,6,5,6,13,22,33,-11,21
Mattersburg,3790,7,5,6,13,27,41,-14,21
FC Salzburg,3791,1,13,7,4,43,20,23,46
SK Sturm Gra,3791,2,13,4,7,35,28,7,43
Rapid Vienna,3791,3,8,11,5,34,27,7,35
LASK Linz,3791,4,7,8,9,26,31,-5,29
Vienna,3791,5,8,5,11,25,37,-12,29
Mattersburg,3791,6,6,7,11,28,38,-10,25
SC Rheindorf,3791,7,5,6,13,20,30,-10,21
FC Salzburg,3792,1,14,8,2,45,17,28,50
SK Sturm Gra,3792,2,13,4,7,32,27,5,43
LASK Linz,3792,3,10,5,9,29,28,1,35
Rapid Vienna,3792,4,8,9,7,34,30,4,33
Vienna,3792,5,6,6,12,23,38,-15,24
SC Rheindorf,3792,6,6,5,13,22,30,-8,23
Mattersburg,3792,7,6,5,13,27,42,-15,23
FC Salzburg,3793,1,14,7,3,45,20,25,49
SK Sturm Gra,3793,2,12,4,8,35,31,4,40
Rapid Vienna,3793,3,8,10,6,35,30,5,34
LASK Linz,3793,4,9,7,8,28,27,1,34
Vienna,3793,5,7,5,12,25,39,-14,26
Mattersburg,3793,6,6,7,11,28,38,-10,25
SC Rheindorf,3793,7,4,8,12,16,27,-11,20
FC Salzburg,3794,1,16,6,2,52,19,33,54
SK Sturm Gra,3794,2,12,5,7,32,32,0,41
Rapid Vienna,3794,3,7,11,6,34,29,5,32
LASK Linz,3794,4,8,6,10,26,31,-5,30
SC Rheindorf,3794,5,7,6,11,23,28,-5,27
Vienna,3794,6,6,6,12,25,40,-15,24
Mattersburg,3794,7,5,6,13,32,45,-13,21
FC Salzburg,3795,1,13,7,4,42,18,24,46
SK Sturm Gra,3795,2,13,4,7,33,26,7,43
Rapid Vienna,3795,3,11,9,4,37,25,12,42
Mattersburg,3795,4,8,6,10,31,37,-6,30
LASK Linz,3795,5,8,5,11,27,32,-5,29
Vienna,3795,6,6,5,13,24,43,-19,23
SC Rheindorf,3795,7,4,6,14,18,31,-13,18
FC Salzburg,3796,1,15,7,2,49,15,34,52
SK Sturm Gra,3796,2,13,4,7,32,30,2,43
Rapid Vienna,3796,3,8,10,6,34,29,5,34
LASK Linz,3796,4,7,8,9,25,27,-2,29
Vienna,3796,5,7,6,11,25,38,-13,27
Mattersburg,3796,6,6,6,12,28,42,-14,24
SC Rheindorf,3796,7,5,5,14,18,30,-12,20
FC Salzburg,3797,1,15,6,3,55,21,34,51
SK Sturm Gra,3797,2,11,5,8,32,35,-3,38
Rapid Vienna,3797,3,8,11,5,37,31,6,35
LASK Linz,3797,4,8,6,10,25,28,-3,30
Vienna,3797,5,7,5,12,27,39,-12,26
SC Rheindorf,3797,6,6,7,11,21,28,-7,25
Mattersburg,3797,7,6,6,12,28,43,-15,24
FC Salzburg,3798,1,15,6,3,49,16,33,51
SK Sturm Gra,3798,2,14,3,7,33,32,1,45
Rapid Vienna,3798,3,8,10,6,35,30,5,34
LASK Linz,3798,4,7,8,9,26,28,-2,29
Vienna,3798,5,7,6,11,25,38,-13,27
Mattersburg,3798,6,5,7,12,28,41,-13,22
SC Rheindorf,3798,7,5,6,13,19,30,-11,21
FC Salzburg,3799,1,13,8,3,43,19,24,47
SK Sturm Gra,3799,2,14,3,7,34,28,6,45
Rapid Vienna,3799,3,9,10,5,36,25,11,37
LASK Linz,3799,4,8,6,10,26,28,-2,30
Vienna,3799,5,7,6,11,28,39,-11,27
Mattersburg,3799,6,6,7,11,31,43,-12,25
SC Rheindorf,3799,7,4,6,14,18,34,-16,18
FC Salzburg,3800,1,16,6,2,49,15,34,54
SK Sturm Gra,3800,2,13,4,7,35,33,2,43
Rapid Vienna,3800,3,7,10,7,36,31,5,31
LASK Linz,3800,4,7,7,10,29,32,-3,28
SC Rheindorf,3800,5,7,6,11,25,30,-5,27
Mattersburg,3800,6,6,6,12,28,42,-14,24
Vienna,3800,7,6,5,13,23,42,-19,23
FC Salzburg,3801,1,15,7,2,45,18,27,52
SK Sturm Gra,3801,2,12,4,8,34,31,3,40
Rapid Vienna,3801,3,9,11,4,40,28,12,38
LASK Linz,3801,4,7,5,12,25,32,-7,26
Vienna,3801,5,7,5,12,26,41,-15,26
SC Rheindorf,3801,6,6,6,12,20,29,-9,24
Mattersburg,3801,7,6,6,12,29,40,-11,24
FC Salzburg,3802,1,16,6,2,49,15,34,54
Rapid Vienna,3802,2,10,9,5,41,29,12,39
SK Sturm Gra,3802,3,11,3,10,29,34,-5,36
LASK Linz,3802,4,8,6,10,25,28,-3,30
Vienna,3802,5,7,5,12,27,40,-13,26
Mattersburg,3802,6,6,6,12,32,46,-14,24
SC Rheindorf,3802,7,6,5,13,23,34,-11,23
FC Salzburg,3803,1,15,6,3,50,20,30,51
SK Sturm Gra,3803,2,12,4,8,33,32,1,40
Rapid Vienna,3803,3,8,10,6,35,27,8,34
LASK Linz,3803,4,9,6,9,28,28,0,33
Vienna,3803,5,7,5,12,27,42,-15,26
Mattersburg,3803,6,6,6,12,32,45,-13,24
SC Rheindorf,3803,7,5,7,12,19,30,-11,22
FC Salzburg,3804,1,14,6,4,45,21,24,48
SK Sturm Gra,3804,2,14,3,7,34,29,5,45
Rapid Vienna,3804,3,10,9,5,38,26,12,39
LASK Linz,3804,4,8,5,11,27,31,-4,29
Mattersburg,3804,5,7,6,11,31,40,-9,27
Vienna,3804,6,6,6,12,24,39,-15,24
SC Rheindorf,3804,7,5,5,14,20,33,-13,20
FC Salzburg,3805,1,14,7,3,47,21,26,49
SK Sturm Gra,3805,2,12,4,8,34,32,2,40
Rapid Vienna,3805,3,9,10,5,39,31,8,37
LASK Linz,3805,4,7,8,9,28,30,-2,29
Vienna,3805,5,7,6,11,27,39,-12,27
SC Rheindorf,3805,6,6,6,12,20,29,-9,24
Mattersburg,3805,7,6,5,13,29,42,-13,23
FC Salzburg,3806,1,13,8,3,40,17,23,47
SK Sturm Gra,3806,2,14,4,6,38,26,12,46
Rapid Vienna,3806,3,8,11,5,39,30,9,35
LASK Linz,3806,4,7,8,9,31,34,-3,29
Mattersburg,3806,5,7,7,10,36,40,-4,28
Vienna,3806,6,6,6,12,24,39,-15,24
SC Rheindorf,3806,7,4,6,14,17,39,-22,18
FC Salzburg,3807,1,14,6,4,45,19,26,48
SK Sturm Gra,3807,2,14,3,7,37,29,8,45
Rapid Vienna,3807,3,8,10,6,38,32,6,34
Mattersburg,3807,4,8,6,10,30,36,-6,30
LASK Linz,3807,5,7,6,11,26,32,-6,27
Vienna,3807,6,7,6,11,25,38,-13,27
SC Rheindorf,3807,7,5,5,14,17,32,-15,20
FC Salzburg,3808,1,16,6,2,43,16,27,54
Rapid Vienna,3808,2,9,9,6,34,27,7,36
SK Sturm Gra,3808,3,11,3,10,29,29,0,36
LASK Linz,3808,4,9,7,8,30,28,2,34
Mattersburg,3808,5,6,7,11,33,40,-7,25
Vienna,3808,6,6,6,12,26,41,-15,24
SC Rheindorf,3808,7,5,6,13,17,31,-14,21
FC Salzburg,3809,1,13,8,3,42,20,22,47
SK Sturm Gra,3809,2,12,4,8,32,29,3,40
LASK Linz,3809,3,10,6,8,30,27,3,36
Rapid Vienna,3809,4,7,11,6,34,29,5,32
Mattersburg,3809,5,7,7,10,32,37,-5,28
Vienna,3809,6,7,5,12,27,40,-13,26
SC Rheindorf,3809,7,5,5,14,18,33,-15,20
FC Salzburg,3810,1,16,6,2,45,16,29,54
SK Sturm Gra,3810,2,12,4,8,31,28,3,40
Rapid Vienna,3810,3,8,10,6,34,27,7,34
LASK Linz,3810,4,7,6,11,27,35,-8,27
Vienna,3810,5,7,5,12,25,39,-14,26
SC Rheindorf,3810,6,6,7,11,19,26,-7,25
Mattersburg,3810,7,6,6,12,33,43,-10,24
FC Salzburg,3811,1,14,6,4,43,20,23,48
Rapid Vienna,3811,2,10,9,5,39,26,13,39
SK Sturm Gra,3811,3,11,3,10,29,32,-3,36
LASK Linz,3811,4,8,6,10,24,27,-3,30
Mattersburg,3811,5,7,7,10,31,39,-8,28
SC Rheindorf,3811,6,6,7,11,21,28,-7,25
Vienna,3811,7,6,6,12,24,39,-15,24
FC Salzburg,3812,1,14,7,3,47,20,27,49
Rapid Vienna,3812,2,10,9,5,38,25,13,39
SK Sturm Gra,3812,3,12,3,9,32,30,2,39
LASK Linz,3812,4,9,5,10,28,30,-2,32
Mattersburg,3812,5,8,6,10,35,41,-6,30
Vienna,3812,6,6,5,13,25,44,-19,23
SC Rheindorf,3812,7,5,5,14,17,32,-15,20
FC Salzburg,3813,1,15,7,2,47,17,30,52
SK Sturm Gra,3813,2,13,3,8,33,29,4,42
Rapid Vienna,3813,3,10,9,5,38,26,12,39
LASK Linz,3813,4,8,6,10,27,30,-3,30
Mattersburg,3813,5,7,5,12,34,45,-11,26
Vienna,3813,6,6,6,12,24,40,-16,24
SC Rheindorf,3813,7,4,6,14,17,33,-16,18
FC Salzburg,3814,1,15,7,2,47,19,28,52
SK Sturm Gra,3814,2,13,4,7,34,27,7,43
LASK Linz,3814,3,9,5,10,30,29,1,32
Rapid Vienna,3814,4,7,10,7,33,32,1,31
SC Rheindorf,3814,5,6,6,12,18,27,-9,24
Mattersburg,3814,6,6,6,12,33,44,-11,24
Vienna,3814,7,6,6,12,25,42,-17,24
FC Salzburg,3815,1,15,7,2,46,18,28,52
SK Sturm Gra,3815,2,12,4,8,31,28,3,40
Rapid Vienna,3815,3,8,10,6,36,29,7,34
LASK Linz,3815,4,9,7,8,29,28,1,34
Vienna,3815,5,7,6,11,28,40,-12,27
Mattersburg,3815,6,6,5,13,29,42,-13,23
SC Rheindorf,3815,7,5,5,14,17,31,-14,20
FC Salzburg,3816,1,14,7,3,44,17,27,49
SK Sturm Gra,3816,2,13,4,7,35,27,8,43
Rapid Vienna,3816,3,9,10,5,36,26,10,37
LASK Linz,3816,4,8,6,10,27,33,-6,30
Vienna,3816,5,8,5,11,26,37,-11,29
SC Rheindorf,3816,6,5,7,12,21,31,-10,22
Mattersburg,3816,7,5,5,14,28,46,-18,20
FC Salzburg,3817,1,15,6,3,44,18,26,51
SK Sturm Gra,3817,2,13,4,7,36,30,6,43
Rapid Vienna,3817,3,10,9,5,39,28,11,39
LASK Linz,3817,4,7,7,10,25,30,-5,28
Mattersburg,3817,5,6,7,11,30,40,-10,25
Vienna,3817,6,6,5,13,24,41,-17,23
SC Rheindorf,3817,7,4,8,12,17,28,-11,20
FC Salzburg,3818,1,13,9,2,43,19,24,48
SK Sturm Gra,3818,2,11,6,7,29,27,2,39
Rapid Vienna,3818,3,8,11,5,37,28,9,35
LASK Linz,3818,4,7,8,9,29,31,-2,29
SC Rheindorf,3818,5,6,7,11,18,26,-8,25
Mattersburg,3818,6,6,7,11,30,40,-10,25
Vienna,3818,7,6,6,12,24,39,-15,24
FC Salzburg,3819,1,13,8,3,45,22,23,47
SK Sturm Gra,3819,2,12,4,8,36,33,3,40
Rapid Vienna,3819,3,8,12,4,37,28,9,36
LASK Linz,3819,4,7,6,11,25,32,-7,27
Mattersburg,3819,5,7,6,11,37,45,-8,27
Vienna,3819,6,7,5,12,27,42,-15,26
SC Rheindorf,3819,7,6,7,11,24,29,-5,25
FC Salzburg,3820,1,15,6,3,44,18,26,51
SK Sturm Gra,3820,2,14,3,7,32,27,5,45
Rapid Vienna,3820,3,7,10,7,34,30,4,31
LASK Linz,3820,4,8,6,10,29,30,-1,30
Vienna,3820,5,8,5,11,25,37,-12,29
SC Rheindorf,3820,6,6,6,12,21,30,-9,24
Mattersburg,3820,7,5,6,13,30,43,-13,21
FC Salzburg,3821,1,14,6,4,44,21,23,48
SK Sturm Gra,3821,2,13,4,7,34,29,5,43
Rapid Vienna,3821,3,8,10,6,37,27,10,34
LASK Linz,3821,4,8,8,8,26,25,1,32
Vienna,3821,5,8,5,11,30,41,-11,29
Mattersburg,3821,6,6,6,12,30,42,-12,24
SC Rheindorf,3821,7,5,5,14,17,33,-16,20
FC Salzburg,3822,1,14,7,3,43,17,26,49
SK Sturm Gra,3822,2,14,3,7,32,27,5,45
Rapid Vienna,3822,3,10,9,5,39,27,12,39
LASK Linz,3822,4,8,5,11,27,31,-4,29
Vienna,3822,5,7,6,11,24,37,-13,27
Mattersburg,3822,6,7,5,12,29,41,-12,26
SC Rheindorf,3822,7,4,5,15,17,31,-14,17
FC Salzburg,3823,1,14,7,3,45,19,26,49
SK Sturm Gra,3823,2,13,4,7,36,31,5,43
Rapid Vienna,3823,3,8,10,6,38,32,6,34
LASK Linz,3823,4,8,6,10,28,30,-2,30
Mattersburg,3823,5,7,6,11,33,39,-6,27
Vienna,3823,6,7,5,12,24,40,-16,26
SC Rheindorf,3823,7,5,6,13,18,31,-13,21
FC Salzburg,3824,1,14,6,4,46,18,28,48
SK Sturm Gra,3824,2,14,4,6,33,25,8,46
Rapid Vienna,3824,3,9,9,6,35,27,8,36
LASK Linz,3824,4,9,6,9,29,32,-3,33
Mattersburg,3824,5,7,5,12,34,44,-10,26
Vienna,3824,6,7,5,12,28,42,-14,26
SC Rheindorf,3824,7,4,5,15,18,35,-17,17
FC Salzburg,3825,1,14,8,2,42,17,25,50
SK Sturm Gra,3825,2,13,4,7,31,26,5,43
LASK Linz,3825,3,9,6,9,28,27,1,33
Rapid Vienna,3825,4,7,10,7,33,29,4,31
Vienna,3825,5,7,6,11,28,41,-13,27
SC Rheindorf,3825,6,7,5,12,20,28,-8,26
Mattersburg,3825,7,5,5,14,30,44,-14,20
FC Salzburg,3826,1,13,6,5,44,21,23,45
SK Sturm Gra,3826,2,12,4,8,31,29,2,40
Rapid Vienna,3826,3,10,9,5,37,28,9,39
LASK Linz,3826,4,9,6,9,29,27,2,33
Mattersburg,3826,5,7,6,11,32,42,-10,27
SC Rheindorf,3826,6,6,6,12,24,31,-7,24
Vienna,3826,7,6,5,13,23,42,-19,23
FC Salzburg,3827,1,14,7,3,46,19,27,49
SK Sturm Gra,3827,2,13,4,7,33,31,2,43
Rapid Vienna,3827,3,8,10,6,35,28,7,34
LASK Linz,3827,4,8,7,9,27,27,0,31
Vienna,3827,5,8,5,11,26,38,-12,29
SC Rheindorf,3827,6,5,7,12,18,29,-11,22
Mattersburg,3827,7,5,6,13,27,40,-13,21
FC Salzburg,3828,1,14,8,2,45,20,25,50
SK Sturm Gra,3828,2,12,4,8,34,33,1,40
Rapid Vienna,3828,3,8,10,6,34,29,5,34
LASK Linz,3828,4,8,7,9,27,29,-2,31
Vienna,3828,5,7,5,12,25,39,-14,26
SC Rheindorf,3828,6,6,6,12,21,26,-5,24
Mattersburg,3828,7,6,6,12,29,39,-10,24
FC Salzburg,3829,1,14,8,2,43,17,26,50
LASK Linz,3829,2,11,5,8,29,26,3,38
SK Sturm Gra,3829,3,11,5,8,34,32,2,38
Rapid Vienna,3829,4,7,10,7,34,31,3,31
Vienna,3829,5,7,6,11,26,37,-11,27
SC Rheindorf,3829,6,6,6,12,23,30,-7,24
Mattersburg,3829,7,5,6,13,27,43,-16,21
FC Salzburg,3830,1,13,8,3,43,20,23,47
SK Sturm Gra,3830,2,13,4,7,31,27,4,43
Rapid Vienna,3830,3,9,9,6,37,27,10,36
LASK Linz,3830,4,10,6,8,31,28,3,36
Mattersburg,3830,5,7,6,11,35,43,-8,27
Vienna,3830,6,6,6,12,27,42,-15,24
SC Rheindorf,3830,7,4,5,15,18,35,-17,17
FC Salzburg,3831,1,14,8,2,44,18,26,50
SK Sturm Gra,3831,2,12,4,8,31,30,1,40
LASK Linz,3831,3,10,5,9,32,29,3,35
Rapid Vienna,3831,4,7,11,6,37,31,6,32
Vienna,3831,5,7,5,12,25,39,-14,26
Mattersburg,3831,6,6,6,12,30,42,-12,24
SC Rheindorf,3831,7,5,7,12,19,29,-10,22
FC Salzburg,3832,1,16,6,2,48,16,32,54
SK Sturm Gra,3832,2,12,5,7,31,29,2,41
Rapid Vienna,3832,3,9,9,6,35,27,8,36
LASK Linz,3832,4,7,7,10,25,29,-4,28
Mattersburg,3832,5,6,7,11,31,42,-11,25
Vienna,3832,6,6,6,12,26,41,-15,24
SC Rheindorf,3832,7,5,6,13,17,29,-12,21
FC Salzburg,3833,1,15,7,2,43,17,26,52
SK Sturm Gra,3833,2,12,5,7,31,26,5,41
Rapid Vienna,3833,3,9,9,6,34,27,7,36
LASK Linz,3833,4,9,6,9,27,27,0,33
Mattersburg,3833,5,6,7,11,29,39,-10,25
Vienna,3833,6,6,5,13,24,40,-16,23
SC Rheindorf,3833,7,4,7,13,16,28,-12,19
FC Salzburg,3834,1,14,6,4,43,17,26,48
SK Sturm Gra,3834,2,12,5,7,32,29,3,41
Rapid Vienna,3834,3,8,10,6,32,26,6,34
LASK Linz,3834,4,8,6,10,26,29,-3,30
Mattersburg,3834,5,8,5,11,31,39,-8,29
Vienna,3834,6,7,5,12,25,40,-15,26
SC Rheindorf,3834,7,5,7,12,20,29,-9,22
FC Salzburg,3835,1,14,7,3,47,22,25,49
SK Sturm Gra,3835,2,12,5,7,34,32,2,41
Rapid Vienna,3835,3,9,11,4,38,26,12,38
LASK Linz,3835,4,7,7,10,24,30,-6,28
Vienna,3835,5,7,6,11,27,39,-12,27
Mattersburg,3835,6,5,8,11,30,41,-11,23
SC Rheindorf,3835,7,5,6,13,21,31,-10,21
FC Salzburg,3836,1,14,8,2,46,20,26,50
SK Sturm Gra,3836,2,12,5,7,31,28,3,41
Rapid Vienna,3836,3,7,9,8,38,36,2,30
LASK Linz,3836,4,8,6,10,27,32,-5,30
SC Rheindorf,3836,5,8,5,11,25,28,-3,29
Vienna,3836,6,7,6,11,31,39,-8,27
Mattersburg,3836,7,6,5,13,31,46,-15,23
FC Salzburg,3837,1,15,7,2,51,18,33,52
SK Sturm Gra,3837,2,13,3,8,32,29,3,42
Rapid Vienna,3837,3,9,9,6,36,29,7,36
LASK Linz,3837,4,9,5,10,29,29,0,32
Mattersburg,3837,5,7,6,11,34,41,-7,27
Vienna,3837,6,6,5,13,24,47,-23,23
SC Rheindorf,3837,7,5,5,14,19,32,-13,20
FC Salzburg,3838,1,14,7,3,44,19,25,49
SK Sturm Gra,3838,2,14,3,7,33,26,7,45
Rapid Vienna,3838,3,8,10,6,37,31,6,34
LASK Linz,3838,4,9,6,9,30,29,1,33
Mattersburg,3838,5,6,8,10,32,41,-9,26
Vienna,3838,6,6,6,12,24,39,-15,24
SC Rheindorf,3838,7,4,6,14,17,32,-15,18
FC Salzburg,3839,1,13,8,3,42,18,24,47
SK Sturm Gra,3839,2,12,4,8,30,28,2,40
Rapid Vienna,3839,3,8,11,5,36,28,8,35
LASK Linz,3839,4,9,7,8,29,26,3,34
Vienna,3839,5,6,7,11,26,40,-14,25
Mattersburg,3839,6,6,6,12,31,42,-11,24
SC Rheindorf,3839,7,5,7,12,19,31,-12,22
FC Salzburg,3840,1,14,7,3,44,19,25,49
SK Sturm Gra,3840,2,14,3,7,33,29,4,45
Rapid Vienna,3840,3,7,9,8,35,32,3,30
SC Rheindorf,3840,4,8,5,11,24,25,-1,29
LASK Linz,3840,5,8,5,11,27,34,-7,29
Mattersburg,3840,6,6,7,11,32,40,-8,25
Vienna,3840,7,6,6,12,24,40,-16,24
FC Salzburg,3841,1,14,8,2,44,19,25,50
SK Sturm Gra,3841,2,11,6,7,32,29,3,39
Rapid Vienna,3841,3,9,11,4,37,27,10,38
LASK Linz,3841,4,7,7,10,27,32,-5,28
Vienna,3841,5,6,7,11,28,42,-14,25
SC Rheindorf,3841,6,6,6,12,21,27,-6,24
Mattersburg,3841,7,5,7,12,30,43,-13,22
FC Salzburg,3842,1,13,8,3,44,20,24,47
SK Sturm Gra,3842,2,14,4,6,35,27,8,46
Rapid Vienna,3842,3,8,9,7,33,29,4,33
LASK Linz,3842,4,8,5,11,27,33,-6,29
Vienna,3842,5,7,6,11,26,39,-13,27
Mattersburg,3842,6,7,5,12,29,40,-11,26
SC Rheindorf,3842,7,6,5,13,22,28,-6,23
FC Salzburg,3843,1,14,7,3,43,17,26,49
SK Sturm Gra,3843,2,14,3,7,37,29,8,45
Rapid Vienna,3843,3,7,11,6,35,30,5,32
Mattersburg,3843,4,8,5,11,37,42,-5,29
LASK Linz,3843,5,7,7,10,28,37,-9,28
SC Rheindorf,3843,6,6,6,12,22,30,-8,24
Vienna,3843,7,6,5,13,24,41,-17,23
FC Salzburg,3844,1,14,7,3,45,22,23,49
SK Sturm Gra,3844,2,13,5,6,36,28,8,44
Rapid Vienna,3844,3,9,11,4,36,25,11,38
LASK Linz,3844,4,8,5,11,25,31,-6,29
Vienna,3844,5,6,6,12,27,42,-15,24
SC Rheindorf,3844,6,5,7,12,20,29,-9,22
Mattersburg,3844,7,5,7,12,31,43,-12,22
FC Salzburg,3845,1,15,6,3,49,21,28,51
SK Sturm Gra,3845,2,13,3,8,34,31,3,42
Rapid Vienna,3845,3,9,9,6,35,28,7,36
SC Rheindorf,3845,4,7,6,11,24,29,-5,27
LASK Linz,3845,5,7,6,11,25,31,-6,27
Mattersburg,3845,6,6,6,12,31,42,-11,24
Vienna,3845,7,6,6,12,27,43,-16,24
FC Salzburg,3846,1,14,8,2,44,17,27,50
SK Sturm Gra,3846,2,11,5,8,30,28,2,38
Rapid Vienna,3846,3,9,9,6,35,27,8,36
LASK Linz,3846,4,9,5,10,27,28,-1,32
Vienna,3846,5,6,7,11,25,39,-14,25
SC Rheindorf,3846,6,6,6,12,21,30,-9,24
Mattersburg,3846,7,6,6,12,29,42,-13,24
FC Salzburg,3847,1,16,6,2,49,18,31,54
SK Sturm Gra,3847,2,11,5,8,33,32,1,38
Rapid Vienna,3847,3,9,10,5,38,29,9,37
LASK Linz,3847,4,8,7,9,26,27,-1,31
Vienna,3847,5,6,6,12,24,39,-15,24
SC Rheindorf,3847,6,6,5,13,25,34,-9,23
Mattersburg,3847,7,5,7,12,29,45,-16,22
FC Salzburg,3848,1,14,7,3,44,17,27,49
SK Sturm Gra,3848,2,13,3,8,31,30,1,42
Rapid Vienna,3848,3,9,9,6,36,29,7,36
LASK Linz,3848,4,8,5,11,30,33,-3,29
Vienna,3848,5,8,5,11,27,39,-12,29
Mattersburg,3848,6,6,6,12,32,43,-11,24
SC Rheindorf,3848,7,6,5,13,22,31,-9,23
FC Salzburg,3849,1,15,7,2,44,18,26,52
Rapid Vienna,3849,2,9,10,5,36,25,11,37
SK Sturm Gra,3849,3,11,4,9,30,31,-1,37
LASK Linz,3849,4,9,6,9,28,28,0,33
Mattersburg,3849,5,7,5,12,32,41,-9,26
Vienna,3849,6,7,5,12,25,39,-14,26
SC Rheindorf,3849,7,5,5,14,18,31,-13,20
FC Salzburg,3850,1,15,6,3,47,20,27,51
SK Sturm Gra,3850,2,14,3,7,37,29,8,45
LASK Linz,3850,3,10,5,9,29,30,-1,35
Rapid Vienna,3850,4,8,9,7,36,30,6,33
Vienna,3850,5,8,5,11,26,38,-12,29
SC Rheindorf,3850,6,5,5,14,21,33,-12,20
Mattersburg,3850,7,5,5,14,27,43,-16,20
FC Salzburg,3851,1,13,8,3,47,22,25,47
SK Sturm Gra,3851,2,14,3,7,35,31,4,45
Rapid Vienna,3851,3,9,10,5,38,26,12,37
Mattersburg,3851,4,7,6,11,35,43,-8,27
LASK Linz,3851,5,7,5,12,25,36,-11,26
SC Rheindorf,3851,6,6,6,12,22,29,-7,24
Vienna,3851,7,6,6,12,28,43,-15,24
FC Salzburg,3852,1,14,6,4,43,18,25,48
SK Sturm Gra,3852,2,14,3,7,34,28,6,45
Rapid Vienna,3852,3,8,11,5,34,26,8,35
LASK Linz,3852,4,7,7,10,25,28,-3,28
SC Rheindorf,3852,5,7,6,11,22,29,-7,27
Mattersburg,3852,6,6,6,12,31,42,-11,24
Vienna,3852,7,6,5,13,24,42,-18,23
FC Salzburg,3853,1,13,6,5,41,20,21,45
SK Sturm Gra,3853,2,13,4,7,36,31,5,43
Rapid Vienna,3853,3,8,10,6,33,28,5,34
Mattersburg,3853,4,9,5,10,33,37,-4,32
LASK Linz,3853,5,7,7,10,25,29,-4,28
Vienna,3853,6,7,5,12,25,39,-14,26
SC Rheindorf,3853,7,6,5,13,22,31,-9,23
FC Salzburg,3854,1,15,7,2,49,17,32,52
SK Sturm Gra,3854,2,13,4,7,37,31,6,43
Rapid Vienna,3854,3,9,10,5,39,30,9,37
LASK Linz,3854,4,8,5,11,26,30,-4,29
Vienna,3854,5,7,5,12,27,40,-13,26
SC Rheindorf,3854,6,6,6,12,20,29,-9,24
Mattersburg,3854,7,5,5,14,29,50,-21,20
FC Salzburg,3855,1,14,7,3,46,21,25,49
SK Sturm Gra,3855,2,13,4,7,35,29,6,43
Rapid Vienna,3855,3,8,9,7,36,32,4,33
LASK Linz,3855,4,9,6,9,32,30,2,33
Vienna,3855,5,7,5,12,24,39,-15,26
Mattersburg,3855,6,6,7,11,33,43,-10,25
SC Rheindorf,3855,7,5,6,13,19,31,-12,21
FC Salzburg,3856,1,15,6,3,47,19,28,51
Rapid Vienna,3856,2,11,9,4,39,25,14,42
SK Sturm Gra,3856,3,12,3,9,33,30,3,39
LASK Linz,3856,4,9,5,10,26,27,-1,32
Vienna,3856,5,6,6,12,24,39,-15,24
SC Rheindorf,3856,6,6,5,13,20,32,-12,23
Mattersburg,3856,7,5,6,13,27,44,-17,21
FC Salzburg,3857,1,14,6,4,47,26,21,48
SK Sturm Gra,3857,2,12,4,8,33,33,0,40
Rapid Vienna,3857,3,9,9,6,42,29,13,36
LASK Linz,3857,4,8,6,10,31,33,-2,30
Mattersburg,3857,5,8,5,11,31,41,-10,29
Vienna,3857,6,7,5,12,28,40,-12,26
SC Rheindorf,3857,7,5,7,12,19,29,-10,22
FC Salzburg,3858,1,14,7,3,45,19,26,49
Rapid Vienna,3858,2,10,10,4,39,25,14,40
SK Sturm Gra,3858,3,12,4,8,30,27,3,40
LASK Linz,3858,4,7,7,10,26,31,-5,28
Mattersburg,3858,5,6,6,12,31,42,-11,24
SC Rheindorf,3858,6,6,6,12,18,30,-12,24
Vienna,3858,7,6,6,12,25,40,-15,24
FC Salzburg,3859,1,15,7,2,48,17,31,52
SK Sturm Gra,3859,2,13,3,8,34,31,3,42
Rapid Vienna,3859,3,9,9,6,36,28,8,36
LASK Linz,3859,4,8,7,9,28,29,-1,31
Mattersburg,3859,5,6,7,11,29,40,-11,25
Vienna,3859,6,6,7,11,24,38,-14,25
SC Rheindorf,3859,7,4,6,14,16,32,-16,18
FC Salzburg,3860,1,14,7,3,45,19,26,49
SK Sturm Gra,3860,2,12,4,8,30,29,1,40
Rapid Vienna,3860,3,8,10,6,34,27,7,34
LASK Linz,3860,4,8,7,9,29,31,-2,31
Mattersburg,3860,5,7,6,11,35,43,-8,27
Vienna,3860,6,7,5,12,25,41,-16,26
SC Rheindorf,3860,7,5,7,12,21,29,-8,22
FC Salzburg,3861,1,14,7,3,46,19,27,49
SK Sturm Gra,3861,2,12,5,7,30,26,4,41
Rapid Vienna,3861,3,8,10,6,35,27,8,34
LASK Linz,3861,4,8,6,10,26,28,-2,30
Mattersburg,3861,5,8,5,11,34,42,-8,29
Vienna,3861,6,7,5,12,26,39,-13,26
SC Rheindorf,3861,7,5,6,13,17,33,-16,21
FC Salzburg,3862,1,14,8,2,44,16,28,50
SK Sturm Gra,3862,2,11,5,8,31,30,1,38
Rapid Vienna,3862,3,9,10,5,33,25,8,37
LASK Linz,3862,4,9,6,9,27,26,1,33
Vienna,3862,5,7,6,11,25,38,-13,27
Mattersburg,3862,6,6,6,12,30,43,-13,24
SC Rheindorf,3862,7,4,7,13,18,30,-12,19
FC Salzburg,3863,1,15,7,2,47,18,29,52
SK Sturm Gra,3863,2,12,4,8,32,29,3,40
Rapid Vienna,3863,3,8,12,4,36,25,11,36
LASK Linz,3863,4,8,6,10,28,28,0,30
Mattersburg,3863,5,7,5,12,30,40,-10,26
SC Rheindorf,3863,6,6,5,13,17,31,-14,23
Vienna,3863,7,6,5,13,24,43,-19,23
FC Salzburg,3864,1,15,6,3,45,18,27,51
SK Sturm Gra,3864,2,12,4,8,31,27,4,40
Rapid Vienna,3864,3,8,9,7,36,30,6,33
LASK Linz,3864,4,9,5,10,26,27,-1,32
Mattersburg,3864,5,7,6,11,31,41,-10,27
SC Rheindorf,3864,6,6,6,12,20,30,-10,24
Vienna,3864,7,6,6,12,24,40,-16,24
FC Salzburg,3865,1,15,7,2,48,20,28,52
SK Sturm Gra,3865,2,13,3,8,33,30,3,42
Rapid Vienna,3865,3,8,10,6,38,31,7,34
LASK Linz,3865,4,7,6,11,28,34,-6,27
SC Rheindorf,3865,5,7,5,12,21,26,-5,26
Mattersburg,3865,6,6,7,11,31,42,-11,25
Vienna,3865,7,6,6,12,27,43,-16,24
FC Salzburg,3866,1,13,7,4,41,19,22,46
SK Sturm Gra,3866,2,12,4,8,30,27,3,40
Rapid Vienna,3866,3,9,10,5,36,27,9,37
LASK Linz,3866,4,8,7,9,27,28,-1,31
Vienna,3866,5,7,6,11,24,37,-13,27
SC Rheindorf,3866,6,6,7,11,19,27,-8,25
Mattersburg,3866,7,6,5,13,28,40,-12,23
FC Salzburg,3867,1,13,8,3,44,21,23,47
SK Sturm Gra,3867,2,12,5,7,33,31,2,41
Rapid Vienna,3867,3,9,11,4,36,25,11,38
LASK Linz,3867,4,9,6,9,30,28,2,33
Vienna,3867,5,7,6,11,28,39,-11,27
SC Rheindorf,3867,6,5,6,13,18,27,-9,21
Mattersburg,3867,7,5,6,13,27,45,-18,21
FC Salzburg,3868,1,14,7,3,46,20,26,49
SK Sturm Gra,3868,2,11,5,8,30,28,2,38
Rapid Vienna,3868,3,8,12,4,38,29,9,36
LASK Linz,3868,4,9,7,8,33,31,2,34
Vienna,3868,5,8,5,11,32,40,-8,29
Mattersburg,3868,6,5,6,13,33,53,-20,21
SC Rheindorf,3868,7,4,8,12,18,29,-11,20
FC Salzburg,3869,1,15,7,2,44,17,27,52
SK Sturm Gra,3869,2,14,3,7,35,27,8,45
Rapid Vienna,3869,3,8,10,6,36,28,8,34
LASK Linz,3869,4,8,6,10,26,31,-5,30
Mattersburg,3869,5,6,6,12,30,41,-11,24
Vienna,3869,6,6,5,13,24,41,-17,23
SC Rheindorf,3869,7,5,7,12,20,30,-10,22
FC Salzburg,3870,1,15,7,2,46,18,28,52
SK Sturm Gra,3870,2,12,5,7,30,26,4,41
Rapid Vienna,3870,3,9,9,6,39,30,9,36
Mattersburg,3870,4,7,6,11,35,41,-6,27
LASK Linz,3870,5,7,6,11,28,34,-6,27
SC Rheindorf,3870,6,6,6,12,21,31,-10,24
Vienna,3870,7,6,5,13,23,42,-19,23
FC Salzburg,3871,1,14,7,3,46,17,29,49
Rapid Vienna,3871,2,9,11,4,35,24,11,38
SK Sturm Gra,3871,3,11,5,8,28,28,0,38
Vienna,3871,4,8,5,11,26,38,-12,29
LASK Linz,3871,5,7,7,10,23,30,-7,28
SC Rheindorf,3871,6,5,8,11,17,26,-9,23
Mattersburg,3871,7,6,5,13,32,44,-12,23
FC Salzburg,3872,1,15,6,3,47,20,27,51
SK Sturm Gra,3872,2,14,3,7,36,29,7,45
LASK Linz,3872,3,10,5,9,29,26,3,35
Rapid Vienna,3872,4,8,9,7,34,31,3,33
Vienna,3872,5,8,5,11,28,38,-10,29
Mattersburg,3872,6,5,6,13,27,42,-15,21
SC Rheindorf,3872,7,4,6,14,16,31,-15,18
FC Salzburg,3873,1,15,7,2,48,19,29,52
SK Sturm Gra,3873,2,12,4,8,33,31,2,40
Rapid Vienna,3873,3,9,10,5,35,27,8,37
LASK Linz,3873,4,7,5,12,24,34,-10,26
SC Rheindorf,3873,5,6,7,11,24,27,-3,25
Mattersburg,3873,6,6,7,11,34,43,-9,25
Vienna,3873,7,6,6,12,26,43,-17,24
FC Salzburg,3874,1,15,6,3,43,19,24,51
SK Sturm Gra,3874,2,12,4,8,34,30,4,40
Rapid Vienna,3874,3,10,9,5,40,29,11,39
LASK Linz,3874,4,8,6,10,30,33,-3,30
Mattersburg,3874,5,7,6,11,33,39,-6,27
Vienna,3874,6,6,5,13,25,41,-16,23
SC Rheindorf,3874,7,5,6,13,20,34,-14,21
FC Salzburg,3875,1,15,7,2,44,17,27,52
Rapid Vienna,3875,2,10,9,5,36,26,10,39
SK Sturm Gra,3875,3,11,4,9,31,30,1,37
LASK Linz,3875,4,8,7,9,27,28,-1,31
Vienna,3875,5,7,6,11,25,38,-13,27
SC Rheindorf,3875,6,6,5,13,22,30,-8,23
Mattersburg,3875,7,5,6,13,30,46,-16,21
FC Salzburg,3876,1,14,7,3,45,19,26,49
Rapid Vienna,3876,2,10,10,4,37,25,12,40
SK Sturm Gra,3876,3,12,4,8,30,28,2,40
LASK Linz,3876,4,8,5,11,25,29,-4,29
Mattersburg,3876,5,7,6,11,35,41,-6,27
Vienna,3876,6,7,5,12,28,43,-15,26
SC Rheindorf,3876,7,5,5,14,17,32,-15,20
FC Salzburg,3877,1,15,6,3,45,18,27,51
SK Sturm Gra,3877,2,14,3,7,38,30,8,45
Rapid Vienna,3877,3,8,11,5,34,27,7,35
LASK Linz,3877,4,7,7,10,25,29,-4,28
Mattersburg,3877,5,7,6,11,32,40,-8,27
Vienna,3877,6,6,6,12,25,41,-16,24
SC Rheindorf,3877,7,4,7,13,20,34,-14,19
FC Salzburg,3878,1,14,8,2,45,18,27,50
SK Sturm Gra,3878,2,11,4,9,29,28,1,37
LASK Linz,3878,3,9,7,8,28,26,2,34
Rapid Vienna,3878,4,7,12,5,36,30,6,33
Mattersburg,3878,5,6,7,11,30,41,-11,25
SC Rheindorf,3878,6,6,6,12,19,28,-9,24
Vienna,3878,7,6,6,12,25,41,-16,24
FC Salzburg,3879,1,16,6,2,46,15,31,54
SK Sturm Gra,3879,2,12,3,9,29,29,0,39
Rapid Vienna,3879,3,9,10,5,35,27,8,37
LASK Linz,3879,4,9,6,9,28,27,1,33
Mattersburg,3879,5,6,6,12,33,44,-11,24
Vienna,3879,6,6,5,13,24,42,-18,23
SC Rheindorf,3879,7,5,6,13,21,32,-11,21
FC Salzburg,3880,1,14,7,3,46,19,27,49
SK Sturm Gra,3880,2,12,4,8,31,30,1,40
Rapid Vienna,3880,3,8,11,5,37,31,6,35
LASK Linz,3880,4,8,5,11,30,34,-4,29
Vienna,3880,5,7,6,11,26,38,-12,27
Mattersburg,3880,6,7,5,12,34,43,-9,26
SC Rheindorf,3880,7,6,6,12,24,33,-9,24
FC Salzburg,3881,1,14,6,4,42,19,23,48
SK Sturm Gra,3881,2,14,3,7,32,25,7,45
Rapid Vienna,3881,3,9,9,6,35,27,8,36
LASK Linz,3881,4,8,6,10,25,28,-3,30
Vienna,3881,5,7,6,11,26,38,-12,27
Mattersburg,3881,6,6,7,11,30,40,-10,25
SC Rheindorf,3881,7,5,5,14,17,30,-13,20
FC Salzburg,3882,1,15,6,3,48,18,30,51
SK Sturm Gra,3882,2,14,4,6,37,29,8,46
Rapid Vienna,3882,3,8,10,6,36,30,6,34
LASK Linz,3882,4,8,6,10,30,32,-2,30
Vienna,3882,5,7,5,12,29,40,-11,26
Mattersburg,3882,6,5,7,12,29,49,-20,22
SC Rheindorf,3882,7,4,8,12,19,30,-11,20
FC Salzburg,3883,1,14,7,3,44,18,26,49
Rapid Vienna,3883,2,10,10,4,37,25,12,40
SK Sturm Gra,3883,3,12,4,8,32,30,2,40
LASK Linz,3883,4,8,5,11,27,31,-4,29
Vienna,3883,5,7,6,11,25,38,-13,27
SC Rheindorf,3883,6,6,5,13,19,30,-11,23
Mattersburg,3883,7,6,5,13,31,43,-12,23
FC Salzburg,3884,1,15,7,2,46,18,28,52
SK Sturm Gra,3884,2,12,4,8,31,29,2,40
LASK Linz,3884,3,11,5,8,31,27,4,38
Rapid Vienna,3884,4,8,11,5,35,27,8,35
Mattersburg,3884,5,6,6,12,31,41,-10,24
Vienna,3884,6,6,6,12,24,39,-15,24
SC Rheindorf,3884,7,4,5,15,17,34,-17,17
FC Salzburg,3885,1,14,7,3,46,21,25,49
SK Sturm Gra,3885,2,12,4,8,33,30,3,40
Rapid Vienna,3885,3,9,10,5,36,27,9,37
LASK Linz,3885,4,9,6,9,30,28,2,33
Mattersburg,3885,5,7,5,12,31,43,-12,26
Vienna,3885,6,6,6,12,25,40,-15,24
SC Rheindorf,3885,7,4,8,12,18,30,-12,20
FC Salzburg,3886,1,15,6,3,47,21,26,51
SK Sturm Gra,3886,2,12,4,8,34,31,3,40
LASK Linz,3886,3,10,6,8,29,26,3,36
Rapid Vienna,3886,4,7,9,8,34,33,1,30
Vienna,3886,5,8,5,11,27,39,-12,29
SC Rheindorf,3886,6,6,6,12,20,28,-8,24
Mattersburg,3886,7,5,6,13,32,45,-13,21
FC Salzburg,3887,1,13,8,3,45,21,24,47
SK Sturm Gra,3887,2,13,4,7,35,31,4,43
Rapid Vienna,3887,3,9,10,5,39,29,10,37
LASK Linz,3887,4,7,6,11,27,32,-5,27
Mattersburg,3887,5,7,6,11,30,39,-9,27
Vienna,3887,6,7,6,11,27,39,-12,27
SC Rheindorf,3887,7,4,8,12,17,29,-12,20
FC Salzburg,3888,1,14,6,4,44,20,24,48
SK Sturm Gra,3888,2,13,3,8,30,26,4,42
Rapid Vienna,3888,3,8,10,6,36,28,8,34
LASK Linz,3888,4,9,6,9,27,27,0,33
SC Rheindorf,3888,5,7,5,12,19,27,-8,26
Vienna,3888,6,7,5,12,25,40,-15,26
Mattersburg,3888,7,6,5,13,27,40,-13,23
FC Salzburg,3889,1,14,8,2,44,18,26,50
SK Sturm Gra,3889,2,13,3,8,36,30,6,42
LASK Linz,3889,3,10,6,8,29,26,3,36
Rapid Vienna,3889,4,7,11,6,35,32,3,32
Vienna,3889,5,6,6,12,25,41,-16,24
Mattersburg,3889,6,5,8,11,29,40,-11,23
SC Rheindorf,3889,7,4,8,12,15,26,-11,20
FC Salzburg,3890,1,15,6,3,43,21,22,51
SK Sturm Gra,3890,2,14,3,7,40,28,12,45
Rapid Vienna,3890,3,8,11,5,34,26,8,35
LASK Linz,3890,4,7,6,11,24,31,-7,27
Mattersburg,3890,5,7,5,12,31,41,-10,26
Vienna,3890,6,7,5,12,25,38,-13,26
SC Rheindorf,3890,7,5,6,13,18,30,-12,21
FC Salzburg,3891,1,14,7,3,40,17,23,49
SK Sturm Gra,3891,2,12,5,7,34,30,4,41
Rapid Vienna,3891,3,8,11,5,36,27,9,35
LASK Linz,3891,4,8,6,10,31,30,1,30
SC Rheindorf,3891,5,7,6,11,22,29,-7,27
Vienna,3891,6,6,6,12,24,39,-15,24
Mattersburg,3891,7,6,5,13,28,43,-15,23
FC Salzburg,3892,1,14,7,3,47,22,25,49
SK Sturm Gra,3892,2,12,4,8,35,33,2,40
Rapid Vienna,3892,3,8,10,6,38,32,6,34
LASK Linz,3892,4,8,7,9,28,29,-1,31
Mattersburg,3892,5,7,6,11,33,40,-7,27
Vienna,3892,6,7,5,12,27,42,-15,26
SC Rheindorf,3892,7,5,7,12,18,28,-10,22
FC Salzburg,3893,1,15,7,2,44,18,26,52
SK Sturm Gra,3893,2,11,7,6,31,27,4,40
LASK Linz,3893,3,10,6,8,28,26,2,36
Rapid Vienna,3893,4,8,10,6,39,28,11,34
Vienna,3893,5,7,5,12,25,39,-14,26
Mattersburg,3893,6,5,6,13,30,43,-13,21
SC Rheindorf,3893,7,4,7,13,17,33,-16,19
FC Salzburg,3894,1,16,6,2,46,16,30,54
SK Sturm Gra,3894,2,14,3,7,36,28,8,45
Rapid Vienna,3894,3,8,9,7,33,29,4,33
LASK Linz,3894,4,8,6,10,28,29,-1,30
Mattersburg,3894,5,6,6,12,32,45,-13,24
Vienna,3894,6,6,6,12,25,40,-15,24
SC Rheindorf,3894,7,5,6,13,19,32,-13,21
FC Salzburg,3895,1,16,6,2,50,18,32,54
SK Sturm Gra,3895,2,11,5,8,33,31,2,38
Rapid Vienna,3895,3,9,9,6,36,30,6,36
LASK Linz,3895,4,8,7,9,29,29,0,31
Mattersburg,3895,5,6,7,11,33,44,-11,25
Vienna,3895,6,6,6,12,24,42,-18,24
SC Rheindorf,3895,7,4,8,12,21,32,-11,20
FC Salzburg,3896,1,14,8,2,44,17,27,50
SK Sturm Gra,3896,2,12,5,7,32,29,3,41
Rapid Vienna,3896,3,8,10,6,36,30,6,34
LASK Linz,3896,4,9,5,10,32,30,2,32
Vienna,3896,5,7,6,11,25,37,-12,27
Mattersburg,3896,6,6,5,13,30,44,-14,23
SC Rheindorf,3896,7,5,7,12,20,32,-12,22
FC Salzburg,3897,1,15,7,2,45,16,29,52
SK Sturm Gra,3897,2,13,3,8,32,28,4,42
Rapid Vienna,3897,3,8,10,6,34,26,8,34
LASK Linz,3897,4,9,6,9,30,30,0,33
Mattersburg,3897,5,7,6,11,33,43,-10,27
Vienna,3897,6,6,6,12,25,41,-16,24
SC Rheindorf,3897,7,4,6,14,18,33,-15,18
FC Salzburg,3898,1,13,7,4,42,23,19,46
SK Sturm Gra,3898,2,12,5,7,33,31,2,41
Rapid Vienna,3898,3,8,12,4,36,27,9,36
LASK Linz,3898,4,8,6,10,28,30,-2,30
Vienna,3898,5,8,5,11,29,38,-9,29
SC Rheindorf,3898,6,6,6,12,19,27,-8,24
Mattersburg,3898,7,6,5,13,30,41,-11,23
FC Salzburg,3899,1,13,6,5,43,24,19,45
SK Sturm Gra,3899,2,14,3,7,34,27,7,45
Rapid Vienna,3899,3,10,9,5,38,25,13,39
LASK Linz,3899,4,9,6,9,28,28,0,33
Vienna,3899,5,8,5,11,28,38,-10,29
Mattersburg,3899,6,6,5,13,31,42,-11,23
SC Rheindorf,3899,7,4,6,14,16,34,-18,18
FC Salzburg,3900,1,14,7,3,46,22,24,49
SK Sturm Gra,3900,2,12,5,7,35,32,3,41
Rapid Vienna,3900,3,8,11,5,39,29,10,35
LASK Linz,3900,4,8,6,10,29,32,-3,30
Vienna,3900,5,7,6,11,26,38,-12,27
SC Rheindorf,3900,6,6,6,12,21,31,-10,24
Mattersburg,3900,7,6,5,13,31,43,-12,23
FC Salzburg,3901,1,12,7,5,41,25,16,43
SK Sturm Gra,3901,2,13,4,7,37,31,6,43
Rapid Vienna,3901,3,7,11,6,34,32,2,32
LASK Linz,3901,4,8,8,8,28,28,0,32
Vienna,3901,5,8,5,11,27,37,-10,29
SC Rheindorf,3901,6,6,7,11,23,28,-5,25
Mattersburg,3901,7,6,6,12,31,40,-9,24
FC Salzburg,3902,1,15,7,2,45,19,26,52
SK Sturm Gra,3902,2,12,4,8,32,31,1,40
Rapid Vienna,3902,3,9,10,5,37,26,11,37
LASK Linz,3902,4,9,6,9,26,26,0,33
Mattersburg,3902,5,6,7,11,34,42,-8,25
Vienna,3902,6,6,6,12,26,41,-15,24
SC Rheindorf,3902,7,4,6,14,17,32,-15,18
FC Salzburg,3903,1,12,8,4,44,23,21,44
SK Sturm Gra,3903,2,12,6,6,33,27,6,42
Rapid Vienna,3903,3,10,9,5,36,26,10,39
LASK Linz,3903,4,8,7,9,27,28,-1,31
Vienna,3903,5,7,6,11,29,42,-13,27
Mattersburg,3903,6,6,6,12,28,40,-12,24
SC Rheindorf,3903,7,4,8,12,17,28,-11,20
FC Salzburg,3904,1,15,6,3,42,16,26,51
SK Sturm Gra,3904,2,12,4,8,30,27,3,40
Rapid Vienna,3904,3,10,9,5,36,25,11,39
LASK Linz,3904,4,9,6,9,27,27,0,33
Mattersburg,3904,5,6,6,12,31,43,-12,24
Vienna,3904,6,6,5,13,25,41,-16,23
SC Rheindorf,3904,7,5,6,13,18,30,-12,21
FC Salzburg,3905,1,15,7,2,46,20,26,52
SK Sturm Gra,3905,2,11,4,9,31,30,1,37
Rapid Vienna,3905,3,9,9,6,38,30,8,36
LASK Linz,3905,4,7,7,10,24,29,-5,28
Mattersburg,3905,5,7,7,10,31,39,-8,28
SC Rheindorf,3905,6,7,5,12,22,28,-6,26
Vienna,3905,7,6,5,13,23,39,-16,23
FC Salzburg,3906,1,14,7,3,45,20,25,49
SK Sturm Gra,3906,2,11,5,8,32,30,2,38
Rapid Vienna,3906,3,8,12,4,38,28,10,36
LASK Linz,3906,4,7,7,10,25,30,-5,28
SC Rheindorf,3906,5,7,6,11,24,30,-6,27
Vienna,3906,6,6,7,11,24,38,-14,25
Mattersburg,3906,7,6,6,12,32,44,-12,24
FC Salzburg,3907,1,15,6,3,48,18,30,51
SK Sturm Gra,3907,2,11,6,7,31,29,2,39
Rapid Vienna,3907,3,8,11,5,36,29,7,35
LASK Linz,3907,4,8,7,9,29,31,-2,31
Vienna,3907,5,7,6,11,27,40,-13,27
SC Rheindorf,3907,6,5,7,12,19,29,-10,22
Mattersburg,3907,7,5,7,12,32,46,-14,22
FC Salzburg,3908,1,14,7,3,43,17,26,49
SK Sturm Gra,3908,2,11,4,9,28,31,-3,37
Rapid Vienna,3908,3,8,12,4,37,26,11,36
LASK Linz,3908,4,7,8,9,24,27,-3,29
Vienna,3908,5,8,5,11,26,38,-12,29
SC Rheindorf,3908,6,6,7,11,21,27,-6,25
Mattersburg,3908,7,6,5,13,28,41,-13,23
FC Salzburg,3909,1,15,6,3,46,17,29,51
SK Sturm Gra,3909,2,14,3,7,33,27,6,45
Rapid Vienna,3909,3,8,9,7,34,31,3,33
LASK Linz,3909,4,8,5,11,27,32,-5,29
Mattersburg,3909,5,7,6,11,33,40,-7,27
Vienna,3909,6,7,5,12,25,39,-14,26
SC Rheindorf,3909,7,5,6,13,20,32,-12,21
FC Salzburg,3910,1,16,6,2,47,16,31,54
Rapid Vienna,3910,2,10,9,5,38,27,11,39
SK Sturm Gra,3910,3,12,3,9,31,29,2,39
LASK Linz,3910,4,7,7,10,29,34,-5,28
Vienna,3910,5,7,5,12,27,42,-15,26
SC Rheindorf,3910,6,5,7,12,20,31,-11,22
Mattersburg,3910,7,5,7,12,32,45,-13,22
FC Salzburg,3911,1,14,6,4,45,19,26,48
SK Sturm Gra,3911,2,13,3,8,33,30,3,42
Rapid Vienna,3911,3,8,10,6,35,30,5,34
LASK Linz,3911,4,7,7,10,25,30,-5,28
Vienna,3911,5,7,6,11,26,39,-13,27
SC Rheindorf,3911,6,6,7,11,22,28,-6,25
Mattersburg,3911,7,6,7,11,31,41,-10,25
FC Salzburg,3912,1,15,6,3,47,21,26,51
SK Sturm Gra,3912,2,13,3,8,33,32,1,42
Rapid Vienna,3912,3,9,10,5,37,27,10,37
LASK Linz,3912,4,8,6,10,28,30,-2,30
Mattersburg,3912,5,6,6,12,31,41,-10,24
SC Rheindorf,3912,6,5,8,11,22,27,-5,23
Vienna,3912,7,6,5,13,25,45,-20,23
FC Salzburg,3913,1,13,8,3,41,19,22,47
Rapid Vienna,3913,2,11,9,4,43,26,17,42
SK Sturm Gra,3913,3,12,5,7,31,27,4,41
LASK Linz,3913,4,7,6,11,26,31,-5,27
Vienna,3913,5,7,5,12,25,40,-15,26
Mattersburg,3913,6,6,7,11,30,40,-10,25
SC Rheindorf,3913,7,5,6,13,18,31,-13,21
FC Salzburg,3914,1,14,8,2,43,18,25,50
Rapid Vienna,3914,2,9,11,4,38,27,11,38
SK Sturm Gra,3914,3,11,4,9,29,28,1,37
LASK Linz,3914,4,8,5,11,26,33,-7,29
Vienna,3914,5,7,6,11,26,39,-13,27
SC Rheindorf,3914,6,7,5,12,20,27,-7,26
Mattersburg,3914,7,6,5,13,32,42,-10,23
FC Salzburg,3915,1,12,10,2,40,17,23,46
SK Sturm Gra,3915,2,12,4,8,31,27,4,40
Rapid Vienna,3915,3,8,12,4,34,25,9,36
LASK Linz,3915,4,8,6,10,29,31,-2,30
Vienna,3915,5,7,6,11,26,38,-12,27
SC Rheindorf,3915,6,6,7,11,22,30,-8,25
Mattersburg,3915,7,5,7,12,29,43,-14,22
FC Salzburg,3916,1,14,8,2,45,17,28,50
SK Sturm Gra,3916,2,12,4,8,35,32,3,40
Rapid Vienna,3916,3,10,9,5,37,27,10,39
LASK Linz,3916,4,9,5,10,30,31,-1,32
Vienna,3916,5,6,7,11,26,40,-14,25
SC Rheindorf,3916,6,6,5,13,20,28,-8,23
Mattersburg,3916,7,5,6,13,29,47,-18,21
FC Salzburg,3917,1,12,9,3,43,22,21,45
SK Sturm Gra,3917,2,14,3,7,34,27,7,45
Rapid Vienna,3917,3,8,11,5,35,27,8,35
LASK Linz,3917,4,9,6,9,31,27,4,33
Vienna,3917,5,6,7,11,26,40,-14,25
Mattersburg,3917,6,5,8,11,32,47,-15,23
SC Rheindorf,3917,7,5,6,13,19,30,-11,21
FC Salzburg,3918,1,14,7,3,43,19,24,49
SK Sturm Gra,3918,2,12,4,8,30,27,3,40
Rapid Vienna,3918,3,8,11,5,35,26,9,35
LASK Linz,3918,4,7,7,10,25,29,-4,28
Vienna,3918,5,7,6,11,27,40,-13,27
Mattersburg,3918,6,6,8,10,33,41,-8,26
SC Rheindorf,3918,7,5,7,12,18,29,-11,22
FC Salzburg,3919,1,14,8,2,45,16,29,50
SK Sturm Gra,3919,2,11,6,7,30,27,3,39
Rapid Vienna,3919,3,7,11,6,32,27,5,32
LASK Linz,3919,4,8,6,10,25,27,-2,30
Vienna,3919,5,7,6,11,27,39,-12,27
Mattersburg,3919,6,7,5,12,30,43,-13,26
SC Rheindorf,3919,7,6,6,12,19,29,-10,24
FC Salzburg,3920,1,14,8,2,42,16,26,50
SK Sturm Gra,3920,2,13,5,6,37,25,12,44
Rapid Vienna,3920,3,9,11,4,38,26,12,38
Mattersburg,3920,4,7,5,12,34,41,-7,26
LASK Linz,3920,5,7,5,12,24,36,-12,26
Vienna,3920,6,7,5,12,25,39,-14,26
SC Rheindorf,3920,7,5,5,14,18,35,-17,20
FC Salzburg,3921,1,14,8,2,44,19,25,50
SK Sturm Gra,3921,2,13,3,8,31,27,4,42
Rapid Vienna,3921,3,7,11,6,34,29,5,32
LASK Linz,3921,4,7,7,10,26,29,-3,28
SC Rheindorf,3921,5,7,6,11,21,27,-6,27
Vienna,3921,6,7,6,11,26,39,-13,27
Mattersburg,3921,7,6,5,13,30,42,-12,23
FC Salzburg,3922,1,13,8,3,41,18,23,47
SK Sturm Gra,3922,2,12,4,8,34,29,5,40
Rapid Vienna,3922,3,10,9,5,38,27,11,39
SC Rheindorf,3922,4,7,6,11,24,29,-5,27
LASK Linz,3922,5,7,6,11,24,32,-8,27
Vienna,3922,6,7,6,11,26,39,-13,27
Mattersburg,3922,7,6,5,13,29,42,-13,23
FC Salzburg,3923,1,15,6,3,47,19,28,51
Rapid Vienna,3923,2,9,10,5,37,26,11,37
SK Sturm Gra,3923,3,11,4,9,31,33,-2,37
LASK Linz,3923,4,8,7,9,29,31,-2,31
Vienna,3923,5,7,5,12,27,41,-14,26
SC Rheindorf,3923,6,6,6,12,20,29,-9,24
Mattersburg,3923,7,6,6,12,33,45,-12,24
FC Salzburg,3924,1,14,8,2,47,18,29,50
SK Sturm Gra,3924,2,12,3,9,31,28,3,39
Rapid Vienna,3924,3,9,11,4,37,26,11,38
LASK Linz,3924,4,7,6,11,25,31,-6,27
SC Rheindorf,3924,5,7,5,12,21,29,-8,26
Mattersburg,3924,6,6,7,11,32,42,-10,25
Vienna,3924,7,6,6,12,25,44,-19,24
FC Salzburg,3925,1,15,6,3,47,20,27,51
SK Sturm Gra,3925,2,11,5,8,29,27,2,38
Rapid Vienna,3925,3,8,10,6,34,27,7,34
LASK Linz,3925,4,9,5,10,26,28,-2,32
Mattersburg,3925,5,7,5,12,33,43,-10,26
Vienna,3925,6,7,5,12,25,41,-16,26
SC Rheindorf,3925,7,6,6,12,20,28,-8,24
FC Salzburg,3926,1,15,6,3,43,18,25,51
SK Sturm Gra,3926,2,12,4,8,31,29,2,40
Rapid Vienna,3926,3,9,10,5,37,28,9,37
LASK Linz,3926,4,9,7,8,29,28,1,34
Mattersburg,3926,5,7,5,12,36,41,-5,26
Vienna,3926,6,6,5,13,23,39,-16,23
SC Rheindorf,3926,7,5,5,14,18,34,-16,20
FC Salzburg,3927,1,14,8,2,44,17,27,50
SK Sturm Gra,3927,2,12,3,9,31,30,1,39
Rapid Vienna,3927,3,7,11,6,33,27,6,32
LASK Linz,3927,4,8,6,10,28,31,-3,30
SC Rheindorf,3927,5,8,5,11,22,27,-5,29
Mattersburg,3927,6,7,5,12,32,43,-11,26
Vienna,3927,7,6,6,12,24,39,-15,24
FC Salzburg,3928,1,13,8,3,46,21,25,47
SK Sturm Gra,3928,2,13,4,7,31,27,4,43
Rapid Vienna,3928,3,8,10,6,34,26,8,34
LASK Linz,3928,4,9,6,9,27,25,2,33
Vienna,3928,5,6,7,11,27,41,-14,25
Mattersburg,3928,6,6,6,12,29,43,-14,24
SC Rheindorf,3928,7,6,5,13,19,30,-11,23
FC Salzburg,3929,1,15,7,2,45,15,30,52
SK Sturm Gra,3929,2,14,3,7,36,29,7,45
Rapid Vienna,3929,3,9,10,5,35,25,10,37
LASK Linz,3929,4,9,5,10,29,28,1,32
Mattersburg,3929,5,6,6,12,31,45,-14,24
Vienna,3929,6,6,6,12,27,43,-16,24
SC Rheindorf,3929,7,4,5,15,18,36,-18,17
FC Salzburg,3930,1,15,6,3,50,20,30,51
SK Sturm Gra,3930,2,13,4,7,32,30,2,43
Rapid Vienna,3930,3,8,9,7,37,32,5,33
Mattersburg,3930,4,8,5,11,32,40,-8,29
LASK Linz,3930,5,7,7,10,25,28,-3,28
Vienna,3930,6,7,5,12,25,39,-14,26
SC Rheindorf,3930,7,5,6,13,20,32,-12,21
FC Salzburg,3931,1,15,7,2,47,19,28,52
Rapid Vienna,3931,2,10,10,4,38,27,11,40
SK Sturm Gra,3931,3,12,4,8,31,27,4,40
LASK Linz,3931,4,8,6,10,26,30,-4,30
Mattersburg,3931,5,6,6,12,30,42,-12,24
Vienna,3931,6,6,5,13,24,40,-16,23
SC Rheindorf,3931,7,5,6,13,20,31,-11,21
FC Salzburg,3932,1,15,6,3,45,19,26,51
SK Sturm Gra,3932,2,14,4,6,33,25,8,46
Rapid Vienna,3932,3,8,11,5,36,28,8,35
LASK Linz,3932,4,8,6,10,24,27,-3,30
Vienna,3932,5,6,6,12,24,39,-15,24
Mattersburg,3932,6,5,7,12,30,43,-13,22
SC Rheindorf,3932,7,4,8,12,18,29,-11,20
FC Salzburg,3933,1,15,6,3,48,18,30,51
SK Sturm Gra,3933,2,12,4,8,32,30,2,40
Rapid Vienna,3933,3,8,10,6,35,28,7,34
LASK Linz,3933,4,8,7,9,24,25,-1,31
Vienna,3933,5,8,5,11,27,39,-12,29
Mattersburg,3933,6,6,6,12,31,43,-12,24
SC Rheindorf,3933,7,5,6,13,18,32,-14,21
FC Salzburg,3934,1,14,7,3,44,18,26,49
SK Sturm Gra,3934,2,13,3,8,35,32,3,42
Rapid Vienna,3934,3,9,9,6,39,30,9,36
LASK Linz,3934,4,7,6,11,26,33,-7,27
Vienna,3934,5,7,6,11,25,38,-13,27
Mattersburg,3934,6,6,7,11,31,41,-10,25
SC Rheindorf,3934,7,6,6,12,23,31,-8,24
FC Salzburg,3935,1,16,6,2,50,20,30,54
SK Sturm Gra,3935,2,12,4,8,36,33,3,40
Rapid Vienna,3935,3,9,9,6,36,28,8,36
LASK Linz,3935,4,8,6,10,26,29,-3,30
Vienna,3935,5,7,5,12,27,41,-14,26
SC Rheindorf,3935,6,5,7,12,24,33,-9,22
Mattersburg,3935,7,5,7,12,27,42,-15,22
FC Salzburg,3936,1,14,7,3,42,17,25,49
SK Sturm Gra,3936,2,11,5,8,30,29,1,38
Rapid Vienna,3936,3,8,11,5,35,27,8,35
LASK Linz,3936,4,9,6,9,29,29,0,33
SC Rheindorf,3936,5,8,5,11,23,27,-4,29
Mattersburg,3936,6,6,5,13,32,43,-11,23
Vienna,3936,7,6,5,13,23,42,-19,23
FC Salzburg,3937,1,16,6,2,50,19,31,54
SK Sturm Gra,3937,2,12,3,9,34,32,2,39
Rapid Vienna,3937,3,9,9,6,37,32,5,36
LASK Linz,3937,4,8,5,11,31,38,-7,29
Mattersburg,3937,5,7,5,12,33,43,-10,26
Vienna,3937,6,7,5,12,28,40,-12,26
SC Rheindorf,3937,7,6,5,13,22,31,-9,23
FC Salzburg,3938,1,14,7,3,46,19,27,49
SK Sturm Gra,3938,2,13,4,7,37,30,7,43
Rapid Vienna,3938,3,9,9,6,35,30,5,36
LASK Linz,3938,4,8,5,11,28,33,-5,29
Mattersburg,3938,5,7,6,11,33,42,-9,27
Vienna,3938,6,7,5,12,27,41,-14,26
SC Rheindorf,3938,7,5,6,13,19,30,-11,21
SK Sturm Gra,3939,1,14,4,6,36,25,11,46
FC Salzburg,3939,2,12,9,3,41,19,22,45
Rapid Vienna,3939,3,7,12,5,37,30,7,33
LASK Linz,3939,4,8,7,9,29,29,0,31
Mattersburg,3939,5,7,6,11,32,41,-9,27
Vienna,3939,6,7,6,11,27,39,-12,27
SC Rheindorf,3939,7,4,6,14,18,37,-19,18
FC Salzburg,3940,1,16,6,2,50,17,33,54
SK Sturm Gra,3940,2,14,3,7,36,28,8,45
Rapid Vienna,3940,3,8,10,6,34,32,2,34
LASK Linz,3940,4,8,5,11,28,33,-5,29
Mattersburg,3940,5,7,5,12,33,42,-9,26
Vienna,3940,6,6,5,13,26,43,-17,23
SC Rheindorf,3940,7,5,6,13,16,28,-12,21
FC Salzburg,3941,1,14,7,3,48,22,26,49
SK Sturm Gra,3941,2,12,4,8,34,35,-1,40
Rapid Vienna,3941,3,9,9,6,37,28,9,36
LASK Linz,3941,4,9,6,9,27,27,0,33
Mattersburg,3941,5,7,6,11,32,37,-5,27
Vienna,3941,6,6,7,11,25,39,-14,25
SC Rheindorf,3941,7,5,5,14,17,32,-15,20
FC Salzburg,3942,1,14,6,4,45,21,24,48
SK Sturm Gra,3942,2,13,4,7,32,27,5,43
Rapid Vienna,3942,3,8,10,6,40,29,11,34
LASK Linz,3942,4,8,7,9,25,26,-1,31
Vienna,3942,5,8,5,11,27,39,-12,29
Mattersburg,3942,6,6,7,11,30,40,-10,25
SC Rheindorf,3942,7,4,7,13,18,35,-17,19
FC Salzburg,3943,1,15,7,2,50,17,33,52
SK Sturm Gra,3943,2,13,4,7,33,29,4,43
Rapid Vienna,3943,3,8,10,6,38,33,5,34
LASK Linz,3943,4,8,5,11,27,31,-4,29
Mattersburg,3943,5,7,6,11,32,44,-12,27
Vienna,3943,6,6,6,12,27,43,-16,24
SC Rheindorf,3943,7,5,6,13,22,32,-10,21
FC Salzburg,3944,1,13,8,3,43,19,24,47
SK Sturm Gra,3944,2,12,6,6,32,27,5,42
Rapid Vienna,3944,3,8,10,6,35,29,6,34
LASK Linz,3944,4,8,6,10,27,31,-4,30
Mattersburg,3944,5,8,5,11,33,39,-6,29
Vienna,3944,6,7,5,12,25,39,-14,26
SC Rheindorf,3944,7,5,6,13,19,30,-11,21
FC Salzburg,3945,1,15,7,2,42,16,26,52
SK Sturm Gra,3945,2,13,5,6,32,25,7,44
LASK Linz,3945,3,8,7,9,28,28,0,31
Rapid Vienna,3945,4,7,9,8,31,30,1,30
Mattersburg,3945,5,6,7,11,34,42,-8,25
SC Rheindorf,3945,6,5,8,11,18,26,-8,23
Vienna,3945,7,6,5,13,25,43,-18,23
FC Salzburg,3946,1,13,7,4,39,18,21,46
SK Sturm Gra,3946,2,14,3,7,38,26,12,45
Rapid Vienna,3946,3,11,9,4,42,27,15,42
LASK Linz,3946,4,7,6,11,24,35,-11,27
Vienna,3946,5,7,5,12,25,38,-13,26
Mattersburg,3946,6,6,6,12,29,40,-11,24
SC Rheindorf,3946,7,5,6,13,19,32,-13,21
FC Salzburg,3947,1,16,6,2,49,18,31,54
SK Sturm Gra,3947,2,13,3,8,34,31,3,42
Rapid Vienna,3947,3,7,10,7,33,31,2,31
LASK Linz,3947,4,8,5,11,26,31,-5,29
Mattersburg,3947,5,7,5,12,33,44,-11,26
Vienna,3947,6,7,5,12,27,40,-13,26
SC Rheindorf,3947,7,6,6,12,22,29,-7,24
FC Salzburg,3948,1,13,9,2,44,18,26,48
SK Sturm Gra,3948,2,13,4,7,33,29,4,43
Rapid Vienna,3948,3,8,10,6,35,27,8,34
LASK Linz,3948,4,8,5,11,24,31,-7,29
Vienna,3948,5,7,6,11,25,38,-13,27
SC Rheindorf,3948,6,6,7,11,24,30,-6,25
Mattersburg,3948,7,5,7,12,29,41,-12,22
FC Salzburg,3949,1,13,8,3,43,19,24,47
SK Sturm Gra,3949,2,12,5,7,29,25,4,41
Rapid Vienna,3949,3,8,9,7,34,30,4,33
LASK Linz,3949,4,9,6,9,29,27,2,33
Mattersburg,3949,5,7,7,10,34,39,-5,28
Vienna,3949,6,7,6,11,27,40,-13,27
SC Rheindorf,3949,7,5,5,14,19,35,-16,20
FC Salzburg,3950,1,14,6,4,43,18,25,48
SK Sturm Gra,3950,2,13,5,6,33,26,7,44
Rapid Vienna,3950,3,8,10,6,35,28,7,34
LASK Linz,3950,4,8,7,9,27,29,-2,31
Vienna,3950,5,8,5,11,25,37,-12,29
Mattersburg,3950,6,6,5,13,28,40,-12,23
SC Rheindorf,3950,7,5,6,13,18,31,-13,21
FC Salzburg,3951,1,14,6,4,45,20,25,48
SK Sturm Gra,3951,2,12,4,8,33,30,3,40
Rapid Vienna,3951,3,9,10,5,35,27,8,37
LASK Linz,3951,4,10,5,9,31,31,0,35
Vienna,3951,5,8,5,11,31,39,-8,29
Mattersburg,3951,6,6,5,13,31,45,-14,23
SC Rheindorf,3951,7,5,5,14,16,30,-14,20
FC Salzburg,3952,1,15,6,3,46,16,30,51
SK Sturm Gra,3952,2,11,5,8,31,30,1,38
Rapid Vienna,3952,3,9,10,5,36,27,9,37
LASK Linz,3952,4,9,5,10,30,30,0,32
Vienna,3952,5,7,6,11,24,37,-13,27
Mattersburg,3952,6,6,6,12,28,42,-14,24
SC Rheindorf,3952,7,5,6,13,18,31,-13,21
FC Salzburg,3953,1,15,7,2,45,17,28,52
SK Sturm Gra,3953,2,13,5,6,39,31,8,44
Rapid Vienna,3953,3,7,10,7,35,32,3,31
LASK Linz,3953,4,8,7,9,29,32,-3,31
Mattersburg,3953,5,6,6,12,28,39,-11,24
SC Rheindorf,3953,6,5,8,11,22,31,-9,23
Vienna,3953,7,6,5,13,24,40,-16,23
FC Salzburg,3954,1,14,7,3,48,22,26,49
SK Sturm Gra,3954,2,11,6,7,33,30,3,39
Rapid Vienna,3954,3,9,10,5,38,27,11,37
LASK Linz,3954,4,8,6,10,27,30,-3,30
Vienna,3954,5,7,5,12,27,42,-15,26
SC Rheindorf,3954,6,6,6,12,20,30,-10,24
Mattersburg,3954,7,6,6,12,29,41,-12,24
FC Salzburg,3955,1,12,9,3,43,21,22,45
SK Sturm Gra,3955,2,11,6,7,30,28,2,39
Rapid Vienna,3955,3,9,11,4,38,25,13,38
LASK Linz,3955,4,7,7,10,26,30,-4,28
Mattersburg,3955,5,7,6,11,33,44,-11,27
Vienna,3955,6,7,5,12,28,43,-15,26
SC Rheindorf,3955,7,6,6,12,23,30,-7,24
FC Salzburg,3956,1,15,6,3,49,22,27,51
SK Sturm Gra,3956,2,13,4,7,32,27,5,43
Rapid Vienna,3956,3,9,11,4,37,25,12,38
LASK Linz,3956,4,7,6,11,25,29,-4,27
Vienna,3956,5,7,5,12,29,41,-12,26
SC Rheindorf,3956,6,6,5,13,18,28,-10,23
Mattersburg,3956,7,6,5,13,29,47,-18,23
FC Salzburg,3957,1,14,8,2,45,20,25,50
SK Sturm Gra,3957,2,13,3,8,33,27,6,42
Rapid Vienna,3957,3,8,10,6,35,29,6,34
LASK Linz,3957,4,9,6,9,30,28,2,33
Mattersburg,3957,5,5,9,10,32,42,-10,24
Vienna,3957,6,6,6,12,24,39,-15,24
SC Rheindorf,3957,7,5,6,13,17,31,-14,21
FC Salzburg,3958,1,14,6,4,46,23,23,48
SK Sturm Gra,3958,2,13,5,6,32,25,7,44
Rapid Vienna,3958,3,9,11,4,37,25,12,38
LASK Linz,3958,4,7,8,9,27,29,-2,29
Vienna,3958,5,6,6,12,26,41,-15,24
SC Rheindorf,3958,6,6,5,13,19,31,-12,23
Mattersburg,3958,7,5,7,12,31,44,-13,22
FC Salzburg,3959,1,13,6,5,43,22,21,45
SK Sturm Gra,3959,2,13,4,7,35,31,4,43
Rapid Vienna,3959,3,8,11,5,40,31,9,35
Vienna,3959,4,8,5,11,27,38,-11,29
LASK Linz,3959,5,7,6,11,26,31,-5,27
SC Rheindorf,3959,6,7,6,11,23,28,-5,27
Mattersburg,3959,7,6,6,12,29,42,-13,24
FC Salzburg,3960,1,15,6,3,46,17,29,51
SK Sturm Gra,3960,2,13,3,8,32,28,4,42
Rapid Vienna,3960,3,9,9,6,37,31,6,36
LASK Linz,3960,4,7,7,10,26,29,-3,28
Mattersburg,3960,5,6,7,11,30,40,-10,25
SC Rheindorf,3960,6,6,6,12,20,28,-8,24
Vienna,3960,7,6,6,12,24,42,-18,24
FC Salzburg,3961,1,15,7,2,46,18,28,52
SK Sturm Gra,3961,2,12,5,7,32,27,5,41
Rapid Vienna,3961,3,9,11,4,41,29,12,38
LASK Linz,3961,4,7,7,10,25,30,-5,28
Vienna,3961,5,7,5,12,25,40,-15,26
SC Rheindorf,3961,6,6,5,13,22,33,-11,23
Mattersburg,3961,7,5,6,13,29,43,-14,21
FC Salzburg,3962,1,16,6,2,47,17,30,54
SK Sturm Gra,3962,2,12,4,8,32,29,3,40
Rapid Vienna,3962,3,8,10,6,35,29,6,34
LASK Linz,3962,4,9,7,8,28,26,2,34
Mattersburg,3962,5,7,6,11,33,41,-8,27
Vienna,3962,6,6,5,13,23,40,-17,23
SC Rheindorf,3962,7,4,6,14,21,37,-16,18
FC Salzburg,3963,1,14,6,4,43,20,23,48
SK Sturm Gra,3963,2,12,4,8,30,27,3,40
LASK Linz,3963,3,11,5,8,30,25,5,38
Rapid Vienna,3963,4,8,9,7,35,30,5,33
Vienna,3963,5,7,5,12,25,38,-13,26
Mattersburg,3963,6,6,6,12,28,41,-13,24
SC Rheindorf,3963,7,5,7,12,17,27,-10,22
FC Salzburg,3964,1,14,7,3,44,18,26,49
SK Sturm Gra,3964,2,13,4,7,33,27,6,43
LASK Linz,3964,3,9,6,9,27,27,0,33
Rapid Vienna,3964,4,7,10,7,35,31,4,31
SC Rheindorf,3964,5,7,5,12,20,29,-9,26
Vienna,3964,6,7,5,12,24,39,-15,26
Mattersburg,3964,7,6,5,13,28,40,-12,23
FC Salzburg,3965,1,16,6,2,46,18,28,54
Rapid Vienna,3965,2,9,10,5,38,27,11,37
SK Sturm Gra,3965,3,11,4,9,31,33,-2,37
LASK Linz,3965,4,9,5,10,28,29,-1,32
Vienna,3965,5,7,5,12,27,40,-13,26
Mattersburg,3965,6,6,6,12,28,40,-12,24
SC Rheindorf,3965,7,4,8,12,17,28,-11,20
FC Salzburg,3966,1,13,9,2,45,21,24,48
SK Sturm Gra,3966,2,11,5,8,32,31,1,38
Rapid Vienna,3966,3,8,10,6,33,26,7,34
LASK Linz,3966,4,8,6,10,26,28,-2,30
SC Rheindorf,3966,5,7,6,11,22,28,-6,27
Mattersburg,3966,6,6,7,11,31,41,-10,25
Vienna,3966,7,6,7,11,26,40,-14,25
FC Salzburg,3967,1,13,8,3,42,19,23,47
SK Sturm Gra,3967,2,12,4,8,32,30,2,40
Rapid Vienna,3967,3,9,10,5,39,29,10,37
LASK Linz,3967,4,9,6,9,29,27,2,33
Mattersburg,3967,5,8,6,10,34,38,-4,30
Vienna,3967,6,6,6,12,26,41,-15,24
SC Rheindorf,3967,7,4,6,14,17,35,-18,18
FC Salzburg,3968,1,14,7,3,44,17,27,49
SK Sturm Gra,3968,2,12,3,9,33,31,2,39
Rapid Vienna,3968,3,9,9,6,36,29,7,36
LASK Linz,3968,4,8,5,11,26,32,-6,29
Mattersburg,3968,5,7,6,11,30,39,-9,27
SC Rheindorf,3968,6,7,5,12,20,27,-7,26
Vienna,3968,7,7,5,12,27,41,-14,26
FC Salzburg,3969,1,15,7,2,44,15,29,52
SK Sturm Gra,3969,2,12,4,8,31,29,2,40
LASK Linz,3969,3,11,5,8,29,24,5,38
Rapid Vienna,3969,4,7,9,8,32,30,2,30
Vienna,3969,5,7,6,11,25,37,-12,27
Mattersburg,3969,6,6,5,13,28,41,-13,23
SC Rheindorf,3969,7,5,6,13,17,30,-13,21
FC Salzburg,3970,1,14,8,2,45,19,26,50
SK Sturm Gra,3970,2,12,4,8,34,31,3,40
Rapid Vienna,3970,3,9,10,5,39,29,10,37
LASK Linz,3970,4,9,5,10,31,32,-1,32
Mattersburg,3970,5,7,6,11,31,43,-12,27
Vienna,3970,6,6,5,13,25,41,-16,23
SC Rheindorf,3970,7,5,6,13,19,29,-10,21
FC Salzburg,3971,1,13,7,4,43,20,23,46
SK Sturm Gra,3971,2,12,5,7,34,30,4,41
Rapid Vienna,3971,3,8,12,4,36,27,9,36
LASK Linz,3971,4,8,7,9,27,27,0,31
Vienna,3971,5,8,5,11,27,38,-11,29
SC Rheindorf,3971,6,6,6,12,19,29,-10,24
Mattersburg,3971,7,5,6,13,30,45,-15,21
FC Salzburg,3972,1,15,6,3,47,19,28,51
SK Sturm Gra,3972,2,13,4,7,33,28,5,43
Rapid Vienna,3972,3,9,9,6,34,28,6,36
LASK Linz,3972,4,8,5,11,30,30,0,29
Mattersburg,3972,5,6,7,11,31,43,-12,25
Vienna,3972,6,6,6,12,25,41,-16,24
SC Rheindorf,3972,7,5,7,12,19,30,-11,22
FC Salzburg,3973,1,15,6,3,44,19,25,51
Rapid Vienna,3973,2,10,10,4,39,25,14,40
SK Sturm Gra,3973,3,11,5,8,30,29,1,38
LASK Linz,3973,4,7,7,10,28,32,-4,28
Mattersburg,3973,5,7,6,11,32,41,-9,27
Vienna,3973,6,6,5,13,26,43,-17,23
SC Rheindorf,3973,7,5,7,12,21,31,-10,22
FC Salzburg,3974,1,13,6,5,40,21,19,45
SK Sturm Gra,3974,2,12,4,8,33,29,4,40
Rapid Vienna,3974,3,9,9,6,34,28,6,36
LASK Linz,3974,4,9,5,10,26,26,0,32
Vienna,3974,5,8,5,11,28,39,-11,29
Mattersburg,3974,6,7,5,12,31,43,-12,26
SC Rheindorf,3974,7,6,6,12,21,27,-6,24
FC Salzburg,3975,1,13,7,4,39,18,21,46
SK Sturm Gra,3975,2,13,4,7,32,27,5,43
Rapid Vienna,3975,3,8,9,7,33,29,4,33
LASK Linz,3975,4,8,6,10,26,29,-3,30
Mattersburg,3975,5,7,6,11,32,44,-12,27
SC Rheindorf,3975,6,7,5,12,25,29,-4,26
Vienna,3975,7,7,5,12,27,38,-11,26
FC Salzburg,3976,1,15,6,3,43,18,25,51
Rapid Vienna,3976,2,11,9,4,40,25,15,42
SK Sturm Gra,3976,3,11,3,10,30,34,-4,36
LASK Linz,3976,4,8,6,10,29,30,-1,30
Mattersburg,3976,5,7,6,11,31,39,-8,27
Vienna,3976,6,6,6,12,25,40,-15,24
SC Rheindorf,3976,7,5,6,13,20,32,-12,21
FC Salzburg,3977,1,15,6,3,46,21,25,51
SK Sturm Gra,3977,2,12,4,8,32,29,3,40
Rapid Vienna,3977,3,9,10,5,36,28,8,37
SC Rheindorf,3977,4,7,6,11,23,27,-4,27
LASK Linz,3977,5,7,6,11,25,30,-5,27
Mattersburg,3977,6,6,6,12,29,41,-12,24
Vienna,3977,7,6,6,12,27,42,-15,24
FC Salzburg,3978,1,14,8,2,43,18,25,50
SK Sturm Gra,3978,2,12,4,8,32,29,3,40
Rapid Vienna,3978,3,9,9,6,38,28,10,36
LASK Linz,3978,4,9,5,10,26,27,-1,32
Vienna,3978,5,7,6,11,27,40,-13,27
Mattersburg,3978,6,7,5,12,32,40,-8,26
SC Rheindorf,3978,7,5,5,14,18,34,-16,20
FC Salzburg,3979,1,14,7,3,42,18,24,49
SK Sturm Gra,3979,2,12,4,8,33,30,3,40
Rapid Vienna,3979,3,10,9,5,36,26,10,39
LASK Linz,3979,4,9,6,9,29,28,1,33
Vienna,3979,5,7,5,12,28,39,-11,26
Mattersburg,3979,6,6,7,11,30,43,-13,25
SC Rheindorf,3979,7,4,6,14,19,33,-14,18
FC Salzburg,3980,1,12,8,4,40,20,20,44
SK Sturm Gra,3980,2,13,4,7,33,27,6,43
Rapid Vienna,3980,3,10,10,4,40,26,14,40
LASK Linz,3980,4,8,5,11,24,30,-6,29
SC Rheindorf,3980,5,7,5,12,21,27,-6,26
Mattersburg,3980,6,6,6,12,30,42,-12,24
Vienna,3980,7,6,6,12,23,39,-16,24
FC Salzburg,3981,1,16,6,2,46,16,30,54
SK Sturm Gra,3981,2,13,4,7,33,28,5,43
Rapid Vienna,3981,3,7,11,6,33,28,5,32
LASK Linz,3981,4,7,8,9,27,30,-3,29
Mattersburg,3981,5,7,6,11,31,39,-8,27
Vienna,3981,6,6,6,12,24,41,-17,24
SC Rheindorf,3981,7,4,7,13,18,30,-12,19
FC Salzburg,3982,1,14,7,3,43,18,25,49
Rapid Vienna,3982,2,10,9,5,36,26,10,39
SK Sturm Gra,3982,3,12,3,9,31,29,2,39
LASK Linz,3982,4,8,6,10,25,27,-2,30
Vienna,3982,5,7,5,12,26,40,-14,26
SC Rheindorf,3982,6,6,6,12,17,26,-9,24
Mattersburg,3982,7,5,8,11,28,40,-12,23
FC Salzburg,3983,1,14,7,3,44,19,25,49
SK Sturm Gra,3983,2,12,4,8,30,28,2,40
LASK Linz,3983,3,9,6,9,29,26,3,33
Rapid Vienna,3983,4,7,10,7,31,29,2,31
Vienna,3983,5,8,5,11,25,37,-12,29
SC Rheindorf,3983,6,6,6,12,19,28,-9,24
Mattersburg,3983,7,5,8,11,30,41,-11,23
FC Salzburg,3984,1,13,6,5,41,22,19,45
Rapid Vienna,3984,2,10,10,4,41,26,15,40
SK Sturm Gra,3984,3,12,4,8,33,31,2,40
LASK Linz,3984,4,8,8,8,33,32,1,32
Vienna,3984,5,8,5,11,27,38,-11,29
Mattersburg,3984,6,6,6,12,33,44,-11,24
SC Rheindorf,3984,7,4,7,13,17,32,-15,19
FC Salzburg,3985,1,15,7,2,43,15,28,52
SK Sturm Gra,3985,2,14,3,7,33,26,7,45
Rapid Vienna,3985,3,9,10,5,34,24,10,37
LASK Linz,3985,4,8,6,10,27,28,-1,30
Mattersburg,3985,5,7,5,12,30,42,-12,26
Vienna,3985,6,6,5,13,24,42,-18,23
SC Rheindorf,3985,7,4,6,14,17,31,-14,18
FC Salzburg,3986,1,13,7,4,45,25,20,46
SK Sturm Gra,3986,2,12,5,7,33,30,3,41
Rapid Vienna,3986,3,8,12,4,41,30,11,36
LASK Linz,3986,4,10,6,8,28,25,3,36
Vienna,3986,5,7,6,11,26,38,-12,27
Mattersburg,3986,6,5,6,13,30,44,-14,21
SC Rheindorf,3986,7,4,8,12,20,31,-11,20
SK Sturm Gra,3987,1,15,3,6,38,29,9,48
FC Salzburg,3987,2,13,7,4,41,19,22,46
Rapid Vienna,3987,3,9,10,5,40,26,14,37
Mattersburg,3987,4,8,5,11,33,41,-8,29
LASK Linz,3987,5,7,6,11,27,33,-6,27
Vienna,3987,6,7,5,12,26,40,-14,26
SC Rheindorf,3987,7,4,6,14,18,35,-17,18
FC Salzburg,3988,1,14,6,4,46,19,27,48
LASK Linz,3988,2,11,5,8,30,26,4,38
Rapid Vienna,3988,3,9,10,5,40,29,11,37
SK Sturm Gra,3988,4,11,4,9,31,33,-2,37
Vienna,3988,5,8,5,11,26,37,-11,29
Mattersburg,3988,6,6,5,13,28,44,-16,23
SC Rheindorf,3988,7,5,5,14,19,32,-13,20
FC Salzburg,3989,1,15,6,3,47,21,26,51
SK Sturm Gra,3989,2,14,4,6,39,29,10,46
Rapid Vienna,3989,3,7,11,6,35,29,6,32
LASK Linz,3989,4,8,6,10,31,34,-3,30
Mattersburg,3989,5,6,6,12,30,43,-13,24
Vienna,3989,6,6,6,12,24,39,-15,24
SC Rheindorf,3989,7,6,5,13,23,34,-11,23
FC Salzburg,3990,1,15,7,2,47,18,29,52
SK Sturm Gra,3990,2,11,5,8,29,30,-1,38
Rapid Vienna,3990,3,9,10,5,37,25,12,37
LASK Linz,3990,4,8,7,9,29,31,-2,31
Vienna,3990,5,7,6,11,28,40,-12,27
SC Rheindorf,3990,6,5,7,12,20,31,-11,22
Mattersburg,3990,7,5,6,13,32,47,-15,21
FC Salzburg,3991,1,15,6,3,46,20,26,51
SK Sturm Gra,3991,2,14,3,7,38,29,9,45
Rapid Vienna,3991,3,8,9,7,34,30,4,33
LASK Linz,3991,4,9,6,9,25,26,-1,33
Mattersburg,3991,5,6,6,12,32,43,-11,24
Vienna,3991,6,6,5,13,25,42,-17,23
SC Rheindorf,3991,7,5,7,12,21,31,-10,22
FC Salzburg,3992,1,15,7,2,48,16,32,52
SK Sturm Gra,3992,2,12,4,8,33,30,3,40
Rapid Vienna,3992,3,9,9,6,36,30,6,36
LASK Linz,3992,4,9,6,9,29,29,0,33
Mattersburg,3992,5,6,7,11,31,44,-13,25
Vienna,3992,6,6,5,13,25,43,-18,23
SC Rheindorf,3992,7,5,6,13,20,30,-10,21
FC Salzburg,3993,1,15,6,3,49,20,29,51
SK Sturm Gra,3993,2,12,3,9,30,32,-2,39
Rapid Vienna,3993,3,9,9,6,35,26,9,36
LASK Linz,3993,4,9,6,9,29,27,2,33
Mattersburg,3993,5,7,6,11,30,40,-10,27
Vienna,3993,6,6,5,13,25,43,-18,23
SC Rheindorf,3993,7,5,7,12,19,29,-10,22
FC Salzburg,3994,1,15,6,3,45,18,27,51
SK Sturm Gra,3994,2,12,5,7,33,30,3,41
LASK Linz,3994,3,9,6,9,31,28,3,33
Rapid Vienna,3994,4,7,10,7,33,30,3,31
Vienna,3994,5,7,5,12,24,38,-14,26
Mattersburg,3994,6,6,6,12,29,40,-11,24
SC Rheindorf,3994,7,6,6,12,20,31,-11,24
FC Salzburg,3995,1,13,7,4,41,21,20,46
Rapid Vienna,3995,2,9,11,4,36,25,11,38
SK Sturm Gra,3995,3,11,4,9,29,30,-1,37
Mattersburg,3995,4,9,5,10,37,40,-3,32
LASK Linz,3995,5,8,5,11,27,29,-2,29
SC Rheindorf,3995,6,6,6,12,19,29,-10,24
Vienna,3995,7,6,6,12,27,42,-15,24
FC Salzburg,3996,1,14,7,3,48,23,25,49
SK Sturm Gra,3996,2,12,5,7,31,27,4,41
Rapid Vienna,3996,3,9,11,4,36,26,10,38
LASK Linz,3996,4,8,6,10,25,27,-2,30
Vienna,3996,5,7,5,12,28,41,-13,26
Mattersburg,3996,6,6,6,12,33,46,-13,24
SC Rheindorf,3996,7,5,6,13,17,28,-11,21
FC Salzburg,3997,1,16,6,2,49,15,34,54
SK Sturm Gra,3997,2,12,3,9,31,32,-1,39
Rapid Vienna,3997,3,9,9,6,36,30,6,36
LASK Linz,3997,4,8,6,10,25,27,-2,30
Mattersburg,3997,5,7,5,12,30,42,-12,26
SC Rheindorf,3997,6,6,6,12,22,29,-7,24
Vienna,3997,7,6,5,13,24,42,-18,23
FC Salzburg,3998,1,16,6,2,48,16,32,54
SK Sturm Gra,3998,2,14,3,7,36,29,7,45
Rapid Vienna,3998,3,8,10,6,36,29,7,34
LASK Linz,3998,4,7,6,11,26,32,-6,27
Mattersburg,3998,5,7,6,11,32,44,-12,27
Vienna,3998,6,6,6,12,25,40,-15,24
SC Rheindorf,3998,7,5,5,14,18,31,-13,20
SK Sturm Gra,3999,1,15,3,6,38,25,13,48
FC Salzburg,3999,2,13,6,5,40,23,17,45
Rapid Vienna,3999,3,9,10,5,39,28,11,37
LASK Linz,3999,4,8,6,10,25,31,-6,30
Mattersburg,3999,5,7,5,12,30,41,-11,26
Vienna,3999,6,7,5,12,28,40,-12,26
SC Rheindorf,3999,7,5,5,14,17,29,-12,20
FC Salzburg,4000,1,15,6,3,46,18,28,51
SK Sturm Gra,4000,2,12,3,9,31,31,0,39
LASK Linz,4000,3,10,6,8,29,26,3,36
Rapid Vienna,4000,4,8,9,7,34,30,4,33
Mattersburg,4000,5,8,6,10,34,39,-5,30
Vienna,4000,6,6,5,13,25,42,-17,23
SC Rheindorf,4000,7,5,5,14,18,31,-13,20
FC Salzburg,4001,1,15,6,3,47,17,30,51
SK Sturm Gra,4001,2,14,3,7,35,27,8,45
Rapid Vienna,4001,3,7,10,7,32,30,2,31
LASK Linz,4001,4,8,6,10,27,31,-4,30
Vienna,4001,5,8,5,11,26,38,-12,29
Mattersburg,4001,6,6,6,12,29,42,-13,24
SC Rheindorf,4001,7,4,8,12,16,27,-11,20
FC Salzburg,4002,1,16,6,2,51,18,33,54
SK Sturm Gra,4002,2,12,4,8,31,29,2,40
Rapid Vienna,4002,3,9,9,6,35,27,8,36
LASK Linz,4002,4,9,6,9,28,27,1,33
Mattersburg,4002,5,7,6,11,32,44,-12,27
Vienna,4002,6,6,5,13,25,43,-18,23
SC Rheindorf,4002,7,4,6,14,18,32,-14,18
FC Salzburg,4003,1,15,6,3,43,17,26,51
SK Sturm Gra,4003,2,12,5,7,31,27,4,41
Rapid Vienna,4003,3,8,11,5,34,27,7,35
LASK Linz,4003,4,8,8,8,26,25,1,32
Vienna,4003,5,6,6,12,24,40,-16,24
SC Rheindorf,4003,6,5,7,12,18,28,-10,22
Mattersburg,4003,7,5,7,12,29,41,-12,22
FC Salzburg,4004,1,15,7,2,42,16,26,52
SK Sturm Gra,4004,2,12,5,7,31,27,4,41
Rapid Vienna,4004,3,7,11,6,33,28,5,32
LASK Linz,4004,4,7,8,9,25,28,-3,29
Mattersburg,4004,5,7,5,12,32,39,-7,26
SC Rheindorf,4004,6,6,7,11,20,27,-7,25
Vienna,4004,7,6,5,13,23,41,-18,23
FC Salzburg,4005,1,14,6,4,45,19,26,48
SK Sturm Gra,4005,2,11,5,8,32,30,2,38
Rapid Vienna,4005,3,8,11,5,36,30,6,35
LASK Linz,4005,4,8,7,9,32,33,-1,31
Mattersburg,4005,5,7,5,12,30,41,-11,26
Vienna,4005,6,7,5,12,26,42,-16,26
SC Rheindorf,4005,7,6,7,11,24,30,-6,25
FC Salzburg,4006,1,13,8,3,40,18,22,47
SK Sturm Gra,4006,2,14,3,7,35,27,8,45
LASK Linz,4006,3,10,5,9,29,29,0,35
Rapid Vienna,4006,4,7,11,6,31,26,5,32
Vienna,4006,5,7,5,12,26,39,-13,26
Mattersburg,4006,6,6,6,12,30,42,-12,24
SC Rheindorf,4006,7,5,6,13,17,27,-10,21
FC Salzburg,4007,1,14,7,3,43,21,22,49
SK Sturm Gra,4007,2,12,4,8,33,30,3,40
Rapid Vienna,4007,3,9,9,6,40,27,13,36
LASK Linz,4007,4,9,6,9,28,29,-1,33
Vienna,4007,5,7,6,11,25,37,-12,27
Mattersburg,4007,6,6,7,11,31,40,-9,25
SC Rheindorf,4007,7,4,7,13,16,32,-16,19
FC Salzburg,4008,1,14,8,2,47,17,30,50
SK Sturm Gra,4008,2,12,5,7,35,31,4,41
Rapid Vienna,4008,3,8,10,6,34,29,5,34
LASK Linz,4008,4,8,7,9,31,31,0,31
Mattersburg,4008,5,7,6,11,32,42,-10,27
Vienna,4008,6,6,6,12,23,41,-18,24
SC Rheindorf,4008,7,5,6,13,18,29,-11,21
FC Salzburg,4009,1,14,7,3,48,17,31,49
SK Sturm Gra,4009,2,12,4,8,32,29,3,40
Rapid Vienna,4009,3,8,9,7,34,30,4,33
LASK Linz,4009,4,9,6,9,25,27,-2,33
Mattersburg,4009,5,7,6,11,31,42,-11,27
Vienna,4009,6,7,5,12,26,42,-16,26
SC Rheindorf,4009,7,6,5,13,23,32,-9,23
FC Salzburg,4010,1,14,6,4,43,21,22,48
SK Sturm Gra,4010,2,12,3,9,30,28,2,39
Rapid Vienna,4010,3,9,9,6,38,27,11,36
LASK Linz,4010,4,10,5,9,27,25,2,35
Vienna,4010,5,8,5,11,27,39,-12,29
SC Rheindorf,4010,6,6,6,12,18,29,-11,24
Mattersburg,4010,7,5,6,13,27,41,-14,21
FC Salzburg,4011,1,15,7,2,48,21,27,52
SK Sturm Gra,4011,2,14,3,7,34,27,7,45
Rapid Vienna,4011,3,8,10,6,35,28,7,34
LASK Linz,4011,4,7,6,11,26,32,-6,27
Vienna,4011,5,7,6,11,28,41,-13,27
SC Rheindorf,4011,6,6,5,13,22,32,-10,23
Mattersburg,4011,7,6,5,13,32,44,-12,23
FC Salzburg,4012,1,15,6,3,45,19,26,51
SK Sturm Gra,4012,2,12,4,8,30,29,1,40
LASK Linz,4012,3,10,6,8,26,24,2,36
Rapid Vienna,4012,4,8,9,7,36,28,8,33
Mattersburg,4012,5,7,5,12,29,41,-12,26
SC Rheindorf,4012,6,6,5,13,20,28,-8,23
Vienna,4012,7,6,5,13,25,42,-17,23
FC Salzburg,4013,1,15,6,3,45,16,29,51
SK Sturm Gra,4013,2,11,4,9,30,30,0,37
Rapid Vienna,4013,3,8,10,6,34,28,6,34
LASK Linz,4013,4,9,6,9,27,26,1,33
Vienna,4013,5,8,5,11,25,37,-12,29
SC Rheindorf,4013,6,7,6,11,20,26,-6,27
Mattersburg,4013,7,5,5,14,26,44,-18,20
FC Salzburg,4014,1,16,6,2,47,18,29,54
SK Sturm Gra,4014,2,13,3,8,31,29,2,42
Rapid Vienna,4014,3,8,10,6,35,27,8,34
LASK Linz,4014,4,7,7,10,25,28,-3,28
Vienna,4014,5,7,5,12,24,39,-15,26
Mattersburg,4014,6,6,6,12,30,41,-11,24
SC Rheindorf,4014,7,5,7,12,19,29,-10,22
FC Salzburg,4015,1,15,7,2,48,17,31,52
SK Sturm Gra,4015,2,12,4,8,32,31,1,40
Rapid Vienna,4015,3,7,11,6,37,31,6,32
LASK Linz,4015,4,8,8,8,28,28,0,32
Mattersburg,4015,5,7,6,11,32,40,-8,27
Vienna,4015,6,6,5,13,25,45,-20,23
SC Rheindorf,4015,7,5,7,12,18,28,-10,22
FC Salzburg,4016,1,14,6,4,42,18,24,48
SK Sturm Gra,4016,2,13,3,8,32,27,5,42
Rapid Vienna,4016,3,10,9,5,35,25,10,39
LASK Linz,4016,4,8,5,11,26,30,-4,29
Mattersburg,4016,5,7,6,11,30,40,-10,27
Vienna,4016,6,7,5,12,25,39,-14,26
SC Rheindorf,4016,7,5,6,13,17,28,-11,21
FC Salzburg,4017,1,15,7,2,48,18,30,52
SK Sturm Gra,4017,2,12,5,7,35,31,4,41
LASK Linz,4017,3,10,5,9,30,27,3,35
Rapid Vienna,4017,4,8,10,6,37,31,6,34
Mattersburg,4017,5,7,6,11,29,41,-12,27
Vienna,4017,6,6,6,12,24,40,-16,24
SC Rheindorf,4017,7,4,5,15,17,32,-15,17
FC Salzburg,4018,1,15,6,3,48,18,30,51
SK Sturm Gra,4018,2,13,4,7,32,26,6,43
Rapid Vienna,4018,3,10,9,5,35,27,8,39
LASK Linz,4018,4,7,7,10,23,27,-4,28
Mattersburg,4018,5,7,5,12,31,41,-10,26
Vienna,4018,6,6,5,13,24,43,-19,23
SC Rheindorf,4018,7,5,6,13,16,27,-11,21
FC Salzburg,4019,1,14,8,2,45,17,28,50
SK Sturm Gra,4019,2,12,6,6,31,25,6,42
LASK Linz,4019,3,9,7,8,29,27,2,34
Rapid Vienna,4019,4,7,11,6,35,30,5,32
Vienna,4019,5,6,7,11,26,40,-14,25
Mattersburg,4019,6,6,6,12,31,44,-13,24
SC Rheindorf,4019,7,5,5,14,18,32,-14,20
FC Salzburg,4020,1,15,7,2,49,21,28,52
SK Sturm Gra,4020,2,13,4,7,37,33,4,43
Rapid Vienna,4020,3,9,9,6,34,26,8,36
LASK Linz,4020,4,8,6,10,28,29,-1,30
SC Rheindorf,4020,5,6,6,12,22,30,-8,24
Mattersburg,4020,6,6,5,13,31,45,-14,23
Vienna,4020,7,6,5,13,24,41,-17,23
FC Salzburg,4021,1,13,8,3,42,19,23,47
SK Sturm Gra,4021,2,12,5,7,33,28,5,41
Rapid Vienna,4021,3,10,9,5,39,28,11,39
LASK Linz,4021,4,7,7,10,26,31,-5,28
Vienna,4021,5,7,5,12,26,39,-13,26
SC Rheindorf,4021,6,6,7,11,20,28,-8,25
Mattersburg,4021,7,5,7,12,30,43,-13,22
FC Salzburg,4022,1,14,8,2,48,20,28,50
SK Sturm Gra,4022,2,12,3,9,32,33,-1,39
Rapid Vienna,4022,3,9,11,4,42,28,14,38
LASK Linz,4022,4,8,8,8,27,27,0,32
Vienna,4022,5,7,5,12,26,40,-14,26
Mattersburg,4022,6,5,7,12,31,44,-13,22
SC Rheindorf,4022,7,5,6,13,18,32,-14,21
FC Salzburg,4023,1,16,6,2,46,16,30,54
SK Sturm Gra,4023,2,12,4,8,32,30,2,40
Rapid Vienna,4023,3,7,11,6,35,29,6,32
LASK Linz,4023,4,7,7,10,26,30,-4,28
Mattersburg,4023,5,7,6,11,33,41,-8,27
SC Rheindorf,4023,6,7,5,12,22,30,-8,26
Vienna,4023,7,6,5,13,24,42,-18,23
FC Salzburg,4024,1,14,7,3,46,20,26,49
SK Sturm Gra,4024,2,12,5,7,35,32,3,41
Rapid Vienna,4024,3,8,11,5,34,27,7,35
Mattersburg,4024,4,8,5,11,32,38,-6,29
LASK Linz,4024,5,7,7,10,25,28,-3,28
Vienna,4024,6,7,5,12,26,41,-15,26
SC Rheindorf,4024,7,5,6,13,20,32,-12,21
FC Salzburg,4025,1,15,6,3,48,19,29,51
SK Sturm Gra,4025,2,12,4,8,30,27,3,40
Rapid Vienna,4025,3,10,9,5,37,27,10,39
LASK Linz,4025,4,7,6,11,25,30,-5,27
Mattersburg,4025,5,7,5,12,31,45,-14,26
Vienna,4025,6,7,5,12,28,42,-14,26
SC Rheindorf,4025,7,6,5,13,18,27,-9,23
FC Salzburg,4026,1,15,6,3,42,17,25,51
SK Sturm Gra,4026,2,12,4,8,31,28,3,40
Rapid Vienna,4026,3,8,10,6,34,27,7,34
LASK Linz,4026,4,8,6,10,25,30,-5,30
Mattersburg,4026,5,7,6,11,33,39,-6,27
Vienna,4026,6,7,5,12,24,39,-15,26
SC Rheindorf,4026,7,5,7,12,19,28,-9,22
FC Salzburg,4027,1,15,6,3,46,19,27,51
SK Sturm Gra,4027,2,14,4,6,34,26,8,46
Rapid Vienna,4027,3,7,9,8,33,31,2,30
LASK Linz,4027,4,8,6,10,26,28,-2,30
SC Rheindorf,4027,5,6,7,11,20,27,-7,25
Vienna,4027,6,6,6,12,26,43,-17,24
Mattersburg,4027,7,5,8,11,29,40,-11,23
FC Salzburg,4028,1,15,6,3,42,16,26,51
SK Sturm Gra,4028,2,12,3,9,30,28,2,39
Rapid Vienna,4028,3,8,11,5,35,28,7,35
LASK Linz,4028,4,8,7,9,31,32,-1,31
Mattersburg,4028,5,7,6,11,32,41,-9,27
Vienna,4028,6,6,6,12,24,39,-15,24
SC Rheindorf,4028,7,5,7,12,19,29,-10,22
FC Salzburg,4029,1,15,6,3,45,17,28,51
SK Sturm Gra,4029,2,11,4,9,30,31,-1,37
Rapid Vienna,4029,3,8,9,7,35,29,6,33
LASK Linz,4029,4,8,7,9,26,27,-1,31
Mattersburg,4029,5,7,6,11,29,39,-10,27
SC Rheindorf,4029,6,7,5,12,20,28,-8,26
Vienna,4029,7,7,5,12,25,39,-14,26
FC Salzburg,4030,1,15,7,2,46,18,28,52
SK Sturm Gra,4030,2,11,5,8,28,27,1,38
Rapid Vienna,4030,3,9,10,5,39,28,11,37
LASK Linz,4030,4,10,5,9,31,29,2,35
Vienna,4030,5,7,6,11,26,38,-12,27
Mattersburg,4030,6,5,6,13,32,47,-15,21
SC Rheindorf,4030,7,4,7,13,20,35,-15,19
FC Salzburg,4031,1,14,7,3,47,19,28,49
SK Sturm Gra,4031,2,12,4,8,33,32,1,40
Rapid Vienna,4031,3,8,11,5,35,28,7,35
LASK Linz,4031,4,10,5,9,35,30,5,35
Vienna,4031,5,7,6,11,27,39,-12,27
Mattersburg,4031,6,6,6,12,34,47,-13,24
SC Rheindorf,4031,7,5,5,14,20,36,-16,20
FC Salzburg,4032,1,15,7,2,43,17,26,52
SK Sturm Gra,4032,2,13,3,8,34,29,5,42
Rapid Vienna,4032,3,8,10,6,35,29,6,34
LASK Linz,4032,4,7,8,9,29,31,-2,29
Vienna,4032,5,7,5,12,26,40,-14,26
Mattersburg,4032,6,6,7,11,32,41,-9,25
SC Rheindorf,4032,7,5,6,13,19,31,-12,21
FC Salzburg,4033,1,14,6,4,47,19,28,48
Rapid Vienna,4033,2,9,10,5,35,26,9,37
LASK Linz,4033,3,10,6,8,30,26,4,36
SK Sturm Gra,4033,4,11,3,10,29,33,-4,36
Vienna,4033,5,8,5,11,26,37,-11,29
SC Rheindorf,4033,6,6,5,13,20,30,-10,23
Mattersburg,4033,7,6,5,13,31,47,-16,23
FC Salzburg,4034,1,15,7,2,48,18,30,52
SK Sturm Gra,4034,2,13,3,8,30,29,1,42
Rapid Vienna,4034,3,8,10,6,33,27,6,34
LASK Linz,4034,4,7,7,10,24,29,-5,28
Mattersburg,4034,5,7,6,11,34,41,-7,27
Vienna,4034,6,6,7,11,25,39,-14,25
SC Rheindorf,4034,7,5,6,13,19,30,-11,21
FC Salzburg,4035,1,14,8,2,43,16,27,50
SK Sturm Gra,4035,2,12,3,9,32,30,2,39
Rapid Vienna,4035,3,8,10,6,34,29,5,34
SC Rheindorf,4035,4,8,5,11,23,26,-3,29
LASK Linz,4035,5,8,5,11,25,30,-5,29
Vienna,4035,6,7,6,11,27,37,-10,27
Mattersburg,4035,7,6,5,13,28,44,-16,23
FC Salzburg,4036,1,13,8,3,42,18,24,47
SK Sturm Gra,4036,2,14,4,6,32,24,8,46
Rapid Vienna,4036,3,10,9,5,36,24,12,39
Mattersburg,4036,4,8,5,11,32,39,-7,29
LASK Linz,4036,5,8,5,11,25,32,-7,29
Vienna,4036,6,6,6,12,26,41,-15,24
SC Rheindorf,4036,7,4,5,15,16,31,-15,17
FC Salzburg,4037,1,14,8,2,46,17,29,50
SK Sturm Gra,4037,2,13,4,7,33,32,1,43
Rapid Vienna,4037,3,9,9,6,35,27,8,36
LASK Linz,4037,4,7,8,9,26,28,-2,29
Mattersburg,4037,5,6,7,11,30,39,-9,25
Vienna,4037,6,6,6,12,23,39,-16,24
SC Rheindorf,4037,7,5,6,13,16,27,-11,21
FC Salzburg,4038,1,13,8,3,44,19,25,47
SK Sturm Gra,4038,2,13,4,7,32,28,4,43
Rapid Vienna,4038,3,9,9,6,35,26,9,36
LASK Linz,4038,4,8,6,10,26,32,-6,30
Mattersburg,4038,5,6,8,10,31,39,-8,26
Vienna,4038,6,6,6,12,25,41,-16,24
SC Rheindorf,4038,7,5,7,12,19,27,-8,22
FC Salzburg,4039,1,15,7,2,48,18,30,52
SK Sturm Gra,4039,2,14,4,6,35,27,8,46
Rapid Vienna,4039,3,8,10,6,42,34,8,34
LASK Linz,4039,4,8,7,9,27,27,0,31
Mattersburg,4039,5,6,6,12,31,44,-13,24
Vienna,4039,6,6,5,13,24,43,-19,23
SC Rheindorf,4039,7,4,7,13,17,31,-14,19
FC Salzburg,4040,1,15,7,2,46,18,28,52
SK Sturm Gra,4040,2,12,3,9,33,31,2,39
Rapid Vienna,4040,3,9,10,5,39,29,10,37
LASK Linz,4040,4,9,5,10,26,29,-3,32
Mattersburg,4040,5,8,5,11,33,37,-4,29
Vienna,4040,6,6,5,13,25,45,-20,23
SC Rheindorf,4040,7,5,5,14,17,30,-13,20
FC Salzburg,4041,1,16,6,2,52,15,37,54
SK Sturm Gra,4041,2,12,3,9,30,31,-1,39
Rapid Vienna,4041,3,9,9,6,38,32,6,36
LASK Linz,4041,4,8,5,11,24,31,-7,29
Mattersburg,4041,5,7,5,12,33,45,-12,26
Vienna,4041,6,7,5,12,27,40,-13,26
SC Rheindorf,4041,7,6,5,13,21,31,-10,23
FC Salzburg,4042,1,15,6,3,50,17,33,51
SK Sturm Gra,4042,2,13,4,7,33,31,2,43
Rapid Vienna,4042,3,8,11,5,34,28,6,35
Mattersburg,4042,4,8,5,11,34,41,-7,29
LASK Linz,4042,5,7,7,10,23,27,-4,28
Vienna,4042,6,7,5,12,26,40,-14,26
SC Rheindorf,4042,7,4,6,14,16,32,-16,18
FC Salzburg,4043,1,15,6,3,45,18,27,51
SK Sturm Gra,4043,2,12,5,7,34,31,3,41
Rapid Vienna,4043,3,8,11,5,35,27,8,35
LASK Linz,4043,4,8,6,10,28,30,-2,30
SC Rheindorf,4043,5,7,6,11,22,29,-7,27
Vienna,4043,6,7,5,12,25,40,-15,26
Mattersburg,4043,7,5,5,14,31,45,-14,20
FC Salzburg,4044,1,14,8,2,46,18,28,50
SK Sturm Gra,4044,2,14,3,7,32,28,4,45
Rapid Vienna,4044,3,8,10,6,35,29,6,34
LASK Linz,4044,4,8,6,10,28,30,-2,30
Vienna,4044,5,7,5,12,26,40,-14,26
Mattersburg,4044,6,5,8,11,31,42,-11,23
SC Rheindorf,4044,7,5,6,13,18,29,-11,21
FC Salzburg,4045,1,13,9,2,40,16,24,48
SK Sturm Gra,4045,2,11,5,8,32,35,-3,38
Rapid Vienna,4045,3,9,10,5,38,29,9,37
LASK Linz,4045,4,8,6,10,31,29,2,30
Mattersburg,4045,5,7,7,10,31,39,-8,28
Vienna,4045,6,6,6,12,25,40,-15,24
SC Rheindorf,4045,7,5,7,12,19,28,-9,22
FC Salzburg,4046,1,14,7,3,44,18,26,49
Rapid Vienna,4046,2,11,9,4,39,24,15,42
SK Sturm Gra,4046,3,11,6,7,33,31,2,39
LASK Linz,4046,4,8,7,9,27,28,-1,31
Vienna,4046,5,6,6,12,24,41,-17,24
Mattersburg,4046,6,5,7,12,27,40,-13,22
SC Rheindorf,4046,7,4,8,12,19,31,-12,20
FC Salzburg,4047,1,14,6,4,43,21,22,48
SK Sturm Gra,4047,2,13,4,7,34,28,6,43
LASK Linz,4047,3,10,6,8,29,26,3,36
Rapid Vienna,4047,4,8,10,6,33,26,7,34
Mattersburg,4047,5,8,5,11,36,39,-3,29
Vienna,4047,6,6,5,13,25,43,-18,23
SC Rheindorf,4047,7,4,6,14,15,32,-17,18
FC Salzburg,4048,1,15,7,2,45,17,28,52
SK Sturm Gra,4048,2,13,4,7,32,27,5,43
Rapid Vienna,4048,3,8,11,5,36,28,8,35
LASK Linz,4048,4,8,6,10,26,29,-3,30
Vienna,4048,5,7,5,12,28,40,-12,26
SC Rheindorf,4048,6,5,8,11,22,31,-9,23
Mattersburg,4048,7,5,5,14,30,47,-17,20
FC Salzburg,4049,1,13,8,3,44,18,26,47
SK Sturm Gra,4049,2,12,5,7,32,27,5,41
Rapid Vienna,4049,3,8,12,4,34,25,9,36
Mattersburg,4049,4,8,5,11,33,42,-9,29
LASK Linz,4049,5,7,7,10,24,28,-4,28
Vienna,4049,6,6,6,12,23,39,-16,24
SC Rheindorf,4049,7,5,7,12,17,28,-11,22
FC Salzburg,4050,1,16,6,2,45,17,28,54
SK Sturm Gra,4050,2,13,3,8,33,30,3,42
Rapid Vienna,4050,3,8,9,7,33,27,6,33
LASK Linz,4050,4,8,6,10,28,30,-2,30
SC Rheindorf,4050,5,6,6,12,19,28,-9,24
Mattersburg,4050,6,6,6,12,30,41,-11,24
Vienna,4050,7,6,6,12,24,39,-15,24
FC Salzburg,4051,1,14,8,2,42,16,26,50
SK Sturm Gra,4051,2,11,5,8,29,28,1,38
Rapid Vienna,4051,3,9,10,5,35,25,10,37
LASK Linz,4051,4,8,7,9,27,29,-2,31
Mattersburg,4051,5,6,6,12,30,39,-9,24
SC Rheindorf,4051,6,6,6,12,18,27,-9,24
Vienna,4051,7,6,6,12,23,40,-17,24
FC Salzburg,4052,1,14,7,3,45,21,24,49
SK Sturm Gra,4052,2,13,5,6,32,26,6,44
Rapid Vienna,4052,3,10,9,5,38,27,11,39
LASK Linz,4052,4,9,6,9,30,29,1,33
Vienna,4052,5,7,5,12,25,39,-14,26
SC Rheindorf,4052,6,5,5,14,19,30,-11,20
Mattersburg,4052,7,5,5,14,29,46,-17,20
SK Sturm Gra,4053,1,15,3,6,35,25,10,48
FC Salzburg,4053,2,12,8,4,42,22,20,44
Rapid Vienna,4053,3,9,9,6,36,28,8,36
LASK Linz,4053,4,8,6,10,27,29,-2,30
SC Rheindorf,4053,5,6,6,12,23,31,-8,24
Mattersburg,4053,6,6,6,12,33,43,-10,24
Vienna,4053,7,6,6,12,25,43,-18,24
FC Salzburg,4054,1,14,7,3,45,21,24,49
SK Sturm Gra,4054,2,12,4,8,31,30,1,40
Rapid Vienna,4054,3,9,10,5,38,27,11,37
LASK Linz,4054,4,8,7,9,26,27,-1,31
SC Rheindorf,4054,5,6,7,11,21,28,-7,25
Vienna,4054,6,6,7,11,24,38,-14,25
Mattersburg,4054,7,5,6,13,26,40,-14,21
FC Salzburg,4055,1,15,6,3,43,19,24,51
SK Sturm Gra,4055,2,14,3,7,33,26,7,45
Rapid Vienna,4055,3,7,11,6,36,30,6,32
Vienna,4055,4,8,5,11,29,39,-10,29
LASK Linz,4055,5,7,6,11,27,31,-4,27
Mattersburg,4055,6,7,5,12,35,45,-10,26
SC Rheindorf,4055,7,5,6,13,20,33,-13,21
FC Salzburg,4056,1,16,6,2,50,19,31,54
SK Sturm Gra,4056,2,13,3,8,36,33,3,42
Rapid Vienna,4056,3,9,9,6,35,29,6,36
LASK Linz,4056,4,8,6,10,28,28,0,30
Mattersburg,4056,5,6,7,11,31,41,-10,25
Vienna,4056,6,6,5,13,23,41,-18,23
SC Rheindorf,4056,7,5,6,13,20,32,-12,21
FC Salzburg,4057,1,13,6,5,41,21,20,45
SK Sturm Gra,4057,2,12,4,8,32,28,4,40
Rapid Vienna,4057,3,8,11,5,36,27,9,35
LASK Linz,4057,4,8,6,10,26,32,-6,30
SC Rheindorf,4057,5,7,6,11,24,27,-3,27
Vienna,4057,6,7,6,11,27,40,-13,27
Mattersburg,4057,7,6,7,11,32,43,-11,25
FC Salzburg,4058,1,15,7,2,45,17,28,52
SK Sturm Gra,4058,2,12,4,8,31,30,1,40
LASK Linz,4058,3,10,5,9,32,29,3,35
Rapid Vienna,4058,4,8,10,6,36,31,5,34
Vienna,4058,5,7,5,12,25,39,-14,26
Mattersburg,4058,6,5,7,12,31,43,-12,22
SC Rheindorf,4058,7,5,6,13,20,31,-11,21
FC Salzburg,4059,1,14,7,3,47,21,26,49
SK Sturm Gra,4059,2,13,3,8,33,29,4,42
Rapid Vienna,4059,3,9,11,4,37,25,12,38
LASK Linz,4059,4,8,7,9,28,30,-2,31
Mattersburg,4059,5,6,7,11,33,44,-11,25
Vienna,4059,6,6,6,12,26,41,-15,24
SC Rheindorf,4059,7,5,5,14,17,31,-14,20
FC Salzburg,4060,1,15,6,3,45,16,29,51
SK Sturm Gra,4060,2,12,4,8,30,31,-1,40
LASK Linz,4060,3,9,7,8,26,25,1,34
Rapid Vienna,4060,4,8,9,7,36,30,6,33
Mattersburg,4060,5,7,6,11,30,40,-10,27
SC Rheindorf,4060,6,6,5,13,23,31,-8,23
Vienna,4060,7,6,5,13,23,40,-17,23
FC Salzburg,4061,1,14,6,4,51,23,28,48
SK Sturm Gra,4061,2,12,4,8,35,30,5,40
LASK Linz,4061,3,9,7,8,28,27,1,34
Rapid Vienna,4061,4,8,9,7,35,31,4,33
Vienna,4061,5,7,5,12,30,43,-13,26
SC Rheindorf,4061,6,6,7,11,20,28,-8,25
Mattersburg,4061,7,6,6,12,28,45,-17,24
FC Salzburg,4062,1,16,6,2,46,17,29,54
SK Sturm Gra,4062,2,12,5,7,33,29,4,41
Rapid Vienna,4062,3,9,10,5,36,27,9,37
LASK Linz,4062,4,8,6,10,25,27,-2,30
Vienna,4062,5,7,5,12,29,40,-11,26
Mattersburg,4062,6,6,5,13,30,46,-16,23
SC Rheindorf,4062,7,5,5,14,19,32,-13,20
FC Salzburg,4063,1,12,9,3,40,18,22,45
SK Sturm Gra,4063,2,12,5,7,32,28,4,41
Rapid Vienna,4063,3,9,10,5,35,27,8,37
LASK Linz,4063,4,8,8,8,26,25,1,32
Vienna,4063,5,7,6,11,24,37,-13,27
SC Rheindorf,4063,6,5,7,12,20,29,-9,22
Mattersburg,4063,7,5,7,12,28,41,-13,22
FC Salzburg,4064,1,14,8,2,43,17,26,50
SK Sturm Gra,4064,2,12,3,9,33,29,4,39
LASK Linz,4064,3,9,5,10,27,27,0,32
Rapid Vienna,4064,4,7,10,7,33,32,1,31
SC Rheindorf,4064,5,7,6,11,21,27,-6,27
Mattersburg,4064,6,6,7,11,29,40,-11,25
Vienna,4064,7,6,7,11,24,38,-14,25
FC Salzburg,4065,1,13,6,5,40,19,21,45
SK Sturm Gra,4065,2,14,3,7,32,26,6,45
Rapid Vienna,4065,3,10,10,4,37,25,12,40
LASK Linz,4065,4,8,7,9,29,30,-1,31
Vienna,4065,5,7,5,12,25,39,-14,26
Mattersburg,4065,6,6,6,12,29,41,-12,24
SC Rheindorf,4065,7,5,5,14,17,29,-12,20
FC Salzburg,4066,1,15,7,2,47,17,30,52
SK Sturm Gra,4066,2,14,3,7,35,28,7,45
Rapid Vienna,4066,3,9,9,6,38,25,13,36
LASK Linz,4066,4,9,5,10,28,33,-5,32
Vienna,4066,5,6,6,12,24,39,-15,24
Mattersburg,4066,6,6,5,13,27,43,-16,23
SC Rheindorf,4066,7,5,5,14,19,33,-14,20
FC Salzburg,4067,1,16,6,2,43,15,28,54
SK Sturm Gra,4067,2,12,5,7,33,28,5,41
Rapid Vienna,4067,3,8,11,5,37,28,9,35
LASK Linz,4067,4,7,5,12,26,33,-7,26
Mattersburg,4067,5,7,5,12,30,40,-10,26
Vienna,4067,6,7,5,12,24,38,-14,26
SC Rheindorf,4067,7,5,7,12,21,32,-11,22
FC Salzburg,4068,1,16,6,2,47,18,29,54
SK Sturm Gra,4068,2,12,4,8,32,31,1,40
Rapid Vienna,4068,3,9,9,6,38,27,11,36
LASK Linz,4068,4,8,6,10,24,30,-6,30
Vienna,4068,5,7,5,12,27,41,-14,26
SC Rheindorf,4068,6,6,5,13,23,32,-9,23
Mattersburg,4068,7,6,5,13,31,43,-12,23
FC Salzburg,4069,1,16,6,2,55,20,35,54
SK Sturm Gra,4069,2,12,4,8,33,34,-1,40
LASK Linz,4069,3,9,6,9,29,30,-1,33
Rapid Vienna,4069,4,7,9,8,33,32,1,30
SC Rheindorf,4069,5,7,6,11,23,28,-5,27
Vienna,4069,6,7,5,12,28,41,-13,26
Mattersburg,4069,7,5,6,13,27,43,-16,21
FC Salzburg,4070,1,15,6,3,45,16,29,51
SK Sturm Gra,4070,2,14,3,7,35,28,7,45
Rapid Vienna,4070,3,9,9,6,37,26,11,36
LASK Linz,4070,4,10,5,9,29,27,2,35
Mattersburg,4070,5,6,6,12,29,41,-12,24
Vienna,4070,6,6,6,12,24,42,-18,24
SC Rheindorf,4070,7,4,5,15,16,35,-19,17
FC Salzburg,4071,1,15,6,3,47,17,30,51
SK Sturm Gra,4071,2,14,3,7,38,28,10,45
Rapid Vienna,4071,3,10,9,5,40,30,10,39
LASK Linz,4071,4,7,5,12,27,37,-10,26
Vienna,4071,5,7,5,12,28,42,-14,26
SC Rheindorf,4071,6,6,5,13,21,33,-12,23
Mattersburg,4071,7,6,5,13,33,47,-14,23
FC Salzburg,4072,1,15,6,3,43,17,26,51
SK Sturm Gra,4072,2,11,4,9,30,32,-2,37
Rapid Vienna,4072,3,8,11,5,35,28,7,35
LASK Linz,4072,4,8,6,10,30,29,1,30
Vienna,4072,5,8,5,11,26,37,-11,29
Mattersburg,4072,6,7,5,12,30,40,-10,26
SC Rheindorf,4072,7,6,5,13,20,31,-11,23
FC Salzburg,4073,1,16,6,2,45,18,27,54
SK Sturm Gra,4073,2,12,3,9,32,32,0,39
Rapid Vienna,4073,3,8,11,5,33,24,9,35
LASK Linz,4073,4,8,6,10,24,26,-2,30
Mattersburg,4073,5,7,5,12,31,41,-10,26
SC Rheindorf,4073,6,6,6,12,21,29,-8,24
Vienna,4073,7,6,5,13,25,41,-16,23
FC Salzburg,4074,1,15,7,2,47,18,29,52
SK Sturm Gra,4074,2,12,5,7,31,28,3,41
Rapid Vienna,4074,3,7,10,7,32,30,2,31
LASK Linz,4074,4,8,7,9,26,27,-1,31
Mattersburg,4074,5,7,6,11,31,38,-7,27
Vienna,4074,6,6,6,12,24,40,-16,24
SC Rheindorf,4074,7,6,5,13,18,28,-10,23
FC Salzburg,4075,1,14,7,3,45,20,25,49
SK Sturm Gra,4075,2,13,4,7,35,29,6,43
Rapid Vienna,4075,3,10,9,5,36,25,11,39
SC Rheindorf,4075,4,7,5,12,20,27,-7,26
Mattersburg,4075,5,7,5,12,39,47,-8,26
LASK Linz,4075,6,7,5,12,25,34,-9,26
Vienna,4075,7,6,5,13,26,44,-18,23
FC Salzburg,4076,1,15,6,3,56,20,36,51
Rapid Vienna,4076,2,11,9,4,43,25,18,42
SK Sturm Gra,4076,3,12,3,9,34,39,-5,39
LASK Linz,4076,4,8,6,10,27,30,-3,30
Vienna,4076,5,6,6,12,26,43,-17,24
SC Rheindorf,4076,6,5,7,12,19,31,-12,22
Mattersburg,4076,7,5,7,12,29,46,-17,22
FC Salzburg,4077,1,13,9,2,44,20,24,48
SK Sturm Gra,4077,2,13,5,6,35,26,9,44
Rapid Vienna,4077,3,8,10,6,36,31,5,34
LASK Linz,4077,4,8,7,9,32,32,0,31
Mattersburg,4077,5,6,8,10,35,44,-9,26
Vienna,4077,6,6,7,11,26,40,-14,25
SC Rheindorf,4077,7,4,6,14,17,32,-15,18
FC Salzburg,4078,1,16,6,2,51,17,34,54
Rapid Vienna,4078,2,9,10,5,39,28,11,37
SK Sturm Gra,4078,3,11,4,9,32,32,0,37
LASK Linz,4078,4,9,5,10,31,33,-2,32
Vienna,4078,5,7,5,12,26,42,-16,26
SC Rheindorf,4078,6,6,5,13,18,30,-12,23
Mattersburg,4078,7,6,5,13,33,48,-15,23
FC Salzburg,4079,1,15,7,2,49,17,32,52
SK Sturm Gra,4079,2,14,4,6,37,29,8,46
LASK Linz,4079,3,9,5,10,32,33,-1,32
Rapid Vienna,4079,4,7,10,7,35,31,4,31
Vienna,4079,5,7,5,12,27,43,-16,26
Mattersburg,4079,6,6,5,13,29,45,-16,23
SC Rheindorf,4079,7,5,6,13,22,33,-11,21
FC Salzburg,4080,1,13,9,2,45,19,26,48
SK Sturm Gra,4080,2,13,4,7,34,30,4,43
Rapid Vienna,4080,3,8,11,5,38,30,8,35
LASK Linz,4080,4,8,6,10,26,28,-2,30
Mattersburg,4080,5,6,8,10,30,38,-8,26
Vienna,4080,6,6,7,11,26,40,-14,25
SC Rheindorf,4080,7,5,5,14,21,35,-14,20
FC Salzburg,4081,1,14,7,3,47,18,29,49
SK Sturm Gra,4081,2,14,3,7,37,28,9,45
Rapid Vienna,4081,3,8,10,6,34,29,5,34
LASK Linz,4081,4,7,8,9,26,28,-2,29
Vienna,4081,5,6,7,11,24,38,-14,25
SC Rheindorf,4081,6,6,6,12,19,27,-8,24
Mattersburg,4081,7,5,7,12,27,46,-19,22
FC Salzburg,4082,1,16,6,2,48,17,31,54
SK Sturm Gra,4082,2,13,3,8,34,32,2,42
LASK Linz,4082,3,10,5,9,34,30,4,35
Rapid Vienna,4082,4,7,9,8,36,33,3,30
Mattersburg,4082,5,7,5,12,33,40,-7,26
SC Rheindorf,4082,6,6,5,13,21,33,-12,23
Vienna,4082,7,6,5,13,23,44,-21,23
FC Salzburg,4083,1,14,7,3,46,20,26,49
Rapid Vienna,4083,2,10,9,5,38,25,13,39
SK Sturm Gra,4083,3,11,5,8,31,31,0,38
LASK Linz,4083,4,8,8,8,29,28,1,32
Mattersburg,4083,5,6,7,11,30,40,-10,25
Vienna,4083,6,6,5,13,23,42,-19,23
SC Rheindorf,4083,7,5,7,12,18,29,-11,22
FC Salzburg,4084,1,14,8,2,44,16,28,50
SK Sturm Gra,4084,2,13,5,6,32,26,6,44
Rapid Vienna,4084,3,7,10,7,32,29,3,31
LASK Linz,4084,4,7,7,10,25,30,-5,28
Mattersburg,4084,5,7,6,11,31,40,-9,27
SC Rheindorf,4084,6,6,7,11,21,27,-6,25
Vienna,4084,7,6,5,13,24,41,-17,23
FC Salzburg,4085,1,14,6,4,51,22,29,48
SK Sturm Gra,4085,2,14,3,7,35,28,7,45
Rapid Vienna,4085,3,10,9,5,38,25,13,39
LASK Linz,4085,4,9,5,10,27,31,-4,32
Vienna,4085,5,7,6,11,29,40,-11,27
Mattersburg,4085,6,6,6,12,31,48,-17,24
SC Rheindorf,4085,7,4,5,15,17,34,-17,17
FC Salzburg,4086,1,14,8,2,46,19,27,50
SK Sturm Gra,4086,2,12,5,7,36,32,4,41
Rapid Vienna,4086,3,8,10,6,36,30,6,34
LASK Linz,4086,4,9,6,9,30,30,0,33
Vienna,4086,5,6,7,11,27,41,-14,25
Mattersburg,4086,6,5,8,11,30,42,-12,23
SC Rheindorf,4086,7,4,8,12,19,30,-11,20
FC Salzburg,4087,1,15,7,2,47,16,31,52
SK Sturm Gra,4087,2,13,4,7,35,26,9,43
Rapid Vienna,4087,3,8,10,6,36,32,4,34
Mattersburg,4087,4,7,6,11,33,41,-8,27
LASK Linz,4087,5,7,6,11,26,34,-8,27
Vienna,4087,6,7,5,12,27,43,-16,26
SC Rheindorf,4087,7,5,6,13,19,31,-12,21
FC Salzburg,4088,1,14,7,3,44,19,25,49
SK Sturm Gra,4088,2,12,3,9,31,31,0,39
Rapid Vienna,4088,3,9,10,5,36,28,8,37
LASK Linz,4088,4,9,5,10,30,30,0,32
Mattersburg,4088,5,7,5,12,36,44,-8,26
Vienna,4088,6,7,5,12,26,41,-15,26
SC Rheindorf,4088,7,6,5,13,21,31,-10,23
FC Salzburg,4089,1,14,7,3,44,18,26,49
SK Sturm Gra,4089,2,14,3,7,33,29,4,45
Rapid Vienna,4089,3,8,10,6,37,30,7,34
LASK Linz,4089,4,9,5,10,29,28,1,32
Mattersburg,4089,5,8,5,11,32,38,-6,29
Vienna,4089,6,7,5,12,25,39,-14,26
SC Rheindorf,4089,7,4,5,15,16,34,-18,17
FC Salzburg,4090,1,16,6,2,47,16,31,54
SK Sturm Gra,4090,2,12,4,8,35,31,4,40
Rapid Vienna,4090,3,8,11,5,35,27,8,35
Mattersburg,4090,4,7,6,11,31,40,-9,27
LASK Linz,4090,5,7,5,12,26,34,-8,26
SC Rheindorf,4090,6,6,6,12,19,28,-9,24
Vienna,4090,7,6,6,12,24,41,-17,24
FC Salzburg,4091,1,15,7,2,50,19,31,52
SK Sturm Gra,4091,2,11,4,9,29,31,-2,37
LASK Linz,4091,3,9,6,9,32,27,5,33
Rapid Vienna,4091,4,7,10,7,34,34,0,31
Vienna,4091,5,7,6,11,28,39,-11,27
SC Rheindorf,4091,6,7,5,12,21,29,-8,26
Mattersburg,4091,7,6,6,12,32,47,-15,24
FC Salzburg,4092,1,14,8,2,46,18,28,50
SK Sturm Gra,4092,2,13,3,8,35,32,3,42
Rapid Vienna,4092,3,8,10,6,36,29,7,34
LASK Linz,4092,4,8,6,10,29,31,-2,30
SC Rheindorf,4092,5,6,7,11,22,28,-6,25
Mattersburg,4092,6,6,6,12,31,46,-15,24
Vienna,4092,7,6,6,12,25,40,-15,24
FC Salzburg,4093,1,14,7,3,46,17,29,49
SK Sturm Gra,4093,2,12,5,7,31,27,4,41
Rapid Vienna,4093,3,10,10,4,37,26,11,40
LASK Linz,4093,4,8,6,10,24,27,-3,30
Vienna,4093,5,7,5,12,27,42,-15,26
SC Rheindorf,4093,6,5,7,12,19,28,-9,22
Mattersburg,4093,7,5,6,13,27,44,-17,21
FC Salzburg,4094,1,16,6,2,47,17,30,54
SK Sturm Gra,4094,2,12,4,8,31,28,3,40
Rapid Vienna,4094,3,9,9,6,34,29,5,36
LASK Linz,4094,4,9,6,9,31,26,5,33
Vienna,4094,5,7,5,12,27,40,-13,26
Mattersburg,4094,6,5,6,13,31,49,-18,21
SC Rheindorf,4094,7,4,8,12,17,29,-12,20
FC Salzburg,4095,1,15,7,2,48,18,30,52
SK Sturm Gra,4095,2,13,5,6,33,26,7,44
Rapid Vienna,4095,3,7,10,7,35,31,4,31
LASK Linz,4095,4,8,7,9,27,28,-1,31
Vienna,4095,5,7,5,12,25,38,-13,26
SC Rheindorf,4095,6,5,7,12,20,30,-10,22
Mattersburg,4095,7,5,7,12,27,44,-17,22
FC Salzburg,4096,1,15,7,2,43,17,26,52
SK Sturm Gra,4096,2,12,3,9,31,28,3,39
Rapid Vienna,4096,3,8,9,7,36,29,7,33
LASK Linz,4096,4,9,5,10,27,27,0,32
Mattersburg,4096,5,7,7,10,32,40,-8,28
SC Rheindorf,4096,6,6,6,12,19,31,-12,24
Vienna,4096,7,6,5,13,24,40,-16,23
FC Salzburg,4097,1,15,6,3,46,20,26,51
SK Sturm Gra,4097,2,13,4,7,34,29,5,43
Rapid Vienna,4097,3,10,9,5,40,27,13,39
LASK Linz,4097,4,9,5,10,27,27,0,32
Vienna,4097,5,7,5,12,26,40,-14,26
Mattersburg,4097,6,6,5,13,31,44,-13,23
SC Rheindorf,4097,7,4,6,14,19,36,-17,18
FC Salzburg,4098,1,16,6,2,45,17,28,54
SK Sturm Gra,4098,2,13,3,8,35,28,7,42
Rapid Vienna,4098,3,8,10,6,35,30,5,34
LASK Linz,4098,4,7,5,12,25,32,-7,26
Vienna,4098,5,7,5,12,27,39,-12,26
SC Rheindorf,4098,6,6,7,11,21,29,-8,25
Mattersburg,4098,7,6,6,12,32,45,-13,24
FC Salzburg,4099,1,15,6,3,46,17,29,51
SK Sturm Gra,4099,2,13,3,8,34,29,5,42
Rapid Vienna,4099,3,9,9,6,36,30,6,36
LASK Linz,4099,4,9,6,9,30,29,1,33
Vienna,4099,5,7,5,12,26,39,-13,26
SC Rheindorf,4099,6,5,7,12,19,31,-12,22
Mattersburg,4099,7,5,6,13,27,43,-16,21
FC Salzburg,4100,1,14,7,3,43,19,24,49
SK Sturm Gra,4100,2,12,4,8,34,28,6,40
Rapid Vienna,4100,3,10,9,5,39,30,9,39
LASK Linz,4100,4,8,6,10,27,29,-2,30
Vienna,4100,5,7,6,11,27,39,-12,27
SC Rheindorf,4100,6,7,5,12,21,30,-9,26
Mattersburg,4100,7,5,5,14,27,43,-16,20
FC Salzburg,4101,1,13,8,3,46,23,23,47
SK Sturm Gra,4101,2,12,4,8,33,29,4,40
Rapid Vienna,4101,3,10,9,5,39,30,9,39
LASK Linz,4101,4,9,6,9,29,27,2,33
SC Rheindorf,4101,5,6,6,12,23,31,-8,24
Vienna,4101,6,6,6,12,25,40,-15,24
Mattersburg,4101,7,6,5,13,30,45,-15,23
FC Salzburg,4102,1,14,8,2,47,19,28,50
SK Sturm Gra,4102,2,13,5,6,34,27,7,44
Rapid Vienna,4102,3,7,9,8,33,32,1,30
LASK Linz,4102,4,8,6,10,26,28,-2,30
Vienna,4102,5,7,6,11,29,39,-10,27
Mattersburg,4102,6,7,5,12,31,44,-13,26
SC Rheindorf,4102,7,5,7,12,17,28,-11,22
FC Salzburg,4103,1,15,7,2,49,16,33,52
SK Sturm Gra,4103,2,12,4,8,33,30,3,40
Rapid Vienna,4103,3,9,10,5,37,27,10,37
Mattersburg,4103,4,7,7,10,32,39,-7,28
LASK Linz,4103,5,7,5,12,26,34,-8,26
SC Rheindorf,4103,6,6,6,12,21,32,-11,24
Vienna,4103,7,6,5,13,23,43,-20,23
FC Salzburg,4104,1,14,8,2,47,19,28,50
SK Sturm Gra,4104,2,12,3,9,32,33,-1,39
Rapid Vienna,4104,3,7,11,6,34,31,3,32
LASK Linz,4104,4,9,5,10,31,30,1,32
SC Rheindorf,4104,5,7,6,11,24,30,-6,27
Vienna,4104,6,6,7,11,26,40,-14,25
Mattersburg,4104,7,6,6,12,32,43,-11,24
FC Salzburg,4105,1,15,7,2,48,19,29,52
SK Sturm Gra,4105,2,12,3,9,31,32,-1,39
Rapid Vienna,4105,3,8,11,5,36,29,7,35
LASK Linz,4105,4,8,6,10,27,30,-3,30
Vienna,4105,5,7,5,12,26,39,-13,26
SC Rheindorf,4105,6,6,7,11,20,26,-6,25
Mattersburg,4105,7,5,7,12,28,41,-13,22
FC Salzburg,4106,1,15,6,3,46,23,23,51
SK Sturm Gra,4106,2,15,3,6,42,29,13,48
Rapid Vienna,4106,3,7,10,7,34,30,4,31
LASK Linz,4106,4,7,7,10,26,30,-4,28
SC Rheindorf,4106,5,6,6,12,19,28,-9,24
Vienna,4106,6,6,6,12,23,39,-16,24
Mattersburg,4106,7,5,8,11,29,40,-11,23
FC Salzburg,4107,1,14,7,3,48,17,31,49
SK Sturm Gra,4107,2,12,4,8,32,31,1,40
Rapid Vienna,4107,3,9,9,6,34,32,2,36
LASK Linz,4107,4,10,5,9,31,26,5,35
Vienna,4107,5,7,6,11,26,37,-11,27
Mattersburg,4107,6,6,5,13,29,46,-17,23
SC Rheindorf,4107,7,5,6,13,19,30,-11,21
FC Salzburg,4108,1,13,7,4,41,18,23,46
SK Sturm Gra,4108,2,12,5,7,31,28,3,41
Rapid Vienna,4108,3,8,11,5,34,26,8,35
LASK Linz,4108,4,8,5,11,27,30,-3,29
Mattersburg,4108,5,8,5,11,32,40,-8,29
Vienna,4108,6,7,6,11,25,38,-13,27
SC Rheindorf,4108,7,5,7,12,20,30,-10,22
FC Salzburg,4109,1,14,6,4,43,20,23,48
SK Sturm Gra,4109,2,14,3,7,33,27,6,45
Mattersburg,4109,3,9,5,10,37,38,-1,32
Rapid Vienna,4109,4,7,10,7,35,32,3,31
LASK Linz,4109,5,8,5,11,26,31,-5,29
Vienna,4109,6,7,5,12,24,39,-15,26
SC Rheindorf,4109,7,5,6,13,20,31,-11,21
FC Salzburg,4110,1,14,6,4,46,20,26,48
SK Sturm Gra,4110,2,13,3,8,32,28,4,42
Rapid Vienna,4110,3,10,9,5,38,27,11,39
LASK Linz,4110,4,8,6,10,26,28,-2,30
Mattersburg,4110,5,6,7,11,32,45,-13,25
Vienna,4110,6,6,6,12,26,42,-16,24
SC Rheindorf,4110,7,5,7,12,19,29,-10,22
FC Salzburg,4111,1,14,8,2,48,23,25,50
Rapid Vienna,4111,2,10,10,4,41,25,16,40
SK Sturm Gra,4111,3,11,4,9,32,31,1,37
LASK Linz,4111,4,8,7,9,25,29,-4,31
Mattersburg,4111,5,6,6,12,31,42,-11,24
Vienna,4111,6,6,6,12,27,43,-16,24
SC Rheindorf,4111,7,6,5,13,20,31,-11,23
FC Salzburg,4112,1,14,7,3,48,17,31,49
SK Sturm Gra,4112,2,13,4,7,34,27,7,43
Rapid Vienna,4112,3,10,10,4,36,25,11,40
LASK Linz,4112,4,7,6,11,25,31,-6,27
Mattersburg,4112,5,6,7,11,31,44,-13,25
Vienna,4112,6,6,6,12,24,42,-18,24
SC Rheindorf,4112,7,5,6,13,17,29,-12,21
FC Salzburg,4113,1,15,7,2,44,16,28,52
SK Sturm Gra,4113,2,12,6,6,34,29,5,42
Rapid Vienna,4113,3,7,11,6,34,29,5,32
LASK Linz,4113,4,9,5,10,28,29,-1,32
Mattersburg,4113,5,7,6,11,32,40,-8,27
Vienna,4113,6,6,5,13,25,41,-16,23
SC Rheindorf,4113,7,4,8,12,19,32,-13,20
FC Salzburg,4114,1,13,9,2,45,19,26,48
SK Sturm Gra,4114,2,12,3,9,31,32,-1,39
Rapid Vienna,4114,3,7,12,5,37,30,7,33
LASK Linz,4114,4,9,6,9,31,29,2,33
SC Rheindorf,4114,5,6,7,11,21,29,-8,25
Vienna,4114,6,6,7,11,24,38,-14,25
Mattersburg,4114,7,5,8,11,29,41,-12,23
FC Salzburg,4115,1,15,7,2,44,16,28,52
SK Sturm Gra,4115,2,12,4,8,32,29,3,40
Rapid Vienna,4115,3,9,10,5,36,26,10,37
LASK Linz,4115,4,8,6,10,29,30,-1,30
Mattersburg,4115,5,8,5,11,32,40,-8,29
Vienna,4115,6,6,6,12,24,39,-15,24
SC Rheindorf,4115,7,4,6,14,16,33,-17,18
FC Salzburg,4116,1,14,8,2,43,18,25,50
SK Sturm Gra,4116,2,13,4,7,31,26,5,43
Rapid Vienna,4116,3,7,10,7,33,28,5,31
LASK Linz,4116,4,8,5,11,27,34,-7,29
SC Rheindorf,4116,5,7,6,11,23,28,-5,27
Vienna,4116,6,7,5,12,25,39,-14,26
Mattersburg,4116,7,6,6,12,33,42,-9,24
FC Salzburg,4117,1,14,8,2,45,17,28,50
Rapid Vienna,4117,2,10,10,4,38,27,11,40
SK Sturm Gra,4117,3,12,4,8,32,28,4,40
SC Rheindorf,4117,4,7,5,12,26,31,-5,26
LASK Linz,4117,5,7,5,12,26,37,-11,26
Vienna,4117,6,7,5,12,25,39,-14,26
Mattersburg,4117,7,6,5,13,32,45,-13,23
FC Salzburg,4118,1,15,7,2,43,16,27,52
Rapid Vienna,4118,2,8,12,4,33,24,9,36
SK Sturm Gra,4118,3,11,3,10,29,30,-1,36
LASK Linz,4118,4,8,8,8,26,26,0,32
Vienna,4118,5,6,6,12,24,39,-15,24
SC Rheindorf,4118,6,5,8,11,20,29,-9,23
Mattersburg,4118,7,5,8,11,28,39,-11,23
FC Salzburg,4119,1,15,7,2,45,18,27,52
SK Sturm Gra,4119,2,13,3,8,34,29,5,42
Rapid Vienna,4119,3,8,10,6,34,28,6,34
LASK Linz,4119,4,7,7,10,26,30,-4,28
Mattersburg,4119,5,6,8,10,31,40,-9,26
Vienna,4119,6,6,6,12,26,41,-15,24
SC Rheindorf,4119,7,5,7,12,17,27,-10,22
FC Salzburg,4120,1,14,7,3,43,19,24,49
SK Sturm Gra,4120,2,12,3,9,33,32,1,39
LASK Linz,4120,3,10,6,8,30,26,4,36
Rapid Vienna,4120,4,7,10,7,34,32,2,31
Vienna,4120,5,8,5,11,29,37,-8,29
SC Rheindorf,4120,6,7,5,12,21,28,-7,26
Mattersburg,4120,7,5,6,13,26,42,-16,21
FC Salzburg,4121,1,14,6,4,43,20,23,48
Rapid Vienna,4121,2,10,10,4,39,25,14,40
SK Sturm Gra,4121,3,12,3,9,33,35,-2,39
Mattersburg,4121,4,9,5,10,36,40,-4,32
LASK Linz,4121,5,7,7,10,26,29,-3,28
Vienna,4121,6,6,5,13,25,42,-17,23
SC Rheindorf,4121,7,5,6,13,21,32,-11,21
FC Salzburg,4122,1,15,7,2,48,19,29,52
SK Sturm Gra,4122,2,12,6,6,32,27,5,42
Rapid Vienna,4122,3,8,10,6,38,30,8,34
LASK Linz,4122,4,9,7,8,29,27,2,34
Vienna,4122,5,7,5,12,27,40,-13,26
Mattersburg,4122,6,5,6,13,28,44,-16,21
SC Rheindorf,4122,7,5,5,14,17,32,-15,20
FC Salzburg,4123,1,13,7,4,42,20,22,46
SK Sturm Gra,4123,2,13,3,8,32,27,5,42
Rapid Vienna,4123,3,8,11,5,35,27,8,35
Mattersburg,4123,4,8,5,11,31,38,-7,29
LASK Linz,4123,5,7,7,10,29,34,-5,28
Vienna,4123,6,7,6,11,25,38,-13,27
SC Rheindorf,4123,7,5,7,12,19,29,-10,22
FC Salzburg,4124,1,14,7,3,47,18,29,49
Rapid Vienna,4124,2,10,9,5,38,28,10,39
SK Sturm Gra,4124,3,12,3,9,32,33,-1,39
LASK Linz,4124,4,9,5,10,27,30,-3,32
Vienna,4124,5,7,5,12,27,43,-16,26
Mattersburg,4124,6,6,6,12,32,44,-12,24
SC Rheindorf,4124,7,6,5,13,24,31,-7,23
FC Salzburg,4125,1,13,6,5,42,26,16,45
SK Sturm Gra,4125,2,13,5,6,37,30,7,44
Rapid Vienna,4125,3,8,10,6,33,26,7,34
Mattersburg,4125,4,8,6,10,31,36,-5,30
LASK Linz,4125,5,7,8,9,25,29,-4,29
Vienna,4125,6,7,5,12,27,39,-12,26
SC Rheindorf,4125,7,5,6,13,20,29,-9,21
FC Salzburg,4126,1,16,6,2,48,18,30,54
SK Sturm Gra,4126,2,14,3,7,34,26,8,45
LASK Linz,4126,3,10,5,9,27,25,2,35
Rapid Vienna,4126,4,8,9,7,33,30,3,33
Mattersburg,4126,5,6,6,12,34,44,-10,24
Vienna,4126,6,6,5,13,24,43,-19,23
SC Rheindorf,4126,7,4,6,14,19,33,-14,18
FC Salzburg,4127,1,15,6,3,44,18,26,51
SK Sturm Gra,4127,2,13,3,8,39,28,11,42
Rapid Vienna,4127,3,8,11,5,35,31,4,35
LASK Linz,4127,4,7,8,9,27,32,-5,29
Mattersburg,4127,5,6,7,11,31,41,-10,25
Vienna,4127,6,6,6,12,24,40,-16,24
SC Rheindorf,4127,7,5,7,12,16,26,-10,22
FC Salzburg,4128,1,14,7,3,46,20,26,49
SK Sturm Gra,4128,2,14,4,6,36,27,9,46
Rapid Vienna,4128,3,8,9,7,34,31,3,33
LASK Linz,4128,4,8,7,9,29,27,2,31
Mattersburg,4128,5,6,8,10,31,40,-9,26
Vienna,4128,6,6,6,12,25,43,-18,24
SC Rheindorf,4128,7,5,5,14,17,30,-13,20
FC Salzburg,4129,1,15,6,3,46,19,27,51
SK Sturm Gra,4129,2,12,5,7,34,32,2,41
Rapid Vienna,4129,3,8,12,4,35,26,9,36
LASK Linz,4129,4,7,8,9,28,30,-2,29
Mattersburg,4129,5,6,7,11,30,40,-10,25
Vienna,4129,6,6,6,12,27,42,-15,24
SC Rheindorf,4129,7,4,8,12,16,27,-11,20
FC Salzburg,4130,1,14,7,3,45,20,25,49
SK Sturm Gra,4130,2,12,3,9,34,30,4,39
LASK Linz,4130,3,10,5,9,31,27,4,35
Rapid Vienna,4130,4,7,11,6,35,35,0,32
Vienna,4130,5,8,5,11,28,39,-11,29
Mattersburg,4130,6,7,5,12,30,40,-10,26
SC Rheindorf,4130,7,5,6,13,19,31,-12,21
FC Salzburg,4131,1,15,6,3,47,17,30,51
SK Sturm Gra,4131,2,13,4,7,33,30,3,43
Rapid Vienna,4131,3,9,10,5,37,27,10,37
LASK Linz,4131,4,7,6,11,25,30,-5,27
Mattersburg,4131,5,6,7,11,29,41,-12,25
Vienna,4131,6,6,6,12,23,39,-16,24
SC Rheindorf,4131,7,6,5,13,20,30,-10,23
FC Salzburg,4132,1,14,6,4,41,18,23,48
SK Sturm Gra,4132,2,12,4,8,30,28,2,40
Rapid Vienna,4132,3,8,10,6,36,28,8,34
LASK Linz,4132,4,8,7,9,27,30,-3,31
Mattersburg,4132,5,7,6,11,36,40,-4,27
Vienna,4132,6,7,5,12,25,42,-17,26
SC Rheindorf,4132,7,5,8,11,21,30,-9,23
FC Salzburg,4133,1,14,6,4,45,22,23,48
SK Sturm Gra,4133,2,14,3,7,34,27,7,45
Rapid Vienna,4133,3,11,9,4,40,25,15,42
LASK Linz,4133,4,7,7,10,24,28,-4,28
Vienna,4133,5,7,5,12,29,41,-12,26
SC Rheindorf,4133,6,5,6,13,19,29,-10,21
Mattersburg,4133,7,5,6,13,27,46,-19,21
FC Salzburg,4134,1,14,8,2,43,17,26,50
SK Sturm Gra,4134,2,12,5,7,33,28,5,41
LASK Linz,4134,3,10,6,8,31,27,4,36
Rapid Vienna,4134,4,8,10,6,35,30,5,34
Vienna,4134,5,7,5,12,26,39,-13,26
SC Rheindorf,4134,6,5,6,13,18,30,-12,21
Mattersburg,4134,7,5,6,13,28,43,-15,21
FC Salzburg,4135,1,15,7,2,47,16,31,52
Rapid Vienna,4135,2,9,10,5,35,27,8,37
SK Sturm Gra,4135,3,11,3,10,29,31,-2,36
LASK Linz,4135,4,9,6,9,29,30,-1,33
Vienna,4135,5,7,5,12,26,41,-15,26
Mattersburg,4135,6,6,6,12,30,43,-13,24
SC Rheindorf,4135,7,6,5,13,21,29,-8,23
FC Salzburg,4136,1,14,7,3,44,20,24,49
SK Sturm Gra,4136,2,11,4,9,29,28,1,37
Rapid Vienna,4136,3,7,11,6,32,29,3,32
LASK Linz,4136,4,9,5,10,29,29,0,32
SC Rheindorf,4136,5,7,6,11,20,26,-6,27
Mattersburg,4136,6,7,6,11,33,40,-7,27
Vienna,4136,7,7,5,12,25,40,-15,26
FC Salzburg,4137,1,15,7,2,46,18,28,52
SK Sturm Gra,4137,2,13,4,7,36,28,8,43
Rapid Vienna,4137,3,8,11,5,38,29,9,35
Mattersburg,4137,4,8,5,11,32,40,-8,29
LASK Linz,4137,5,7,5,12,26,34,-8,26
Vienna,4137,6,6,6,12,26,42,-16,24
SC Rheindorf,4137,7,5,6,13,17,30,-13,21
FC Salzburg,4138,1,15,6,3,46,20,26,51
SK Sturm Gra,4138,2,13,3,8,32,30,2,42
Rapid Vienna,4138,3,9,9,6,44,31,13,36
LASK Linz,4138,4,8,5,11,26,32,-6,29
Mattersburg,4138,5,7,6,11,33,41,-8,27
Vienna,4138,6,6,6,12,25,40,-15,24
SC Rheindorf,4138,7,6,5,13,20,32,-12,23
FC Salzburg,4139,1,15,7,2,45,19,26,52
SK Sturm Gra,4139,2,12,4,8,35,30,5,40
Rapid Vienna,4139,3,9,10,5,36,29,7,37
LASK Linz,4139,4,8,7,9,28,29,-1,31
Mattersburg,4139,5,6,6,12,32,43,-11,24
SC Rheindorf,4139,6,6,5,13,21,31,-10,23
Vienna,4139,7,6,5,13,25,41,-16,23
FC Salzburg,4140,1,15,6,3,44,17,27,51
SK Sturm Gra,4140,2,11,4,9,30,29,1,37
Rapid Vienna,4140,3,8,11,5,35,27,8,35
LASK Linz,4140,4,8,6,10,26,29,-3,30
Mattersburg,4140,5,8,5,11,34,41,-7,29
Vienna,4140,6,7,5,12,26,41,-15,26
SC Rheindorf,4140,7,6,5,13,24,35,-11,23
FC Salzburg,4141,1,15,6,3,44,17,27,51
SK Sturm Gra,4141,2,13,4,7,33,29,4,43
Rapid Vienna,4141,3,7,10,7,34,30,4,31
LASK Linz,4141,4,8,6,10,28,31,-3,30
Vienna,4141,5,8,5,11,26,38,-12,29
SC Rheindorf,4141,6,6,7,11,19,26,-7,25
Mattersburg,4141,7,5,6,13,29,42,-13,21
FC Salzburg,4142,1,14,6,4,45,19,26,48
SK Sturm Gra,4142,2,11,6,7,32,30,2,39
Rapid Vienna,4142,3,8,10,6,33,27,6,34
LASK Linz,4142,4,8,7,9,26,27,-1,31
Mattersburg,4142,5,7,6,11,30,39,-9,27
Vienna,4142,6,7,5,12,25,40,-15,26
SC Rheindorf,4142,7,6,6,12,20,29,-9,24
FC Salzburg,4143,1,15,6,3,44,20,24,51
Rapid Vienna,4143,2,11,9,4,41,23,18,42
SK Sturm Gra,4143,3,11,5,8,30,28,2,38
LASK Linz,4143,4,7,7,10,24,33,-9,28
Vienna,4143,5,7,5,12,28,41,-13,26
SC Rheindorf,4143,6,5,7,12,22,30,-8,22
Mattersburg,4143,7,5,7,12,29,43,-14,22
FC Salzburg,4144,1,15,6,3,48,22,26,51
SK Sturm Gra,4144,2,13,3,8,35,30,5,42
Rapid Vienna,4144,3,9,9,6,37,28,9,36
LASK Linz,4144,4,9,5,10,27,28,-1,32
Vienna,4144,5,7,5,12,26,40,-14,26
SC Rheindorf,4144,6,6,5,13,18,27,-9,23
Mattersburg,4144,7,6,5,13,30,46,-16,23
FC Salzburg,4145,1,13,7,4,42,19,23,46
SK Sturm Gra,4145,2,13,5,6,36,26,10,44
Rapid Vienna,4145,3,9,9,6,36,31,5,36
LASK Linz,4145,4,8,7,9,29,30,-1,31
Mattersburg,4145,5,7,6,11,33,42,-9,27
Vienna,4145,6,7,5,12,25,41,-16,26
SC Rheindorf,4145,7,4,7,13,19,31,-12,19
FC Salzburg,4146,1,15,6,3,46,19,27,51
SK Sturm Gra,4146,2,12,5,7,32,28,4,41
Rapid Vienna,4146,3,8,9,7,35,30,5,33
LASK Linz,4146,4,8,7,9,28,29,-1,31
Vienna,4146,5,7,5,12,26,42,-16,26
SC Rheindorf,4146,6,6,6,12,21,29,-8,24
Mattersburg,4146,7,6,6,12,29,40,-11,24
FC Salzburg,4147,1,15,6,3,44,18,26,51
SK Sturm Gra,4147,2,13,3,8,33,30,3,42
Rapid Vienna,4147,3,7,11,6,33,29,4,32
LASK Linz,4147,4,8,7,9,27,29,-2,31
Mattersburg,4147,5,8,5,11,34,39,-5,29
Vienna,4147,6,7,5,12,25,39,-14,26
SC Rheindorf,4147,7,4,7,13,17,29,-12,19
FC Salzburg,4148,1,14,7,3,43,19,24,49
SK Sturm Gra,4148,2,13,3,8,32,29,3,42
Rapid Vienna,4148,3,10,9,5,39,29,10,39
LASK Linz,4148,4,10,5,9,31,27,4,35
Vienna,4148,5,7,6,11,26,38,-12,27
Mattersburg,4148,6,5,6,13,28,43,-15,21
SC Rheindorf,4148,7,4,6,14,17,31,-14,18
FC Salzburg,4149,1,13,8,3,43,21,22,47
SK Sturm Gra,4149,2,12,4,8,31,28,3,40
Rapid Vienna,4149,3,9,9,6,38,29,9,36
LASK Linz,4149,4,8,5,11,27,35,-8,29
Mattersburg,4149,5,7,6,11,33,41,-8,27
Vienna,4149,6,7,6,11,26,39,-13,27
SC Rheindorf,4149,7,6,6,12,23,28,-5,24
FC Salzburg,4150,1,15,6,3,44,17,27,51
SK Sturm Gra,4150,2,12,5,7,31,28,3,41
Rapid Vienna,4150,3,8,10,6,37,29,8,34
LASK Linz,4150,4,9,6,9,29,27,2,33
Mattersburg,4150,5,7,5,12,34,41,-7,26
Vienna,4150,6,7,5,12,25,41,-16,26
SC Rheindorf,4150,7,4,7,13,17,34,-17,19
FC Salzburg,4151,1,15,7,2,43,17,26,52
SK Sturm Gra,4151,2,12,3,9,33,33,0,39
Rapid Vienna,4151,3,8,10,6,36,33,3,34
LASK Linz,4151,4,9,6,9,31,29,2,33
SC Rheindorf,4151,5,6,6,12,23,28,-5,24
Vienna,4151,6,6,6,12,24,39,-15,24
Mattersburg,4151,7,5,8,11,30,41,-11,23
FC Salzburg,4152,1,14,8,2,48,18,30,50
SK Sturm Gra,4152,2,11,7,6,33,29,4,40
Rapid Vienna,4152,3,7,13,4,33,25,8,34
LASK Linz,4152,4,7,8,9,27,29,-2,29
Vienna,4152,5,7,5,12,25,43,-18,26
Mattersburg,4152,6,6,6,12,31,42,-11,24
SC Rheindorf,4152,7,5,7,12,19,30,-11,22
FC Salzburg,4153,1,14,6,4,46,21,25,48
SK Sturm Gra,4153,2,13,3,8,36,31,5,42
Rapid Vienna,4153,3,9,11,4,34,23,11,38
LASK Linz,4153,4,8,6,10,27,31,-4,30
Vienna,4153,5,8,5,11,27,39,-12,29
SC Rheindorf,4153,6,6,6,12,25,30,-5,24
Mattersburg,4153,7,5,5,14,29,49,-20,20
FC Salzburg,4154,1,15,6,3,52,18,34,51
SK Sturm Gra,4154,2,13,3,8,34,30,4,42
Rapid Vienna,4154,3,10,9,5,37,29,8,39
LASK Linz,4154,4,8,6,10,27,29,-2,30
Vienna,4154,5,7,5,12,26,42,-16,26
Mattersburg,4154,6,6,5,13,32,46,-14,23
SC Rheindorf,4154,7,5,6,13,18,32,-14,21
FC Salzburg,4155,1,14,6,4,47,23,24,48
SK Sturm Gra,4155,2,12,4,8,33,32,1,40
Rapid Vienna,4155,3,9,10,5,38,29,9,37
LASK Linz,4155,4,9,5,10,28,28,0,32
Mattersburg,4155,5,8,5,11,35,40,-5,29
SC Rheindorf,4155,6,6,5,13,17,27,-10,23
Vienna,4155,7,6,5,13,25,44,-19,23
FC Salzburg,4156,1,16,6,2,50,18,32,54
SK Sturm Gra,4156,2,12,4,8,31,31,0,40
Rapid Vienna,4156,3,8,10,6,39,30,9,34
LASK Linz,4156,4,7,8,9,30,32,-2,29
SC Rheindorf,4156,5,7,5,12,21,30,-9,26
Vienna,4156,6,7,5,12,26,42,-16,26
Mattersburg,4156,7,5,6,13,33,47,-14,21
FC Salzburg,4157,1,13,7,4,42,19,23,46
Rapid Vienna,4157,2,11,9,4,37,25,12,42
SK Sturm Gra,4157,3,12,4,8,31,29,2,40
LASK Linz,4157,4,7,7,10,27,30,-3,28
Vienna,4157,5,7,6,11,27,38,-11,27
Mattersburg,4157,6,7,5,12,29,41,-12,26
SC Rheindorf,4157,7,5,6,13,18,29,-11,21
FC Salzburg,4158,1,16,6,2,47,16,31,54
SK Sturm Gra,4158,2,12,4,8,33,31,2,40
Rapid Vienna,4158,3,9,9,6,37,31,6,36
LASK Linz,4158,4,7,7,10,30,33,-3,28
Mattersburg,4158,5,7,6,11,30,40,-10,27
Vienna,4158,6,6,5,13,23,39,-16,23
SC Rheindorf,4158,7,5,7,12,19,29,-10,22
FC Salzburg,4159,1,14,8,2,45,20,25,50
SK Sturm Gra,4159,2,12,4,8,31,28,3,40
Rapid Vienna,4159,3,8,10,6,35,27,8,34
LASK Linz,4159,4,9,5,10,29,29,0,32
Vienna,4159,5,7,6,11,27,39,-12,27
Mattersburg,4159,6,6,7,11,30,41,-11,25
SC Rheindorf,4159,7,5,6,13,19,32,-13,21
FC Salzburg,4160,1,16,6,2,52,16,36,54
SK Sturm Gra,4160,2,13,3,8,35,32,3,42
Rapid Vienna,4160,3,8,10,6,38,33,5,34
LASK Linz,4160,4,8,5,11,27,31,-4,29
Mattersburg,4160,5,8,5,11,31,43,-12,29
Vienna,4160,6,6,5,13,23,39,-16,23
SC Rheindorf,4160,7,5,6,13,22,34,-12,21
FC Salzburg,4161,1,14,7,3,45,20,25,49
Rapid Vienna,4161,2,11,9,4,40,26,14,42
SK Sturm Gra,4161,3,12,5,7,31,28,3,41
Mattersburg,4161,4,8,5,11,32,40,-8,29
LASK Linz,4161,5,7,6,11,24,29,-5,27
Vienna,4161,6,6,5,13,24,41,-17,23
SC Rheindorf,4161,7,5,5,14,20,32,-12,20
FC Salzburg,4162,1,15,6,3,48,19,29,51
SK Sturm Gra,4162,2,12,3,9,30,31,-1,39
Rapid Vienna,4162,3,9,9,6,34,27,7,36
LASK Linz,4162,4,9,5,10,27,27,0,32
Vienna,4162,5,8,5,11,31,43,-12,29
SC Rheindorf,4162,6,6,5,13,20,31,-11,23
Mattersburg,4162,7,6,5,13,32,44,-12,23
FC Salzburg,4163,1,14,6,4,42,18,24,48
Rapid Vienna,4163,2,10,9,5,35,26,9,39
SK Sturm Gra,4163,3,11,4,9,28,29,-1,37
LASK Linz,4163,4,10,5,9,30,28,2,35
Vienna,4163,5,7,6,11,26,39,-13,27
Mattersburg,4163,6,6,6,12,31,41,-10,24
SC Rheindorf,4163,7,5,6,13,19,30,-11,21
FC Salzburg,4164,1,14,6,4,46,21,25,48
SK Sturm Gra,4164,2,12,4,8,32,29,3,40
Rapid Vienna,4164,3,9,10,5,36,28,8,37
LASK Linz,4164,4,8,6,10,29,31,-2,30
SC Rheindorf,4164,5,7,5,12,21,28,-7,26
Vienna,4164,6,7,5,12,27,42,-15,26
Mattersburg,4164,7,6,6,12,31,43,-12,24
FC Salzburg,4165,1,13,8,3,45,21,24,47
Rapid Vienna,4165,2,11,9,4,41,26,15,42
SK Sturm Gra,4165,3,12,4,8,31,30,1,40
LASK Linz,4165,4,8,5,11,29,33,-4,29
Mattersburg,4165,5,7,6,11,33,40,-7,27
SC Rheindorf,4165,6,6,5,13,22,34,-12,23
Vienna,4165,7,6,5,13,23,40,-17,23
FC Salzburg,4166,1,14,6,4,44,21,23,48
SK Sturm Gra,4166,2,14,3,7,37,30,7,45
Rapid Vienna,4166,3,9,10,5,36,27,9,37
Vienna,4166,4,8,5,11,28,38,-10,29
LASK Linz,4166,5,7,6,11,28,36,-8,27
SC Rheindorf,4166,6,6,6,12,20,27,-7,24
Mattersburg,4166,7,5,6,13,28,42,-14,21
FC Salzburg,4167,1,14,7,3,49,20,29,49
SK Sturm Gra,4167,2,13,5,6,34,28,6,44
Rapid Vienna,4167,3,8,12,4,36,27,9,36
LASK Linz,4167,4,7,9,8,27,28,-1,30
Mattersburg,4167,5,6,7,11,31,44,-13,25
Vienna,4167,6,6,5,13,24,42,-18,23
SC Rheindorf,4167,7,4,7,13,20,32,-12,19
FC Salzburg,4168,1,13,7,4,41,20,21,46
SK Sturm Gra,4168,2,11,3,10,30,32,-2,36
Rapid Vienna,4168,3,8,11,5,37,27,10,35
LASK Linz,4168,4,8,7,9,28,29,-1,31
Vienna,4168,5,8,5,11,27,38,-11,29
SC Rheindorf,4168,6,7,6,11,19,26,-7,27
Mattersburg,4168,7,6,7,11,30,40,-10,25
FC Salzburg,4169,1,15,7,2,44,17,27,52
SK Sturm Gra,4169,2,14,3,7,34,27,7,45
Rapid Vienna,4169,3,8,10,6,35,29,6,34
LASK Linz,4169,4,7,6,11,24,31,-7,27
Mattersburg,4169,5,6,7,11,32,40,-8,25
Vienna,4169,6,6,7,11,23,37,-14,25
SC Rheindorf,4169,7,5,6,13,20,31,-11,21
FC Salzburg,4170,1,14,7,3,44,19,25,49
SK Sturm Gra,4170,2,13,3,8,30,27,3,42
LASK Linz,4170,3,10,6,8,29,27,2,36
Rapid Vienna,4170,4,7,11,6,34,28,6,32
SC Rheindorf,4170,5,6,6,12,21,29,-8,24
Mattersburg,4170,6,6,6,12,33,45,-12,24
Vienna,4170,7,6,5,13,27,43,-16,23
FC Salzburg,4171,1,15,7,2,44,17,27,52
SK Sturm Gra,4171,2,13,4,7,33,28,5,43
Rapid Vienna,4171,3,9,9,6,33,26,7,36
LASK Linz,4171,4,7,6,11,26,32,-6,27
Mattersburg,4171,5,7,6,11,30,38,-8,27
Vienna,4171,6,6,6,12,26,41,-15,24
SC Rheindorf,4171,7,5,6,13,19,29,-10,21
FC Salzburg,4172,1,15,6,3,44,18,26,51
SK Sturm Gra,4172,2,13,4,7,35,28,7,43
Rapid Vienna,4172,3,8,11,5,36,28,8,35
LASK Linz,4172,4,8,6,10,27,31,-4,30
Mattersburg,4172,5,7,6,11,34,43,-9,27
Vienna,4172,6,6,6,12,25,40,-15,24
SC Rheindorf,4172,7,4,7,13,19,32,-13,19
FC Salzburg,4173,1,13,8,3,41,17,24,47
SK Sturm Gra,4173,2,14,3,7,32,26,6,45
Rapid Vienna,4173,3,7,11,6,32,27,5,32
LASK Linz,4173,4,8,7,9,25,26,-1,31
Vienna,4173,5,7,6,11,25,37,-12,27
Mattersburg,4173,6,6,6,12,27,39,-12,24
SC Rheindorf,4173,7,5,7,12,17,27,-10,22
FC Salzburg,4174,1,14,7,3,44,19,25,49
SK Sturm Gra,4174,2,12,3,9,32,30,2,39
Rapid Vienna,4174,3,8,12,4,37,28,9,36
LASK Linz,4174,4,8,6,10,30,32,-2,30
Mattersburg,4174,5,7,6,11,32,41,-9,27
SC Rheindorf,4174,6,6,7,11,20,28,-8,25
Vienna,4174,7,6,5,13,25,42,-17,23
FC Salzburg,4175,1,16,6,2,46,16,30,54
SK Sturm Gra,4175,2,11,4,9,30,30,0,37
LASK Linz,4175,3,10,5,9,29,28,1,35
Rapid Vienna,4175,4,8,9,7,35,29,6,33
Vienna,4175,5,7,5,12,29,42,-13,26
SC Rheindorf,4175,6,6,6,12,20,30,-10,24
Mattersburg,4175,7,6,5,13,32,46,-14,23
FC Salzburg,4176,1,14,6,4,41,18,23,48
SK Sturm Gra,4176,2,14,3,7,37,28,9,45
Rapid Vienna,4176,3,10,9,5,39,27,12,39
Mattersburg,4176,4,8,5,11,32,42,-10,29
LASK Linz,4176,5,7,5,12,25,35,-10,26
Vienna,4176,6,7,5,12,27,39,-12,26
SC Rheindorf,4176,7,5,5,14,19,31,-12,20
FC Salzburg,4177,1,14,7,3,48,21,27,49
SK Sturm Gra,4177,2,11,6,7,31,28,3,39
Rapid Vienna,4177,3,9,9,6,36,28,8,36
LASK Linz,4177,4,8,6,10,27,30,-3,30
Mattersburg,4177,5,7,5,12,34,45,-11,26
Vienna,4177,6,7,5,12,27,41,-14,26
SC Rheindorf,4177,7,6,6,12,18,28,-10,24
FC Salzburg,4178,1,13,8,3,42,20,22,47
Rapid Vienna,4178,2,10,10,4,40,26,14,40
SK Sturm Gra,4178,3,11,5,8,32,30,2,38
LASK Linz,4178,4,8,7,9,30,32,-2,31
Vienna,4178,5,7,5,12,25,40,-15,26
Mattersburg,4178,6,6,6,12,32,43,-11,24
SC Rheindorf,4178,7,6,5,13,21,31,-10,23
FC Salzburg,4179,1,13,7,4,41,18,23,46
SK Sturm Gra,4179,2,13,3,8,33,30,3,42
Rapid Vienna,4179,3,9,9,6,33,28,5,36
Mattersburg,4179,4,8,6,10,31,36,-5,30
LASK Linz,4179,5,7,7,10,26,29,-3,28
SC Rheindorf,4179,6,6,6,12,21,28,-7,24
Vienna,4179,7,6,6,12,24,40,-16,24
FC Salzburg,4180,1,14,8,2,43,16,27,50
SK Sturm Gra,4180,2,14,4,6,35,25,10,46
Rapid Vienna,4180,3,8,11,5,39,30,9,35
LASK Linz,4180,4,8,7,9,27,28,-1,31
Vienna,4180,5,7,5,12,25,40,-15,26
Mattersburg,4180,6,6,5,13,30,43,-13,23
SC Rheindorf,4180,7,4,6,14,18,35,-17,18
FC Salzburg,4181,1,12,10,2,43,20,23,46
SK Sturm Gra,4181,2,11,5,8,30,30,0,38
LASK Linz,4181,3,10,6,8,31,27,4,36
Rapid Vienna,4181,4,8,11,5,37,28,9,35
Mattersburg,4181,5,6,8,10,33,42,-9,26
Vienna,4181,6,6,6,12,26,41,-15,24
SC Rheindorf,4181,7,5,6,13,18,30,-12,21
FC Salzburg,4182,1,16,6,2,45,15,30,54
SK Sturm Gra,4182,2,14,3,7,35,27,8,45
Rapid Vienna,4182,3,8,9,7,36,32,4,33
LASK Linz,4182,4,9,5,10,33,32,1,32
Vienna,4182,5,7,5,12,27,40,-13,26
Mattersburg,4182,6,6,6,12,33,44,-11,24
SC Rheindorf,4182,7,4,6,14,19,38,-19,18
FC Salzburg,4183,1,15,7,2,46,19,27,52
SK Sturm Gra,4183,2,11,5,8,29,29,0,38
Rapid Vienna,4183,3,7,11,6,32,26,6,32
LASK Linz,4183,4,8,7,9,24,25,-1,31
SC Rheindorf,4183,5,7,5,12,21,28,-7,26
Mattersburg,4183,6,6,7,11,30,39,-9,25
Vienna,4183,7,6,6,12,24,40,-16,24
FC Salzburg,4184,1,15,6,3,44,17,27,51
SK Sturm Gra,4184,2,12,4,8,31,28,3,40
Rapid Vienna,4184,3,8,10,6,34,27,7,34
LASK Linz,4184,4,8,8,8,27,27,0,32
Vienna,4184,5,8,5,11,32,37,-5,29
Mattersburg,4184,6,5,7,12,31,52,-21,22
SC Rheindorf,4184,7,4,8,12,18,29,-11,20
FC Salzburg,4185,1,15,6,3,44,19,25,51
SK Sturm Gra,4185,2,13,3,8,30,27,3,42
Rapid Vienna,4185,3,10,9,5,37,24,13,39
LASK Linz,4185,4,9,5,10,26,27,-1,32
Mattersburg,4185,5,7,5,12,31,40,-9,26
Vienna,4185,6,6,5,13,25,42,-17,23
SC Rheindorf,4185,7,5,5,14,17,31,-14,20
FC Salzburg,4186,1,13,8,3,41,18,23,47
SK Sturm Gra,4186,2,13,4,7,33,27,6,43
Rapid Vienna,4186,3,7,12,5,34,28,6,33
Vienna,4186,4,8,5,11,28,38,-10,29
LASK Linz,4186,5,7,6,11,25,30,-5,27
SC Rheindorf,4186,6,6,7,11,19,27,-8,25
Mattersburg,4186,7,6,6,12,29,41,-12,24
FC Salzburg,4187,1,13,7,4,44,23,21,46
SK Sturm Gra,4187,2,12,5,7,32,28,4,41
Rapid Vienna,4187,3,9,11,4,38,27,11,38
LASK Linz,4187,4,9,5,10,28,27,1,32
Vienna,4187,5,8,5,11,27,39,-12,29
Mattersburg,4187,6,6,5,13,27,41,-14,23
SC Rheindorf,4187,7,5,6,13,17,28,-11,21
FC Salzburg,4188,1,15,6,3,45,19,26,51
SK Sturm Gra,4188,2,13,3,8,31,28,3,42
LASK Linz,4188,3,10,5,9,30,28,2,35
Rapid Vienna,4188,4,7,10,7,34,29,5,31
Vienna,4188,5,7,6,11,26,38,-12,27
SC Rheindorf,4188,6,5,7,12,20,29,-9,22
Mattersburg,4188,7,5,7,12,29,44,-15,22
FC Salzburg,4189,1,16,6,2,47,16,31,54
SK Sturm Gra,4189,2,12,4,8,31,28,3,40
Rapid Vienna,4189,3,10,9,5,35,25,10,39
LASK Linz,4189,4,7,6,11,23,28,-5,27
Mattersburg,4189,5,7,6,11,33,41,-8,27
Vienna,4189,6,6,5,13,24,42,-18,23
SC Rheindorf,4189,7,5,6,13,19,32,-13,21
FC Salzburg,4190,1,15,7,2,48,18,30,52
SK Sturm Gra,4190,2,11,4,9,31,33,-2,37
LASK Linz,4190,3,9,6,9,29,28,1,33
Rapid Vienna,4190,4,7,11,6,31,27,4,32
SC Rheindorf,4190,5,8,5,11,21,26,-5,29
Vienna,4190,6,7,5,12,25,39,-14,26
Mattersburg,4190,7,5,6,13,26,40,-14,21
FC Salzburg,4191,1,15,7,2,48,17,31,52
SK Sturm Gra,4191,2,12,5,7,34,29,5,41
Rapid Vienna,4191,3,7,11,6,32,26,6,32
LASK Linz,4191,4,9,5,10,26,29,-3,32
Vienna,4191,5,7,5,12,25,44,-19,26
SC Rheindorf,4191,6,6,7,11,22,29,-7,25
Mattersburg,4191,7,5,6,13,29,42,-13,21
FC Salzburg,4192,1,14,7,3,48,21,27,49
SK Sturm Gra,4192,2,13,4,7,34,29,5,43
Rapid Vienna,4192,3,11,9,4,38,25,13,42
LASK Linz,4192,4,8,6,10,26,28,-2,30
Mattersburg,4192,5,6,5,13,32,43,-11,23
Vienna,4192,6,6,5,13,23,43,-20,23
SC Rheindorf,4192,7,5,6,13,20,32,-12,21
FC Salzburg,4193,1,14,7,3,42,17,25,49
SK Sturm Gra,4193,2,13,4,7,37,28,9,43
Rapid Vienna,4193,3,10,9,5,36,26,10,39
LASK Linz,4193,4,8,6,10,26,32,-6,30
Mattersburg,4193,5,7,6,11,31,39,-8,27
Vienna,4193,6,6,6,12,24,39,-15,24
SC Rheindorf,4193,7,4,6,14,17,32,-15,18
FC Salzburg,4194,1,15,7,2,46,18,28,52
SK Sturm Gra,4194,2,12,4,8,32,31,1,40
Rapid Vienna,4194,3,8,12,4,33,24,9,36
LASK Linz,4194,4,8,6,10,28,30,-2,30
Vienna,4194,5,7,5,12,25,38,-13,26
SC Rheindorf,4194,6,5,7,12,19,28,-9,22
Mattersburg,4194,7,5,7,12,29,43,-14,22
FC Salzburg,4195,1,15,7,2,44,18,26,52
SK Sturm Gra,4195,2,13,3,8,34,29,5,42
Rapid Vienna,4195,3,9,9,6,39,30,9,36
LASK Linz,4195,4,8,7,9,30,31,-1,31
Vienna,4195,5,7,6,11,27,40,-13,27
Mattersburg,4195,6,5,7,12,31,43,-12,22
SC Rheindorf,4195,7,4,7,13,18,32,-14,19
FC Salzburg,4196,1,15,6,3,44,17,27,51
SK Sturm Gra,4196,2,12,4,8,35,30,5,40
Rapid Vienna,4196,3,8,11,5,34,27,7,35
Mattersburg,4196,4,7,7,10,32,38,-6,28
LASK Linz,4196,5,7,7,10,25,31,-6,28
SC Rheindorf,4196,6,6,6,12,20,28,-8,24
Vienna,4196,7,6,5,13,24,43,-19,23
FC Salzburg,4197,1,14,7,3,45,17,28,49
SK Sturm Gra,4197,2,13,3,8,34,29,5,42
Rapid Vienna,4197,3,9,10,5,35,26,9,37
LASK Linz,4197,4,7,6,11,26,34,-8,27
Mattersburg,4197,5,6,8,10,30,39,-9,26
SC Rheindorf,4197,6,6,7,11,21,28,-7,25
Vienna,4197,7,6,5,13,24,42,-18,23
FC Salzburg,4198,1,14,6,4,43,19,24,48
SK Sturm Gra,4198,2,14,4,6,35,27,8,46
Rapid Vienna,4198,3,9,10,5,38,28,10,37
LASK Linz,4198,4,8,6,10,27,29,-2,30
Vienna,4198,5,6,6,12,24,41,-17,24
SC Rheindorf,4198,6,6,5,13,21,29,-8,23
Mattersburg,4198,7,5,7,12,28,43,-15,22
FC Salzburg,4199,1,14,7,3,48,23,25,49
SK Sturm Gra,4199,2,14,4,6,36,28,8,46
Rapid Vienna,4199,3,8,10,6,36,28,8,34
LASK Linz,4199,4,8,5,11,27,29,-2,29
Vienna,4199,5,7,5,12,26,41,-15,26
Mattersburg,4199,6,6,6,12,31,44,-13,24
SC Rheindorf,4199,7,5,7,12,22,33,-11,22
FC Salzburg,4200,1,14,6,4,43,19,24,48
SK Sturm Gra,4200,2,13,4,7,35,30,5,43
Rapid Vienna,4200,3,7,11,6,36,30,6,32
Mattersburg,4200,4,8,6,10,37,42,-5,30
LASK Linz,4200,5,7,7,10,28,31,-3,28
SC Rheindorf,4200,6,6,6,12,19,30,-11,24
Vienna,4200,7,6,6,12,26,42,-16,24
FC Salzburg,4201,1,14,8,2,43,18,25,50
SK Sturm Gra,4201,2,13,3,8,35,31,4,42
Rapid Vienna,4201,3,9,10,5,37,26,11,37
LASK Linz,4201,4,8,6,10,28,29,-1,30
Mattersburg,4201,5,6,8,10,30,39,-9,26
Vienna,4201,6,6,6,12,24,39,-15,24
SC Rheindorf,4201,7,5,5,14,17,32,-15,20
FC Salzburg,4202,1,14,8,2,44,16,28,50
SK Sturm Gra,4202,2,12,3,9,32,32,0,39
Rapid Vienna,4202,3,8,11,5,37,27,10,35
LASK Linz,4202,4,9,5,10,28,30,-2,32
SC Rheindorf,4202,5,7,6,11,20,26,-6,27
Mattersburg,4202,6,6,6,12,30,41,-11,24
Vienna,4202,7,6,5,13,24,43,-19,23
FC Salzburg,4203,1,16,6,2,49,17,32,54
SK Sturm Gra,4203,2,12,4,8,33,30,3,40
Rapid Vienna,4203,3,8,11,5,38,30,8,35
LASK Linz,4203,4,8,7,9,30,32,-2,31
Vienna,4203,5,7,5,12,25,41,-16,26
SC Rheindorf,4203,6,5,7,12,19,29,-10,22
Mattersburg,4203,7,5,6,13,31,46,-15,21
FC Salzburg,4204,1,14,8,2,45,18,27,50
SK Sturm Gra,4204,2,13,3,8,33,30,3,42
Rapid Vienna,4204,3,9,10,5,38,26,12,37
Mattersburg,4204,4,7,6,11,31,39,-8,27
LASK Linz,4204,5,7,5,12,25,33,-8,26
Vienna,4204,6,7,5,12,24,39,-15,26
SC Rheindorf,4204,7,6,5,13,19,30,-11,23
FC Salzburg,4205,1,15,7,2,48,18,30,52
SK Sturm Gra,4205,2,14,3,7,36,28,8,45
Rapid Vienna,4205,3,8,10,6,34,28,6,34
LASK Linz,4205,4,9,6,9,28,28,0,33
Mattersburg,4205,5,6,6,12,31,46,-15,24
Vienna,4205,6,6,6,12,26,41,-15,24
SC Rheindorf,4205,7,4,6,14,19,33,-14,18
FC Salzburg,4206,1,13,7,4,46,20,26,46
SK Sturm Gra,4206,2,12,4,8,30,29,1,40
Rapid Vienna,4206,3,8,12,4,36,26,10,36
LASK Linz,4206,4,8,6,10,26,29,-3,30
Mattersburg,4206,5,7,6,11,33,43,-10,27
Vienna,4206,6,7,5,12,27,44,-17,26
SC Rheindorf,4206,7,6,6,12,21,28,-7,24
FC Salzburg,4207,1,15,7,2,46,17,29,52
SK Sturm Gra,4207,2,11,5,8,35,34,1,38
LASK Linz,4207,3,9,7,8,33,31,2,34
Rapid Vienna,4207,4,7,12,5,33,26,7,33
Vienna,4207,5,7,5,12,27,41,-14,26
SC Rheindorf,4207,6,6,7,11,20,28,-8,25
Mattersburg,4207,7,5,5,14,28,45,-17,20
FC Salzburg,4208,1,15,6,3,44,16,28,51
SK Sturm Gra,4208,2,14,3,7,35,28,7,45
Rapid Vienna,4208,3,8,10,6,36,29,7,34
LASK Linz,4208,4,8,5,11,28,37,-9,29
Mattersburg,4208,5,7,5,12,32,39,-7,26
Vienna,4208,6,7,5,12,24,39,-15,26
SC Rheindorf,4208,7,5,6,13,19,30,-11,21
SK Sturm Gra,4209,1,15,3,6,39,27,12,48
FC Salzburg,4209,2,13,8,3,40,17,23,47
Rapid Vienna,4209,3,8,11,5,35,27,8,35
LASK Linz,4209,4,7,8,9,23,29,-6,29
Mattersburg,4209,5,7,6,11,32,39,-7,27
Vienna,4209,6,6,6,12,24,40,-16,24
SC Rheindorf,4209,7,4,6,14,17,31,-14,18
FC Salzburg,4210,1,14,7,3,45,18,27,49
SK Sturm Gra,4210,2,12,5,7,32,27,5,41
Rapid Vienna,4210,3,8,10,6,36,32,4,34
LASK Linz,4210,4,8,6,10,30,31,-1,30
Vienna,4210,5,8,5,11,28,39,-11,29
Mattersburg,4210,6,6,6,12,30,44,-14,24
SC Rheindorf,4210,7,5,7,12,19,29,-10,22
FC Salzburg,4211,1,13,7,4,41,18,23,46
SK Sturm Gra,4211,2,13,4,7,32,28,4,43
Rapid Vienna,4211,3,7,12,5,33,28,5,33
LASK Linz,4211,4,7,9,8,25,26,-1,30
Vienna,4211,5,8,5,11,26,38,-12,29
SC Rheindorf,4211,6,5,8,11,20,26,-6,23
Mattersburg,4211,7,5,7,12,29,42,-13,22
FC Salzburg,4212,1,15,6,3,43,16,27,51
SK Sturm Gra,4212,2,11,3,10,29,31,-2,36
Rapid Vienna,4212,3,8,10,6,33,26,7,34
LASK Linz,4212,4,9,6,9,27,27,0,33
Vienna,4212,5,8,5,11,27,38,-11,29
SC Rheindorf,4212,6,7,5,12,19,27,-8,26
Mattersburg,4212,7,6,5,13,29,42,-13,23
FC Salzburg,4213,1,15,7,2,47,18,29,52
SK Sturm Gra,4213,2,13,5,6,32,26,6,44
Rapid Vienna,4213,3,7,11,6,36,30,6,32
LASK Linz,4213,4,8,7,9,26,31,-5,31
Vienna,4213,5,7,5,12,26,39,-13,26
SC Rheindorf,4213,6,6,6,12,24,28,-4,24
Mattersburg,4213,7,5,5,14,28,47,-19,20
FC Salzburg,4214,1,15,6,3,46,18,28,51
Rapid Vienna,4214,2,11,9,4,40,25,15,42
SK Sturm Gra,4214,3,12,3,9,31,30,1,39
LASK Linz,4214,4,7,5,12,26,33,-7,26
Mattersburg,4214,5,7,5,12,30,43,-13,26
Vienna,4214,6,7,5,12,25,39,-14,26
SC Rheindorf,4214,7,6,5,13,19,29,-10,23
FC Salzburg,4215,1,14,6,4,43,20,23,48
SK Sturm Gra,4215,2,13,3,8,35,29,6,42
Rapid Vienna,4215,3,10,10,4,38,24,14,40
LASK Linz,4215,4,7,8,9,25,27,-2,29
Vienna,4215,5,7,5,12,25,39,-14,26
Mattersburg,4215,6,6,6,12,31,43,-12,24
SC Rheindorf,4215,7,5,6,13,18,33,-15,21
FC Salzburg,4216,1,13,8,3,40,19,21,47
SK Sturm Gra,4216,2,13,5,6,34,26,8,44
Rapid Vienna,4216,3,9,10,5,38,28,10,37
LASK Linz,4216,4,8,6,10,25,28,-3,30
Vienna,4216,5,7,5,12,24,38,-14,26
SC Rheindorf,4216,6,5,7,12,19,29,-10,22
Mattersburg,4216,7,5,7,12,26,38,-12,22
FC Salzburg,4217,1,13,9,2,45,20,25,48
SK Sturm Gra,4217,2,13,4,7,35,26,9,43
Rapid Vienna,4217,3,8,10,6,35,31,4,34
LASK Linz,4217,4,8,6,10,27,32,-5,30
Mattersburg,4217,5,7,6,11,34,41,-7,27
Vienna,4217,6,6,6,12,25,41,-16,24
SC Rheindorf,4217,7,5,7,12,18,28,-10,22
FC Salzburg,4218,1,15,7,2,43,15,28,52
SK Sturm Gra,4218,2,11,4,9,29,29,0,37
LASK Linz,4218,3,10,5,9,31,29,2,35
Rapid Vienna,4218,4,8,10,6,33,26,7,34
Mattersburg,4218,5,8,5,11,34,39,-5,29
Vienna,4218,6,6,5,13,23,41,-18,23
SC Rheindorf,4218,7,5,6,13,19,33,-14,21
FC Salzburg,4219,1,16,6,2,48,16,32,54
SK Sturm Gra,4219,2,12,4,8,33,32,1,40
Rapid Vienna,4219,3,7,10,7,35,30,5,31
LASK Linz,4219,4,8,6,10,29,31,-2,30
SC Rheindorf,4219,5,7,6,11,25,29,-4,27
Mattersburg,4219,6,7,5,12,31,44,-13,26
Vienna,4219,7,6,5,13,24,43,-19,23
FC Salzburg,4220,1,15,7,2,51,20,31,52
SK Sturm Gra,4220,2,13,4,7,36,29,7,43
Rapid Vienna,4220,3,8,11,5,33,27,6,35
LASK Linz,4220,4,8,5,11,27,30,-3,29
Vienna,4220,5,7,5,12,27,41,-14,26
SC Rheindorf,4220,6,6,7,11,20,28,-8,25
Mattersburg,4220,7,5,5,14,29,48,-19,20
FC Salzburg,4221,1,16,6,2,47,19,28,54
SK Sturm Gra,4221,2,13,3,8,34,29,5,42
Rapid Vienna,4221,3,8,10,6,36,30,6,34
LASK Linz,4221,4,9,6,9,31,30,1,33
Vienna,4221,5,7,5,12,27,41,-14,26
Mattersburg,4221,6,6,5,13,29,43,-14,23
SC Rheindorf,4221,7,5,5,14,19,31,-12,20
FC Salzburg,4222,1,12,8,4,40,19,21,44
SK Sturm Gra,4222,2,13,5,6,36,28,8,44
Rapid Vienna,4222,3,8,12,4,33,24,9,36
LASK Linz,4222,4,9,6,9,27,27,0,33
Vienna,4222,5,8,5,11,26,38,-12,29
Mattersburg,4222,6,7,5,12,32,42,-10,26
SC Rheindorf,4222,7,4,5,15,17,33,-16,17
FC Salzburg,4223,1,15,7,2,45,17,28,52
SK Sturm Gra,4223,2,12,4,8,32,31,1,40
LASK Linz,4223,3,10,5,9,29,27,2,35
Rapid Vienna,4223,4,8,9,7,37,30,7,33
SC Rheindorf,4223,5,7,5,12,22,30,-8,26
Vienna,4223,6,7,5,12,25,39,-14,26
Mattersburg,4223,7,5,5,14,28,44,-16,20
FC Salzburg,4224,1,14,7,3,46,21,25,49
SK Sturm Gra,4224,2,12,4,8,36,31,5,40
Rapid Vienna,4224,3,9,9,6,37,29,8,36
LASK Linz,4224,4,9,6,9,28,30,-2,33
Vienna,4224,5,7,5,12,28,44,-16,26
Mattersburg,4224,6,6,6,12,35,45,-10,24
SC Rheindorf,4224,7,6,5,13,21,31,-10,23
FC Salzburg,4225,1,15,7,2,46,17,29,52
SK Sturm Gra,4225,2,12,4,8,33,29,4,40
LASK Linz,4225,3,10,6,8,29,26,3,36
Rapid Vienna,4225,4,8,10,6,36,30,6,34
Mattersburg,4225,5,6,6,12,30,41,-11,24
Vienna,4225,6,6,5,13,23,40,-17,23
SC Rheindorf,4225,7,5,6,13,17,31,-14,21
FC Salzburg,4226,1,15,7,2,46,16,30,52
SK Sturm Gra,4226,2,13,4,7,32,29,3,43
LASK Linz,4226,3,9,7,8,30,26,4,34
Rapid Vienna,4226,4,8,9,7,35,29,6,33
Mattersburg,4226,5,6,7,11,31,42,-11,25
Vienna,4226,6,6,6,12,24,41,-17,24
SC Rheindorf,4226,7,4,6,14,18,33,-15,18
FC Salzburg,4227,1,15,7,2,44,17,27,52
Rapid Vienna,4227,2,9,11,4,38,27,11,38
SK Sturm Gra,4227,3,11,5,8,32,30,2,38
LASK Linz,4227,4,7,7,10,25,30,-5,28
Mattersburg,4227,5,6,7,11,32,41,-9,25
Vienna,4227,6,6,6,12,24,40,-16,24
SC Rheindorf,4227,7,6,5,13,21,31,-10,23
FC Salzburg,4228,1,14,6,4,45,23,22,48
SK Sturm Gra,4228,2,11,6,7,33,31,2,39
Rapid Vienna,4228,3,9,10,5,39,30,9,37
LASK Linz,4228,4,8,7,9,29,31,-2,31
Vienna,4228,5,8,5,11,29,38,-9,29
SC Rheindorf,4228,6,6,7,11,23,27,-4,25
Mattersburg,4228,7,5,5,14,29,47,-18,20
FC Salzburg,4229,1,15,6,3,46,18,28,51
SK Sturm Gra,4229,2,12,5,7,31,27,4,41
Rapid Vienna,4229,3,9,10,5,36,27,9,37
LASK Linz,4229,4,7,8,9,27,29,-2,29
Mattersburg,4229,5,7,6,11,31,41,-10,27
Vienna,4229,6,6,5,13,23,41,-18,23
SC Rheindorf,4229,7,4,8,12,19,30,-11,20
FC Salzburg,4230,1,16,6,2,45,16,29,54
SK Sturm Gra,4230,2,13,3,8,36,28,8,42
Rapid Vienna,4230,3,8,10,6,33,28,5,34
LASK Linz,4230,4,8,5,11,25,30,-5,29
Mattersburg,4230,5,8,5,11,33,41,-8,29
Vienna,4230,6,6,5,13,24,40,-16,23
SC Rheindorf,4230,7,5,6,13,18,31,-13,21
FC Salzburg,4231,1,15,6,3,50,25,25,51
SK Sturm Gra,4231,2,14,3,7,38,29,9,45
Rapid Vienna,4231,3,9,10,5,41,33,8,37
Mattersburg,4231,4,7,6,11,32,40,-8,27
LASK Linz,4231,5,7,5,12,28,36,-8,26
Vienna,4231,6,6,6,12,27,42,-15,24
SC Rheindorf,4231,7,5,6,13,20,31,-11,21
FC Salzburg,4232,1,15,7,2,47,18,29,52
SK Sturm Gra,4232,2,13,3,8,33,29,4,42
Rapid Vienna,4232,3,9,10,5,37,26,11,37
LASK Linz,4232,4,7,5,12,24,32,-8,26
Vienna,4232,5,7,5,12,28,40,-12,26
SC Rheindorf,4232,6,6,6,12,22,30,-8,24
Mattersburg,4232,7,6,6,12,30,46,-16,24
FC Salzburg,4233,1,15,7,2,45,18,27,52
SK Sturm Gra,4233,2,13,3,8,35,29,6,42
Rapid Vienna,4233,3,8,9,7,33,27,6,33
LASK Linz,4233,4,9,6,9,28,28,0,33
Vienna,4233,5,7,6,11,28,40,-12,27
Mattersburg,4233,6,7,5,12,34,44,-10,26
SC Rheindorf,4233,7,4,6,14,16,33,-17,18
FC Salzburg,4234,1,13,7,4,42,21,21,46
SK Sturm Gra,4234,2,13,4,7,37,28,9,43
Rapid Vienna,4234,3,9,10,5,40,29,11,37
Mattersburg,4234,4,9,5,10,38,40,-2,32
LASK Linz,4234,5,7,7,10,28,35,-7,28
Vienna,4234,6,6,6,12,28,43,-15,24
SC Rheindorf,4234,7,4,7,13,19,36,-17,19
FC Salzburg,4235,1,14,7,3,43,18,25,49
SK Sturm Gra,4235,2,11,6,7,32,30,2,39
Rapid Vienna,4235,3,9,10,5,39,30,9,37
LASK Linz,4235,4,8,6,10,28,30,-2,30
Vienna,4235,5,7,5,12,24,39,-15,26
SC Rheindorf,4235,6,6,6,12,19,28,-9,24
Mattersburg,4235,7,6,6,12,30,40,-10,24
FC Salzburg,4236,1,15,7,2,46,18,28,52
SK Sturm Gra,4236,2,13,5,6,34,28,6,44
Rapid Vienna,4236,3,9,10,5,40,27,13,37
LASK Linz,4236,4,7,6,11,25,32,-7,27
Vienna,4236,5,7,5,12,26,38,-12,26
Mattersburg,4236,6,7,5,12,31,44,-13,26
SC Rheindorf,4236,7,4,6,14,15,30,-15,18
FC Salzburg,4237,1,15,7,2,49,17,32,52
SK Sturm Gra,4237,2,12,4,8,32,31,1,40
Rapid Vienna,4237,3,7,12,5,34,27,7,33
LASK Linz,4237,4,9,6,9,28,29,-1,33
Mattersburg,4237,5,8,5,11,35,41,-6,29
Vienna,4237,6,6,5,13,24,44,-20,23
SC Rheindorf,4237,7,4,7,13,17,30,-13,19
FC Salzburg,4238,1,13,8,3,46,19,27,47
Rapid Vienna,4238,2,10,10,4,40,27,13,40
SK Sturm Gra,4238,3,11,6,7,33,30,3,39
LASK Linz,4238,4,7,7,10,27,31,-4,28
Mattersburg,4238,5,7,6,11,32,41,-9,27
Vienna,4238,6,7,5,12,25,44,-19,26
SC Rheindorf,4238,7,5,6,13,20,31,-11,21
FC Salzburg,4239,1,13,8,3,43,19,24,47
SK Sturm Gra,4239,2,12,4,8,31,30,1,40
Rapid Vienna,4239,3,9,11,4,38,24,14,38
LASK Linz,4239,4,8,7,9,27,30,-3,31
Mattersburg,4239,5,7,5,12,35,43,-8,26
Vienna,4239,6,6,6,12,23,39,-16,24
SC Rheindorf,4239,7,6,5,13,19,31,-12,23
FC Salzburg,4240,1,15,7,2,44,18,26,52
SK Sturm Gra,4240,2,13,3,8,30,26,4,42
Rapid Vienna,4240,3,7,11,6,34,28,6,32
LASK Linz,4240,4,7,8,9,26,28,-2,29
Mattersburg,4240,5,6,7,11,32,42,-10,25
Vienna,4240,6,6,7,11,25,39,-14,25
SC Rheindorf,4240,7,5,7,12,18,28,-10,22
FC Salzburg,4241,1,15,6,3,47,19,28,51
SK Sturm Gra,4241,2,14,3,7,35,27,8,45
Rapid Vienna,4241,3,7,10,7,34,31,3,31
LASK Linz,4241,4,7,6,11,26,31,-5,27
SC Rheindorf,4241,5,7,6,11,23,29,-6,27
Mattersburg,4241,6,6,7,11,30,43,-13,25
Vienna,4241,7,6,6,12,24,39,-15,24
FC Salzburg,4242,1,15,6,3,45,19,26,51
SK Sturm Gra,4242,2,11,4,9,33,33,0,37
LASK Linz,4242,3,10,5,9,33,27,6,35
Rapid Vienna,4242,4,8,10,6,37,34,3,34
SC Rheindorf,4242,5,8,5,11,23,29,-6,29
Vienna,4242,6,7,5,12,27,40,-13,26
Mattersburg,4242,7,5,5,14,29,45,-16,20
FC Salzburg,4243,1,14,7,3,44,21,23,49
SK Sturm Gra,4243,2,12,4,8,32,29,3,40
Rapid Vienna,4243,3,10,9,5,37,25,12,39
LASK Linz,4243,4,8,7,9,28,30,-2,31
Vienna,4243,5,7,5,12,28,39,-11,26
SC Rheindorf,4243,6,5,7,12,24,31,-7,22
Mattersburg,4243,7,5,7,12,30,48,-18,22
FC Salzburg,4244,1,14,8,2,49,20,29,50
SK Sturm Gra,4244,2,13,4,7,34,28,6,43
Rapid Vienna,4244,3,9,10,5,39,29,10,37
LASK Linz,4244,4,8,6,10,27,29,-2,30
Mattersburg,4244,5,6,6,12,31,45,-14,24
SC Rheindorf,4244,6,6,5,13,20,32,-12,23
Vienna,4244,7,6,5,13,25,42,-17,23
FC Salzburg,4245,1,15,7,2,46,19,27,52
SK Sturm Gra,4245,2,13,4,7,32,26,6,43
Rapid Vienna,4245,3,8,10,6,35,28,7,34
LASK Linz,4245,4,8,5,11,25,30,-5,29
Mattersburg,4245,5,7,5,12,35,43,-8,26
Vienna,4245,6,7,5,12,26,41,-15,26
SC Rheindorf,4245,7,5,6,13,20,32,-12,21
FC Salzburg,4246,1,15,7,2,48,20,28,52
SK Sturm Gra,4246,2,12,5,7,32,29,3,41
Rapid Vienna,4246,3,9,11,4,38,27,11,38
LASK Linz,4246,4,7,7,10,27,30,-3,28
Mattersburg,4246,5,7,6,11,33,43,-10,27
Vienna,4246,6,6,6,12,26,41,-15,24
SC Rheindorf,4246,7,4,6,14,17,31,-14,18
FC Salzburg,4247,1,14,6,4,43,20,23,48
SK Sturm Gra,4247,2,13,3,8,31,28,3,42
Rapid Vienna,4247,3,9,9,6,35,27,8,36
LASK Linz,4247,4,8,6,10,25,26,-1,30
Vienna,4247,5,7,6,11,25,38,-13,27
SC Rheindorf,4247,6,6,6,12,19,28,-9,24
Mattersburg,4247,7,6,6,12,30,41,-11,24
FC Salzburg,4248,1,13,8,3,42,18,24,47
SK Sturm Gra,4248,2,12,5,7,31,27,4,41
Rapid Vienna,4248,3,9,10,5,35,28,7,37
Mattersburg,4248,4,8,6,10,34,38,-4,30
LASK Linz,4248,5,7,6,11,25,31,-6,27
Vienna,4248,6,7,5,12,25,39,-14,26
SC Rheindorf,4248,7,5,6,13,20,31,-11,21
FC Salzburg,4249,1,13,8,3,43,18,25,47
SK Sturm Gra,4249,2,12,5,7,30,27,3,41
Rapid Vienna,4249,3,10,10,4,39,25,14,40
LASK Linz,4249,4,7,8,9,23,27,-4,29
Mattersburg,4249,5,7,7,10,31,39,-8,28
Vienna,4249,6,6,5,13,24,42,-18,23
SC Rheindorf,4249,7,4,7,13,16,28,-12,19
FC Salzburg,4250,1,14,8,2,44,17,27,50
SK Sturm Gra,4250,2,12,4,8,35,30,5,40
Rapid Vienna,4250,3,9,10,5,39,28,11,37
LASK Linz,4250,4,8,6,10,26,31,-5,30
SC Rheindorf,4250,5,7,5,12,19,28,-9,26
Vienna,4250,6,7,5,12,27,39,-12,26
Mattersburg,4250,7,5,6,13,29,46,-17,21
FC Salzburg,4251,1,15,7,2,47,18,29,52
SK Sturm Gra,4251,2,12,5,7,32,28,4,41
Rapid Vienna,4251,3,8,10,6,35,28,7,34
LASK Linz,4251,4,9,6,9,28,28,0,33
Vienna,4251,5,7,5,12,27,39,-12,26
Mattersburg,4251,6,6,6,12,31,46,-15,24
SC Rheindorf,4251,7,4,7,13,17,30,-13,19
FC Salzburg,4252,1,14,7,3,46,22,24,49
SK Sturm Gra,4252,2,12,4,8,31,31,0,40
Rapid Vienna,4252,3,9,10,5,37,25,12,37
LASK Linz,4252,4,10,6,8,29,27,2,36
Vienna,4252,5,7,6,11,28,39,-11,27
SC Rheindorf,4252,6,5,6,13,18,28,-10,21
Mattersburg,4252,7,5,5,14,30,47,-17,20
FC Salzburg,4253,1,15,6,3,46,18,28,51
SK Sturm Gra,4253,2,11,5,8,32,32,0,38
LASK Linz,4253,3,10,5,9,28,28,0,35
Rapid Vienna,4253,4,7,11,6,34,28,6,32
Vienna,4253,5,8,5,11,27,37,-10,29
Mattersburg,4253,6,6,5,13,30,44,-14,23
SC Rheindorf,4253,7,5,7,12,17,27,-10,22
FC Salzburg,4254,1,15,6,3,46,19,27,51
SK Sturm Gra,4254,2,14,3,7,38,28,10,45
Rapid Vienna,4254,3,10,9,5,39,29,10,39
LASK Linz,4254,4,8,6,10,28,30,-2,30
Mattersburg,4254,5,6,7,11,30,42,-12,25
Vienna,4254,6,6,5,13,25,41,-16,23
SC Rheindorf,4254,7,4,6,14,20,37,-17,18
FC Salzburg,4255,1,14,7,3,46,19,27,49
SK Sturm Gra,4255,2,14,4,6,36,25,11,46
Rapid Vienna,4255,3,7,10,7,32,30,2,31
LASK Linz,4255,4,8,6,10,26,30,-4,30
Vienna,4255,5,8,5,11,28,39,-11,29
SC Rheindorf,4255,6,6,5,13,20,31,-11,23
Mattersburg,4255,7,6,5,13,31,45,-14,23
FC Salzburg,4256,1,14,8,2,46,19,27,50
SK Sturm Gra,4256,2,12,5,7,31,27,4,41
Rapid Vienna,4256,3,8,11,5,35,28,7,35
LASK Linz,4256,4,8,7,9,27,28,-1,31
Vienna,4256,5,7,5,12,27,42,-15,26
Mattersburg,4256,6,6,6,12,30,42,-12,24
SC Rheindorf,4256,7,5,6,13,18,28,-10,21
FC Salzburg,4257,1,13,8,3,40,18,22,47
SK Sturm Gra,4257,2,13,4,7,36,31,5,43
Rapid Vienna,4257,3,10,10,4,38,23,15,40
LASK Linz,4257,4,7,7,10,27,31,-4,28
Mattersburg,4257,5,7,6,11,36,43,-7,27
Vienna,4257,6,6,6,12,25,42,-17,24
SC Rheindorf,4257,7,4,7,13,22,36,-14,19
FC Salzburg,4258,1,14,8,2,43,16,27,50
Rapid Vienna,4258,2,8,12,4,34,25,9,36
SK Sturm Gra,4258,3,11,3,10,28,28,0,36
LASK Linz,4258,4,8,6,10,26,29,-3,30
Mattersburg,4258,5,7,6,11,33,41,-8,27
SC Rheindorf,4258,6,6,7,11,17,25,-8,25
Vienna,4258,7,6,6,12,24,41,-17,24
FC Salzburg,4259,1,15,7,2,43,17,26,52
SK Sturm Gra,4259,2,13,4,7,32,26,6,43
Rapid Vienna,4259,3,7,11,6,35,33,2,32
LASK Linz,4259,4,8,7,9,29,27,2,31
Vienna,4259,5,7,5,12,26,39,-13,26
SC Rheindorf,4259,6,5,8,11,18,27,-9,23
Mattersburg,4259,7,5,6,13,29,43,-14,21
FC Salzburg,4260,1,14,7,3,44,20,24,49
SK Sturm Gra,4260,2,13,4,7,32,27,5,43
Rapid Vienna,4260,3,8,10,6,36,26,10,34
LASK Linz,4260,4,9,6,9,27,27,0,33
Mattersburg,4260,5,6,7,11,32,42,-10,25
Vienna,4260,6,6,7,11,25,39,-14,25
SC Rheindorf,4260,7,5,5,14,18,33,-15,20
FC Salzburg,4261,1,14,7,3,47,22,25,49
SK Sturm Gra,4261,2,13,4,7,33,29,4,43
Rapid Vienna,4261,3,10,10,4,39,25,14,40
LASK Linz,4261,4,7,7,10,27,30,-3,28
Vienna,4261,5,7,5,12,28,43,-15,26
Mattersburg,4261,6,5,7,12,28,41,-13,22
SC Rheindorf,4261,7,5,6,13,18,30,-12,21
FC Salzburg,4262,1,14,8,2,44,18,26,50
SK Sturm Gra,4262,2,11,4,9,32,31,1,37
Rapid Vienna,4262,3,7,12,5,34,27,7,33
LASK Linz,4262,4,8,7,9,28,29,-1,31
Vienna,4262,5,7,6,11,26,38,-12,27
SC Rheindorf,4262,6,6,7,11,19,27,-8,25
Mattersburg,4262,7,6,6,12,28,41,-13,24
FC Salzburg,4263,1,13,6,5,41,20,21,45
SK Sturm Gra,4263,2,13,3,8,35,31,4,42
Rapid Vienna,4263,3,9,9,6,40,28,12,36
LASK Linz,4263,4,9,5,10,27,29,-2,32
Vienna,4263,5,8,5,11,26,37,-11,29
SC Rheindorf,4263,6,7,5,12,24,33,-9,26
Mattersburg,4263,7,6,5,13,28,43,-15,23
FC Salzburg,4264,1,16,6,2,46,15,31,54
SK Sturm Gra,4264,2,13,4,7,34,27,7,43
Rapid Vienna,4264,3,8,9,7,34,30,4,33
LASK Linz,4264,4,8,6,10,28,31,-3,30
Mattersburg,4264,5,7,6,11,33,43,-10,27
Vienna,4264,6,6,6,12,25,42,-17,24
SC Rheindorf,4264,7,5,5,14,19,31,-12,20
FC Salzburg,4265,1,16,6,2,49,18,31,54
SK Sturm Gra,4265,2,13,4,7,36,30,6,43
Rapid Vienna,4265,3,8,10,6,36,30,6,34
Mattersburg,4265,4,8,5,11,32,42,-10,29
LASK Linz,4265,5,7,7,10,25,29,-4,28
Vienna,4265,6,6,5,13,24,40,-16,23
SC Rheindorf,4265,7,5,5,14,20,33,-13,20
FC Salzburg,4266,1,15,6,3,44,17,27,51
SK Sturm Gra,4266,2,12,4,8,33,29,4,40
Rapid Vienna,4266,3,9,10,5,35,27,8,37
LASK Linz,4266,4,9,6,9,31,26,5,33
Vienna,4266,5,7,5,12,24,38,-14,26
Mattersburg,4266,6,6,5,13,29,45,-16,23
SC Rheindorf,4266,7,5,6,13,17,31,-14,21
FC Salzburg,4267,1,15,7,2,49,15,34,52
SK Sturm Gra,4267,2,12,4,8,32,31,1,40
Rapid Vienna,4267,3,9,10,5,39,29,10,37
LASK Linz,4267,4,7,7,10,28,31,-3,28
SC Rheindorf,4267,5,7,5,12,22,31,-9,26
Mattersburg,4267,6,6,6,12,29,44,-15,24
Vienna,4267,7,6,5,13,24,42,-18,23
FC Salzburg,4268,1,13,9,2,47,20,27,48
SK Sturm Gra,4268,2,12,5,7,32,27,5,41
LASK Linz,4268,3,10,6,8,30,27,3,36
Rapid Vienna,4268,4,7,11,6,34,29,5,32
Vienna,4268,5,7,6,11,28,40,-12,27
SC Rheindorf,4268,6,5,8,11,20,29,-9,23
Mattersburg,4268,7,5,5,14,26,45,-19,20
FC Salzburg,4269,1,14,8,2,47,18,29,50
SK Sturm Gra,4269,2,13,4,7,32,26,6,43
Rapid Vienna,4269,3,8,11,5,36,27,9,35
LASK Linz,4269,4,7,6,11,24,30,-6,27
Mattersburg,4269,5,6,7,11,32,44,-12,25
SC Rheindorf,4269,6,6,6,12,19,28,-9,24
Vienna,4269,7,6,6,12,25,42,-17,24
FC Salzburg,4270,1,14,6,4,46,19,27,48
SK Sturm Gra,4270,2,13,3,8,32,28,4,42
LASK Linz,4270,3,10,6,8,35,28,7,36
Rapid Vienna,4270,4,7,10,7,32,32,0,31
Mattersburg,4270,5,7,6,11,37,45,-8,27
Vienna,4270,6,7,5,12,26,41,-15,26
SC Rheindorf,4270,7,5,6,13,18,33,-15,21
FC Salzburg,4271,1,13,9,2,43,19,24,48
SK Sturm Gra,4271,2,11,5,8,31,29,2,38
Rapid Vienna,4271,3,8,11,5,37,28,9,35
LASK Linz,4271,4,8,6,10,26,29,-3,30
Mattersburg,4271,5,8,6,10,34,40,-6,30
SC Rheindorf,4271,6,6,6,12,20,29,-9,24
Vienna,4271,7,6,5,13,25,42,-17,23
FC Salzburg,4272,1,14,7,3,42,17,25,49
Rapid Vienna,4272,2,10,9,5,36,26,10,39
SK Sturm Gra,4272,3,11,5,8,30,28,2,38
LASK Linz,4272,4,8,7,9,26,28,-2,31
SC Rheindorf,4272,5,7,5,12,21,27,-6,26
Vienna,4272,6,7,5,12,25,39,-14,26
Mattersburg,4272,7,5,6,13,27,42,-15,21
FC Salzburg,4273,1,15,7,2,49,19,30,52
SK Sturm Gra,4273,2,13,4,7,34,30,4,43
Rapid Vienna,4273,3,8,11,5,36,29,7,35
LASK Linz,4273,4,7,6,11,27,31,-4,27
Mattersburg,4273,5,7,6,11,37,43,-6,27
Vienna,4273,6,6,5,13,24,43,-19,23
SC Rheindorf,4273,7,5,7,12,18,30,-12,22
FC Salzburg,4274,1,15,7,2,48,18,30,52
SK Sturm Gra,4274,2,12,5,7,29,26,3,41
Rapid Vienna,4274,3,7,12,5,32,25,7,33
LASK Linz,4274,4,7,8,9,25,27,-2,29
Mattersburg,4274,5,6,7,11,31,44,-13,25
SC Rheindorf,4274,6,5,8,11,16,25,-9,23
Vienna,4274,7,6,5,13,25,41,-16,23
FC Salzburg,4275,1,15,6,3,49,19,30,51
SK Sturm Gra,4275,2,13,3,8,32,30,2,42
Rapid Vienna,4275,3,9,9,6,36,26,10,36
LASK Linz,4275,4,8,5,11,26,35,-9,29
Mattersburg,4275,5,7,5,12,34,43,-9,26
Vienna,4275,6,7,5,12,26,40,-14,26
SC Rheindorf,4275,7,6,5,13,21,31,-10,23
FC Salzburg,4276,1,14,8,2,42,17,25,50
SK Sturm Gra,4276,2,12,5,7,32,28,4,41
Rapid Vienna,4276,3,8,10,6,35,29,6,34
LASK Linz,4276,4,9,6,9,27,26,1,33
Vienna,4276,5,7,6,11,28,38,-10,27
SC Rheindorf,4276,6,6,5,13,20,30,-10,23
Mattersburg,4276,7,5,6,13,29,45,-16,21
FC Salzburg,4277,1,14,6,4,43,18,25,48
SK Sturm Gra,4277,2,12,4,8,30,29,1,40
Rapid Vienna,4277,3,8,10,6,36,29,7,34
LASK Linz,4277,4,8,6,10,26,30,-4,30
Vienna,4277,5,8,5,11,27,38,-11,29
SC Rheindorf,4277,6,7,6,11,23,28,-5,27
Mattersburg,4277,7,6,5,13,29,42,-13,23
FC Salzburg,4278,1,13,9,2,48,23,25,48
SK Sturm Gra,4278,2,12,5,7,35,30,5,41
Rapid Vienna,4278,3,8,11,5,38,32,6,35
LASK Linz,4278,4,9,5,10,27,27,0,32
Vienna,4278,5,7,5,12,25,39,-14,26
Mattersburg,4278,6,6,6,12,30,39,-9,24
SC Rheindorf,4278,7,6,5,13,18,31,-13,23
FC Salzburg,4279,1,15,6,3,43,17,26,51
SK Sturm Gra,4279,2,13,3,8,33,29,4,42
LASK Linz,4279,3,9,5,10,27,26,1,32
Rapid Vienna,4279,4,7,9,8,32,31,1,30
Mattersburg,4279,5,8,5,11,33,38,-5,29
Vienna,4279,6,7,5,12,24,38,-14,26
SC Rheindorf,4279,7,6,5,13,20,33,-13,23
FC Salzburg,4280,1,15,7,2,45,16,29,52
SK Sturm Gra,4280,2,13,4,7,32,26,6,43
Rapid Vienna,4280,3,7,10,7,33,31,2,31
LASK Linz,4280,4,8,7,9,26,29,-3,31
Vienna,4280,5,7,5,12,27,41,-14,26
Mattersburg,4280,6,5,8,11,31,43,-12,23
SC Rheindorf,4280,7,5,7,12,19,27,-8,22
FC Salzburg,4281,1,15,7,2,46,20,26,52
SK Sturm Gra,4281,2,13,3,8,33,28,5,42
Rapid Vienna,4281,3,9,9,6,35,27,8,36
LASK Linz,4281,4,9,6,9,27,27,0,33
Vienna,4281,5,6,7,11,26,40,-14,25
Mattersburg,4281,6,5,7,12,32,44,-12,22
SC Rheindorf,4281,7,4,7,13,17,30,-13,19
FC Salzburg,4282,1,15,7,2,48,17,31,52
SK Sturm Gra,4282,2,13,3,8,34,29,5,42
Rapid Vienna,4282,3,8,10,6,34,30,4,34
LASK Linz,4282,4,8,7,9,27,27,0,31
Vienna,4282,5,7,6,11,26,38,-12,27
Mattersburg,4282,6,6,6,12,28,45,-17,24
SC Rheindorf,4282,7,5,5,14,19,30,-11,20
FC Salzburg,4283,1,15,7,2,50,18,32,52
SK Sturm Gra,4283,2,13,4,7,33,29,4,43
Rapid Vienna,4283,3,9,9,6,38,30,8,36
LASK Linz,4283,4,7,6,11,26,32,-6,27
Mattersburg,4283,5,7,6,11,30,41,-11,27
Vienna,4283,6,6,6,12,23,39,-16,24
SC Rheindorf,4283,7,5,6,13,17,28,-11,21
FC Salzburg,4284,1,15,7,2,49,16,33,52
SK Sturm Gra,4284,2,11,7,6,30,26,4,40
Rapid Vienna,4284,3,7,10,7,31,29,2,31
LASK Linz,4284,4,8,6,10,25,28,-3,30
SC Rheindorf,4284,5,7,6,11,20,27,-7,27
Mattersburg,4284,6,6,6,12,30,43,-13,24
Vienna,4284,7,6,6,12,25,41,-16,24
FC Salzburg,4285,1,14,7,3,43,18,25,49
SK Sturm Gra,4285,2,11,6,7,32,29,3,39
Rapid Vienna,4285,3,8,12,4,36,27,9,36
LASK Linz,4285,4,7,8,9,27,29,-2,29
Vienna,4285,5,7,6,11,27,40,-13,27
Mattersburg,4285,6,7,5,12,30,40,-10,26
SC Rheindorf,4285,7,4,8,12,17,29,-12,20
FC Salzburg,4286,1,14,8,2,49,16,33,50
SK Sturm Gra,4286,2,12,4,8,30,35,-5,40
Rapid Vienna,4286,3,8,10,6,34,28,6,34
LASK Linz,4286,4,9,6,9,29,28,1,33
Vienna,4286,5,7,6,11,25,38,-13,27
SC Rheindorf,4286,6,6,6,12,20,27,-7,24
Mattersburg,4286,7,5,6,13,28,43,-15,21
FC Salzburg,4287,1,14,7,3,41,16,25,49
SK Sturm Gra,4287,2,12,4,8,31,28,3,40
Rapid Vienna,4287,3,10,9,5,35,26,9,39
LASK Linz,4287,4,9,5,10,25,26,-1,32
Vienna,4287,5,8,5,11,25,37,-12,29
Mattersburg,4287,6,6,5,13,28,40,-12,23
SC Rheindorf,4287,7,5,5,14,18,30,-12,20
FC Salzburg,4288,1,16,6,2,52,20,32,54
SK Sturm Gra,4288,2,12,4,8,31,30,1,40
Rapid Vienna,4288,3,8,10,6,37,30,7,34
LASK Linz,4288,4,8,6,10,29,33,-4,30
SC Rheindorf,4288,5,6,6,12,22,31,-9,24
Mattersburg,4288,6,6,6,12,34,46,-12,24
Vienna,4288,7,6,6,12,25,40,-15,24
FC Salzburg,4289,1,14,7,3,46,22,24,49
Rapid Vienna,4289,2,10,10,4,38,26,12,40
SK Sturm Gra,4289,3,11,5,8,31,30,1,38
LASK Linz,4289,4,8,7,9,29,29,0,31
Vienna,4289,5,7,6,11,28,40,-12,27
SC Rheindorf,4289,6,5,8,11,19,26,-7,23
Mattersburg,4289,7,5,5,14,30,48,-18,20
FC Salzburg,4290,1,13,8,3,44,19,25,47
SK Sturm Gra,4290,2,12,4,8,30,31,-1,40
LASK Linz,4290,3,10,5,9,29,26,3,35
Rapid Vienna,4290,4,8,10,6,33,26,7,34
Vienna,4290,5,7,6,11,27,40,-13,27
Mattersburg,4290,6,6,6,12,29,42,-13,24
SC Rheindorf,4290,7,6,5,13,20,28,-8,23
FC Salzburg,4291,1,14,7,3,42,18,24,49
SK Sturm Gra,4291,2,12,4,8,31,28,3,40
LASK Linz,4291,3,9,6,9,28,29,-1,33
Rapid Vienna,4291,4,7,10,7,33,29,4,31
SC Rheindorf,4291,5,7,6,11,23,28,-5,27
Vienna,4291,6,7,6,11,27,39,-12,27
Mattersburg,4291,7,5,7,12,29,42,-13,22
FC Salzburg,4292,1,14,8,2,41,15,26,50
SK Sturm Gra,4292,2,12,4,8,31,29,2,40
Rapid Vienna,4292,3,8,11,5,35,27,8,35
LASK Linz,4292,4,8,8,8,27,26,1,32
Vienna,4292,5,7,6,11,25,37,-12,27
Mattersburg,4292,6,6,5,13,28,41,-13,23
SC Rheindorf,4292,7,5,6,13,19,31,-12,21
FC Salzburg,4293,1,14,8,2,43,16,27,50
SK Sturm Gra,4293,2,12,5,7,33,27,6,41
Rapid Vienna,4293,3,8,11,5,36,28,8,35
LASK Linz,4293,4,8,5,11,26,33,-7,29
Mattersburg,4293,5,7,6,11,33,39,-6,27
Vienna,4293,6,7,5,12,24,40,-16,26
SC Rheindorf,4293,7,5,6,13,22,34,-12,21
FC Salzburg,4294,1,15,7,2,45,17,28,52
SK Sturm Gra,4294,2,14,3,7,34,28,6,45
Rapid Vienna,4294,3,8,11,5,34,26,8,35
LASK Linz,4294,4,7,7,10,24,27,-3,28
Mattersburg,4294,5,7,6,11,28,38,-10,27
Vienna,4294,6,6,6,12,24,40,-16,24
SC Rheindorf,4294,7,4,6,14,18,31,-13,18
FC Salzburg,4295,1,13,8,3,46,19,27,47
SK Sturm Gra,4295,2,12,5,7,36,31,5,41
Rapid Vienna,4295,3,9,10,5,37,28,9,37
LASK Linz,4295,4,8,7,9,27,29,-2,31
Mattersburg,4295,5,6,8,10,33,40,-7,26
Vienna,4295,6,6,5,13,23,45,-22,23
SC Rheindorf,4295,7,5,7,12,22,32,-10,22
FC Salzburg,4296,1,15,7,2,47,21,26,52
SK Sturm Gra,4296,2,13,4,7,33,28,5,43
Rapid Vienna,4296,3,9,9,6,38,28,10,36
LASK Linz,4296,4,8,6,10,26,30,-4,30
Mattersburg,4296,5,7,6,11,36,41,-5,27
Vienna,4296,6,6,5,13,27,45,-18,23
SC Rheindorf,4296,7,5,5,14,16,30,-14,20
FC Salzburg,4297,1,13,7,4,42,19,23,46
SK Sturm Gra,4297,2,12,5,7,39,30,9,41
Rapid Vienna,4297,3,9,9,6,35,32,3,36
LASK Linz,4297,4,8,6,10,28,33,-5,30
Mattersburg,4297,5,8,5,11,38,42,-4,29
Vienna,4297,6,7,5,12,25,39,-14,26
SC Rheindorf,4297,7,6,5,13,21,33,-12,23
FC Salzburg,4298,1,15,7,2,51,17,34,52
SK Sturm Gra,4298,2,13,4,7,34,27,7,43
Rapid Vienna,4298,3,8,9,7,34,33,1,33
LASK Linz,4298,4,9,5,10,28,29,-1,32
SC Rheindorf,4298,5,7,5,12,22,28,-6,26
Mattersburg,4298,6,6,5,13,29,44,-15,23
Vienna,4298,7,6,5,13,24,44,-20,23
FC Salzburg,4299,1,15,6,3,43,16,27,51
SK Sturm Gra,4299,2,13,3,8,32,30,2,42
Rapid Vienna,4299,3,10,9,5,35,25,10,39
LASK Linz,4299,4,9,5,10,27,28,-1,32
Mattersburg,4299,5,7,5,12,31,41,-10,26
Vienna,4299,6,6,5,13,23,39,-16,23
SC Rheindorf,4299,7,5,5,14,18,30,-12,20
FC Salzburg,4300,1,13,8,3,48,23,25,47
SK Sturm Gra,4300,2,13,4,7,36,31,5,43
LASK Linz,4300,3,10,6,8,31,26,5,36
Rapid Vienna,4300,4,7,11,6,34,30,4,32
Mattersburg,4300,5,7,6,11,31,42,-11,27
Vienna,4300,6,6,6,12,26,41,-15,24
SC Rheindorf,4300,7,4,7,13,17,30,-13,19
FC Salzburg,4301,1,14,6,4,44,21,23,48
SK Sturm Gra,4301,2,12,5,7,33,27,6,41
Rapid Vienna,4301,3,10,10,4,39,26,13,40
Mattersburg,4301,4,8,6,10,32,37,-5,30
LASK Linz,4301,5,7,6,11,27,34,-7,27
Vienna,4301,6,6,6,12,25,42,-17,24
SC Rheindorf,4301,7,4,7,13,17,30,-13,19
FC Salzburg,4302,1,16,6,2,46,16,30,54
SK Sturm Gra,4302,2,12,5,7,30,25,5,41
Rapid Vienna,4302,3,7,11,6,34,29,5,32
LASK Linz,4302,4,7,7,10,25,30,-5,28
Mattersburg,4302,5,7,5,12,31,43,-12,26
Vienna,4302,6,7,5,12,25,39,-14,26
SC Rheindorf,4302,7,5,7,12,18,27,-9,22
FC Salzburg,4303,1,13,7,4,43,20,23,46
SK Sturm Gra,4303,2,12,5,7,30,27,3,41
Rapid Vienna,4303,3,9,11,4,38,24,14,38
LASK Linz,4303,4,9,5,10,27,29,-2,32
Vienna,4303,5,8,5,11,30,39,-9,29
SC Rheindorf,4303,6,5,7,12,17,29,-12,22
Mattersburg,4303,7,5,6,13,29,46,-17,21
FC Salzburg,4304,1,12,8,4,44,23,21,44
SK Sturm Gra,4304,2,11,5,8,31,30,1,38
Rapid Vienna,4304,3,9,10,5,39,31,8,37
Vienna,4304,4,8,5,11,27,38,-11,29
LASK Linz,4304,5,7,7,10,25,30,-5,28
SC Rheindorf,4304,6,7,6,11,24,27,-3,27
Mattersburg,4304,7,6,7,11,28,39,-11,25
FC Salzburg,4305,1,15,7,2,43,17,26,52
SK Sturm Gra,4305,2,13,4,7,32,27,5,43
Rapid Vienna,4305,3,9,10,5,37,26,11,37
LASK Linz,4305,4,8,5,11,25,28,-3,29
Mattersburg,4305,5,6,6,12,27,40,-13,24
SC Rheindorf,4305,6,6,5,13,19,29,-10,23
Vienna,4305,7,6,5,13,23,39,-16,23
FC Salzburg,4306,1,14,8,2,45,18,27,50
Rapid Vienna,4306,2,10,10,4,39,24,15,40
SK Sturm Gra,4306,3,12,3,9,31,30,1,39
LASK Linz,4306,4,8,6,10,27,31,-4,30
Mattersburg,4306,5,7,6,11,34,42,-8,27
Vienna,4306,6,6,5,13,23,42,-19,23
SC Rheindorf,4306,7,5,6,13,18,30,-12,21
FC Salzburg,4307,1,14,7,3,41,16,25,49
Rapid Vienna,4307,2,10,10,4,40,27,13,40
SK Sturm Gra,4307,3,12,4,8,32,29,3,40
LASK Linz,4307,4,9,6,9,31,29,2,33
Vienna,4307,5,7,6,11,24,37,-13,27
Mattersburg,4307,6,6,5,13,28,40,-12,23
SC Rheindorf,4307,7,4,6,14,16,34,-18,18
FC Salzburg,4308,1,15,6,3,45,18,27,51
Rapid Vienna,4308,2,10,9,5,35,26,9,39
SK Sturm Gra,4308,3,11,3,10,29,31,-2,36
LASK Linz,4308,4,9,6,9,27,28,-1,33
SC Rheindorf,4308,5,7,5,12,23,28,-5,26
Vienna,4308,6,7,5,12,25,39,-14,26
Mattersburg,4308,7,5,6,13,30,44,-14,21
FC Salzburg,4309,1,16,6,2,52,17,35,54
SK Sturm Gra,4309,2,13,3,8,33,30,3,42
LASK Linz,4309,3,9,6,9,29,29,0,33
Rapid Vienna,4309,4,7,9,8,33,30,3,30
Vienna,4309,5,7,5,12,24,41,-17,26
SC Rheindorf,4309,6,6,6,12,18,27,-9,24
Mattersburg,4309,7,5,7,12,27,42,-15,22
FC Salzburg,4310,1,14,6,4,46,22,24,48
SK Sturm Gra,4310,2,13,4,7,40,33,7,43
LASK Linz,4310,3,9,7,8,32,30,2,34
Rapid Vienna,4310,4,7,9,8,35,37,-2,30
Vienna,4310,5,8,5,11,26,38,-12,29
Mattersburg,4310,6,6,6,12,30,41,-11,24
SC Rheindorf,4310,7,5,7,12,22,30,-8,22
FC Salzburg,4311,1,14,7,3,43,19,24,49
SK Sturm Gra,4311,2,12,6,6,35,29,6,42
Rapid Vienna,4311,3,9,9,6,39,31,8,36
LASK Linz,4311,4,8,6,10,29,30,-1,30
Mattersburg,4311,5,7,6,11,32,39,-7,27
Vienna,4311,6,6,5,13,23,42,-19,23
SC Rheindorf,4311,7,5,7,12,19,30,-11,22
FC Salzburg,4312,1,15,7,2,48,19,29,52
SK Sturm Gra,4312,2,12,3,9,33,34,-1,39
Rapid Vienna,4312,3,8,10,6,35,31,4,34
LASK Linz,4312,4,8,7,9,29,27,2,31
Vienna,4312,5,7,6,11,27,38,-11,27
SC Rheindorf,4312,6,7,5,12,21,28,-7,26
Mattersburg,4312,7,5,6,13,28,44,-16,21
FC Salzburg,4313,1,14,6,4,44,20,24,48
SK Sturm Gra,4313,2,13,4,7,34,27,7,43
Rapid Vienna,4313,3,7,10,7,32,29,3,31
LASK Linz,4313,4,8,6,10,27,30,-3,30
Mattersburg,4313,5,8,6,10,33,39,-6,30
Vienna,4313,6,7,5,12,25,39,-14,26
SC Rheindorf,4313,7,6,5,13,19,30,-11,23
FC Salzburg,4314,1,16,6,2,48,17,31,54
SK Sturm Gra,4314,2,12,4,8,33,31,2,40
Rapid Vienna,4314,3,7,10,7,33,30,3,31
LASK Linz,4314,4,7,8,9,26,28,-2,29
Mattersburg,4314,5,8,5,11,33,41,-8,29
SC Rheindorf,4314,6,6,6,12,21,31,-10,24
Vienna,4314,7,6,5,13,24,40,-16,23
FC Salzburg,4315,1,15,7,2,49,19,30,52
SK Sturm Gra,4315,2,12,5,7,36,31,5,41
Rapid Vienna,4315,3,7,11,6,34,31,3,32
LASK Linz,4315,4,8,7,9,29,29,0,31
Vienna,4315,5,7,5,12,25,40,-15,26
Mattersburg,4315,6,6,6,12,30,43,-13,24
SC Rheindorf,4315,7,5,7,12,20,30,-10,22
FC Salzburg,4316,1,13,8,3,41,17,24,47
Rapid Vienna,4316,2,10,10,4,43,27,16,40
SK Sturm Gra,4316,3,12,3,9,33,33,0,39
LASK Linz,4316,4,9,6,9,29,31,-2,33
Vienna,4316,5,7,5,12,25,39,-14,26
Mattersburg,4316,6,6,6,12,29,40,-11,24
SC Rheindorf,4316,7,5,6,13,21,34,-13,21
FC Salzburg,4317,1,14,7,3,44,20,24,49
SK Sturm Gra,4317,2,15,3,6,41,27,14,48
Rapid Vienna,4317,3,9,9,6,35,28,7,36
LASK Linz,4317,4,8,5,11,25,31,-6,29
Mattersburg,4317,5,7,7,10,34,41,-7,28
Vienna,4317,6,6,6,12,27,43,-16,24
SC Rheindorf,4317,7,4,5,15,18,34,-16,17
FC Salzburg,4318,1,15,7,2,48,17,31,52
SK Sturm Gra,4318,2,12,4,8,33,31,2,40
Rapid Vienna,4318,3,10,9,5,38,28,10,39
Mattersburg,4318,4,7,7,10,33,40,-7,28
LASK Linz,4318,5,7,5,12,23,32,-9,26
Vienna,4318,6,6,6,12,27,45,-18,24
SC Rheindorf,4318,7,5,6,13,19,28,-9,21
FC Salzburg,4319,1,15,7,2,50,19,31,52
SK Sturm Gra,4319,2,13,4,7,33,27,6,43
Rapid Vienna,4319,3,8,10,6,37,29,8,34
Mattersburg,4319,4,8,5,11,37,42,-5,29
LASK Linz,4319,5,7,6,11,26,32,-6,27
SC Rheindorf,4319,6,6,5,13,19,33,-14,23
Vienna,4319,7,6,5,13,23,43,-20,23
FC Salzburg,4320,1,14,6,4,47,23,24,48
SK Sturm Gra,4320,2,14,3,7,34,29,5,45
Rapid Vienna,4320,3,9,10,5,35,24,11,37
Mattersburg,4320,4,7,7,10,33,40,-7,28
LASK Linz,4320,5,7,6,11,25,30,-5,27
Vienna,4320,6,6,6,12,26,42,-16,24
SC Rheindorf,4320,7,5,6,13,17,29,-12,21
FC Salzburg,4321,1,14,7,3,43,18,25,49
SK Sturm Gra,4321,2,14,3,7,35,29,6,45
Rapid Vienna,4321,3,7,10,7,34,29,5,31
LASK Linz,4321,4,8,7,9,29,30,-1,31
Mattersburg,4321,5,7,6,11,32,41,-9,27
Vienna,4321,6,6,6,12,26,41,-15,24
SC Rheindorf,4321,7,5,7,12,20,31,-11,22
FC Salzburg,4322,1,14,7,3,45,19,26,49
SK Sturm Gra,4322,2,13,4,7,34,31,3,43
Rapid Vienna,4322,3,9,11,4,38,26,12,38
LASK Linz,4322,4,7,6,11,26,31,-5,27
Mattersburg,4322,5,7,6,11,34,42,-8,27
Vienna,4322,6,7,5,12,27,40,-13,26
SC Rheindorf,4322,7,5,5,14,17,32,-15,20
FC Salzburg,4323,1,14,6,4,45,21,24,48
SK Sturm Gra,4323,2,12,4,8,31,30,1,40
Rapid Vienna,4323,3,10,9,5,39,29,10,39
LASK Linz,4323,4,7,8,9,27,29,-2,29
Mattersburg,4323,5,7,6,11,32,39,-7,27
Vienna,4323,6,7,5,12,24,38,-14,26
SC Rheindorf,4323,7,5,6,13,19,31,-12,21
FC Salzburg,4324,1,13,8,3,44,21,23,47
SK Sturm Gra,4324,2,12,5,7,32,27,5,41
Rapid Vienna,4324,3,9,10,5,36,27,9,37
LASK Linz,4324,4,8,6,10,25,28,-3,30
Vienna,4324,5,6,7,11,29,43,-14,25
Mattersburg,4324,6,6,6,12,34,44,-10,24
SC Rheindorf,4324,7,6,6,12,22,32,-10,24
FC Salzburg,4325,1,14,7,3,47,22,25,49
SK Sturm Gra,4325,2,13,5,6,35,27,8,44
LASK Linz,4325,3,9,6,9,30,28,2,33
Rapid Vienna,4325,4,7,10,7,33,34,-1,31
Vienna,4325,5,8,5,11,34,42,-8,29
Mattersburg,4325,6,5,7,12,32,46,-14,22
SC Rheindorf,4325,7,5,6,13,19,31,-12,21
FC Salzburg,4326,1,14,6,4,44,19,25,48
SK Sturm Gra,4326,2,14,3,7,35,29,6,45
LASK Linz,4326,3,10,6,8,32,28,4,36
Rapid Vienna,4326,4,8,10,6,34,27,7,34
Vienna,4326,5,7,5,12,26,41,-15,26
Mattersburg,4326,6,6,5,13,29,42,-13,23
SC Rheindorf,4326,7,4,7,13,19,33,-14,19
FC Salzburg,4327,1,15,6,3,46,18,28,51
SK Sturm Gra,4327,2,13,4,7,34,30,4,43
LASK Linz,4327,3,10,5,9,34,29,5,35
Rapid Vienna,4327,4,8,10,6,35,29,6,34
Vienna,4327,5,7,5,12,26,40,-14,26
Mattersburg,4327,6,5,6,13,31,47,-16,21
SC Rheindorf,4327,7,4,8,12,20,33,-13,20
FC Salzburg,4328,1,15,6,3,49,18,31,51
SK Sturm Gra,4328,2,12,5,7,32,28,4,41
Rapid Vienna,4328,3,9,11,4,37,27,10,38
LASK Linz,4328,4,8,8,8,26,26,0,32
Mattersburg,4328,5,7,6,11,30,41,-11,27
Vienna,4328,6,6,5,13,24,41,-17,23
SC Rheindorf,4328,7,4,5,15,18,35,-17,17
FC Salzburg,4329,1,14,7,3,42,18,24,49
SK Sturm Gra,4329,2,13,4,7,31,25,6,43
Rapid Vienna,4329,3,9,10,5,35,26,9,37
LASK Linz,4329,4,8,6,10,27,28,-1,30
Mattersburg,4329,5,8,5,11,32,40,-8,29
Vienna,4329,6,6,6,12,24,39,-15,24
SC Rheindorf,4329,7,4,6,14,16,31,-15,18
FC Salzburg,4330,1,14,8,2,44,18,26,50
Rapid Vienna,4330,2,9,10,5,37,29,8,37
SK Sturm Gra,4330,3,11,4,9,34,36,-2,37
LASK Linz,4330,4,9,6,9,32,30,2,33
Mattersburg,4330,5,7,6,11,31,39,-8,27
Vienna,4330,6,6,7,11,24,38,-14,25
SC Rheindorf,4330,7,5,5,14,19,31,-12,20
FC Salzburg,4331,1,14,6,4,47,20,27,48
SK Sturm Gra,4331,2,12,4,8,32,33,-1,40
Rapid Vienna,4331,3,10,9,5,41,28,13,39
LASK Linz,4331,4,8,6,10,26,29,-3,30
Vienna,4331,5,7,6,11,25,38,-13,27
SC Rheindorf,4331,6,7,5,12,21,29,-8,26
Mattersburg,4331,7,5,6,13,30,45,-15,21
FC Salzburg,4332,1,16,6,2,50,21,29,54
SK Sturm Gra,4332,2,13,4,7,39,33,6,43
Rapid Vienna,4332,3,8,10,6,38,32,6,34
LASK Linz,4332,4,8,7,9,28,29,-1,31
Vienna,4332,5,7,5,12,25,39,-14,26
Mattersburg,4332,6,6,5,13,31,43,-12,23
SC Rheindorf,4332,7,4,7,13,18,32,-14,19
FC Salzburg,4333,1,14,7,3,41,18,23,49
SK Sturm Gra,4333,2,13,3,8,33,29,4,42
Rapid Vienna,4333,3,9,9,6,35,26,9,36
LASK Linz,4333,4,9,5,10,27,28,-1,32
Mattersburg,4333,5,7,6,11,34,42,-8,27
Vienna,4333,6,6,7,11,26,40,-14,25
SC Rheindorf,4333,7,5,5,14,19,32,-13,20
FC Salzburg,4334,1,13,8,3,45,20,25,47
SK Sturm Gra,4334,2,11,5,8,31,29,2,38
Rapid Vienna,4334,3,9,9,6,34,26,8,36
LASK Linz,4334,4,9,5,10,25,28,-3,32
Mattersburg,4334,5,8,6,10,30,37,-7,30
SC Rheindorf,4334,6,6,6,12,21,28,-7,24
Vienna,4334,7,6,5,13,24,42,-18,23
FC Salzburg,4335,1,15,6,3,46,19,27,51
Rapid Vienna,4335,2,11,9,4,38,24,14,42
SK Sturm Gra,4335,3,12,4,8,33,34,-1,40
Mattersburg,4335,4,8,5,11,32,39,-7,29
LASK Linz,4335,5,7,7,10,26,29,-3,28
Vienna,4335,6,6,5,13,24,41,-17,23
SC Rheindorf,4335,7,4,6,14,15,28,-13,18
FC Salzburg,4336,1,15,7,2,46,17,29,52
SK Sturm Gra,4336,2,12,4,8,34,31,3,40
Rapid Vienna,4336,3,10,9,5,39,28,11,39
LASK Linz,4336,4,8,7,9,28,31,-3,31
Vienna,4336,5,6,6,12,24,40,-16,24
Mattersburg,4336,6,5,8,11,30,41,-11,23
SC Rheindorf,4336,7,5,5,14,19,32,-13,20
FC Salzburg,4337,1,15,6,3,50,21,29,51
SK Sturm Gra,4337,2,12,5,7,33,29,4,41
LASK Linz,4337,3,9,6,9,31,29,2,33
Rapid Vienna,4337,4,7,11,6,35,32,3,32
Mattersburg,4337,5,7,5,12,33,46,-13,26
Vienna,4337,6,7,5,12,27,41,-14,26
SC Rheindorf,4337,7,4,8,12,18,29,-11,20
FC Salzburg,4338,1,15,7,2,49,17,32,52
Rapid Vienna,4338,2,9,11,4,38,27,11,38
SK Sturm Gra,4338,3,11,4,9,31,32,-1,37
LASK Linz,4338,4,8,7,9,26,28,-2,31
Mattersburg,4338,5,8,5,11,34,41,-7,29
Vienna,4338,6,6,5,13,23,41,-18,23
SC Rheindorf,4338,7,5,5,14,18,33,-15,20
FC Salzburg,4339,1,14,7,3,43,18,25,49
SK Sturm Gra,4339,2,12,3,9,29,27,2,39
Rapid Vienna,4339,3,9,10,5,33,24,9,37
LASK Linz,4339,4,9,6,9,25,26,-1,33
Mattersburg,4339,5,8,5,11,33,39,-6,29
Vienna,4339,6,6,6,12,26,41,-15,24
SC Rheindorf,4339,7,5,5,14,16,30,-14,20
FC Salzburg,4340,1,15,6,3,50,19,31,51
SK Sturm Gra,4340,2,13,3,8,36,29,7,42
Rapid Vienna,4340,3,8,9,7,35,33,2,33
LASK Linz,4340,4,8,6,10,26,32,-6,30
Vienna,4340,5,8,5,11,28,38,-10,29
Mattersburg,4340,6,7,5,12,33,44,-11,26
SC Rheindorf,4340,7,5,6,13,16,29,-13,21
FC Salzburg,4341,1,14,6,4,44,20,24,48
SK Sturm Gra,4341,2,13,3,8,33,28,5,42
Rapid Vienna,4341,3,8,9,7,33,27,6,33
LASK Linz,4341,4,8,6,10,25,31,-6,30
Vienna,4341,5,8,5,11,26,38,-12,29
SC Rheindorf,4341,6,7,5,12,23,27,-4,26
Mattersburg,4341,7,6,6,12,29,42,-13,24
FC Salzburg,4342,1,15,6,3,45,18,27,51
SK Sturm Gra,4342,2,15,3,6,36,26,10,48
Rapid Vienna,4342,3,7,11,6,33,30,3,32
LASK Linz,4342,4,7,6,11,26,33,-7,27
Mattersburg,4342,5,7,5,12,30,42,-12,26
Vienna,4342,6,7,5,12,27,40,-13,26
SC Rheindorf,4342,7,5,6,13,19,27,-8,21
FC Salzburg,4343,1,15,6,3,46,20,26,51
SK Sturm Gra,4343,2,13,3,8,33,28,5,42
Rapid Vienna,4343,3,10,9,5,39,30,9,39
LASK Linz,4343,4,9,6,9,31,31,0,33
Vienna,4343,5,7,5,12,27,39,-12,26
SC Rheindorf,4343,6,5,6,13,22,32,-10,21
Mattersburg,4343,7,5,5,14,28,46,-18,20
FC Salzburg,4344,1,16,6,2,54,17,37,54
SK Sturm Gra,4344,2,12,4,8,33,32,1,40
LASK Linz,4344,3,9,7,8,33,30,3,34
Rapid Vienna,4344,4,8,9,7,36,31,5,33
Vienna,4344,5,6,6,12,24,43,-19,24
SC Rheindorf,4344,6,6,5,13,19,30,-11,23
Mattersburg,4344,7,5,7,12,28,44,-16,22
FC Salzburg,4345,1,12,9,3,41,19,22,45
SK Sturm Gra,4345,2,13,4,7,34,27,7,43
Rapid Vienna,4345,3,8,10,6,36,30,6,34
LASK Linz,4345,4,9,5,10,26,28,-2,32
Mattersburg,4345,5,7,6,11,33,42,-9,27
Vienna,4345,6,7,5,12,26,40,-14,26
SC Rheindorf,4345,7,6,5,13,20,30,-10,23
FC Salzburg,4346,1,14,7,3,44,21,23,49
SK Sturm Gra,4346,2,13,4,7,34,26,8,43
Rapid Vienna,4346,3,9,9,6,40,31,9,36
LASK Linz,4346,4,8,5,11,26,29,-3,29
Vienna,4346,5,7,6,11,26,37,-11,27
Mattersburg,4346,6,6,6,12,28,43,-15,24
SC Rheindorf,4346,7,5,7,12,17,28,-11,22
FC Salzburg,4347,1,15,6,3,47,17,30,51
SK Sturm Gra,4347,2,13,3,8,32,32,0,42
LASK Linz,4347,3,10,5,9,34,29,5,35
Rapid Vienna,4347,4,8,9,7,35,30,5,33
Vienna,4347,5,7,5,12,26,42,-16,26
Mattersburg,4347,6,6,6,12,33,45,-12,24
SC Rheindorf,4347,7,5,6,13,20,32,-12,21
FC Salzburg,4348,1,14,7,3,48,19,29,49
SK Sturm Gra,4348,2,13,3,8,36,32,4,42
Rapid Vienna,4348,3,8,9,7,37,35,2,33
LASK Linz,4348,4,9,5,10,27,30,-3,32
Mattersburg,4348,5,7,7,10,35,38,-3,28
SC Rheindorf,4348,6,6,6,12,21,30,-9,24
Vienna,4348,7,6,5,13,23,43,-20,23
FC Salzburg,4349,1,15,7,2,47,17,30,52
SK Sturm Gra,4349,2,12,3,9,32,31,1,39
LASK Linz,4349,3,11,5,8,32,27,5,38
Rapid Vienna,4349,4,8,9,7,34,29,5,33
Mattersburg,4349,5,7,5,12,31,43,-12,26
Vienna,4349,6,6,6,12,24,39,-15,24
SC Rheindorf,4349,7,5,5,14,19,33,-14,20
FC Salzburg,4350,1,14,8,2,44,19,25,50
SK Sturm Gra,4350,2,13,4,7,34,27,7,43
Rapid Vienna,4350,3,8,10,6,34,27,7,34
LASK Linz,4350,4,8,6,10,26,29,-3,30
Vienna,4350,5,7,6,11,27,39,-12,27
SC Rheindorf,4350,6,5,7,12,18,29,-11,22
Mattersburg,4350,7,5,7,12,31,44,-13,22
FC Salzburg,4351,1,13,6,5,40,21,19,45
SK Sturm Gra,4351,2,12,4,8,35,30,5,40
Rapid Vienna,4351,3,9,10,5,36,27,9,37
LASK Linz,4351,4,8,5,11,28,32,-4,29
Mattersburg,4351,5,7,6,11,32,40,-8,27
Vienna,4351,6,7,6,11,27,40,-13,27
SC Rheindorf,4351,7,7,5,12,20,28,-8,26
FC Salzburg,4352,1,13,8,3,43,20,23,47
SK Sturm Gra,4352,2,13,5,6,36,26,10,44
Rapid Vienna,4352,3,7,11,6,32,26,6,32
LASK Linz,4352,4,8,6,10,26,30,-4,30
Vienna,4352,5,8,5,11,27,39,-12,29
SC Rheindorf,4352,6,6,6,12,22,31,-9,24
Mattersburg,4352,7,5,7,12,31,45,-14,22
FC Salzburg,4353,1,14,7,3,41,20,21,49
Rapid Vienna,4353,2,10,9,5,41,27,14,39
SK Sturm Gra,4353,3,12,3,9,33,30,3,39
LASK Linz,4353,4,9,5,10,28,29,-1,32
Mattersburg,4353,5,8,5,11,34,41,-7,29
Vienna,4353,6,6,6,12,25,40,-15,24
SC Rheindorf,4353,7,5,5,14,19,34,-15,20
FC Salzburg,4354,1,14,8,2,44,18,26,50
SK Sturm Gra,4354,2,13,5,6,34,28,6,44
Rapid Vienna,4354,3,9,11,4,39,28,11,38
LASK Linz,4354,4,8,6,10,30,32,-2,30
Vienna,4354,5,7,5,12,24,38,-14,26
Mattersburg,4354,6,6,5,13,28,41,-13,23
SC Rheindorf,4354,7,4,6,14,18,32,-14,18
FC Salzburg,4355,1,15,7,2,52,20,32,52
SK Sturm Gra,4355,2,12,4,8,32,28,4,40
Rapid Vienna,4355,3,8,11,5,34,27,7,35
LASK Linz,4355,4,8,7,9,30,30,0,31
Mattersburg,4355,5,6,7,11,31,43,-12,25
Vienna,4355,6,6,6,12,27,44,-17,24
SC Rheindorf,4355,7,5,6,13,18,32,-14,21
FC Salzburg,4356,1,16,6,2,46,15,31,54
SK Sturm Gra,4356,2,13,4,7,32,27,5,43
Rapid Vienna,4356,3,8,10,6,39,29,10,34
LASK Linz,4356,4,7,7,10,25,29,-4,28
Vienna,4356,5,7,5,12,25,39,-14,26
Mattersburg,4356,6,6,5,13,28,42,-14,23
SC Rheindorf,4356,7,5,7,12,17,31,-14,22
FC Salzburg,4357,1,15,6,3,47,18,29,51
SK Sturm Gra,4357,2,13,3,8,31,29,2,42
Rapid Vienna,4357,3,9,9,6,34,26,8,36
SC Rheindorf,4357,4,7,6,11,19,26,-7,27
Mattersburg,4357,5,7,6,11,29,39,-10,27
LASK Linz,4357,6,7,5,12,24,29,-5,26
Vienna,4357,7,6,5,13,23,40,-17,23
FC Salzburg,4358,1,16,6,2,53,18,35,54
SK Sturm Gra,4358,2,12,4,8,32,35,-3,40
Rapid Vienna,4358,3,8,11,5,37,30,7,35
LASK Linz,4358,4,8,7,9,28,27,1,31
Vienna,4358,5,7,5,12,24,42,-18,26
SC Rheindorf,4358,6,6,6,12,28,31,-3,24
Mattersburg,4358,7,5,5,14,28,47,-19,20
FC Salzburg,4359,1,14,7,3,45,20,25,49
SK Sturm Gra,4359,2,12,3,9,32,31,1,39
Rapid Vienna,4359,3,8,11,5,34,26,8,35
LASK Linz,4359,4,8,6,10,26,29,-3,30
SC Rheindorf,4359,5,7,6,11,18,25,-7,27
Mattersburg,4359,6,6,7,11,30,39,-9,25
Vienna,4359,7,6,6,12,24,39,-15,24
FC Salzburg,4360,1,14,8,2,47,19,28,50
SK Sturm Gra,4360,2,13,4,7,35,29,6,43
Rapid Vienna,4360,3,10,9,5,41,28,13,39
LASK Linz,4360,4,7,5,12,26,34,-8,26
Vienna,4360,5,7,5,12,25,42,-17,26
Mattersburg,4360,6,6,6,12,31,42,-11,24
SC Rheindorf,4360,7,6,5,13,17,28,-11,23
FC Salzburg,4361,1,15,7,2,47,20,27,52
SK Sturm Gra,4361,2,11,4,9,32,33,-1,37
Rapid Vienna,4361,3,8,10,6,35,28,7,34
LASK Linz,4361,4,9,7,8,30,28,2,34
Vienna,4361,5,7,5,12,27,40,-13,26
Mattersburg,4361,6,5,8,11,30,42,-12,23
SC Rheindorf,4361,7,5,7,12,19,29,-10,22
FC Salzburg,4362,1,14,7,3,48,18,30,49
SK Sturm Gra,4362,2,13,3,8,31,30,1,42
Rapid Vienna,4362,3,9,10,5,37,29,8,37
LASK Linz,4362,4,8,6,10,29,30,-1,30
Vienna,4362,5,7,6,11,25,38,-13,27
SC Rheindorf,4362,6,7,5,12,22,29,-7,26
Mattersburg,4362,7,5,5,14,27,45,-18,20
FC Salzburg,4363,1,13,7,4,44,23,21,46
SK Sturm Gra,4363,2,14,3,7,38,30,8,45
Rapid Vienna,4363,3,8,10,6,36,29,7,34
LASK Linz,4363,4,9,6,9,29,29,0,33
Vienna,4363,5,7,6,11,30,39,-9,27
SC Rheindorf,4363,6,5,7,12,19,30,-11,22
Mattersburg,4363,7,5,7,12,28,44,-16,22
FC Salzburg,4364,1,15,6,3,45,19,26,51
SK Sturm Gra,4364,2,12,3,9,32,29,3,39
LASK Linz,4364,3,11,5,8,31,27,4,38
Rapid Vienna,4364,4,9,9,6,35,27,8,36
Vienna,4364,5,8,5,11,27,38,-11,29
SC Rheindorf,4364,6,5,5,14,20,33,-13,20
Mattersburg,4364,7,5,5,14,30,47,-17,20
FC Salzburg,4365,1,14,6,4,43,22,21,48
SK Sturm Gra,4365,2,13,3,8,35,31,4,42
Rapid Vienna,4365,3,9,9,6,38,29,9,36
LASK Linz,4365,4,8,5,11,26,31,-5,29
Vienna,4365,5,8,5,11,27,37,-10,29
Mattersburg,4365,6,6,6,12,33,42,-9,24
SC Rheindorf,4365,7,6,6,12,20,30,-10,24
FC Salzburg,4366,1,15,7,2,48,19,29,52
SK Sturm Gra,4366,2,13,3,8,34,30,4,42
Rapid Vienna,4366,3,7,10,7,33,31,2,31
LASK Linz,4366,4,8,5,11,26,31,-5,29
SC Rheindorf,4366,5,7,6,11,26,28,-2,27
Vienna,4366,6,7,6,11,25,37,-12,27
Mattersburg,4366,7,6,5,13,31,47,-16,23
FC Salzburg,4367,1,14,8,2,45,19,26,50
SK Sturm Gra,4367,2,12,5,7,33,29,4,41
Rapid Vienna,4367,3,9,10,5,39,30,9,37
LASK Linz,4367,4,7,6,11,27,33,-6,27
Mattersburg,4367,5,7,6,11,31,39,-8,27
SC Rheindorf,4367,6,6,6,12,20,29,-9,24
Vienna,4367,7,6,5,13,25,41,-16,23
FC Salzburg,4368,1,15,7,2,49,22,27,52
SK Sturm Gra,4368,2,13,4,7,35,29,6,43
Rapid Vienna,4368,3,9,9,6,38,28,10,36
LASK Linz,4368,4,7,6,11,25,30,-5,27
SC Rheindorf,4368,5,7,5,12,22,32,-10,26
Vienna,4368,6,7,5,12,25,40,-15,26
Mattersburg,4368,7,5,6,13,30,43,-13,21
FC Salzburg,4369,1,14,6,4,41,18,23,48
Rapid Vienna,4369,2,11,9,4,38,24,14,42
SK Sturm Gra,4369,3,12,4,8,30,27,3,40
LASK Linz,4369,4,8,6,10,25,28,-3,30
Mattersburg,4369,5,7,6,11,33,42,-9,27
Vienna,4369,6,6,5,13,24,41,-17,23
SC Rheindorf,4369,7,5,6,13,18,29,-11,21
FC Salzburg,4370,1,15,6,3,45,21,24,51
SK Sturm Gra,4370,2,14,3,7,41,30,11,45
Rapid Vienna,4370,3,9,10,5,41,29,12,37
LASK Linz,4370,4,7,8,9,28,33,-5,29
Vienna,4370,5,7,5,12,27,40,-13,26
Mattersburg,4370,6,5,7,12,30,45,-15,22
SC Rheindorf,4370,7,4,7,13,18,32,-14,19
FC Salzburg,4371,1,14,7,3,50,19,31,49
SK Sturm Gra,4371,2,12,4,8,32,32,0,40
Rapid Vienna,4371,3,8,10,6,38,32,6,34
LASK Linz,4371,4,8,6,10,32,35,-3,30
Mattersburg,4371,5,8,5,11,37,48,-11,29
Vienna,4371,6,7,5,12,27,42,-15,26
SC Rheindorf,4371,7,5,7,12,21,29,-8,22
FC Salzburg,4372,1,15,7,2,48,17,31,52
SK Sturm Gra,4372,2,12,4,8,29,30,-1,40
Rapid Vienna,4372,3,9,11,4,34,24,10,38
Mattersburg,4372,4,7,6,11,36,43,-7,27
LASK Linz,4372,5,7,5,12,27,35,-8,26
SC Rheindorf,4372,6,5,8,11,20,27,-7,23
Vienna,4372,7,6,5,13,25,43,-18,23
FC Salzburg,4373,1,14,6,4,45,21,24,48
SK Sturm Gra,4373,2,13,3,8,38,30,8,42
Rapid Vienna,4373,3,9,10,5,41,30,11,37
Mattersburg,4373,4,8,6,10,32,38,-6,30
LASK Linz,4373,5,7,6,11,27,35,-8,27
Vienna,4373,6,6,6,12,25,43,-18,24
SC Rheindorf,4373,7,5,7,12,20,31,-11,22
FC Salzburg,4374,1,14,8,2,44,17,27,50
SK Sturm Gra,4374,2,12,6,6,35,30,5,42
Rapid Vienna,4374,3,7,12,5,34,27,7,33
LASK Linz,4374,4,7,9,8,29,30,-1,30
Vienna,4374,5,7,6,11,27,40,-13,27
Mattersburg,4374,6,6,6,12,32,45,-13,24
SC Rheindorf,4374,7,4,7,13,16,28,-12,19
FC Salzburg,4375,1,13,7,4,43,24,19,46
Rapid Vienna,4375,2,10,9,5,41,26,15,39
SK Sturm Gra,4375,3,11,4,9,30,31,-1,37
LASK Linz,4375,4,8,8,8,28,28,0,32
Vienna,4375,5,8,5,11,28,38,-10,29
Mattersburg,4375,6,6,7,11,31,41,-10,25
SC Rheindorf,4375,7,5,6,13,20,33,-13,21
FC Salzburg,4376,1,14,7,3,44,21,23,49
Rapid Vienna,4376,2,9,11,4,39,26,13,38
SK Sturm Gra,4376,3,11,4,9,30,34,-4,37
LASK Linz,4376,4,9,6,9,28,27,1,33
Mattersburg,4376,5,7,5,12,33,43,-10,26
Vienna,4376,6,7,5,12,25,40,-15,26
SC Rheindorf,4376,7,5,6,13,21,29,-8,21
FC Salzburg,4377,1,15,7,2,48,17,31,52
Rapid Vienna,4377,2,10,10,4,40,27,13,40
SK Sturm Gra,4377,3,12,4,8,31,30,1,40
LASK Linz,4377,4,7,6,11,25,32,-7,27
Mattersburg,4377,5,7,6,11,33,42,-9,27
Vienna,4377,6,6,6,12,23,38,-15,24
SC Rheindorf,4377,7,4,7,13,18,32,-14,19
FC Salzburg,4378,1,15,7,2,46,17,29,52
SK Sturm Gra,4378,2,12,6,6,35,30,5,42
Rapid Vienna,4378,3,8,11,5,35,29,6,35
LASK Linz,4378,4,7,7,10,25,29,-4,28
SC Rheindorf,4378,5,6,6,12,22,30,-8,24
Vienna,4378,6,6,6,12,26,41,-15,24
Mattersburg,4378,7,5,7,12,30,43,-13,22
FC Salzburg,4379,1,13,8,3,40,17,23,47
SK Sturm Gra,4379,2,12,4,8,30,27,3,40
Rapid Vienna,4379,3,8,11,5,33,25,8,35
LASK Linz,4379,4,8,7,9,25,27,-2,31
Mattersburg,4379,5,7,7,10,34,39,-5,28
Vienna,4379,6,6,6,12,25,42,-17,24
SC Rheindorf,4379,7,6,5,13,19,29,-10,23
FC Salzburg,4380,1,12,8,4,44,23,21,44
SK Sturm Gra,4380,2,13,3,8,37,33,4,42
Rapid Vienna,4380,3,8,12,4,39,30,9,36
LASK Linz,4380,4,8,7,9,30,31,-1,31
Vienna,4380,5,7,6,11,30,43,-13,27
Mattersburg,4380,6,5,9,10,29,39,-10,24
SC Rheindorf,4380,7,5,7,12,21,31,-10,22
FC Salzburg,4381,1,14,7,3,46,21,25,49
SK Sturm Gra,4381,2,13,4,7,32,27,5,43
Rapid Vienna,4381,3,10,10,4,38,25,13,40
LASK Linz,4381,4,8,5,11,26,29,-3,29
Vienna,4381,5,7,5,12,27,42,-15,26
SC Rheindorf,4381,6,6,6,12,22,31,-9,24
Mattersburg,4381,7,5,5,14,32,48,-16,20
FC Salzburg,4382,1,15,6,3,45,18,27,51
SK Sturm Gra,4382,2,12,4,8,30,30,0,40
Rapid Vienna,4382,3,9,10,5,38,28,10,37
LASK Linz,4382,4,8,6,10,28,28,0,30
SC Rheindorf,4382,5,7,6,11,21,27,-6,27
Mattersburg,4382,6,6,5,13,28,43,-15,23
Vienna,4382,7,6,5,13,24,40,-16,23
FC Salzburg,4383,1,13,7,4,44,22,22,46
SK Sturm Gra,4383,2,13,4,7,32,28,4,43
LASK Linz,4383,3,9,6,9,30,30,0,33
Rapid Vienna,4383,4,7,11,6,35,32,3,32
Mattersburg,4383,5,8,6,10,38,41,-3,30
Vienna,4383,6,7,6,11,27,39,-12,27
SC Rheindorf,4383,7,4,6,14,19,33,-14,18
FC Salzburg,4384,1,15,6,3,45,18,27,51
SK Sturm Gra,4384,2,13,4,7,35,29,6,43
LASK Linz,4384,3,10,5,9,27,26,1,35
Rapid Vienna,4384,4,7,11,6,32,26,6,32
Vienna,4384,5,8,5,11,28,38,-10,29
Mattersburg,4384,6,6,5,13,29,43,-14,23
SC Rheindorf,4384,7,4,6,14,18,34,-16,18
FC Salzburg,4385,1,16,6,2,45,15,30,54
SK Sturm Gra,4385,2,12,4,8,32,27,5,40
Rapid Vienna,4385,3,8,10,6,37,30,7,34
LASK Linz,4385,4,8,7,9,28,31,-3,31
Vienna,4385,5,7,5,12,27,41,-14,26
Mattersburg,4385,6,6,6,12,33,45,-12,24
SC Rheindorf,4385,7,5,6,13,17,30,-13,21
FC Salzburg,4386,1,14,7,3,45,19,26,49
SK Sturm Gra,4386,2,13,3,8,35,32,3,42
Rapid Vienna,4386,3,9,10,5,40,30,10,37
LASK Linz,4386,4,7,7,10,27,31,-4,28
Vienna,4386,5,7,6,11,27,39,-12,27
Mattersburg,4386,6,7,5,12,31,42,-11,26
SC Rheindorf,4386,7,5,6,13,19,31,-12,21
FC Salzburg,4387,1,15,7,2,47,18,29,52
SK Sturm Gra,4387,2,13,5,6,33,27,6,44
Rapid Vienna,4387,3,9,10,5,39,30,9,37
LASK Linz,4387,4,7,5,12,24,31,-7,26
Vienna,4387,5,7,5,12,27,38,-11,26
SC Rheindorf,4387,6,6,5,13,19,28,-9,23
Mattersburg,4387,7,6,5,13,28,45,-17,23
FC Salzburg,4388,1,14,8,2,48,19,29,50
SK Sturm Gra,4388,2,12,4,8,35,33,2,40
Rapid Vienna,4388,3,8,10,6,34,28,6,34
LASK Linz,4388,4,9,5,10,27,31,-4,32
Mattersburg,4388,5,6,7,11,31,40,-9,25
Vienna,4388,6,6,7,11,25,39,-14,25
SC Rheindorf,4388,7,5,7,12,20,30,-10,22
FC Salzburg,4389,1,13,7,4,41,19,22,46
SK Sturm Gra,4389,2,13,4,7,31,27,4,43
Rapid Vienna,4389,3,9,11,4,37,24,13,38
LASK Linz,4389,4,8,7,9,26,27,-1,31
Mattersburg,4389,5,7,6,11,29,39,-10,27
Vienna,4389,6,6,6,12,24,39,-15,24
SC Rheindorf,4389,7,4,7,13,17,30,-13,19
FC Salzburg,4390,1,16,6,2,50,19,31,54
SK Sturm Gra,4390,2,12,4,8,31,27,4,40
Rapid Vienna,4390,3,7,11,6,35,30,5,32
LASK Linz,4390,4,7,7,10,26,29,-3,28
SC Rheindorf,4390,5,7,6,11,23,29,-6,27
Vienna,4390,6,7,5,12,25,42,-17,26
Mattersburg,4390,7,6,5,13,30,44,-14,23
FC Salzburg,4391,1,15,7,2,48,16,32,52
SK Sturm Gra,4391,2,13,3,8,34,32,2,42
Rapid Vienna,4391,3,9,11,4,39,25,14,38
LASK Linz,4391,4,8,6,10,27,32,-5,30
Vienna,4391,5,7,5,12,27,41,-14,26
Mattersburg,4391,6,6,5,13,30,46,-16,23
SC Rheindorf,4391,7,5,5,14,20,33,-13,20
FC Salzburg,4392,1,16,6,2,45,16,29,54
SK Sturm Gra,4392,2,11,5,8,28,28,0,38
Rapid Vienna,4392,3,8,10,6,32,25,7,34
LASK Linz,4392,4,7,7,10,24,27,-3,28
SC Rheindorf,4392,5,7,6,11,19,26,-7,27
Vienna,4392,6,7,5,12,25,39,-14,26
Mattersburg,4392,7,6,5,13,29,41,-12,23
FC Salzburg,4393,1,14,6,4,45,18,27,48
SK Sturm Gra,4393,2,13,4,7,34,29,5,43
LASK Linz,4393,3,10,6,8,31,27,4,36
Rapid Vienna,4393,4,8,9,7,34,30,4,33
Vienna,4393,5,6,6,12,26,43,-17,24
SC Rheindorf,4393,6,5,8,11,18,27,-9,23
Mattersburg,4393,7,5,7,12,28,42,-14,22
FC Salzburg,4394,1,14,8,2,46,18,28,50
SK Sturm Gra,4394,2,12,4,8,34,28,6,40
Rapid Vienna,4394,3,9,10,5,34,26,8,37
LASK Linz,4394,4,7,6,11,23,30,-7,27
Mattersburg,4394,5,6,8,10,29,38,-9,26
Vienna,4394,6,6,6,12,24,42,-18,24
SC Rheindorf,4394,7,5,8,11,18,26,-8,23
FC Salzburg,4395,1,15,6,3,44,17,27,51
SK Sturm Gra,4395,2,12,4,8,30,29,1,40
Rapid Vienna,4395,3,8,10,6,35,28,7,34
LASK Linz,4395,4,9,6,9,25,25,0,33
SC Rheindorf,4395,5,7,5,12,21,28,-7,26
Vienna,4395,6,7,5,12,28,42,-14,26
Mattersburg,4395,7,5,6,13,29,43,-14,21
FC Salzburg,4396,1,15,6,3,52,22,30,51
SK Sturm Gra,4396,2,12,4,8,31,32,-1,40
Rapid Vienna,4396,3,9,9,6,40,30,10,36
LASK Linz,4396,4,9,6,9,29,28,1,33
Mattersburg,4396,5,7,6,11,31,42,-11,27
Vienna,4396,6,6,5,13,27,43,-16,23
SC Rheindorf,4396,7,5,6,13,18,31,-13,21
FC Salzburg,4397,1,16,6,2,48,18,30,54
SK Sturm Gra,4397,2,12,4,8,31,28,3,40
Rapid Vienna,4397,3,7,10,7,32,29,3,31
LASK Linz,4397,4,7,8,9,27,29,-2,29
Mattersburg,4397,5,7,6,11,33,42,-9,27
SC Rheindorf,4397,6,6,6,12,19,29,-10,24
Vienna,4397,7,6,6,12,25,40,-15,24
FC Salzburg,4398,1,15,6,3,47,18,29,51
SK Sturm Gra,4398,2,12,4,8,32,30,2,40
Rapid Vienna,4398,3,9,11,4,37,27,10,38
LASK Linz,4398,4,9,6,9,27,27,0,33
Vienna,4398,5,7,5,12,26,41,-15,26
SC Rheindorf,4398,6,6,5,13,22,30,-8,23
Mattersburg,4398,7,5,5,14,30,48,-18,20
FC Salzburg,4399,1,14,8,2,47,18,29,50
SK Sturm Gra,4399,2,12,4,8,32,28,4,40
Rapid Vienna,4399,3,8,12,4,34,25,9,36
LASK Linz,4399,4,7,7,10,24,28,-4,28
Mattersburg,4399,5,7,6,11,30,40,-10,27
SC Rheindorf,4399,6,5,8,11,19,28,-9,23
Vienna,4399,7,6,5,13,24,43,-19,23
FC Salzburg,4400,1,14,8,2,48,19,29,50
SK Sturm Gra,4400,2,12,5,7,33,27,6,41
Rapid Vienna,4400,3,9,11,4,37,26,11,38
LASK Linz,4400,4,9,5,10,28,31,-3,32
Vienna,4400,5,7,5,12,26,41,-15,26
Mattersburg,4400,6,6,5,13,32,46,-14,23
SC Rheindorf,4400,7,5,5,14,17,31,-14,20
FC Salzburg,4401,1,15,7,2,48,16,32,52
SK Sturm Gra,4401,2,13,4,7,33,30,3,43
Rapid Vienna,4401,3,7,11,6,34,29,5,32
LASK Linz,4401,4,8,6,10,28,30,-2,30
Mattersburg,4401,5,7,5,12,31,42,-11,26
Vienna,4401,6,7,5,12,25,41,-16,26
SC Rheindorf,4401,7,4,8,12,20,31,-11,20
FC Salzburg,4402,1,14,7,3,48,21,27,49
SK Sturm Gra,4402,2,11,4,9,31,32,-1,37
Rapid Vienna,4402,3,8,11,5,36,29,7,35
LASK Linz,4402,4,7,9,8,28,29,-1,30
Vienna,4402,5,7,6,11,26,39,-13,27
Mattersburg,4402,6,5,9,10,30,40,-10,24
SC Rheindorf,4402,7,5,8,11,19,28,-9,23
FC Salzburg,4403,1,13,8,3,42,19,23,47
SK Sturm Gra,4403,2,12,5,7,34,29,5,41
Rapid Vienna,4403,3,9,10,5,37,28,9,37
LASK Linz,4403,4,8,7,9,32,31,1,31
Mattersburg,4403,5,8,5,11,37,40,-3,29
Vienna,4403,6,6,6,12,23,39,-16,24
SC Rheindorf,4403,7,5,5,14,16,35,-19,20
FC Salzburg,4404,1,15,7,2,44,17,27,52
SK Sturm Gra,4404,2,13,4,7,32,26,6,43
LASK Linz,4404,3,10,5,9,33,27,6,35
Rapid Vienna,4404,4,7,9,8,32,32,0,30
SC Rheindorf,4404,5,7,5,12,21,28,-7,26
Mattersburg,4404,6,6,5,13,31,46,-15,23
Vienna,4404,7,6,5,13,24,41,-17,23
FC Salzburg,4405,1,13,8,3,46,23,23,47
SK Sturm Gra,4405,2,13,4,7,32,27,5,43
Rapid Vienna,4405,3,9,10,5,38,27,11,37
LASK Linz,4405,4,9,6,9,28,27,1,33
Vienna,4405,5,8,5,11,27,38,-11,29
Mattersburg,4405,6,6,6,12,33,45,-12,24
SC Rheindorf,4405,7,4,5,15,15,32,-17,17
FC Salzburg,4406,1,15,7,2,47,18,29,52
SK Sturm Gra,4406,2,12,4,8,34,31,3,40
Rapid Vienna,4406,3,8,11,5,38,30,8,35
LASK Linz,4406,4,7,6,11,26,33,-7,27
Vienna,4406,5,7,5,12,25,40,-15,26
SC Rheindorf,4406,6,6,7,11,23,30,-7,25
Mattersburg,4406,7,6,6,12,31,42,-11,24
FC Salzburg,4407,1,14,6,4,44,22,22,48
SK Sturm Gra,4407,2,13,3,8,31,29,2,42
Rapid Vienna,4407,3,9,9,6,40,31,9,36
LASK Linz,4407,4,9,6,9,29,30,-1,33
Vienna,4407,5,7,5,12,26,39,-13,26
Mattersburg,4407,6,6,6,12,31,42,-11,24
SC Rheindorf,4407,7,6,5,13,23,31,-8,23
FC Salzburg,4408,1,14,8,2,46,16,30,50
SK Sturm Gra,4408,2,12,5,7,30,27,3,41
LASK Linz,4408,3,9,7,8,28,26,2,34
Rapid Vienna,4408,4,8,9,7,36,34,2,33
Mattersburg,4408,5,7,6,11,31,39,-8,27
Vienna,4408,6,6,5,13,23,39,-16,23
SC Rheindorf,4408,7,5,6,13,19,32,-13,21
FC Salzburg,4409,1,14,6,4,42,20,22,48
Rapid Vienna,4409,2,10,10,4,40,27,13,40
SK Sturm Gra,4409,3,12,4,8,32,29,3,40
LASK Linz,4409,4,7,6,11,25,31,-6,27
Mattersburg,4409,5,7,6,11,31,40,-9,27
Vienna,4409,6,7,6,11,28,40,-12,27
SC Rheindorf,4409,7,5,6,13,19,30,-11,21
FC Salzburg,4410,1,15,6,3,48,17,31,51
SK Sturm Gra,4410,2,13,4,7,32,30,2,43
Rapid Vienna,4410,3,8,10,6,40,31,9,34
LASK Linz,4410,4,9,5,10,28,29,-1,32
Mattersburg,4410,5,7,5,12,32,44,-12,26
Vienna,4410,6,7,5,12,27,42,-15,26
SC Rheindorf,4410,7,5,5,14,19,33,-14,20
FC Salzburg,4411,1,14,7,3,42,18,24,49
SK Sturm Gra,4411,2,12,4,8,30,26,4,40
Rapid Vienna,4411,3,7,10,7,33,29,4,31
Mattersburg,4411,4,8,6,10,31,38,-7,30
LASK Linz,4411,5,7,7,10,24,27,-3,28
SC Rheindorf,4411,6,7,5,12,20,28,-8,26
Vienna,4411,7,7,5,12,25,39,-14,26
FC Salzburg,4412,1,14,8,2,42,17,25,50
SK Sturm Gra,4412,2,13,3,8,32,27,5,42
Rapid Vienna,4412,3,8,10,6,36,28,8,34
LASK Linz,4412,4,9,6,9,31,30,1,33
Mattersburg,4412,5,6,7,11,30,39,-9,25
Vienna,4412,6,6,6,12,25,41,-16,24
SC Rheindorf,4412,7,5,6,13,16,30,-14,21
FC Salzburg,4413,1,14,7,3,47,17,30,49
SK Sturm Gra,4413,2,11,5,8,32,30,2,38
Rapid Vienna,4413,3,9,9,6,35,28,7,36
LASK Linz,4413,4,9,6,9,27,26,1,33
Vienna,4413,5,7,6,11,25,38,-13,27
Mattersburg,4413,6,6,6,12,29,44,-15,24
SC Rheindorf,4413,7,5,7,12,21,33,-12,22
FC Salzburg,4414,1,15,7,2,46,15,31,52
SK Sturm Gra,4414,2,13,4,7,32,27,5,43
LASK Linz,4414,3,9,6,9,30,29,1,33
Rapid Vienna,4414,4,7,9,8,33,30,3,30
Vienna,4414,5,6,7,11,24,38,-14,25
Mattersburg,4414,6,6,6,12,32,44,-12,24
SC Rheindorf,4414,7,5,7,12,18,32,-14,22
FC Salzburg,4415,1,13,7,4,41,21,20,46
SK Sturm Gra,4415,2,12,4,8,31,31,0,40
Rapid Vienna,4415,3,8,11,5,36,30,6,35
LASK Linz,4415,4,7,8,9,25,27,-2,29
SC Rheindorf,4415,5,7,6,11,26,28,-2,27
Mattersburg,4415,6,7,5,12,32,40,-8,26
Vienna,4415,7,7,5,12,27,41,-14,26
FC Salzburg,4416,1,16,6,2,48,17,31,54
SK Sturm Gra,4416,2,12,5,7,31,27,4,41
Rapid Vienna,4416,3,8,11,5,37,27,10,35
LASK Linz,4416,4,7,6,11,23,30,-7,27
SC Rheindorf,4416,5,6,7,11,17,25,-8,25
Mattersburg,4416,6,6,6,12,31,41,-10,24
Vienna,4416,7,6,5,13,24,44,-20,23
FC Salzburg,4417,1,15,6,3,46,16,30,51
SK Sturm Gra,4417,2,12,4,8,33,33,0,40
Rapid Vienna,4417,3,10,9,5,38,26,12,39
LASK Linz,4417,4,9,5,10,32,32,0,32
Vienna,4417,5,7,5,12,24,41,-17,26
Mattersburg,4417,6,6,5,13,30,44,-14,23
SC Rheindorf,4417,7,5,6,13,20,31,-11,21
FC Salzburg,4418,1,15,7,2,51,20,31,52
SK Sturm Gra,4418,2,14,3,7,34,27,7,45
Rapid Vienna,4418,3,8,11,5,34,28,6,35
LASK Linz,4418,4,8,6,10,26,28,-2,30
Vienna,4418,5,7,5,12,32,44,-12,26
Mattersburg,4418,6,7,5,12,30,46,-16,26
SC Rheindorf,4418,7,4,5,15,16,30,-14,17
FC Salzburg,4419,1,15,6,3,45,17,28,51
SK Sturm Gra,4419,2,13,3,8,34,29,5,42
Rapid Vienna,4419,3,8,10,6,36,31,5,34
LASK Linz,4419,4,9,6,9,29,28,1,33
Mattersburg,4419,5,7,5,12,30,42,-12,26
Vienna,4419,6,6,5,13,23,40,-17,23
SC Rheindorf,4419,7,5,7,12,17,27,-10,22
FC Salzburg,4420,1,14,8,2,43,16,27,50
SK Sturm Gra,4420,2,13,4,7,34,28,6,43
Rapid Vienna,4420,3,8,9,7,36,32,4,33
LASK Linz,4420,4,8,6,10,27,29,-2,30
Mattersburg,4420,5,7,5,12,32,43,-11,26
SC Rheindorf,4420,6,6,6,12,21,29,-8,24
Vienna,4420,7,6,6,12,24,40,-16,24
FC Salzburg,4421,1,15,6,3,46,18,28,51
SK Sturm Gra,4421,2,14,3,7,34,28,6,45
LASK Linz,4421,3,10,5,9,28,28,0,35
Rapid Vienna,4421,4,8,9,7,35,29,6,33
Vienna,4421,5,7,5,12,26,40,-14,26
SC Rheindorf,4421,6,6,5,13,19,28,-9,23
Mattersburg,4421,7,5,5,14,30,47,-17,20
FC Salzburg,4422,1,15,7,2,47,20,27,52
SK Sturm Gra,4422,2,11,5,8,30,30,0,38
Rapid Vienna,4422,3,8,10,6,35,28,7,34
LASK Linz,4422,4,8,5,11,28,30,-2,29
Mattersburg,4422,5,6,8,10,33,42,-9,26
SC Rheindorf,4422,6,6,7,11,19,26,-7,25
Vienna,4422,7,6,6,12,24,40,-16,24
FC Salzburg,4423,1,15,7,2,43,16,27,52
SK Sturm Gra,4423,2,13,3,8,32,29,3,42
Rapid Vienna,4423,3,9,10,5,37,28,9,37
LASK Linz,4423,4,9,5,10,29,30,-1,32
SC Rheindorf,4423,5,6,5,13,20,30,-10,23
Mattersburg,4423,6,6,5,13,31,43,-12,23
Vienna,4423,7,6,5,13,25,41,-16,23
FC Salzburg,4424,1,14,7,3,45,18,27,49
SK Sturm Gra,4424,2,13,4,7,32,28,4,43
Rapid Vienna,4424,3,9,10,5,37,26,11,37
LASK Linz,4424,4,8,6,10,26,28,-2,30
SC Rheindorf,4424,5,7,5,12,22,28,-6,26
Vienna,4424,6,7,5,12,24,39,-15,26
Mattersburg,4424,7,5,5,14,26,45,-19,20
FC Salzburg,4425,1,15,7,2,48,20,28,52
Rapid Vienna,4425,2,9,11,4,36,26,10,38
SK Sturm Gra,4425,3,11,4,9,31,33,-2,37
LASK Linz,4425,4,9,7,8,28,27,1,34
Vienna,4425,5,7,5,12,24,39,-15,26
Mattersburg,4425,6,6,5,13,30,42,-12,23
SC Rheindorf,4425,7,5,5,14,21,31,-10,20
FC Salzburg,4426,1,12,8,4,41,22,19,44
SK Sturm Gra,4426,2,13,4,7,32,26,6,43
Rapid Vienna,4426,3,11,9,4,39,25,14,42
LASK Linz,4426,4,8,6,10,27,29,-2,30
Mattersburg,4426,5,6,6,12,34,45,-11,24
Vienna,4426,6,6,6,12,26,42,-16,24
SC Rheindorf,4426,7,5,7,12,19,29,-10,22
FC Salzburg,4427,1,14,7,3,46,20,26,49
SK Sturm Gra,4427,2,13,3,8,35,32,3,42
Rapid Vienna,4427,3,9,10,5,37,29,8,37
LASK Linz,4427,4,9,6,9,30,27,3,33
Vienna,4427,5,7,6,11,28,41,-13,27
Mattersburg,4427,6,7,5,12,31,40,-9,26
SC Rheindorf,4427,7,4,5,15,16,34,-18,17
FC Salzburg,4428,1,13,8,3,41,18,23,47
SK Sturm Gra,4428,2,13,4,7,33,28,5,43
Rapid Vienna,4428,3,8,11,5,36,32,4,35
LASK Linz,4428,4,8,5,11,30,30,0,29
Mattersburg,4428,5,7,7,10,32,39,-7,28
Vienna,4428,6,6,6,12,24,39,-15,24
SC Rheindorf,4428,7,5,7,12,21,31,-10,22
FC Salzburg,4429,1,15,6,3,44,18,26,51
SK Sturm Gra,4429,2,12,4,8,31,29,2,40
Rapid Vienna,4429,3,8,9,7,35,30,5,33
LASK Linz,4429,4,8,7,9,27,27,0,31
Mattersburg,4429,5,8,5,11,36,42,-6,29
Vienna,4429,6,7,5,12,27,40,-13,26
SC Rheindorf,4429,7,5,6,13,18,32,-14,21
FC Salzburg,4430,1,14,7,3,44,19,25,49
SK Sturm Gra,4430,2,12,4,8,29,28,1,40
Rapid Vienna,4430,3,9,11,4,35,23,12,38
LASK Linz,4430,4,8,7,9,27,28,-1,31
Vienna,4430,5,7,6,11,29,40,-11,27
Mattersburg,4430,6,6,5,13,33,45,-12,23
SC Rheindorf,4430,7,5,6,13,18,32,-14,21
FC Salzburg,4431,1,14,8,2,47,15,32,50
SK Sturm Gra,4431,2,12,3,9,31,35,-4,39
Rapid Vienna,4431,3,8,11,5,37,26,11,35
LASK Linz,4431,4,7,6,11,26,32,-6,27
Vienna,4431,5,7,6,11,24,37,-13,27
SC Rheindorf,4431,6,7,5,12,24,29,-5,26
Mattersburg,4431,7,7,5,12,29,44,-15,26
FC Salzburg,4432,1,16,6,2,50,18,32,54
Rapid Vienna,4432,2,10,9,5,38,27,11,39
SK Sturm Gra,4432,3,12,3,9,30,29,1,39
LASK Linz,4432,4,9,6,9,28,28,0,33
Mattersburg,4432,5,6,7,11,31,42,-11,25
Vienna,4432,6,6,5,13,25,44,-19,23
SC Rheindorf,4432,7,4,6,14,16,30,-14,18
FC Salzburg,4433,1,14,7,3,47,22,25,49
SK Sturm Gra,4433,2,13,3,8,34,32,2,42
Rapid Vienna,4433,3,10,10,4,39,26,13,40
LASK Linz,4433,4,7,6,11,25,30,-5,27
SC Rheindorf,4433,5,7,5,12,23,29,-6,26
Vienna,4433,6,7,5,12,25,40,-15,26
Mattersburg,4433,7,5,6,13,30,44,-14,21
FC Salzburg,4434,1,15,6,3,44,18,26,51
Rapid Vienna,4434,2,10,9,5,41,30,11,39
SK Sturm Gra,4434,3,11,4,9,32,33,-1,37
LASK Linz,4434,4,9,6,9,29,28,1,33
Mattersburg,4434,5,6,6,12,27,41,-14,24
Vienna,4434,6,6,6,12,25,41,-16,24
SC Rheindorf,4434,7,6,5,13,23,30,-7,23
FC Salzburg,4435,1,12,8,4,40,19,21,44
SK Sturm Gra,4435,2,13,4,7,32,28,4,43
Rapid Vienna,4435,3,8,9,7,33,30,3,33
LASK Linz,4435,4,9,6,9,30,27,3,33
Vienna,4435,5,7,6,11,27,40,-13,27
SC Rheindorf,4435,6,6,6,12,21,29,-8,24
Mattersburg,4435,7,5,9,10,32,42,-10,24
FC Salzburg,4436,1,14,7,3,45,21,24,49
SK Sturm Gra,4436,2,13,4,7,39,32,7,43
Rapid Vienna,4436,3,8,10,6,38,33,5,34
LASK Linz,4436,4,9,6,9,32,32,0,33
Mattersburg,4436,5,6,6,12,35,46,-11,24
Vienna,4436,6,6,6,12,26,41,-15,24
SC Rheindorf,4436,7,5,7,12,23,33,-10,22
FC Salzburg,4437,1,13,7,4,46,22,24,46
SK Sturm Gra,4437,2,12,4,8,30,28,2,40
Rapid Vienna,4437,3,10,9,5,38,27,11,39
LASK Linz,4437,4,9,6,9,29,29,0,33
Vienna,4437,5,8,5,11,28,39,-11,29
SC Rheindorf,4437,6,6,5,13,23,31,-8,23
Mattersburg,4437,7,5,6,13,28,46,-18,21
FC Salzburg,4438,1,14,7,3,42,16,26,49
SK Sturm Gra,4438,2,12,4,8,31,28,3,40
Rapid Vienna,4438,3,9,10,5,36,28,8,37
LASK Linz,4438,4,9,7,8,28,26,2,34
Mattersburg,4438,5,7,7,10,29,37,-8,28
Vienna,4438,6,6,5,13,23,40,-17,23
SC Rheindorf,4438,7,4,6,14,16,30,-14,18
FC Salzburg,4439,1,15,6,3,46,19,27,51
SK Sturm Gra,4439,2,12,5,7,32,29,3,41
Rapid Vienna,4439,3,8,10,6,36,29,7,34
LASK Linz,4439,4,8,6,10,25,29,-4,30
Mattersburg,4439,5,7,7,10,34,41,-7,28
Vienna,4439,6,6,5,13,23,41,-18,23
SC Rheindorf,4439,7,5,7,12,22,30,-8,22
FC Salzburg,4440,1,15,6,3,43,18,25,51
SK Sturm Gra,4440,2,13,4,7,32,25,7,43
Rapid Vienna,4440,3,9,10,5,37,27,10,37
LASK Linz,4440,4,8,7,9,29,28,1,31
Mattersburg,4440,5,6,6,12,28,44,-16,24
Vienna,4440,6,6,5,13,24,40,-16,23
SC Rheindorf,4440,7,4,8,12,16,27,-11,20
FC Salzburg,4441,1,15,6,3,43,18,25,51
SK Sturm Gra,4441,2,13,4,7,32,25,7,43
LASK Linz,4441,3,10,5,9,28,25,3,35
Rapid Vienna,4441,4,7,10,7,31,27,4,31
Vienna,4441,5,7,5,12,27,40,-13,26
Mattersburg,4441,6,6,6,12,27,40,-13,24
SC Rheindorf,4441,7,5,6,13,16,29,-13,21
FC Salzburg,4442,1,14,8,2,51,23,28,50
SK Sturm Gra,4442,2,12,4,8,34,31,3,40
Rapid Vienna,4442,3,9,10,5,39,29,10,37
LASK Linz,4442,4,9,6,9,28,29,-1,33
Vienna,4442,5,7,6,11,28,40,-12,27
Mattersburg,4442,6,5,6,13,29,43,-14,21
SC Rheindorf,4442,7,5,6,13,18,32,-14,21
FC Salzburg,4443,1,15,7,2,45,18,27,52
SK Sturm Gra,4443,2,12,5,7,34,30,4,41
Rapid Vienna,4443,3,8,11,5,34,27,7,35
LASK Linz,4443,4,8,6,10,30,31,-1,30
Mattersburg,4443,5,8,5,11,32,38,-6,29
Vienna,4443,6,6,5,13,26,42,-16,23
SC Rheindorf,4443,7,4,7,13,19,34,-15,19
FC Salzburg,4444,1,15,7,2,45,17,28,52
Rapid Vienna,4444,2,10,9,5,36,25,11,39
SK Sturm Gra,4444,3,11,4,9,30,31,-1,37
LASK Linz,4444,4,8,5,11,27,32,-5,29
Mattersburg,4444,5,7,6,11,33,41,-8,27
Vienna,4444,6,6,6,12,26,42,-16,24
SC Rheindorf,4444,7,6,5,13,19,28,-9,23
FC Salzburg,4445,1,14,7,3,46,19,27,49
SK Sturm Gra,4445,2,12,6,6,32,27,5,42
Rapid Vienna,4445,3,8,12,4,34,25,9,36
LASK Linz,4445,4,7,7,10,26,30,-4,28
Vienna,4445,5,7,5,12,27,41,-14,26
SC Rheindorf,4445,6,6,7,11,21,28,-7,25
Mattersburg,4445,7,5,6,13,28,44,-16,21
FC Salzburg,4446,1,15,7,2,49,18,31,52
SK Sturm Gra,4446,2,13,4,7,37,28,9,43
Rapid Vienna,4446,3,7,11,6,32,31,1,32
LASK Linz,4446,4,7,7,10,26,29,-3,28
Vienna,4446,5,7,6,11,25,38,-13,27
Mattersburg,4446,6,7,5,12,31,45,-14,26
SC Rheindorf,4446,7,4,8,12,17,28,-11,20
FC Salzburg,4447,1,15,6,3,47,18,29,51
SK Sturm Gra,4447,2,12,5,7,32,31,1,41
Rapid Vienna,4447,3,7,10,7,34,30,4,31
LASK Linz,4447,4,8,6,10,25,29,-4,30
Vienna,4447,5,8,5,11,28,39,-11,29
Mattersburg,4447,6,6,6,12,30,41,-11,24
SC Rheindorf,4447,7,5,8,11,19,27,-8,23
FC Salzburg,4448,1,15,6,3,46,19,27,51
SK Sturm Gra,4448,2,14,4,6,34,27,7,46
LASK Linz,4448,3,9,7,8,29,28,1,34
Rapid Vienna,4448,4,7,9,8,36,33,3,30
Vienna,4448,5,7,5,12,25,40,-15,26
SC Rheindorf,4448,6,5,7,12,20,30,-10,22
Mattersburg,4448,7,5,6,13,30,43,-13,21
FC Salzburg,4449,1,15,6,3,47,22,25,51
SK Sturm Gra,4449,2,14,3,7,37,29,8,45
LASK Linz,4449,3,9,5,10,28,29,-1,32
Rapid Vienna,4449,4,7,9,8,32,31,1,30
Mattersburg,4449,5,7,6,11,32,41,-9,27
SC Rheindorf,4449,6,6,6,12,20,27,-7,24
Vienna,4449,7,6,5,13,25,42,-17,23
FC Salzburg,4450,1,15,6,3,50,18,32,51
Rapid Vienna,4450,2,9,10,5,36,27,9,37
SK Sturm Gra,4450,3,11,4,9,30,30,0,37
LASK Linz,4450,4,9,6,9,27,28,-1,33
Mattersburg,4450,5,6,7,11,31,47,-16,25
SC Rheindorf,4450,6,5,8,11,20,28,-8,23
Vienna,4450,7,6,5,13,23,39,-16,23
FC Salzburg,4451,1,15,7,2,47,16,31,52
SK Sturm Gra,4451,2,13,3,8,32,27,5,42
Rapid Vienna,4451,3,8,10,6,34,29,5,34
LASK Linz,4451,4,8,7,9,26,27,-1,31
Vienna,4451,5,7,5,12,26,42,-16,26
Mattersburg,4451,6,6,6,12,30,42,-12,24
SC Rheindorf,4451,7,5,6,13,19,31,-12,21
FC Salzburg,4452,1,15,7,2,47,21,26,52
SK Sturm Gra,4452,2,12,4,8,32,29,3,40
Rapid Vienna,4452,3,8,11,5,36,28,8,35
LASK Linz,4452,4,7,6,11,27,31,-4,27
Vienna,4452,5,7,6,11,28,40,-12,27
SC Rheindorf,4452,6,6,6,12,20,29,-9,24
Mattersburg,4452,7,6,6,12,30,42,-12,24
FC Salzburg,4453,1,15,7,2,46,16,30,52
SK Sturm Gra,4453,2,11,4,9,30,30,0,37
Rapid Vienna,4453,3,8,11,5,34,26,8,35
LASK Linz,4453,4,9,6,9,31,33,-2,33
Mattersburg,4453,5,8,5,11,35,40,-5,29
Vienna,4453,6,6,5,13,24,44,-20,23
SC Rheindorf,4453,7,4,8,12,20,31,-11,20
FC Salzburg,4454,1,14,7,3,45,18,27,49
SK Sturm Gra,4454,2,11,4,9,28,30,-2,37
Rapid Vienna,4454,3,8,12,4,34,25,9,36
LASK Linz,4454,4,8,6,10,26,28,-2,30
SC Rheindorf,4454,5,7,6,11,19,25,-6,27
Mattersburg,4454,6,7,6,11,32,39,-7,27
Vienna,4454,7,6,5,13,23,42,-19,23
FC Salzburg,4455,1,15,7,2,46,15,31,52
Rapid Vienna,4455,2,10,10,4,39,24,15,40
SK Sturm Gra,4455,3,11,3,10,29,30,-1,36
LASK Linz,4455,4,9,5,10,27,30,-3,32
SC Rheindorf,4455,5,7,5,12,22,31,-9,26
Mattersburg,4455,6,6,5,13,30,46,-16,23
Vienna,4455,7,6,5,13,24,41,-17,23
FC Salzburg,4456,1,14,7,3,43,20,23,49
SK Sturm Gra,4456,2,12,4,8,31,28,3,40
Rapid Vienna,4456,3,10,9,5,38,27,11,39
LASK Linz,4456,4,9,6,9,25,26,-1,33
Mattersburg,4456,5,6,6,12,32,42,-10,24
Vienna,4456,6,6,5,13,24,41,-17,23
SC Rheindorf,4456,7,5,7,12,21,30,-9,22
FC Salzburg,4457,1,15,7,2,48,19,29,52
SK Sturm Gra,4457,2,12,3,9,31,28,3,39
LASK Linz,4457,3,10,6,8,31,29,2,36
Rapid Vienna,4457,4,8,11,5,35,27,8,35
Vienna,4457,5,6,6,12,27,44,-17,24
SC Rheindorf,4457,6,6,5,13,20,31,-11,23
Mattersburg,4457,7,5,6,13,31,45,-14,21
FC Salzburg,4458,1,16,6,2,43,15,28,54
SK Sturm Gra,4458,2,13,4,7,31,26,5,43
Rapid Vienna,4458,3,7,10,7,32,28,4,31
LASK Linz,4458,4,7,8,9,28,30,-2,29
Vienna,4458,5,7,5,12,25,39,-14,26
SC Rheindorf,4458,6,6,6,12,18,27,-9,24
Mattersburg,4458,7,5,7,12,29,41,-12,22
FC Salzburg,4459,1,14,7,3,45,18,27,49
SK Sturm Gra,4459,2,13,5,6,35,27,8,44
Rapid Vienna,4459,3,8,11,5,34,28,6,35
LASK Linz,4459,4,7,7,10,26,30,-4,28
Vienna,4459,5,7,5,12,26,40,-14,26
Mattersburg,4459,6,6,6,12,29,43,-14,24
SC Rheindorf,4459,7,5,7,12,19,28,-9,22
FC Salzburg,4460,1,15,7,2,49,18,31,52
SK Sturm Gra,4460,2,11,5,8,30,29,1,38
Rapid Vienna,4460,3,9,10,5,38,29,9,37
LASK Linz,4460,4,9,5,10,28,29,-1,32
Vienna,4460,5,7,5,12,24,40,-16,26
Mattersburg,4460,6,6,6,12,30,42,-12,24
SC Rheindorf,4460,7,5,6,13,18,30,-12,21
FC Salzburg,4461,1,14,8,2,45,19,26,50
SK Sturm Gra,4461,2,13,3,8,30,27,3,42
Rapid Vienna,4461,3,8,11,5,34,26,8,35
Mattersburg,4461,4,7,7,10,35,42,-7,28
LASK Linz,4461,5,7,6,11,25,30,-5,27
SC Rheindorf,4461,6,6,6,12,20,29,-9,24
Vienna,4461,7,6,5,13,26,42,-16,23
FC Salzburg,4462,1,15,6,3,45,17,28,51
SK Sturm Gra,4462,2,14,4,6,35,27,8,46
Rapid Vienna,4462,3,8,10,6,34,29,5,34
Mattersburg,4462,4,8,5,11,34,40,-6,29
LASK Linz,4462,5,7,6,11,25,31,-6,27
Vienna,4462,6,6,5,13,24,41,-17,23
SC Rheindorf,4462,7,4,8,12,17,29,-12,20
FC Salzburg,4463,1,15,6,3,50,18,32,51
SK Sturm Gra,4463,2,13,4,7,35,29,6,43
LASK Linz,4463,3,8,8,8,29,29,0,32
Rapid Vienna,4463,4,7,9,8,36,34,2,30
Mattersburg,4463,5,7,6,11,35,45,-10,27
SC Rheindorf,4463,6,6,6,12,19,30,-11,24
Vienna,4463,7,6,5,13,23,42,-19,23
FC Salzburg,4464,1,15,7,2,51,21,30,52
SK Sturm Gra,4464,2,13,4,7,33,30,3,43
Rapid Vienna,4464,3,8,10,6,35,28,7,34
LASK Linz,4464,4,8,5,11,28,32,-4,29
Mattersburg,4464,5,7,5,12,34,44,-10,26
Vienna,4464,6,7,5,12,28,42,-14,26
SC Rheindorf,4464,7,5,6,13,19,31,-12,21
FC Salzburg,4465,1,14,6,4,45,24,21,48
SK Sturm Gra,4465,2,11,6,7,33,30,3,39
Rapid Vienna,4465,3,9,11,4,36,24,12,38
LASK Linz,4465,4,8,7,9,31,30,1,31
Vienna,4465,5,8,5,11,30,40,-10,29
Mattersburg,4465,6,6,5,13,34,48,-14,23
SC Rheindorf,4465,7,5,6,13,19,32,-13,21
FC Salzburg,4466,1,14,7,3,47,20,27,49
SK Sturm Gra,4466,2,12,5,7,33,30,3,41
Rapid Vienna,4466,3,8,10,6,36,30,6,34
LASK Linz,4466,4,9,5,10,29,29,0,32
SC Rheindorf,4466,5,7,5,12,23,29,-6,26
Mattersburg,4466,6,7,5,12,30,43,-13,26
Vienna,4466,7,6,5,13,25,42,-17,23
FC Salzburg,4467,1,15,7,2,46,17,29,52
SK Sturm Gra,4467,2,11,6,7,31,28,3,39
Rapid Vienna,4467,3,9,10,5,34,25,9,37
LASK Linz,4467,4,7,7,10,26,30,-4,28
Mattersburg,4467,5,6,7,11,34,43,-9,25
Vienna,4467,6,6,6,12,24,41,-17,24
SC Rheindorf,4467,7,5,7,12,19,30,-11,22
FC Salzburg,4468,1,14,7,3,43,19,24,49
SK Sturm Gra,4468,2,13,4,7,36,27,9,43
Rapid Vienna,4468,3,10,9,5,37,27,10,39
LASK Linz,4468,4,8,6,10,27,30,-3,30
Vienna,4468,5,6,7,11,25,39,-14,25
SC Rheindorf,4468,6,6,5,13,20,31,-11,23
Mattersburg,4468,7,5,6,13,28,43,-15,21
FC Salzburg,4469,1,13,7,4,43,23,20,46
Rapid Vienna,4469,2,9,11,4,38,26,12,38
SK Sturm Gra,4469,3,11,5,8,30,28,2,38
Vienna,4469,4,8,5,11,30,40,-10,29
LASK Linz,4469,5,7,7,10,26,29,-3,28
Mattersburg,4469,6,6,7,11,34,45,-11,25
SC Rheindorf,4469,7,6,6,12,21,31,-10,24
FC Salzburg,4470,1,16,6,2,45,16,29,54
SK Sturm Gra,4470,2,11,5,8,31,29,2,38
Rapid Vienna,4470,3,9,10,5,36,27,9,37
LASK Linz,4470,4,8,7,9,29,30,-1,31
Vienna,4470,5,7,5,12,26,40,-14,26
Mattersburg,4470,6,6,6,12,30,41,-11,24
SC Rheindorf,4470,7,5,5,14,18,32,-14,20
FC Salzburg,4471,1,15,7,2,47,19,28,52
SK Sturm Gra,4471,2,12,3,9,33,34,-1,39
Rapid Vienna,4471,3,8,10,6,37,31,6,34
LASK Linz,4471,4,8,6,10,29,31,-2,30
SC Rheindorf,4471,5,7,5,12,24,31,-7,26
Vienna,4471,6,6,7,11,28,42,-14,25
Mattersburg,4471,7,6,6,12,35,45,-10,24
FC Salzburg,4472,1,14,6,4,48,20,28,48
Rapid Vienna,4472,2,11,9,4,41,27,14,42
SK Sturm Gra,4472,3,12,3,9,34,33,1,39
LASK Linz,4472,4,9,5,10,31,33,-2,32
Mattersburg,4472,5,7,6,11,33,47,-14,27
Vienna,4472,6,6,6,12,26,41,-15,24
SC Rheindorf,4472,7,5,5,14,22,34,-12,20
FC Salzburg,4473,1,14,8,2,45,17,28,50
SK Sturm Gra,4473,2,12,5,7,33,28,5,41
Rapid Vienna,4473,3,8,12,4,34,25,9,36
LASK Linz,4473,4,7,7,10,28,32,-4,28
Mattersburg,4473,5,7,5,12,30,44,-14,26
Vienna,4473,6,6,6,12,25,41,-16,24
SC Rheindorf,4473,7,5,7,12,21,29,-8,22
FC Salzburg,4474,1,15,6,3,45,17,28,51
Rapid Vienna,4474,2,11,9,4,37,24,13,42
SK Sturm Gra,4474,3,12,3,9,29,29,0,39
LASK Linz,4474,4,7,6,11,25,29,-4,27
Mattersburg,4474,5,7,5,12,29,39,-10,26
SC Rheindorf,4474,6,6,6,12,19,29,-10,24
Vienna,4474,7,6,5,13,24,41,-17,23
FC Salzburg,4475,1,15,7,2,47,17,30,52
SK Sturm Gra,4475,2,13,3,8,33,31,2,42
Rapid Vienna,4475,3,9,11,4,38,27,11,38
Mattersburg,4475,4,8,5,11,36,43,-7,29
LASK Linz,4475,5,7,7,10,27,31,-4,28
Vienna,4475,6,6,5,13,26,43,-17,23
SC Rheindorf,4475,7,4,6,14,20,35,-15,18
FC Salzburg,4476,1,14,7,3,50,23,27,49
SK Sturm Gra,4476,2,12,4,8,30,27,3,40
Rapid Vienna,4476,3,8,12,4,36,26,10,36
Mattersburg,4476,4,7,6,11,34,45,-11,27
Vienna,4476,5,7,6,11,28,40,-12,27
LASK Linz,4476,6,7,5,12,24,34,-10,26
SC Rheindorf,4476,7,6,6,12,22,29,-7,24
FC Salzburg,4477,1,15,7,2,46,16,30,52
SK Sturm Gra,4477,2,13,4,7,30,29,1,43
Rapid Vienna,4477,3,8,9,7,34,28,6,33
LASK Linz,4477,4,9,6,9,28,29,-1,33
Vienna,4477,5,6,7,11,25,39,-14,25
SC Rheindorf,4477,6,6,5,13,20,29,-9,23
Mattersburg,4477,7,5,6,13,29,42,-13,21
FC Salzburg,4478,1,16,6,2,49,18,31,54
SK Sturm Gra,4478,2,13,4,7,32,31,1,43
Rapid Vienna,4478,3,9,9,6,36,27,9,36
LASK Linz,4478,4,7,5,12,26,34,-8,26
Mattersburg,4478,5,7,5,12,32,43,-11,26
Vienna,4478,6,7,5,12,26,38,-12,26
SC Rheindorf,4478,7,5,6,13,19,29,-10,21
FC Salzburg,4479,1,14,7,3,45,19,26,49
SK Sturm Gra,4479,2,14,4,6,35,26,9,46
Rapid Vienna,4479,3,10,9,5,39,27,12,39
LASK Linz,4479,4,7,6,11,25,31,-6,27
Vienna,4479,5,7,5,12,27,40,-13,26
Mattersburg,4479,6,5,7,12,29,44,-15,22
SC Rheindorf,4479,7,5,6,13,19,32,-13,21
FC Salzburg,4480,1,14,6,4,43,20,23,48
Rapid Vienna,4480,2,10,10,4,37,24,13,40
SK Sturm Gra,4480,3,11,3,10,31,31,0,36
LASK Linz,4480,4,9,7,8,28,27,1,34
Vienna,4480,5,7,5,12,24,38,-14,26
Mattersburg,4480,6,6,6,12,28,40,-12,24
SC Rheindorf,4480,7,6,5,13,21,32,-11,23
FC Salzburg,4481,1,14,7,3,43,18,25,49
SK Sturm Gra,4481,2,15,3,6,36,26,10,48
Rapid Vienna,4481,3,8,10,6,37,30,7,34
LASK Linz,4481,4,7,6,11,29,33,-4,27
Mattersburg,4481,5,6,7,11,29,40,-11,25
Vienna,4481,6,6,6,12,25,40,-15,24
SC Rheindorf,4481,7,5,7,12,19,31,-12,22
FC Salzburg,4482,1,14,6,4,46,20,26,48
SK Sturm Gra,4482,2,13,4,7,33,27,6,43
Rapid Vienna,4482,3,9,9,6,36,30,6,36
LASK Linz,4482,4,8,7,9,28,30,-2,31
Vienna,4482,5,7,5,12,26,40,-14,26
Mattersburg,4482,6,6,6,12,31,44,-13,24
SC Rheindorf,4482,7,5,7,12,24,33,-9,22
FC Salzburg,4483,1,13,8,3,46,21,25,47
SK Sturm Gra,4483,2,13,4,7,32,27,5,43
Rapid Vienna,4483,3,8,11,5,38,30,8,35
LASK Linz,4483,4,9,5,10,28,30,-2,32
Vienna,4483,5,8,5,11,28,40,-12,29
SC Rheindorf,4483,6,6,6,12,22,29,-7,24
Mattersburg,4483,7,5,5,14,30,47,-17,20
FC Salzburg,4484,1,16,6,2,52,19,33,54
SK Sturm Gra,4484,2,13,4,7,35,33,2,43
Rapid Vienna,4484,3,7,10,7,34,31,3,31
LASK Linz,4484,4,8,5,11,27,31,-4,29
Mattersburg,4484,5,7,6,11,35,44,-9,27
SC Rheindorf,4484,6,5,8,11,23,30,-7,23
Vienna,4484,7,6,5,13,26,44,-18,23
FC Salzburg,4485,1,12,6,6,38,21,17,42
Rapid Vienna,4485,2,11,9,4,37,24,13,42
SK Sturm Gra,4485,3,12,4,8,32,29,3,40
LASK Linz,4485,4,9,6,9,28,27,1,33
Vienna,4485,5,8,5,11,25,37,-12,29
Mattersburg,4485,6,7,5,12,29,38,-9,26
SC Rheindorf,4485,7,4,7,13,16,29,-13,19
FC Salzburg,4486,1,14,8,2,48,17,31,50
Rapid Vienna,4486,2,10,9,5,37,27,10,39
SK Sturm Gra,4486,3,11,6,7,30,27,3,39
LASK Linz,4486,4,7,7,10,26,29,-3,28
Mattersburg,4486,5,7,6,11,30,44,-14,27
Vienna,4486,6,6,7,11,24,38,-14,25
SC Rheindorf,4486,7,4,7,13,17,30,-13,19
FC Salzburg,4487,1,15,6,3,51,20,31,51
SK Sturm Gra,4487,2,13,4,7,34,29,5,43
Rapid Vienna,4487,3,9,10,5,36,27,9,37
LASK Linz,4487,4,7,7,10,26,30,-4,28
Vienna,4487,5,7,5,12,25,41,-16,26
Mattersburg,4487,6,6,5,13,31,46,-15,23
SC Rheindorf,4487,7,5,7,12,17,27,-10,22
FC Salzburg,4488,1,14,6,4,46,20,26,48
SK Sturm Gra,4488,2,15,3,6,34,26,8,48
Rapid Vienna,4488,3,9,9,6,37,27,10,36
LASK Linz,4488,4,7,6,11,25,31,-6,27
Mattersburg,4488,5,7,5,12,31,44,-13,26
Vienna,4488,6,7,5,12,26,40,-14,26
SC Rheindorf,4488,7,5,6,13,18,29,-11,21
FC Salzburg,4489,1,14,8,2,49,18,31,50
SK Sturm Gra,4489,2,11,5,8,30,30,0,38
LASK Linz,4489,3,9,5,10,29,28,1,32
Rapid Vienna,4489,4,7,10,7,32,32,0,31
Mattersburg,4489,5,7,6,11,31,44,-13,27
SC Rheindorf,4489,6,7,5,12,23,28,-5,26
Vienna,4489,7,6,7,11,25,39,-14,25
FC Salzburg,4490,1,13,8,3,40,17,23,47
SK Sturm Gra,4490,2,11,5,8,30,29,1,38
Rapid Vienna,4490,3,8,10,6,36,30,6,34
LASK Linz,4490,4,8,7,9,27,27,0,31
Mattersburg,4490,5,8,6,10,33,39,-6,30
SC Rheindorf,4490,6,6,6,12,20,29,-9,24
Vienna,4490,7,6,6,12,24,39,-15,24
FC Salzburg,4491,1,14,6,4,45,20,25,48
Rapid Vienna,4491,2,11,9,4,39,25,14,42
SK Sturm Gra,4491,3,11,4,9,29,29,0,37
Mattersburg,4491,4,8,6,10,35,39,-4,30
LASK Linz,4491,5,8,6,10,25,32,-7,30
Vienna,4491,6,6,5,13,25,42,-17,23
SC Rheindorf,4491,7,4,8,12,17,28,-11,20
FC Salzburg,4492,1,15,6,3,47,20,27,51
SK Sturm Gra,4492,2,12,3,9,34,31,3,39
Rapid Vienna,4492,3,9,9,6,36,28,8,36
LASK Linz,4492,4,9,5,10,30,31,-1,32
SC Rheindorf,4492,5,7,5,12,23,29,-6,26
Mattersburg,4492,6,7,5,12,31,46,-15,26
Vienna,4492,7,6,5,13,27,43,-16,23
FC Salzburg,4493,1,14,7,3,44,19,25,49
SK Sturm Gra,4493,2,12,5,7,34,28,6,41
Rapid Vienna,4493,3,9,11,4,38,26,12,38
LASK Linz,4493,4,9,6,9,28,31,-3,33
Vienna,4493,5,7,5,12,26,41,-15,26
SC Rheindorf,4493,6,6,5,13,21,29,-8,23
Mattersburg,4493,7,5,5,14,30,47,-17,20
FC Salzburg,4494,1,13,8,3,41,19,22,47
SK Sturm Gra,4494,2,12,4,8,33,30,3,40
Rapid Vienna,4494,3,8,10,6,35,28,7,34
LASK Linz,4494,4,9,5,10,27,27,0,32
Vienna,4494,5,7,6,11,27,39,-12,27
Mattersburg,4494,6,6,7,11,28,38,-10,25
SC Rheindorf,4494,7,6,6,12,17,27,-10,24
FC Salzburg,4495,1,14,7,3,50,22,28,49
SK Sturm Gra,4495,2,13,4,7,37,31,6,43
Rapid Vienna,4495,3,11,9,4,39,25,14,42
LASK Linz,4495,4,9,5,10,30,31,-1,32
Mattersburg,4495,5,7,5,12,28,41,-13,26
Vienna,4495,6,6,5,13,24,41,-17,23
SC Rheindorf,4495,7,4,5,15,16,33,-17,17
FC Salzburg,4496,1,15,7,2,46,19,27,52
SK Sturm Gra,4496,2,13,3,8,31,27,4,42
Rapid Vienna,4496,3,8,10,6,34,27,7,34
LASK Linz,4496,4,7,8,9,24,27,-3,29
Mattersburg,4496,5,7,6,11,32,41,-9,27
Vienna,4496,6,6,6,12,25,40,-15,24
SC Rheindorf,4496,7,5,6,13,19,30,-11,21
FC Salzburg,4497,1,14,7,3,45,23,22,49
SK Sturm Gra,4497,2,12,4,8,33,30,3,40
Rapid Vienna,4497,3,9,10,5,36,27,9,37
LASK Linz,4497,4,8,6,10,29,31,-2,30
Vienna,4497,5,8,5,11,31,40,-9,29
Mattersburg,4497,6,6,6,12,31,42,-11,24
SC Rheindorf,4497,7,5,6,13,18,30,-12,21
FC Salzburg,4498,1,15,7,2,48,17,31,52
SK Sturm Gra,4498,2,13,5,6,37,30,7,44
LASK Linz,4498,3,9,6,9,30,28,2,33
Rapid Vienna,4498,4,7,9,8,35,35,0,30
SC Rheindorf,4498,5,7,5,12,23,30,-7,26
Mattersburg,4498,6,6,5,13,30,45,-15,23
Vienna,4498,7,6,5,13,25,43,-18,23
FC Salzburg,4499,1,16,6,2,47,19,28,54
SK Sturm Gra,4499,2,12,4,8,32,29,3,40
Rapid Vienna,4499,3,9,9,6,35,27,8,36
LASK Linz,4499,4,8,6,10,24,26,-2,30
Mattersburg,4499,5,6,6,12,29,40,-11,24
Vienna,4499,6,6,6,12,24,39,-15,24
SC Rheindorf,4499,7,6,5,13,17,28,-11,23
FC Salzburg,4500,1,15,6,3,47,22,25,51
SK Sturm Gra,4500,2,13,3,8,33,29,4,42
Rapid Vienna,4500,3,10,10,4,37,25,12,40
LASK Linz,4500,4,9,5,10,32,30,2,32
Mattersburg,4500,5,6,5,13,33,48,-15,23
Vienna,4500,6,6,5,13,24,41,-17,23
SC Rheindorf,4500,7,5,6,13,19,30,-11,21
FC Salzburg,4501,1,13,7,4,41,19,22,46
SK Sturm Gra,4501,2,13,5,6,33,26,7,44
Rapid Vienna,4501,3,10,9,5,38,26,12,39
LASK Linz,4501,4,8,7,9,26,27,-1,31
Vienna,4501,5,8,5,11,25,37,-12,29
SC Rheindorf,4501,6,5,6,13,17,31,-14,21
Mattersburg,4501,7,5,5,14,27,41,-14,20
FC Salzburg,4502,1,15,7,2,45,19,26,52
SK Sturm Gra,4502,2,12,5,7,32,27,5,41
Rapid Vienna,4502,3,7,12,5,38,31,7,33
LASK Linz,4502,4,8,6,10,29,31,-2,30
Vienna,4502,5,7,6,11,26,38,-12,27
Mattersburg,4502,6,6,5,13,32,46,-14,23
SC Rheindorf,4502,7,5,7,12,18,28,-10,22
FC Salzburg,4503,1,14,7,3,42,18,24,49
SK Sturm Gra,4503,2,13,3,8,35,31,4,42
Rapid Vienna,4503,3,7,10,7,35,30,5,31
LASK Linz,4503,4,7,8,9,27,30,-3,29
Mattersburg,4503,5,7,7,10,33,39,-6,28
Vienna,4503,6,7,5,12,25,39,-14,26
SC Rheindorf,4503,7,6,6,12,20,30,-10,24
FC Salzburg,4504,1,13,7,4,43,21,22,46
SK Sturm Gra,4504,2,13,4,7,36,29,7,43
Rapid Vienna,4504,3,8,10,6,35,31,4,34
LASK Linz,4504,4,7,7,10,26,29,-3,28
Vienna,4504,5,7,6,11,25,38,-13,27
SC Rheindorf,4504,6,6,7,11,22,29,-7,25
Mattersburg,4504,7,6,7,11,32,42,-10,25
FC Salzburg,4505,1,16,6,2,51,17,34,54
SK Sturm Gra,4505,2,11,5,8,31,33,-2,38
Rapid Vienna,4505,3,9,9,6,37,30,7,36
LASK Linz,4505,4,9,6,9,30,30,0,33
Mattersburg,4505,5,6,6,12,30,43,-13,24
Vienna,4505,6,6,5,13,23,40,-17,23
SC Rheindorf,4505,7,5,7,12,23,32,-9,22
FC Salzburg,4506,1,14,8,2,42,16,26,50
Rapid Vienna,4506,2,10,10,4,37,25,12,40
SK Sturm Gra,4506,3,11,4,9,29,29,0,37
LASK Linz,4506,4,8,6,10,26,28,-2,30
Mattersburg,4506,5,7,6,11,30,40,-10,27
Vienna,4506,6,6,7,11,24,38,-14,25
SC Rheindorf,4506,7,5,5,14,17,29,-12,20
FC Salzburg,4507,1,16,6,2,48,17,31,54
SK Sturm Gra,4507,2,13,4,7,32,26,6,43
Rapid Vienna,4507,3,7,11,6,35,30,5,32
LASK Linz,4507,4,8,6,10,29,29,0,30
Mattersburg,4507,5,7,5,12,32,45,-13,26
SC Rheindorf,4507,6,6,5,13,20,30,-10,23
Vienna,4507,7,6,5,13,25,44,-19,23
FC Salzburg,4508,1,14,7,3,45,17,28,49
SK Sturm Gra,4508,2,12,5,7,34,33,1,41
Rapid Vienna,4508,3,9,10,5,35,28,7,37
LASK Linz,4508,4,9,5,10,30,27,3,32
Mattersburg,4508,5,7,5,12,31,42,-11,26
SC Rheindorf,4508,6,6,5,13,21,30,-9,23
Vienna,4508,7,6,5,13,24,43,-19,23
FC Salzburg,4509,1,14,7,3,44,19,25,49
SK Sturm Gra,4509,2,13,3,8,34,31,3,42
Rapid Vienna,4509,3,8,10,6,34,27,7,34
LASK Linz,4509,4,9,6,9,25,26,-1,33
Vienna,4509,5,8,5,11,26,37,-11,29
Mattersburg,4509,6,6,6,12,28,39,-11,24
SC Rheindorf,4509,7,4,7,13,19,31,-12,19
FC Salzburg,4510,1,15,6,3,46,19,27,51
SK Sturm Gra,4510,2,11,6,7,30,28,2,39
Rapid Vienna,4510,3,9,10,5,35,26,9,37
LASK Linz,4510,4,7,7,10,27,31,-4,28
SC Rheindorf,4510,5,7,6,11,22,28,-6,27
Mattersburg,4510,6,6,6,12,31,42,-11,24
Vienna,4510,7,6,5,13,25,42,-17,23
FC Salzburg,4511,1,13,7,4,44,22,22,46
SK Sturm Gra,4511,2,13,4,7,36,31,5,43
Rapid Vienna,4511,3,10,10,4,37,25,12,40
LASK Linz,4511,4,8,7,9,26,27,-1,31
Vienna,4511,5,7,6,11,27,38,-11,27
Mattersburg,4511,6,6,5,13,29,45,-16,23
SC Rheindorf,4511,7,5,5,14,20,31,-11,20
FC Salzburg,4512,1,15,7,2,45,18,27,52
SK Sturm Gra,4512,2,13,3,8,35,30,5,42
Rapid Vienna,4512,3,9,9,6,36,29,7,36
LASK Linz,4512,4,8,5,11,26,29,-3,29
Vienna,4512,5,7,6,11,27,39,-12,27
SC Rheindorf,4512,6,6,5,13,21,30,-9,23
Mattersburg,4512,7,6,5,13,31,46,-15,23
FC Salzburg,4513,1,13,8,3,43,17,26,47
SK Sturm Gra,4513,2,12,5,7,33,29,4,41
Rapid Vienna,4513,3,9,9,6,34,26,8,36
LASK Linz,4513,4,9,5,10,28,29,-1,32
Mattersburg,4513,5,7,6,11,32,39,-7,27
SC Rheindorf,4513,6,6,6,12,18,28,-10,24
Vienna,4513,7,6,5,13,23,43,-20,23
FC Salzburg,4514,1,14,8,2,43,15,28,50
SK Sturm Gra,4514,2,13,5,6,32,26,6,44
Rapid Vienna,4514,3,8,10,6,35,28,7,34
LASK Linz,4514,4,8,8,8,29,28,1,32
Vienna,4514,5,7,5,12,24,38,-14,26
SC Rheindorf,4514,6,5,6,13,17,29,-12,21
Mattersburg,4514,7,5,6,13,27,43,-16,21
FC Salzburg,4515,1,15,7,2,47,17,30,52
SK Sturm Gra,4515,2,11,4,9,35,36,-1,37
Rapid Vienna,4515,3,8,11,5,37,28,9,35
LASK Linz,4515,4,7,8,9,27,30,-3,29
Vienna,4515,5,7,5,12,25,40,-15,26
SC Rheindorf,4515,6,6,7,11,21,29,-8,25
Mattersburg,4515,7,6,6,12,32,44,-12,24
FC Salzburg,4516,1,14,7,3,43,20,23,49
SK Sturm Gra,4516,2,13,4,7,34,28,6,43
Rapid Vienna,4516,3,8,9,7,32,29,3,33
LASK Linz,4516,4,8,5,11,24,28,-4,29
Vienna,4516,5,8,5,11,29,40,-11,29
SC Rheindorf,4516,6,7,6,11,23,27,-4,27
Mattersburg,4516,7,5,6,13,29,42,-13,21
FC Salzburg,4517,1,15,6,3,46,21,25,51
SK Sturm Gra,4517,2,14,3,7,37,30,7,45
Rapid Vienna,4517,3,8,10,6,36,28,8,34
LASK Linz,4517,4,7,8,9,28,31,-3,29
Mattersburg,4517,5,7,6,11,33,41,-8,27
Vienna,4517,6,7,5,12,24,39,-15,26
SC Rheindorf,4517,7,4,6,14,17,31,-14,18
FC Salzburg,4518,1,14,8,2,46,19,27,50
SK Sturm Gra,4518,2,13,4,7,32,27,5,43
LASK Linz,4518,3,10,5,9,34,27,7,35
Rapid Vienna,4518,4,7,10,7,33,29,4,31
Vienna,4518,5,6,7,11,26,40,-14,25
Mattersburg,4518,6,6,6,12,30,45,-15,24
SC Rheindorf,4518,7,5,6,13,18,32,-14,21
FC Salzburg,4519,1,14,7,3,42,18,24,49
SK Sturm Gra,4519,2,13,3,8,36,30,6,42
LASK Linz,4519,3,9,6,9,28,29,-1,33
Rapid Vienna,4519,4,7,11,6,31,26,5,32
Mattersburg,4519,5,7,6,11,31,42,-11,27
Vienna,4519,6,7,5,12,28,39,-11,26
SC Rheindorf,4519,7,5,6,13,20,32,-12,21
FC Salzburg,4520,1,14,7,3,46,20,26,49
SK Sturm Gra,4520,2,12,4,8,33,27,6,40
Rapid Vienna,4520,3,9,9,6,33,27,6,36
LASK Linz,4520,4,8,6,10,30,34,-4,30
Mattersburg,4520,5,7,6,11,36,44,-8,27
SC Rheindorf,4520,6,6,6,12,22,32,-10,24
Vienna,4520,7,6,6,12,25,41,-16,24
FC Salzburg,4521,1,14,7,3,44,18,26,49
SK Sturm Gra,4521,2,13,4,7,32,29,3,43
Rapid Vienna,4521,3,9,9,6,39,27,12,36
LASK Linz,4521,4,7,7,10,27,32,-5,28
Mattersburg,4521,5,5,9,10,31,41,-10,24
Vienna,4521,6,6,6,12,24,41,-17,24
SC Rheindorf,4521,7,5,8,11,20,29,-9,23
FC Salzburg,4522,1,14,6,4,44,23,21,48
SK Sturm Gra,4522,2,11,5,8,34,32,2,38
Rapid Vienna,4522,3,8,12,4,37,28,9,36
LASK Linz,4522,4,9,6,9,31,30,1,33
Mattersburg,4522,5,7,5,12,31,41,-10,26
Vienna,4522,6,7,5,12,27,40,-13,26
SC Rheindorf,4522,7,5,7,12,19,29,-10,22
FC Salzburg,4523,1,13,7,4,41,18,23,46
SK Sturm Gra,4523,2,11,5,8,32,31,1,38
Rapid Vienna,4523,3,8,11,5,34,26,8,35
LASK Linz,4523,4,9,7,8,29,28,1,34
Vienna,4523,5,7,6,11,28,41,-13,27
Mattersburg,4523,6,6,7,11,33,41,-8,25
SC Rheindorf,4523,7,6,5,13,20,32,-12,23
FC Salzburg,4524,1,15,6,3,44,19,25,51
SK Sturm Gra,4524,2,13,3,8,34,30,4,42
Rapid Vienna,4524,3,7,10,7,35,30,5,31
LASK Linz,4524,4,8,6,10,29,32,-3,30
Mattersburg,4524,5,7,6,11,35,44,-9,27
Vienna,4524,6,7,5,12,28,41,-13,26
SC Rheindorf,4524,7,5,8,11,24,33,-9,23
FC Salzburg,4525,1,15,7,2,46,18,28,52
SK Sturm Gra,4525,2,11,6,7,30,27,3,39
LASK Linz,4525,3,9,7,8,29,28,1,34
Rapid Vienna,4525,4,7,12,5,35,28,7,33
Mattersburg,4525,5,7,5,12,31,40,-9,26
Vienna,4525,6,6,5,13,24,43,-19,23
SC Rheindorf,4525,7,4,8,12,18,29,-11,20
FC Salzburg,4526,1,12,8,4,41,20,21,44
SK Sturm Gra,4526,2,12,4,8,36,33,3,40
Rapid Vienna,4526,3,9,11,4,37,27,10,38
LASK Linz,4526,4,9,7,8,30,29,1,34
Vienna,4526,5,7,6,11,27,40,-13,27
Mattersburg,4526,6,6,8,10,31,40,-9,26
SC Rheindorf,4526,7,4,6,14,17,30,-13,18
FC Salzburg,4527,1,16,6,2,49,17,32,54
SK Sturm Gra,4527,2,13,3,8,33,30,3,42
Rapid Vienna,4527,3,8,10,6,35,31,4,34
LASK Linz,4527,4,8,8,8,29,29,0,32
Vienna,4527,5,7,5,12,25,39,-14,26
SC Rheindorf,4527,6,5,6,13,17,29,-12,21
Mattersburg,4527,7,5,6,13,27,40,-13,21
FC Salzburg,4528,1,16,6,2,48,17,31,54
SK Sturm Gra,4528,2,11,4,9,32,33,-1,37
Rapid Vienna,4528,3,9,9,6,37,30,7,36
LASK Linz,4528,4,8,8,8,29,28,1,32
Vienna,4528,5,6,6,12,26,41,-15,24
Mattersburg,4528,6,5,8,11,32,44,-12,23
SC Rheindorf,4528,7,5,7,12,20,31,-11,22
FC Salzburg,4529,1,13,7,4,42,19,23,46
SK Sturm Gra,4529,2,14,4,6,39,27,12,46
Rapid Vienna,4529,3,8,10,6,35,31,4,34
LASK Linz,4529,4,7,6,11,29,34,-5,27
Mattersburg,4529,5,7,6,11,31,41,-10,27
Vienna,4529,6,7,6,11,26,39,-13,27
SC Rheindorf,4529,7,5,7,12,20,31,-11,22
FC Salzburg,4530,1,14,7,3,43,19,24,49
SK Sturm Gra,4530,2,11,6,7,33,30,3,39
Rapid Vienna,4530,3,7,11,6,33,28,5,32
LASK Linz,4530,4,8,6,10,27,30,-3,30
Mattersburg,4530,5,7,6,11,32,39,-7,27
SC Rheindorf,4530,6,7,6,11,20,27,-7,27
Vienna,4530,7,6,6,12,25,40,-15,24
FC Salzburg,4531,1,14,7,3,44,17,27,49
SK Sturm Gra,4531,2,13,5,6,31,25,6,44
Rapid Vienna,4531,3,10,10,4,37,24,13,40
LASK Linz,4531,4,9,5,10,30,30,0,32
Vienna,4531,5,7,5,12,24,39,-15,26
SC Rheindorf,4531,6,5,5,14,18,30,-12,20
Mattersburg,4531,7,5,5,14,28,47,-19,20
FC Salzburg,4532,1,15,6,3,44,18,26,51
SK Sturm Gra,4532,2,12,3,9,31,30,1,39
Rapid Vienna,4532,3,8,9,7,35,29,6,33
LASK Linz,4532,4,9,5,10,29,30,-1,32
SC Rheindorf,4532,5,8,5,11,24,28,-4,29
Vienna,4532,6,7,5,12,24,38,-14,26
Mattersburg,4532,7,6,5,13,30,44,-14,23
FC Salzburg,4533,1,14,7,3,44,22,22,49
SK Sturm Gra,4533,2,12,4,8,32,28,4,40
Rapid Vienna,4533,3,10,9,5,40,27,13,39
LASK Linz,4533,4,9,5,10,27,29,-2,32
Mattersburg,4533,5,7,5,12,34,44,-10,26
Vienna,4533,6,6,6,12,26,41,-15,24
SC Rheindorf,4533,7,5,6,13,17,29,-12,21
FC Salzburg,4534,1,14,7,3,45,17,28,49
SK Sturm Gra,4534,2,12,3,9,30,31,-1,39
Rapid Vienna,4534,3,9,10,5,34,25,9,37
LASK Linz,4534,4,9,5,10,29,28,1,32
Vienna,4534,5,7,6,11,28,40,-12,27
Mattersburg,4534,6,6,6,12,33,46,-13,24
SC Rheindorf,4534,7,6,5,13,18,30,-12,23
FC Salzburg,4535,1,15,7,2,45,17,28,52
SK Sturm Gra,4535,2,12,4,8,34,30,4,40
Rapid Vienna,4535,3,8,10,6,36,29,7,34
LASK Linz,4535,4,9,5,10,30,32,-2,32
Vienna,4535,5,7,5,12,28,41,-13,26
Mattersburg,4535,6,6,6,12,29,43,-14,24
SC Rheindorf,4535,7,5,7,12,18,28,-10,22
FC Salzburg,4536,1,13,7,4,41,20,21,46
SK Sturm Gra,4536,2,11,5,8,32,32,0,38
Rapid Vienna,4536,3,9,10,5,38,28,10,37
LASK Linz,4536,4,9,5,10,30,31,-1,32
Mattersburg,4536,5,8,6,10,33,37,-4,30
Vienna,4536,6,7,5,12,25,40,-15,26
SC Rheindorf,4536,7,5,6,13,19,30,-11,21
FC Salzburg,4537,1,12,8,4,40,19,21,44
SK Sturm Gra,4537,2,12,5,7,34,30,4,41
Rapid Vienna,4537,3,10,9,5,38,30,8,39
LASK Linz,4537,4,8,6,10,28,27,1,30
Vienna,4537,5,7,6,11,26,39,-13,27
Mattersburg,4537,6,6,7,11,29,39,-10,25
SC Rheindorf,4537,7,5,7,12,21,32,-11,22
FC Salzburg,4538,1,13,8,3,43,21,22,47
Rapid Vienna,4538,2,10,10,4,38,26,12,40
SK Sturm Gra,4538,3,12,4,8,35,34,1,40
LASK Linz,4538,4,8,6,10,29,31,-2,30
Vienna,4538,5,7,5,12,26,39,-13,26
Mattersburg,4538,6,6,6,12,30,42,-12,24
SC Rheindorf,4538,7,6,5,13,23,31,-8,23
FC Salzburg,4539,1,13,7,4,45,22,23,46
SK Sturm Gra,4539,2,12,5,7,33,29,4,41
Rapid Vienna,4539,3,9,9,6,35,26,9,36
LASK Linz,4539,4,10,5,9,29,28,1,35
Vienna,4539,5,8,5,11,30,38,-8,29
Mattersburg,4539,6,6,6,12,30,45,-15,24
SC Rheindorf,4539,7,4,7,13,18,32,-14,19
FC Salzburg,4540,1,14,7,3,43,19,24,49
SK Sturm Gra,4540,2,12,4,8,34,32,2,40
Rapid Vienna,4540,3,8,10,6,35,29,6,34
LASK Linz,4540,4,8,6,10,27,29,-2,30
Mattersburg,4540,5,7,7,10,32,39,-7,28
Vienna,4540,6,7,5,12,25,38,-13,26
SC Rheindorf,4540,7,4,9,11,19,29,-10,21
FC Salzburg,4541,1,13,7,4,44,22,22,46
SK Sturm Gra,4541,2,13,4,7,31,26,5,43
Rapid Vienna,4541,3,10,9,5,37,27,10,39
LASK Linz,4541,4,8,7,9,29,28,1,31
Mattersburg,4541,5,6,6,12,30,42,-12,24
Vienna,4541,6,6,6,12,25,40,-15,24
SC Rheindorf,4541,7,6,5,13,20,31,-11,23
FC Salzburg,4542,1,14,7,3,47,22,25,49
SK Sturm Gra,4542,2,14,3,7,34,27,7,45
LASK Linz,4542,3,9,7,8,33,29,4,34
Rapid Vienna,4542,4,7,11,6,39,35,4,32
Vienna,4542,5,7,5,12,26,41,-15,26
Mattersburg,4542,6,6,6,12,33,46,-13,24
SC Rheindorf,4542,7,4,7,13,19,31,-12,19
SK Sturm Gra,4543,1,14,3,7,35,26,9,45
FC Salzburg,4543,2,12,8,4,41,22,19,44
Rapid Vienna,4543,3,8,9,7,33,27,6,33
LASK Linz,4543,4,9,5,10,27,29,-2,32
Mattersburg,4543,5,7,7,10,33,41,-8,28
SC Rheindorf,4543,6,6,6,12,20,29,-9,24
Vienna,4543,7,6,6,12,25,40,-15,24
FC Salzburg,4544,1,14,7,3,42,18,24,49
SK Sturm Gra,4544,2,14,4,6,32,24,8,46
Rapid Vienna,4544,3,8,10,6,36,30,6,34
LASK Linz,4544,4,7,6,11,26,30,-4,27
Vienna,4544,5,7,5,12,28,42,-14,26
Mattersburg,4544,6,6,7,11,35,45,-10,25
SC Rheindorf,4544,7,5,7,12,21,31,-10,22
FC Salzburg,4545,1,13,7,4,42,20,22,46
SK Sturm Gra,4545,2,14,3,7,36,27,9,45
Rapid Vienna,4545,3,9,9,6,38,27,11,36
LASK Linz,4545,4,8,6,10,24,28,-4,30
Mattersburg,4545,5,7,7,10,32,40,-8,28
Vienna,4545,6,7,5,12,25,39,-14,26
SC Rheindorf,4545,7,5,5,14,19,35,-16,20
FC Salzburg,4546,1,13,8,3,45,22,23,47
Rapid Vienna,4546,2,9,11,4,38,28,10,38
SK Sturm Gra,4546,3,11,5,8,31,32,-1,38
LASK Linz,4546,4,10,6,8,33,28,5,36
Mattersburg,4546,5,7,6,11,34,44,-10,27
Vienna,4546,6,6,5,13,24,40,-16,23
SC Rheindorf,4546,7,5,5,14,21,32,-11,20
FC Salzburg,4547,1,16,6,2,45,16,29,54
SK Sturm Gra,4547,2,12,4,8,33,28,5,40
Rapid Vienna,4547,3,8,10,6,35,28,7,34
LASK Linz,4547,4,8,5,11,30,36,-6,29
Mattersburg,4547,5,7,6,11,34,41,-7,27
SC Rheindorf,4547,6,6,6,12,22,32,-10,24
Vienna,4547,7,6,5,13,24,42,-18,23
FC Salzburg,4548,1,12,7,5,41,22,19,43
SK Sturm Gra,4548,2,13,4,7,35,28,7,43
Rapid Vienna,4548,3,8,12,4,36,26,10,36
LASK Linz,4548,4,8,6,10,25,32,-7,30
Vienna,4548,5,8,5,11,28,40,-12,29
SC Rheindorf,4548,6,7,5,12,22,28,-6,26
Mattersburg,4548,7,6,5,13,33,44,-11,23
FC Salzburg,4549,1,13,7,4,45,21,24,46
SK Sturm Gra,4549,2,13,4,7,34,27,7,43
Rapid Vienna,4549,3,8,10,6,36,32,4,34
LASK Linz,4549,4,9,6,9,29,28,1,33
SC Rheindorf,4549,5,6,7,11,21,27,-6,25
Mattersburg,4549,6,6,6,12,29,44,-15,24
Vienna,4549,7,6,6,12,24,39,-15,24
FC Salzburg,4550,1,15,6,3,46,17,29,51
SK Sturm Gra,4550,2,13,3,8,32,29,3,42
Rapid Vienna,4550,3,8,10,6,36,29,7,34
LASK Linz,4550,4,9,7,8,30,29,1,34
Vienna,4550,5,7,5,12,25,39,-14,26
SC Rheindorf,4550,6,5,7,12,21,31,-10,22
Mattersburg,4550,7,5,6,13,30,46,-16,21
FC Salzburg,4551,1,14,7,3,41,17,24,49
SK Sturm Gra,4551,2,13,3,8,33,27,6,42
Rapid Vienna,4551,3,9,10,5,34,25,9,37
LASK Linz,4551,4,7,6,11,24,30,-6,27
Mattersburg,4551,5,7,5,12,31,39,-8,26
SC Rheindorf,4551,6,7,5,12,19,27,-8,26
Vienna,4551,7,6,6,12,24,41,-17,24
FC Salzburg,4552,1,15,7,2,47,17,30,52
SK Sturm Gra,4552,2,12,5,7,32,28,4,41
Rapid Vienna,4552,3,9,10,5,37,28,9,37
LASK Linz,4552,4,8,5,11,29,32,-3,29
SC Rheindorf,4552,5,7,5,12,25,32,-7,26
Vienna,4552,6,6,6,12,24,39,-15,24
Mattersburg,4552,7,5,6,13,30,48,-18,21
FC Salzburg,4553,1,13,6,5,42,22,20,45
SK Sturm Gra,4553,2,12,5,7,33,29,4,41
Rapid Vienna,4553,3,10,10,4,36,23,13,40
LASK Linz,4553,4,8,7,9,27,30,-3,31
Mattersburg,4553,5,7,7,10,34,40,-6,28
Vienna,4553,6,6,6,12,25,40,-15,24
SC Rheindorf,4553,7,4,7,13,19,32,-13,19
FC Salzburg,4554,1,14,7,3,45,18,27,49
Rapid Vienna,4554,2,10,9,5,37,28,9,39
SK Sturm Gra,4554,3,11,4,9,32,32,0,37
LASK Linz,4554,4,10,6,8,31,27,4,36
Vienna,4554,5,7,6,11,28,39,-11,27
SC Rheindorf,4554,6,5,7,12,24,32,-8,22
Mattersburg,4554,7,5,5,14,30,51,-21,20
FC Salzburg,4555,1,13,7,4,44,23,21,46
SK Sturm Gra,4555,2,12,5,7,35,29,6,41
Rapid Vienna,4555,3,8,11,5,36,28,8,35
LASK Linz,4555,4,10,5,9,31,29,2,35
Vienna,4555,5,8,5,11,29,38,-9,29
Mattersburg,4555,6,6,5,13,30,45,-15,23
SC Rheindorf,4555,7,5,6,13,18,31,-13,21
FC Salzburg,4556,1,14,7,3,43,17,26,49
SK Sturm Gra,4556,2,13,4,7,35,28,7,43
Rapid Vienna,4556,3,8,10,6,35,29,6,34
LASK Linz,4556,4,8,7,9,27,29,-2,31
Mattersburg,4556,5,7,6,11,34,44,-10,27
Vienna,4556,6,7,5,12,25,40,-15,26
SC Rheindorf,4556,7,5,5,14,20,32,-12,20
FC Salzburg,4557,1,14,7,3,44,19,25,49
SK Sturm Gra,4557,2,13,4,7,35,29,6,43
Rapid Vienna,4557,3,9,9,6,36,31,5,36
LASK Linz,4557,4,9,6,9,28,26,2,33
Vienna,4557,5,7,6,11,26,38,-12,27
Mattersburg,4557,6,7,5,12,30,40,-10,26
SC Rheindorf,4557,7,4,5,15,16,32,-16,17
FC Salzburg,4558,1,15,7,2,45,16,29,52
SK Sturm Gra,4558,2,13,3,8,31,30,1,42
Rapid Vienna,4558,3,8,11,5,35,25,10,35
LASK Linz,4558,4,7,6,11,24,28,-4,27
Mattersburg,4558,5,7,6,11,31,39,-8,27
Vienna,4558,6,6,6,12,24,39,-15,24
SC Rheindorf,4558,7,6,5,13,20,33,-13,23
FC Salzburg,4559,1,15,6,3,44,19,25,51
SK Sturm Gra,4559,2,13,4,7,32,27,5,43
Rapid Vienna,4559,3,8,11,5,36,29,7,35
LASK Linz,4559,4,8,6,10,27,30,-3,30
Vienna,4559,5,7,5,12,25,39,-14,26
SC Rheindorf,4559,6,6,5,13,20,28,-8,23
Mattersburg,4559,7,6,5,13,29,41,-12,23
FC Salzburg,4560,1,14,8,2,45,18,27,50
SK Sturm Gra,4560,2,12,5,7,29,26,3,41
Rapid Vienna,4560,3,9,10,5,41,27,14,37
LASK Linz,4560,4,7,6,11,24,35,-11,27
Vienna,4560,5,7,6,11,26,39,-13,27
Mattersburg,4560,6,7,5,12,33,44,-11,26
SC Rheindorf,4560,7,5,6,13,21,30,-9,21
FC Salzburg,4561,1,15,7,2,45,17,28,52
SK Sturm Gra,4561,2,12,4,8,31,31,0,40
LASK Linz,4561,3,10,6,8,32,26,6,36
Rapid Vienna,4561,4,7,10,7,32,28,4,31
Vienna,4561,5,6,6,12,23,40,-17,24
SC Rheindorf,4561,6,5,8,11,20,29,-9,23
Mattersburg,4561,7,5,7,12,29,41,-12,22
FC Salzburg,4562,1,15,7,2,47,20,27,52
SK Sturm Gra,4562,2,11,5,8,31,30,1,38
LASK Linz,4562,3,10,6,8,32,26,6,36
Rapid Vienna,4562,4,7,10,7,34,29,5,31
SC Rheindorf,4562,5,7,5,12,20,30,-10,26
Vienna,4562,6,6,7,11,25,39,-14,25
Mattersburg,4562,7,5,6,13,30,45,-15,21
FC Salzburg,4563,1,13,9,2,41,17,24,48
SK Sturm Gra,4563,2,12,6,6,35,30,5,42
Rapid Vienna,4563,3,7,11,6,35,31,4,32
LASK Linz,4563,4,8,6,10,30,33,-3,30
SC Rheindorf,4563,5,7,6,11,27,29,-2,27
Vienna,4563,6,7,5,12,25,39,-14,26
Mattersburg,4563,7,5,7,12,33,47,-14,22
FC Salzburg,4564,1,15,7,2,51,19,32,52
SK Sturm Gra,4564,2,13,3,8,34,27,7,42
Rapid Vienna,4564,3,9,9,6,38,34,4,36
LASK Linz,4564,4,10,5,9,32,29,3,35
Vienna,4564,5,7,6,11,27,39,-12,27
Mattersburg,4564,6,5,6,13,28,47,-19,21
SC Rheindorf,4564,7,4,6,14,18,33,-15,18
SK Sturm Gra,4565,1,14,4,6,35,26,9,46
FC Salzburg,4565,2,12,8,4,41,21,20,44
LASK Linz,4565,3,9,6,9,31,31,0,33
Rapid Vienna,4565,4,7,11,6,35,29,6,32
Mattersburg,4565,5,8,5,11,35,44,-9,29
Vienna,4565,6,7,5,12,28,41,-13,26
SC Rheindorf,4565,7,5,5,14,18,31,-13,20
FC Salzburg,4566,1,14,7,3,47,22,25,49
SK Sturm Gra,4566,2,13,4,7,33,28,5,43
Rapid Vienna,4566,3,7,12,5,37,30,7,33
LASK Linz,4566,4,7,6,11,28,32,-4,27
Mattersburg,4566,5,7,6,11,30,39,-9,27
Vienna,4566,6,7,6,11,26,39,-13,27
SC Rheindorf,4566,7,5,7,12,19,30,-11,22
FC Salzburg,4567,1,14,8,2,42,16,26,50
SK Sturm Gra,4567,2,12,4,8,31,28,3,40
Rapid Vienna,4567,3,8,10,6,32,25,7,34
LASK Linz,4567,4,8,7,9,26,27,-1,31
Vienna,4567,5,7,6,11,26,37,-11,27
Mattersburg,4567,6,6,6,12,29,43,-14,24
SC Rheindorf,4567,7,5,7,12,19,29,-10,22
FC Salzburg,4568,1,15,6,3,45,19,26,51
Rapid Vienna,4568,2,9,10,5,34,25,9,37
SK Sturm Gra,4568,3,11,4,9,31,31,0,37
LASK Linz,4568,4,9,5,10,32,31,1,32
Mattersburg,4568,5,7,5,12,32,42,-10,26
Vienna,4568,6,7,5,12,25,41,-16,26
SC Rheindorf,4568,7,5,7,12,18,28,-10,22
FC Salzburg,4569,1,13,8,3,42,19,23,47
SK Sturm Gra,4569,2,12,4,8,31,28,3,40
Rapid Vienna,4569,3,9,11,4,38,27,11,38
Mattersburg,4569,4,9,5,10,31,37,-6,32
LASK Linz,4569,5,8,5,11,27,30,-3,29
Vienna,4569,6,6,6,12,24,39,-15,24
SC Rheindorf,4569,7,5,5,14,18,31,-13,20
FC Salzburg,4570,1,15,6,3,46,18,28,51
SK Sturm Gra,4570,2,12,5,7,33,30,3,41
Rapid Vienna,4570,3,9,10,5,39,27,12,37
LASK Linz,4570,4,7,7,10,26,32,-6,28
Mattersburg,4570,5,7,6,11,32,43,-11,27
Vienna,4570,6,6,5,13,25,41,-16,23
SC Rheindorf,4570,7,5,7,12,21,31,-10,22
FC Salzburg,4571,1,14,8,2,46,19,27,50
SK Sturm Gra,4571,2,11,4,9,30,30,0,37
LASK Linz,4571,3,10,5,9,28,27,1,35
Rapid Vienna,4571,4,8,10,6,36,30,6,34
SC Rheindorf,4571,5,7,6,11,26,30,-4,27
Vienna,4571,6,6,6,12,26,43,-17,24
Mattersburg,4571,7,5,7,12,31,44,-13,22
FC Salzburg,4572,1,15,7,2,49,18,31,52
SK Sturm Gra,4572,2,12,5,7,30,25,5,41
LASK Linz,4572,3,10,5,9,30,29,1,35
Rapid Vienna,4572,4,7,12,5,35,28,7,33
Mattersburg,4572,5,7,5,12,31,45,-14,26
Vienna,4572,6,6,5,13,24,42,-18,23
SC Rheindorf,4572,7,4,7,13,17,29,-12,19
FC Salzburg,4573,1,14,7,3,45,20,25,49
SK Sturm Gra,4573,2,13,3,8,34,31,3,42
Rapid Vienna,4573,3,8,10,6,35,29,6,34
LASK Linz,4573,4,7,7,10,25,29,-4,28
Mattersburg,4573,5,7,6,11,30,38,-8,27
SC Rheindorf,4573,6,7,5,12,21,27,-6,26
Vienna,4573,7,6,6,12,25,41,-16,24
FC Salzburg,4574,1,15,7,2,43,16,27,52
SK Sturm Gra,4574,2,12,3,9,31,31,0,39
Rapid Vienna,4574,3,7,12,5,33,27,6,33
LASK Linz,4574,4,8,6,10,28,30,-2,30
SC Rheindorf,4574,5,7,6,11,21,26,-5,27
Vienna,4574,6,7,5,12,25,38,-13,26
Mattersburg,4574,7,6,5,13,28,41,-13,23
FC Salzburg,4575,1,14,6,4,47,20,27,48
SK Sturm Gra,4575,2,13,3,8,31,26,5,42
Rapid Vienna,4575,3,9,10,5,34,24,10,37
LASK Linz,4575,4,9,5,10,25,28,-3,32
Vienna,4575,5,8,5,11,29,39,-10,29
Mattersburg,4575,6,6,5,13,28,46,-18,23
SC Rheindorf,4575,7,5,6,13,17,28,-11,21
FC Salzburg,4576,1,14,6,4,43,19,24,48
SK Sturm Gra,4576,2,14,4,6,35,25,10,46
Rapid Vienna,4576,3,9,10,5,34,25,9,37
Mattersburg,4576,4,7,6,11,31,39,-8,27
LASK Linz,4576,5,7,6,11,24,32,-8,27
Vienna,4576,6,7,5,12,24,40,-16,26
SC Rheindorf,4576,7,5,5,14,18,29,-11,20
FC Salzburg,4577,1,14,7,3,46,21,25,49
SK Sturm Gra,4577,2,14,3,7,38,28,10,45
Rapid Vienna,4577,3,8,11,5,34,27,7,35
Mattersburg,4577,4,8,5,11,33,41,-8,29
LASK Linz,4577,5,7,6,11,29,33,-4,27
SC Rheindorf,4577,6,6,5,13,17,29,-12,23
Vienna,4577,7,6,5,13,24,42,-18,23
FC Salzburg,4578,1,15,6,3,44,19,25,51
SK Sturm Gra,4578,2,14,3,7,33,28,5,45
Rapid Vienna,4578,3,8,10,6,35,27,8,34
LASK Linz,4578,4,9,6,9,28,26,2,33
Mattersburg,4578,5,7,5,12,30,41,-11,26
Vienna,4578,6,6,5,13,25,41,-16,23
SC Rheindorf,4578,7,4,7,13,17,30,-13,19
FC Salzburg,4579,1,14,7,3,43,19,24,49
SK Sturm Gra,4579,2,13,5,6,34,28,6,44
Rapid Vienna,4579,3,7,10,7,35,30,5,31
LASK Linz,4579,4,8,7,9,27,28,-1,31
Vienna,4579,5,7,6,11,25,38,-13,27
Mattersburg,4579,6,7,5,12,31,41,-10,26
SC Rheindorf,4579,7,5,6,13,18,29,-11,21
SK Sturm Gra,4580,1,14,3,7,35,28,7,45
FC Salzburg,4580,2,12,7,5,41,25,16,43
Rapid Vienna,4580,3,8,11,5,39,28,11,35
LASK Linz,4580,4,8,5,11,26,33,-7,29
Vienna,4580,5,8,5,11,27,38,-11,29
SC Rheindorf,4580,6,7,6,11,20,27,-7,27
Mattersburg,4580,7,6,5,13,33,42,-9,23
FC Salzburg,4581,1,14,7,3,49,20,29,49
SK Sturm Gra,4581,2,13,5,6,36,29,7,44
Rapid Vienna,4581,3,9,10,5,38,28,10,37
LASK Linz,4581,4,9,5,10,28,31,-3,32
Mattersburg,4581,5,7,5,12,33,41,-8,26
Vienna,4581,6,6,5,13,23,44,-21,23
SC Rheindorf,4581,7,5,5,14,18,32,-14,20
FC Salzburg,4582,1,14,6,4,42,19,23,48
SK Sturm Gra,4582,2,11,5,8,31,31,0,38
LASK Linz,4582,3,10,6,8,32,25,7,36
Rapid Vienna,4582,4,8,10,6,34,30,4,34
Mattersburg,4582,5,7,5,12,29,40,-11,26
Vienna,4582,6,7,5,12,25,38,-13,26
SC Rheindorf,4582,7,6,5,13,21,31,-10,23
FC Salzburg,4583,1,13,9,2,41,17,24,48
SK Sturm Gra,4583,2,12,4,8,33,32,1,40
Rapid Vienna,4583,3,9,11,4,41,25,16,38
LASK Linz,4583,4,8,6,10,30,33,-3,30
SC Rheindorf,4583,5,7,5,12,21,32,-11,26
Vienna,4583,6,6,7,11,27,41,-14,25
Mattersburg,4583,7,5,6,13,30,43,-13,21
FC Salzburg,4584,1,15,7,2,50,16,34,52
SK Sturm Gra,4584,2,12,4,8,31,31,0,40
Rapid Vienna,4584,3,9,11,4,38,25,13,38
LASK Linz,4584,4,8,7,9,27,28,-1,31
Mattersburg,4584,5,7,6,11,33,45,-12,27
Vienna,4584,6,6,5,13,26,45,-19,23
SC Rheindorf,4584,7,4,6,14,17,32,-15,18
FC Salzburg,4585,1,13,9,2,41,17,24,48
SK Sturm Gra,4585,2,14,4,6,33,25,8,46
Rapid Vienna,4585,3,8,10,6,32,26,6,34
LASK Linz,4585,4,9,5,10,27,28,-1,32
Mattersburg,4585,5,7,5,12,35,43,-8,26
Vienna,4585,6,6,6,12,25,42,-17,24
SC Rheindorf,4585,7,5,5,14,19,31,-12,20
FC Salzburg,4586,1,14,8,2,47,17,30,50
SK Sturm Gra,4586,2,12,3,9,31,29,2,39
Rapid Vienna,4586,3,8,11,5,34,28,6,35
LASK Linz,4586,4,8,6,10,27,27,0,30
SC Rheindorf,4586,5,7,6,11,20,27,-7,27
Vienna,4586,6,6,7,11,23,37,-14,25
Mattersburg,4586,7,5,7,12,27,44,-17,22
FC Salzburg,4587,1,15,7,2,46,19,27,52
SK Sturm Gra,4587,2,13,4,7,34,27,7,43
Rapid Vienna,4587,3,9,9,6,37,31,6,36
LASK Linz,4587,4,7,6,11,27,33,-6,27
Vienna,4587,5,6,7,11,24,38,-14,25
Mattersburg,4587,6,6,6,12,29,39,-10,24
SC Rheindorf,4587,7,5,7,12,19,29,-10,22
FC Salzburg,4588,1,15,7,2,46,17,29,52
SK Sturm Gra,4588,2,13,4,7,34,29,5,43
Rapid Vienna,4588,3,9,9,6,36,27,9,36
LASK Linz,4588,4,8,5,11,28,34,-6,29
Vienna,4588,5,7,5,12,25,38,-13,26
SC Rheindorf,4588,6,6,6,12,23,30,-7,24
Mattersburg,4588,7,5,6,13,29,46,-17,21
FC Salzburg,4589,1,16,6,2,46,17,29,54
SK Sturm Gra,4589,2,14,3,7,37,27,10,45
Rapid Vienna,4589,3,8,10,6,35,26,9,34
LASK Linz,4589,4,8,7,9,25,28,-3,31
Mattersburg,4589,5,6,7,11,27,38,-11,25
Vienna,4589,6,6,6,12,23,39,-16,24
SC Rheindorf,4589,7,4,5,15,15,33,-18,17
FC Salzburg,4590,1,15,7,2,47,20,27,52
SK Sturm Gra,4590,2,12,5,7,33,29,4,41
Rapid Vienna,4590,3,8,11,5,34,27,7,35
LASK Linz,4590,4,8,6,10,27,29,-2,30
Vienna,4590,5,7,5,12,26,40,-14,26
SC Rheindorf,4590,6,6,5,13,22,30,-8,23
Mattersburg,4590,7,6,5,13,30,44,-14,23
FC Salzburg,4591,1,15,6,3,46,18,28,51
SK Sturm Gra,4591,2,12,5,7,31,29,2,41
Rapid Vienna,4591,3,7,11,6,34,31,3,32
Vienna,4591,4,8,5,11,30,37,-7,29
LASK Linz,4591,5,7,7,10,28,31,-3,28
Mattersburg,4591,6,7,5,12,32,45,-13,26
SC Rheindorf,4591,7,5,7,12,19,29,-10,22
FC Salzburg,4592,1,15,6,3,47,22,25,51
Rapid Vienna,4592,2,10,9,5,42,28,14,39
SK Sturm Gra,4592,3,12,3,9,32,29,3,39
LASK Linz,4592,4,8,6,10,28,33,-5,30
SC Rheindorf,4592,5,6,6,12,21,29,-8,24
Mattersburg,4592,6,6,6,12,31,45,-14,24
Vienna,4592,7,6,6,12,24,39,-15,24
FC Salzburg,4593,1,13,9,2,44,19,25,48
SK Sturm Gra,4593,2,13,3,8,34,29,5,42
Rapid Vienna,4593,3,8,10,6,35,30,5,34
LASK Linz,4593,4,9,5,10,30,27,3,32
Mattersburg,4593,5,6,7,11,29,42,-13,25
SC Rheindorf,4593,6,6,6,12,20,30,-10,24
Vienna,4593,7,6,6,12,24,39,-15,24
FC Salzburg,4594,1,14,8,2,46,20,26,50
SK Sturm Gra,4594,2,14,4,6,34,26,8,46
Rapid Vienna,4594,3,8,10,6,39,32,7,34
LASK Linz,4594,4,8,7,9,28,29,-1,31
Mattersburg,4594,5,6,6,12,30,41,-11,24
Vienna,4594,6,6,6,12,25,41,-16,24
SC Rheindorf,4594,7,4,7,13,19,32,-13,19
FC Salzburg,4595,1,14,7,3,44,19,25,49
SK Sturm Gra,4595,2,13,4,7,37,31,6,43
Rapid Vienna,4595,3,9,11,4,38,27,11,38
LASK Linz,4595,4,8,7,9,28,31,-3,31
Vienna,4595,5,7,6,11,28,40,-12,27
Mattersburg,4595,6,5,6,13,30,45,-15,21
SC Rheindorf,4595,7,5,5,14,20,32,-12,20
FC Salzburg,4596,1,16,6,2,58,18,40,54
SK Sturm Gra,4596,2,12,5,7,32,31,1,41
Rapid Vienna,4596,3,9,9,6,37,30,7,36
LASK Linz,4596,4,7,6,11,25,31,-6,27
Mattersburg,4596,5,7,6,11,34,49,-15,27
Vienna,4596,6,6,6,12,26,41,-15,24
SC Rheindorf,4596,7,5,6,13,20,32,-12,21
FC Salzburg,4597,1,14,8,2,43,16,27,50
SK Sturm Gra,4597,2,14,3,7,33,25,8,45
Rapid Vienna,4597,3,7,12,5,35,28,7,33
LASK Linz,4597,4,8,6,10,25,28,-3,30
Mattersburg,4597,5,7,6,11,32,40,-8,27
Vienna,4597,6,6,6,12,24,41,-17,24
SC Rheindorf,4597,7,4,7,13,17,31,-14,19
FC Salzburg,4598,1,15,7,2,45,16,29,52
SK Sturm Gra,4598,2,14,3,7,36,28,8,45
Rapid Vienna,4598,3,8,9,7,35,33,2,33
LASK Linz,4598,4,8,6,10,28,29,-1,30
Vienna,4598,5,7,6,11,25,38,-13,27
SC Rheindorf,4598,6,6,5,13,20,30,-10,23
Mattersburg,4598,7,5,6,13,27,42,-15,21
FC Salzburg,4599,1,14,7,3,44,18,26,49
SK Sturm Gra,4599,2,12,5,7,31,26,5,41
Rapid Vienna,4599,3,9,9,6,35,28,7,36
LASK Linz,4599,4,9,6,9,27,29,-2,33
Vienna,4599,5,7,6,11,24,37,-13,27
SC Rheindorf,4599,6,5,7,12,21,29,-8,22
Mattersburg,4599,7,5,6,13,30,45,-15,21
FC Salzburg,4600,1,14,8,2,47,21,26,50
SK Sturm Gra,4600,2,13,3,8,31,30,1,42
LASK Linz,4600,3,10,5,9,29,26,3,35
Rapid Vienna,4600,4,7,9,8,34,31,3,30
Vienna,4600,5,7,6,11,27,40,-13,27
Mattersburg,4600,6,6,6,12,33,43,-10,24
SC Rheindorf,4600,7,6,5,13,20,30,-10,23
FC Salzburg,4601,1,16,6,2,54,22,32,54
Rapid Vienna,4601,2,10,9,5,39,27,12,39
SK Sturm Gra,4601,3,12,3,9,30,33,-3,39
LASK Linz,4601,4,7,5,12,23,30,-7,26
SC Rheindorf,4601,5,7,5,12,21,28,-7,26
Mattersburg,4601,6,6,6,12,30,42,-12,24
Vienna,4601,7,6,6,12,27,42,-15,24
FC Salzburg,4602,1,13,7,4,39,18,21,46
SK Sturm Gra,4602,2,11,5,8,31,31,0,38
Rapid Vienna,4602,3,9,10,5,39,28,11,37
LASK Linz,4602,4,9,7,8,32,27,5,34
Vienna,4602,5,7,6,11,26,39,-13,27
Mattersburg,4602,6,6,8,10,31,40,-9,26
SC Rheindorf,4602,7,4,7,13,19,34,-15,19
FC Salzburg,4603,1,13,8,3,39,17,22,47
SK Sturm Gra,4603,2,12,6,6,34,29,5,42
Rapid Vienna,4603,3,8,10,6,35,27,8,34
LASK Linz,4603,4,9,5,10,28,30,-2,32
Mattersburg,4603,5,8,5,11,34,38,-4,29
Vienna,4603,6,6,6,12,23,39,-16,24
SC Rheindorf,4603,7,5,6,13,20,33,-13,21
FC Salzburg,4604,1,15,6,3,44,20,24,51
SK Sturm Gra,4604,2,14,3,7,35,27,8,45
Rapid Vienna,4604,3,10,9,5,40,29,11,39
LASK Linz,4604,4,8,5,11,29,32,-3,29
Mattersburg,4604,5,7,6,11,32,41,-9,27
Vienna,4604,6,6,5,13,24,40,-16,23
SC Rheindorf,4604,7,4,6,14,21,36,-15,18
FC Salzburg,4605,1,12,9,3,40,18,22,45
SK Sturm Gra,4605,2,14,3,7,37,26,11,45
Rapid Vienna,4605,3,9,10,5,36,27,9,37
LASK Linz,4605,4,7,6,11,24,35,-11,27
Vienna,4605,5,7,6,11,27,39,-12,27
SC Rheindorf,4605,6,6,6,12,22,30,-8,24
Mattersburg,4605,7,6,6,12,31,42,-11,24
FC Salzburg,4606,1,14,6,4,43,19,24,48
SK Sturm Gra,4606,2,13,4,7,35,28,7,43
Rapid Vienna,4606,3,9,9,6,37,31,6,36
LASK Linz,4606,4,9,6,9,26,26,0,33
Vienna,4606,5,8,5,11,28,39,-11,29
Mattersburg,4606,6,6,5,13,30,43,-13,23
SC Rheindorf,4606,7,4,7,13,19,32,-13,19
FC Salzburg,4607,1,13,8,3,45,21,24,47
SK Sturm Gra,4607,2,11,6,7,32,29,3,39
LASK Linz,4607,3,8,8,8,28,28,0,32
Rapid Vienna,4607,4,7,10,7,33,29,4,31
Vienna,4607,5,8,5,11,30,41,-11,29
Mattersburg,4607,6,6,7,11,31,42,-11,25
SC Rheindorf,4607,7,6,6,12,20,29,-9,24
FC Salzburg,4608,1,16,6,2,51,17,34,54
SK Sturm Gra,4608,2,13,4,7,33,27,6,43
Rapid Vienna,4608,3,9,10,5,36,29,7,37
LASK Linz,4608,4,7,5,12,23,30,-7,26
Mattersburg,4608,5,7,5,12,31,42,-11,26
Vienna,4608,6,7,5,12,27,44,-17,26
SC Rheindorf,4608,7,5,5,14,21,33,-12,20
FC Salzburg,4609,1,13,8,3,41,19,22,47
SK Sturm Gra,4609,2,13,5,6,34,28,6,44
Rapid Vienna,4609,3,8,11,5,36,27,9,35
LASK Linz,4609,4,8,7,9,26,28,-2,31
Vienna,4609,5,8,5,11,27,38,-11,29
SC Rheindorf,4609,6,5,7,12,20,29,-9,22
Mattersburg,4609,7,5,5,14,29,44,-15,20
FC Salzburg,4610,1,13,6,5,43,22,21,45
SK Sturm Gra,4610,2,12,5,7,34,29,5,41
LASK Linz,4610,3,10,5,9,28,31,-3,35
Rapid Vienna,4610,4,8,10,6,33,27,6,34
Vienna,4610,5,7,5,12,25,40,-15,26
SC Rheindorf,4610,6,6,7,11,25,28,-3,25
Mattersburg,4610,7,6,6,12,32,43,-11,24
FC Salzburg,4611,1,15,6,3,45,18,27,51
Rapid Vienna,4611,2,10,10,4,40,25,15,40
SK Sturm Gra,4611,3,11,4,9,33,37,-4,37
LASK Linz,4611,4,8,7,9,26,26,0,31
Mattersburg,4611,5,8,5,11,34,41,-7,29
Vienna,4611,6,6,5,13,24,42,-18,23
SC Rheindorf,4611,7,4,7,13,19,32,-13,19
FC Salzburg,4612,1,13,9,2,45,18,27,48
SK Sturm Gra,4612,2,12,4,8,33,30,3,40
Rapid Vienna,4612,3,7,12,5,36,30,6,33
LASK Linz,4612,4,9,6,9,31,29,2,33
SC Rheindorf,4612,5,6,7,11,21,29,-8,25
Vienna,4612,6,6,6,12,24,42,-18,24
Mattersburg,4612,7,5,8,11,30,42,-12,23
FC Salzburg,4613,1,15,6,3,44,16,28,51
SK Sturm Gra,4613,2,13,5,6,31,24,7,44
Rapid Vienna,4613,3,9,10,5,34,27,7,37
LASK Linz,4613,4,8,6,10,26,29,-3,30
Mattersburg,4613,5,6,6,12,30,40,-10,24
Vienna,4613,6,6,5,13,24,41,-17,23
SC Rheindorf,4613,7,4,8,12,16,28,-12,20
FC Salzburg,4614,1,14,7,3,46,18,28,49
SK Sturm Gra,4614,2,12,4,8,31,31,0,40
LASK Linz,4614,3,10,6,8,28,24,4,36
Rapid Vienna,4614,4,8,9,7,33,29,4,33
Vienna,4614,5,7,6,11,26,39,-13,27
Mattersburg,4614,6,5,9,10,29,39,-10,24
SC Rheindorf,4614,7,4,7,13,18,31,-13,19
FC Salzburg,4615,1,14,6,4,43,19,24,48
SK Sturm Gra,4615,2,13,5,6,32,25,7,44
Rapid Vienna,4615,3,9,9,6,36,29,7,36
LASK Linz,4615,4,7,7,10,26,31,-5,28
SC Rheindorf,4615,5,6,7,11,22,30,-8,25
Mattersburg,4615,6,6,6,12,36,45,-9,24
Vienna,4615,7,6,6,12,26,42,-16,24
FC Salzburg,4616,1,15,6,3,48,17,31,51
SK Sturm Gra,4616,2,13,3,8,34,28,6,42
Rapid Vienna,4616,3,9,9,6,35,27,8,36
LASK Linz,4616,4,9,6,9,31,32,-1,33
Vienna,4616,5,7,5,12,25,41,-16,26
Mattersburg,4616,6,6,6,12,30,42,-12,24
SC Rheindorf,4616,7,5,5,14,17,33,-16,20
FC Salzburg,4617,1,13,8,3,43,19,24,47
SK Sturm Gra,4617,2,13,4,7,34,28,6,43
Rapid Vienna,4617,3,9,10,5,38,30,8,37
Vienna,4617,4,8,5,11,28,39,-11,29
LASK Linz,4617,5,7,7,10,27,30,-3,28
Mattersburg,4617,6,5,8,11,30,42,-12,23
SC Rheindorf,4617,7,5,6,13,20,32,-12,21
FC Salzburg,4618,1,15,6,3,45,18,27,51
Rapid Vienna,4618,2,11,9,4,42,28,14,42
SK Sturm Gra,4618,3,12,4,8,33,31,2,40
LASK Linz,4618,4,7,6,11,25,32,-7,27
Vienna,4618,5,7,5,12,24,39,-15,26
SC Rheindorf,4618,6,6,6,12,22,30,-8,24
Mattersburg,4618,7,5,6,13,28,41,-13,21
FC Salzburg,4619,1,14,6,4,46,20,26,48
SK Sturm Gra,4619,2,13,5,6,37,29,8,44
LASK Linz,4619,3,8,8,8,30,28,2,32
Rapid Vienna,4619,4,7,10,7,33,32,1,31
Mattersburg,4619,5,7,6,11,33,44,-11,27
Vienna,4619,6,7,5,12,24,39,-15,26
SC Rheindorf,4619,7,4,8,12,19,30,-11,20
FC Salzburg,4620,1,15,6,3,49,18,31,51
SK Sturm Gra,4620,2,13,4,7,36,31,5,43
Rapid Vienna,4620,3,8,11,5,38,30,8,35
LASK Linz,4620,4,8,5,11,27,34,-7,29
Vienna,4620,5,7,5,12,25,40,-15,26
SC Rheindorf,4620,6,6,6,12,24,28,-4,24
Mattersburg,4620,7,6,5,13,28,46,-18,23
FC Salzburg,4621,1,13,8,3,45,20,25,47
SK Sturm Gra,4621,2,13,4,7,35,31,4,43
Rapid Vienna,4621,3,8,11,5,38,27,11,35
Mattersburg,4621,4,8,6,10,34,39,-5,30
LASK Linz,4621,5,8,5,11,26,31,-5,29
Vienna,4621,6,6,6,12,24,39,-15,24
SC Rheindorf,4621,7,5,6,13,19,34,-15,21
FC Salzburg,4622,1,14,7,3,44,18,26,49
SK Sturm Gra,4622,2,13,5,6,32,26,6,44
Rapid Vienna,4622,3,8,9,7,33,29,4,33
LASK Linz,4622,4,9,6,9,29,26,3,33
Mattersburg,4622,5,7,6,11,31,40,-9,27
Vienna,4622,6,7,5,12,24,40,-16,26
SC Rheindorf,4622,7,4,6,14,17,31,-14,18
FC Salzburg,4623,1,14,8,2,43,18,25,50
SK Sturm Gra,4623,2,13,4,7,31,26,5,43
Rapid Vienna,4623,3,9,10,5,34,25,9,37
LASK Linz,4623,4,8,6,10,25,28,-3,30
Vienna,4623,5,7,5,12,26,38,-12,26
Mattersburg,4623,6,5,7,12,28,42,-14,22
SC Rheindorf,4623,7,5,6,13,17,27,-10,21
FC Salzburg,4624,1,15,6,3,48,21,27,51
Rapid Vienna,4624,2,9,11,4,39,25,14,38
SK Sturm Gra,4624,3,11,4,9,29,31,-2,37
LASK Linz,4624,4,10,6,8,27,24,3,36
Mattersburg,4624,5,6,6,12,29,41,-12,24
Vienna,4624,6,6,5,13,26,43,-17,23
SC Rheindorf,4624,7,5,6,13,18,31,-13,21
FC Salzburg,4625,1,14,6,4,43,21,22,48
Rapid Vienna,4625,2,10,9,5,35,25,10,39
SK Sturm Gra,4625,3,11,3,10,31,31,0,36
SC Rheindorf,4625,4,8,5,11,23,25,-2,29
LASK Linz,4625,5,8,5,11,27,32,-5,29
Vienna,4625,6,8,5,11,28,38,-10,29
Mattersburg,4625,7,6,5,13,30,45,-15,23
FC Salzburg,4626,1,12,8,4,44,24,20,44
SK Sturm Gra,4626,2,11,6,7,33,31,2,39
Rapid Vienna,4626,3,9,9,6,36,28,8,36
LASK Linz,4626,4,10,6,8,32,30,2,36
Vienna,4626,5,7,6,11,28,40,-12,27
Mattersburg,4626,6,6,6,12,32,44,-12,24
SC Rheindorf,4626,7,5,7,12,20,28,-8,22
FC Salzburg,4627,1,15,7,2,52,20,32,52
Rapid Vienna,4627,2,9,10,5,39,32,7,37
SK Sturm Gra,4627,3,11,3,10,29,30,-1,36
LASK Linz,4627,4,9,6,9,28,25,3,33
Mattersburg,4627,5,8,5,11,31,44,-13,29
Vienna,4627,6,6,5,13,24,41,-17,23
SC Rheindorf,4627,7,5,6,13,19,30,-11,21
FC Salzburg,4628,1,14,6,4,46,18,28,48
SK Sturm Gra,4628,2,12,4,8,32,32,0,40
LASK Linz,4628,3,11,5,8,30,26,4,38
Rapid Vienna,4628,4,8,11,5,37,29,8,35
Mattersburg,4628,5,8,5,11,35,39,-4,29
Vienna,4628,6,6,5,13,23,42,-19,23
SC Rheindorf,4628,7,4,6,14,17,34,-17,18
FC Salzburg,4629,1,13,9,2,44,20,24,48
SK Sturm Gra,4629,2,14,4,6,35,28,7,46
Rapid Vienna,4629,3,8,9,7,37,30,7,33
LASK Linz,4629,4,8,6,10,29,29,0,30
Mattersburg,4629,5,6,7,11,31,39,-8,25
Vienna,4629,6,6,6,12,26,43,-17,24
SC Rheindorf,4629,7,6,5,13,18,31,-13,23
FC Salzburg,4630,1,14,8,2,45,16,29,50
SK Sturm Gra,4630,2,13,4,7,34,28,6,43
Rapid Vienna,4630,3,8,12,4,35,25,10,36
LASK Linz,4630,4,8,6,10,28,33,-5,30
Vienna,4630,5,7,5,12,25,41,-16,26
SC Rheindorf,4630,6,6,6,12,21,28,-7,24
Mattersburg,4630,7,5,5,14,27,44,-17,20
FC Salzburg,4631,1,14,7,3,49,21,28,49
SK Sturm Gra,4631,2,14,3,7,36,29,7,45
LASK Linz,4631,3,11,5,8,30,27,3,38
Rapid Vienna,4631,4,8,9,7,39,31,8,33
Vienna,4631,5,7,6,11,27,40,-13,27
SC Rheindorf,4631,6,5,5,14,18,33,-15,20
Mattersburg,4631,7,5,5,14,28,46,-18,20
FC Salzburg,4632,1,15,6,3,49,18,31,51
SK Sturm Gra,4632,2,13,4,7,33,28,5,43
Rapid Vienna,4632,3,8,10,6,35,30,5,34
LASK Linz,4632,4,8,8,8,26,26,0,32
Vienna,4632,5,7,5,12,26,41,-15,26
Mattersburg,4632,6,6,6,12,29,42,-13,24
SC Rheindorf,4632,7,4,7,13,17,30,-13,19
FC Salzburg,4633,1,15,7,2,43,17,26,52
SK Sturm Gra,4633,2,13,3,8,36,30,6,42
Rapid Vienna,4633,3,7,11,6,33,30,3,32
SC Rheindorf,4633,4,7,6,11,23,27,-4,27
LASK Linz,4633,5,7,6,11,24,30,-6,27
Mattersburg,4633,6,7,6,11,29,38,-9,27
Vienna,4633,7,6,5,13,24,40,-16,23
FC Salzburg,4634,1,14,7,3,48,20,28,49
SK Sturm Gra,4634,2,13,4,7,32,28,4,43
LASK Linz,4634,3,10,6,8,28,25,3,36
Rapid Vienna,4634,4,7,10,7,32,30,2,31
Vienna,4634,5,8,5,11,27,38,-11,29
SC Rheindorf,4634,6,6,5,13,23,31,-8,23
Mattersburg,4634,7,5,5,14,29,47,-18,20
FC Salzburg,4635,1,16,6,2,49,19,30,54
SK Sturm Gra,4635,2,13,4,7,36,28,8,43
LASK Linz,4635,3,9,5,10,27,32,-5,32
Rapid Vienna,4635,4,7,10,7,33,28,5,31
Vienna,4635,5,7,5,12,29,41,-12,26
SC Rheindorf,4635,6,6,5,13,20,30,-10,23
Mattersburg,4635,7,6,5,13,32,48,-16,23
FC Salzburg,4636,1,15,7,2,48,18,30,52
SK Sturm Gra,4636,2,12,5,7,31,26,5,41
Rapid Vienna,4636,3,9,10,5,41,29,12,37
Mattersburg,4636,4,8,5,11,38,47,-9,29
LASK Linz,4636,5,7,7,10,26,33,-7,28
Vienna,4636,6,6,5,13,26,43,-17,23
SC Rheindorf,4636,7,4,7,13,18,32,-14,19
FC Salzburg,4637,1,14,6,4,42,18,24,48
Rapid Vienna,4637,2,11,9,4,38,25,13,42
SK Sturm Gra,4637,3,11,5,8,32,31,1,38
LASK Linz,4637,4,7,7,10,25,29,-4,28
Mattersburg,4637,5,7,6,11,29,39,-10,27
Vienna,4637,6,6,6,12,25,40,-15,24
SC Rheindorf,4637,7,5,7,12,21,30,-9,22
FC Salzburg,4638,1,13,7,4,40,18,22,46
SK Sturm Gra,4638,2,13,5,6,35,26,9,44
Rapid Vienna,4638,3,10,10,4,38,26,12,40
LASK Linz,4638,4,8,5,11,29,35,-6,29
SC Rheindorf,4638,5,6,6,12,20,28,-8,24
Mattersburg,4638,6,6,6,12,30,43,-13,24
Vienna,4638,7,6,5,13,23,39,-16,23
FC Salzburg,4639,1,14,8,2,45,16,29,50
SK Sturm Gra,4639,2,12,4,8,31,30,1,40
Rapid Vienna,4639,3,8,11,5,34,27,7,35
LASK Linz,4639,4,8,7,9,27,27,0,31
Vienna,4639,5,7,6,11,26,39,-13,27
Mattersburg,4639,6,6,6,12,31,42,-11,24
SC Rheindorf,4639,7,5,6,13,17,30,-13,21
FC Salzburg,4640,1,14,7,3,42,17,25,49
SK Sturm Gra,4640,2,13,3,8,37,28,9,42
Rapid Vienna,4640,3,9,9,6,35,30,5,36
LASK Linz,4640,4,9,5,10,29,33,-4,32
SC Rheindorf,4640,5,7,5,12,21,28,-7,26
Vienna,4640,6,6,7,11,24,38,-14,25
Mattersburg,4640,7,5,6,13,28,42,-14,21
FC Salzburg,4641,1,14,8,2,47,19,28,50
SK Sturm Gra,4641,2,13,4,7,36,31,5,43
Rapid Vienna,4641,3,10,9,5,38,25,13,39
LASK Linz,4641,4,8,5,11,25,32,-7,29
Mattersburg,4641,5,8,5,11,35,44,-9,29
Vienna,4641,6,6,6,12,26,41,-15,24
SC Rheindorf,4641,7,4,5,15,15,30,-15,17
FC Salzburg,4642,1,15,7,2,46,17,29,52
SK Sturm Gra,4642,2,11,5,8,30,28,2,38
LASK Linz,4642,3,9,7,8,26,25,1,34
Rapid Vienna,4642,4,7,12,5,37,31,6,33
Vienna,4642,5,7,5,12,25,40,-15,26
Mattersburg,4642,6,6,7,11,28,39,-11,25
SC Rheindorf,4642,7,4,7,13,17,29,-12,19
FC Salzburg,4643,1,15,7,2,43,17,26,52
SK Sturm Gra,4643,2,12,6,6,31,26,5,42
Rapid Vienna,4643,3,8,10,6,32,25,7,34
LASK Linz,4643,4,8,6,10,25,28,-3,30
Vienna,4643,5,7,5,12,27,41,-14,26
SC Rheindorf,4643,6,6,6,12,21,27,-6,24
Mattersburg,4643,7,5,6,13,29,44,-15,21
FC Salzburg,4644,1,15,7,2,45,16,29,52
SK Sturm Gra,4644,2,14,3,7,33,28,5,45
Rapid Vienna,4644,3,9,9,6,39,28,11,36
LASK Linz,4644,4,7,7,10,26,31,-5,28
Vienna,4644,5,7,6,11,26,38,-12,27
Mattersburg,4644,6,5,7,12,26,40,-14,22
SC Rheindorf,4644,7,4,7,13,16,30,-14,19
FC Salzburg,4645,1,14,7,3,47,22,25,49
Rapid Vienna,4645,2,9,11,4,38,28,10,38
SK Sturm Gra,4645,3,11,5,8,33,32,1,38
LASK Linz,4645,4,10,6,8,28,25,3,36
Mattersburg,4645,5,6,5,13,30,44,-14,23
Vienna,4645,6,6,5,13,24,41,-17,23
SC Rheindorf,4645,7,5,7,12,20,28,-8,22
FC Salzburg,4646,1,14,7,3,46,21,25,49
SK Sturm Gra,4646,2,13,4,7,33,28,5,43
Rapid Vienna,4646,3,8,11,5,38,30,8,35
LASK Linz,4646,4,8,7,9,28,28,0,31
Vienna,4646,5,7,5,12,27,42,-15,26
SC Rheindorf,4646,6,5,7,12,20,29,-9,22
Mattersburg,4646,7,5,7,12,30,44,-14,22
FC Salzburg,4647,1,14,7,3,44,19,25,49
SK Sturm Gra,4647,2,12,3,9,32,31,1,39
Rapid Vienna,4647,3,8,11,5,36,28,8,35
LASK Linz,4647,4,9,6,9,27,26,1,33
Vienna,4647,5,7,6,11,25,38,-13,27
Mattersburg,4647,6,7,5,12,29,41,-12,26
SC Rheindorf,4647,7,5,6,13,18,28,-10,21
FC Salzburg,4648,1,15,6,3,47,17,30,51
Rapid Vienna,4648,2,10,9,5,40,29,11,39
LASK Linz,4648,3,11,5,8,31,26,5,38
SK Sturm Gra,4648,4,11,3,10,29,30,-1,36
Vienna,4648,5,7,5,12,24,39,-15,26
SC Rheindorf,4648,6,5,6,13,18,31,-13,21
Mattersburg,4648,7,5,6,13,26,43,-17,21
FC Salzburg,4649,1,16,6,2,47,18,29,54
SK Sturm Gra,4649,2,12,5,7,31,27,4,41
Rapid Vienna,4649,3,8,9,7,35,28,7,33
LASK Linz,4649,4,8,6,10,26,31,-5,30
Mattersburg,4649,5,7,5,12,35,43,-8,26
Vienna,4649,6,7,5,12,26,41,-15,26
SC Rheindorf,4649,7,5,6,13,18,30,-12,21
FC Salzburg,4650,1,15,6,3,45,17,28,51
SK Sturm Gra,4650,2,11,5,8,31,32,-1,38
Rapid Vienna,4650,3,8,12,4,36,27,9,36
LASK Linz,4650,4,7,8,9,27,31,-4,29
Vienna,4650,5,7,5,12,27,40,-13,26
SC Rheindorf,4650,6,6,6,12,26,30,-4,24
Mattersburg,4650,7,6,6,12,30,45,-15,24
FC Salzburg,4651,1,14,7,3,43,18,25,49
SK Sturm Gra,4651,2,12,4,8,33,32,1,40
Rapid Vienna,4651,3,10,9,5,38,27,11,39
LASK Linz,4651,4,9,5,10,29,29,0,32
Vienna,4651,5,7,5,12,26,40,-14,26
SC Rheindorf,4651,6,5,7,12,19,28,-9,22
Mattersburg,4651,7,5,7,12,28,42,-14,22
FC Salzburg,4652,1,14,8,2,44,17,27,50
SK Sturm Gra,4652,2,14,3,7,33,28,5,45
Rapid Vienna,4652,3,7,11,6,32,28,4,32
LASK Linz,4652,4,8,6,10,29,29,0,30
Mattersburg,4652,5,6,7,11,33,39,-6,25
Vienna,4652,6,6,7,11,24,38,-14,25
SC Rheindorf,4652,7,5,6,13,16,32,-16,21
FC Salzburg,4653,1,14,8,2,43,16,27,50
Rapid Vienna,4653,2,9,10,5,35,24,11,37
SK Sturm Gra,4653,3,11,4,9,30,32,-2,37
LASK Linz,4653,4,8,7,9,24,27,-3,31
Mattersburg,4653,5,7,6,11,33,40,-7,27
Vienna,4653,6,6,6,12,25,40,-15,24
SC Rheindorf,4653,7,5,7,12,18,29,-11,22
FC Salzburg,4654,1,14,7,3,43,19,24,49
Rapid Vienna,4654,2,10,10,4,38,27,11,40
SK Sturm Gra,4654,3,12,3,9,34,32,2,39
Mattersburg,4654,4,9,5,10,33,39,-6,32
LASK Linz,4654,5,8,5,11,29,30,-1,29
Vienna,4654,6,6,5,13,24,40,-16,23
SC Rheindorf,4654,7,5,5,14,19,33,-14,20
FC Salzburg,4655,1,14,8,2,41,16,25,50
SK Sturm Gra,4655,2,13,3,8,33,26,7,42
Rapid Vienna,4655,3,9,9,6,35,26,9,36
LASK Linz,4655,4,9,5,10,26,32,-6,32
Mattersburg,4655,5,6,7,11,31,40,-9,25
Vienna,4655,6,6,7,11,25,39,-14,25
SC Rheindorf,4655,7,5,5,14,18,30,-12,20
FC Salzburg,4656,1,13,9,2,43,17,26,48
Rapid Vienna,4656,2,9,10,5,35,26,9,37
SK Sturm Gra,4656,3,11,4,9,28,30,-2,37
LASK Linz,4656,4,8,8,8,25,25,0,32
Mattersburg,4656,5,7,7,10,33,40,-7,28
Vienna,4656,6,6,6,12,25,41,-16,24
SC Rheindorf,4656,7,5,6,13,20,30,-10,21
FC Salzburg,4657,1,13,8,3,44,19,25,47
SK Sturm Gra,4657,2,13,4,7,32,28,4,43
Rapid Vienna,4657,3,11,9,4,44,26,18,42
LASK Linz,4657,4,8,5,11,26,33,-7,29
Mattersburg,4657,5,6,7,11,33,41,-8,25
Vienna,4657,6,6,6,12,27,44,-17,24
SC Rheindorf,4657,7,5,5,14,18,33,-15,20
FC Salzburg,4658,1,14,7,3,44,19,25,49
SK Sturm Gra,4658,2,12,5,7,32,28,4,41
Rapid Vienna,4658,3,9,9,6,39,31,8,36
LASK Linz,4658,4,7,6,11,25,30,-5,27
Mattersburg,4658,5,7,6,11,32,41,-9,27
Vienna,4658,6,7,5,12,27,41,-14,26
SC Rheindorf,4658,7,6,6,12,23,32,-9,24
FC Salzburg,4659,1,13,8,3,42,19,23,47
SK Sturm Gra,4659,2,13,4,7,33,28,5,43
Rapid Vienna,4659,3,7,11,6,33,28,5,32
LASK Linz,4659,4,8,7,9,27,28,-1,31
Vienna,4659,5,7,6,11,27,39,-12,27
SC Rheindorf,4659,6,6,6,12,22,31,-9,24
Mattersburg,4659,7,5,8,11,30,41,-11,23
FC Salzburg,4660,1,15,6,3,44,19,25,51
SK Sturm Gra,4660,2,12,3,9,32,30,2,39
Rapid Vienna,4660,3,8,10,6,35,29,6,34
LASK Linz,4660,4,9,6,9,29,29,0,33
Vienna,4660,5,7,5,12,26,39,-13,26
Mattersburg,4660,6,6,7,11,31,41,-10,25
SC Rheindorf,4660,7,5,7,12,20,30,-10,22
FC Salzburg,4661,1,14,7,3,43,17,26,49
SK Sturm Gra,4661,2,14,3,7,37,32,5,45
Rapid Vienna,4661,3,9,10,5,38,29,9,37
LASK Linz,4661,4,8,6,10,28,31,-3,30
Vienna,4661,5,7,6,11,25,38,-13,27
Mattersburg,4661,6,6,5,13,28,41,-13,23
SC Rheindorf,4661,7,5,5,14,20,31,-11,20
FC Salzburg,4662,1,16,6,2,48,18,30,54
SK Sturm Gra,4662,2,12,3,9,30,33,-3,39
Rapid Vienna,4662,3,9,9,6,37,27,10,36
LASK Linz,4662,4,9,5,10,27,27,0,32
Mattersburg,4662,5,7,5,12,32,42,-10,26
Vienna,4662,6,7,5,12,25,40,-15,26
SC Rheindorf,4662,7,5,5,14,19,31,-12,20
FC Salzburg,4663,1,14,6,4,44,23,21,48
SK Sturm Gra,4663,2,12,4,8,33,31,2,40
Rapid Vienna,4663,3,8,12,4,37,26,11,36
LASK Linz,4663,4,8,6,10,27,29,-2,30
Vienna,4663,5,7,5,12,27,40,-13,26
SC Rheindorf,4663,6,6,7,11,21,29,-8,25
Mattersburg,4663,7,6,6,12,30,41,-11,24
FC Salzburg,4664,1,14,6,4,44,19,25,48
SK Sturm Gra,4664,2,14,3,7,34,30,4,45
Rapid Vienna,4664,3,9,9,6,37,27,10,36
LASK Linz,4664,4,8,6,10,31,33,-2,30
SC Rheindorf,4664,5,7,5,12,24,31,-7,26
Vienna,4664,6,7,5,12,26,40,-14,26
Mattersburg,4664,7,5,6,13,34,50,-16,21
FC Salzburg,4665,1,14,6,4,41,20,21,48
SK Sturm Gra,4665,2,12,5,7,31,27,4,41
Rapid Vienna,4665,3,9,10,5,35,25,10,37
LASK Linz,4665,4,8,7,9,27,28,-1,31
Vienna,4665,5,7,5,12,26,39,-13,26
SC Rheindorf,4665,6,6,6,12,19,27,-8,24
Mattersburg,4665,7,5,7,12,30,43,-13,22
FC Salzburg,4666,1,12,9,3,40,19,21,45
SK Sturm Gra,4666,2,13,4,7,31,26,5,43
Rapid Vienna,4666,3,9,9,6,36,27,9,36
LASK Linz,4666,4,10,5,9,29,27,2,35
Mattersburg,4666,5,6,6,12,30,43,-13,24
Vienna,4666,6,6,6,12,24,39,-15,24
SC Rheindorf,4666,7,6,5,13,19,28,-9,23
FC Salzburg,4667,1,14,6,4,44,20,24,48
SK Sturm Gra,4667,2,11,4,9,30,30,0,37
Rapid Vienna,4667,3,8,11,5,37,30,7,35
Mattersburg,4667,4,8,6,10,32,39,-7,30
LASK Linz,4667,5,8,5,11,27,30,-3,29
Vienna,4667,6,7,6,11,26,38,-12,27
SC Rheindorf,4667,7,6,6,12,19,28,-9,24
FC Salzburg,4668,1,14,6,4,44,17,27,48
SK Sturm Gra,4668,2,13,3,8,35,28,7,42
Rapid Vienna,4668,3,9,10,5,35,27,8,37
LASK Linz,4668,4,8,6,10,29,32,-3,30
Vienna,4668,5,8,5,11,26,38,-12,29
SC Rheindorf,4668,6,5,7,12,22,33,-11,22
Mattersburg,4668,7,5,7,12,29,45,-16,22
FC Salzburg,4669,1,14,8,2,44,17,27,50
Rapid Vienna,4669,2,9,11,4,37,25,12,38
SK Sturm Gra,4669,3,11,5,8,30,29,1,38
LASK Linz,4669,4,8,8,8,27,27,0,32
Vienna,4669,5,7,5,12,25,40,-15,26
SC Rheindorf,4669,6,5,7,12,20,30,-10,22
Mattersburg,4669,7,5,6,13,28,43,-15,21
FC Salzburg,4670,1,13,7,4,44,21,23,46
SK Sturm Gra,4670,2,13,4,7,33,27,6,43
Rapid Vienna,4670,3,10,9,5,39,28,11,39
LASK Linz,4670,4,8,6,10,27,29,-2,30
Vienna,4670,5,8,5,11,26,37,-11,29
SC Rheindorf,4670,6,6,5,13,23,32,-9,23
Mattersburg,4670,7,5,6,13,28,46,-18,21
FC Salzburg,4671,1,13,7,4,41,19,22,46
SK Sturm Gra,4671,2,13,4,7,32,26,6,43
Rapid Vienna,4671,3,8,11,5,36,29,7,35
LASK Linz,4671,4,9,6,9,28,27,1,33
Mattersburg,4671,5,8,5,11,37,40,-3,29
Vienna,4671,6,7,5,12,24,39,-15,26
SC Rheindorf,4671,7,4,6,14,19,37,-18,18
FC Salzburg,4672,1,14,7,3,43,19,24,49
SK Sturm Gra,4672,2,12,5,7,35,31,4,41
Rapid Vienna,4672,3,10,9,5,39,28,11,39
LASK Linz,4672,4,8,5,11,28,32,-4,29
Vienna,4672,5,7,5,12,26,39,-13,26
Mattersburg,4672,6,6,6,12,29,41,-12,24
SC Rheindorf,4672,7,5,7,12,20,30,-10,22
FC Salzburg,4673,1,15,6,3,45,18,27,51
SK Sturm Gra,4673,2,13,3,8,34,29,5,42
Rapid Vienna,4673,3,10,10,4,38,25,13,40
LASK Linz,4673,4,8,7,9,27,30,-3,31
Mattersburg,4673,5,7,5,12,30,40,-10,26
Vienna,4673,6,6,5,13,23,40,-17,23
SC Rheindorf,4673,7,4,6,14,15,30,-15,18
FC Salzburg,4674,1,13,7,4,43,21,22,46
SK Sturm Gra,4674,2,13,4,7,35,31,4,43
Rapid Vienna,4674,3,8,11,5,33,24,9,35
LASK Linz,4674,4,8,5,11,26,30,-4,29
Vienna,4674,5,7,6,11,25,38,-13,27
Mattersburg,4674,6,6,7,11,27,38,-11,25
SC Rheindorf,4674,7,6,6,12,21,28,-7,24
FC Salzburg,4675,1,14,7,3,45,18,27,49
SK Sturm Gra,4675,2,12,5,7,34,31,3,41
Rapid Vienna,4675,3,8,11,5,36,29,7,35
LASK Linz,4675,4,7,6,11,27,33,-6,27
Mattersburg,4675,5,7,5,12,33,42,-9,26
Vienna,4675,6,7,5,12,25,40,-15,26
SC Rheindorf,4675,7,6,7,11,24,31,-7,25
FC Salzburg,4676,1,15,6,3,48,20,28,51
SK Sturm Gra,4676,2,12,5,7,36,31,5,41
Rapid Vienna,4676,3,9,10,5,36,27,9,37
LASK Linz,4676,4,8,7,9,26,28,-2,31
Vienna,4676,5,7,5,12,25,41,-16,26
Mattersburg,4676,6,6,5,13,31,44,-13,23
SC Rheindorf,4676,7,5,6,13,22,33,-11,21
FC Salzburg,4677,1,13,9,2,43,18,25,48
SK Sturm Gra,4677,2,13,5,6,33,25,8,44
Rapid Vienna,4677,3,9,10,5,39,27,12,37
Mattersburg,4677,4,7,6,11,31,39,-8,27
Vienna,4677,5,7,6,11,26,39,-13,27
LASK Linz,4677,6,7,5,12,23,28,-5,26
SC Rheindorf,4677,7,5,5,14,16,35,-19,20
FC Salzburg,4678,1,14,6,4,46,21,25,48
SK Sturm Gra,4678,2,12,3,9,33,30,3,39
Rapid Vienna,4678,3,9,10,5,35,28,7,37
Vienna,4678,4,8,5,11,30,39,-9,29
SC Rheindorf,4678,5,7,6,11,22,27,-5,27
LASK Linz,4678,6,7,5,12,24,32,-8,26
Mattersburg,4678,7,7,5,12,33,46,-13,26
FC Salzburg,4679,1,15,7,2,54,17,37,52
SK Sturm Gra,4679,2,12,3,9,30,34,-4,39
Rapid Vienna,4679,3,9,10,5,36,27,9,37
Vienna,4679,4,7,6,11,27,38,-11,27
LASK Linz,4679,5,7,5,12,24,31,-7,26
SC Rheindorf,4679,6,6,7,11,20,26,-6,25
Mattersburg,4679,7,6,6,12,28,46,-18,24
FC Salzburg,4680,1,15,6,3,48,20,28,51
SK Sturm Gra,4680,2,13,4,7,33,27,6,43
Rapid Vienna,4680,3,10,9,5,37,25,12,39
LASK Linz,4680,4,8,5,11,26,32,-6,29
Vienna,4680,5,7,5,12,29,44,-15,26
SC Rheindorf,4680,6,5,7,12,18,28,-10,22
Mattersburg,4680,7,5,6,13,31,46,-15,21
FC Salzburg,4681,1,15,6,3,46,21,25,51
SK Sturm Gra,4681,2,12,4,8,32,29,3,40
Rapid Vienna,4681,3,9,9,6,36,26,10,36
LASK Linz,4681,4,9,5,10,31,30,1,32
Vienna,4681,5,7,5,12,26,41,-15,26
SC Rheindorf,4681,6,6,6,12,21,32,-11,24
Mattersburg,4681,7,6,5,13,31,44,-13,23
FC Salzburg,4682,1,16,6,2,49,19,30,54
SK Sturm Gra,4682,2,12,4,8,34,29,5,40
Rapid Vienna,4682,3,7,11,6,34,29,5,32
LASK Linz,4682,4,9,5,10,29,33,-4,32
SC Rheindorf,4682,5,6,7,11,21,27,-6,25
Mattersburg,4682,6,6,6,12,31,42,-11,24
Vienna,4682,7,6,5,13,23,42,-19,23
FC Salzburg,4683,1,15,7,2,46,17,29,52
SK Sturm Gra,4683,2,13,3,8,33,30,3,42
Rapid Vienna,4683,3,8,9,7,35,32,3,33
LASK Linz,4683,4,8,6,10,28,30,-2,30
SC Rheindorf,4683,5,7,6,11,19,25,-6,27
Mattersburg,4683,6,6,6,12,31,41,-10,24
Vienna,4683,7,6,5,13,24,41,-17,23
FC Salzburg,4684,1,13,8,3,42,18,24,47
SK Sturm Gra,4684,2,12,4,8,30,29,1,40
Rapid Vienna,4684,3,10,9,5,40,27,13,39
LASK Linz,4684,4,9,5,10,28,29,-1,32
Mattersburg,4684,5,7,6,11,33,42,-9,27
Vienna,4684,6,6,6,12,24,39,-15,24
SC Rheindorf,4684,7,5,6,13,18,31,-13,21
FC Salzburg,4685,1,14,6,4,41,20,21,48
SK Sturm Gra,4685,2,12,5,7,31,26,5,41
Rapid Vienna,4685,3,9,10,5,36,26,10,37
LASK Linz,4685,4,8,6,10,27,32,-5,30
Mattersburg,4685,5,8,5,11,38,39,-1,29
Vienna,4685,6,6,5,13,24,43,-19,23
SC Rheindorf,4685,7,5,7,12,20,31,-11,22
FC Salzburg,4686,1,13,8,3,43,18,25,47
SK Sturm Gra,4686,2,12,6,6,31,26,5,42
Rapid Vienna,4686,3,8,11,5,35,27,8,35
LASK Linz,4686,4,8,8,8,29,29,0,32
Vienna,4686,5,6,7,11,24,38,-14,25
SC Rheindorf,4686,6,5,7,12,19,29,-10,22
Mattersburg,4686,7,5,7,12,28,42,-14,22
FC Salzburg,4687,1,13,7,4,44,21,23,46
SK Sturm Gra,4687,2,13,3,8,34,27,7,42
Rapid Vienna,4687,3,9,9,6,38,31,7,36
LASK Linz,4687,4,8,6,10,27,30,-3,30
Vienna,4687,5,8,5,11,29,39,-10,29
Mattersburg,4687,6,7,6,11,34,45,-11,27
SC Rheindorf,4687,7,5,6,13,19,32,-13,21
FC Salzburg,4688,1,16,6,2,51,17,34,54
SK Sturm Gra,4688,2,11,3,10,30,34,-4,36
LASK Linz,4688,3,10,5,9,32,29,3,35
Rapid Vienna,4688,4,8,10,6,35,30,5,34
SC Rheindorf,4688,5,7,6,11,23,29,-6,27
Vienna,4688,6,6,6,12,27,44,-17,24
Mattersburg,4688,7,5,6,13,31,46,-15,21
FC Salzburg,4689,1,14,7,3,46,21,25,49
SK Sturm Gra,4689,2,13,4,7,34,29,5,43
Rapid Vienna,4689,3,7,12,5,35,28,7,33
LASK Linz,4689,4,8,7,9,26,27,-1,31
Mattersburg,4689,5,7,6,11,32,39,-7,27
Vienna,4689,6,7,5,12,26,41,-15,26
SC Rheindorf,4689,7,5,5,14,18,32,-14,20
FC Salzburg,4690,1,16,6,2,48,15,33,54
SK Sturm Gra,4690,2,12,4,8,32,30,2,40
Rapid Vienna,4690,3,8,10,6,33,28,5,34
LASK Linz,4690,4,8,7,9,28,27,1,31
Vienna,4690,5,7,5,12,25,41,-16,26
Mattersburg,4690,6,6,6,12,29,43,-14,24
SC Rheindorf,4690,7,5,6,13,17,28,-11,21
FC Salzburg,4691,1,14,6,4,46,23,23,48
SK Sturm Gra,4691,2,12,4,8,33,29,4,40
Rapid Vienna,4691,3,8,11,5,36,29,7,35
LASK Linz,4691,4,8,7,9,28,29,-1,31
Vienna,4691,5,7,5,12,27,40,-13,26
SC Rheindorf,4691,6,6,7,11,22,29,-7,25
Mattersburg,4691,7,6,6,12,31,44,-13,24
FC Salzburg,4692,1,13,7,4,46,23,23,46
SK Sturm Gra,4692,2,13,4,7,34,29,5,43
Rapid Vienna,4692,3,7,11,6,34,28,6,32
LASK Linz,4692,4,8,6,10,28,30,-2,30
Mattersburg,4692,5,7,6,11,34,43,-9,27
Vienna,4692,6,7,5,12,26,41,-15,26
SC Rheindorf,4692,7,6,7,11,19,27,-8,25
FC Salzburg,4693,1,15,6,3,46,20,26,51
Rapid Vienna,4693,2,10,9,5,39,27,12,39
SK Sturm Gra,4693,3,11,3,10,29,35,-6,36
LASK Linz,4693,4,8,6,10,26,28,-2,30
Vienna,4693,5,7,5,12,27,41,-14,26
Mattersburg,4693,6,6,7,11,31,40,-9,25
SC Rheindorf,4693,7,6,6,12,19,26,-7,24
FC Salzburg,4694,1,14,7,3,46,20,26,49
SK Sturm Gra,4694,2,11,5,8,32,32,0,38
Rapid Vienna,4694,3,8,11,5,35,27,8,35
LASK Linz,4694,4,8,8,8,28,28,0,32
Vienna,4694,5,8,5,11,27,38,-11,29
SC Rheindorf,4694,6,5,7,12,18,28,-10,22
Mattersburg,4694,7,5,7,12,28,41,-13,22
FC Salzburg,4695,1,14,7,3,46,17,29,49
Rapid Vienna,4695,2,11,9,4,37,25,12,42
SK Sturm Gra,4695,3,12,3,9,31,31,0,39
LASK Linz,4695,4,7,7,10,27,30,-3,28
Vienna,4695,5,6,7,11,23,37,-14,25
Mattersburg,4695,6,5,8,11,31,45,-14,23
SC Rheindorf,4695,7,5,7,12,20,30,-10,22
FC Salzburg,4696,1,15,7,2,44,16,28,52
Rapid Vienna,4696,2,10,9,5,37,28,9,39
SK Sturm Gra,4696,3,12,3,9,30,31,-1,39
LASK Linz,4696,4,8,6,10,29,30,-1,30
Mattersburg,4696,5,6,6,12,33,43,-10,24
Vienna,4696,6,6,6,12,23,39,-16,24
SC Rheindorf,4696,7,6,5,13,23,32,-9,23
FC Salzburg,4697,1,14,6,4,46,22,24,48
SK Sturm Gra,4697,2,13,3,8,32,29,3,42
Rapid Vienna,4697,3,9,9,6,38,30,8,36
Vienna,4697,4,8,5,11,27,38,-11,29
Mattersburg,4697,5,7,6,11,30,39,-9,27
LASK Linz,4697,6,7,5,12,25,32,-7,26
SC Rheindorf,4697,7,6,6,12,20,28,-8,24
FC Salzburg,4698,1,13,8,3,42,20,22,47
SK Sturm Gra,4698,2,13,4,7,34,28,6,43
Rapid Vienna,4698,3,8,10,6,39,27,12,34
LASK Linz,4698,4,9,6,9,28,29,-1,33
Vienna,4698,5,7,5,12,27,40,-13,26
Mattersburg,4698,6,6,7,11,30,40,-10,25
SC Rheindorf,4698,7,4,8,12,19,35,-16,20
FC Salzburg,4699,1,15,7,2,50,22,28,52
SK Sturm Gra,4699,2,13,4,7,33,27,6,43
Rapid Vienna,4699,3,9,11,4,40,29,11,38
LASK Linz,4699,4,7,6,11,25,35,-10,27
Mattersburg,4699,5,7,5,12,37,44,-7,26
Vienna,4699,6,6,5,13,25,42,-17,23
SC Rheindorf,4699,7,5,6,13,19,30,-11,21
FC Salzburg,4700,1,16,6,2,49,17,32,54
SK Sturm Gra,4700,2,11,6,7,31,30,1,39
LASK Linz,4700,3,9,7,8,29,27,2,34
Rapid Vienna,4700,4,7,11,6,33,30,3,32
Mattersburg,4700,5,6,6,12,33,44,-11,24
Vienna,4700,6,6,5,13,25,42,-17,23
SC Rheindorf,4700,7,5,7,12,20,30,-10,22
FC Salzburg,4701,1,14,7,3,47,22,25,49
SK Sturm Gra,4701,2,12,5,7,35,30,5,41
Rapid Vienna,4701,3,8,10,6,37,31,6,34
LASK Linz,4701,4,8,7,9,29,30,-1,31
Mattersburg,4701,5,8,5,11,35,42,-7,29
Vienna,4701,6,6,6,12,27,42,-15,24
SC Rheindorf,4701,7,5,6,13,20,33,-13,21
FC Salzburg,4702,1,15,7,2,43,16,27,52
SK Sturm Gra,4702,2,11,6,7,30,27,3,39
Rapid Vienna,4702,3,8,11,5,35,26,9,35
LASK Linz,4702,4,8,7,9,27,29,-2,31
Vienna,4702,5,7,5,12,27,39,-12,26
SC Rheindorf,4702,6,5,8,11,21,30,-9,23
Mattersburg,4702,7,5,6,13,28,44,-16,21
FC Salzburg,4703,1,16,6,2,47,18,29,54
SK Sturm Gra,4703,2,14,3,7,33,27,6,45
Rapid Vienna,4703,3,7,11,6,34,28,6,32
LASK Linz,4703,4,8,6,10,26,28,-2,30
Mattersburg,4703,5,7,5,12,32,40,-8,26
Vienna,4703,6,7,5,12,26,40,-14,26
SC Rheindorf,4703,7,4,6,14,16,33,-17,18
FC Salzburg,4704,1,15,7,2,48,19,29,52
SK Sturm Gra,4704,2,12,4,8,35,30,5,40
LASK Linz,4704,3,10,5,9,26,29,-3,35
Rapid Vienna,4704,4,7,11,6,34,28,6,32
SC Rheindorf,4704,5,7,5,12,19,27,-8,26
Mattersburg,4704,6,6,5,13,29,42,-13,23
Vienna,4704,7,6,5,13,25,41,-16,23
FC Salzburg,4705,1,15,7,2,45,17,28,52
SK Sturm Gra,4705,2,11,4,9,32,32,0,37
Rapid Vienna,4705,3,8,11,5,37,30,7,35
LASK Linz,4705,4,9,7,8,32,29,3,34
Mattersburg,4705,5,6,7,11,30,42,-12,25
Vienna,4705,6,6,6,12,24,39,-15,24
SC Rheindorf,4705,7,4,8,12,21,32,-11,20
FC Salzburg,4706,1,14,7,3,47,19,28,49
SK Sturm Gra,4706,2,13,3,8,32,32,0,42
Rapid Vienna,4706,3,10,9,5,39,28,11,39
LASK Linz,4706,4,8,6,10,25,27,-2,30
Mattersburg,4706,5,6,6,12,32,43,-11,24
Vienna,4706,6,6,6,12,27,43,-16,24
SC Rheindorf,4706,7,6,5,13,19,29,-10,23
FC Salzburg,4707,1,15,7,2,47,18,29,52
SK Sturm Gra,4707,2,13,4,7,35,30,5,43
Rapid Vienna,4707,3,7,10,7,33,29,4,31
LASK Linz,4707,4,8,7,9,30,31,-1,31
Mattersburg,4707,5,7,7,10,35,41,-6,28
Vienna,4707,6,6,5,13,24,41,-17,23
SC Rheindorf,4707,7,5,6,13,18,32,-14,21
FC Salzburg,4708,1,15,6,3,48,21,27,51
SK Sturm Gra,4708,2,12,3,9,34,32,2,39
Rapid Vienna,4708,3,9,9,6,38,32,6,36
LASK Linz,4708,4,9,6,9,29,28,1,33
Vienna,4708,5,8,5,11,28,38,-10,29
Mattersburg,4708,6,6,5,13,31,43,-12,23
SC Rheindorf,4708,7,5,6,13,20,34,-14,21
FC Salzburg,4709,1,13,8,3,42,19,23,47
Rapid Vienna,4709,2,10,10,4,39,26,13,40
SK Sturm Gra,4709,3,12,4,8,31,29,2,40
LASK Linz,4709,4,9,7,8,29,28,1,34
Vienna,4709,5,7,6,11,25,38,-13,27
Mattersburg,4709,6,6,6,12,30,41,-11,24
SC Rheindorf,4709,7,4,5,15,17,32,-15,17
FC Salzburg,4710,1,15,6,3,50,21,29,51
SK Sturm Gra,4710,2,13,4,7,35,30,5,43
Rapid Vienna,4710,3,9,9,6,37,31,6,36
Mattersburg,4710,4,7,6,11,34,45,-11,27
LASK Linz,4710,5,7,5,12,24,29,-5,26
SC Rheindorf,4710,6,6,6,12,21,28,-7,24
Vienna,4710,7,6,6,12,26,43,-17,24
FC Salzburg,4711,1,14,7,3,44,19,25,49
SK Sturm Gra,4711,2,12,5,7,30,27,3,41
Rapid Vienna,4711,3,9,11,4,35,24,11,38
LASK Linz,4711,4,8,6,10,26,28,-2,30
Mattersburg,4711,5,6,7,11,30,41,-11,25
Vienna,4711,6,6,6,12,24,39,-15,24
SC Rheindorf,4711,7,4,8,12,17,28,-11,20
FC Salzburg,4712,1,14,7,3,44,19,25,49
SK Sturm Gra,4712,2,13,3,8,33,30,3,42
Rapid Vienna,4712,3,8,9,7,36,31,5,33
LASK Linz,4712,4,9,6,9,29,28,1,33
SC Rheindorf,4712,5,6,7,11,21,29,-8,25
Mattersburg,4712,6,6,6,12,32,42,-10,24
Vienna,4712,7,6,6,12,26,42,-16,24
FC Salzburg,4713,1,14,6,4,43,22,21,48
Rapid Vienna,4713,2,9,10,5,37,29,8,37
SK Sturm Gra,4713,3,11,4,9,32,33,-1,37
LASK Linz,4713,4,10,5,9,33,27,6,35
Mattersburg,4713,5,8,5,11,34,41,-7,29
Vienna,4713,6,7,5,12,26,40,-14,26
SC Rheindorf,4713,7,5,5,14,21,34,-13,20
FC Salzburg,4714,1,13,8,3,44,21,23,47
SK Sturm Gra,4714,2,12,4,8,32,30,2,40
Rapid Vienna,4714,3,9,10,5,37,28,9,37
LASK Linz,4714,4,10,5,9,30,27,3,35
Mattersburg,4714,5,8,5,11,32,40,-8,29
Vienna,4714,6,6,6,12,24,39,-15,24
SC Rheindorf,4714,7,4,6,14,16,30,-14,18
FC Salzburg,4715,1,14,7,3,46,19,27,49
SK Sturm Gra,4715,2,12,5,7,32,32,0,41
Rapid Vienna,4715,3,8,9,7,34,29,5,33
LASK Linz,4715,4,8,7,9,27,27,0,31
Mattersburg,4715,5,7,6,11,33,42,-9,27
SC Rheindorf,4715,6,6,7,11,21,25,-4,25
Vienna,4715,7,6,5,13,23,42,-19,23
FC Salzburg,4716,1,13,8,3,43,20,23,47
SK Sturm Gra,4716,2,12,4,8,34,30,4,40
Rapid Vienna,4716,3,9,10,5,36,30,6,37
LASK Linz,4716,4,8,8,8,30,27,3,32
Vienna,4716,5,8,5,11,26,38,-12,29
Mattersburg,4716,6,6,7,11,30,40,-10,25
SC Rheindorf,4716,7,4,6,14,19,33,-14,18
FC Salzburg,4717,1,14,8,2,45,20,25,50
SK Sturm Gra,4717,2,12,5,7,36,32,4,41
Rapid Vienna,4717,3,8,10,6,37,28,9,34
LASK Linz,4717,4,9,6,9,28,30,-2,33
Vienna,4717,5,6,7,11,24,38,-14,25
SC Rheindorf,4717,6,5,8,11,21,30,-9,23
Mattersburg,4717,7,5,6,13,30,43,-13,21
FC Salzburg,4718,1,14,7,3,44,18,26,49
SK Sturm Gra,4718,2,13,3,8,36,29,7,42
Rapid Vienna,4718,3,7,9,8,33,34,-1,30
LASK Linz,4718,4,8,6,10,26,28,-2,30
SC Rheindorf,4718,5,8,5,11,21,26,-5,29
Vienna,4718,6,7,6,11,28,39,-11,27
Mattersburg,4718,7,6,6,12,31,45,-14,24
FC Salzburg,4719,1,15,7,2,43,16,27,52
SK Sturm Gra,4719,2,12,4,8,31,28,3,40
Rapid Vienna,4719,3,9,10,5,37,25,12,37
LASK Linz,4719,4,7,7,10,24,27,-3,28
Mattersburg,4719,5,6,8,10,32,39,-7,26
Vienna,4719,6,6,5,13,23,42,-19,23
SC Rheindorf,4719,7,5,7,12,20,33,-13,22
FC Salzburg,4720,1,13,8,3,45,23,22,47
SK Sturm Gra,4720,2,12,6,6,33,28,5,42
Rapid Vienna,4720,3,10,10,4,43,27,16,40
LASK Linz,4720,4,8,5,11,28,32,-4,29
Mattersburg,4720,5,6,7,11,35,44,-9,25
Vienna,4720,6,6,5,13,25,43,-18,23
SC Rheindorf,4720,7,5,7,12,19,31,-12,22
FC Salzburg,4721,1,16,6,2,53,16,37,54
SK Sturm Gra,4721,2,13,4,7,34,31,3,43
LASK Linz,4721,3,10,5,9,29,27,2,35
Rapid Vienna,4721,4,7,10,7,32,30,2,31
Mattersburg,4721,5,6,6,12,29,42,-13,24
Vienna,4721,6,6,6,12,26,43,-17,24
SC Rheindorf,4721,7,5,5,14,18,32,-14,20
FC Salzburg,4722,1,14,7,3,43,18,25,49
SK Sturm Gra,4722,2,13,4,7,35,31,4,43
Rapid Vienna,4722,3,7,10,7,32,30,2,31
LASK Linz,4722,4,8,6,10,30,31,-1,30
Mattersburg,4722,5,7,6,11,30,39,-9,27
SC Rheindorf,4722,6,6,7,11,21,27,-6,25
Vienna,4722,7,6,6,12,24,39,-15,24
FC Salzburg,4723,1,16,6,2,49,17,32,54
SK Sturm Gra,4723,2,14,3,7,32,26,6,45
Rapid Vienna,4723,3,8,9,7,32,28,4,33
LASK Linz,4723,4,8,5,11,25,28,-3,29
Vienna,4723,5,7,5,12,27,41,-14,26
Mattersburg,4723,6,6,6,12,32,46,-14,24
SC Rheindorf,4723,7,5,6,13,19,30,-11,21
FC Salzburg,4724,1,16,6,2,48,18,30,54
SK Sturm Gra,4724,2,11,5,8,32,31,1,38
Rapid Vienna,4724,3,9,10,5,38,28,10,37
LASK Linz,4724,4,7,9,8,29,30,-1,30
Mattersburg,4724,5,7,6,11,32,42,-10,27
Vienna,4724,6,6,5,13,26,43,-17,23
SC Rheindorf,4724,7,4,7,13,18,31,-13,19
FC Salzburg,4725,1,14,7,3,42,16,26,49
SK Sturm Gra,4725,2,13,4,7,31,26,5,43
Rapid Vienna,4725,3,9,9,6,33,28,5,36
LASK Linz,4725,4,9,5,10,30,28,2,32
Mattersburg,4725,5,7,6,11,35,44,-9,27
Vienna,4725,6,6,6,12,27,44,-17,24
SC Rheindorf,4725,7,5,5,14,17,29,-12,20
FC Salzburg,4726,1,15,6,3,43,18,25,51
Rapid Vienna,4726,2,9,10,5,33,24,9,37
SK Sturm Gra,4726,3,11,3,10,30,32,-2,36
LASK Linz,4726,4,9,6,9,27,26,1,33
Vienna,4726,5,8,5,11,27,38,-11,29
Mattersburg,4726,6,7,5,12,30,39,-9,26
SC Rheindorf,4726,7,5,5,14,17,30,-13,20
FC Salzburg,4727,1,13,8,3,46,22,24,47
Rapid Vienna,4727,2,10,10,4,36,23,13,40
SK Sturm Gra,4727,3,11,4,9,31,30,1,37
LASK Linz,4727,4,8,7,9,25,27,-2,31
Mattersburg,4727,5,6,8,10,34,42,-8,26
Vienna,4727,6,6,6,12,24,40,-16,24
SC Rheindorf,4727,7,5,7,12,17,29,-12,22
FC Salzburg,4728,1,14,7,3,43,17,26,49
SK Sturm Gra,4728,2,12,4,8,33,29,4,40
Rapid Vienna,4728,3,8,12,4,37,28,9,36
LASK Linz,4728,4,7,7,10,26,32,-6,28
Mattersburg,4728,5,7,6,11,32,40,-8,27
Vienna,4728,6,7,5,12,25,40,-15,26
SC Rheindorf,4728,7,4,9,11,18,28,-10,21
FC Salzburg,4729,1,16,6,2,47,18,29,54
SK Sturm Gra,4729,2,14,3,7,35,29,6,45
Rapid Vienna,4729,3,8,9,7,33,28,5,33
LASK Linz,4729,4,8,6,10,27,29,-2,30
Mattersburg,4729,5,6,7,11,30,40,-10,25
Vienna,4729,6,6,5,13,23,40,-17,23
SC Rheindorf,4729,7,5,6,13,19,30,-11,21
FC Salzburg,4730,1,16,6,2,51,18,33,54
SK Sturm Gra,4730,2,12,4,8,31,28,3,40
Rapid Vienna,4730,3,8,9,7,36,30,6,33
LASK Linz,4730,4,9,5,10,31,31,0,32
Vienna,4730,5,7,5,12,28,41,-13,26
Mattersburg,4730,6,6,6,12,30,47,-17,24
SC Rheindorf,4730,7,5,7,12,20,32,-12,22
FC Salzburg,4731,1,13,8,3,44,19,25,47
SK Sturm Gra,4731,2,13,3,8,32,32,0,42
LASK Linz,4731,3,10,6,8,29,25,4,36
Rapid Vienna,4731,4,8,11,5,33,25,8,35
Vienna,4731,5,7,6,11,28,39,-11,27
Mattersburg,4731,6,6,5,13,33,48,-15,23
SC Rheindorf,4731,7,5,5,14,18,29,-11,20
FC Salzburg,4732,1,16,6,2,47,19,28,54
SK Sturm Gra,4732,2,12,4,8,29,26,3,40
Rapid Vienna,4732,3,10,9,5,37,26,11,39
LASK Linz,4732,4,8,6,10,25,28,-3,30
Mattersburg,4732,5,7,6,11,33,41,-8,27
Vienna,4732,6,6,5,13,25,41,-16,23
SC Rheindorf,4732,7,4,6,14,15,30,-15,18
FC Salzburg,4733,1,15,6,3,47,18,29,51
SK Sturm Gra,4733,2,12,4,8,33,30,3,40
Rapid Vienna,4733,3,8,10,6,35,29,6,34
LASK Linz,4733,4,8,7,9,28,28,0,31
SC Rheindorf,4733,5,8,5,11,23,27,-4,29
Vienna,4733,6,7,5,12,25,38,-13,26
Mattersburg,4733,7,5,5,14,26,47,-21,20
FC Salzburg,4734,1,13,8,3,45,23,22,47
SK Sturm Gra,4734,2,13,4,7,36,30,6,43
Rapid Vienna,4734,3,11,9,4,37,24,13,42
LASK Linz,4734,4,8,5,11,27,30,-3,29
Mattersburg,4734,5,6,6,12,29,41,-12,24
Vienna,4734,6,6,6,12,26,41,-15,24
SC Rheindorf,4734,7,5,6,13,19,30,-11,21
FC Salzburg,4735,1,14,7,3,44,18,26,49
SK Sturm Gra,4735,2,13,5,6,31,25,6,44
LASK Linz,4735,3,10,6,8,29,26,3,36
Rapid Vienna,4735,4,7,11,6,33,27,6,32
Vienna,4735,5,7,5,12,26,40,-14,26
Mattersburg,4735,6,6,5,13,29,43,-14,23
SC Rheindorf,4735,7,4,7,13,16,29,-13,19
FC Salzburg,4736,1,16,6,2,50,17,33,54
SK Sturm Gra,4736,2,12,5,7,31,29,2,41
Rapid Vienna,4736,3,9,10,5,36,27,9,37
LASK Linz,4736,4,8,6,10,24,29,-5,30
Mattersburg,4736,5,7,5,12,33,42,-9,26
Vienna,4736,6,6,5,13,24,43,-19,23
SC Rheindorf,4736,7,5,5,14,20,31,-11,20
FC Salzburg,4737,1,14,6,4,44,20,24,48
SK Sturm Gra,4737,2,12,4,8,31,28,3,40
Rapid Vienna,4737,3,8,10,6,35,29,6,34
LASK Linz,4737,4,8,6,10,28,35,-7,30
Mattersburg,4737,5,7,6,11,36,42,-6,27
Vienna,4737,6,7,6,11,26,39,-13,27
SC Rheindorf,4737,7,6,6,12,19,26,-7,24
FC Salzburg,4738,1,14,6,4,46,22,24,48
SK Sturm Gra,4738,2,13,3,8,33,28,5,42
Rapid Vienna,4738,3,9,9,6,37,30,7,36
LASK Linz,4738,4,10,5,9,29,27,2,35
SC Rheindorf,4738,5,7,5,12,21,28,-7,26
Vienna,4738,6,6,6,12,24,41,-17,24
Mattersburg,4738,7,5,6,13,30,44,-14,21
FC Salzburg,4739,1,14,6,4,45,20,25,48
SK Sturm Gra,4739,2,12,4,8,31,29,2,40
Rapid Vienna,4739,3,9,11,4,36,24,12,38
Vienna,4739,4,8,5,11,28,40,-12,29
LASK Linz,4739,5,7,7,10,26,32,-6,28
SC Rheindorf,4739,6,6,6,12,21,30,-9,24
Mattersburg,4739,7,5,7,12,31,43,-12,22
FC Salzburg,4740,1,16,6,2,48,17,31,54
SK Sturm Gra,4740,2,12,4,8,32,31,1,40
Rapid Vienna,4740,3,9,10,5,35,25,10,37
LASK Linz,4740,4,7,7,10,23,28,-5,28
Mattersburg,4740,5,6,7,11,32,43,-11,25
Vienna,4740,6,6,6,12,25,40,-15,24
SC Rheindorf,4740,7,4,8,12,20,31,-11,20
FC Salzburg,4741,1,14,7,3,44,19,25,49
SK Sturm Gra,4741,2,11,4,9,32,34,-2,37
LASK Linz,4741,3,9,7,8,30,26,4,34
Rapid Vienna,4741,4,8,9,7,36,30,6,33
Vienna,4741,5,8,5,11,26,38,-12,29
SC Rheindorf,4741,6,7,5,12,20,29,-9,26
Mattersburg,4741,7,5,7,12,28,40,-12,22
FC Salzburg,4742,1,16,6,2,48,19,29,54
SK Sturm Gra,4742,2,11,5,8,30,30,0,38
Rapid Vienna,4742,3,7,11,6,31,25,6,32
LASK Linz,4742,4,8,7,9,27,29,-2,31
SC Rheindorf,4742,5,7,6,11,21,26,-5,27
Vienna,4742,6,7,5,12,28,41,-13,26
Mattersburg,4742,7,5,6,13,31,46,-15,21
FC Salzburg,4743,1,13,8,3,40,17,23,47
SK Sturm Gra,4743,2,13,5,6,31,25,6,44
Rapid Vienna,4743,3,8,10,6,33,25,8,34
Mattersburg,4743,4,8,5,11,36,40,-4,29
Vienna,4743,5,7,6,11,25,38,-13,27
LASK Linz,4743,6,7,5,12,25,33,-8,26
SC Rheindorf,4743,7,5,7,12,16,28,-12,22
FC Salzburg,4744,1,15,6,3,47,19,28,51
SK Sturm Gra,4744,2,13,4,7,33,28,5,43
Rapid Vienna,4744,3,7,10,7,33,31,2,31
LASK Linz,4744,4,8,7,9,27,30,-3,31
Mattersburg,4744,5,8,5,11,34,40,-6,29
Vienna,4744,6,7,5,12,26,40,-14,26
SC Rheindorf,4744,7,5,5,14,18,30,-12,20
FC Salzburg,4745,1,16,6,2,48,18,30,54
SK Sturm Gra,4745,2,12,4,8,35,30,5,40
Rapid Vienna,4745,3,9,9,6,37,28,9,36
LASK Linz,4745,4,8,8,8,27,27,0,32
Vienna,4745,5,6,6,12,26,42,-16,24
Mattersburg,4745,6,5,7,12,30,43,-13,22
SC Rheindorf,4745,7,5,6,13,19,34,-15,21
FC Salzburg,4746,1,13,7,4,47,24,23,46
SK Sturm Gra,4746,2,12,3,9,32,33,-1,39
Rapid Vienna,4746,3,8,11,5,39,30,9,35
LASK Linz,4746,4,10,5,9,27,28,-1,35
Vienna,4746,5,8,5,11,28,38,-10,29
Mattersburg,4746,6,7,5,12,34,42,-8,26
SC Rheindorf,4746,7,5,6,13,22,34,-12,21
FC Salzburg,4747,1,14,6,4,45,20,25,48
SK Sturm Gra,4747,2,13,3,8,33,29,4,42
Rapid Vienna,4747,3,10,9,5,38,28,10,39
LASK Linz,4747,4,8,6,10,27,28,-1,30
Mattersburg,4747,5,7,5,12,30,43,-13,26
Vienna,4747,6,7,5,12,26,41,-15,26
SC Rheindorf,4747,7,5,6,13,18,28,-10,21
FC Salzburg,4748,1,14,7,3,44,17,27,49
SK Sturm Gra,4748,2,12,4,8,29,28,1,40
Rapid Vienna,4748,3,7,10,7,32,27,5,31
LASK Linz,4748,4,8,6,10,25,27,-2,30
SC Rheindorf,4748,5,7,6,11,21,28,-7,27
Mattersburg,4748,6,7,6,11,30,39,-9,27
Vienna,4748,7,7,5,12,26,41,-15,26
FC Salzburg,4749,1,14,8,2,45,17,28,50
SK Sturm Gra,4749,2,14,4,6,36,28,8,46
Rapid Vienna,4749,3,7,10,7,37,33,4,31
LASK Linz,4749,4,7,6,11,29,34,-5,27
Mattersburg,4749,5,7,6,11,29,40,-11,27
Vienna,4749,6,6,7,11,24,38,-14,25
SC Rheindorf,4749,7,6,5,13,20,30,-10,23
FC Salzburg,4750,1,13,7,4,43,20,23,46
SK Sturm Gra,4750,2,12,4,8,31,29,2,40
Rapid Vienna,4750,3,9,9,6,39,30,9,36
LASK Linz,4750,4,10,5,9,30,29,1,35
Vienna,4750,5,8,5,11,27,37,-10,29
SC Rheindorf,4750,6,6,5,13,22,32,-10,23
Mattersburg,4750,7,6,5,13,30,45,-15,23
FC Salzburg,4751,1,15,6,3,50,19,31,51
SK Sturm Gra,4751,2,12,4,8,32,33,-1,40
Rapid Vienna,4751,3,9,10,5,40,30,10,37
LASK Linz,4751,4,8,5,11,29,32,-3,29
Vienna,4751,5,8,5,11,29,40,-11,29
Mattersburg,4751,6,6,6,12,31,46,-15,24
SC Rheindorf,4751,7,5,6,13,19,30,-11,21
FC Salzburg,4752,1,13,7,4,45,20,25,46
SK Sturm Gra,4752,2,14,4,6,37,27,10,46
Rapid Vienna,4752,3,9,11,4,36,26,10,38
LASK Linz,4752,4,8,6,10,27,31,-4,30
Vienna,4752,5,7,6,11,28,40,-12,27
Mattersburg,4752,6,6,5,13,31,46,-15,23
SC Rheindorf,4752,7,5,5,14,18,32,-14,20
FC Salzburg,4753,1,14,8,2,47,19,28,50
SK Sturm Gra,4753,2,14,4,6,38,27,11,46
LASK Linz,4753,3,10,5,9,32,26,6,35
Rapid Vienna,4753,4,8,10,6,36,32,4,34
Vienna,4753,5,7,5,12,26,40,-14,26
Mattersburg,4753,6,5,6,13,28,46,-18,21
SC Rheindorf,4753,7,4,6,14,17,34,-17,18
SK Sturm Gra,4754,1,15,3,6,35,26,9,48
FC Salzburg,4754,2,13,8,3,47,22,25,47
Rapid Vienna,4754,3,8,11,5,33,25,8,35
LASK Linz,4754,4,8,6,10,26,27,-1,30
Mattersburg,4754,5,7,6,11,33,44,-11,27
Vienna,4754,6,6,7,11,27,41,-14,25
SC Rheindorf,4754,7,4,5,15,17,33,-16,17
FC Salzburg,4755,1,15,6,3,44,17,27,51
SK Sturm Gra,4755,2,13,4,7,33,27,6,43
Rapid Vienna,4755,3,9,9,6,35,27,8,36
LASK Linz,4755,4,10,6,8,28,25,3,36
Vienna,4755,5,6,6,12,25,40,-15,24
Mattersburg,4755,6,5,6,13,29,45,-16,21
SC Rheindorf,4755,7,5,5,14,18,31,-13,20
FC Salzburg,4756,1,13,6,5,40,20,20,45
SK Sturm Gra,4756,2,13,5,6,34,27,7,44
Rapid Vienna,4756,3,9,11,4,37,27,10,38
LASK Linz,4756,4,7,8,9,27,29,-2,29
Vienna,4756,5,8,5,11,29,37,-8,29
SC Rheindorf,4756,6,6,5,13,21,32,-11,23
Mattersburg,4756,7,5,6,13,30,46,-16,21
FC Salzburg,4757,1,14,6,4,44,20,24,48
SK Sturm Gra,4757,2,13,4,7,32,27,5,43
Rapid Vienna,4757,3,9,10,5,35,26,9,37
LASK Linz,4757,4,8,7,9,27,28,-1,31
Vienna,4757,5,6,6,12,26,41,-15,24
SC Rheindorf,4757,6,5,8,11,24,29,-5,23
Mattersburg,4757,7,5,7,12,29,46,-17,22
FC Salzburg,4758,1,15,6,3,47,21,26,51
SK Sturm Gra,4758,2,12,5,7,34,30,4,41
Rapid Vienna,4758,3,10,9,5,40,27,13,39
LASK Linz,4758,4,8,6,10,30,35,-5,30
Mattersburg,4758,5,6,6,12,29,43,-14,24
Vienna,4758,6,6,5,13,25,42,-17,23
SC Rheindorf,4758,7,5,7,12,22,29,-7,22
FC Salzburg,4759,1,15,7,2,43,16,27,52
SK Sturm Gra,4759,2,12,3,9,30,29,1,39
Rapid Vienna,4759,3,8,9,7,35,29,6,33
LASK Linz,4759,4,9,5,10,28,28,0,32
SC Rheindorf,4759,5,8,5,11,21,27,-6,29
Vienna,4759,6,7,5,12,24,38,-14,26
Mattersburg,4759,7,5,6,13,27,41,-14,21
FC Salzburg,4760,1,16,6,2,50,17,33,54
Rapid Vienna,4760,2,9,9,6,37,31,6,36
SK Sturm Gra,4760,3,11,3,10,30,30,0,36
LASK Linz,4760,4,8,5,11,26,31,-5,29
Mattersburg,4760,5,8,5,11,36,45,-9,29
SC Rheindorf,4760,6,7,5,12,21,30,-9,26
Vienna,4760,7,6,5,13,26,42,-16,23
FC Salzburg,4761,1,14,7,3,44,20,24,49
Rapid Vienna,4761,2,10,10,4,40,26,14,40
SK Sturm Gra,4761,3,11,5,8,32,31,1,38
LASK Linz,4761,4,7,7,10,27,36,-9,28
Vienna,4761,5,7,6,11,26,39,-13,27
Mattersburg,4761,6,6,5,13,34,42,-8,23
SC Rheindorf,4761,7,5,8,11,20,29,-9,23
FC Salzburg,4762,1,14,7,3,49,21,28,49
SK Sturm Gra,4762,2,13,4,7,32,27,5,43
Rapid Vienna,4762,3,11,9,4,41,26,15,42
LASK Linz,4762,4,7,6,11,25,29,-4,27
Mattersburg,4762,5,7,5,12,31,44,-13,26
Vienna,4762,6,6,5,13,24,43,-19,23
SC Rheindorf,4762,7,5,6,13,19,31,-12,21
FC Salzburg,4763,1,15,7,2,43,17,26,52
SK Sturm Gra,4763,2,13,5,6,33,26,7,44
Rapid Vienna,4763,3,8,10,6,36,30,6,34
LASK Linz,4763,4,9,5,10,28,30,-2,32
Vienna,4763,5,7,5,12,26,40,-14,26
Mattersburg,4763,6,6,6,12,31,41,-10,24
SC Rheindorf,4763,7,4,6,14,16,29,-13,18
FC Salzburg,4764,1,13,8,3,42,19,23,47
SK Sturm Gra,4764,2,14,3,7,35,26,9,45
Rapid Vienna,4764,3,9,10,5,40,30,10,37
LASK Linz,4764,4,8,5,11,27,33,-6,29
Vienna,4764,5,7,6,11,25,38,-13,27
Mattersburg,4764,6,6,8,10,32,40,-8,26
SC Rheindorf,4764,7,4,6,14,18,33,-15,18
FC Salzburg,4765,1,15,7,2,48,18,30,52
SK Sturm Gra,4765,2,13,4,7,36,30,6,43
Rapid Vienna,4765,3,8,10,6,36,27,9,34
LASK Linz,4765,4,9,5,10,28,29,-1,32
Mattersburg,4765,5,7,5,12,30,44,-14,26
Vienna,4765,6,6,6,12,24,39,-15,24
SC Rheindorf,4765,7,5,5,14,18,33,-15,20
FC Salzburg,4766,1,14,7,3,44,18,26,49
SK Sturm Gra,4766,2,13,4,7,37,32,5,43
Rapid Vienna,4766,3,7,10,7,34,32,2,31
LASK Linz,4766,4,8,5,11,28,31,-3,29
Vienna,4766,5,7,6,11,28,40,-12,27
SC Rheindorf,4766,6,7,5,12,20,28,-8,26
Mattersburg,4766,7,6,7,11,31,41,-10,25
FC Salzburg,4767,1,14,7,3,47,19,28,49
SK Sturm Gra,4767,2,12,4,8,34,28,6,40
LASK Linz,4767,3,10,5,9,28,28,0,35
Rapid Vienna,4767,4,8,10,6,34,27,7,34
Mattersburg,4767,5,7,5,12,32,44,-12,26
Vienna,4767,6,7,5,12,27,42,-15,26
SC Rheindorf,4767,7,5,6,13,19,33,-14,21
FC Salzburg,4768,1,16,6,2,49,16,33,54
SK Sturm Gra,4768,2,13,4,7,33,29,4,43
Rapid Vienna,4768,3,8,9,7,34,32,2,33
LASK Linz,4768,4,8,5,11,28,30,-2,29
Mattersburg,4768,5,8,5,11,31,41,-10,29
Vienna,4768,6,6,5,13,24,40,-16,23
SC Rheindorf,4768,7,5,6,13,18,29,-11,21
FC Salzburg,4769,1,14,7,3,46,20,26,49
Rapid Vienna,4769,2,10,10,4,37,25,12,40
SK Sturm Gra,4769,3,11,4,9,30,32,-2,37
LASK Linz,4769,4,8,6,10,29,30,-1,30
Mattersburg,4769,5,7,6,11,35,43,-8,27
Vienna,4769,6,7,5,12,26,40,-14,26
SC Rheindorf,4769,7,5,6,13,16,29,-13,21
FC Salzburg,4770,1,15,7,2,50,19,31,52
SK Sturm Gra,4770,2,13,4,7,35,31,4,43
Rapid Vienna,4770,3,8,9,7,38,35,3,33
LASK Linz,4770,4,8,6,10,27,31,-4,30
Vienna,4770,5,7,6,11,29,39,-10,27
Mattersburg,4770,6,7,5,12,31,43,-12,26
SC Rheindorf,4770,7,4,7,13,18,30,-12,19
FC Salzburg,4771,1,14,8,2,42,17,25,50
Rapid Vienna,4771,2,10,10,4,37,24,13,40
SK Sturm Gra,4771,3,11,3,10,30,35,-5,36
LASK Linz,4771,4,9,5,10,28,28,0,32
SC Rheindorf,4771,5,7,5,12,22,27,-5,26
Vienna,4771,6,6,6,12,24,39,-15,24
Mattersburg,4771,7,6,5,13,28,41,-13,23
FC Salzburg,4772,1,13,9,2,42,18,24,48
SK Sturm Gra,4772,2,12,4,8,32,33,-1,40
Rapid Vienna,4772,3,8,10,6,34,25,9,34
LASK Linz,4772,4,8,8,8,30,28,2,32
Vienna,4772,5,6,7,11,24,38,-14,25
Mattersburg,4772,6,5,9,10,30,40,-10,24
SC Rheindorf,4772,7,5,7,12,19,29,-10,22
FC Salzburg,4773,1,15,6,3,49,18,31,51
SK Sturm Gra,4773,2,12,4,8,30,27,3,40
Rapid Vienna,4773,3,8,11,5,34,29,5,35
LASK Linz,4773,4,8,7,9,30,31,-1,31
Mattersburg,4773,5,7,5,12,34,45,-11,26
SC Rheindorf,4773,6,5,8,11,22,31,-9,23
Vienna,4773,7,6,5,13,26,44,-18,23
FC Salzburg,4774,1,13,7,4,42,20,22,46
SK Sturm Gra,4774,2,12,5,7,32,31,1,41
Rapid Vienna,4774,3,10,10,4,41,24,17,40
LASK Linz,4774,4,8,8,8,26,26,0,32
Vienna,4774,5,8,5,11,26,38,-12,29
Mattersburg,4774,6,6,5,13,31,40,-9,23
SC Rheindorf,4774,7,4,6,14,18,37,-19,18
FC Salzburg,4775,1,15,6,3,47,20,27,51
SK Sturm Gra,4775,2,13,4,7,31,27,4,43
Rapid Vienna,4775,3,8,10,6,38,29,9,34
LASK Linz,4775,4,9,7,8,31,27,4,34
Mattersburg,4775,5,6,6,12,32,45,-13,24
Vienna,4775,6,6,6,12,24,40,-16,24
SC Rheindorf,4775,7,5,5,14,21,36,-15,20
FC Salzburg,4776,1,15,6,3,46,20,26,51
SK Sturm Gra,4776,2,12,5,7,32,27,5,41
Rapid Vienna,4776,3,9,10,5,37,28,9,37
LASK Linz,4776,4,8,6,10,26,29,-3,30
Mattersburg,4776,5,7,6,11,33,41,-8,27
Vienna,4776,6,6,5,13,25,43,-18,23
SC Rheindorf,4776,7,4,8,12,19,30,-11,20
FC Salzburg,4777,1,15,7,2,49,16,33,52
SK Sturm Gra,4777,2,13,4,7,33,29,4,43
Rapid Vienna,4777,3,7,10,7,33,29,4,31
LASK Linz,4777,4,8,6,10,27,32,-5,30
Mattersburg,4777,5,7,5,12,32,43,-11,26
Vienna,4777,6,7,5,12,25,41,-16,26
SC Rheindorf,4777,7,6,5,13,20,29,-9,23
FC Salzburg,4778,1,13,7,4,44,21,23,46
Rapid Vienna,4778,2,10,10,4,40,28,12,40
SK Sturm Gra,4778,3,12,4,8,32,33,-1,40
LASK Linz,4778,4,8,6,10,25,27,-2,30
Vienna,4778,5,8,5,11,28,37,-9,29
Mattersburg,4778,6,6,6,12,31,43,-12,24
SC Rheindorf,4778,7,5,6,13,20,31,-11,21
FC Salzburg,4779,1,14,6,4,47,18,29,48
SK Sturm Gra,4779,2,12,5,7,33,32,1,41
Rapid Vienna,4779,3,8,9,7,35,33,2,33
Mattersburg,4779,4,7,7,10,33,40,-7,28
LASK Linz,4779,5,7,6,11,25,30,-5,27
Vienna,4779,6,7,6,11,27,40,-13,27
SC Rheindorf,4779,7,6,7,11,23,30,-7,25
FC Salzburg,4780,1,14,7,3,44,19,25,49
Rapid Vienna,4780,2,10,10,4,40,27,13,40
SK Sturm Gra,4780,3,12,4,8,35,31,4,40
LASK Linz,4780,4,8,6,10,27,30,-3,30
Vienna,4780,5,7,5,12,27,38,-11,26
Mattersburg,4780,6,6,6,12,30,45,-15,24
SC Rheindorf,4780,7,5,6,13,18,31,-13,21
FC Salzburg,4781,1,16,6,2,46,16,30,54
SK Sturm Gra,4781,2,12,4,8,32,29,3,40
Rapid Vienna,4781,3,10,9,5,39,31,8,39
LASK Linz,4781,4,8,5,11,28,33,-5,29
Vienna,4781,5,7,5,12,24,38,-14,26
Mattersburg,4781,6,6,6,12,32,42,-10,24
SC Rheindorf,4781,7,4,7,13,21,33,-12,19
FC Salzburg,4782,1,15,6,3,48,19,29,51
Rapid Vienna,4782,2,9,10,5,39,28,11,37
SK Sturm Gra,4782,3,11,4,9,30,34,-4,37
LASK Linz,4782,4,8,5,11,27,29,-2,29
SC Rheindorf,4782,5,7,6,11,22,28,-6,27
Mattersburg,4782,6,7,6,11,32,42,-10,27
Vienna,4782,7,6,5,13,24,42,-18,23
FC Salzburg,4783,1,14,6,4,43,19,24,48
Rapid Vienna,4783,2,10,9,5,39,29,10,39
SK Sturm Gra,4783,3,12,3,9,33,31,2,39
Mattersburg,4783,4,7,7,10,31,39,-8,28
LASK Linz,4783,5,7,6,11,25,30,-5,27
Vienna,4783,6,7,6,11,25,38,-13,27
SC Rheindorf,4783,7,6,5,13,20,30,-10,23
FC Salzburg,4784,1,15,7,2,47,17,30,52
SK Sturm Gra,4784,2,13,3,8,34,31,3,42
Rapid Vienna,4784,3,7,10,7,34,30,4,31
LASK Linz,4784,4,8,6,10,26,28,-2,30
Mattersburg,4784,5,7,6,11,28,39,-11,27
SC Rheindorf,4784,6,6,6,12,20,29,-9,24
Vienna,4784,7,6,6,12,24,39,-15,24
FC Salzburg,4785,1,14,8,2,48,19,29,50
SK Sturm Gra,4785,2,12,3,9,31,34,-3,39
Rapid Vienna,4785,3,9,10,5,36,26,10,37
LASK Linz,4785,4,9,5,10,28,31,-3,32
Vienna,4785,5,7,6,11,25,38,-13,27
SC Rheindorf,4785,6,6,5,13,24,32,-8,23
Mattersburg,4785,7,6,5,13,30,42,-12,23
FC Salzburg,4786,1,13,7,4,42,20,22,46
SK Sturm Gra,4786,2,13,4,7,33,28,5,43
Rapid Vienna,4786,3,8,10,6,35,29,6,34
LASK Linz,4786,4,8,7,9,25,27,-2,31
Mattersburg,4786,5,8,5,11,35,39,-4,29
Vienna,4786,6,6,6,12,24,42,-18,24
SC Rheindorf,4786,7,6,5,13,21,30,-9,23
FC Salzburg,4787,1,14,6,4,45,20,25,48
SK Sturm Gra,4787,2,12,3,9,32,29,3,39
Rapid Vienna,4787,3,8,11,5,36,28,8,35
LASK Linz,4787,4,9,6,9,26,25,1,33
Vienna,4787,5,8,5,11,26,38,-12,29
SC Rheindorf,4787,6,6,6,12,20,32,-12,24
Mattersburg,4787,7,6,5,13,32,45,-13,23
FC Salzburg,4788,1,14,7,3,47,19,28,49
Rapid Vienna,4788,2,10,9,5,39,27,12,39
SK Sturm Gra,4788,3,11,4,9,31,32,-1,37
LASK Linz,4788,4,9,6,9,29,29,0,33
Mattersburg,4788,5,7,6,11,32,43,-11,27
Vienna,4788,6,6,6,12,27,42,-15,24
SC Rheindorf,4788,7,5,6,13,17,30,-13,21
FC Salzburg,4789,1,14,8,2,46,18,28,50
SK Sturm Gra,4789,2,12,5,7,32,28,4,41
Rapid Vienna,4789,3,9,10,5,36,27,9,37
LASK Linz,4789,4,7,7,10,24,29,-5,28
Mattersburg,4789,5,7,7,10,35,41,-6,28
Vienna,4789,6,6,5,13,25,43,-18,23
SC Rheindorf,4789,7,5,6,13,19,31,-12,21
FC Salzburg,4790,1,16,6,2,45,16,29,54
SK Sturm Gra,4790,2,11,4,9,32,32,0,37
LASK Linz,4790,3,10,5,9,29,27,2,35
Rapid Vienna,4790,4,8,9,7,34,29,5,33
SC Rheindorf,4790,5,6,7,11,24,31,-7,25
Vienna,4790,6,6,6,12,23,39,-16,24
Mattersburg,4790,7,5,7,12,29,42,-13,22
FC Salzburg,4791,1,15,6,3,43,18,25,51
SK Sturm Gra,4791,2,11,6,7,32,29,3,39
Rapid Vienna,4791,3,8,10,6,35,28,7,34
LASK Linz,4791,4,9,7,8,26,25,1,34
Vienna,4791,5,7,5,12,26,40,-14,26
Mattersburg,4791,6,6,6,12,31,42,-11,24
SC Rheindorf,4791,7,4,8,12,19,30,-11,20
FC Salzburg,4792,1,15,7,2,49,18,31,52
SK Sturm Gra,4792,2,13,4,7,32,31,1,43
Rapid Vienna,4792,3,8,9,7,38,32,6,33
LASK Linz,4792,4,9,5,10,27,28,-1,32
Mattersburg,4792,5,8,5,11,33,40,-7,29
Vienna,4792,6,6,6,12,24,40,-16,24
SC Rheindorf,4792,7,4,6,14,17,31,-14,18
FC Salzburg,4793,1,15,6,3,43,23,20,51
SK Sturm Gra,4793,2,12,4,8,32,28,4,40
Rapid Vienna,4793,3,9,10,5,37,28,9,37
Vienna,4793,4,8,5,11,33,38,-5,29
LASK Linz,4793,5,8,5,11,27,32,-5,29
SC Rheindorf,4793,6,6,5,13,20,31,-11,23
Mattersburg,4793,7,6,5,13,30,42,-12,23
FC Salzburg,4794,1,13,8,3,45,19,26,47
SK Sturm Gra,4794,2,13,5,6,34,28,6,44
Rapid Vienna,4794,3,8,12,4,35,26,9,36
LASK Linz,4794,4,9,5,10,30,31,-1,32
Vienna,4794,5,7,6,11,26,38,-12,27
Mattersburg,4794,6,6,5,13,30,46,-16,23
SC Rheindorf,4794,7,4,7,13,20,32,-12,19
FC Salzburg,4795,1,14,6,4,46,19,27,48
Rapid Vienna,4795,2,10,10,4,40,24,16,40
SK Sturm Gra,4795,3,12,3,9,31,36,-5,39
Vienna,4795,4,8,5,11,29,39,-10,29
LASK Linz,4795,5,7,7,10,27,30,-3,28
Mattersburg,4795,6,6,6,12,32,46,-14,24
SC Rheindorf,4795,7,6,5,13,23,34,-11,23
FC Salzburg,4796,1,13,9,2,43,17,26,48
SK Sturm Gra,4796,2,13,4,7,31,26,5,43
Rapid Vienna,4796,3,8,10,6,34,28,6,34
Vienna,4796,4,7,6,11,24,37,-13,27
LASK Linz,4796,5,7,5,12,24,31,-7,26
Mattersburg,4796,6,7,5,12,33,41,-8,26
SC Rheindorf,4796,7,7,5,12,21,30,-9,26
FC Salzburg,4797,1,15,7,2,45,16,29,52
SK Sturm Gra,4797,2,13,4,7,31,28,3,43
Rapid Vienna,4797,3,8,10,6,36,30,6,34
LASK Linz,4797,4,8,7,9,26,26,0,31
Vienna,4797,5,7,5,12,27,38,-11,26
Mattersburg,4797,6,6,5,13,27,44,-17,23
SC Rheindorf,4797,7,5,6,13,20,30,-10,21
FC Salzburg,4798,1,14,7,3,49,20,29,49
SK Sturm Gra,4798,2,12,5,7,34,29,5,41
Rapid Vienna,4798,3,9,10,5,36,25,11,37
LASK Linz,4798,4,9,6,9,27,26,1,33
Vienna,4798,5,7,5,12,27,45,-18,26
Mattersburg,4798,6,6,5,13,30,45,-15,23
SC Rheindorf,4798,7,5,6,13,17,30,-13,21
FC Salzburg,4799,1,13,7,4,46,23,23,46
SK Sturm Gra,4799,2,13,4,7,34,29,5,43
Rapid Vienna,4799,3,9,9,6,38,29,9,36
LASK Linz,4799,4,9,5,10,27,27,0,32
Mattersburg,4799,5,7,5,12,30,41,-11,26
Vienna,4799,6,7,5,12,26,42,-16,26
SC Rheindorf,4799,7,6,5,13,21,31,-10,23
FC Salzburg,4800,1,15,6,3,49,18,31,51
SK Sturm Gra,4800,2,13,4,7,34,30,4,43
Rapid Vienna,4800,3,9,10,5,35,26,9,37
LASK Linz,4800,4,8,5,11,28,30,-2,29
Mattersburg,4800,5,7,5,12,34,49,-15,26
SC Rheindorf,4800,6,6,5,13,23,32,-9,23
Vienna,4800,7,6,5,13,25,43,-18,23
FC Salzburg,4801,1,14,8,2,44,18,26,50
SK Sturm Gra,4801,2,12,4,8,33,30,3,40
Rapid Vienna,4801,3,8,11,5,34,28,6,35
LASK Linz,4801,4,9,5,10,30,30,0,32
Mattersburg,4801,5,6,7,11,35,46,-11,25
Vienna,4801,6,6,6,12,26,41,-15,24
SC Rheindorf,4801,7,5,7,12,21,30,-9,22
FC Salzburg,4802,1,14,7,3,44,20,24,49
Rapid Vienna,4802,2,9,11,4,44,30,14,38
SK Sturm Gra,4802,3,11,4,9,33,35,-2,37
LASK Linz,4802,4,9,7,8,29,28,1,34
Mattersburg,4802,5,6,7,11,30,41,-11,25
Vienna,4802,6,6,6,12,26,41,-15,24
SC Rheindorf,4802,7,4,8,12,20,31,-11,20
FC Salzburg,4803,1,13,7,4,43,21,22,46
SK Sturm Gra,4803,2,12,4,8,31,29,2,40
Rapid Vienna,4803,3,9,10,5,36,26,10,37
LASK Linz,4803,4,9,5,10,30,30,0,32
Vienna,4803,5,8,5,11,29,41,-12,29
SC Rheindorf,4803,6,7,6,11,28,33,-5,27
Mattersburg,4803,7,5,5,14,32,49,-17,20
FC Salzburg,4804,1,15,7,2,46,19,27,52
SK Sturm Gra,4804,2,11,7,6,32,28,4,40
Rapid Vienna,4804,3,7,12,5,33,27,6,33
LASK Linz,4804,4,8,7,9,27,28,-1,31
SC Rheindorf,4804,5,6,7,11,19,27,-8,25
Vienna,4804,6,6,6,12,27,42,-15,24
Mattersburg,4804,7,5,6,13,31,44,-13,21
FC Salzburg,4805,1,14,8,2,49,18,31,50
SK Sturm Gra,4805,2,13,5,6,33,25,8,44
Rapid Vienna,4805,3,7,12,5,34,28,6,33
LASK Linz,4805,4,8,6,10,26,28,-2,30
Mattersburg,4805,5,7,5,12,30,43,-13,26
Vienna,4805,6,6,5,13,25,44,-19,23
SC Rheindorf,4805,7,5,7,12,18,29,-11,22
FC Salzburg,4806,1,15,7,2,47,19,28,52
SK Sturm Gra,4806,2,12,5,7,32,30,2,41
LASK Linz,4806,3,9,7,8,30,27,3,34
Rapid Vienna,4806,4,8,9,7,35,30,5,33
Vienna,4806,5,7,5,12,26,39,-13,26
Mattersburg,4806,6,6,6,12,33,44,-11,24
SC Rheindorf,4806,7,5,5,14,17,31,-14,20
FC Salzburg,4807,1,16,6,2,47,16,31,54
SK Sturm Gra,4807,2,12,4,8,30,30,0,40
Rapid Vienna,4807,3,9,10,5,38,27,11,37
LASK Linz,4807,4,7,7,10,26,32,-6,28
Vienna,4807,5,7,5,12,24,38,-14,26
Mattersburg,4807,6,6,6,12,30,41,-11,24
SC Rheindorf,4807,7,4,8,12,17,28,-11,20
FC Salzburg,4808,1,13,8,3,43,20,23,47
SK Sturm Gra,4808,2,11,6,7,31,30,1,39
Rapid Vienna,4808,3,9,10,5,34,24,10,37
LASK Linz,4808,4,9,5,10,27,28,-1,32
Vienna,4808,5,7,6,11,28,41,-13,27
Mattersburg,4808,6,6,6,12,31,40,-9,24
SC Rheindorf,4808,7,5,7,12,17,28,-11,22
FC Salzburg,4809,1,15,7,2,44,17,27,52
SK Sturm Gra,4809,2,13,4,7,33,29,4,43
Rapid Vienna,4809,3,8,11,5,35,27,8,35
LASK Linz,4809,4,9,6,9,31,29,2,33
Vienna,4809,5,7,5,12,26,40,-14,26
Mattersburg,4809,6,5,7,12,29,42,-13,22
SC Rheindorf,4809,7,4,6,14,16,30,-14,18
FC Salzburg,4810,1,15,6,3,42,17,25,51
SK Sturm Gra,4810,2,14,3,7,36,26,10,45
Rapid Vienna,4810,3,8,9,7,35,30,5,33
SC Rheindorf,4810,4,7,6,11,20,26,-6,27
LASK Linz,4810,5,7,5,12,25,36,-11,26
Vienna,4810,6,7,5,12,26,39,-13,26
Mattersburg,4810,7,6,6,12,31,41,-10,24
FC Salzburg,4811,1,15,7,2,45,19,26,52
SK Sturm Gra,4811,2,13,4,7,34,29,5,43
Rapid Vienna,4811,3,7,12,5,36,29,7,33
LASK Linz,4811,4,9,5,10,28,31,-3,32
Mattersburg,4811,5,8,5,11,37,41,-4,29
Vienna,4811,6,6,5,13,26,42,-16,23
SC Rheindorf,4811,7,4,6,14,18,33,-15,18
FC Salzburg,4812,1,14,7,3,43,19,24,49
SK Sturm Gra,4812,2,14,4,6,37,26,11,46
Rapid Vienna,4812,3,9,9,6,36,31,5,36
Mattersburg,4812,4,8,5,11,32,38,-6,29
LASK Linz,4812,5,7,5,12,24,31,-7,26
SC Rheindorf,4812,6,6,5,13,18,29,-11,23
Vienna,4812,7,6,5,13,24,40,-16,23
FC Salzburg,4813,1,16,6,2,49,16,33,54
SK Sturm Gra,4813,2,13,3,8,33,31,2,42
LASK Linz,4813,3,9,5,10,27,28,-1,32
Rapid Vienna,4813,4,7,10,7,32,28,4,31
Mattersburg,4813,5,7,5,12,30,41,-11,26
SC Rheindorf,4813,6,6,6,12,19,27,-8,24
Vienna,4813,7,6,5,13,24,43,-19,23
FC Salzburg,4814,1,14,8,2,51,20,31,50
SK Sturm Gra,4814,2,13,4,7,35,34,1,43
Rapid Vienna,4814,3,7,11,6,37,31,6,32
LASK Linz,4814,4,9,5,10,28,31,-3,32
Vienna,4814,5,7,6,11,25,38,-13,27
Mattersburg,4814,6,7,5,12,34,42,-8,26
SC Rheindorf,4814,7,4,7,13,17,31,-14,19
FC Salzburg,4815,1,14,8,2,42,15,27,50
SK Sturm Gra,4815,2,11,6,7,32,29,3,39
Rapid Vienna,4815,3,8,11,5,37,27,10,35
LASK Linz,4815,4,8,8,8,30,30,0,32
Vienna,4815,5,7,5,12,28,39,-11,26
SC Rheindorf,4815,6,6,6,12,25,34,-9,24
Mattersburg,4815,7,5,6,13,30,50,-20,21
FC Salzburg,4816,1,14,7,3,42,18,24,49
Rapid Vienna,4816,2,10,9,5,36,26,10,39
SK Sturm Gra,4816,3,12,3,9,31,31,0,39
LASK Linz,4816,4,8,6,10,27,27,0,30
Vienna,4816,5,7,6,11,28,38,-10,27
Mattersburg,4816,6,7,5,12,28,41,-13,26
SC Rheindorf,4816,7,5,6,13,16,27,-11,21
FC Salzburg,4817,1,14,6,4,43,19,24,48
SK Sturm Gra,4817,2,13,5,6,30,24,6,44
Rapid Vienna,4817,3,10,10,4,37,24,13,40
LASK Linz,4817,4,7,8,9,26,28,-2,29
Vienna,4817,5,7,5,12,26,41,-15,26
Mattersburg,4817,6,5,6,13,31,44,-13,21
SC Rheindorf,4817,7,5,6,13,17,30,-13,21
FC Salzburg,4818,1,15,7,2,47,17,30,52
SK Sturm Gra,4818,2,11,5,8,30,30,0,38
Rapid Vienna,4818,3,8,10,6,35,28,7,34
LASK Linz,4818,4,9,6,9,29,29,0,33
Vienna,4818,5,7,5,12,24,40,-16,26
Mattersburg,4818,6,6,6,12,29,41,-12,24
SC Rheindorf,4818,7,5,7,12,19,28,-9,22
FC Salzburg,4819,1,15,7,2,48,18,30,52
Rapid Vienna,4819,2,9,10,5,36,28,8,37
SK Sturm Gra,4819,3,11,4,9,30,30,0,37
LASK Linz,4819,4,8,6,10,27,33,-6,30
Mattersburg,4819,5,7,6,11,37,42,-5,27
Vienna,4819,6,6,6,12,24,40,-16,24
SC Rheindorf,4819,7,5,7,12,19,30,-11,22
SK Sturm Gra,4820,1,14,3,7,35,29,6,45
FC Salzburg,4820,2,12,8,4,44,23,21,44
Rapid Vienna,4820,3,8,11,5,35,27,8,35
LASK Linz,4820,4,7,6,11,26,30,-4,27
Vienna,4820,5,7,6,11,26,39,-13,27
Mattersburg,4820,6,6,8,10,30,39,-9,26
SC Rheindorf,4820,7,6,6,12,21,30,-9,24
FC Salzburg,4821,1,13,9,2,45,20,25,48
SK Sturm Gra,4821,2,13,4,7,39,30,9,43
Rapid Vienna,4821,3,8,10,6,38,30,8,34
LASK Linz,4821,4,9,5,10,29,32,-3,32
Vienna,4821,5,7,6,11,25,38,-13,27
Mattersburg,4821,6,7,5,12,29,40,-11,26
SC Rheindorf,4821,7,5,5,14,17,32,-15,20
FC Salzburg,4822,1,16,6,2,45,17,28,54
SK Sturm Gra,4822,2,12,5,7,32,27,5,41
Rapid Vienna,4822,3,8,10,6,37,31,6,34
LASK Linz,4822,4,8,8,8,28,27,1,32
Vienna,4822,5,7,5,12,25,39,-14,26
SC Rheindorf,4822,6,5,6,13,20,32,-12,21
Mattersburg,4822,7,5,6,13,27,41,-14,21
FC Salzburg,4823,1,16,6,2,51,18,33,54
SK Sturm Gra,4823,2,13,3,8,31,30,1,42
Rapid Vienna,4823,3,7,11,6,33,28,5,32
LASK Linz,4823,4,8,6,10,28,32,-4,30
SC Rheindorf,4823,5,6,6,12,19,26,-7,24
Mattersburg,4823,6,6,6,12,33,45,-12,24
Vienna,4823,7,6,6,12,27,43,-16,24
FC Salzburg,4824,1,14,8,2,42,17,25,50
SK Sturm Gra,4824,2,13,3,8,33,27,6,42
Rapid Vienna,4824,3,9,10,5,35,26,9,37
LASK Linz,4824,4,9,5,10,28,31,-3,32
Vienna,4824,5,7,6,11,26,38,-12,27
Mattersburg,4824,6,7,5,12,31,40,-9,26
SC Rheindorf,4824,7,4,5,15,17,33,-16,17
FC Salzburg,4825,1,16,6,2,50,17,33,54
SK Sturm Gra,4825,2,11,4,9,32,33,-1,37
Rapid Vienna,4825,3,9,9,6,36,29,7,36
LASK Linz,4825,4,10,6,8,29,26,3,36
Vienna,4825,5,7,5,12,26,42,-16,26
SC Rheindorf,4825,6,5,6,13,18,29,-11,21
Mattersburg,4825,7,5,6,13,29,44,-15,21
FC Salzburg,4826,1,16,6,2,45,15,30,54
SK Sturm Gra,4826,2,14,3,7,33,27,6,45
LASK Linz,4826,3,9,6,9,29,26,3,33
Rapid Vienna,4826,4,7,10,7,33,31,2,31
Mattersburg,4826,5,6,6,12,29,41,-12,24
Vienna,4826,6,6,6,12,23,38,-15,24
SC Rheindorf,4826,7,4,7,13,16,30,-14,19
FC Salzburg,4827,1,13,7,4,42,19,23,46
SK Sturm Gra,4827,2,13,5,6,36,28,8,44
Rapid Vienna,4827,3,10,9,5,35,26,9,39
LASK Linz,4827,4,8,6,10,28,30,-2,30
Vienna,4827,5,7,5,12,25,41,-16,26
Mattersburg,4827,6,6,6,12,31,42,-11,24
SC Rheindorf,4827,7,5,6,13,20,31,-11,21
FC Salzburg,4828,1,13,8,3,46,21,25,47
SK Sturm Gra,4828,2,14,3,7,40,30,10,45
Rapid Vienna,4828,3,8,11,5,35,28,7,35
LASK Linz,4828,4,9,6,9,31,30,1,33
Vienna,4828,5,8,5,11,26,38,-12,29
Mattersburg,4828,6,5,6,13,30,45,-15,21
SC Rheindorf,4828,7,5,5,14,19,35,-16,20
FC Salzburg,4829,1,15,6,3,45,18,27,51
SK Sturm Gra,4829,2,13,3,8,32,27,5,42
Rapid Vienna,4829,3,9,9,6,38,30,8,36
LASK Linz,4829,4,9,5,10,27,28,-1,32
Vienna,4829,5,7,5,12,27,40,-13,26
Mattersburg,4829,6,6,6,12,29,43,-14,24
SC Rheindorf,4829,7,5,6,13,18,30,-12,21
FC Salzburg,4830,1,15,7,2,43,16,27,52
SK Sturm Gra,4830,2,12,3,9,33,32,1,39
Rapid Vienna,4830,3,9,10,5,39,27,12,37
LASK Linz,4830,4,10,6,8,33,29,4,36
Mattersburg,4830,5,6,7,11,34,44,-10,25
Vienna,4830,6,6,6,12,26,42,-16,24
SC Rheindorf,4830,7,4,5,15,17,35,-18,17
FC Salzburg,4831,1,14,7,3,44,17,27,49
SK Sturm Gra,4831,2,13,3,8,31,27,4,42
Rapid Vienna,4831,3,9,9,6,35,27,8,36
LASK Linz,4831,4,9,5,10,26,28,-2,32
Vienna,4831,5,6,7,11,25,39,-14,25
Mattersburg,4831,6,6,6,12,31,43,-12,24
SC Rheindorf,4831,7,6,5,13,19,30,-11,23
FC Salzburg,4832,1,15,6,3,47,19,28,51
Rapid Vienna,4832,2,10,9,5,37,29,8,39
SK Sturm Gra,4832,3,12,3,9,36,34,2,39
LASK Linz,4832,4,8,6,10,30,31,-1,30
SC Rheindorf,4832,5,7,5,12,23,29,-6,26
Vienna,4832,6,7,5,12,27,40,-13,26
Mattersburg,4832,7,5,6,13,27,45,-18,21
FC Salzburg,4833,1,13,8,3,42,19,23,47
SK Sturm Gra,4833,2,14,3,7,35,28,7,45
Rapid Vienna,4833,3,8,11,5,37,27,10,35
LASK Linz,4833,4,7,8,9,26,29,-3,29
Mattersburg,4833,5,6,7,11,30,40,-10,25
Vienna,4833,6,6,7,11,25,39,-14,25
SC Rheindorf,4833,7,5,6,13,19,32,-13,21
FC Salzburg,4834,1,13,8,3,49,24,25,47
SK Sturm Gra,4834,2,14,3,7,37,26,11,45
Rapid Vienna,4834,3,8,11,5,39,33,6,35
LASK Linz,4834,4,7,8,9,26,31,-5,29
Mattersburg,4834,5,7,6,11,33,41,-8,27
Vienna,4834,6,6,6,12,25,40,-15,24
SC Rheindorf,4834,7,5,6,13,17,31,-14,21
FC Salzburg,4835,1,14,8,2,44,17,27,50
SK Sturm Gra,4835,2,13,4,7,36,29,7,43
Rapid Vienna,4835,3,9,9,6,36,27,9,36
LASK Linz,4835,4,8,6,10,29,34,-5,30
Vienna,4835,5,7,5,12,25,41,-16,26
Mattersburg,4835,6,6,6,12,31,43,-12,24
SC Rheindorf,4835,7,5,6,13,20,30,-10,21
FC Salzburg,4836,1,14,6,4,45,21,24,48
SK Sturm Gra,4836,2,14,3,7,36,30,6,45
Rapid Vienna,4836,3,9,10,5,36,27,9,37
LASK Linz,4836,4,8,7,9,31,32,-1,31
Mattersburg,4836,5,6,6,12,33,44,-11,24
Vienna,4836,6,6,5,13,24,41,-17,23
SC Rheindorf,4836,7,5,7,12,18,28,-10,22
FC Salzburg,4837,1,14,7,3,46,19,27,49
SK Sturm Gra,4837,2,13,3,8,31,29,2,42
Rapid Vienna,4837,3,8,10,6,33,27,6,34
LASK Linz,4837,4,8,6,10,26,29,-3,30
Mattersburg,4837,5,7,6,11,35,42,-7,27
Vienna,4837,6,7,6,11,27,39,-12,27
SC Rheindorf,4837,7,5,6,13,18,31,-13,21
FC Salzburg,4838,1,14,8,2,45,19,26,50
SK Sturm Gra,4838,2,11,5,8,33,33,0,38
LASK Linz,4838,3,9,7,8,30,27,3,34
Rapid Vienna,4838,4,7,12,5,36,29,7,33
Mattersburg,4838,5,7,7,10,35,42,-7,28
Vienna,4838,6,6,6,12,26,42,-16,24
SC Rheindorf,4838,7,4,7,13,19,32,-13,19
FC Salzburg,4839,1,15,6,3,44,16,28,51
SK Sturm Gra,4839,2,12,4,8,31,30,1,40
Rapid Vienna,4839,3,8,9,7,35,29,6,33
LASK Linz,4839,4,9,5,10,29,31,-2,32
Mattersburg,4839,5,7,6,11,32,41,-9,27
Vienna,4839,6,7,6,11,25,38,-13,27
SC Rheindorf,4839,7,5,6,13,17,28,-11,21
FC Salzburg,4840,1,15,6,3,46,20,26,51
SK Sturm Gra,4840,2,12,5,7,36,30,6,41
Rapid Vienna,4840,3,8,11,5,36,31,5,35
LASK Linz,4840,4,8,7,9,26,27,-1,31
Vienna,4840,5,6,6,12,25,40,-15,24
SC Rheindorf,4840,6,5,8,11,21,30,-9,23
Mattersburg,4840,7,5,7,12,27,39,-12,22
FC Salzburg,4841,1,14,7,3,46,20,26,49
SK Sturm Gra,4841,2,14,4,6,37,28,9,46
Rapid Vienna,4841,3,8,10,6,34,25,9,34
LASK Linz,4841,4,9,5,10,30,32,-2,32
Vienna,4841,5,6,6,12,27,43,-16,24
SC Rheindorf,4841,6,6,5,13,21,33,-12,23
Mattersburg,4841,7,6,5,13,35,49,-14,23
FC Salzburg,4842,1,14,6,4,44,18,26,48
SK Sturm Gra,4842,2,14,3,7,35,26,9,45
Rapid Vienna,4842,3,10,9,5,36,25,11,39
LASK Linz,4842,4,7,6,11,25,36,-11,27
Mattersburg,4842,5,7,5,12,36,43,-7,26
Vienna,4842,6,7,5,12,26,41,-15,26
SC Rheindorf,4842,7,5,6,13,20,33,-13,21
FC Salzburg,4843,1,15,6,3,48,20,28,51
SK Sturm Gra,4843,2,11,5,8,32,33,-1,38
Rapid Vienna,4843,3,9,10,5,38,29,9,37
LASK Linz,4843,4,8,7,9,29,31,-2,31
Mattersburg,4843,5,6,7,11,35,44,-9,25
Vienna,4843,6,6,6,12,24,39,-15,24
SC Rheindorf,4843,7,5,7,12,22,32,-10,22
FC Salzburg,4844,1,12,7,5,44,24,20,43
Rapid Vienna,4844,2,10,10,4,38,27,11,40
SK Sturm Gra,4844,3,12,4,8,34,31,3,40
LASK Linz,4844,4,8,6,10,27,28,-1,30
SC Rheindorf,4844,5,7,6,11,22,27,-5,27
Vienna,4844,6,7,6,11,27,39,-12,27
Mattersburg,4844,7,6,5,13,32,48,-16,23
FC Salzburg,4845,1,13,8,3,40,19,21,47
SK Sturm Gra,4845,2,12,5,7,32,27,5,41
Rapid Vienna,4845,3,9,10,5,37,26,11,37
LASK Linz,4845,4,9,5,10,26,27,-1,32
Vienna,4845,5,7,6,11,27,39,-12,27
Mattersburg,4845,6,6,6,12,29,41,-12,24
SC Rheindorf,4845,7,5,6,13,20,32,-12,21
FC Salzburg,4846,1,14,7,3,43,18,25,49
SK Sturm Gra,4846,2,13,4,7,32,27,5,43
Rapid Vienna,4846,3,7,10,7,33,32,1,31
LASK Linz,4846,4,8,5,11,27,29,-2,29
Mattersburg,4846,5,7,6,11,32,42,-10,27
Vienna,4846,6,7,5,12,25,39,-14,26
SC Rheindorf,4846,7,6,7,11,21,26,-5,25
FC Salzburg,4847,1,15,6,3,44,17,27,51
SK Sturm Gra,4847,2,13,3,8,32,29,3,42
Rapid Vienna,4847,3,9,10,5,35,27,8,37
LASK Linz,4847,4,8,6,10,25,28,-3,30
SC Rheindorf,4847,5,6,6,12,23,29,-6,24
Vienna,4847,6,6,6,12,25,41,-16,24
Mattersburg,4847,7,5,7,12,30,43,-13,22
FC Salzburg,4848,1,16,6,2,45,17,28,54
SK Sturm Gra,4848,2,12,4,8,30,27,3,40
Rapid Vienna,4848,3,8,11,5,33,25,8,35
LASK Linz,4848,4,7,9,8,24,25,-1,30
Mattersburg,4848,5,6,7,11,27,38,-11,25
Vienna,4848,6,6,6,12,23,38,-15,24
SC Rheindorf,4848,7,4,7,13,16,28,-12,19
FC Salzburg,4849,1,13,7,4,41,21,20,46
SK Sturm Gra,4849,2,12,6,6,34,28,6,42
Rapid Vienna,4849,3,9,11,4,38,25,13,38
LASK Linz,4849,4,8,8,8,27,27,0,32
Vienna,4849,5,8,5,11,26,37,-11,29
SC Rheindorf,4849,6,5,6,13,21,34,-13,21
Mattersburg,4849,7,5,5,14,28,43,-15,20
FC Salzburg,4850,1,15,6,3,47,20,27,51
SK Sturm Gra,4850,2,14,3,7,35,26,9,45
Rapid Vienna,4850,3,8,10,6,35,30,5,34
LASK Linz,4850,4,8,7,9,27,28,-1,31
Mattersburg,4850,5,7,6,11,33,40,-7,27
Vienna,4850,6,6,5,13,24,41,-17,23
SC Rheindorf,4850,7,5,5,14,20,36,-16,20
FC Salzburg,4851,1,15,6,3,45,17,28,51
SK Sturm Gra,4851,2,13,3,8,32,29,3,42
Rapid Vienna,4851,3,8,9,7,35,29,6,33
LASK Linz,4851,4,8,6,10,28,30,-2,30
SC Rheindorf,4851,5,7,6,11,22,28,-6,27
Mattersburg,4851,6,7,5,12,33,45,-12,26
Vienna,4851,7,6,5,13,25,42,-17,23
FC Salzburg,4852,1,15,7,2,46,18,28,52
SK Sturm Gra,4852,2,13,4,7,34,29,5,43
Rapid Vienna,4852,3,7,11,6,35,29,6,32
LASK Linz,4852,4,8,6,10,27,30,-3,30
Vienna,4852,5,7,5,12,25,39,-14,26
SC Rheindorf,4852,6,6,6,12,22,29,-7,24
Mattersburg,4852,7,6,5,13,30,45,-15,23
FC Salzburg,4853,1,15,6,3,44,18,26,51
SK Sturm Gra,4853,2,12,5,7,33,26,7,41
LASK Linz,4853,3,9,7,8,27,26,1,34
Rapid Vienna,4853,4,7,10,7,32,31,1,31
Vienna,4853,5,7,5,12,25,40,-15,26
Mattersburg,4853,6,6,6,12,32,43,-11,24
SC Rheindorf,4853,7,5,7,12,20,29,-9,22
FC Salzburg,4854,1,14,6,4,43,19,24,48
SK Sturm Gra,4854,2,13,4,7,32,28,4,43
Rapid Vienna,4854,3,8,9,7,33,29,4,33
LASK Linz,4854,4,9,6,9,29,28,1,33
Mattersburg,4854,5,7,5,12,31,41,-10,26
Vienna,4854,6,7,5,12,27,41,-14,26
SC Rheindorf,4854,7,6,5,13,21,30,-9,23
FC Salzburg,4855,1,14,7,3,43,18,25,49
SK Sturm Gra,4855,2,13,3,8,33,31,2,42
Rapid Vienna,4855,3,9,9,6,35,26,9,36
LASK Linz,4855,4,8,6,10,29,30,-1,30
Vienna,4855,5,8,5,11,27,37,-10,29
SC Rheindorf,4855,6,6,5,13,20,31,-11,23
Mattersburg,4855,7,5,7,12,28,42,-14,22
FC Salzburg,4856,1,14,7,3,48,20,28,49
SK Sturm Gra,4856,2,13,4,7,35,31,4,43
Rapid Vienna,4856,3,8,10,6,39,30,9,34
LASK Linz,4856,4,8,6,10,27,30,-3,30
Mattersburg,4856,5,7,7,10,31,39,-8,28
Vienna,4856,6,6,5,13,24,41,-17,23
SC Rheindorf,4856,7,5,7,12,19,32,-13,22
FC Salzburg,4857,1,13,8,3,43,21,22,47
SK Sturm Gra,4857,2,12,3,9,31,28,3,39
Rapid Vienna,4857,3,8,11,5,35,27,8,35
LASK Linz,4857,4,9,6,9,28,28,0,33
SC Rheindorf,4857,5,7,6,11,22,29,-7,27
Vienna,4857,6,7,5,12,28,38,-10,26
Mattersburg,4857,7,5,7,12,31,47,-16,22
FC Salzburg,4858,1,13,8,3,48,21,27,47
SK Sturm Gra,4858,2,13,4,7,35,29,6,43
Rapid Vienna,4858,3,9,10,5,38,29,9,37
LASK Linz,4858,4,10,5,9,33,30,3,35
Vienna,4858,5,8,5,11,26,38,-12,29
Mattersburg,4858,6,5,6,13,31,48,-17,21
SC Rheindorf,4858,7,4,6,14,18,34,-16,18
FC Salzburg,4859,1,15,6,3,45,17,28,51
SK Sturm Gra,4859,2,12,4,8,29,26,3,40
Rapid Vienna,4859,3,9,10,5,35,28,7,37
LASK Linz,4859,4,8,5,11,27,30,-3,29
Mattersburg,4859,5,8,5,11,37,41,-4,29
Vienna,4859,6,7,5,12,25,41,-16,26
SC Rheindorf,4859,7,4,7,13,17,32,-15,19
FC Salzburg,4860,1,16,6,2,48,18,30,54
SK Sturm Gra,4860,2,12,3,9,31,30,1,39
Rapid Vienna,4860,3,8,9,7,34,30,4,33
LASK Linz,4860,4,8,5,11,25,29,-4,29
SC Rheindorf,4860,5,7,6,11,19,26,-7,27
Vienna,4860,6,7,5,12,25,39,-14,26
Mattersburg,4860,7,6,6,12,31,41,-10,24
FC Salzburg,4861,1,13,8,3,46,21,25,47
SK Sturm Gra,4861,2,13,3,8,35,33,2,42
Rapid Vienna,4861,3,10,10,4,37,24,13,40
LASK Linz,4861,4,9,5,10,32,31,1,32
Mattersburg,4861,5,7,5,12,33,45,-12,26
Vienna,4861,6,6,6,12,27,42,-15,24
SC Rheindorf,4861,7,5,5,14,21,35,-14,20
FC Salzburg,4862,1,14,7,3,44,20,24,49
Rapid Vienna,4862,2,10,9,5,40,30,10,39
SK Sturm Gra,4862,3,11,4,9,32,32,0,37
LASK Linz,4862,4,9,5,10,30,31,-1,32
SC Rheindorf,4862,5,8,5,11,24,28,-4,29
Vienna,4862,6,7,5,12,25,39,-14,26
Mattersburg,4862,7,5,5,14,28,43,-15,20
FC Salzburg,4863,1,15,7,2,46,18,28,52
SK Sturm Gra,4863,2,14,4,6,39,29,10,46
Rapid Vienna,4863,3,8,9,7,34,31,3,33
LASK Linz,4863,4,9,5,10,29,29,0,32
Vienna,4863,5,6,6,12,23,38,-15,24
SC Rheindorf,4863,6,6,5,13,19,30,-11,23
Mattersburg,4863,7,5,6,13,28,43,-15,21
FC Salzburg,4864,1,14,7,3,46,19,27,49
SK Sturm Gra,4864,2,13,4,7,38,33,5,43
Rapid Vienna,4864,3,10,9,5,41,27,14,39
Vienna,4864,4,8,5,11,27,37,-10,29
LASK Linz,4864,5,7,6,11,26,33,-7,27
Mattersburg,4864,6,6,6,12,27,43,-16,24
SC Rheindorf,4864,7,5,5,14,17,30,-13,20
FC Salzburg,4865,1,15,7,2,45,17,28,52
SK Sturm Gra,4865,2,12,4,8,31,30,1,40
Rapid Vienna,4865,3,7,11,6,32,27,5,32
LASK Linz,4865,4,8,7,9,27,28,-1,31
Vienna,4865,5,7,6,11,29,40,-11,27
Mattersburg,4865,6,6,6,12,31,44,-13,24
SC Rheindorf,4865,7,5,7,12,22,31,-9,22
FC Salzburg,4866,1,14,6,4,42,19,23,48
SK Sturm Gra,4866,2,12,4,8,31,28,3,40
Rapid Vienna,4866,3,8,10,6,34,28,6,34
LASK Linz,4866,4,9,6,9,30,29,1,33
SC Rheindorf,4866,5,7,5,12,21,28,-7,26
Vienna,4866,6,7,5,12,25,39,-14,26
Mattersburg,4866,7,6,6,12,32,44,-12,24
FC Salzburg,4867,1,13,8,3,46,22,24,47
SK Sturm Gra,4867,2,12,4,8,36,32,4,40
LASK Linz,4867,3,9,5,10,28,31,-3,32
Rapid Vienna,4867,4,7,10,7,34,32,2,31
SC Rheindorf,4867,5,8,5,11,23,27,-4,29
Mattersburg,4867,6,7,5,12,31,39,-8,26
Vienna,4867,7,7,5,12,26,41,-15,26
FC Salzburg,4868,1,13,8,3,39,16,23,47
SK Sturm Gra,4868,2,12,6,6,31,26,5,42
Rapid Vienna,4868,3,8,10,6,34,27,7,34
LASK Linz,4868,4,8,7,9,27,28,-1,31
Mattersburg,4868,5,8,5,11,33,39,-6,29
Vienna,4868,6,6,5,13,23,40,-17,23
SC Rheindorf,4868,7,5,7,12,17,28,-11,22
FC Salzburg,4869,1,13,8,3,43,19,24,47
SK Sturm Gra,4869,2,13,4,7,34,29,5,43
Rapid Vienna,4869,3,9,10,5,38,27,11,37
LASK Linz,4869,4,8,5,11,27,31,-4,29
Mattersburg,4869,5,7,5,12,32,44,-12,26
SC Rheindorf,4869,6,6,6,12,24,33,-9,24
Vienna,4869,7,6,6,12,25,40,-15,24
FC Salzburg,4870,1,14,7,3,45,19,26,49
SK Sturm Gra,4870,2,12,4,8,31,28,3,40
Rapid Vienna,4870,3,9,11,4,35,25,10,38
LASK Linz,4870,4,8,7,9,29,31,-2,31
Vienna,4870,5,7,5,12,27,42,-15,26
Mattersburg,4870,6,5,8,11,34,45,-11,23
SC Rheindorf,4870,7,4,8,12,21,32,-11,20
FC Salzburg,4871,1,16,6,2,49,17,32,54
SK Sturm Gra,4871,2,12,3,9,31,30,1,39
Rapid Vienna,4871,3,8,9,7,37,30,7,33
LASK Linz,4871,4,9,5,10,29,31,-2,32
SC Rheindorf,4871,5,7,5,12,19,30,-11,26
Vienna,4871,6,7,5,12,27,39,-12,26
Mattersburg,4871,7,6,5,13,32,47,-15,23
FC Salzburg,4872,1,13,7,4,43,20,23,46
SK Sturm Gra,4872,2,11,6,7,30,28,2,39
LASK Linz,4872,3,10,6,8,34,28,6,36
Rapid Vienna,4872,4,8,11,5,35,29,6,35
Vienna,4872,5,8,5,11,28,38,-10,29
Mattersburg,4872,6,6,5,13,30,44,-14,23
SC Rheindorf,4872,7,5,6,13,19,32,-13,21
FC Salzburg,4873,1,16,6,2,48,18,30,54
SK Sturm Gra,4873,2,11,4,9,31,35,-4,37
Rapid Vienna,4873,3,9,9,6,35,27,8,36
LASK Linz,4873,4,10,5,9,31,27,4,35
Mattersburg,4873,5,6,6,12,31,43,-12,24
Vienna,4873,6,6,5,13,25,41,-16,23
SC Rheindorf,4873,7,5,7,12,18,28,-10,22
FC Salzburg,4874,1,13,7,4,45,21,24,46
Rapid Vienna,4874,2,10,10,4,39,27,12,40
SK Sturm Gra,4874,3,12,4,8,32,31,1,40
LASK Linz,4874,4,9,6,9,28,28,0,33
Mattersburg,4874,5,7,5,12,32,42,-10,26
Vienna,4874,6,6,6,12,25,40,-15,24
SC Rheindorf,4874,7,5,6,13,20,32,-12,21
FC Salzburg,4875,1,15,7,2,48,16,32,52
SK Sturm Gra,4875,2,13,4,7,33,28,5,43
Rapid Vienna,4875,3,8,10,6,33,29,4,34
Mattersburg,4875,4,8,5,11,33,41,-8,29
LASK Linz,4875,5,7,6,11,26,32,-6,27
Vienna,4875,6,6,6,12,24,39,-15,24
SC Rheindorf,4875,7,5,6,13,18,30,-12,21
FC Salzburg,4876,1,14,8,2,45,18,27,50
SK Sturm Gra,4876,2,13,4,7,33,27,6,43
Rapid Vienna,4876,3,8,11,5,35,28,7,35
LASK Linz,4876,4,7,8,9,28,30,-2,29
Vienna,4876,5,7,6,11,25,38,-13,27
Mattersburg,4876,6,7,5,12,29,41,-12,26
SC Rheindorf,4876,7,4,6,14,18,31,-13,18
FC Salzburg,4877,1,14,7,3,44,18,26,49
SK Sturm Gra,4877,2,13,3,8,33,28,5,42
Rapid Vienna,4877,3,9,11,4,40,26,14,38
LASK Linz,4877,4,9,6,9,28,30,-2,33
Vienna,4877,5,7,5,12,25,41,-16,26
Mattersburg,4877,6,6,5,13,31,41,-10,23
SC Rheindorf,4877,7,5,5,14,19,36,-17,20
FC Salzburg,4878,1,14,7,3,51,20,31,49
SK Sturm Gra,4878,2,12,4,8,30,29,1,40
Rapid Vienna,4878,3,7,12,5,33,26,7,33
LASK Linz,4878,4,7,6,11,24,30,-6,27
SC Rheindorf,4878,5,7,6,11,19,26,-7,27
Vienna,4878,6,7,6,11,28,41,-13,27
Mattersburg,4878,7,6,7,11,32,45,-13,25
FC Salzburg,4879,1,15,6,3,51,17,34,51
SK Sturm Gra,4879,2,12,3,9,30,33,-3,39
Rapid Vienna,4879,3,9,10,5,35,27,8,37
LASK Linz,4879,4,8,6,10,28,30,-2,30
Mattersburg,4879,5,7,5,12,31,44,-13,26
SC Rheindorf,4879,6,6,7,11,24,29,-5,25
Vienna,4879,7,6,5,13,25,44,-19,23
FC Salzburg,4880,1,14,8,2,42,16,26,50
SK Sturm Gra,4880,2,13,4,7,32,26,6,43
LASK Linz,4880,3,10,5,9,28,27,1,35
Rapid Vienna,4880,4,8,10,6,35,29,6,34
Vienna,4880,5,7,5,12,24,39,-15,26
Mattersburg,4880,6,6,5,13,30,42,-12,23
SC Rheindorf,4880,7,5,5,14,21,33,-12,20
FC Salzburg,4881,1,15,6,3,46,19,27,51
SK Sturm Gra,4881,2,15,3,6,37,25,12,48
LASK Linz,4881,3,9,6,9,28,26,2,33
Rapid Vienna,4881,4,7,9,8,34,33,1,30
Mattersburg,4881,5,6,7,11,30,43,-13,25
Vienna,4881,6,6,6,12,24,39,-15,24
SC Rheindorf,4881,7,5,5,14,17,31,-14,20
FC Salzburg,4882,1,14,8,2,45,19,26,50
SK Sturm Gra,4882,2,12,4,8,36,31,5,40
Rapid Vienna,4882,3,8,11,5,36,28,8,35
LASK Linz,4882,4,8,6,10,27,31,-4,30
Vienna,4882,5,7,6,11,25,38,-13,27
Mattersburg,4882,6,7,5,12,33,42,-9,26
SC Rheindorf,4882,7,4,8,12,17,30,-13,20
FC Salzburg,4883,1,12,8,4,41,21,20,44
SK Sturm Gra,4883,2,12,5,7,34,26,8,41
Rapid Vienna,4883,3,8,11,5,37,32,5,35
Mattersburg,4883,4,8,6,10,38,41,-3,30
LASK Linz,4883,5,7,8,9,28,30,-2,29
Vienna,4883,6,7,5,12,27,41,-14,26
SC Rheindorf,4883,7,6,5,13,18,32,-14,23
FC Salzburg,4884,1,15,6,3,51,17,34,51
SK Sturm Gra,4884,2,12,4,8,33,32,1,40
LASK Linz,4884,3,11,5,8,30,26,4,38
Rapid Vienna,4884,4,8,9,7,34,31,3,33
Mattersburg,4884,5,6,6,12,32,44,-12,24
Vienna,4884,6,6,6,12,23,41,-18,24
SC Rheindorf,4884,7,5,6,13,21,33,-12,21
FC Salzburg,4885,1,16,6,2,48,18,30,54
SK Sturm Gra,4885,2,12,4,8,34,31,3,40
Rapid Vienna,4885,3,10,9,5,37,25,12,39
LASK Linz,4885,4,7,6,11,26,33,-7,27
Mattersburg,4885,5,6,7,11,34,46,-12,25
Vienna,4885,6,6,6,12,27,42,-15,24
SC Rheindorf,4885,7,5,6,13,18,29,-11,21
FC Salzburg,4886,1,14,7,3,44,20,24,49
SK Sturm Gra,4886,2,12,4,8,33,30,3,40
Rapid Vienna,4886,3,8,11,5,37,28,9,35
LASK Linz,4886,4,8,6,10,27,33,-6,30
Mattersburg,4886,5,7,6,11,36,41,-5,27
Vienna,4886,6,7,5,12,25,39,-14,26
SC Rheindorf,4886,7,6,5,13,20,31,-11,23
FC Salzburg,4887,1,15,7,2,47,17,30,52
SK Sturm Gra,4887,2,12,4,8,30,28,2,40
Rapid Vienna,4887,3,7,11,6,33,31,2,32
LASK Linz,4887,4,7,8,9,25,27,-2,29
SC Rheindorf,4887,5,7,6,11,22,27,-5,27
Vienna,4887,6,7,6,11,25,38,-13,27
Mattersburg,4887,7,5,6,13,28,42,-14,21
FC Salzburg,4888,1,15,7,2,48,17,31,52
Rapid Vienna,4888,2,9,10,5,36,27,9,37
SK Sturm Gra,4888,3,11,4,9,33,33,0,37
LASK Linz,4888,4,9,6,9,30,28,2,33
Mattersburg,4888,5,7,6,11,30,41,-11,27
Vienna,4888,6,6,5,13,23,42,-19,23
SC Rheindorf,4888,7,5,6,13,18,30,-12,21
FC Salzburg,4889,1,16,6,2,49,15,34,54
SK Sturm Gra,4889,2,12,4,8,31,30,1,40
Rapid Vienna,4889,3,8,10,6,34,28,6,34
SC Rheindorf,4889,4,7,6,11,22,29,-7,27
LASK Linz,4889,5,7,5,12,24,30,-6,26
Mattersburg,4889,6,6,7,11,32,43,-11,25
Vienna,4889,7,6,6,12,26,43,-17,24
FC Salzburg,4890,1,15,7,2,46,20,26,52
SK Sturm Gra,4890,2,13,4,7,32,26,6,43
Rapid Vienna,4890,3,8,11,5,36,28,8,35
Mattersburg,4890,4,7,7,10,36,41,-5,28
LASK Linz,4890,5,7,6,11,24,31,-7,27
Vienna,4890,6,6,5,13,24,41,-17,23
SC Rheindorf,4890,7,5,6,13,17,28,-11,21
FC Salzburg,4891,1,14,7,3,45,19,26,49
SK Sturm Gra,4891,2,14,4,6,36,27,9,46
Rapid Vienna,4891,3,9,10,5,35,27,8,37
LASK Linz,4891,4,7,8,9,26,29,-3,29
Vienna,4891,5,7,5,12,26,41,-15,26
Mattersburg,4891,6,5,7,12,29,42,-13,22
SC Rheindorf,4891,7,4,7,13,19,31,-12,19
FC Salzburg,4892,1,14,6,4,44,20,24,48
SK Sturm Gra,4892,2,12,5,7,32,28,4,41
Rapid Vienna,4892,3,9,10,5,35,28,7,37
LASK Linz,4892,4,8,6,10,27,28,-1,30
Vienna,4892,5,8,5,11,27,37,-10,29
Mattersburg,4892,6,6,6,12,29,42,-13,24
SC Rheindorf,4892,7,5,6,13,18,29,-11,21
FC Salzburg,4893,1,14,7,3,49,21,28,49
SK Sturm Gra,4893,2,11,3,10,32,37,-5,36
LASK Linz,4893,3,10,5,9,31,28,3,35
Rapid Vienna,4893,4,8,10,6,35,33,2,34
Mattersburg,4893,5,7,6,11,31,39,-8,27
Vienna,4893,6,7,6,11,25,38,-13,27
SC Rheindorf,4893,7,5,7,12,20,27,-7,22
FC Salzburg,4894,1,14,7,3,44,20,24,49
SK Sturm Gra,4894,2,13,3,8,35,31,4,42
Rapid Vienna,4894,3,10,9,5,40,27,13,39
Mattersburg,4894,4,7,7,10,34,39,-5,28
LASK Linz,4894,5,7,5,12,25,36,-11,26
SC Rheindorf,4894,6,6,6,12,23,31,-8,24
Vienna,4894,7,6,5,13,23,40,-17,23
FC Salzburg,4895,1,14,7,3,47,20,27,49
SK Sturm Gra,4895,2,12,5,7,33,29,4,41
Rapid Vienna,4895,3,8,10,6,34,27,7,34
LASK Linz,4895,4,8,5,11,27,32,-5,29
Mattersburg,4895,5,8,5,11,32,40,-8,29
SC Rheindorf,4895,6,7,5,12,20,26,-6,26
Vienna,4895,7,6,5,13,25,44,-19,23
FC Salzburg,4896,1,14,8,2,45,19,26,50
SK Sturm Gra,4896,2,13,3,8,34,31,3,42
Rapid Vienna,4896,3,9,10,5,35,25,10,37
Mattersburg,4896,4,7,6,11,34,42,-8,27
LASK Linz,4896,5,7,5,12,25,30,-5,26
SC Rheindorf,4896,6,6,6,12,20,29,-9,24
Vienna,4896,7,6,6,12,26,43,-17,24
FC Salzburg,4897,1,15,6,3,46,20,26,51
SK Sturm Gra,4897,2,13,4,7,32,28,4,43
LASK Linz,4897,3,10,6,8,31,25,6,36
Rapid Vienna,4897,4,8,10,6,34,27,7,34
Mattersburg,4897,5,7,5,12,28,40,-12,26
Vienna,4897,6,6,5,13,25,41,-16,23
SC Rheindorf,4897,7,4,6,14,16,31,-15,18
FC Salzburg,4898,1,14,7,3,42,18,24,49
SK Sturm Gra,4898,2,13,3,8,37,31,6,42
Rapid Vienna,4898,3,8,12,4,38,25,13,36
LASK Linz,4898,4,8,6,10,26,32,-6,30
Mattersburg,4898,5,7,6,11,33,39,-6,27
Vienna,4898,6,7,6,11,25,38,-13,27
SC Rheindorf,4898,7,4,6,14,17,35,-18,18
FC Salzburg,4899,1,15,7,2,45,18,27,52
SK Sturm Gra,4899,2,13,4,7,33,27,6,43
Rapid Vienna,4899,3,8,11,5,41,30,11,35
LASK Linz,4899,4,8,5,11,25,33,-8,29
Mattersburg,4899,5,7,5,12,29,40,-11,26
SC Rheindorf,4899,6,6,5,13,21,30,-9,23
Vienna,4899,7,6,5,13,23,39,-16,23
FC Salzburg,4900,1,15,6,3,46,17,29,51
Rapid Vienna,4900,2,10,10,4,37,26,11,40
SK Sturm Gra,4900,3,11,4,9,30,33,-3,37
LASK Linz,4900,4,8,6,10,27,29,-2,30
Vienna,4900,5,7,5,12,25,39,-14,26
SC Rheindorf,4900,6,6,6,12,23,30,-7,24
Mattersburg,4900,7,5,7,12,28,42,-14,22
FC Salzburg,4901,1,14,6,4,43,20,23,48
SK Sturm Gra,4901,2,13,3,8,36,31,5,42
Rapid Vienna,4901,3,10,9,5,36,27,9,39
LASK Linz,4901,4,9,6,9,29,28,1,33
Vienna,4901,5,8,5,11,29,40,-11,29
Mattersburg,4901,6,5,6,13,32,46,-14,21
SC Rheindorf,4901,7,4,7,13,18,31,-13,19
FC Salzburg,4902,1,14,6,4,46,19,27,48
SK Sturm Gra,4902,2,14,3,7,34,29,5,45
Rapid Vienna,4902,3,8,11,5,36,29,7,35
Vienna,4902,4,8,5,11,26,38,-12,29
LASK Linz,4902,5,7,7,10,27,31,-4,28
SC Rheindorf,4902,6,5,7,12,19,28,-9,22
Mattersburg,4902,7,5,7,12,29,43,-14,22
FC Salzburg,4903,1,14,8,2,45,19,26,50
Rapid Vienna,4903,2,9,11,4,36,25,11,38
SK Sturm Gra,4903,3,11,4,9,31,32,-1,37
LASK Linz,4903,4,8,7,9,25,26,-1,31
Vienna,4903,5,7,6,11,25,38,-13,27
Mattersburg,4903,6,6,6,12,30,40,-10,24
SC Rheindorf,4903,7,4,8,12,19,31,-12,20
FC Salzburg,4904,1,13,8,3,41,19,22,47
SK Sturm Gra,4904,2,12,5,7,33,28,5,41
Rapid Vienna,4904,3,9,10,5,37,28,9,37
LASK Linz,4904,4,8,7,9,28,30,-2,31
Vienna,4904,5,7,5,12,27,40,-13,26
SC Rheindorf,4904,6,6,6,12,18,27,-9,24
Mattersburg,4904,7,6,5,13,29,41,-12,23
FC Salzburg,4905,1,14,7,3,43,17,26,49
Rapid Vienna,4905,2,10,10,4,38,26,12,40
SK Sturm Gra,4905,3,11,5,8,30,28,2,38
LASK Linz,4905,4,7,7,10,27,31,-4,28
Mattersburg,4905,5,7,6,11,30,40,-10,27
Vienna,4905,6,6,7,11,24,38,-14,25
SC Rheindorf,4905,7,5,6,13,18,30,-12,21
FC Salzburg,4906,1,15,6,3,51,20,31,51
SK Sturm Gra,4906,2,11,5,8,30,32,-2,38
Rapid Vienna,4906,3,9,9,6,37,29,8,36
LASK Linz,4906,4,8,7,9,27,28,-1,31
Mattersburg,4906,5,7,5,12,31,44,-13,26
Vienna,4906,6,7,5,12,28,41,-13,26
SC Rheindorf,4906,7,5,7,12,17,27,-10,22
FC Salzburg,4907,1,16,6,2,50,18,32,54
SK Sturm Gra,4907,2,13,4,7,34,30,4,43
LASK Linz,4907,3,8,7,9,28,28,0,31
Rapid Vienna,4907,4,7,9,8,33,32,1,30
Mattersburg,4907,5,7,6,11,31,43,-12,27
Vienna,4907,6,6,5,13,26,43,-17,23
SC Rheindorf,4907,7,5,7,12,20,28,-8,22
FC Salzburg,4908,1,14,8,2,46,21,25,50
SK Sturm Gra,4908,2,12,5,7,33,29,4,41
Rapid Vienna,4908,3,8,11,5,34,26,8,35
LASK Linz,4908,4,8,7,9,28,29,-1,31
Vienna,4908,5,7,5,12,26,40,-14,26
Mattersburg,4908,6,6,7,11,34,44,-10,25
SC Rheindorf,4908,7,4,7,13,18,30,-12,19
FC Salzburg,4909,1,15,7,2,48,19,29,52
SK Sturm Gra,4909,2,12,6,6,35,28,7,42
Rapid Vienna,4909,3,7,10,7,36,33,3,31
LASK Linz,4909,4,8,6,10,26,32,-6,30
Mattersburg,4909,5,7,6,11,31,40,-9,27
SC Rheindorf,4909,6,5,8,11,23,31,-8,23
Vienna,4909,7,6,5,13,25,41,-16,23
FC Salzburg,4910,1,13,7,4,43,20,23,46
SK Sturm Gra,4910,2,12,3,9,34,34,0,39
Rapid Vienna,4910,3,9,10,5,40,29,11,37
LASK Linz,4910,4,10,5,9,28,31,-3,35
Vienna,4910,5,8,5,11,26,38,-12,29
SC Rheindorf,4910,6,6,5,13,23,31,-8,23
Mattersburg,4910,7,6,5,13,34,45,-11,23
FC Salzburg,4911,1,15,6,3,42,17,25,51
SK Sturm Gra,4911,2,14,3,7,38,28,10,45
Rapid Vienna,4911,3,9,9,6,34,26,8,36
LASK Linz,4911,4,7,6,11,28,36,-8,27
Mattersburg,4911,5,7,6,11,31,40,-9,27
Vienna,4911,6,6,6,12,25,40,-15,24
SC Rheindorf,4911,7,5,6,13,18,29,-11,21
FC Salzburg,4912,1,15,6,3,49,17,32,51
SK Sturm Gra,4912,2,13,4,7,37,29,8,43
LASK Linz,4912,3,9,6,9,28,32,-4,33
Rapid Vienna,4912,4,7,10,7,34,33,1,31
Vienna,4912,5,7,6,11,26,39,-13,27
SC Rheindorf,4912,6,6,6,12,19,28,-9,24
Mattersburg,4912,7,5,6,13,28,43,-15,21
FC Salzburg,4913,1,13,8,3,41,19,22,47
SK Sturm Gra,4913,2,12,5,7,33,28,5,41
Rapid Vienna,4913,3,8,10,6,34,28,6,34
LASK Linz,4913,4,8,5,11,25,28,-3,29
Vienna,4913,5,8,5,11,27,38,-11,29
SC Rheindorf,4913,6,7,5,12,21,28,-7,26
Mattersburg,4913,7,6,6,12,29,41,-12,24
FC Salzburg,4914,1,15,7,2,49,16,33,52
SK Sturm Gra,4914,2,12,4,8,32,31,1,40
Rapid Vienna,4914,3,7,11,6,32,29,3,32
LASK Linz,4914,4,7,8,9,27,29,-2,29
Mattersburg,4914,5,7,6,11,35,44,-9,27
SC Rheindorf,4914,6,6,7,11,23,28,-5,25
Vienna,4914,7,6,5,13,23,44,-21,23
FC Salzburg,4915,1,15,7,2,47,16,31,52
SK Sturm Gra,4915,2,13,4,7,32,26,6,43
Rapid Vienna,4915,3,9,9,6,38,27,11,36
LASK Linz,4915,4,7,5,12,23,32,-9,26
SC Rheindorf,4915,5,7,5,12,21,30,-9,26
Vienna,4915,6,7,5,12,27,41,-14,26
Mattersburg,4915,7,6,5,13,31,47,-16,23
FC Salzburg,4916,1,13,7,4,46,20,26,46
SK Sturm Gra,4916,2,13,4,7,33,27,6,43
Rapid Vienna,4916,3,10,10,4,38,25,13,40
Mattersburg,4916,4,8,5,11,33,40,-7,29
LASK Linz,4916,5,7,6,11,25,32,-7,27
Vienna,4916,6,7,5,12,26,43,-17,26
SC Rheindorf,4916,7,4,7,13,19,33,-14,19
FC Salzburg,4917,1,15,6,3,45,18,27,51
Rapid Vienna,4917,2,9,11,4,38,26,12,38
SK Sturm Gra,4917,3,11,4,9,30,31,-1,37
LASK Linz,4917,4,8,8,8,29,29,0,32
Vienna,4917,5,7,5,12,25,38,-13,26
SC Rheindorf,4917,6,5,7,12,20,30,-10,22
Mattersburg,4917,7,5,7,12,28,43,-15,22
FC Salzburg,4918,1,15,6,3,48,21,27,51
SK Sturm Gra,4918,2,13,3,8,31,29,2,42
LASK Linz,4918,3,9,7,8,29,28,1,34
Rapid Vienna,4918,4,7,9,8,36,32,4,30
Mattersburg,4918,5,6,8,10,33,41,-8,26
Vienna,4918,6,6,6,12,24,39,-15,24
SC Rheindorf,4918,7,5,7,12,21,32,-11,22
FC Salzburg,4919,1,15,6,3,48,19,29,51
SK Sturm Gra,4919,2,11,4,9,32,31,1,37
Rapid Vienna,4919,3,8,11,5,37,29,8,35
LASK Linz,4919,4,8,7,9,28,30,-2,31
Vienna,4919,5,7,5,12,27,40,-13,26
SC Rheindorf,4919,6,6,7,11,21,29,-8,25
Mattersburg,4919,7,6,6,12,32,47,-15,24
FC Salzburg,4920,1,13,8,3,40,18,22,47
SK Sturm Gra,4920,2,11,6,7,30,29,1,39
Rapid Vienna,4920,3,9,11,4,36,25,11,38
LASK Linz,4920,4,8,5,11,26,30,-4,29
Mattersburg,4920,5,8,5,11,35,40,-5,29
Vienna,4920,6,7,5,12,27,40,-13,26
SC Rheindorf,4920,7,5,6,13,21,33,-12,21
FC Salzburg,4921,1,14,7,3,43,19,24,49
SK Sturm Gra,4921,2,13,4,7,34,29,5,43
Rapid Vienna,4921,3,9,11,4,41,28,13,38
LASK Linz,4921,4,7,7,10,29,32,-3,28
Mattersburg,4921,5,5,9,10,29,39,-10,24
Vienna,4921,6,6,6,12,24,39,-15,24
SC Rheindorf,4921,7,5,6,13,18,32,-14,21
FC Salzburg,4922,1,14,6,4,46,24,22,48
SK Sturm Gra,4922,2,13,4,7,33,27,6,43
LASK Linz,4922,3,9,6,9,27,28,-1,33
Rapid Vienna,4922,4,7,10,7,36,32,4,31
Vienna,4922,5,8,5,11,30,40,-10,29
Mattersburg,4922,6,7,6,11,33,42,-9,27
SC Rheindorf,4922,7,4,7,13,19,31,-12,19
FC Salzburg,4923,1,14,6,4,44,19,25,48
SK Sturm Gra,4923,2,11,6,7,30,29,1,39
Rapid Vienna,4923,3,9,10,5,36,29,7,37
LASK Linz,4923,4,8,6,10,28,30,-2,30
Mattersburg,4923,5,8,6,10,32,37,-5,30
Vienna,4923,6,6,6,12,24,39,-15,24
SC Rheindorf,4923,7,5,6,13,19,30,-11,21
FC Salzburg,4924,1,13,8,3,43,20,23,47
SK Sturm Gra,4924,2,13,5,6,33,26,7,44
Rapid Vienna,4924,3,7,11,6,33,28,5,32
Mattersburg,4924,4,9,5,10,33,39,-6,32
LASK Linz,4924,5,8,6,10,24,26,-2,30
Vienna,4924,6,6,6,12,27,42,-15,24
SC Rheindorf,4924,7,4,7,13,20,32,-12,19
FC Salzburg,4925,1,15,6,3,45,20,25,51
SK Sturm Gra,4925,2,12,3,9,32,32,0,39
Rapid Vienna,4925,3,8,10,6,35,28,7,34
LASK Linz,4925,4,9,5,10,29,30,-1,32
Mattersburg,4925,5,7,6,11,31,41,-10,27
Vienna,4925,6,7,5,12,26,39,-13,26
SC Rheindorf,4925,7,5,7,12,21,29,-8,22
FC Salzburg,4926,1,14,7,3,47,23,24,49
SK Sturm Gra,4926,2,12,4,8,34,31,3,40
Rapid Vienna,4926,3,9,9,6,34,26,8,36
LASK Linz,4926,4,8,7,9,27,28,-1,31
Vienna,4926,5,7,5,12,28,41,-13,26
SC Rheindorf,4926,6,6,6,12,20,29,-9,24
Mattersburg,4926,7,6,6,12,30,42,-12,24
FC Salzburg,4927,1,15,6,3,46,21,25,51
SK Sturm Gra,4927,2,14,3,7,33,25,8,45
Rapid Vienna,4927,3,8,10,6,36,27,9,34
LASK Linz,4927,4,8,7,9,26,26,0,31
Vienna,4927,5,7,5,12,28,39,-11,26
SC Rheindorf,4927,6,6,6,12,19,30,-11,24
Mattersburg,4927,7,5,5,14,29,49,-20,20
FC Salzburg,4928,1,15,7,2,43,17,26,52
SK Sturm Gra,4928,2,12,6,6,34,28,6,42
Rapid Vienna,4928,3,8,10,6,33,26,7,34
LASK Linz,4928,4,8,7,9,28,30,-2,31
Mattersburg,4928,5,7,5,12,32,41,-9,26
Vienna,4928,6,6,5,13,24,41,-17,23
SC Rheindorf,4928,7,5,6,13,19,30,-11,21
FC Salzburg,4929,1,14,6,4,43,19,24,48
SK Sturm Gra,4929,2,13,5,6,32,25,7,44
Rapid Vienna,4929,3,8,11,5,34,27,7,35
LASK Linz,4929,4,8,6,10,28,31,-3,30
Vienna,4929,5,7,5,12,26,39,-13,26
Mattersburg,4929,6,6,6,12,31,43,-12,24
SC Rheindorf,4929,7,4,9,11,17,27,-10,21
FC Salzburg,4930,1,13,6,5,43,21,22,45
SK Sturm Gra,4930,2,13,4,7,35,28,7,43
Rapid Vienna,4930,3,8,11,5,35,27,8,35
LASK Linz,4930,4,8,7,9,30,32,-2,31
Vienna,4930,5,8,5,11,27,38,-11,29
SC Rheindorf,4930,6,6,6,12,21,29,-8,24
Mattersburg,4930,7,6,5,13,29,45,-16,23
FC Salzburg,4931,1,15,7,2,46,19,27,52
SK Sturm Gra,4931,2,12,5,7,35,31,4,41
Rapid Vienna,4931,3,8,10,6,38,32,6,34
LASK Linz,4931,4,7,8,9,26,28,-2,29
Vienna,4931,5,7,6,11,26,39,-13,27
Mattersburg,4931,6,6,6,12,30,41,-11,24
SC Rheindorf,4931,7,5,6,13,20,31,-11,21
FC Salzburg,4932,1,14,7,3,47,18,29,49
SK Sturm Gra,4932,2,13,4,7,33,30,3,43
LASK Linz,4932,3,9,7,8,28,26,2,34
Rapid Vienna,4932,4,7,11,6,33,27,6,32
Vienna,4932,5,7,6,11,26,39,-13,27
Mattersburg,4932,6,5,8,11,30,43,-13,23
SC Rheindorf,4932,7,4,7,13,17,31,-14,19
FC Salzburg,4933,1,15,6,3,46,19,27,51
SK Sturm Gra,4933,2,14,3,7,36,31,5,45
Rapid Vienna,4933,3,9,9,6,36,26,10,36
LASK Linz,4933,4,8,5,11,27,34,-7,29
Mattersburg,4933,5,6,7,11,32,42,-10,25
Vienna,4933,6,6,6,12,24,39,-15,24
SC Rheindorf,4933,7,5,6,13,19,29,-10,21
FC Salzburg,4934,1,15,7,2,46,19,27,52
SK Sturm Gra,4934,2,11,4,9,32,31,1,37
Rapid Vienna,4934,3,7,12,5,36,29,7,33
LASK Linz,4934,4,9,5,10,28,30,-2,32
Vienna,4934,5,7,5,12,27,41,-14,26
SC Rheindorf,4934,6,6,7,11,21,28,-7,25
Mattersburg,4934,7,6,6,12,30,42,-12,24
FC Salzburg,4935,1,14,8,2,44,16,28,50
SK Sturm Gra,4935,2,12,5,7,36,32,4,41
Rapid Vienna,4935,3,7,12,5,36,29,7,33
LASK Linz,4935,4,7,8,9,28,32,-4,29
Mattersburg,4935,5,7,5,12,32,41,-9,26
SC Rheindorf,4935,6,6,6,12,20,30,-10,24
Vienna,4935,7,6,6,12,24,40,-16,24
FC Salzburg,4936,1,15,6,3,44,20,24,51
Rapid Vienna,4936,2,10,9,5,42,27,15,39
SK Sturm Gra,4936,3,12,3,9,33,34,-1,39
LASK Linz,4936,4,9,6,9,30,30,0,33
Vienna,4936,5,7,5,12,25,40,-15,26
Mattersburg,4936,6,5,7,12,30,42,-12,22
SC Rheindorf,4936,7,5,6,13,19,30,-11,21
FC Salzburg,4937,1,15,6,3,48,19,29,51
SK Sturm Gra,4937,2,13,3,8,34,33,1,42
Rapid Vienna,4937,3,8,10,6,40,31,9,34
LASK Linz,4937,4,7,7,10,29,32,-3,28
SC Rheindorf,4937,5,7,5,12,22,30,-8,26
Vienna,4937,6,7,5,12,25,42,-17,26
Mattersburg,4937,7,6,6,12,31,42,-11,24
FC Salzburg,4938,1,15,7,2,45,19,26,52
SK Sturm Gra,4938,2,12,3,9,32,31,1,39
Rapid Vienna,4938,3,8,10,6,34,29,5,34
LASK Linz,4938,4,8,6,10,29,29,0,30
Vienna,4938,5,7,6,11,26,39,-13,27
SC Rheindorf,4938,6,6,7,11,22,29,-7,25
Mattersburg,4938,7,6,5,13,31,43,-12,23
FC Salzburg,4939,1,14,6,4,43,20,23,48
Rapid Vienna,4939,2,10,10,4,39,27,12,40
SK Sturm Gra,4939,3,11,4,9,30,30,0,37
LASK Linz,4939,4,9,7,8,31,29,2,34
Mattersburg,4939,5,7,5,12,31,41,-10,26
Vienna,4939,6,6,5,13,25,42,-17,23
SC Rheindorf,4939,7,5,7,12,20,30,-10,22
FC Salzburg,4940,1,15,6,3,45,18,27,51
Rapid Vienna,4940,2,10,10,4,36,24,12,40
SK Sturm Gra,4940,3,12,3,9,30,31,-1,39
LASK Linz,4940,4,8,7,9,26,26,0,31
Vienna,4940,5,7,5,12,30,40,-10,26
Mattersburg,4940,6,6,6,12,29,45,-16,24
SC Rheindorf,4940,7,4,7,13,16,28,-12,19
FC Salzburg,4941,1,14,7,3,47,19,28,49
SK Sturm Gra,4941,2,12,4,8,32,33,-1,40
Rapid Vienna,4941,3,9,10,5,34,26,8,37
LASK Linz,4941,4,9,6,9,29,29,0,33
Vienna,4941,5,7,6,11,26,39,-13,27
Mattersburg,4941,6,7,5,12,34,42,-8,26
SC Rheindorf,4941,7,4,6,14,17,31,-14,18
FC Salzburg,4942,1,15,7,2,52,18,34,52
SK Sturm Gra,4942,2,13,4,7,34,31,3,43
Rapid Vienna,4942,3,8,11,5,37,29,8,35
LASK Linz,4942,4,10,5,9,30,28,2,35
Vienna,4942,5,7,5,12,27,40,-13,26
SC Rheindorf,4942,6,5,5,14,20,33,-13,20
Mattersburg,4942,7,5,5,14,29,50,-21,20
FC Salzburg,4943,1,14,8,2,45,17,28,50
SK Sturm Gra,4943,2,14,3,7,37,30,7,45
Rapid Vienna,4943,3,8,10,6,34,29,5,34
LASK Linz,4943,4,9,6,9,28,28,0,33
Mattersburg,4943,5,6,6,12,29,39,-10,24
Vienna,4943,6,6,6,12,24,40,-16,24
SC Rheindorf,4943,7,5,5,14,20,34,-14,20
FC Salzburg,4944,1,15,7,2,46,17,29,52
SK Sturm Gra,4944,2,13,3,8,36,30,6,42
Rapid Vienna,4944,3,8,9,7,35,31,4,33
LASK Linz,4944,4,8,7,9,28,31,-3,31
Vienna,4944,5,7,5,12,27,39,-12,26
Mattersburg,4944,6,6,7,11,28,40,-12,25
SC Rheindorf,4944,7,5,6,13,18,30,-12,21
FC Salzburg,4945,1,16,6,2,46,18,28,54
SK Sturm Gra,4945,2,12,4,8,33,31,2,40
Rapid Vienna,4945,3,9,10,5,37,26,11,37
LASK Linz,4945,4,7,6,11,25,30,-5,27
Mattersburg,4945,5,6,7,11,30,39,-9,25
SC Rheindorf,4945,6,6,6,12,20,29,-9,24
Vienna,4945,7,6,5,13,26,44,-18,23
FC Salzburg,4946,1,13,8,3,46,19,27,47
SK Sturm Gra,4946,2,12,5,7,32,28,4,41
Rapid Vienna,4946,3,9,10,5,36,27,9,37
LASK Linz,4946,4,8,5,11,28,30,-2,29
Mattersburg,4946,5,7,6,11,30,42,-12,27
Vienna,4946,6,7,6,11,25,38,-13,27
SC Rheindorf,4946,7,5,6,13,16,29,-13,21
FC Salzburg,4947,1,14,8,2,44,18,26,50
SK Sturm Gra,4947,2,14,4,6,34,25,9,46
Rapid Vienna,4947,3,8,9,7,34,29,5,33
LASK Linz,4947,4,8,7,9,28,29,-1,31
Mattersburg,4947,5,6,6,12,31,43,-12,24
Vienna,4947,6,6,6,12,26,41,-15,24
SC Rheindorf,4947,7,5,6,13,16,28,-12,21
FC Salzburg,4948,1,13,8,3,43,21,22,47
SK Sturm Gra,4948,2,13,3,8,32,26,6,42
Rapid Vienna,4948,3,8,10,6,34,29,5,34
LASK Linz,4948,4,8,5,11,24,28,-4,29
Vienna,4948,5,7,6,11,27,40,-13,27
Mattersburg,4948,6,7,5,12,34,41,-7,26
SC Rheindorf,4948,7,7,5,12,21,30,-9,26
FC Salzburg,4949,1,14,7,3,48,21,27,49
SK Sturm Gra,4949,2,13,4,7,33,28,5,43
Rapid Vienna,4949,3,8,9,7,33,30,3,33
LASK Linz,4949,4,7,8,9,26,28,-2,29
SC Rheindorf,4949,5,7,6,11,24,29,-5,27
Vienna,4949,6,7,5,12,27,42,-15,26
Mattersburg,4949,7,5,7,12,32,45,-13,22
FC Salzburg,4950,1,15,7,2,46,18,28,52
SK Sturm Gra,4950,2,12,5,7,33,29,4,41
Rapid Vienna,4950,3,9,9,6,37,29,8,36
LASK Linz,4950,4,8,6,10,29,32,-3,30
Mattersburg,4950,5,7,5,12,33,43,-10,26
Vienna,4950,6,7,5,12,27,41,-14,26
SC Rheindorf,4950,7,4,7,13,16,29,-13,19
FC Salzburg,4951,1,14,7,3,46,20,26,49
SK Sturm Gra,4951,2,13,4,7,34,28,6,43
Rapid Vienna,4951,3,9,9,6,34,29,5,36
LASK Linz,4951,4,8,6,10,28,30,-2,30
Vienna,4951,5,7,6,11,27,39,-12,27
Mattersburg,4951,6,7,5,12,32,42,-10,26
SC Rheindorf,4951,7,5,5,14,18,31,-13,20
FC Salzburg,4952,1,15,7,2,48,17,31,52
SK Sturm Gra,4952,2,13,3,8,34,30,4,42
Rapid Vienna,4952,3,9,9,6,33,27,6,36
LASK Linz,4952,4,8,5,11,26,32,-6,29
Vienna,4952,5,6,7,11,24,38,-14,25
Mattersburg,4952,6,6,6,12,33,45,-12,24
SC Rheindorf,4952,7,6,5,13,20,29,-9,23
FC Salzburg,4953,1,13,9,2,43,17,26,48
SK Sturm Gra,4953,2,13,5,6,34,27,7,44
Rapid Vienna,4953,3,7,11,6,34,28,6,32
LASK Linz,4953,4,7,9,8,29,30,-1,30
SC Rheindorf,4953,5,6,6,12,20,30,-10,24
Mattersburg,4953,6,6,6,12,30,43,-13,24
Vienna,4953,7,6,6,12,25,40,-15,24
FC Salzburg,4954,1,16,6,2,46,16,30,54
SK Sturm Gra,4954,2,12,4,8,31,28,3,40
Rapid Vienna,4954,3,8,9,7,34,28,6,33
LASK Linz,4954,4,9,5,10,27,29,-2,32
Mattersburg,4954,5,8,5,11,30,40,-10,29
Vienna,4954,6,6,5,13,23,39,-16,23
SC Rheindorf,4954,7,5,6,13,18,29,-11,21
FC Salzburg,4955,1,14,7,3,42,17,25,49
SK Sturm Gra,4955,2,13,3,8,34,29,5,42
Rapid Vienna,4955,3,8,10,6,33,27,6,34
LASK Linz,4955,4,9,7,8,30,29,1,34
Vienna,4955,5,7,6,11,25,38,-13,27
Mattersburg,4955,6,5,7,12,32,44,-12,22
SC Rheindorf,4955,7,5,6,13,19,31,-12,21
FC Salzburg,4956,1,14,7,3,49,19,30,49
SK Sturm Gra,4956,2,13,4,7,33,27,6,43
LASK Linz,4956,3,10,5,9,33,30,3,35
Rapid Vienna,4956,4,8,10,6,35,30,5,34
Mattersburg,4956,5,7,6,11,34,45,-11,27
Vienna,4956,6,6,5,13,25,46,-21,23
SC Rheindorf,4956,7,4,7,13,17,29,-12,19
FC Salzburg,4957,1,14,8,2,47,20,27,50
SK Sturm Gra,4957,2,12,4,8,32,30,2,40
Rapid Vienna,4957,3,9,10,5,40,28,12,37
LASK Linz,4957,4,8,5,11,29,37,-8,29
Vienna,4957,5,7,6,11,25,38,-13,27
Mattersburg,4957,6,7,5,12,35,44,-9,26
SC Rheindorf,4957,7,5,6,13,21,32,-11,21
FC Salzburg,4958,1,13,7,4,44,21,23,46
SK Sturm Gra,4958,2,13,4,7,33,28,5,43
Rapid Vienna,4958,3,10,10,4,39,27,12,40
Vienna,4958,4,8,5,11,28,39,-11,29
LASK Linz,4958,5,7,7,10,26,31,-5,28
Mattersburg,4958,6,6,6,12,31,42,-11,24
SC Rheindorf,4958,7,4,7,13,16,29,-13,19
FC Salzburg,4959,1,13,7,4,42,19,23,46
SK Sturm Gra,4959,2,11,4,9,30,32,-2,37
Rapid Vienna,4959,3,8,10,6,36,30,6,34
Mattersburg,4959,4,9,5,10,36,38,-2,32
LASK Linz,4959,5,8,7,9,27,28,-1,31
Vienna,4959,6,7,5,12,24,39,-15,26
SC Rheindorf,4959,7,6,6,12,22,31,-9,24
FC Salzburg,4960,1,13,6,5,40,24,16,45
SK Sturm Gra,4960,2,13,4,7,34,28,6,43
Rapid Vienna,4960,3,8,12,4,33,24,9,36
LASK Linz,4960,4,8,7,9,27,28,-1,31
Vienna,4960,5,8,5,11,30,37,-7,29
Mattersburg,4960,6,7,5,12,31,40,-9,26
SC Rheindorf,4960,7,4,7,13,19,33,-14,19
FC Salzburg,4961,1,15,7,2,44,16,28,52
SK Sturm Gra,4961,2,12,4,8,31,28,3,40
Rapid Vienna,4961,3,8,12,4,35,26,9,36
LASK Linz,4961,4,9,5,10,26,26,0,32
Vienna,4961,5,6,6,12,25,41,-16,24
SC Rheindorf,4961,6,5,7,12,19,30,-11,22
Mattersburg,4961,7,5,7,12,29,42,-13,22
FC Salzburg,4962,1,15,7,2,46,17,29,52
SK Sturm Gra,4962,2,12,3,9,31,31,0,39
Rapid Vienna,4962,3,9,10,5,35,26,9,37
Mattersburg,4962,4,7,6,11,32,39,-7,27
LASK Linz,4962,5,7,6,11,25,32,-7,27
Vienna,4962,6,7,5,12,25,40,-15,26
SC Rheindorf,4962,7,6,5,13,20,29,-9,23
FC Salzburg,4963,1,15,6,3,46,16,30,51
SK Sturm Gra,4963,2,13,3,8,34,29,5,42
Rapid Vienna,4963,3,8,10,6,34,30,4,34
Mattersburg,4963,4,8,5,11,34,39,-5,29
LASK Linz,4963,5,7,7,10,25,31,-6,28
Vienna,4963,6,7,5,12,24,40,-16,26
SC Rheindorf,4963,7,5,6,13,18,30,-12,21
FC Salzburg,4964,1,14,8,2,42,17,25,50
Rapid Vienna,4964,2,9,10,5,35,25,10,37
LASK Linz,4964,3,10,6,8,28,25,3,36
SK Sturm Gra,4964,4,11,3,10,28,28,0,36
Mattersburg,4964,5,6,7,11,30,39,-9,25
SC Rheindorf,4964,6,6,5,13,17,29,-12,23
Vienna,4964,7,6,5,13,25,42,-17,23
FC Salzburg,4965,1,15,6,3,44,19,25,51
SK Sturm Gra,4965,2,13,4,7,32,27,5,43
Rapid Vienna,4965,3,9,10,5,37,27,10,37
LASK Linz,4965,4,9,5,10,29,31,-2,32
SC Rheindorf,4965,5,6,5,13,21,30,-9,23
Mattersburg,4965,6,6,5,13,30,42,-12,23
Vienna,4965,7,6,5,13,24,41,-17,23
FC Salzburg,4966,1,15,7,2,50,20,30,52
SK Sturm Gra,4966,2,12,4,8,35,32,3,40
Rapid Vienna,4966,3,8,11,5,36,30,6,35
LASK Linz,4966,4,9,6,9,27,26,1,33
Vienna,4966,5,7,6,11,28,41,-13,27
Mattersburg,4966,6,5,6,13,31,45,-14,21
SC Rheindorf,4966,7,4,8,12,20,33,-13,20
FC Salzburg,4967,1,16,6,2,49,18,31,54
SK Sturm Gra,4967,2,13,3,8,31,29,2,42
Rapid Vienna,4967,3,8,9,7,33,28,5,33
LASK Linz,4967,4,8,7,9,25,27,-2,31
Vienna,4967,5,7,5,12,28,41,-13,26
SC Rheindorf,4967,6,5,7,12,21,30,-9,22
Mattersburg,4967,7,5,7,12,30,44,-14,22
FC Salzburg,4968,1,13,8,3,42,18,24,47
SK Sturm Gra,4968,2,13,5,6,32,26,6,44
Rapid Vienna,4968,3,9,10,5,37,29,8,37
LASK Linz,4968,4,9,5,10,28,28,0,32
Vienna,4968,5,7,5,12,26,40,-14,26
Mattersburg,4968,6,6,7,11,29,39,-10,25
SC Rheindorf,4968,7,4,6,14,17,31,-14,18
FC Salzburg,4969,1,15,6,3,47,18,29,51
SK Sturm Gra,4969,2,12,5,7,29,27,2,41
Rapid Vienna,4969,3,9,10,5,36,27,9,37
LASK Linz,4969,4,9,6,9,30,29,1,33
Mattersburg,4969,5,7,5,12,34,42,-8,26
Vienna,4969,6,7,5,12,25,40,-15,26
SC Rheindorf,4969,7,4,5,15,16,34,-18,17
FC Salzburg,4970,1,15,6,3,45,18,27,51
SK Sturm Gra,4970,2,13,4,7,34,28,6,43
Rapid Vienna,4970,3,9,9,6,37,31,6,36
LASK Linz,4970,4,9,6,9,30,29,1,33
Vienna,4970,5,7,5,12,24,39,-15,26
SC Rheindorf,4970,6,5,6,13,20,32,-12,21
Mattersburg,4970,7,5,6,13,27,40,-13,21
SK Sturm Gra,4971,1,13,5,6,35,27,8,44
FC Salzburg,4971,2,12,7,5,39,24,15,43
Rapid Vienna,4971,3,9,11,4,37,25,12,38
LASK Linz,4971,4,7,8,9,25,28,-3,29
Vienna,4971,5,8,5,11,28,37,-9,29
Mattersburg,4971,6,6,7,11,31,40,-9,25
SC Rheindorf,4971,7,4,7,13,18,32,-14,19
FC Salzburg,4972,1,15,7,2,46,17,29,52
SK Sturm Gra,4972,2,12,3,9,30,29,1,39
Rapid Vienna,4972,3,8,11,5,35,27,8,35
LASK Linz,4972,4,7,7,10,25,31,-6,28
Mattersburg,4972,5,7,6,11,35,43,-8,27
SC Rheindorf,4972,6,6,6,12,21,29,-8,24
Vienna,4972,7,6,6,12,25,41,-16,24
FC Salzburg,4973,1,14,6,4,46,19,27,48
SK Sturm Gra,4973,2,13,3,8,30,27,3,42
LASK Linz,4973,3,10,5,9,30,28,2,35
Rapid Vienna,4973,4,8,10,6,37,31,6,34
Mattersburg,4973,5,7,5,12,33,43,-10,26
Vienna,4973,6,7,5,12,25,41,-16,26
SC Rheindorf,4973,7,5,6,13,19,31,-12,21
FC Salzburg,4974,1,16,6,2,48,17,31,54
SK Sturm Gra,4974,2,14,3,7,32,28,4,45
Rapid Vienna,4974,3,8,10,6,36,29,7,34
LASK Linz,4974,4,8,6,10,25,27,-2,30
Mattersburg,4974,5,6,6,12,31,42,-11,24
Vienna,4974,6,6,5,13,23,41,-18,23
SC Rheindorf,4974,7,5,6,13,19,30,-11,21
FC Salzburg,4975,1,15,6,3,49,18,31,51
SK Sturm Gra,4975,2,13,3,8,31,29,2,42
Rapid Vienna,4975,3,9,9,6,35,26,9,36
SC Rheindorf,4975,4,8,5,11,23,27,-4,29
LASK Linz,4975,5,7,5,12,25,32,-7,26
Mattersburg,4975,6,6,6,12,31,45,-14,24
Vienna,4975,7,6,6,12,27,44,-17,24
FC Salzburg,4976,1,15,6,3,46,18,28,51
Rapid Vienna,4976,2,11,9,4,40,26,14,42
SK Sturm Gra,4976,3,13,3,8,35,31,4,42
LASK Linz,4976,4,8,6,10,28,30,-2,30
Mattersburg,4976,5,6,6,12,29,43,-14,24
Vienna,4976,6,6,5,13,23,39,-16,23
SC Rheindorf,4976,7,4,7,13,21,35,-14,19
FC Salzburg,4977,1,14,8,2,48,20,28,50
SK Sturm Gra,4977,2,13,4,7,34,29,5,43
Rapid Vienna,4977,3,8,10,6,36,29,7,34
Mattersburg,4977,4,8,5,11,36,41,-5,29
LASK Linz,4977,5,7,6,11,26,34,-8,27
Vienna,4977,6,6,6,12,24,39,-15,24
SC Rheindorf,4977,7,6,5,13,19,31,-12,23
FC Salzburg,4978,1,15,6,3,44,16,28,51
SK Sturm Gra,4978,2,14,3,7,36,30,6,45
Rapid Vienna,4978,3,9,9,6,35,27,8,36
LASK Linz,4978,4,8,6,10,26,28,-2,30
Vienna,4978,5,7,5,12,24,38,-14,26
Mattersburg,4978,6,5,7,12,27,40,-13,22
SC Rheindorf,4978,7,5,6,13,19,32,-13,21
FC Salzburg,4979,1,14,7,3,46,21,25,49
SK Sturm Gra,4979,2,12,3,9,34,32,2,39
Rapid Vienna,4979,3,9,11,4,37,24,13,38
LASK Linz,4979,4,8,7,9,28,31,-3,31
Mattersburg,4979,5,7,7,10,34,41,-7,28
Vienna,4979,6,6,6,12,25,41,-16,24
SC Rheindorf,4979,7,4,7,13,16,30,-14,19
FC Salzburg,4980,1,12,9,3,43,21,22,45
SK Sturm Gra,4980,2,12,5,7,32,27,5,41
Rapid Vienna,4980,3,7,11,6,34,29,5,32
Mattersburg,4980,4,9,5,10,34,40,-6,32
LASK Linz,4980,5,7,7,10,27,31,-4,28
SC Rheindorf,4980,6,7,5,12,21,28,-7,26
Vienna,4980,7,6,6,12,27,42,-15,24
FC Salzburg,4981,1,13,8,3,43,20,23,47
SK Sturm Gra,4981,2,12,5,7,33,29,4,41
LASK Linz,4981,3,9,6,9,29,28,1,33
Rapid Vienna,4981,4,7,10,7,34,31,3,31
Vienna,4981,5,8,5,11,29,41,-12,29
Mattersburg,4981,6,7,6,11,33,40,-7,27
SC Rheindorf,4981,7,5,6,13,19,31,-12,21
FC Salzburg,4982,1,15,6,3,49,20,29,51
Rapid Vienna,4982,2,11,9,4,42,28,14,42
SK Sturm Gra,4982,3,13,3,8,35,34,1,42
LASK Linz,4982,4,9,5,10,27,29,-2,32
Vienna,4982,5,7,5,12,26,39,-13,26
Mattersburg,4982,6,5,6,13,27,42,-15,21
SC Rheindorf,4982,7,4,6,14,18,32,-14,18
FC Salzburg,4983,1,13,8,3,42,19,23,47
SK Sturm Gra,4983,2,12,5,7,32,27,5,41
Rapid Vienna,4983,3,7,12,5,32,25,7,33
LASK Linz,4983,4,8,8,8,25,24,1,32
Vienna,4983,5,7,6,11,25,38,-13,27
SC Rheindorf,4983,6,6,6,12,19,28,-9,24
Mattersburg,4983,7,6,5,13,29,43,-14,23
FC Salzburg,4984,1,15,6,3,45,17,28,51
SK Sturm Gra,4984,2,12,3,9,30,32,-2,39
Rapid Vienna,4984,3,9,9,6,36,28,8,36
LASK Linz,4984,4,8,6,10,28,31,-3,30
Vienna,4984,5,7,6,11,25,38,-13,27
Mattersburg,4984,6,6,7,11,31,41,-10,25
SC Rheindorf,4984,7,6,5,13,19,27,-8,23
FC Salzburg,4985,1,14,6,4,45,21,24,48
SK Sturm Gra,4985,2,12,4,8,33,30,3,40
Rapid Vienna,4985,3,9,11,4,38,27,11,38
LASK Linz,4985,4,7,7,10,25,30,-5,28
Mattersburg,4985,5,7,6,11,34,41,-7,27
Vienna,4985,6,7,5,12,26,41,-15,26
SC Rheindorf,4985,7,5,7,12,22,33,-11,22
FC Salzburg,4986,1,15,6,3,42,17,25,51
SK Sturm Gra,4986,2,12,4,8,32,27,5,40
Rapid Vienna,4986,3,8,10,6,32,27,5,34
LASK Linz,4986,4,9,6,9,31,27,4,33
Mattersburg,4986,5,7,5,12,32,44,-12,26
Vienna,4986,6,7,5,12,27,40,-13,26
SC Rheindorf,4986,7,5,6,13,18,32,-14,21
FC Salzburg,4987,1,16,6,2,54,17,37,54
SK Sturm Gra,4987,2,11,5,8,30,28,2,38
Rapid Vienna,4987,3,8,9,7,35,34,1,33
LASK Linz,4987,4,8,7,9,32,33,-1,31
Vienna,4987,5,7,5,12,26,42,-16,26
SC Rheindorf,4987,6,6,7,11,23,29,-6,25
Mattersburg,4987,7,5,7,12,34,51,-17,22
FC Salzburg,4988,1,14,6,4,42,23,19,48
SK Sturm Gra,4988,2,14,4,6,40,28,12,46
Rapid Vienna,4988,3,8,10,6,38,31,7,34
Vienna,4988,4,8,5,11,26,37,-11,29
LASK Linz,4988,5,7,6,11,26,32,-6,27
SC Rheindorf,4988,6,6,6,12,17,26,-9,24
Mattersburg,4988,7,5,7,12,27,39,-12,22
FC Salzburg,4989,1,13,6,5,42,22,20,45
Rapid Vienna,4989,2,10,10,4,38,26,12,40
SK Sturm Gra,4989,3,11,5,8,30,28,2,38
LASK Linz,4989,4,8,6,10,25,28,-3,30
Mattersburg,4989,5,8,6,10,35,40,-5,30
Vienna,4989,6,7,6,11,27,40,-13,27
SC Rheindorf,4989,7,4,7,13,19,32,-13,19
FC Salzburg,4990,1,14,7,3,44,20,24,49
SK Sturm Gra,4990,2,13,4,7,36,29,7,43
Rapid Vienna,4990,3,9,10,5,40,30,10,37
LASK Linz,4990,4,8,5,11,28,30,-2,29
Mattersburg,4990,5,8,5,11,37,41,-4,29
Vienna,4990,6,7,6,11,26,39,-13,27
SC Rheindorf,4990,7,4,5,15,18,40,-22,17
FC Salzburg,4991,1,14,7,3,44,18,26,49
Rapid Vienna,4991,2,9,10,5,35,27,8,37
SK Sturm Gra,4991,3,11,4,9,31,33,-2,37
LASK Linz,4991,4,9,7,8,31,28,3,34
Vienna,4991,5,7,6,11,27,39,-12,27
SC Rheindorf,4991,6,6,6,12,24,29,-5,24
Mattersburg,4991,7,5,6,13,28,46,-18,21
FC Salzburg,4992,1,13,7,4,46,23,23,46
Rapid Vienna,4992,2,9,11,4,39,28,11,38
SK Sturm Gra,4992,3,11,4,9,32,32,0,37
LASK Linz,4992,4,9,7,8,29,28,1,34
Vienna,4992,5,7,5,12,25,38,-13,26
Mattersburg,4992,6,6,7,11,29,41,-12,25
SC Rheindorf,4992,7,5,7,12,20,30,-10,22
FC Salzburg,4993,1,14,7,3,46,19,27,49
SK Sturm Gra,4993,2,14,3,7,34,27,7,45
Rapid Vienna,4993,3,9,10,5,38,30,8,37
LASK Linz,4993,4,8,5,11,26,30,-4,29
Mattersburg,4993,5,7,5,12,31,44,-13,26
Vienna,4993,6,7,5,12,26,40,-14,26
SC Rheindorf,4993,7,5,5,14,19,30,-11,20
FC Salzburg,4994,1,13,8,3,42,21,21,47
SK Sturm Gra,4994,2,12,4,8,35,28,7,40
Rapid Vienna,4994,3,8,11,5,37,32,5,35
LASK Linz,4994,4,9,6,9,29,27,2,33
Mattersburg,4994,5,7,5,12,33,43,-10,26
Vienna,4994,6,7,5,12,26,40,-14,26
SC Rheindorf,4994,7,6,5,13,19,30,-11,23
FC Salzburg,4995,1,14,6,4,45,21,24,48
Rapid Vienna,4995,2,10,9,5,37,26,11,39
SK Sturm Gra,4995,3,12,3,9,30,36,-6,39
LASK Linz,4995,4,8,7,9,31,30,1,31
Vienna,4995,5,7,6,11,27,38,-11,27
Mattersburg,4995,6,6,7,11,29,39,-10,25
SC Rheindorf,4995,7,5,6,13,22,31,-9,21
FC Salzburg,4996,1,15,6,3,46,18,28,51
SK Sturm Gra,4996,2,12,4,8,32,31,1,40
LASK Linz,4996,3,9,5,10,30,31,-1,32
Rapid Vienna,4996,4,7,10,7,35,30,5,31
Vienna,4996,5,8,5,11,27,38,-11,29
Mattersburg,4996,6,6,6,12,32,45,-13,24
SC Rheindorf,4996,7,5,8,11,18,27,-9,23
FC Salzburg,4997,1,14,7,3,47,18,29,49
SK Sturm Gra,4997,2,12,3,9,30,31,-1,39
Rapid Vienna,4997,3,8,10,6,37,30,7,34
LASK Linz,4997,4,8,6,10,28,29,-1,30
Mattersburg,4997,5,7,6,11,32,44,-12,27
SC Rheindorf,4997,6,7,5,12,20,28,-8,26
Vienna,4997,7,6,7,11,26,40,-14,25
FC Salzburg,4998,1,16,6,2,45,16,29,54
SK Sturm Gra,4998,2,12,4,8,31,29,2,40
LASK Linz,4998,3,9,7,8,28,25,3,34
Rapid Vienna,4998,4,7,12,5,33,27,6,33
Mattersburg,4998,5,6,6,12,30,42,-12,24
Vienna,4998,6,6,5,13,25,41,-16,23
SC Rheindorf,4998,7,5,6,13,18,30,-12,21
FC Salzburg,4999,1,13,8,3,43,19,24,47
Rapid Vienna,4999,2,11,9,4,35,23,12,42
SK Sturm Gra,4999,3,11,5,8,31,29,2,38
LASK Linz,4999,4,7,7,10,25,28,-3,28
Mattersburg,4999,5,6,7,11,28,39,-11,25
Vienna,4999,6,6,7,11,24,38,-14,25
SC Rheindorf,4999,7,5,7,12,18,28,-10,22
FC Salzburg,5000,1,14,7,3,43,18,25,49
SK Sturm Gra,5000,2,13,3,8,31,30,1,42
Rapid Vienna,5000,3,10,9,5,38,25,13,39
LASK Linz,5000,4,10,5,9,29,27,2,35
Vienna,5000,5,7,6,11,26,39,-13,27
Mattersburg,5000,6,5,6,13,30,43,-13,21
SC Rheindorf,5000,7,4,6,14,18,33,-15,18
FC Salzburg,5001,1,15,6,3,49,21,28,51
SK Sturm Gra,5001,2,13,4,7,32,28,4,43
Rapid Vienna,5001,3,9,10,5,35,27,8,37
LASK Linz,5001,4,9,5,10,27,29,-2,32
Vienna,5001,5,8,5,11,28,39,-11,29
Mattersburg,5001,6,5,6,13,30,43,-13,21
SC Rheindorf,5001,7,4,6,14,17,31,-14,18
FC Salzburg,5002,1,15,6,3,53,21,32,51
SK Sturm Gra,5002,2,12,4,8,33,31,2,40
LASK Linz,5002,3,10,6,8,28,25,3,36
Rapid Vienna,5002,4,8,10,6,34,29,5,34
SC Rheindorf,5002,5,5,8,11,21,27,-6,23
Mattersburg,5002,6,6,5,13,29,45,-16,23
Vienna,5002,7,6,5,13,25,45,-20,23
FC Salzburg,5003,1,13,8,3,41,17,24,47
SK Sturm Gra,5003,2,13,5,6,32,24,8,44
Rapid Vienna,5003,3,9,10,5,36,28,8,37
LASK Linz,5003,4,7,7,10,26,31,-5,28
Mattersburg,5003,5,5,9,10,30,40,-10,24
Vienna,5003,6,6,6,12,25,41,-16,24
SC Rheindorf,5003,7,5,7,12,20,29,-9,22
FC Salzburg,5004,1,16,6,2,50,16,34,54
SK Sturm Gra,5004,2,13,3,8,32,29,3,42
Rapid Vienna,5004,3,8,10,6,33,29,4,34
LASK Linz,5004,4,8,6,10,27,29,-2,30
Mattersburg,5004,5,7,6,11,33,44,-11,27
Vienna,5004,6,6,6,12,24,39,-15,24
SC Rheindorf,5004,7,5,5,14,18,31,-13,20
FC Salzburg,5005,1,14,7,3,43,18,25,49
SK Sturm Gra,5005,2,12,5,7,32,29,3,41
Rapid Vienna,5005,3,10,9,5,37,25,12,39
LASK Linz,5005,4,7,8,9,27,31,-4,29
Mattersburg,5005,5,7,7,10,33,40,-7,28
Vienna,5005,6,6,5,13,24,41,-17,23
SC Rheindorf,5005,7,4,7,13,18,30,-12,19
FC Salzburg,5006,1,16,6,2,48,16,32,54
SK Sturm Gra,5006,2,12,5,7,32,26,6,41
Rapid Vienna,5006,3,8,11,5,40,30,10,35
LASK Linz,5006,4,8,6,10,29,34,-5,30
Mattersburg,5006,5,6,7,11,31,42,-11,25
Vienna,5006,6,6,6,12,25,43,-18,24
SC Rheindorf,5006,7,4,7,13,17,31,-14,19
FC Salzburg,5007,1,15,6,3,47,21,26,51
SK Sturm Gra,5007,2,13,5,6,36,29,7,44
LASK Linz,5007,3,9,7,8,31,27,4,34
Rapid Vienna,5007,4,7,9,8,33,34,-1,30
Vienna,5007,5,6,6,12,26,41,-15,24
Mattersburg,5007,6,5,8,11,29,41,-12,23
SC Rheindorf,5007,7,5,7,12,21,30,-9,22
FC Salzburg,5008,1,15,6,3,42,17,25,51
SK Sturm Gra,5008,2,12,5,7,34,28,6,41
Rapid Vienna,5008,3,8,9,7,35,30,5,33
LASK Linz,5008,4,8,7,9,26,27,-1,31
Mattersburg,5008,5,7,6,11,32,39,-7,27
SC Rheindorf,5008,6,6,6,12,20,30,-10,24
Vienna,5008,7,6,5,13,24,42,-18,23
FC Salzburg,5009,1,15,7,2,42,16,26,52
SK Sturm Gra,5009,2,12,4,8,32,28,4,40
Rapid Vienna,5009,3,8,10,6,36,29,7,34
LASK Linz,5009,4,8,6,10,28,31,-3,30
Mattersburg,5009,5,8,5,11,29,37,-8,29
Vienna,5009,6,6,6,12,23,38,-15,24
SC Rheindorf,5009,7,4,8,12,18,29,-11,20
FC Salzburg,5010,1,14,6,4,43,18,25,48
SK Sturm Gra,5010,2,13,4,7,34,27,7,43
Rapid Vienna,5010,3,9,10,5,35,28,7,37
LASK Linz,5010,4,7,7,10,23,27,-4,28
SC Rheindorf,5010,5,7,5,12,20,27,-7,26
Mattersburg,5010,6,6,6,12,27,39,-12,24
Vienna,5010,7,6,6,12,23,39,-16,24
FC Salzburg,5011,1,15,6,3,46,18,28,51
SK Sturm Gra,5011,2,13,5,6,37,26,11,44
Rapid Vienna,5011,3,8,10,6,34,31,3,34
LASK Linz,5011,4,7,8,9,26,29,-3,29
Mattersburg,5011,5,7,5,12,34,41,-7,26
Vienna,5011,6,7,5,12,24,40,-16,26
SC Rheindorf,5011,7,4,7,13,17,33,-16,19
FC Salzburg,5012,1,15,6,3,48,18,30,51
SK Sturm Gra,5012,2,14,3,7,33,28,5,45
Rapid Vienna,5012,3,10,9,5,39,28,11,39
LASK Linz,5012,4,8,5,11,26,28,-2,29
Vienna,5012,5,7,5,12,25,40,-15,26
Mattersburg,5012,6,6,5,13,28,43,-15,23
SC Rheindorf,5012,7,5,5,14,20,34,-14,20
FC Salzburg,5013,1,14,8,2,46,19,27,50
SK Sturm Gra,5013,2,11,5,8,29,27,2,38
LASK Linz,5013,3,10,5,9,27,26,1,35
Rapid Vienna,5013,4,8,9,7,35,31,4,33
Vienna,5013,5,7,5,12,25,39,-14,26
SC Rheindorf,5013,6,6,7,11,21,27,-6,25
Mattersburg,5013,7,5,7,12,28,42,-14,22
FC Salzburg,5014,1,13,6,5,44,24,20,45
SK Sturm Gra,5014,2,13,4,7,31,26,5,43
Rapid Vienna,5014,3,9,11,4,35,24,11,38
LASK Linz,5014,4,8,7,9,26,27,-1,31
Vienna,5014,5,8,5,11,30,41,-11,29
Mattersburg,5014,6,6,6,12,29,41,-12,24
SC Rheindorf,5014,7,4,7,13,16,28,-12,19
FC Salzburg,5015,1,15,7,2,47,18,29,52
SK Sturm Gra,5015,2,12,4,8,32,31,1,40
Rapid Vienna,5015,3,8,10,6,37,31,6,34
LASK Linz,5015,4,8,6,10,27,30,-3,30
Vienna,5015,5,7,6,11,25,38,-13,27
Mattersburg,5015,6,6,6,12,30,41,-11,24
SC Rheindorf,5015,7,6,5,13,22,31,-9,23
FC Salzburg,5016,1,15,7,2,51,17,34,52
SK Sturm Gra,5016,2,14,3,7,33,28,5,45
Rapid Vienna,5016,3,8,11,5,35,26,9,35
LASK Linz,5016,4,8,5,11,26,30,-4,29
Mattersburg,5016,5,7,6,11,34,43,-9,27
Vienna,5016,6,6,5,13,24,44,-20,23
SC Rheindorf,5016,7,4,7,13,19,34,-15,19
FC Salzburg,5017,1,15,7,2,45,17,28,52
SK Sturm Gra,5017,2,13,3,8,32,28,4,42
Rapid Vienna,5017,3,7,12,5,35,28,7,33
LASK Linz,5017,4,9,6,9,27,28,-1,33
Vienna,5017,5,7,5,12,29,40,-11,26
Mattersburg,5017,6,6,5,13,29,45,-16,23
SC Rheindorf,5017,7,5,6,13,19,30,-11,21
FC Salzburg,5018,1,14,7,3,44,17,27,49
SK Sturm Gra,5018,2,13,4,7,33,27,6,43
LASK Linz,5018,3,10,5,9,30,26,4,35
Rapid Vienna,5018,4,8,10,6,32,27,5,34
Vienna,5018,5,7,5,12,26,41,-15,26
Mattersburg,5018,6,6,6,12,29,42,-13,24
SC Rheindorf,5018,7,5,5,14,17,31,-14,20
FC Salzburg,5019,1,15,7,2,47,17,30,52
SK Sturm Gra,5019,2,11,6,7,30,29,1,39
Rapid Vienna,5019,3,9,11,4,36,25,11,38
LASK Linz,5019,4,8,7,9,26,26,0,31
Vienna,5019,5,7,5,12,28,42,-14,26
Mattersburg,5019,6,6,5,13,30,45,-15,23
SC Rheindorf,5019,7,4,7,13,15,28,-13,19
FC Salzburg,5020,1,15,6,3,50,19,31,51
SK Sturm Gra,5020,2,13,4,7,33,27,6,43
Rapid Vienna,5020,3,8,9,7,34,32,2,33
LASK Linz,5020,4,9,5,10,25,28,-3,32
Mattersburg,5020,5,7,6,11,31,40,-9,27
Vienna,5020,6,6,6,12,24,39,-15,24
SC Rheindorf,5020,7,5,6,13,19,31,-12,21
FC Salzburg,5021,1,15,6,3,48,16,32,51
Rapid Vienna,5021,2,9,10,5,35,25,10,37
SK Sturm Gra,5021,3,11,4,9,31,36,-5,37
LASK Linz,5021,4,9,7,8,28,27,1,34
Vienna,5021,5,7,5,12,24,38,-14,26
Mattersburg,5021,6,5,7,12,27,41,-14,22
SC Rheindorf,5021,7,4,9,11,19,29,-10,21
FC Salzburg,5022,1,15,6,3,45,18,27,51
SK Sturm Gra,5022,2,12,4,8,30,26,4,40
Rapid Vienna,5022,3,9,10,5,36,27,9,37
LASK Linz,5022,4,7,7,10,26,30,-4,28
SC Rheindorf,5022,5,7,6,11,20,27,-7,27
Vienna,5022,6,7,5,12,27,39,-12,26
Mattersburg,5022,7,5,6,13,27,44,-17,21
FC Salzburg,5023,1,13,6,5,43,23,20,45
Rapid Vienna,5023,2,11,9,4,39,26,13,42
SK Sturm Gra,5023,3,12,3,9,33,30,3,39
LASK Linz,5023,4,9,5,10,30,31,-1,32
Vienna,5023,5,7,5,12,27,41,-14,26
SC Rheindorf,5023,6,6,6,12,21,30,-9,24
Mattersburg,5023,7,6,6,12,32,44,-12,24
FC Salzburg,5024,1,13,9,2,40,16,24,48
Rapid Vienna,5024,2,9,10,5,38,25,13,37
SK Sturm Gra,5024,3,11,4,9,29,30,-1,37
LASK Linz,5024,4,10,5,9,30,29,1,35
Mattersburg,5024,5,7,6,11,29,39,-10,27
Vienna,5024,6,7,5,12,25,38,-13,26
SC Rheindorf,5024,7,5,5,14,19,33,-14,20
FC Salzburg,5025,1,16,6,2,50,17,33,54
SK Sturm Gra,5025,2,11,6,7,29,27,2,39
Rapid Vienna,5025,3,7,10,7,33,29,4,31
LASK Linz,5025,4,8,6,10,28,31,-3,30
SC Rheindorf,5025,5,7,6,11,22,27,-5,27
Vienna,5025,6,7,5,12,25,38,-13,26
Mattersburg,5025,7,6,5,13,30,48,-18,23
FC Salzburg,5026,1,15,7,2,43,16,27,52
SK Sturm Gra,5026,2,12,4,8,32,29,3,40
Rapid Vienna,5026,3,8,12,4,35,25,10,36
LASK Linz,5026,4,8,7,9,30,31,-1,31
Vienna,5026,5,7,5,12,25,39,-14,26
Mattersburg,5026,6,6,6,12,31,43,-12,24
SC Rheindorf,5026,7,5,5,14,21,34,-13,20
FC Salzburg,5027,1,13,6,5,42,20,22,45
SK Sturm Gra,5027,2,12,4,8,30,29,1,40
Rapid Vienna,5027,3,8,10,6,34,27,7,34
Mattersburg,5027,4,9,5,10,32,37,-5,32
LASK Linz,5027,5,8,6,10,26,29,-3,30
Vienna,5027,6,7,5,12,25,39,-14,26
SC Rheindorf,5027,7,6,6,12,21,29,-8,24
FC Salzburg,5028,1,12,8,4,42,21,21,44
SK Sturm Gra,5028,2,12,5,7,32,28,4,41
Rapid Vienna,5028,3,9,11,4,36,24,12,38
LASK Linz,5028,4,8,7,9,25,26,-1,31
Mattersburg,5028,5,8,5,11,32,44,-12,29
Vienna,5028,6,7,6,11,31,40,-9,27
SC Rheindorf,5028,7,4,6,14,18,33,-15,18
FC Salzburg,5029,1,16,6,2,45,15,30,54
SK Sturm Gra,5029,2,13,3,8,31,26,5,42
Rapid Vienna,5029,3,8,9,7,36,28,8,33
LASK Linz,5029,4,9,6,9,27,27,0,33
Vienna,5029,5,7,5,12,26,41,-15,26
SC Rheindorf,5029,6,6,5,13,19,32,-13,23
Mattersburg,5029,7,5,6,13,31,46,-15,21
FC Salzburg,5030,1,14,8,2,45,20,25,50
SK Sturm Gra,5030,2,12,6,6,31,26,5,42
LASK Linz,5030,3,10,5,9,30,25,5,35
Rapid Vienna,5030,4,8,10,6,35,27,8,34
Vienna,5030,5,7,6,11,26,39,-13,27
Mattersburg,5030,6,5,6,13,30,45,-15,21
SC Rheindorf,5030,7,4,7,13,18,33,-15,19
FC Salzburg,5031,1,13,7,4,41,20,21,46
SK Sturm Gra,5031,2,11,6,7,31,28,3,39
Rapid Vienna,5031,3,8,11,5,33,25,8,35
LASK Linz,5031,4,9,6,9,29,27,2,33
SC Rheindorf,5031,5,7,6,11,22,29,-7,27
Vienna,5031,6,7,6,11,28,38,-10,27
Mattersburg,5031,7,5,6,13,27,44,-17,21
FC Salzburg,5032,1,15,6,3,43,16,27,51
SK Sturm Gra,5032,2,13,4,7,36,29,7,43
Rapid Vienna,5032,3,8,10,6,34,28,6,34
LASK Linz,5032,4,7,7,10,26,33,-7,28
SC Rheindorf,5032,5,7,5,12,21,29,-8,26
Mattersburg,5032,6,6,6,12,33,43,-10,24
Vienna,5032,7,6,6,12,26,41,-15,24
FC Salzburg,5033,1,14,6,4,48,22,26,48
SK Sturm Gra,5033,2,12,5,7,32,27,5,41
Rapid Vienna,5033,3,9,10,5,36,27,9,37
LASK Linz,5033,4,8,6,10,27,29,-2,30
SC Rheindorf,5033,5,6,7,11,17,25,-8,25
Mattersburg,5033,6,6,6,12,30,45,-15,24
Vienna,5033,7,6,6,12,28,43,-15,24
FC Salzburg,5034,1,13,9,2,46,20,26,48
SK Sturm Gra,5034,2,14,4,6,36,26,10,46
Rapid Vienna,5034,3,8,10,6,37,35,2,34
Mattersburg,5034,4,7,6,11,33,41,-8,27
Vienna,5034,5,7,6,11,26,39,-13,27
LASK Linz,5034,6,7,5,12,27,33,-6,26
SC Rheindorf,5034,7,5,6,13,19,30,-11,21
FC Salzburg,5035,1,14,7,3,46,21,25,49
SK Sturm Gra,5035,2,12,4,8,33,29,4,40
LASK Linz,5035,3,9,6,9,29,29,0,33
Rapid Vienna,5035,4,7,11,6,36,32,4,32
SC Rheindorf,5035,5,8,5,11,23,27,-4,29
Vienna,5035,6,7,6,11,25,38,-13,27
Mattersburg,5035,7,5,5,14,27,43,-16,20
FC Salzburg,5036,1,15,6,3,49,19,30,51
SK Sturm Gra,5036,2,11,4,9,32,31,1,37
Rapid Vienna,5036,3,8,10,6,37,30,7,34
LASK Linz,5036,4,9,6,9,29,29,0,33
Mattersburg,5036,5,8,5,11,33,41,-8,29
Vienna,5036,6,7,5,12,26,43,-17,26
SC Rheindorf,5036,7,5,6,13,18,31,-13,21
FC Salzburg,5037,1,13,6,5,41,21,20,45
SK Sturm Gra,5037,2,13,4,7,33,27,6,43
Rapid Vienna,5037,3,9,10,5,38,26,12,37
LASK Linz,5037,4,8,6,10,28,32,-4,30
Mattersburg,5037,5,7,6,11,34,44,-10,27
Vienna,5037,6,7,6,11,28,41,-13,27
SC Rheindorf,5037,7,5,6,13,19,30,-11,21
FC Salzburg,5038,1,15,6,3,47,20,27,51
SK Sturm Gra,5038,2,13,4,7,33,28,5,43
Rapid Vienna,5038,3,8,10,6,35,29,6,34
LASK Linz,5038,4,8,8,8,27,27,0,32
Mattersburg,5038,5,7,6,11,32,40,-8,27
Vienna,5038,6,6,6,12,25,41,-16,24
SC Rheindorf,5038,7,4,6,14,16,30,-14,18
FC Salzburg,5039,1,16,6,2,48,20,28,54
Rapid Vienna,5039,2,10,9,5,42,27,15,39
SK Sturm Gra,5039,3,11,5,8,32,32,0,38
LASK Linz,5039,4,9,6,9,30,30,0,33
Mattersburg,5039,5,7,5,12,35,42,-7,26
Vienna,5039,6,6,5,13,24,43,-19,23
SC Rheindorf,5039,7,4,6,14,15,32,-17,18
FC Salzburg,5040,1,15,6,3,45,17,28,51
SK Sturm Gra,5040,2,12,4,8,33,31,2,40
Rapid Vienna,5040,3,7,11,6,34,29,5,32
LASK Linz,5040,4,8,7,9,27,30,-3,31
Vienna,5040,5,8,5,11,26,37,-11,29
Mattersburg,5040,6,7,5,12,33,40,-7,26
SC Rheindorf,5040,7,5,6,13,19,33,-14,21
FC Salzburg,5041,1,13,7,4,42,18,24,46
SK Sturm Gra,5041,2,14,4,6,36,27,9,46
Rapid Vienna,5041,3,8,9,7,34,31,3,33
LASK Linz,5041,4,8,6,10,27,30,-3,30
Mattersburg,5041,5,8,6,10,32,37,-5,30
Vienna,5041,6,6,7,11,24,38,-14,25
SC Rheindorf,5041,7,4,7,13,19,33,-14,19
FC Salzburg,5042,1,14,7,3,42,17,25,49
SK Sturm Gra,5042,2,13,3,8,36,30,6,42
Rapid Vienna,5042,3,9,10,5,37,28,9,37
LASK Linz,5042,4,7,7,10,26,31,-5,28
Vienna,5042,5,7,5,12,25,40,-15,26
SC Rheindorf,5042,6,6,6,12,20,29,-9,24
Mattersburg,5042,7,6,6,12,29,40,-11,24
FC Salzburg,5043,1,14,6,4,44,18,26,48
SK Sturm Gra,5043,2,12,4,8,32,31,1,40
Rapid Vienna,5043,3,10,9,5,36,25,11,39
LASK Linz,5043,4,8,7,9,28,29,-1,31
Vienna,5043,5,8,5,11,26,37,-11,29
Mattersburg,5043,6,6,6,12,31,45,-14,24
SC Rheindorf,5043,7,5,5,14,20,32,-12,20
FC Salzburg,5044,1,14,8,2,47,17,30,50
SK Sturm Gra,5044,2,14,3,7,34,28,6,45
Rapid Vienna,5044,3,8,10,6,35,27,8,34
LASK Linz,5044,4,9,5,10,25,27,-2,32
Mattersburg,5044,5,7,5,12,30,45,-15,26
Vienna,5044,6,6,6,12,23,39,-16,24
SC Rheindorf,5044,7,5,5,14,20,31,-11,20
FC Salzburg,5045,1,15,6,3,46,21,25,51
SK Sturm Gra,5045,2,12,5,7,33,30,3,41
Rapid Vienna,5045,3,7,10,7,34,32,2,31
LASK Linz,5045,4,8,7,9,31,29,2,31
Mattersburg,5045,5,7,7,10,35,41,-6,28
Vienna,5045,6,6,6,12,26,42,-16,24
SC Rheindorf,5045,7,5,7,12,18,28,-10,22
FC Salzburg,5046,1,15,7,2,45,18,27,52
SK Sturm Gra,5046,2,14,3,7,33,27,6,45
Rapid Vienna,5046,3,8,11,5,35,26,9,35
LASK Linz,5046,4,7,6,11,25,29,-4,27
Mattersburg,5046,5,7,5,12,32,40,-8,26
Vienna,5046,6,7,5,12,24,39,-15,26
SC Rheindorf,5046,7,5,5,14,17,32,-15,20
FC Salzburg,5047,1,14,7,3,44,20,24,49
SK Sturm Gra,5047,2,11,5,8,29,27,2,38
Rapid Vienna,5047,3,8,10,6,34,27,7,34
LASK Linz,5047,4,8,6,10,25,27,-2,30
Mattersburg,5047,5,8,5,11,31,39,-8,29
SC Rheindorf,5047,6,7,5,12,19,27,-8,26
Vienna,5047,7,6,6,12,26,41,-15,24
FC Salzburg,5048,1,15,7,2,45,17,28,52
SK Sturm Gra,5048,2,12,5,7,32,28,4,41
Rapid Vienna,5048,3,8,12,4,34,25,9,36
LASK Linz,5048,4,8,6,10,29,28,1,30
SC Rheindorf,5048,5,6,6,12,18,27,-9,24
Mattersburg,5048,6,6,5,13,29,44,-15,23
Vienna,5048,7,6,5,13,24,42,-18,23
FC Salzburg,5049,1,13,9,2,45,21,24,48
SK Sturm Gra,5049,2,13,4,7,33,31,2,43
Rapid Vienna,5049,3,8,9,7,37,30,7,33
LASK Linz,5049,4,9,5,10,29,28,1,32
Mattersburg,5049,5,7,7,10,34,40,-6,28
Vienna,5049,6,6,6,12,25,42,-17,24
SC Rheindorf,5049,7,5,6,13,21,32,-11,21
FC Salzburg,5050,1,13,7,4,45,24,21,46
SK Sturm Gra,5050,2,11,5,8,34,33,1,38
LASK Linz,5050,3,10,6,8,33,30,3,36
Rapid Vienna,5050,4,8,10,6,38,30,8,34
Mattersburg,5050,5,7,6,11,33,40,-7,27
Vienna,5050,6,7,5,12,25,40,-15,26
SC Rheindorf,5050,7,5,7,12,19,30,-11,22
FC Salzburg,5051,1,14,6,4,45,20,25,48
SK Sturm Gra,5051,2,15,3,6,38,26,12,48
Rapid Vienna,5051,3,9,9,6,36,29,7,36
LASK Linz,5051,4,10,5,9,34,29,5,35
Mattersburg,5051,5,7,5,12,33,43,-10,26
Vienna,5051,6,6,5,13,23,42,-19,23
SC Rheindorf,5051,7,4,5,15,18,38,-20,17
FC Salzburg,5052,1,15,6,3,51,22,29,51
SK Sturm Gra,5052,2,13,4,7,34,28,6,43
Rapid Vienna,5052,3,8,10,6,37,30,7,34
LASK Linz,5052,4,9,5,10,27,29,-2,32
Vienna,5052,5,7,5,12,26,41,-15,26
SC Rheindorf,5052,6,6,7,11,22,30,-8,25
Mattersburg,5052,7,5,5,14,31,48,-17,20
FC Salzburg,5053,1,15,7,2,46,16,30,52
SK Sturm Gra,5053,2,12,4,8,32,30,2,40
Rapid Vienna,5053,3,8,12,4,36,27,9,36
LASK Linz,5053,4,8,5,11,28,31,-3,29
SC Rheindorf,5053,5,7,6,11,23,29,-6,27
Mattersburg,5053,6,6,5,13,32,44,-12,23
Vienna,5053,7,6,5,13,24,44,-20,23
FC Salzburg,5054,1,16,6,2,50,16,34,54
SK Sturm Gra,5054,2,13,3,8,33,32,1,42
Rapid Vienna,5054,3,9,9,6,34,27,7,36
LASK Linz,5054,4,7,7,10,25,28,-3,28
Mattersburg,5054,5,7,6,11,32,45,-13,27
Vienna,5054,6,6,5,13,24,40,-16,23
SC Rheindorf,5054,7,5,6,13,22,32,-10,21
FC Salzburg,5055,1,13,7,4,42,22,20,46
SK Sturm Gra,5055,2,14,3,7,37,29,8,45
Rapid Vienna,5055,3,8,10,6,36,31,5,34
LASK Linz,5055,4,8,6,10,29,30,-1,30
Vienna,5055,5,7,6,11,24,37,-13,27
SC Rheindorf,5055,6,6,6,12,21,29,-8,24
Mattersburg,5055,7,6,6,12,32,43,-11,24
FC Salzburg,5056,1,16,6,2,49,16,33,54
SK Sturm Gra,5056,2,11,4,9,30,35,-5,37
Rapid Vienna,5056,3,8,10,6,35,29,6,34
LASK Linz,5056,4,7,8,9,28,30,-2,29
Mattersburg,5056,5,7,5,12,30,41,-11,26
Vienna,5056,6,7,5,12,26,39,-13,26
SC Rheindorf,5056,7,6,6,12,21,29,-8,24
FC Salzburg,5057,1,14,7,3,44,20,24,49
SK Sturm Gra,5057,2,11,4,9,28,30,-2,37
Rapid Vienna,5057,3,7,13,4,33,25,8,34
LASK Linz,5057,4,8,7,9,28,28,0,31
Mattersburg,5057,5,8,5,11,35,39,-4,29
Vienna,5057,6,7,5,12,27,43,-16,26
SC Rheindorf,5057,7,5,7,12,19,29,-10,22
FC Salzburg,5058,1,15,6,3,44,19,25,51
Rapid Vienna,5058,2,10,10,4,36,25,11,40
SK Sturm Gra,5058,3,11,5,8,30,29,1,38
LASK Linz,5058,4,9,5,10,27,28,-1,32
Mattersburg,5058,5,6,6,12,31,42,-11,24
Vienna,5058,6,6,6,12,26,41,-15,24
SC Rheindorf,5058,7,5,6,13,18,28,-10,21
FC Salzburg,5059,1,15,7,2,47,15,32,52
SK Sturm Gra,5059,2,14,3,7,33,26,7,45
Rapid Vienna,5059,3,8,10,6,36,28,8,34
LASK Linz,5059,4,9,6,9,28,28,0,33
Mattersburg,5059,5,7,6,11,32,42,-10,27
Vienna,5059,6,6,5,13,24,45,-21,23
SC Rheindorf,5059,7,4,5,15,16,32,-16,17
FC Salzburg,5060,1,13,8,3,42,18,24,47
SK Sturm Gra,5060,2,12,3,9,31,32,-1,39
Rapid Vienna,5060,3,8,11,5,34,29,5,35
LASK Linz,5060,4,7,7,10,26,29,-3,28
SC Rheindorf,5060,5,7,6,11,26,28,-2,27
Mattersburg,5060,6,7,6,11,29,38,-9,27
Vienna,5060,7,6,7,11,24,38,-14,25
FC Salzburg,5061,1,15,7,2,56,19,37,52
SK Sturm Gra,5061,2,14,3,7,35,30,5,45
Rapid Vienna,5061,3,8,10,6,38,30,8,34
LASK Linz,5061,4,8,7,9,27,28,-1,31
Mattersburg,5061,5,7,6,11,31,44,-13,27
Vienna,5061,6,6,5,13,25,46,-21,23
SC Rheindorf,5061,7,4,6,14,17,32,-15,18
FC Salzburg,5062,1,14,7,3,49,20,29,49
SK Sturm Gra,5062,2,13,4,7,33,29,4,43
Rapid Vienna,5062,3,9,10,5,38,28,10,37
LASK Linz,5062,4,7,7,10,27,31,-4,28
Vienna,5062,5,7,5,12,25,42,-17,26
SC Rheindorf,5062,6,5,8,11,21,29,-8,23
Mattersburg,5062,7,5,7,12,30,44,-14,22
FC Salzburg,5063,1,16,6,2,46,16,30,54
SK Sturm Gra,5063,2,12,4,8,32,29,3,40
Rapid Vienna,5063,3,9,9,6,36,30,6,36
LASK Linz,5063,4,7,7,10,28,31,-3,28
SC Rheindorf,5063,5,7,5,12,19,28,-9,26
Mattersburg,5063,6,6,6,12,31,42,-11,24
Vienna,5063,7,6,5,13,24,40,-16,23
FC Salzburg,5064,1,14,8,2,45,18,27,50
SK Sturm Gra,5064,2,11,4,9,28,32,-4,37
Rapid Vienna,5064,3,8,11,5,35,27,8,35
LASK Linz,5064,4,9,6,9,27,26,1,33
Mattersburg,5064,5,6,7,11,30,40,-10,25
SC Rheindorf,5064,6,6,6,12,21,28,-7,24
Vienna,5064,7,6,6,12,25,40,-15,24
FC Salzburg,5065,1,15,7,2,48,19,29,52
LASK Linz,5065,2,11,5,8,32,25,7,38
SK Sturm Gra,5065,3,11,3,10,31,35,-4,36
Rapid Vienna,5065,4,8,10,6,33,28,5,34
SC Rheindorf,5065,5,6,6,12,20,28,-8,24
Vienna,5065,6,6,6,12,25,40,-15,24
Mattersburg,5065,7,6,5,13,28,42,-14,23
FC Salzburg,5066,1,14,7,3,45,20,25,49
SK Sturm Gra,5066,2,13,5,6,33,26,7,44
Rapid Vienna,5066,3,9,10,5,37,26,11,37
LASK Linz,5066,4,8,5,11,27,33,-6,29
Mattersburg,5066,5,7,5,12,32,43,-11,26
Vienna,5066,6,6,5,13,24,42,-18,23
SC Rheindorf,5066,7,5,7,12,21,29,-8,22
FC Salzburg,5067,1,13,7,4,41,21,20,46
SK Sturm Gra,5067,2,14,3,7,34,27,7,45
Rapid Vienna,5067,3,8,10,6,37,28,9,34
LASK Linz,5067,4,8,7,9,25,27,-2,31
Vienna,5067,5,7,6,11,26,39,-13,27
Mattersburg,5067,6,7,5,12,32,39,-7,26
SC Rheindorf,5067,7,5,6,13,18,32,-14,21
FC Salzburg,5068,1,15,7,2,45,16,29,52
SK Sturm Gra,5068,2,13,3,8,33,30,3,42
Rapid Vienna,5068,3,8,9,7,35,29,6,33
LASK Linz,5068,4,8,5,11,25,29,-4,29
SC Rheindorf,5068,5,7,5,12,20,27,-7,26
Mattersburg,5068,6,7,5,12,32,43,-11,26
Vienna,5068,7,6,6,12,25,41,-16,24
FC Salzburg,5069,1,16,6,2,45,15,30,54
SK Sturm Gra,5069,2,12,4,8,35,31,4,40
LASK Linz,5069,3,9,5,10,27,29,-2,32
Rapid Vienna,5069,4,7,10,7,33,30,3,31
Mattersburg,5069,5,6,7,11,29,39,-10,25
SC Rheindorf,5069,6,6,6,12,19,28,-9,24
Vienna,5069,7,6,6,12,24,40,-16,24
FC Salzburg,5070,1,14,6,4,44,18,26,48
Rapid Vienna,5070,2,10,10,4,37,25,12,40
SK Sturm Gra,5070,3,11,3,10,31,34,-3,36
LASK Linz,5070,4,9,6,9,27,26,1,33
Mattersburg,5070,5,6,7,11,30,40,-10,25
SC Rheindorf,5070,6,6,6,12,20,28,-8,24
Vienna,5070,7,6,6,12,25,43,-18,24
FC Salzburg,5071,1,15,7,2,46,18,28,52
SK Sturm Gra,5071,2,14,3,7,37,28,9,45
Rapid Vienna,5071,3,8,11,5,35,28,7,35
LASK Linz,5071,4,7,5,12,26,32,-6,26
Mattersburg,5071,5,6,7,11,32,42,-10,25
Vienna,5071,6,6,6,12,24,40,-16,24
SC Rheindorf,5071,7,5,7,12,19,31,-12,22
FC Salzburg,5072,1,14,8,2,44,18,26,50
SK Sturm Gra,5072,2,12,3,9,30,30,0,39
LASK Linz,5072,3,10,5,9,29,29,0,35
Rapid Vienna,5072,4,8,9,7,35,28,7,33
Vienna,5072,5,6,7,11,27,41,-14,25
SC Rheindorf,5072,6,6,6,12,22,30,-8,24
Mattersburg,5072,7,5,8,11,33,44,-11,23
FC Salzburg,5073,1,14,7,3,44,19,25,49
SK Sturm Gra,5073,2,12,4,8,33,31,2,40
Rapid Vienna,5073,3,8,10,6,33,26,7,34
LASK Linz,5073,4,9,6,9,29,29,0,33
SC Rheindorf,5073,5,7,5,12,21,29,-8,26
Vienna,5073,6,7,5,12,29,42,-13,26
Mattersburg,5073,7,5,7,12,35,48,-13,22
FC Salzburg,5074,1,13,8,3,44,18,26,47
SK Sturm Gra,5074,2,14,4,6,34,26,8,46
Rapid Vienna,5074,3,8,11,5,34,26,8,35
LASK Linz,5074,4,8,7,9,27,28,-1,31
Vienna,5074,5,6,7,11,26,40,-14,25
Mattersburg,5074,6,5,8,11,30,44,-14,23
SC Rheindorf,5074,7,4,7,13,19,32,-13,19
FC Salzburg,5075,1,15,7,2,45,18,27,52
Rapid Vienna,5075,2,10,10,4,37,25,12,40
SK Sturm Gra,5075,3,11,4,9,33,32,1,37
LASK Linz,5075,4,8,6,10,28,33,-5,30
SC Rheindorf,5075,5,6,6,12,24,31,-7,24
Mattersburg,5075,6,6,6,12,32,43,-11,24
Vienna,5075,7,6,5,13,24,41,-17,23
FC Salzburg,5076,1,15,6,3,47,22,25,51
SK Sturm Gra,5076,2,13,3,8,33,29,4,42
Rapid Vienna,5076,3,8,10,6,34,29,5,34
LASK Linz,5076,4,8,5,11,27,35,-8,29
Vienna,5076,5,8,5,11,28,40,-12,29
SC Rheindorf,5076,6,6,6,12,23,28,-5,24
Mattersburg,5076,7,6,5,13,33,42,-9,23
FC Salzburg,5077,1,15,7,2,51,19,32,52
SK Sturm Gra,5077,2,12,5,7,31,27,4,41
Rapid Vienna,5077,3,7,11,6,32,29,3,32
LASK Linz,5077,4,8,6,10,27,27,0,30
SC Rheindorf,5077,5,6,7,11,18,26,-8,25
Mattersburg,5077,6,6,6,12,30,44,-14,24
Vienna,5077,7,6,6,12,24,41,-17,24
FC Salzburg,5078,1,15,6,3,44,17,27,51
SK Sturm Gra,5078,2,13,4,7,31,27,4,43
Rapid Vienna,5078,3,8,11,5,34,26,8,35
LASK Linz,5078,4,8,6,10,27,29,-2,30
Mattersburg,5078,5,7,6,11,32,41,-9,27
Vienna,5078,6,6,5,13,23,40,-17,23
SC Rheindorf,5078,7,5,6,13,18,29,-11,21
FC Salzburg,5079,1,15,7,2,51,18,33,52
SK Sturm Gra,5079,2,14,3,7,35,28,7,45
Rapid Vienna,5079,3,8,10,6,35,28,7,34
LASK Linz,5079,4,9,5,10,26,28,-2,32
Vienna,5079,5,7,5,12,25,39,-14,26
Mattersburg,5079,6,6,5,13,31,49,-18,23
SC Rheindorf,5079,7,5,5,14,17,30,-13,20
FC Salzburg,5080,1,15,7,2,48,17,31,52
SK Sturm Gra,5080,2,12,6,6,31,26,5,42
Rapid Vienna,5080,3,9,10,5,33,24,9,37
LASK Linz,5080,4,8,5,11,25,28,-3,29
Vienna,5080,5,7,5,12,28,40,-12,26
SC Rheindorf,5080,6,5,7,12,17,27,-10,22
Mattersburg,5080,7,5,6,13,28,48,-20,21
FC Salzburg,5081,1,14,7,3,46,16,30,49
SK Sturm Gra,5081,2,13,4,7,35,26,9,43
Rapid Vienna,5081,3,8,10,6,34,29,5,34
LASK Linz,5081,4,8,8,8,28,27,1,32
Vienna,5081,5,8,5,11,25,37,-12,29
Mattersburg,5081,6,5,7,12,28,46,-18,22
SC Rheindorf,5081,7,4,7,13,15,30,-15,19
FC Salzburg,5082,1,15,6,3,43,18,25,51
SK Sturm Gra,5082,2,13,4,7,35,27,8,43
Rapid Vienna,5082,3,8,11,5,34,26,8,35
Mattersburg,5082,4,9,5,10,34,39,-5,32
LASK Linz,5082,5,7,5,12,25,32,-7,26
Vienna,5082,6,6,5,13,23,40,-17,23
SC Rheindorf,5082,7,5,6,13,18,30,-12,21
FC Salzburg,5083,1,14,8,2,47,20,27,50
SK Sturm Gra,5083,2,12,5,7,35,32,3,41
Rapid Vienna,5083,3,8,10,6,36,29,7,34
LASK Linz,5083,4,8,6,10,28,30,-2,30
SC Rheindorf,5083,5,7,5,12,22,30,-8,26
Vienna,5083,6,7,5,12,25,39,-14,26
Mattersburg,5083,7,6,5,13,29,42,-13,23
FC Salzburg,5084,1,14,7,3,44,19,25,49
Rapid Vienna,5084,2,11,9,4,38,23,15,42
SK Sturm Gra,5084,3,12,3,9,30,31,-1,39
Mattersburg,5084,4,7,7,10,32,39,-7,28
LASK Linz,5084,5,7,5,12,23,30,-7,26
SC Rheindorf,5084,6,6,6,12,20,28,-8,24
Vienna,5084,7,6,5,13,25,42,-17,23
FC Salzburg,5085,1,12,9,3,45,23,22,45
SK Sturm Gra,5085,2,13,5,6,35,29,6,44
Rapid Vienna,5085,3,8,11,5,39,29,10,35
Mattersburg,5085,4,8,6,10,33,39,-6,30
LASK Linz,5085,5,8,5,11,27,30,-3,29
Vienna,5085,6,7,5,12,26,41,-15,26
SC Rheindorf,5085,7,5,5,14,19,33,-14,20
FC Salzburg,5086,1,15,7,2,46,17,29,52
SK Sturm Gra,5086,2,12,4,8,33,32,1,40
Rapid Vienna,5086,3,8,11,5,39,28,11,35
LASK Linz,5086,4,9,6,9,26,26,0,33
Vienna,5086,5,7,6,11,26,39,-13,27
Mattersburg,5086,6,7,5,12,31,38,-7,26
SC Rheindorf,5086,7,4,5,15,16,37,-21,17
FC Salzburg,5087,1,12,8,4,41,20,21,44
SK Sturm Gra,5087,2,12,4,8,33,33,0,40
Rapid Vienna,5087,3,9,10,5,37,28,9,37
LASK Linz,5087,4,9,6,9,30,28,2,33
Vienna,5087,5,7,6,11,27,40,-13,27
SC Rheindorf,5087,6,6,6,12,22,30,-8,24
Mattersburg,5087,7,5,8,11,31,42,-11,23
FC Salzburg,5088,1,14,7,3,44,20,24,49
SK Sturm Gra,5088,2,11,5,8,32,30,2,38
Rapid Vienna,5088,3,8,11,5,36,28,8,35
LASK Linz,5088,4,8,7,9,27,27,0,31
SC Rheindorf,5088,5,7,6,11,20,27,-7,27
Vienna,5088,6,6,6,12,25,41,-16,24
Mattersburg,5088,7,5,8,11,28,39,-11,23
FC Salzburg,5089,1,15,6,3,45,20,25,51
SK Sturm Gra,5089,2,12,4,8,36,30,6,40
Rapid Vienna,5089,3,8,10,6,36,27,9,34
LASK Linz,5089,4,9,6,9,27,29,-2,33
Vienna,5089,5,7,5,12,25,41,-16,26
SC Rheindorf,5089,6,6,6,12,22,30,-8,24
Mattersburg,5089,7,6,5,13,31,45,-14,23
FC Salzburg,5090,1,15,6,3,45,19,26,51
SK Sturm Gra,5090,2,13,4,7,38,34,4,43
Rapid Vienna,5090,3,8,10,6,37,28,9,34
LASK Linz,5090,4,7,8,9,30,32,-2,29
Vienna,5090,5,8,5,11,27,39,-12,29
Mattersburg,5090,6,5,7,12,32,44,-12,22
SC Rheindorf,5090,7,5,6,13,19,32,-13,21
FC Salzburg,5091,1,13,9,2,47,21,26,48
SK Sturm Gra,5091,2,12,5,7,35,29,6,41
Rapid Vienna,5091,3,9,10,5,38,29,9,37
LASK Linz,5091,4,8,6,10,29,38,-9,30
Mattersburg,5091,5,7,6,11,31,42,-11,27
Vienna,5091,6,6,6,12,26,41,-15,24
SC Rheindorf,5091,7,5,6,13,26,32,-6,21
FC Salzburg,5092,1,15,6,3,44,18,26,51
SK Sturm Gra,5092,2,13,3,8,33,28,5,42
Rapid Vienna,5092,3,9,10,5,39,27,12,37
LASK Linz,5092,4,8,7,9,27,31,-4,31
Vienna,5092,5,7,5,12,27,40,-13,26
Mattersburg,5092,6,6,5,13,33,44,-11,23
SC Rheindorf,5092,7,5,6,13,17,32,-15,21
FC Salzburg,5093,1,13,8,3,43,20,23,47
SK Sturm Gra,5093,2,13,4,7,32,28,4,43
Rapid Vienna,5093,3,8,9,7,34,28,6,33
LASK Linz,5093,4,9,5,10,29,29,0,32
Mattersburg,5093,5,7,7,10,35,42,-7,28
Vienna,5093,6,6,7,11,26,40,-14,25
SC Rheindorf,5093,7,5,6,13,18,30,-12,21
FC Salzburg,5094,1,15,7,2,44,16,28,52
SK Sturm Gra,5094,2,12,4,8,29,27,2,40
Rapid Vienna,5094,3,8,10,6,34,28,6,34
LASK Linz,5094,4,9,5,10,27,28,-1,32
SC Rheindorf,5094,5,7,5,12,19,26,-7,26
Vienna,5094,6,7,5,12,25,39,-14,26
Mattersburg,5094,7,5,6,13,28,42,-14,21
FC Salzburg,5095,1,14,7,3,48,22,26,49
SK Sturm Gra,5095,2,12,4,8,35,35,0,40
Rapid Vienna,5095,3,9,10,5,36,28,8,37
LASK Linz,5095,4,9,6,9,30,27,3,33
Vienna,5095,5,7,6,11,26,39,-13,27
Mattersburg,5095,6,6,5,13,30,43,-13,23
SC Rheindorf,5095,7,5,6,13,20,31,-11,21
FC Salzburg,5096,1,14,8,2,45,19,26,50
SK Sturm Gra,5096,2,13,4,7,33,28,5,43
Rapid Vienna,5096,3,8,10,6,38,30,8,34
LASK Linz,5096,4,9,7,8,32,31,1,34
Mattersburg,5096,5,7,5,12,33,41,-8,26
Vienna,5096,6,6,6,12,24,40,-16,24
SC Rheindorf,5096,7,4,6,14,17,33,-16,18
FC Salzburg,5097,1,14,7,3,42,18,24,49
SK Sturm Gra,5097,2,15,3,6,35,27,8,48
Rapid Vienna,5097,3,8,9,7,36,31,5,33
Mattersburg,5097,4,7,7,10,30,37,-7,28
LASK Linz,5097,5,7,5,12,26,31,-5,26
Vienna,5097,6,6,6,12,23,38,-15,24
SC Rheindorf,5097,7,6,5,13,21,31,-10,23
FC Salzburg,5098,1,12,9,3,45,26,19,45
SK Sturm Gra,5098,2,12,6,6,34,28,6,42
Rapid Vienna,5098,3,8,11,5,37,26,11,35
Mattersburg,5098,4,8,6,10,33,39,-6,30
LASK Linz,5098,5,8,5,11,26,30,-4,29
Vienna,5098,6,6,6,12,26,42,-16,24
SC Rheindorf,5098,7,5,7,12,17,27,-10,22
FC Salzburg,5099,1,14,8,2,46,16,30,50
SK Sturm Gra,5099,2,12,4,8,30,27,3,40
LASK Linz,5099,3,8,8,8,29,29,0,32
Rapid Vienna,5099,4,7,10,7,32,28,4,31
SC Rheindorf,5099,5,7,6,11,20,26,-6,27
Vienna,5099,6,7,6,11,25,38,-13,27
Mattersburg,5099,7,5,6,13,28,46,-18,21
FC Salzburg,5100,1,14,6,4,43,19,24,48
SK Sturm Gra,5100,2,12,5,7,33,28,5,41
Rapid Vienna,5100,3,8,10,6,34,30,4,34
LASK Linz,5100,4,7,8,9,25,27,-2,29
Mattersburg,5100,5,7,7,10,32,37,-5,28
SC Rheindorf,5100,6,6,7,11,18,26,-8,25
Vienna,5100,7,6,5,13,25,43,-18,23
FC Salzburg,5101,1,14,7,3,50,22,28,49
SK Sturm Gra,5101,2,13,4,7,36,31,5,43
Rapid Vienna,5101,3,8,12,4,36,26,10,36
LASK Linz,5101,4,9,6,9,30,29,1,33
Mattersburg,5101,5,7,5,12,35,48,-13,26
Vienna,5101,6,6,5,13,24,43,-19,23
SC Rheindorf,5101,7,5,5,14,22,34,-12,20
FC Salzburg,5102,1,13,7,4,42,21,21,46
SK Sturm Gra,5102,2,14,3,7,36,29,7,45
Rapid Vienna,5102,3,9,9,6,36,28,8,36
LASK Linz,5102,4,9,6,9,29,28,1,33
Mattersburg,5102,5,6,8,10,31,38,-7,26
Vienna,5102,6,6,6,12,25,40,-15,24
SC Rheindorf,5102,7,5,5,14,19,34,-15,20
FC Salzburg,5103,1,14,7,3,44,19,25,49
SK Sturm Gra,5103,2,13,3,8,30,27,3,42
Rapid Vienna,5103,3,8,11,5,35,27,8,35
LASK Linz,5103,4,8,6,10,27,27,0,30
Vienna,5103,5,8,5,11,28,37,-9,29
Mattersburg,5103,6,7,5,12,31,43,-12,26
SC Rheindorf,5103,7,5,5,14,18,33,-15,20
FC Salzburg,5104,1,14,6,4,42,20,22,48
SK Sturm Gra,5104,2,12,4,8,30,28,2,40
Rapid Vienna,5104,3,9,10,5,34,26,8,37
LASK Linz,5104,4,8,5,11,27,32,-5,29
SC Rheindorf,5104,5,7,5,12,24,27,-3,26
Mattersburg,5104,6,7,5,12,34,44,-10,26
Vienna,5104,7,7,5,12,28,42,-14,26
FC Salzburg,5105,1,15,6,3,49,27,22,51
SK Sturm Gra,5105,2,13,4,7,36,30,6,43
LASK Linz,5105,3,10,5,9,30,29,1,35
Rapid Vienna,5105,4,7,11,6,36,31,5,32
Vienna,5105,5,8,5,11,30,38,-8,29
Mattersburg,5105,6,6,5,13,34,44,-10,23
SC Rheindorf,5105,7,4,6,14,19,35,-16,18
FC Salzburg,5106,1,14,6,4,44,21,23,48
SK Sturm Gra,5106,2,13,3,8,36,29,7,42
Rapid Vienna,5106,3,9,9,6,35,28,7,36
LASK Linz,5106,4,9,5,10,27,30,-3,32
Vienna,5106,5,7,5,12,24,38,-14,26
Mattersburg,5106,6,6,6,12,32,42,-10,24
SC Rheindorf,5106,7,6,6,12,19,29,-10,24
FC Salzburg,5107,1,14,7,3,42,20,22,49
SK Sturm Gra,5107,2,13,3,8,32,27,5,42
Rapid Vienna,5107,3,8,10,6,35,28,7,34
LASK Linz,5107,4,9,6,9,31,31,0,33
Vienna,5107,5,7,5,12,26,38,-12,26
Mattersburg,5107,6,6,6,12,34,45,-11,24
SC Rheindorf,5107,7,6,5,13,22,33,-11,23
FC Salzburg,5108,1,14,8,2,46,19,27,50
SK Sturm Gra,5108,2,13,4,7,35,30,5,43
Rapid Vienna,5108,3,8,11,5,35,27,8,35
LASK Linz,5108,4,7,6,11,27,31,-4,27
Vienna,5108,5,7,6,11,26,39,-13,27
SC Rheindorf,5108,6,6,6,12,19,29,-10,24
Mattersburg,5108,7,6,5,13,28,41,-13,23
FC Salzburg,5109,1,16,6,2,52,15,37,54
SK Sturm Gra,5109,2,11,4,9,31,33,-2,37
LASK Linz,5109,3,10,5,9,29,28,1,35
Rapid Vienna,5109,4,8,10,6,35,30,5,34
Mattersburg,5109,5,7,6,11,33,40,-7,27
Vienna,5109,6,6,5,13,24,48,-24,23
SC Rheindorf,5109,7,5,6,13,21,31,-10,21
FC Salzburg,5110,1,14,6,4,43,19,24,48
Rapid Vienna,5110,2,10,9,5,37,26,11,39
SK Sturm Gra,5110,3,12,3,9,32,30,2,39
LASK Linz,5110,4,8,6,10,27,29,-2,30
Mattersburg,5110,5,7,6,11,34,41,-7,27
Vienna,5110,6,7,5,12,26,41,-15,26
SC Rheindorf,5110,7,6,5,13,18,31,-13,23
FC Salzburg,5111,1,15,6,3,47,21,26,51
SK Sturm Gra,5111,2,13,4,7,38,32,6,43
LASK Linz,5111,3,8,7,9,28,29,-1,31
Rapid Vienna,5111,4,7,9,8,33,32,1,30
Vienna,5111,5,8,5,11,27,38,-11,29
SC Rheindorf,5111,6,6,7,11,18,26,-8,25
Mattersburg,5111,7,5,6,13,29,42,-13,21
FC Salzburg,5112,1,15,7,2,46,16,30,52
SK Sturm Gra,5112,2,13,4,7,38,30,8,43
Rapid Vienna,5112,3,9,10,5,35,29,6,37
LASK Linz,5112,4,7,5,12,26,33,-7,26
Mattersburg,5112,5,7,5,12,32,40,-8,26
SC Rheindorf,5112,6,6,6,12,21,31,-10,24
Vienna,5112,7,6,5,13,23,42,-19,23
FC Salzburg,5113,1,15,7,2,55,21,34,52
SK Sturm Gra,5113,2,13,4,7,36,29,7,43
Rapid Vienna,5113,3,8,9,7,37,35,2,33
LASK Linz,5113,4,9,6,9,29,29,0,33
Vienna,5113,5,7,5,12,28,44,-16,26
Mattersburg,5113,6,5,7,12,30,45,-15,22
SC Rheindorf,5113,7,5,6,13,21,33,-12,21
FC Salzburg,5114,1,15,7,2,46,17,29,52
SK Sturm Gra,5114,2,13,3,8,36,30,6,42
Rapid Vienna,5114,3,8,10,6,34,30,4,34
LASK Linz,5114,4,8,7,9,27,28,-1,31
Mattersburg,5114,5,7,6,11,31,39,-8,27
Vienna,5114,6,6,6,12,24,40,-16,24
SC Rheindorf,5114,7,4,7,13,17,31,-14,19
FC Salzburg,5115,1,14,7,3,48,17,31,49
SK Sturm Gra,5115,2,12,4,8,32,29,3,40
LASK Linz,5115,3,10,5,9,30,27,3,35
Rapid Vienna,5115,4,8,9,7,35,32,3,33
Vienna,5115,5,8,5,11,28,39,-11,29
SC Rheindorf,5115,6,7,5,12,21,29,-8,26
Mattersburg,5115,7,5,5,14,28,49,-21,20
FC Salzburg,5116,1,16,6,2,50,16,34,54
Rapid Vienna,5116,2,10,9,5,37,28,9,39
SK Sturm Gra,5116,3,11,4,9,31,32,-1,37
LASK Linz,5116,4,9,5,10,31,32,-1,32
Mattersburg,5116,5,6,6,12,30,42,-12,24
Vienna,5116,6,6,6,12,24,39,-15,24
SC Rheindorf,5116,7,5,6,13,19,33,-14,21
FC Salzburg,5117,1,14,7,3,44,18,26,49
SK Sturm Gra,5117,2,12,4,8,31,28,3,40
Rapid Vienna,5117,3,8,11,5,36,28,8,35
LASK Linz,5117,4,7,7,10,27,32,-5,28
SC Rheindorf,5117,5,7,5,12,20,26,-6,26
Mattersburg,5117,6,7,5,12,30,40,-10,26
Vienna,5117,7,7,5,12,26,42,-16,26
FC Salzburg,5118,1,14,8,2,46,17,29,50
SK Sturm Gra,5118,2,11,4,9,30,31,-1,37
Rapid Vienna,5118,3,8,12,4,38,27,11,36
LASK Linz,5118,4,8,7,9,27,30,-3,31
Vienna,5118,5,7,5,12,26,40,-14,26
SC Rheindorf,5118,6,6,7,11,22,28,-6,25
Mattersburg,5118,7,5,7,12,28,44,-16,22
FC Salzburg,5119,1,12,9,3,41,19,22,45
SK Sturm Gra,5119,2,14,3,7,33,29,4,45
Rapid Vienna,5119,3,9,10,5,39,28,11,37
Mattersburg,5119,4,7,7,10,32,40,-8,28
LASK Linz,5119,5,7,6,11,25,30,-5,27
Vienna,5119,6,6,6,12,26,41,-15,24
SC Rheindorf,5119,7,5,7,12,22,31,-9,22
FC Salzburg,5120,1,13,8,3,43,21,22,47
SK Sturm Gra,5120,2,12,5,7,34,29,5,41
LASK Linz,5120,3,10,6,8,28,25,3,36
Rapid Vienna,5120,4,7,11,6,33,29,4,32
Vienna,5120,5,8,5,11,29,40,-11,29
Mattersburg,5120,6,6,5,13,29,41,-12,23
SC Rheindorf,5120,7,4,8,12,20,31,-11,20
FC Salzburg,5121,1,13,7,4,44,22,22,46
SK Sturm Gra,5121,2,13,3,8,32,29,3,42
Rapid Vienna,5121,3,9,11,4,36,26,10,38
LASK Linz,5121,4,9,6,9,30,28,2,33
Mattersburg,5121,5,7,6,11,32,42,-10,27
Vienna,5121,6,6,7,11,25,39,-14,25
SC Rheindorf,5121,7,4,6,14,18,31,-13,18
FC Salzburg,5122,1,16,6,2,49,17,32,54
SK Sturm Gra,5122,2,12,4,8,37,31,6,40
Rapid Vienna,5122,3,9,9,6,38,32,6,36
Mattersburg,5122,4,8,5,11,33,42,-9,29
LASK Linz,5122,5,8,5,11,26,35,-9,29
Vienna,5122,6,6,5,13,24,42,-18,23
SC Rheindorf,5122,7,5,6,13,24,32,-8,21
FC Salzburg,5123,1,15,6,3,49,19,30,51
SK Sturm Gra,5123,2,14,4,6,35,28,7,46
Rapid Vienna,5123,3,9,9,6,36,28,8,36
LASK Linz,5123,4,8,6,10,27,27,0,30
Vienna,5123,5,7,5,12,29,42,-13,26
SC Rheindorf,5123,6,5,6,13,18,33,-15,21
Mattersburg,5123,7,5,6,13,29,46,-17,21
FC Salzburg,5124,1,15,6,3,49,20,29,51
SK Sturm Gra,5124,2,12,4,8,34,32,2,40
Rapid Vienna,5124,3,9,10,5,38,31,7,37
LASK Linz,5124,4,7,6,11,26,30,-4,27
Mattersburg,5124,5,7,6,11,35,44,-9,27
Vienna,5124,6,7,5,12,27,41,-14,26
SC Rheindorf,5124,7,5,7,12,20,31,-11,22
FC Salzburg,5125,1,16,6,2,48,17,31,54
SK Sturm Gra,5125,2,13,3,8,34,28,6,42
Rapid Vienna,5125,3,8,11,5,39,31,8,35
LASK Linz,5125,4,7,7,10,25,29,-4,28
Mattersburg,5125,5,7,5,12,29,42,-13,26
Vienna,5125,6,6,5,13,23,40,-17,23
SC Rheindorf,5125,7,5,7,12,19,30,-11,22
FC Salzburg,5126,1,14,8,2,42,16,26,50
SK Sturm Gra,5126,2,12,5,7,32,28,4,41
LASK Linz,5126,3,10,6,8,33,27,6,36
Rapid Vienna,5126,4,7,11,6,34,30,4,32
Vienna,5126,5,6,7,11,24,38,-14,25
Mattersburg,5126,6,5,7,12,28,43,-15,22
SC Rheindorf,5126,7,4,8,12,18,29,-11,20
FC Salzburg,5127,1,14,6,4,44,20,24,48
SK Sturm Gra,5127,2,13,3,8,33,29,4,42
Rapid Vienna,5127,3,9,10,5,37,29,8,37
LASK Linz,5127,4,9,6,9,29,29,0,33
Vienna,5127,5,7,6,11,24,37,-13,27
Mattersburg,5127,6,6,6,12,31,41,-10,24
SC Rheindorf,5127,7,5,5,14,18,31,-13,20
FC Salzburg,5128,1,14,8,2,47,19,28,50
SK Sturm Gra,5128,2,11,6,7,30,28,2,39
Rapid Vienna,5128,3,9,10,5,38,27,11,37
LASK Linz,5128,4,8,7,9,27,29,-2,31
Mattersburg,5128,5,7,6,11,37,44,-7,27
Vienna,5128,6,6,5,13,27,48,-21,23
SC Rheindorf,5128,7,5,6,13,19,30,-11,21
FC Salzburg,5129,1,14,6,4,44,23,21,48
SK Sturm Gra,5129,2,14,3,7,41,28,13,45
LASK Linz,5129,3,10,5,9,34,31,3,35
Rapid Vienna,5129,4,8,10,6,35,34,1,34
Mattersburg,5129,5,7,6,11,35,42,-7,27
Vienna,5129,6,6,6,12,26,41,-15,24
SC Rheindorf,5129,7,4,6,14,17,33,-16,18
FC Salzburg,5130,1,15,6,3,46,17,29,51
Rapid Vienna,5130,2,10,9,5,36,25,11,39
SK Sturm Gra,5130,3,11,5,8,33,32,1,38
LASK Linz,5130,4,7,6,11,27,31,-4,27
Mattersburg,5130,5,7,6,11,31,40,-9,27
SC Rheindorf,5130,6,6,6,12,20,30,-10,24
Vienna,5130,7,6,6,12,24,42,-18,24
FC Salzburg,5131,1,13,9,2,45,20,25,48
SK Sturm Gra,5131,2,11,7,6,31,27,4,40
Rapid Vienna,5131,3,9,11,4,38,28,10,38
LASK Linz,5131,4,9,6,9,30,28,2,33
Mattersburg,5131,5,6,6,12,29,42,-13,24
Vienna,5131,6,6,6,12,25,40,-15,24
SC Rheindorf,5131,7,4,7,13,17,30,-13,19
FC Salzburg,5132,1,14,8,2,46,19,27,50
SK Sturm Gra,5132,2,12,5,7,37,31,6,41
Rapid Vienna,5132,3,8,10,6,34,32,2,34
LASK Linz,5132,4,9,7,8,31,29,2,34
Vienna,5132,5,6,7,11,25,39,-14,25
Mattersburg,5132,6,6,6,12,30,42,-12,24
SC Rheindorf,5132,7,5,5,14,19,30,-11,20
FC Salzburg,5133,1,14,7,3,46,19,27,49
Rapid Vienna,5133,2,9,11,4,36,26,10,38
SK Sturm Gra,5133,3,11,5,8,34,33,1,38
LASK Linz,5133,4,8,6,10,29,31,-2,30
Vienna,5133,5,7,6,11,27,38,-11,27
SC Rheindorf,5133,6,6,6,12,22,30,-8,24
Mattersburg,5133,7,6,5,13,27,44,-17,23
FC Salzburg,5134,1,13,6,5,41,20,21,45
SK Sturm Gra,5134,2,12,6,6,29,24,5,42
Rapid Vienna,5134,3,7,12,5,32,26,6,33
LASK Linz,5134,4,8,7,9,25,28,-3,31
Vienna,5134,5,7,6,11,29,42,-13,27
SC Rheindorf,5134,6,6,7,11,21,27,-6,25
Mattersburg,5134,7,6,6,12,36,46,-10,24
FC Salzburg,5135,1,15,7,2,43,16,27,52
SK Sturm Gra,5135,2,14,4,6,32,25,7,46
Rapid Vienna,5135,3,9,9,6,34,26,8,36
LASK Linz,5135,4,8,5,11,25,29,-4,29
Vienna,5135,5,6,6,12,24,39,-15,24
SC Rheindorf,5135,6,6,5,13,21,30,-9,23
Mattersburg,5135,7,5,6,13,28,42,-14,21
FC Salzburg,5136,1,15,7,2,47,18,29,52
SK Sturm Gra,5136,2,13,4,7,35,29,6,43
Rapid Vienna,5136,3,9,9,6,38,28,10,36
LASK Linz,5136,4,9,5,10,27,29,-2,32
Mattersburg,5136,5,7,5,12,35,44,-9,26
Vienna,5136,6,6,5,13,26,43,-17,23
SC Rheindorf,5136,7,5,5,14,17,34,-17,20
FC Salzburg,5137,1,14,8,2,47,17,30,50
Rapid Vienna,5137,2,9,10,5,38,29,9,37
SK Sturm Gra,5137,3,11,4,9,28,32,-4,37
LASK Linz,5137,4,8,6,10,29,30,-1,30
Mattersburg,5137,5,7,7,10,30,38,-8,28
Vienna,5137,6,6,6,12,24,41,-17,24
SC Rheindorf,5137,7,6,5,13,20,29,-9,23
FC Salzburg,5138,1,15,7,2,48,20,28,52
SK Sturm Gra,5138,2,12,4,8,34,30,4,40
Rapid Vienna,5138,3,8,10,6,37,31,6,34
LASK Linz,5138,4,8,7,9,27,27,0,31
Mattersburg,5138,5,7,6,11,31,38,-7,27
Vienna,5138,6,6,5,13,24,43,-19,23
SC Rheindorf,5138,7,5,7,12,19,31,-12,22
FC Salzburg,5139,1,14,8,2,49,19,30,50
SK Sturm Gra,5139,2,13,5,6,35,27,8,44
Rapid Vienna,5139,3,8,12,4,37,28,9,36
LASK Linz,5139,4,8,6,10,28,34,-6,30
Vienna,5139,5,7,5,12,24,38,-14,26
Mattersburg,5139,6,6,5,13,30,46,-16,23
SC Rheindorf,5139,7,5,5,14,21,32,-11,20
FC Salzburg,5140,1,14,6,4,43,19,24,48
SK Sturm Gra,5140,2,14,3,7,34,27,7,45
Rapid Vienna,5140,3,9,9,6,34,27,7,36
LASK Linz,5140,4,9,6,9,28,27,1,33
Mattersburg,5140,5,7,5,12,33,43,-10,26
Vienna,5140,6,7,5,12,26,40,-14,26
SC Rheindorf,5140,7,4,6,14,18,33,-15,18
FC Salzburg,5141,1,14,8,2,48,18,30,50
SK Sturm Gra,5141,2,13,5,6,36,29,7,44
Rapid Vienna,5141,3,7,13,4,35,27,8,34
LASK Linz,5141,4,7,7,10,29,32,-3,28
Mattersburg,5141,5,7,6,11,32,44,-12,27
Vienna,5141,6,6,6,12,26,43,-17,24
SC Rheindorf,5141,7,4,7,13,18,31,-13,19
FC Salzburg,5142,1,14,8,2,44,18,26,50
SK Sturm Gra,5142,2,12,4,8,33,31,2,40
LASK Linz,5142,3,10,5,9,31,29,2,35
Rapid Vienna,5142,4,8,10,6,38,29,9,34
Mattersburg,5142,5,7,6,11,31,40,-9,27
Vienna,5142,6,6,6,12,25,40,-15,24
SC Rheindorf,5142,7,5,5,14,19,34,-15,20
FC Salzburg,5143,1,12,7,5,42,24,18,43
SK Sturm Gra,5143,2,13,4,7,32,26,6,43
Rapid Vienna,5143,3,10,9,5,40,25,15,39
LASK Linz,5143,4,8,6,10,27,31,-4,30
Vienna,5143,5,8,5,11,29,39,-10,29
Mattersburg,5143,6,5,8,11,35,47,-12,23
SC Rheindorf,5143,7,5,7,12,20,33,-13,22
FC Salzburg,5144,1,13,9,2,42,17,25,48
SK Sturm Gra,5144,2,12,3,9,33,32,1,39
Rapid Vienna,5144,3,9,11,4,40,25,15,38
LASK Linz,5144,4,8,7,9,27,29,-2,31
Mattersburg,5144,5,6,8,10,29,38,-9,26
Vienna,5144,6,6,6,12,24,39,-15,24
SC Rheindorf,5144,7,5,6,13,19,34,-15,21
FC Salzburg,5145,1,14,7,3,44,20,24,49
SK Sturm Gra,5145,2,12,4,8,34,31,3,40
Rapid Vienna,5145,3,8,10,6,36,29,7,34
LASK Linz,5145,4,9,6,9,30,29,1,33
Vienna,5145,5,7,6,11,26,39,-13,27
Mattersburg,5145,6,6,8,10,35,44,-9,26
SC Rheindorf,5145,7,5,5,14,21,34,-13,20
FC Salzburg,5146,1,16,6,2,48,18,30,54
SK Sturm Gra,5146,2,12,5,7,31,27,4,41
Rapid Vienna,5146,3,7,11,6,34,30,4,32
LASK Linz,5146,4,8,6,10,28,30,-2,30
Mattersburg,5146,5,7,5,12,33,43,-10,26
SC Rheindorf,5146,6,6,6,12,18,27,-9,24
Vienna,5146,7,6,5,13,24,41,-17,23
FC Salzburg,5147,1,14,7,3,45,21,24,49
SK Sturm Gra,5147,2,12,4,8,32,29,3,40
Rapid Vienna,5147,3,8,10,6,36,27,9,34
LASK Linz,5147,4,9,7,8,27,26,1,34
Vienna,5147,5,7,5,12,25,41,-16,26
Mattersburg,5147,6,6,7,11,30,40,-10,25
SC Rheindorf,5147,7,5,6,13,18,29,-11,21
FC Salzburg,5148,1,16,6,2,49,17,32,54
SK Sturm Gra,5148,2,12,3,9,32,31,1,39
Rapid Vienna,5148,3,8,10,6,34,28,6,34
LASK Linz,5148,4,8,8,8,25,25,0,32
Vienna,5148,5,7,5,12,26,40,-14,26
Mattersburg,5148,6,6,6,12,30,42,-12,24
SC Rheindorf,5148,7,5,6,13,18,31,-13,21
FC Salzburg,5149,1,15,6,3,48,18,30,51
SK Sturm Gra,5149,2,12,4,8,32,28,4,40
Rapid Vienna,5149,3,9,9,6,34,29,5,36
LASK Linz,5149,4,8,8,8,26,25,1,32
Vienna,5149,5,7,5,12,25,41,-16,26
SC Rheindorf,5149,6,6,6,12,20,29,-9,24
Mattersburg,5149,7,5,6,13,29,44,-15,21
FC Salzburg,5150,1,14,7,3,48,21,27,49
SK Sturm Gra,5150,2,13,4,7,32,28,4,43
Rapid Vienna,5150,3,10,9,5,37,27,10,39
LASK Linz,5150,4,7,5,12,25,33,-8,26
Vienna,5150,5,7,5,12,25,40,-15,26
SC Rheindorf,5150,6,6,6,12,22,29,-7,24
Mattersburg,5150,7,6,6,12,34,45,-11,24
FC Salzburg,5151,1,14,7,3,47,19,28,49
SK Sturm Gra,5151,2,12,5,7,33,28,5,41
Rapid Vienna,5151,3,10,9,5,38,28,10,39
LASK Linz,5151,4,8,6,10,29,32,-3,30
SC Rheindorf,5151,5,7,5,12,21,28,-7,26
Vienna,5151,6,7,5,12,27,41,-14,26
Mattersburg,5151,7,5,5,14,29,48,-19,20
FC Salzburg,5152,1,15,7,2,47,18,29,52
SK Sturm Gra,5152,2,13,4,7,35,29,6,43
Rapid Vienna,5152,3,7,9,8,33,31,2,30
LASK Linz,5152,4,8,6,10,27,28,-1,30
Vienna,5152,5,7,6,11,26,37,-11,27
Mattersburg,5152,6,7,5,12,30,44,-14,26
SC Rheindorf,5152,7,6,5,13,18,29,-11,23
FC Salzburg,5153,1,14,8,2,46,19,27,50
SK Sturm Gra,5153,2,12,4,8,37,29,8,40
Rapid Vienna,5153,3,9,11,4,38,24,14,38
LASK Linz,5153,4,8,5,11,26,39,-13,29
Mattersburg,5153,5,6,8,10,31,39,-8,26
Vienna,5153,6,6,6,12,26,43,-17,24
SC Rheindorf,5153,7,4,8,12,17,28,-11,20
FC Salzburg,5154,1,15,7,2,46,17,29,52
SK Sturm Gra,5154,2,12,4,8,30,32,-2,40
LASK Linz,5154,3,9,6,9,26,25,1,33
Rapid Vienna,5154,4,7,9,8,32,28,4,30
Vienna,5154,5,7,6,11,27,38,-11,27
SC Rheindorf,5154,6,7,5,12,20,26,-6,26
Mattersburg,5154,7,6,5,13,28,43,-15,23
FC Salzburg,5155,1,14,8,2,44,17,27,50
SK Sturm Gra,5155,2,12,5,7,32,28,4,41
Rapid Vienna,5155,3,7,11,6,33,30,3,32
LASK Linz,5155,4,9,5,10,27,28,-1,32
Vienna,5155,5,6,7,11,25,39,-14,25
SC Rheindorf,5155,6,6,6,12,21,28,-7,24
Mattersburg,5155,7,6,6,12,28,40,-12,24
FC Salzburg,5156,1,15,6,3,46,18,28,51
SK Sturm Gra,5156,2,14,3,7,34,27,7,45
LASK Linz,5156,3,10,6,8,30,27,3,36
Rapid Vienna,5156,4,8,9,7,35,31,4,33
Mattersburg,5156,5,6,5,13,33,44,-11,23
Vienna,5156,6,6,5,13,23,42,-19,23
SC Rheindorf,5156,7,5,6,13,20,32,-12,21
FC Salzburg,5157,1,16,6,2,50,18,32,54
SK Sturm Gra,5157,2,11,4,9,30,35,-5,37
Rapid Vienna,5157,3,8,11,5,37,29,8,35
LASK Linz,5157,4,8,8,8,26,25,1,32
Mattersburg,5157,5,7,5,12,33,42,-9,26
Vienna,5157,6,6,5,13,24,43,-19,23
SC Rheindorf,5157,7,5,7,12,21,29,-8,22
FC Salzburg,5158,1,15,7,2,47,18,29,52
SK Sturm Gra,5158,2,13,3,8,38,31,7,42
Rapid Vienna,5158,3,8,11,5,36,28,8,35
LASK Linz,5158,4,9,6,9,27,27,0,33
Mattersburg,5158,5,7,5,12,32,42,-10,26
Vienna,5158,6,6,5,13,24,41,-17,23
SC Rheindorf,5158,7,5,5,14,21,38,-17,20
FC Salzburg,5159,1,16,6,2,51,17,34,54
SK Sturm Gra,5159,2,13,3,8,32,32,0,42
Rapid Vienna,5159,3,8,10,6,34,27,7,34
LASK Linz,5159,4,7,7,10,24,28,-4,28
Mattersburg,5159,5,6,7,11,28,39,-11,25
SC Rheindorf,5159,6,5,8,11,19,27,-8,23
Vienna,5159,7,6,5,13,24,42,-18,23
FC Salzburg,5160,1,13,7,4,41,21,20,46
SK Sturm Gra,5160,2,14,4,6,37,27,10,46
Rapid Vienna,5160,3,8,10,6,33,27,6,34
LASK Linz,5160,4,8,6,10,26,28,-2,30
Vienna,5160,5,7,5,12,25,39,-14,26
Mattersburg,5160,6,6,7,11,31,40,-9,25
SC Rheindorf,5160,7,6,5,13,19,30,-11,23
SK Sturm Gra,5161,1,15,3,6,35,26,9,48
FC Salzburg,5161,2,13,8,3,43,18,25,47
Rapid Vienna,5161,3,7,11,6,35,31,4,32
LASK Linz,5161,4,7,7,10,27,31,-4,28
Mattersburg,5161,5,7,7,10,33,38,-5,28
SC Rheindorf,5161,6,6,5,13,21,29,-8,23
Vienna,5161,7,6,5,13,23,44,-21,23
FC Salzburg,5162,1,14,7,3,46,19,27,49
SK Sturm Gra,5162,2,13,3,8,32,30,2,42
Rapid Vienna,5162,3,10,10,4,41,27,14,40
LASK Linz,5162,4,8,6,10,30,33,-3,30
Vienna,5162,5,7,6,11,28,41,-13,27
Mattersburg,5162,6,6,5,13,32,46,-14,23
SC Rheindorf,5162,7,5,5,14,19,32,-13,20
FC Salzburg,5163,1,14,8,2,44,19,25,50
SK Sturm Gra,5163,2,12,4,8,32,29,3,40
Rapid Vienna,5163,3,8,10,6,35,28,7,34
LASK Linz,5163,4,9,7,8,29,27,2,34
Vienna,5163,5,7,6,11,26,38,-12,27
Mattersburg,5163,6,6,6,12,31,42,-11,24
SC Rheindorf,5163,7,4,7,13,17,31,-14,19
FC Salzburg,5164,1,13,7,4,44,22,22,46
SK Sturm Gra,5164,2,13,5,6,34,26,8,44
Rapid Vienna,5164,3,8,10,6,38,30,8,34
LASK Linz,5164,4,9,6,9,31,31,0,33
Vienna,5164,5,7,6,11,28,41,-13,27
SC Rheindorf,5164,6,6,5,13,23,34,-11,23
Mattersburg,5164,7,5,7,12,32,46,-14,22
FC Salzburg,5165,1,16,6,2,47,16,31,54
SK Sturm Gra,5165,2,12,4,8,32,29,3,40
Rapid Vienna,5165,3,9,9,6,38,28,10,36
LASK Linz,5165,4,9,6,9,27,29,-2,33
Vienna,5165,5,6,6,12,25,40,-15,24
SC Rheindorf,5165,6,6,5,13,20,30,-10,23
Mattersburg,5165,7,5,6,13,28,45,-17,21
FC Salzburg,5166,1,15,6,3,44,17,27,51
SK Sturm Gra,5166,2,13,4,7,35,28,7,43
LASK Linz,5166,3,10,5,9,29,28,1,35
Rapid Vienna,5166,4,8,9,7,35,30,5,33
Vienna,5166,5,7,5,12,25,39,-14,26
Mattersburg,5166,6,6,5,13,30,42,-12,23
SC Rheindorf,5166,7,5,6,13,18,32,-14,21
FC Salzburg,5167,1,13,8,3,43,21,22,47
SK Sturm Gra,5167,2,13,3,8,32,28,4,42
Rapid Vienna,5167,3,9,10,5,35,25,10,37
LASK Linz,5167,4,8,6,10,25,26,-1,30
Mattersburg,5167,5,6,7,11,28,39,-11,25
SC Rheindorf,5167,6,6,6,12,18,27,-9,24
Vienna,5167,7,6,6,12,25,40,-15,24
FC Salzburg,5168,1,15,7,2,44,16,28,52
SK Sturm Gra,5168,2,12,5,7,31,28,3,41
Rapid Vienna,5168,3,7,12,5,33,26,7,33
LASK Linz,5168,4,9,5,10,26,28,-2,32
Mattersburg,5168,5,7,6,11,34,41,-7,27
Vienna,5168,6,6,6,12,25,41,-16,24
SC Rheindorf,5168,7,4,7,13,19,32,-13,19
FC Salzburg,5169,1,14,7,3,46,19,27,49
SK Sturm Gra,5169,2,12,6,6,32,27,5,42
Rapid Vienna,5169,3,9,10,5,34,25,9,37
LASK Linz,5169,4,8,7,9,26,26,0,31
Vienna,5169,5,7,5,12,28,42,-14,26
SC Rheindorf,5169,6,6,6,12,19,28,-9,24
Mattersburg,5169,7,5,5,14,30,48,-18,20
FC Salzburg,5170,1,14,6,4,45,20,25,48
Rapid Vienna,5170,2,10,9,5,35,27,8,39
SK Sturm Gra,5170,3,12,3,9,33,31,2,39
LASK Linz,5170,4,8,6,10,24,26,-2,30
Vienna,5170,5,7,6,11,27,39,-12,27
SC Rheindorf,5170,6,7,5,12,22,28,-6,26
Mattersburg,5170,7,5,7,12,29,44,-15,22
FC Salzburg,5171,1,14,8,2,48,18,30,50
SK Sturm Gra,5171,2,11,5,8,29,31,-2,38
Rapid Vienna,5171,3,8,11,5,35,25,10,35
LASK Linz,5171,4,9,6,9,28,27,1,33
Mattersburg,5171,5,7,6,11,33,42,-9,27
SC Rheindorf,5171,6,6,5,13,20,31,-11,23
Vienna,5171,7,6,5,13,26,45,-19,23
FC Salzburg,5172,1,13,9,2,42,16,26,48
Rapid Vienna,5172,2,10,10,4,39,26,13,40
SK Sturm Gra,5172,3,11,5,8,28,27,1,38
LASK Linz,5172,4,8,7,9,29,31,-2,31
Vienna,5172,5,7,5,12,24,40,-16,26
SC Rheindorf,5172,6,6,6,12,19,27,-8,24
Mattersburg,5172,7,5,6,13,28,42,-14,21
FC Salzburg,5173,1,15,6,3,46,18,28,51
SK Sturm Gra,5173,2,11,5,8,30,29,1,38
Rapid Vienna,5173,3,8,10,6,37,30,7,34
LASK Linz,5173,4,9,6,9,29,28,1,33
SC Rheindorf,5173,5,7,6,11,19,25,-6,27
Mattersburg,5173,6,6,6,12,27,40,-13,24
Vienna,5173,7,6,5,13,23,41,-18,23
SK Sturm Gra,5174,1,15,3,6,34,26,8,48
FC Salzburg,5174,2,13,7,4,43,20,23,46
Rapid Vienna,5174,3,9,9,6,34,27,7,36
LASK Linz,5174,4,9,5,10,28,30,-2,32
Vienna,5174,5,7,5,12,27,42,-15,26
Mattersburg,5174,6,6,6,12,34,41,-7,24
SC Rheindorf,5174,7,5,5,14,18,32,-14,20
FC Salzburg,5175,1,15,6,3,43,18,25,51
Rapid Vienna,5175,2,10,9,5,38,27,11,39
SK Sturm Gra,5175,3,12,3,9,32,30,2,39
LASK Linz,5175,4,9,6,9,29,30,-1,33
Vienna,5175,5,6,6,12,26,42,-16,24
SC Rheindorf,5175,6,6,5,13,22,31,-9,23
Mattersburg,5175,7,5,7,12,30,42,-12,22
FC Salzburg,5176,1,14,7,3,46,19,27,49
SK Sturm Gra,5176,2,14,3,7,36,29,7,45
Rapid Vienna,5176,3,10,10,4,36,25,11,40
LASK Linz,5176,4,7,6,11,28,33,-5,27
Mattersburg,5176,5,6,6,12,30,43,-13,24
SC Rheindorf,5176,6,6,5,13,19,29,-10,23
Vienna,5176,7,6,5,13,25,42,-17,23
FC Salzburg,5177,1,13,7,4,39,17,22,46
SK Sturm Gra,5177,2,12,5,7,33,28,5,41
Rapid Vienna,5177,3,9,10,5,36,26,10,37
LASK Linz,5177,4,8,7,9,31,29,2,31
SC Rheindorf,5177,5,7,5,12,21,30,-9,26
Mattersburg,5177,6,7,5,12,29,43,-14,26
Vienna,5177,7,6,5,13,24,40,-16,23
FC Salzburg,5178,1,15,7,2,47,16,31,52
SK Sturm Gra,5178,2,12,4,8,33,31,2,40
Rapid Vienna,5178,3,9,9,6,40,31,9,36
LASK Linz,5178,4,7,8,9,26,28,-2,29
Mattersburg,5178,5,7,7,10,29,37,-8,28
Vienna,5178,6,6,5,13,23,40,-17,23
SC Rheindorf,5178,7,5,6,13,20,35,-15,21
FC Salzburg,5179,1,15,7,2,49,17,32,52
SK Sturm Gra,5179,2,13,3,8,35,32,3,42
Rapid Vienna,5179,3,8,9,7,34,30,4,33
LASK Linz,5179,4,8,6,10,26,28,-2,30
SC Rheindorf,5179,5,7,5,12,19,29,-10,26
Vienna,5179,6,7,5,12,28,40,-12,26
Mattersburg,5179,7,5,7,12,29,44,-15,22
FC Salzburg,5180,1,14,7,3,46,22,24,49
SK Sturm Gra,5180,2,12,5,7,32,29,3,41
LASK Linz,5180,3,10,5,9,31,30,1,35
Rapid Vienna,5180,4,8,9,7,36,30,6,33
Vienna,5180,5,7,5,12,27,44,-17,26
SC Rheindorf,5180,6,6,6,12,22,28,-6,24
Mattersburg,5180,7,6,5,13,35,46,-11,23
FC Salzburg,5181,1,16,6,2,52,18,34,54
SK Sturm Gra,5181,2,13,3,8,32,27,5,42
Rapid Vienna,5181,3,7,11,6,34,32,2,32
LASK Linz,5181,4,7,6,11,24,30,-6,27
Vienna,5181,5,7,5,12,26,41,-15,26
SC Rheindorf,5181,6,6,7,11,21,27,-6,25
Mattersburg,5181,7,6,6,12,29,43,-14,24
FC Salzburg,5182,1,15,7,2,50,20,30,52
SK Sturm Gra,5182,2,11,5,8,30,29,1,38
Rapid Vienna,5182,3,8,10,6,37,31,6,34
LASK Linz,5182,4,8,7,9,29,28,1,31
Vienna,5182,5,6,7,11,25,39,-14,25
SC Rheindorf,5182,6,6,6,12,17,28,-11,24
Mattersburg,5182,7,6,6,12,31,44,-13,24
FC Salzburg,5183,1,14,8,2,43,16,27,50
Rapid Vienna,5183,2,9,10,5,37,26,11,37
SK Sturm Gra,5183,3,11,4,9,30,32,-2,37
LASK Linz,5183,4,9,6,9,30,27,3,33
Vienna,5183,5,7,6,11,25,37,-12,27
SC Rheindorf,5183,6,6,6,12,18,28,-10,24
Mattersburg,5183,7,5,6,13,28,45,-17,21
FC Salzburg,5184,1,16,6,2,51,20,31,54
SK Sturm Gra,5184,2,13,3,8,35,31,4,42
Rapid Vienna,5184,3,10,9,5,37,27,10,39
LASK Linz,5184,4,7,7,10,27,32,-5,28
Mattersburg,5184,5,6,7,11,34,43,-9,25
Vienna,5184,6,6,5,13,24,42,-18,23
SC Rheindorf,5184,7,4,7,13,19,32,-13,19
FC Salzburg,5185,1,13,8,3,42,22,20,47
SK Sturm Gra,5185,2,13,4,7,34,27,7,43
Rapid Vienna,5185,3,10,10,4,40,26,14,40
LASK Linz,5185,4,8,6,10,28,29,-1,30
Vienna,5185,5,7,6,11,24,37,-13,27
Mattersburg,5185,6,5,7,12,29,41,-12,22
SC Rheindorf,5185,7,4,7,13,20,35,-15,19
FC Salzburg,5186,1,14,7,3,46,21,25,49
SK Sturm Gra,5186,2,14,4,6,37,30,7,46
Rapid Vienna,5186,3,8,10,6,36,29,7,34
LASK Linz,5186,4,7,7,10,25,28,-3,28
Mattersburg,5186,5,6,8,10,30,39,-9,26
Vienna,5186,6,6,6,12,25,41,-16,24
SC Rheindorf,5186,7,4,8,12,17,28,-11,20
FC Salzburg,5187,1,13,7,4,41,22,19,46
SK Sturm Gra,5187,2,12,4,8,32,30,2,40
Rapid Vienna,5187,3,8,11,5,36,28,8,35
LASK Linz,5187,4,8,7,9,28,30,-2,31
Vienna,5187,5,8,5,11,28,37,-9,29
SC Rheindorf,5187,6,7,5,12,22,28,-6,26
Mattersburg,5187,7,6,5,13,30,42,-12,23
FC Salzburg,5188,1,15,7,2,46,16,30,52
SK Sturm Gra,5188,2,12,4,8,31,28,3,40
LASK Linz,5188,3,10,6,8,29,25,4,36
Rapid Vienna,5188,4,7,11,6,34,29,5,32
Mattersburg,5188,5,6,6,12,29,42,-13,24
Vienna,5188,6,6,5,13,23,42,-19,23
SC Rheindorf,5188,7,5,7,12,20,30,-10,22
FC Salzburg,5189,1,15,7,2,46,17,29,52
SK Sturm Gra,5189,2,14,4,6,35,26,9,46
LASK Linz,5189,3,9,6,9,31,30,1,33
Rapid Vienna,5189,4,7,10,7,33,32,1,31
Vienna,5189,5,7,5,12,26,39,-13,26
SC Rheindorf,5189,6,5,7,12,21,29,-8,22
Mattersburg,5189,7,5,5,14,29,48,-19,20
FC Salzburg,5190,1,15,7,2,45,17,28,52
SK Sturm Gra,5190,2,14,3,7,33,25,8,45
Rapid Vienna,5190,3,8,10,6,34,29,5,34
LASK Linz,5190,4,9,6,9,27,25,2,33
Vienna,5190,5,7,5,12,24,39,-15,26
Mattersburg,5190,6,6,6,12,29,39,-10,24
SC Rheindorf,5190,7,4,5,15,15,33,-18,17
FC Salzburg,5191,1,14,8,2,46,17,29,50
SK Sturm Gra,5191,2,12,5,7,33,32,1,41
Rapid Vienna,5191,3,8,10,6,34,28,6,34
Mattersburg,5191,4,8,6,10,36,40,-4,30
LASK Linz,5191,5,8,5,11,28,36,-8,29
Vienna,5191,6,6,6,12,24,40,-16,24
SC Rheindorf,5191,7,5,6,13,20,28,-8,21
FC Salzburg,5192,1,15,7,2,44,17,27,52
SK Sturm Gra,5192,2,11,5,8,30,28,2,38
Rapid Vienna,5192,3,9,9,6,35,28,7,36
LASK Linz,5192,4,8,7,9,28,28,0,31
SC Rheindorf,5192,5,7,5,12,21,28,-7,26
Vienna,5192,6,7,5,12,26,41,-15,26
Mattersburg,5192,7,5,6,13,30,44,-14,21
FC Salzburg,5193,1,16,6,2,46,17,29,54
SK Sturm Gra,5193,2,13,4,7,34,28,6,43
Rapid Vienna,5193,3,8,10,6,37,27,10,34
LASK Linz,5193,4,9,5,10,26,28,-2,32
Vienna,5193,5,7,5,12,30,41,-11,26
SC Rheindorf,5193,6,5,6,13,17,32,-15,21
Mattersburg,5193,7,5,6,13,28,45,-17,21
FC Salzburg,5194,1,16,6,2,45,17,28,54
SK Sturm Gra,5194,2,12,3,9,32,30,2,39
LASK Linz,5194,3,10,6,8,32,27,5,36
Rapid Vienna,5194,4,8,9,7,36,33,3,33
Mattersburg,5194,5,7,5,12,29,40,-11,26
Vienna,5194,6,6,5,13,23,39,-16,23
SC Rheindorf,5194,7,5,6,13,19,30,-11,21
FC Salzburg,5195,1,16,6,2,47,17,30,54
SK Sturm Gra,5195,2,12,4,8,32,29,3,40
LASK Linz,5195,3,11,5,8,33,29,4,38
Rapid Vienna,5195,4,7,11,6,34,28,6,32
Mattersburg,5195,5,6,6,12,34,43,-9,24
Vienna,5195,6,6,6,12,25,41,-16,24
SC Rheindorf,5195,7,4,6,14,16,34,-18,18
FC Salzburg,5196,1,14,7,3,45,18,27,49
SK Sturm Gra,5196,2,12,3,9,32,30,2,39
Rapid Vienna,5196,3,9,10,5,39,28,11,37
LASK Linz,5196,4,9,5,10,28,28,0,32
Vienna,5196,5,7,6,11,27,39,-12,27
SC Rheindorf,5196,6,7,5,12,19,28,-9,26
Mattersburg,5196,7,5,6,13,29,48,-19,21
FC Salzburg,5197,1,13,8,3,43,20,23,47
SK Sturm Gra,5197,2,14,3,7,34,27,7,45
Rapid Vienna,5197,3,10,9,5,42,28,14,39
LASK Linz,5197,4,7,6,11,26,32,-6,27
Mattersburg,5197,5,7,6,11,32,40,-8,27
Vienna,5197,6,6,6,12,25,40,-15,24
SC Rheindorf,5197,7,5,6,13,20,35,-15,21
FC Salzburg,5198,1,14,7,3,45,19,26,49
SK Sturm Gra,5198,2,13,5,6,34,28,6,44
Rapid Vienna,5198,3,8,11,5,38,30,8,35
LASK Linz,5198,4,7,6,11,24,28,-4,27
Vienna,5198,5,7,5,12,25,41,-16,26
Mattersburg,5198,6,6,7,11,28,38,-10,25
SC Rheindorf,5198,7,4,9,11,17,27,-10,21
FC Salzburg,5199,1,14,7,3,48,19,29,49
SK Sturm Gra,5199,2,14,3,7,35,28,7,45
Rapid Vienna,5199,3,8,10,6,35,27,8,34
LASK Linz,5199,4,9,6,9,29,28,1,33
Vienna,5199,5,7,5,12,27,42,-15,26
Mattersburg,5199,6,6,6,12,32,47,-15,24
SC Rheindorf,5199,7,5,5,14,17,32,-15,20
FC Salzburg,5200,1,16,6,2,48,17,31,54
SK Sturm Gra,5200,2,13,4,7,36,30,6,43
LASK Linz,5200,3,9,6,9,27,28,-1,33
Rapid Vienna,5200,4,7,9,8,34,31,3,30
Mattersburg,5200,5,7,6,11,33,43,-10,27
Vienna,5200,6,6,5,13,23,41,-18,23
SC Rheindorf,5200,7,5,6,13,19,30,-11,21
FC Salzburg,5201,1,13,7,4,41,20,21,46
SK Sturm Gra,5201,2,13,4,7,31,26,5,43
Rapid Vienna,5201,3,9,10,5,36,26,10,37
Mattersburg,5201,4,9,5,10,35,39,-4,32
LASK Linz,5201,5,8,6,10,26,30,-4,30
Vienna,5201,6,7,5,12,28,41,-13,26
SC Rheindorf,5201,7,4,5,15,17,32,-15,17
FC Salzburg,5202,1,16,6,2,47,18,29,54
SK Sturm Gra,5202,2,13,3,8,31,28,3,42
Rapid Vienna,5202,3,8,9,7,34,30,4,33
SC Rheindorf,5202,4,8,5,11,23,26,-3,29
LASK Linz,5202,5,7,5,12,24,33,-9,26
Mattersburg,5202,6,6,6,12,35,44,-9,24
Vienna,5202,7,6,6,12,27,42,-15,24
FC Salzburg,5203,1,15,7,2,44,16,28,52
SK Sturm Gra,5203,2,12,4,8,35,32,3,40
Rapid Vienna,5203,3,7,12,5,35,30,5,33
LASK Linz,5203,4,8,7,9,27,28,-1,31
SC Rheindorf,5203,5,7,6,11,23,28,-5,27
Vienna,5203,6,7,5,12,26,38,-12,26
Mattersburg,5203,7,5,5,14,27,45,-18,20
FC Salzburg,5204,1,14,7,3,44,19,25,49
SK Sturm Gra,5204,2,12,4,8,32,29,3,40
Rapid Vienna,5204,3,7,12,5,34,28,6,33
LASK Linz,5204,4,8,6,10,28,29,-1,30
Mattersburg,5204,5,7,6,11,32,40,-8,27
SC Rheindorf,5204,6,7,5,12,21,29,-8,26
Vienna,5204,7,6,6,12,24,41,-17,24
FC Salzburg,5205,1,14,7,3,44,19,25,49
SK Sturm Gra,5205,2,13,3,8,31,27,4,42
LASK Linz,5205,3,9,6,9,26,27,-1,33
Rapid Vienna,5205,4,7,11,6,33,29,4,32
Vienna,5205,5,8,5,11,28,38,-10,29
SC Rheindorf,5205,6,6,5,13,20,29,-9,23
Mattersburg,5205,7,6,5,13,29,42,-13,23
SK Sturm Gra,5206,1,15,3,6,36,25,11,48
FC Salzburg,5206,2,12,9,3,43,21,22,45
Rapid Vienna,5206,3,7,12,5,34,29,5,33
LASK Linz,5206,4,7,6,11,24,30,-6,27
Vienna,5206,5,7,6,11,26,39,-13,27
Mattersburg,5206,6,6,7,11,32,41,-9,25
SC Rheindorf,5206,7,5,7,12,18,28,-10,22
FC Salzburg,5207,1,15,7,2,42,15,27,52
SK Sturm Gra,5207,2,13,3,8,32,30,2,42
Rapid Vienna,5207,3,10,9,5,39,27,12,39
LASK Linz,5207,4,7,7,10,25,28,-3,28
Mattersburg,5207,5,6,6,12,28,39,-11,24
Vienna,5207,6,6,6,12,24,39,-15,24
SC Rheindorf,5207,7,5,6,13,20,32,-12,21
FC Salzburg,5208,1,14,6,4,45,21,24,48
SK Sturm Gra,5208,2,13,3,8,33,29,4,42
Rapid Vienna,5208,3,9,10,5,33,26,7,37
LASK Linz,5208,4,8,7,9,27,27,0,31
Vienna,5208,5,7,5,12,26,42,-16,26
SC Rheindorf,5208,6,6,6,12,23,28,-5,24
Mattersburg,5208,7,6,5,13,32,46,-14,23
FC Salzburg,5209,1,15,7,2,45,16,29,52
SK Sturm Gra,5209,2,13,5,6,35,27,8,44
Rapid Vienna,5209,3,8,10,6,38,31,7,34
LASK Linz,5209,4,8,5,11,27,35,-8,29
SC Rheindorf,5209,5,6,7,11,23,28,-5,25
Vienna,5209,6,6,6,12,25,41,-16,24
Mattersburg,5209,7,5,6,13,30,45,-15,21
FC Salzburg,5210,1,14,7,3,46,19,27,49
SK Sturm Gra,5210,2,12,3,9,32,31,1,39
Rapid Vienna,5210,3,9,10,5,38,28,10,37
LASK Linz,5210,4,7,6,11,25,31,-6,27
Vienna,5210,5,7,6,11,26,39,-13,27
SC Rheindorf,5210,6,7,5,12,23,29,-6,26
Mattersburg,5210,7,6,7,11,32,45,-13,25
FC Salzburg,5211,1,16,6,2,48,17,31,54
SK Sturm Gra,5211,2,13,3,8,32,29,3,42
LASK Linz,5211,3,9,6,9,27,27,0,33
Rapid Vienna,5211,4,7,9,8,32,31,1,30
Vienna,5211,5,7,5,12,27,40,-13,26
Mattersburg,5211,6,6,6,12,29,41,-12,24
SC Rheindorf,5211,7,6,5,13,20,30,-10,23
FC Salzburg,5212,1,15,6,3,50,20,30,51
SK Sturm Gra,5212,2,13,3,8,34,28,6,42
Rapid Vienna,5212,3,8,11,5,34,26,8,35
LASK Linz,5212,4,7,7,10,25,32,-7,28
Vienna,5212,5,7,5,12,29,40,-11,26
Mattersburg,5212,6,7,5,12,31,46,-15,26
SC Rheindorf,5212,7,5,7,12,18,29,-11,22
FC Salzburg,5213,1,15,7,2,43,15,28,52
SK Sturm Gra,5213,2,12,4,8,33,29,4,40
Rapid Vienna,5213,3,9,10,5,37,29,8,37
LASK Linz,5213,4,8,5,11,26,32,-6,29
Vienna,5213,5,7,5,12,26,39,-13,26
Mattersburg,5213,6,6,6,12,29,41,-12,24
SC Rheindorf,5213,7,5,7,12,20,29,-9,22
FC Salzburg,5214,1,15,6,3,47,20,27,51
Rapid Vienna,5214,2,10,10,4,38,27,11,40
SK Sturm Gra,5214,3,12,4,8,33,31,2,40
Mattersburg,5214,4,8,5,11,37,45,-8,29
LASK Linz,5214,5,7,7,10,27,30,-3,28
Vienna,5214,6,6,5,13,26,43,-17,23
SC Rheindorf,5214,7,4,7,13,22,34,-12,19
FC Salzburg,5215,1,14,7,3,45,17,28,49
SK Sturm Gra,5215,2,13,3,8,31,29,2,42
Rapid Vienna,5215,3,9,10,5,36,27,9,37
LASK Linz,5215,4,8,5,11,28,31,-3,29
Mattersburg,5215,5,7,7,10,31,39,-8,28
Vienna,5215,6,6,6,12,24,41,-17,24
SC Rheindorf,5215,7,5,6,13,21,32,-11,21
FC Salzburg,5216,1,14,7,3,46,19,27,49
Rapid Vienna,5216,2,9,11,4,40,28,12,38
SK Sturm Gra,5216,3,11,5,8,31,31,0,38
Vienna,5216,4,8,5,11,28,40,-12,29
LASK Linz,5216,5,7,7,10,27,30,-3,28
Mattersburg,5216,6,6,6,12,33,47,-14,24
SC Rheindorf,5216,7,5,7,12,20,30,-10,22
FC Salzburg,5217,1,14,6,4,42,17,25,48
SK Sturm Gra,5217,2,12,5,7,31,28,3,41
Rapid Vienna,5217,3,9,10,5,35,24,11,37
LASK Linz,5217,4,8,6,10,25,29,-4,30
Mattersburg,5217,5,7,6,11,34,40,-6,27
SC Rheindorf,5217,6,6,6,12,21,30,-9,24
Vienna,5217,7,6,5,13,24,44,-20,23
FC Salzburg,5218,1,14,8,2,45,17,28,50
SK Sturm Gra,5218,2,11,6,7,34,31,3,39
Rapid Vienna,5218,3,8,11,5,33,25,8,35
LASK Linz,5218,4,8,6,10,29,31,-2,30
Vienna,5218,5,6,7,11,25,39,-14,25
SC Rheindorf,5218,6,6,6,12,23,32,-9,24
Mattersburg,5218,7,6,6,12,29,43,-14,24
FC Salzburg,5219,1,15,6,3,50,17,33,51
Rapid Vienna,5219,2,11,9,4,39,25,14,42
SK Sturm Gra,5219,3,12,4,8,33,33,0,40
LASK Linz,5219,4,7,7,10,27,32,-5,28
Mattersburg,5219,5,7,6,11,33,45,-12,27
Vienna,5219,6,6,5,13,24,42,-18,23
SC Rheindorf,5219,7,4,7,13,20,32,-12,19
FC Salzburg,5220,1,15,7,2,47,19,28,52
SK Sturm Gra,5220,2,12,4,8,31,29,2,40
Rapid Vienna,5220,3,8,10,6,37,31,6,34
LASK Linz,5220,4,9,6,9,30,29,1,33
Vienna,5220,5,7,5,12,27,39,-12,26
Mattersburg,5220,6,5,7,12,30,45,-15,22
SC Rheindorf,5220,7,4,9,11,19,29,-10,21
FC Salzburg,5221,1,14,8,2,42,16,26,50
Rapid Vienna,5221,2,10,10,4,37,25,12,40
SK Sturm Gra,5221,3,12,3,9,33,30,3,39
LASK Linz,5221,4,9,6,9,27,27,0,33
Mattersburg,5221,5,7,6,11,34,40,-6,27
Vienna,5221,6,6,6,12,25,43,-18,24
SC Rheindorf,5221,7,4,5,15,17,34,-17,17
FC Salzburg,5222,1,16,6,2,45,16,29,54
SK Sturm Gra,5222,2,12,4,8,31,28,3,40
Rapid Vienna,5222,3,8,10,6,35,28,7,34
LASK Linz,5222,4,9,5,10,28,30,-2,32
SC Rheindorf,5222,5,7,5,12,22,28,-6,26
Vienna,5222,6,7,5,12,24,38,-14,26
Mattersburg,5222,7,5,5,14,29,46,-17,20
FC Salzburg,5223,1,13,7,4,46,20,26,46
SK Sturm Gra,5223,2,12,5,7,31,27,4,41
Rapid Vienna,5223,3,8,12,4,34,25,9,36
LASK Linz,5223,4,7,8,9,25,28,-3,29
Vienna,5223,5,7,6,11,29,41,-12,27
SC Rheindorf,5223,6,6,7,11,21,28,-7,25
Mattersburg,5223,7,5,7,12,30,47,-17,22
FC Salzburg,5224,1,14,6,4,44,21,23,48
SK Sturm Gra,5224,2,12,4,8,33,28,5,40
Rapid Vienna,5224,3,8,11,5,37,29,8,35
LASK Linz,5224,4,8,7,9,30,31,-1,31
Mattersburg,5224,5,7,6,11,33,41,-8,27
SC Rheindorf,5224,6,6,7,11,19,27,-8,25
Vienna,5224,7,6,5,13,25,44,-19,23
FC Salzburg,5225,1,15,6,3,47,18,29,51
SK Sturm Gra,5225,2,13,4,7,32,27,5,43
Rapid Vienna,5225,3,8,10,6,34,29,5,34
LASK Linz,5225,4,8,6,10,26,28,-2,30
Vienna,5225,5,7,5,12,27,41,-14,26
SC Rheindorf,5225,6,6,6,12,19,26,-7,24
Mattersburg,5225,7,6,5,13,27,43,-16,23
FC Salzburg,5226,1,14,6,4,46,20,26,48
SK Sturm Gra,5226,2,14,4,6,35,26,9,46
Rapid Vienna,5226,3,7,10,7,35,35,0,31
LASK Linz,5226,4,8,5,11,29,35,-6,29
Mattersburg,5226,5,7,6,11,32,40,-8,27
Vienna,5226,6,7,5,12,25,39,-14,26
SC Rheindorf,5226,7,6,6,12,22,29,-7,24
FC Salzburg,5227,1,13,6,5,41,22,19,45
SK Sturm Gra,5227,2,14,3,7,33,27,6,45
Rapid Vienna,5227,3,8,9,7,34,30,4,33
LASK Linz,5227,4,9,6,9,30,28,2,33
Vienna,5227,5,8,5,11,30,41,-11,29
SC Rheindorf,5227,6,6,6,12,20,29,-9,24
Mattersburg,5227,7,6,5,13,32,43,-11,23
FC Salzburg,5228,1,15,7,2,46,17,29,52
SK Sturm Gra,5228,2,13,4,7,33,28,5,43
Rapid Vienna,5228,3,7,12,5,33,27,6,33
LASK Linz,5228,4,8,6,10,30,31,-1,30
Mattersburg,5228,5,7,5,12,33,42,-9,26
Vienna,5228,6,6,6,12,26,42,-16,24
SC Rheindorf,5228,7,5,6,13,18,32,-14,21
FC Salzburg,5229,1,13,8,3,45,20,25,47
Rapid Vienna,5229,2,10,10,4,42,27,15,40
SK Sturm Gra,5229,3,11,4,9,32,31,1,37
Mattersburg,5229,4,8,5,11,33,39,-6,29
LASK Linz,5229,5,8,5,11,27,33,-6,29
SC Rheindorf,5229,6,7,5,12,21,31,-10,26
Vienna,5229,7,6,5,13,24,43,-19,23
FC Salzburg,5230,1,14,7,3,45,19,26,49
SK Sturm Gra,5230,2,15,3,6,36,27,9,48
Rapid Vienna,5230,3,9,9,6,35,26,9,36
Mattersburg,5230,4,7,7,10,35,42,-7,28
LASK Linz,5230,5,7,5,12,27,34,-7,26
Vienna,5230,6,6,6,12,24,41,-17,24
SC Rheindorf,5230,7,5,5,14,20,33,-13,20
FC Salzburg,5231,1,15,6,3,46,18,28,51
SK Sturm Gra,5231,2,13,3,8,33,28,5,42
Rapid Vienna,5231,3,8,10,6,36,31,5,34
LASK Linz,5231,4,8,6,10,28,30,-2,30
Mattersburg,5231,5,7,5,12,31,44,-13,26
Vienna,5231,6,7,5,12,27,40,-13,26
SC Rheindorf,5231,7,5,7,12,19,29,-10,22
FC Salzburg,5232,1,15,6,3,48,19,29,51
SK Sturm Gra,5232,2,12,5,7,36,29,7,41
Rapid Vienna,5232,3,7,10,7,32,32,0,31
LASK Linz,5232,4,8,6,10,28,31,-3,30
Mattersburg,5232,5,7,6,11,31,39,-8,27
Vienna,5232,6,7,5,12,24,42,-18,26
SC Rheindorf,5232,7,5,8,11,22,29,-7,23
FC Salzburg,5233,1,13,9,2,48,19,29,48
Rapid Vienna,5233,2,10,10,4,38,26,12,40
SK Sturm Gra,5233,3,11,5,8,31,29,2,38
LASK Linz,5233,4,9,6,9,27,27,0,33
Vienna,5233,5,7,6,11,26,39,-13,27
SC Rheindorf,5233,6,6,5,13,18,29,-11,23
Mattersburg,5233,7,5,5,14,29,48,-19,20
FC Salzburg,5234,1,15,7,2,45,16,29,52
SK Sturm Gra,5234,2,14,3,7,32,27,5,45
LASK Linz,5234,3,9,6,9,27,27,0,33
Rapid Vienna,5234,4,7,10,7,36,33,3,31
Mattersburg,5234,5,6,7,11,29,41,-12,25
Vienna,5234,6,6,5,13,23,39,-16,23
SC Rheindorf,5234,7,5,6,13,21,30,-9,21
FC Salzburg,5235,1,15,7,2,44,17,27,52
SK Sturm Gra,5235,2,11,4,9,32,34,-2,37
Rapid Vienna,5235,3,8,11,5,38,29,9,35
LASK Linz,5235,4,9,7,8,31,28,3,34
Mattersburg,5235,5,6,6,12,29,41,-12,24
SC Rheindorf,5235,6,5,8,11,21,30,-9,23
Vienna,5235,7,6,5,13,25,41,-16,23
FC Salzburg,5236,1,15,7,2,47,18,29,52
SK Sturm Gra,5236,2,11,5,8,31,31,0,38
Rapid Vienna,5236,3,8,10,6,34,28,6,34
LASK Linz,5236,4,8,6,10,29,32,-3,30
Mattersburg,5236,5,7,7,10,36,42,-6,28
SC Rheindorf,5236,6,5,8,11,18,27,-9,23
Vienna,5236,7,6,5,13,26,43,-17,23
FC Salzburg,5237,1,16,6,2,48,16,32,54
SK Sturm Gra,5237,2,12,5,7,32,27,5,41
Rapid Vienna,5237,3,8,11,5,40,28,12,35
LASK Linz,5237,4,8,8,8,28,27,1,32
Vienna,5237,5,7,5,12,26,42,-16,26
SC Rheindorf,5237,6,5,6,13,17,33,-16,21
Mattersburg,5237,7,5,5,14,28,46,-18,20
FC Salzburg,5238,1,15,7,2,46,16,30,52
SK Sturm Gra,5238,2,12,5,7,33,30,3,41
LASK Linz,5238,3,9,7,8,31,26,5,34
Rapid Vienna,5238,4,7,10,7,32,30,2,31
Mattersburg,5238,5,7,6,11,31,40,-9,27
Vienna,5238,6,6,5,13,23,41,-18,23
SC Rheindorf,5238,7,5,6,13,18,31,-13,21
FC Salzburg,5239,1,13,8,3,47,23,24,47
SK Sturm Gra,5239,2,12,4,8,33,31,2,40
Rapid Vienna,5239,3,9,10,5,38,29,9,37
LASK Linz,5239,4,9,5,10,30,31,-1,32
Mattersburg,5239,5,7,6,11,33,42,-9,27
Vienna,5239,6,6,7,11,27,41,-14,25
SC Rheindorf,5239,7,5,6,13,18,29,-11,21
FC Salzburg,5240,1,14,7,3,42,18,24,49
Rapid Vienna,5240,2,10,9,5,37,27,10,39
SK Sturm Gra,5240,3,11,4,9,29,28,1,37
LASK Linz,5240,4,8,6,10,25,28,-3,30
Mattersburg,5240,5,6,8,10,31,40,-9,26
SC Rheindorf,5240,6,6,6,12,22,30,-8,24
Vienna,5240,7,6,6,12,24,39,-15,24
FC Salzburg,5241,1,15,7,2,47,17,30,52
SK Sturm Gra,5241,2,13,3,8,33,30,3,42
Rapid Vienna,5241,3,8,11,5,33,26,7,35
LASK Linz,5241,4,7,7,10,24,29,-5,28
Mattersburg,5241,5,7,6,11,34,41,-7,27
SC Rheindorf,5241,6,6,5,13,20,31,-11,23
Vienna,5241,7,6,5,13,24,41,-17,23
FC Salzburg,5242,1,14,6,4,42,20,22,48
SK Sturm Gra,5242,2,13,5,6,33,27,6,44
Rapid Vienna,5242,3,8,11,5,38,29,9,35
Mattersburg,5242,4,8,5,11,34,41,-7,29
LASK Linz,5242,5,7,6,11,27,32,-5,27
Vienna,5242,6,7,5,12,28,40,-12,26
SC Rheindorf,5242,7,5,6,13,21,34,-13,21
FC Salzburg,5243,1,13,6,5,41,22,19,45
SK Sturm Gra,5243,2,13,5,6,34,28,6,44
Rapid Vienna,5243,3,10,10,4,41,26,15,40
LASK Linz,5243,4,9,6,9,31,31,0,33
Vienna,5243,5,7,5,12,25,39,-14,26
Mattersburg,5243,6,6,6,12,29,41,-12,24
SC Rheindorf,5243,7,4,6,14,17,31,-14,18
FC Salzburg,5244,1,15,7,2,46,18,28,52
SK Sturm Gra,5244,2,13,4,7,35,29,6,43
Rapid Vienna,5244,3,8,10,6,36,28,8,34
LASK Linz,5244,4,9,6,9,28,28,0,33
Mattersburg,5244,5,6,6,12,27,40,-13,24
Vienna,5244,6,6,6,12,24,39,-15,24
SC Rheindorf,5244,7,5,5,14,17,31,-14,20
FC Salzburg,5245,1,13,7,4,43,21,22,46
SK Sturm Gra,5245,2,12,4,8,33,33,0,40
Rapid Vienna,5245,3,9,10,5,35,27,8,37
LASK Linz,5245,4,9,5,10,29,28,1,32
Mattersburg,5245,5,8,6,10,30,37,-7,30
SC Rheindorf,5245,6,6,5,13,21,28,-7,23
Vienna,5245,7,6,5,13,24,41,-17,23
FC Salzburg,5246,1,14,7,3,45,18,27,49
Rapid Vienna,5246,2,9,10,5,37,28,9,37
SK Sturm Gra,5246,3,11,4,9,31,32,-1,37
LASK Linz,5246,4,8,7,9,29,30,-1,31
Vienna,5246,5,8,5,11,26,38,-12,29
SC Rheindorf,5246,6,7,5,12,20,28,-8,26
Mattersburg,5246,7,5,6,13,29,43,-14,21
SK Sturm Gra,5247,1,13,5,6,32,25,7,44
FC Salzburg,5247,2,12,7,5,42,22,20,43
Rapid Vienna,5247,3,9,11,4,36,26,10,38
LASK Linz,5247,4,7,6,11,26,33,-7,27
Mattersburg,5247,5,7,6,11,31,39,-8,27
Vienna,5247,6,7,6,11,27,40,-13,27
SC Rheindorf,5247,7,5,7,12,22,31,-9,22
FC Salzburg,5248,1,15,6,3,48,17,31,51
SK Sturm Gra,5248,2,11,5,8,30,31,-1,38
Rapid Vienna,5248,3,9,10,5,36,27,9,37
LASK Linz,5248,4,7,8,9,29,31,-2,29
Vienna,5248,5,8,5,11,27,38,-11,29
Mattersburg,5248,6,6,6,12,31,46,-15,24
SC Rheindorf,5248,7,5,6,13,21,32,-11,21
FC Salzburg,5249,1,15,7,2,45,18,27,52
SK Sturm Gra,5249,2,12,5,7,33,29,4,41
Rapid Vienna,5249,3,9,10,5,38,27,11,37
LASK Linz,5249,4,8,6,10,29,32,-3,30
Mattersburg,5249,5,7,6,11,32,42,-10,27
Vienna,5249,6,6,5,13,24,40,-16,23
SC Rheindorf,5249,7,5,5,14,18,31,-13,20
FC Salzburg,5250,1,14,6,4,45,21,24,48
SK Sturm Gra,5250,2,14,4,6,37,24,13,46
Rapid Vienna,5250,3,9,10,5,35,26,9,37
LASK Linz,5250,4,8,5,11,25,33,-8,29
Mattersburg,5250,5,7,5,12,33,45,-12,26
Vienna,5250,6,7,5,12,29,41,-12,26
SC Rheindorf,5250,7,5,5,14,18,32,-14,20
FC Salzburg,5251,1,15,6,3,49,20,29,51
SK Sturm Gra,5251,2,12,4,8,35,28,7,40
Rapid Vienna,5251,3,7,11,6,33,31,2,32
LASK Linz,5251,4,9,5,10,31,32,-1,32
Vienna,5251,5,8,5,11,29,40,-11,29
SC Rheindorf,5251,6,6,6,12,21,32,-11,24
Mattersburg,5251,7,6,5,13,30,45,-15,23
FC Salzburg,5252,1,14,7,3,44,20,24,49
SK Sturm Gra,5252,2,14,3,7,31,25,6,45
LASK Linz,5252,3,10,5,9,28,28,0,35
Rapid Vienna,5252,4,8,10,6,36,29,7,34
Mattersburg,5252,5,7,6,11,33,40,-7,27
Vienna,5252,6,6,5,13,23,40,-17,23
SC Rheindorf,5252,7,4,6,14,18,31,-13,18
FC Salzburg,5253,1,16,6,2,46,17,29,54
SK Sturm Gra,5253,2,13,3,8,35,29,6,42
Rapid Vienna,5253,3,8,9,7,36,33,3,33
LASK Linz,5253,4,9,5,10,30,31,-1,32
SC Rheindorf,5253,5,7,5,12,22,29,-7,26
Mattersburg,5253,6,6,5,13,30,43,-13,23
Vienna,5253,7,6,5,13,25,42,-17,23
FC Salzburg,5254,1,15,7,2,49,17,32,52
SK Sturm Gra,5254,2,12,4,8,32,29,3,40
Rapid Vienna,5254,3,8,12,4,38,29,9,36
LASK Linz,5254,4,9,5,10,29,29,0,32
Vienna,5254,5,7,5,12,27,43,-16,26
Mattersburg,5254,6,6,5,13,35,47,-12,23
SC Rheindorf,5254,7,5,6,13,19,35,-16,21
FC Salzburg,5255,1,15,6,3,46,18,28,51
SK Sturm Gra,5255,2,12,5,7,33,29,4,41
Rapid Vienna,5255,3,8,10,6,37,30,7,34
LASK Linz,5255,4,7,7,10,25,29,-4,28
Mattersburg,5255,5,7,5,12,31,42,-11,26
Vienna,5255,6,7,5,12,26,39,-13,26
SC Rheindorf,5255,7,6,6,12,20,31,-11,24
FC Salzburg,5256,1,14,8,2,40,15,25,50
SK Sturm Gra,5256,2,11,4,9,28,27,1,37
Rapid Vienna,5256,3,8,11,5,35,27,8,35
LASK Linz,5256,4,8,8,8,28,28,0,32
Mattersburg,5256,5,6,7,11,32,39,-7,25
Vienna,5256,6,6,7,11,24,38,-14,25
SC Rheindorf,5256,7,5,7,12,18,31,-13,22
FC Salzburg,5257,1,14,6,4,44,21,23,48
SK Sturm Gra,5257,2,12,4,8,34,30,4,40
LASK Linz,5257,3,10,5,9,32,26,6,35
Rapid Vienna,5257,4,7,10,7,34,32,2,31
Vienna,5257,5,8,5,11,27,39,-12,29
Mattersburg,5257,6,7,5,12,30,40,-10,26
SC Rheindorf,5257,7,6,5,13,19,32,-13,23
FC Salzburg,5258,1,13,8,3,41,18,23,47
Rapid Vienna,5258,2,10,10,4,38,23,15,40
SK Sturm Gra,5258,3,11,3,10,30,34,-4,36
LASK Linz,5258,4,9,6,9,31,30,1,33
Vienna,5258,5,7,6,11,25,38,-13,27
SC Rheindorf,5258,6,6,6,12,21,30,-9,24
Mattersburg,5258,7,6,5,13,29,42,-13,23
FC Salzburg,5259,1,12,9,3,40,18,22,45
SK Sturm Gra,5259,2,12,5,7,32,28,4,41
Rapid Vienna,5259,3,8,10,6,36,30,6,34
LASK Linz,5259,4,8,6,10,26,29,-3,30
Vienna,5259,5,8,5,11,27,39,-12,29
Mattersburg,5259,6,6,7,11,30,39,-9,25
SC Rheindorf,5259,7,5,8,11,22,30,-8,23
FC Salzburg,5260,1,15,6,3,43,17,26,51
SK Sturm Gra,5260,2,11,4,9,29,31,-2,37
Rapid Vienna,5260,3,8,9,7,35,30,5,33
LASK Linz,5260,4,9,6,9,29,30,-1,33
Mattersburg,5260,5,7,7,10,34,41,-7,28
SC Rheindorf,5260,6,6,7,11,24,29,-5,25
Vienna,5260,7,6,5,13,23,39,-16,23
FC Salzburg,5261,1,14,7,3,46,20,26,49
SK Sturm Gra,5261,2,13,4,7,36,31,5,43
Rapid Vienna,5261,3,9,9,6,37,30,7,36
LASK Linz,5261,4,9,7,8,31,28,3,34
Mattersburg,5261,5,6,6,12,34,45,-11,24
Vienna,5261,6,6,5,13,26,43,-17,23
SC Rheindorf,5261,7,5,6,13,20,33,-13,21
FC Salzburg,5262,1,14,7,3,41,17,24,49
SK Sturm Gra,5262,2,13,3,8,36,32,4,42
LASK Linz,5262,3,9,7,8,30,27,3,34
Rapid Vienna,5262,4,7,10,7,33,29,4,31
Vienna,5262,5,7,6,11,26,38,-12,27
Mattersburg,5262,6,7,5,12,31,41,-10,26
SC Rheindorf,5262,7,5,6,13,19,32,-13,21
FC Salzburg,5263,1,14,8,2,44,18,26,50
SK Sturm Gra,5263,2,12,4,8,32,31,1,40
Rapid Vienna,5263,3,8,11,5,36,27,9,35
LASK Linz,5263,4,9,6,9,31,29,2,33
SC Rheindorf,5263,5,6,6,12,22,31,-9,24
Vienna,5263,6,6,6,12,24,39,-15,24
Mattersburg,5263,7,5,7,12,28,42,-14,22
FC Salzburg,5264,1,14,7,3,43,19,24,49
SK Sturm Gra,5264,2,12,4,8,30,29,1,40
Rapid Vienna,5264,3,9,9,6,36,25,11,36
LASK Linz,5264,4,10,5,9,28,26,2,35
Vienna,5264,5,7,6,11,28,39,-11,27
Mattersburg,5264,6,6,5,13,31,45,-14,23
SC Rheindorf,5264,7,5,6,13,16,29,-13,21
FC Salzburg,5265,1,14,7,3,44,21,23,49
SK Sturm Gra,5265,2,13,4,7,33,27,6,43
Rapid Vienna,5265,3,9,10,5,39,26,13,37
LASK Linz,5265,4,8,7,9,27,27,0,31
Mattersburg,5265,5,7,5,12,30,38,-8,26
Vienna,5265,6,6,6,12,25,41,-16,24
SC Rheindorf,5265,7,5,5,14,17,35,-18,20
FC Salzburg,5266,1,14,7,3,44,18,26,49
SK Sturm Gra,5266,2,13,5,6,38,30,8,44
Rapid Vienna,5266,3,7,10,7,33,29,4,31
LASK Linz,5266,4,8,6,10,27,32,-5,30
Vienna,5266,5,8,5,11,29,39,-10,29
Mattersburg,5266,6,7,5,12,31,43,-12,26
SC Rheindorf,5266,7,5,6,13,18,29,-11,21
FC Salzburg,5267,1,15,6,3,49,23,26,51
SK Sturm Gra,5267,2,13,4,7,34,25,9,43
Rapid Vienna,5267,3,9,10,5,35,27,8,37
LASK Linz,5267,4,8,6,10,30,31,-1,30
Mattersburg,5267,5,6,6,12,34,47,-13,24
Vienna,5267,6,6,5,13,24,44,-20,23
SC Rheindorf,5267,7,5,7,12,18,27,-9,22
FC Salzburg,5268,1,14,7,3,43,18,25,49
SK Sturm Gra,5268,2,13,5,6,36,26,10,44
Rapid Vienna,5268,3,8,10,6,34,28,6,34
LASK Linz,5268,4,8,6,10,27,31,-4,30
Vienna,5268,5,7,5,12,28,44,-16,26
Mattersburg,5268,6,6,6,12,32,43,-11,24
SC Rheindorf,5268,7,5,7,12,19,29,-10,22
FC Salzburg,5269,1,16,6,2,45,16,29,54
SK Sturm Gra,5269,2,12,3,9,31,31,0,39
Rapid Vienna,5269,3,8,10,6,35,29,6,34
LASK Linz,5269,4,8,5,11,27,29,-2,29
Mattersburg,5269,5,8,5,11,31,40,-9,29
SC Rheindorf,5269,6,6,6,12,22,30,-8,24
Vienna,5269,7,6,5,13,24,40,-16,23
FC Salzburg,5270,1,14,7,3,42,17,25,49
Rapid Vienna,5270,2,10,10,4,42,28,14,40
SK Sturm Gra,5270,3,12,3,9,33,34,-1,39
LASK Linz,5270,4,8,6,10,26,30,-4,30
Vienna,5270,5,7,6,11,26,37,-11,27
Mattersburg,5270,6,6,5,13,29,43,-14,23
SC Rheindorf,5270,7,5,7,12,22,31,-9,22
FC Salzburg,5271,1,16,6,2,49,18,31,54
SK Sturm Gra,5271,2,13,3,8,38,34,4,42
Rapid Vienna,5271,3,7,11,6,32,28,4,32
LASK Linz,5271,4,8,7,9,28,30,-2,31
SC Rheindorf,5271,5,6,6,12,20,28,-8,24
Mattersburg,5271,6,6,6,12,30,42,-12,24
Vienna,5271,7,6,5,13,23,40,-17,23
FC Salzburg,5272,1,14,8,2,43,18,25,50
SK Sturm Gra,5272,2,12,5,7,32,28,4,41
Rapid Vienna,5272,3,8,10,6,36,26,10,34
LASK Linz,5272,4,9,6,9,27,28,-1,33
Vienna,5272,5,7,6,11,27,40,-13,27
Mattersburg,5272,6,6,7,11,33,42,-9,25
SC Rheindorf,5272,7,4,6,14,18,34,-16,18
FC Salzburg,5273,1,14,8,2,45,16,29,50
SK Sturm Gra,5273,2,12,3,9,32,30,2,39
Rapid Vienna,5273,3,9,10,5,35,27,8,37
LASK Linz,5273,4,8,7,9,26,28,-2,31
Vienna,5273,5,6,7,11,25,39,-14,25
SC Rheindorf,5273,6,6,6,12,20,29,-9,24
Mattersburg,5273,7,5,7,12,28,42,-14,22
FC Salzburg,5274,1,14,8,2,46,18,28,50
SK Sturm Gra,5274,2,13,5,6,32,26,6,44
Rapid Vienna,5274,3,7,11,6,32,28,4,32
LASK Linz,5274,4,8,7,9,25,26,-1,31
Mattersburg,5274,5,6,7,11,32,41,-9,25
Vienna,5274,6,6,6,12,23,39,-16,24
SC Rheindorf,5274,7,5,6,13,19,31,-12,21
FC Salzburg,5275,1,14,6,4,43,19,24,48
SK Sturm Gra,5275,2,14,3,7,35,28,7,45
Rapid Vienna,5275,3,10,10,4,38,25,13,40
Mattersburg,5275,4,7,6,11,30,41,-11,27
LASK Linz,5275,5,7,5,12,26,33,-7,26
Vienna,5275,6,6,5,13,25,41,-16,23
SC Rheindorf,5275,7,5,7,12,19,29,-10,22
FC Salzburg,5276,1,15,6,3,49,19,30,51
SK Sturm Gra,5276,2,14,3,7,35,29,6,45
Rapid Vienna,5276,3,9,10,5,38,26,12,37
Mattersburg,5276,4,8,5,11,34,39,-5,29
LASK Linz,5276,5,7,5,12,24,37,-13,26
Vienna,5276,6,6,5,13,23,41,-18,23
SC Rheindorf,5276,7,5,6,13,19,31,-12,21
FC Salzburg,5277,1,12,8,4,43,23,20,44
SK Sturm Gra,5277,2,13,4,7,34,29,5,43
Rapid Vienna,5277,3,9,11,4,36,25,11,38
LASK Linz,5277,4,8,6,10,26,30,-4,30
Vienna,5277,5,8,5,11,28,38,-10,29
SC Rheindorf,5277,6,5,7,12,19,28,-9,22
Mattersburg,5277,7,5,7,12,31,44,-13,22
FC Salzburg,5278,1,16,6,2,50,16,34,54
SK Sturm Gra,5278,2,12,3,9,31,33,-2,39
Rapid Vienna,5278,3,8,9,7,35,30,5,33
LASK Linz,5278,4,9,6,9,30,29,1,33
Mattersburg,5278,5,7,6,11,31,41,-10,27
Vienna,5278,6,6,5,13,23,41,-18,23
SC Rheindorf,5278,7,5,7,12,21,31,-10,22
FC Salzburg,5279,1,16,6,2,48,19,29,54
SK Sturm Gra,5279,2,13,3,8,32,30,2,42
Rapid Vienna,5279,3,8,11,5,35,27,8,35
LASK Linz,5279,4,9,6,9,30,29,1,33
Vienna,5279,5,7,5,12,24,38,-14,26
Mattersburg,5279,6,6,5,13,34,43,-9,23
SC Rheindorf,5279,7,4,6,14,17,34,-17,18
FC Salzburg,5280,1,13,8,3,43,19,24,47
SK Sturm Gra,5280,2,12,5,7,31,27,4,41
Rapid Vienna,5280,3,10,9,5,39,26,13,39
LASK Linz,5280,4,9,5,10,29,31,-2,32
Mattersburg,5280,5,7,5,12,32,43,-11,26
Vienna,5280,6,6,6,12,24,41,-17,24
SC Rheindorf,5280,7,5,6,13,17,28,-11,21
FC Salzburg,5281,1,13,8,3,43,21,22,47
SK Sturm Gra,5281,2,13,4,7,37,31,6,43
Rapid Vienna,5281,3,8,12,4,38,29,9,36
LASK Linz,5281,4,8,7,9,28,30,-2,31
Vienna,5281,5,7,6,11,27,39,-12,27
Mattersburg,5281,6,6,7,11,30,40,-10,25
SC Rheindorf,5281,7,4,6,14,24,37,-13,18
FC Salzburg,5282,1,16,6,2,47,18,29,54
SK Sturm Gra,5282,2,14,3,7,38,28,10,45
Rapid Vienna,5282,3,8,9,7,38,32,6,33
LASK Linz,5282,4,9,5,10,27,30,-3,32
Mattersburg,5282,5,6,6,12,32,43,-11,24
Vienna,5282,6,6,6,12,25,42,-17,24
SC Rheindorf,5282,7,5,5,14,20,34,-14,20
FC Salzburg,5283,1,14,7,3,43,18,25,49
SK Sturm Gra,5283,2,13,4,7,31,26,5,43
Rapid Vienna,5283,3,8,11,5,34,26,8,35
LASK Linz,5283,4,9,5,10,29,30,-1,32
Vienna,5283,5,8,5,11,28,38,-10,29
SC Rheindorf,5283,6,5,6,13,20,30,-10,21
Mattersburg,5283,7,5,6,13,30,47,-17,21
FC Salzburg,5284,1,14,7,3,46,22,24,49
SK Sturm Gra,5284,2,13,4,7,36,29,7,43
Rapid Vienna,5284,3,9,10,5,38,27,11,37
LASK Linz,5284,4,8,5,11,29,33,-4,29
Mattersburg,5284,5,7,6,11,31,40,-9,27
Vienna,5284,6,6,6,12,23,39,-16,24
SC Rheindorf,5284,7,5,6,13,19,32,-13,21
FC Salzburg,5285,1,13,7,4,40,18,22,46
SK Sturm Gra,5285,2,12,6,6,34,29,5,42
Rapid Vienna,5285,3,9,10,5,37,28,9,37
Vienna,5285,4,8,5,11,29,40,-11,29
LASK Linz,5285,5,7,5,12,24,30,-6,26
Mattersburg,5285,6,7,5,12,32,43,-11,26
SC Rheindorf,5285,7,6,6,12,23,31,-8,24
FC Salzburg,5286,1,15,6,3,47,18,29,51
SK Sturm Gra,5286,2,13,3,8,33,30,3,42
Rapid Vienna,5286,3,8,9,7,35,30,5,33
LASK Linz,5286,4,9,6,9,32,31,1,33
Vienna,5286,5,7,6,11,26,39,-13,27
Mattersburg,5286,6,6,7,11,30,42,-12,25
SC Rheindorf,5286,7,5,5,14,18,31,-13,20
FC Salzburg,5287,1,14,7,3,43,17,26,49
SK Sturm Gra,5287,2,12,4,8,31,30,1,40
LASK Linz,5287,3,10,5,9,29,25,4,35
Rapid Vienna,5287,4,7,11,6,32,26,6,32
Vienna,5287,5,7,5,12,26,41,-15,26
Mattersburg,5287,6,6,6,12,30,43,-13,24
SC Rheindorf,5287,7,5,8,11,18,27,-9,23
FC Salzburg,5288,1,13,7,4,42,19,23,46
Rapid Vienna,5288,2,11,9,4,38,26,12,42
SK Sturm Gra,5288,3,12,3,9,35,34,1,39
LASK Linz,5288,4,8,6,10,31,33,-2,30
Vienna,5288,5,7,6,11,24,37,-13,27
Mattersburg,5288,6,6,8,10,34,40,-6,26
SC Rheindorf,5288,7,5,5,14,23,38,-15,20
FC Salzburg,5289,1,16,6,2,45,16,29,54
SK Sturm Gra,5289,2,13,4,7,34,28,6,43
Rapid Vienna,5289,3,9,9,6,36,27,9,36
LASK Linz,5289,4,8,5,11,25,32,-7,29
Vienna,5289,5,7,5,12,25,38,-13,26
Mattersburg,5289,6,6,5,13,29,44,-15,23
SC Rheindorf,5289,7,5,6,13,19,28,-9,21
FC Salzburg,5290,1,15,7,2,43,17,26,52
SK Sturm Gra,5290,2,12,4,8,34,31,3,40
Rapid Vienna,5290,3,7,11,6,34,28,6,32
LASK Linz,5290,4,9,5,10,28,31,-3,32
Vienna,5290,5,7,5,12,27,40,-13,26
SC Rheindorf,5290,6,6,6,12,21,30,-9,24
Mattersburg,5290,7,6,6,12,31,41,-10,24
FC Salzburg,5291,1,13,9,2,44,19,25,48
SK Sturm Gra,5291,2,12,5,7,33,29,4,41
Rapid Vienna,5291,3,8,11,5,35,29,6,35
LASK Linz,5291,4,9,6,9,30,27,3,33
Mattersburg,5291,5,6,6,12,34,44,-10,24
Vienna,5291,6,6,6,12,23,41,-18,24
SC Rheindorf,5291,7,5,7,12,21,31,-10,22
FC Salzburg,5292,1,13,8,3,44,19,25,47
SK Sturm Gra,5292,2,12,3,9,33,35,-2,39
Rapid Vienna,5292,3,9,10,5,36,26,10,37
LASK Linz,5292,4,8,6,10,27,29,-2,30
Mattersburg,5292,5,7,7,10,33,40,-7,28
Vienna,5292,6,6,6,12,24,39,-15,24
SC Rheindorf,5292,7,5,8,11,21,30,-9,23
FC Salzburg,5293,1,16,6,2,45,16,29,54
Rapid Vienna,5293,2,10,9,5,38,27,11,39
SK Sturm Gra,5293,3,11,4,9,30,30,0,37
LASK Linz,5293,4,10,5,9,30,28,2,35
Vienna,5293,5,7,5,12,25,39,-14,26
Mattersburg,5293,6,5,6,13,28,42,-14,21
SC Rheindorf,5293,7,4,7,13,18,32,-14,19
FC Salzburg,5294,1,14,8,2,45,19,26,50
SK Sturm Gra,5294,2,12,5,7,31,27,4,41
LASK Linz,5294,3,10,5,9,31,29,2,35
Rapid Vienna,5294,4,7,10,7,34,31,3,31
Vienna,5294,5,7,5,12,26,39,-13,26
SC Rheindorf,5294,6,6,6,12,20,29,-9,24
Mattersburg,5294,7,5,7,12,31,44,-13,22
FC Salzburg,5295,1,14,8,2,43,18,25,50
SK Sturm Gra,5295,2,13,3,8,31,27,4,42
Rapid Vienna,5295,3,7,12,5,37,30,7,33
LASK Linz,5295,4,8,6,10,27,28,-1,30
SC Rheindorf,5295,5,7,6,11,23,30,-7,27
Vienna,5295,6,7,6,11,25,37,-12,27
Mattersburg,5295,7,5,5,14,29,45,-16,20
FC Salzburg,5296,1,15,7,2,47,19,28,52
Rapid Vienna,5296,2,9,10,5,37,28,9,37
SK Sturm Gra,5296,3,11,3,10,32,33,-1,36
LASK Linz,5296,4,8,6,10,30,34,-4,30
Mattersburg,5296,5,6,7,11,31,39,-8,25
SC Rheindorf,5296,6,6,7,11,20,28,-8,25
Vienna,5296,7,6,6,12,24,40,-16,24
FC Salzburg,5297,1,13,7,4,42,20,22,46
SK Sturm Gra,5297,2,14,3,7,36,28,8,45
Rapid Vienna,5297,3,10,9,5,38,28,10,39
Mattersburg,5297,4,9,5,10,33,38,-5,32
LASK Linz,5297,5,7,6,11,24,30,-6,27
Vienna,5297,6,6,6,12,23,38,-15,24
SC Rheindorf,5297,7,4,6,14,18,32,-14,18
FC Salzburg,5298,1,16,6,2,50,17,33,54
SK Sturm Gra,5298,2,13,3,8,32,28,4,42
Rapid Vienna,5298,3,9,9,6,35,29,6,36
LASK Linz,5298,4,8,5,11,30,32,-2,29
Mattersburg,5298,5,8,5,11,35,43,-8,29
Vienna,5298,6,6,5,13,24,42,-18,23
SC Rheindorf,5298,7,5,5,14,19,34,-15,20
FC Salzburg,5299,1,16,6,2,51,22,29,54
SK Sturm Gra,5299,2,12,3,9,33,32,1,39
Rapid Vienna,5299,3,8,11,5,33,25,8,35
LASK Linz,5299,4,7,6,11,24,28,-4,27
Mattersburg,5299,5,7,5,12,31,43,-12,26
Vienna,5299,6,7,5,12,29,42,-13,26
SC Rheindorf,5299,7,6,6,12,20,29,-9,24
FC Salzburg,5300,1,14,7,3,45,18,27,49
SK Sturm Gra,5300,2,12,3,9,34,34,0,39
Rapid Vienna,5300,3,9,9,6,37,29,8,36
LASK Linz,5300,4,9,6,9,26,28,-2,33
SC Rheindorf,5300,5,7,6,11,23,28,-5,27
Vienna,5300,6,7,6,11,27,38,-11,27
Mattersburg,5300,7,5,5,14,28,45,-17,20
FC Salzburg,5301,1,15,7,2,46,17,29,52
SK Sturm Gra,5301,2,14,3,7,34,27,7,45
Rapid Vienna,5301,3,8,9,7,33,30,3,33
LASK Linz,5301,4,8,7,9,27,27,0,31
Mattersburg,5301,5,5,9,10,30,40,-10,24
Vienna,5301,6,6,6,12,24,39,-15,24
SC Rheindorf,5301,7,4,7,13,18,32,-14,19
FC Salzburg,5302,1,15,6,3,50,21,29,51
SK Sturm Gra,5302,2,12,4,8,33,31,2,40
Rapid Vienna,5302,3,9,11,4,36,25,11,38
LASK Linz,5302,4,7,6,11,25,31,-6,27
Vienna,5302,5,7,5,12,27,42,-15,26
SC Rheindorf,5302,6,6,7,11,19,27,-8,25
Mattersburg,5302,7,6,5,13,30,43,-13,23
FC Salzburg,5303,1,14,7,3,48,20,28,49
Rapid Vienna,5303,2,11,9,4,40,26,14,42
SK Sturm Gra,5303,3,12,4,8,33,32,1,40
LASK Linz,5303,4,8,5,11,27,30,-3,29
Mattersburg,5303,5,8,5,11,36,45,-9,29
Vienna,5303,6,6,5,13,25,42,-17,23
SC Rheindorf,5303,7,5,5,14,20,34,-14,20
FC Salzburg,5304,1,15,7,2,48,17,31,52
SK Sturm Gra,5304,2,12,5,7,33,28,5,41
Rapid Vienna,5304,3,7,11,6,35,30,5,32
LASK Linz,5304,4,9,5,10,28,29,-1,32
Mattersburg,5304,5,7,6,11,31,42,-11,27
Vienna,5304,6,6,5,13,24,42,-18,23
SC Rheindorf,5304,7,5,7,12,19,30,-11,22
FC Salzburg,5305,1,12,8,4,42,22,20,44
SK Sturm Gra,5305,2,13,4,7,36,31,5,43
Rapid Vienna,5305,3,9,10,5,40,30,10,37
LASK Linz,5305,4,8,7,9,28,28,0,31
Mattersburg,5305,5,7,7,10,32,39,-7,28
Vienna,5305,6,6,6,12,23,39,-16,24
SC Rheindorf,5305,7,5,6,13,18,30,-12,21
FC Salzburg,5306,1,14,6,4,42,21,21,48
SK Sturm Gra,5306,2,13,3,8,35,31,4,42
Rapid Vienna,5306,3,9,10,5,37,28,9,37
LASK Linz,5306,4,7,7,10,26,31,-5,28
Vienna,5306,5,7,6,11,28,39,-11,27
SC Rheindorf,5306,6,7,5,12,20,26,-6,26
Mattersburg,5306,7,5,7,12,27,39,-12,22
FC Salzburg,5307,1,15,7,2,45,17,28,52
SK Sturm Gra,5307,2,12,4,8,33,30,3,40
Rapid Vienna,5307,3,8,11,5,39,31,8,35
LASK Linz,5307,4,9,6,9,31,30,1,33
Vienna,5307,5,7,5,12,25,41,-16,26
Mattersburg,5307,6,6,5,13,30,44,-14,23
SC Rheindorf,5307,7,5,6,13,20,30,-10,21
FC Salzburg,5308,1,14,8,2,43,17,26,50
SK Sturm Gra,5308,2,13,5,6,34,28,6,44
Rapid Vienna,5308,3,8,11,5,34,27,7,35
LASK Linz,5308,4,8,6,10,27,29,-2,30
Mattersburg,5308,5,6,8,10,32,39,-7,26
Vienna,5308,6,6,6,12,25,40,-15,24
SC Rheindorf,5308,7,4,6,14,17,32,-15,18
FC Salzburg,5309,1,14,7,3,43,18,25,49
SK Sturm Gra,5309,2,13,3,8,34,30,4,42
Rapid Vienna,5309,3,8,10,6,36,28,8,34
LASK Linz,5309,4,9,5,10,29,29,0,32
Vienna,5309,5,7,6,11,26,39,-13,27
Mattersburg,5309,6,6,6,12,30,41,-11,24
SC Rheindorf,5309,7,6,5,13,18,31,-13,23
FC Salzburg,5310,1,15,6,3,47,18,29,51
SK Sturm Gra,5310,2,12,5,7,34,30,4,41
Rapid Vienna,5310,3,8,10,6,36,31,5,34
LASK Linz,5310,4,9,6,9,28,29,-1,33
Mattersburg,5310,5,7,5,12,33,41,-8,26
SC Rheindorf,5310,6,6,5,13,21,32,-11,23
Vienna,5310,7,6,5,13,23,41,-18,23
FC Salzburg,5311,1,14,8,2,48,18,30,50
SK Sturm Gra,5311,2,13,4,7,35,28,7,43
Rapid Vienna,5311,3,8,12,4,37,27,10,36
LASK Linz,5311,4,7,6,11,26,33,-7,27
Mattersburg,5311,5,7,6,11,31,44,-13,27
Vienna,5311,6,6,6,12,25,40,-15,24
SC Rheindorf,5311,7,4,8,12,18,30,-12,20
FC Salzburg,5312,1,14,6,4,43,22,21,48
SK Sturm Gra,5312,2,11,5,8,30,29,1,38
Rapid Vienna,5312,3,9,10,5,37,27,10,37
LASK Linz,5312,4,10,6,8,29,26,3,36
Vienna,5312,5,7,6,11,28,39,-11,27
Mattersburg,5312,6,5,7,12,32,44,-12,22
SC Rheindorf,5312,7,4,8,12,19,31,-12,20
FC Salzburg,5313,1,14,7,3,42,16,26,49
Rapid Vienna,5313,2,9,10,5,35,25,10,37
SK Sturm Gra,5313,3,11,3,10,29,32,-3,36
LASK Linz,5313,4,10,5,9,30,25,5,35
Mattersburg,5313,5,7,7,10,30,38,-8,28
Vienna,5313,6,6,6,12,24,41,-17,24
SC Rheindorf,5313,7,5,6,13,19,32,-13,21
FC Salzburg,5314,1,16,6,2,53,17,36,54
SK Sturm Gra,5314,2,13,3,8,31,31,0,42
Rapid Vienna,5314,3,7,10,7,33,31,2,31
LASK Linz,5314,4,8,6,10,28,30,-2,30
SC Rheindorf,5314,5,8,5,11,24,26,-2,29
Vienna,5314,6,7,5,12,25,42,-17,26
Mattersburg,5314,7,5,5,14,29,46,-17,20
FC Salzburg,5315,1,14,7,3,45,20,25,49
SK Sturm Gra,5315,2,14,3,7,36,29,7,45
Rapid Vienna,5315,3,9,9,6,39,27,12,36
LASK Linz,5315,4,10,5,9,35,35,0,35
Vienna,5315,5,7,5,12,25,40,-15,26
Mattersburg,5315,6,5,6,13,30,44,-14,21
SC Rheindorf,5315,7,5,5,14,21,36,-15,20
FC Salzburg,5316,1,15,6,3,47,19,28,51
SK Sturm Gra,5316,2,11,5,8,29,29,0,38
Rapid Vienna,5316,3,9,10,5,37,25,12,37
LASK Linz,5316,4,9,6,9,27,27,0,33
Mattersburg,5316,5,7,5,12,32,43,-11,26
Vienna,5316,6,7,5,12,27,40,-13,26
SC Rheindorf,5316,7,5,5,14,16,32,-16,20
FC Salzburg,5317,1,15,6,3,49,18,31,51
SK Sturm Gra,5317,2,12,3,9,30,31,-1,39
Rapid Vienna,5317,3,9,10,5,37,30,7,37
LASK Linz,5317,4,8,5,11,26,28,-2,29
Mattersburg,5317,5,7,6,11,31,41,-10,27
Vienna,5317,6,7,6,11,26,39,-13,27
SC Rheindorf,5317,7,5,6,13,20,32,-12,21
FC Salzburg,5318,1,15,6,3,46,16,30,51
SK Sturm Gra,5318,2,12,5,7,31,31,0,41
Rapid Vienna,5318,3,9,9,6,39,28,11,36
Mattersburg,5318,4,9,5,10,34,36,-2,32
LASK Linz,5318,5,8,6,10,28,33,-5,30
Vienna,5318,6,6,5,13,23,40,-17,23
SC Rheindorf,5318,7,4,6,14,17,34,-17,18
FC Salzburg,5319,1,14,8,2,46,16,30,50
SK Sturm Gra,5319,2,13,4,7,36,27,9,43
Rapid Vienna,5319,3,8,10,6,37,34,3,34
LASK Linz,5319,4,8,7,9,29,29,0,31
Vienna,5319,5,7,6,11,25,37,-12,27
Mattersburg,5319,6,6,6,12,28,45,-17,24
SC Rheindorf,5319,7,4,7,13,19,32,-13,19
FC Salzburg,5320,1,14,7,3,47,22,25,49
Rapid Vienna,5320,2,9,10,5,39,28,11,37
SK Sturm Gra,5320,3,11,4,9,29,30,-1,37
LASK Linz,5320,4,9,5,10,30,30,0,32
SC Rheindorf,5320,5,6,7,11,20,28,-8,25
Mattersburg,5320,6,6,7,11,32,43,-11,25
Vienna,5320,7,6,6,12,25,41,-16,24
FC Salzburg,5321,1,13,6,5,40,19,21,45
SK Sturm Gra,5321,2,13,4,7,33,26,7,43
Rapid Vienna,5321,3,10,9,5,38,29,9,39
LASK Linz,5321,4,8,6,10,27,29,-2,30
Vienna,5321,5,8,5,11,26,37,-11,29
Mattersburg,5321,6,7,6,11,33,42,-9,27
SC Rheindorf,5321,7,4,6,14,19,34,-15,18
FC Salzburg,5322,1,15,7,2,48,18,30,52
SK Sturm Gra,5322,2,11,4,9,30,31,-1,37
Rapid Vienna,5322,3,8,12,4,37,28,9,36
LASK Linz,5322,4,9,6,9,28,27,1,33
Vienna,5322,5,7,5,12,27,41,-14,26
SC Rheindorf,5322,6,6,6,12,20,29,-9,24
Mattersburg,5322,7,5,6,13,31,47,-16,21
FC Salzburg,5323,1,15,7,2,44,17,27,52
SK Sturm Gra,5323,2,12,5,7,33,26,7,41
Rapid Vienna,5323,3,7,11,6,33,27,6,32
LASK Linz,5323,4,8,6,10,26,32,-6,30
SC Rheindorf,5323,5,6,7,11,18,25,-7,25
Vienna,5323,6,6,7,11,24,38,-14,25
Mattersburg,5323,7,5,7,12,28,41,-13,22
FC Salzburg,5324,1,14,7,3,46,22,24,49
SK Sturm Gra,5324,2,13,5,6,38,29,9,44
Rapid Vienna,5324,3,8,10,6,37,32,5,34
LASK Linz,5324,4,8,6,10,29,31,-2,30
Vienna,5324,5,7,5,12,25,40,-15,26
SC Rheindorf,5324,6,6,6,12,20,29,-9,24
Mattersburg,5324,7,5,7,12,28,40,-12,22
FC Salzburg,5325,1,16,6,2,47,18,29,54
SK Sturm Gra,5325,2,12,4,8,30,27,3,40
Rapid Vienna,5325,3,9,10,5,35,25,10,37
LASK Linz,5325,4,7,7,10,25,29,-4,28
SC Rheindorf,5325,5,6,6,12,19,28,-9,24
Mattersburg,5325,6,6,6,12,31,43,-12,24
Vienna,5325,7,6,5,13,25,42,-17,23
SK Sturm Gra,5326,1,15,3,6,36,27,9,48
FC Salzburg,5326,2,13,8,3,42,18,24,47
Rapid Vienna,5326,3,8,10,6,38,29,9,34
LASK Linz,5326,4,8,6,10,27,30,-3,30
Vienna,5326,5,7,6,11,26,38,-12,27
Mattersburg,5326,6,6,6,12,32,42,-10,24
SC Rheindorf,5326,7,5,5,14,19,36,-17,20
FC Salzburg,5327,1,15,6,3,44,18,26,51
SK Sturm Gra,5327,2,11,5,8,31,29,2,38
Rapid Vienna,5327,3,9,10,5,36,27,9,37
LASK Linz,5327,4,9,7,8,27,26,1,34
Mattersburg,5327,5,7,5,12,29,40,-11,26
Vienna,5327,6,6,5,13,24,40,-16,23
SC Rheindorf,5327,7,5,6,13,16,27,-11,21
FC Salzburg,5328,1,16,6,2,55,19,36,54
SK Sturm Gra,5328,2,11,4,9,29,34,-5,37
Rapid Vienna,5328,3,8,10,6,36,29,7,34
LASK Linz,5328,4,8,7,9,28,29,-1,31
Vienna,5328,5,7,5,12,27,43,-16,26
Mattersburg,5328,6,6,6,12,30,42,-12,24
SC Rheindorf,5328,7,5,8,11,19,28,-9,23
FC Salzburg,5329,1,14,7,3,42,18,24,49
SK Sturm Gra,5329,2,13,4,7,32,28,4,43
LASK Linz,5329,3,10,5,9,34,30,4,35
Rapid Vienna,5329,4,8,10,6,36,29,7,34
Vienna,5329,5,7,5,12,24,38,-14,26
Mattersburg,5329,6,6,5,13,29,42,-13,23
SC Rheindorf,5329,7,5,6,13,19,31,-12,21
FC Salzburg,5330,1,15,6,3,45,17,28,51
Rapid Vienna,5330,2,11,9,4,36,23,13,42
SK Sturm Gra,5330,3,13,3,8,33,29,4,42
LASK Linz,5330,4,8,6,10,27,30,-3,30
Vienna,5330,5,6,6,12,25,42,-17,24
Mattersburg,5330,6,5,7,12,31,44,-13,22
SC Rheindorf,5330,7,4,7,13,19,31,-12,19
FC Salzburg,5331,1,14,7,3,42,17,25,49
SK Sturm Gra,5331,2,12,5,7,30,26,4,41
Rapid Vienna,5331,3,7,11,6,32,27,5,32
LASK Linz,5331,4,8,6,10,25,27,-2,30
Vienna,5331,5,8,5,11,27,38,-11,29
Mattersburg,5331,6,6,6,12,30,42,-12,24
SC Rheindorf,5331,7,5,8,11,18,27,-9,23
FC Salzburg,5332,1,15,6,3,50,23,27,51
SK Sturm Gra,5332,2,14,3,7,36,29,7,45
LASK Linz,5332,3,10,5,9,32,27,5,35
Rapid Vienna,5332,4,8,9,7,40,33,7,33
Mattersburg,5332,5,7,5,12,32,46,-14,26
Vienna,5332,6,6,5,13,25,42,-17,23
SC Rheindorf,5332,7,5,5,14,16,31,-15,20
FC Salzburg,5333,1,14,6,4,48,20,28,48
SK Sturm Gra,5333,2,12,3,9,31,28,3,39
LASK Linz,5333,3,11,5,8,31,25,6,38
Rapid Vienna,5333,4,9,9,6,34,29,5,36
Vienna,5333,5,8,5,11,30,39,-9,29
Mattersburg,5333,6,6,5,13,31,48,-17,23
SC Rheindorf,5333,7,5,5,14,18,34,-16,20
FC Salzburg,5334,1,15,7,2,47,18,29,52
Rapid Vienna,5334,2,10,9,5,37,27,10,39
SK Sturm Gra,5334,3,12,3,9,29,30,-1,39
LASK Linz,5334,4,10,5,9,28,25,3,35
Mattersburg,5334,5,6,6,12,28,40,-12,24
Vienna,5334,6,6,6,12,25,40,-15,24
SC Rheindorf,5334,7,4,6,14,16,30,-14,18
FC Salzburg,5335,1,14,7,3,46,20,26,49
SK Sturm Gra,5335,2,14,3,7,39,29,10,45
Rapid Vienna,5335,3,9,9,6,35,28,7,36
LASK Linz,5335,4,9,5,10,29,34,-5,32
Mattersburg,5335,5,6,7,11,30,39,-9,25
Vienna,5335,6,6,6,12,23,40,-17,24
SC Rheindorf,5335,7,5,5,14,19,31,-12,20
FC Salzburg,5336,1,15,7,2,44,15,29,52
SK Sturm Gra,5336,2,12,3,9,30,29,1,39
Rapid Vienna,5336,3,7,11,6,32,26,6,32
LASK Linz,5336,4,8,6,10,25,30,-5,30
SC Rheindorf,5336,5,7,6,11,20,27,-7,27
Mattersburg,5336,6,6,7,11,32,41,-9,25
Vienna,5336,7,6,6,12,24,39,-15,24
FC Salzburg,5337,1,15,7,2,44,16,28,52
SK Sturm Gra,5337,2,12,5,7,30,26,4,41
LASK Linz,5337,3,8,7,9,26,27,-1,31
Rapid Vienna,5337,4,7,9,8,32,29,3,30
SC Rheindorf,5337,5,7,6,11,20,26,-6,27
Mattersburg,5337,6,7,5,12,28,39,-11,26
Vienna,5337,7,6,5,13,23,40,-17,23
FC Salzburg,5338,1,14,7,3,46,18,28,49
SK Sturm Gra,5338,2,13,4,7,33,28,5,43
LASK Linz,5338,3,10,5,9,31,30,1,35
Rapid Vienna,5338,4,7,10,7,34,32,2,31
Vienna,5338,5,7,6,11,28,40,-12,27
SC Rheindorf,5338,6,6,6,12,22,30,-8,24
Mattersburg,5338,7,5,6,13,32,48,-16,21
FC Salzburg,5339,1,14,7,3,46,20,26,49
SK Sturm Gra,5339,2,12,4,8,32,31,1,40
Rapid Vienna,5339,3,8,10,6,34,27,7,34
LASK Linz,5339,4,9,6,9,28,30,-2,33
Vienna,5339,5,7,5,12,24,38,-14,26
Mattersburg,5339,6,6,6,12,33,42,-9,24
SC Rheindorf,5339,7,6,6,12,19,28,-9,24
FC Salzburg,5340,1,15,7,2,45,16,29,52
SK Sturm Gra,5340,2,11,4,9,28,28,0,37
Rapid Vienna,5340,3,9,9,6,33,27,6,36
LASK Linz,5340,4,10,5,9,28,26,2,35
Vienna,5340,5,6,7,11,25,39,-14,25
SC Rheindorf,5340,6,5,7,12,17,27,-10,22
Mattersburg,5340,7,5,7,12,29,42,-13,22
FC Salzburg,5341,1,15,7,2,49,20,29,52
SK Sturm Gra,5341,2,11,5,8,30,29,1,38
Rapid Vienna,5341,3,9,10,5,39,29,10,37
LASK Linz,5341,4,8,6,10,25,28,-3,30
Mattersburg,5341,5,7,5,12,30,43,-13,26
Vienna,5341,6,6,6,12,26,41,-15,24
SC Rheindorf,5341,7,5,7,12,19,28,-9,22
FC Salzburg,5342,1,15,6,3,46,16,30,51
SK Sturm Gra,5342,2,12,3,9,33,31,2,39
Rapid Vienna,5342,3,8,11,5,35,27,8,35
LASK Linz,5342,4,9,6,9,31,31,0,33
Mattersburg,5342,5,8,5,11,34,43,-9,29
Vienna,5342,6,6,5,13,23,42,-19,23
SC Rheindorf,5342,7,5,6,13,20,32,-12,21
FC Salzburg,5343,1,13,7,4,42,20,22,46
SK Sturm Gra,5343,2,14,4,6,38,26,12,46
Rapid Vienna,5343,3,8,9,7,34,30,4,33
LASK Linz,5343,4,9,6,9,32,33,-1,33
Vienna,5343,5,8,5,11,27,39,-12,29
Mattersburg,5343,6,6,6,12,31,43,-12,24
SC Rheindorf,5343,7,4,7,13,16,29,-13,19
FC Salzburg,5344,1,15,7,2,44,18,26,52
SK Sturm Gra,5344,2,13,4,7,32,27,5,43
Rapid Vienna,5344,3,8,10,6,33,26,7,34
LASK Linz,5344,4,8,6,10,28,32,-4,30
Mattersburg,5344,5,6,7,11,32,40,-8,25
Vienna,5344,6,6,6,12,26,41,-15,24
SC Rheindorf,5344,7,5,6,13,22,33,-11,21
FC Salzburg,5345,1,14,7,3,49,18,31,49
SK Sturm Gra,5345,2,13,4,7,33,27,6,43
Rapid Vienna,5345,3,10,10,4,41,25,16,40
LASK Linz,5345,4,7,7,10,23,27,-4,28
Vienna,5345,5,7,5,12,26,46,-20,26
Mattersburg,5345,6,6,7,11,34,41,-7,25
SC Rheindorf,5345,7,4,6,14,16,38,-22,18
FC Salzburg,5346,1,14,7,3,44,20,24,49
SK Sturm Gra,5346,2,12,6,6,32,26,6,42
Rapid Vienna,5346,3,7,11,6,36,30,6,32
LASK Linz,5346,4,8,7,9,25,27,-2,31
Mattersburg,5346,5,7,6,11,33,40,-7,27
Vienna,5346,6,7,5,12,28,42,-14,26
SC Rheindorf,5346,7,4,8,12,16,29,-13,20
FC Salzburg,5347,1,14,7,3,45,18,27,49
SK Sturm Gra,5347,2,11,4,9,30,34,-4,37
Rapid Vienna,5347,3,8,9,7,34,30,4,33
LASK Linz,5347,4,9,6,9,27,26,1,33
SC Rheindorf,5347,5,8,5,11,22,26,-4,29
Vienna,5347,6,7,5,12,25,38,-13,26
Mattersburg,5347,7,6,6,12,29,40,-11,24
FC Salzburg,5348,1,15,7,2,43,16,27,52
SK Sturm Gra,5348,2,13,4,7,34,28,6,43
Rapid Vienna,5348,3,8,11,5,40,29,11,35
LASK Linz,5348,4,9,5,10,29,29,0,32
Vienna,5348,5,7,5,12,25,39,-14,26
SC Rheindorf,5348,6,6,5,13,19,35,-16,23
Mattersburg,5348,7,5,5,14,29,43,-14,20
FC Salzburg,5349,1,14,6,4,43,19,24,48
SK Sturm Gra,5349,2,12,4,8,32,29,3,40
Rapid Vienna,5349,3,10,9,5,38,29,9,39
LASK Linz,5349,4,7,7,10,24,27,-3,28
Mattersburg,5349,5,7,5,12,29,42,-13,26
Vienna,5349,6,7,5,12,26,40,-14,26
SC Rheindorf,5349,7,6,6,12,22,28,-6,24
FC Salzburg,5350,1,15,6,3,48,20,28,51
SK Sturm Gra,5350,2,12,4,8,34,32,2,40
Rapid Vienna,5350,3,8,12,4,36,27,9,36
LASK Linz,5350,4,9,6,9,29,29,0,33
Mattersburg,5350,5,7,5,12,30,43,-13,26
Vienna,5350,6,6,5,13,23,39,-16,23
SC Rheindorf,5350,7,5,6,13,18,28,-10,21
FC Salzburg,5351,1,14,8,2,46,16,30,50
SK Sturm Gra,5351,2,13,5,6,35,27,8,44
Rapid Vienna,5351,3,8,11,5,37,29,8,35
LASK Linz,5351,4,8,6,10,28,30,-2,30
Mattersburg,5351,5,6,7,11,30,41,-11,25
Vienna,5351,6,6,6,12,24,43,-19,24
SC Rheindorf,5351,7,4,7,13,18,32,-14,19
FC Salzburg,5352,1,15,7,2,45,16,29,52
SK Sturm Gra,5352,2,11,5,8,30,30,0,38
Rapid Vienna,5352,3,8,11,5,36,26,10,35
LASK Linz,5352,4,7,9,8,26,27,-1,30
Vienna,5352,5,7,6,11,27,40,-13,27
SC Rheindorf,5352,6,6,6,12,19,28,-9,24
Mattersburg,5352,7,5,6,13,29,45,-16,21
FC Salzburg,5353,1,14,6,4,45,22,23,48
SK Sturm Gra,5353,2,14,3,7,35,29,6,45
Rapid Vienna,5353,3,10,9,5,39,25,14,39
LASK Linz,5353,4,9,5,10,30,30,0,32
SC Rheindorf,5353,5,6,5,13,19,30,-11,23
Mattersburg,5353,6,6,5,13,32,47,-15,23
Vienna,5353,7,6,5,13,25,42,-17,23
FC Salzburg,5354,1,14,8,2,45,18,27,50
SK Sturm Gra,5354,2,12,5,7,30,26,4,41
Rapid Vienna,5354,3,8,11,5,34,27,7,35
LASK Linz,5354,4,8,7,9,24,25,-1,31
Vienna,5354,5,6,7,11,25,39,-14,25
Mattersburg,5354,6,6,6,12,28,40,-12,24
SC Rheindorf,5354,7,5,6,13,17,28,-11,21
FC Salzburg,5355,1,14,6,4,45,20,25,48
Rapid Vienna,5355,2,11,9,4,38,23,15,42
SK Sturm Gra,5355,3,11,4,9,32,33,-1,37
LASK Linz,5355,4,8,7,9,28,31,-3,31
Mattersburg,5355,5,7,7,10,35,41,-6,28
Vienna,5355,6,6,6,12,23,39,-16,24
SC Rheindorf,5355,7,5,5,14,20,34,-14,20
FC Salzburg,5356,1,16,6,2,46,16,30,54
SK Sturm Gra,5356,2,14,3,7,33,27,6,45
Rapid Vienna,5356,3,8,10,6,37,31,6,34
LASK Linz,5356,4,8,5,11,27,30,-3,29
Mattersburg,5356,5,6,6,12,30,42,-12,24
Vienna,5356,6,6,6,12,26,41,-15,24
SC Rheindorf,5356,7,5,6,13,18,30,-12,21
FC Salzburg,5357,1,15,6,3,48,19,29,51
Rapid Vienna,5357,2,10,10,4,36,25,11,40
SK Sturm Gra,5357,3,12,3,9,31,31,0,39
LASK Linz,5357,4,8,6,10,28,29,-1,30
Mattersburg,5357,5,6,7,11,32,43,-11,25
Vienna,5357,6,6,6,12,26,42,-16,24
SC Rheindorf,5357,7,5,6,13,19,31,-12,21
FC Salzburg,5358,1,14,7,3,45,20,25,49
SK Sturm Gra,5358,2,14,4,6,36,28,8,46
Rapid Vienna,5358,3,8,11,5,37,29,8,35
LASK Linz,5358,4,7,5,12,25,34,-9,26
Mattersburg,5358,5,7,5,12,30,41,-11,26
Vienna,5358,6,7,5,12,27,41,-14,26
SC Rheindorf,5358,7,5,7,12,21,28,-7,22
FC Salzburg,5359,1,15,6,3,48,19,29,51
SK Sturm Gra,5359,2,12,4,8,31,29,2,40
Rapid Vienna,5359,3,9,9,6,35,30,5,36
LASK Linz,5359,4,10,5,9,30,29,1,35
Mattersburg,5359,5,7,5,12,31,41,-10,26
Vienna,5359,6,6,5,13,25,42,-17,23
SC Rheindorf,5359,7,5,6,13,19,29,-10,21
FC Salzburg,5360,1,15,7,2,51,17,34,52
SK Sturm Gra,5360,2,12,4,8,32,33,-1,40
Rapid Vienna,5360,3,8,10,6,37,28,9,34
LASK Linz,5360,4,8,6,10,26,33,-7,30
Vienna,5360,5,6,7,11,25,39,-14,25
SC Rheindorf,5360,6,6,6,12,20,30,-10,24
Mattersburg,5360,7,6,6,12,30,41,-11,24
FC Salzburg,5361,1,16,6,2,50,18,32,54
SK Sturm Gra,5361,2,12,5,7,39,33,6,41
Rapid Vienna,5361,3,7,12,5,35,30,5,33
LASK Linz,5361,4,8,7,9,28,31,-3,31
Mattersburg,5361,5,7,5,12,34,46,-12,26
Vienna,5361,6,6,5,13,25,41,-16,23
SC Rheindorf,5361,7,4,8,12,21,33,-12,20
FC Salzburg,5362,1,15,7,2,48,18,30,52
SK Sturm Gra,5362,2,13,4,7,35,28,7,43
Rapid Vienna,5362,3,8,11,5,33,25,8,35
LASK Linz,5362,4,9,5,10,28,31,-3,32
Vienna,5362,5,7,5,12,26,40,-14,26
Mattersburg,5362,6,6,5,13,32,47,-15,23
SC Rheindorf,5362,7,5,5,14,18,31,-13,20
FC Salzburg,5363,1,13,7,4,41,21,20,46
SK Sturm Gra,5363,2,14,3,7,35,27,8,45
LASK Linz,5363,3,9,6,9,29,29,0,33
Rapid Vienna,5363,4,7,10,7,36,33,3,31
SC Rheindorf,5363,5,7,5,12,21,28,-7,26
Vienna,5363,6,7,5,12,26,38,-12,26
Mattersburg,5363,7,6,6,12,29,41,-12,24
FC Salzburg,5364,1,16,6,2,46,15,31,54
SK Sturm Gra,5364,2,12,4,8,36,33,3,40
Rapid Vienna,5364,3,8,10,6,34,27,7,34
LASK Linz,5364,4,8,7,9,27,28,-1,31
Mattersburg,5364,5,7,5,12,29,42,-13,26
Vienna,5364,6,7,5,12,24,38,-14,26
SC Rheindorf,5364,7,5,5,14,18,31,-13,20
FC Salzburg,5365,1,14,7,3,47,20,27,49
SK Sturm Gra,5365,2,12,3,9,32,30,2,39
Rapid Vienna,5365,3,9,11,4,39,28,11,38
LASK Linz,5365,4,8,7,9,26,28,-2,31
Vienna,5365,5,7,5,12,25,43,-18,26
Mattersburg,5365,6,6,7,11,31,40,-9,25
SC Rheindorf,5365,7,4,8,12,18,29,-11,20
FC Salzburg,5366,1,14,7,3,44,18,26,49
SK Sturm Gra,5366,2,12,5,7,32,28,4,41
Rapid Vienna,5366,3,9,9,6,37,29,8,36
LASK Linz,5366,4,8,6,10,27,29,-2,30
Mattersburg,5366,5,8,5,11,33,42,-9,29
Vienna,5366,6,7,5,12,25,40,-15,26
SC Rheindorf,5366,7,5,5,14,19,31,-12,20
FC Salzburg,5367,1,14,8,2,44,18,26,50
SK Sturm Gra,5367,2,11,6,7,32,29,3,39
LASK Linz,5367,3,10,6,8,31,28,3,36
Rapid Vienna,5367,4,7,11,6,34,28,6,32
Mattersburg,5367,5,6,7,11,32,43,-11,25
Vienna,5367,6,6,6,12,25,41,-16,24
SC Rheindorf,5367,7,4,8,12,16,27,-11,20
FC Salzburg,5368,1,15,7,2,46,17,29,52
SK Sturm Gra,5368,2,13,4,7,31,27,4,43
Rapid Vienna,5368,3,8,11,5,33,25,8,35
LASK Linz,5368,4,8,7,9,27,28,-1,31
Vienna,5368,5,7,5,12,25,40,-15,26
Mattersburg,5368,6,6,5,13,32,45,-13,23
SC Rheindorf,5368,7,5,5,14,18,30,-12,20
FC Salzburg,5369,1,13,7,4,45,22,23,46
SK Sturm Gra,5369,2,13,4,7,34,28,6,43
Rapid Vienna,5369,3,7,12,5,34,27,7,33
LASK Linz,5369,4,8,6,10,27,31,-4,30
Mattersburg,5369,5,7,7,10,32,39,-7,28
SC Rheindorf,5369,6,6,7,11,21,28,-7,25
Vienna,5369,7,6,5,13,26,44,-18,23
FC Salzburg,5370,1,14,7,3,47,20,27,49
SK Sturm Gra,5370,2,12,5,7,36,30,6,41
Rapid Vienna,5370,3,8,10,6,33,30,3,34
LASK Linz,5370,4,7,9,8,26,27,-1,30
Vienna,5370,5,7,5,12,27,40,-13,26
Mattersburg,5370,6,6,7,11,30,43,-13,25
SC Rheindorf,5370,7,5,7,12,19,28,-9,22
FC Salzburg,5371,1,13,7,4,43,19,24,46
Rapid Vienna,5371,2,11,9,4,40,26,14,42
SK Sturm Gra,5371,3,12,3,9,29,32,-3,39
LASK Linz,5371,4,8,5,11,24,30,-6,29
Vienna,5371,5,8,5,11,27,39,-12,29
Mattersburg,5371,6,6,6,12,30,39,-9,24
SC Rheindorf,5371,7,6,5,13,23,31,-8,23
FC Salzburg,5372,1,13,8,3,42,20,22,47
SK Sturm Gra,5372,2,13,4,7,32,28,4,43
Rapid Vienna,5372,3,10,9,5,38,26,12,39
LASK Linz,5372,4,7,7,10,26,29,-3,28
Vienna,5372,5,7,6,11,29,39,-10,27
SC Rheindorf,5372,6,5,7,12,18,28,-10,22
Mattersburg,5372,7,5,7,12,29,44,-15,22
FC Salzburg,5373,1,16,6,2,48,19,29,54
SK Sturm Gra,5373,2,11,5,8,33,31,2,38
Rapid Vienna,5373,3,9,9,6,36,28,8,36
LASK Linz,5373,4,8,6,10,26,29,-3,30
Mattersburg,5373,5,7,5,12,30,39,-9,26
Vienna,5373,6,7,5,12,26,41,-15,26
SC Rheindorf,5373,7,5,6,13,18,30,-12,21
FC Salzburg,5374,1,15,6,3,46,16,30,51
SK Sturm Gra,5374,2,13,3,8,35,32,3,42
LASK Linz,5374,3,9,6,9,28,29,-1,33
Rapid Vienna,5374,4,7,10,7,35,30,5,31
Vienna,5374,5,7,5,12,24,38,-14,26
SC Rheindorf,5374,6,6,6,12,19,27,-8,24
Mattersburg,5374,7,6,6,12,27,42,-15,24
FC Salzburg,5375,1,15,7,2,42,16,26,52
SK Sturm Gra,5375,2,12,4,8,31,30,1,40
Rapid Vienna,5375,3,8,10,6,36,28,8,34
LASK Linz,5375,4,8,6,10,26,27,-1,30
Vienna,5375,5,7,5,12,26,38,-12,26
SC Rheindorf,5375,6,6,6,12,19,28,-9,24
Mattersburg,5375,7,6,6,12,28,41,-13,24
FC Salzburg,5376,1,15,7,2,48,19,29,52
SK Sturm Gra,5376,2,13,4,7,34,27,7,43
Rapid Vienna,5376,3,9,11,4,35,24,11,38
LASK Linz,5376,4,7,7,10,26,31,-5,28
Vienna,5376,5,7,5,12,27,42,-15,26
Mattersburg,5376,6,5,7,12,28,42,-14,22
SC Rheindorf,5376,7,4,7,13,18,31,-13,19
FC Salzburg,5377,1,15,6,3,47,19,28,51
SK Sturm Gra,5377,2,14,4,6,35,27,8,46
Rapid Vienna,5377,3,8,10,6,37,31,6,34
LASK Linz,5377,4,7,8,9,27,30,-3,29
Vienna,5377,5,7,5,12,27,41,-14,26
Mattersburg,5377,6,6,5,13,32,45,-13,23
SC Rheindorf,5377,7,5,6,13,21,33,-12,21
FC Salzburg,5378,1,15,7,2,48,17,31,52
SK Sturm Gra,5378,2,12,4,8,34,30,4,40
Rapid Vienna,5378,3,9,10,5,40,31,9,37
LASK Linz,5378,4,10,5,9,32,31,1,35
Vienna,5378,5,7,5,12,24,39,-15,26
Mattersburg,5378,6,5,6,13,30,46,-16,21
SC Rheindorf,5378,7,4,7,13,18,32,-14,19
FC Salzburg,5379,1,13,7,4,40,21,19,46
SK Sturm Gra,5379,2,14,4,6,35,26,9,46
Rapid Vienna,5379,3,7,10,7,32,27,5,31
LASK Linz,5379,4,8,6,10,24,27,-3,30
Vienna,5379,5,8,5,11,29,37,-8,29
Mattersburg,5379,6,8,5,11,30,39,-9,29
SC Rheindorf,5379,7,4,7,13,16,29,-13,19
SK Sturm Gra,5380,1,14,4,6,35,27,8,46
FC Salzburg,5380,2,13,6,5,41,21,20,45
Rapid Vienna,5380,3,8,10,6,37,30,7,34
Mattersburg,5380,4,9,5,10,31,37,-6,32
LASK Linz,5380,5,8,5,11,26,29,-3,29
Vienna,5380,6,6,5,13,24,40,-16,23
SC Rheindorf,5380,7,5,7,12,20,30,-10,22
FC Salzburg,5381,1,15,6,3,46,17,29,51
SK Sturm Gra,5381,2,11,4,9,30,31,-1,37
Rapid Vienna,5381,3,9,9,6,36,31,5,36
LASK Linz,5381,4,8,6,10,29,30,-1,30
Vienna,5381,5,8,5,11,27,38,-11,29
Mattersburg,5381,6,7,5,12,32,43,-11,26
SC Rheindorf,5381,7,6,5,13,19,29,-10,23
FC Salzburg,5382,1,16,6,2,46,16,30,54
SK Sturm Gra,5382,2,11,5,8,28,27,1,38
LASK Linz,5382,3,9,6,9,29,27,2,33
Rapid Vienna,5382,4,7,10,7,31,28,3,31
Mattersburg,5382,5,6,7,11,29,40,-11,25
Vienna,5382,6,6,6,12,24,40,-16,24
SC Rheindorf,5382,7,5,8,11,18,27,-9,23
FC Salzburg,5383,1,15,6,3,47,17,30,51
SK Sturm Gra,5383,2,12,5,7,33,28,5,41
Rapid Vienna,5383,3,10,10,4,37,25,12,40
LASK Linz,5383,4,9,6,9,28,28,0,33
Vienna,5383,5,7,5,12,24,40,-16,26
Mattersburg,5383,6,6,5,13,31,42,-11,23
SC Rheindorf,5383,7,4,5,15,15,35,-20,17
FC Salzburg,5384,1,13,8,3,45,21,24,47
SK Sturm Gra,5384,2,13,4,7,34,28,6,43
Rapid Vienna,5384,3,8,11,5,37,28,9,35
LASK Linz,5384,4,8,7,9,26,28,-2,31
Vienna,5384,5,8,5,11,28,38,-10,29
Mattersburg,5384,6,7,5,12,34,46,-12,26
SC Rheindorf,5384,7,4,6,14,19,34,-15,18
FC Salzburg,5385,1,16,6,2,48,16,32,54
SK Sturm Gra,5385,2,13,4,7,31,26,5,43
Rapid Vienna,5385,3,7,11,6,34,29,5,32
LASK Linz,5385,4,8,6,10,28,30,-2,30
Mattersburg,5385,5,6,7,11,31,43,-12,25
Vienna,5385,6,6,6,12,25,42,-17,24
SC Rheindorf,5385,7,5,6,13,17,28,-11,21
FC Salzburg,5386,1,14,7,3,41,17,24,49
SK Sturm Gra,5386,2,12,4,8,30,27,3,40
Rapid Vienna,5386,3,7,11,6,32,26,6,32
LASK Linz,5386,4,8,6,10,26,29,-3,30
Mattersburg,5386,5,7,7,10,31,37,-6,28
Vienna,5386,6,7,6,11,26,39,-13,27
SC Rheindorf,5386,7,5,7,12,18,29,-11,22
FC Salzburg,5387,1,14,7,3,43,17,26,49
SK Sturm Gra,5387,2,12,4,8,33,31,2,40
Rapid Vienna,5387,3,8,10,6,35,28,7,34
LASK Linz,5387,4,8,6,10,26,28,-2,30
SC Rheindorf,5387,5,8,5,11,25,28,-3,29
Vienna,5387,6,8,5,11,25,37,-12,29
Mattersburg,5387,7,5,5,14,28,46,-18,20
FC Salzburg,5388,1,16,6,2,47,17,30,54
SK Sturm Gra,5388,2,14,3,7,35,27,8,45
Rapid Vienna,5388,3,9,9,6,36,29,7,36
LASK Linz,5388,4,7,6,11,24,30,-6,27
Mattersburg,5388,5,7,5,12,29,40,-11,26
Vienna,5388,6,6,5,13,24,40,-16,23
SC Rheindorf,5388,7,5,6,13,17,29,-12,21
FC Salzburg,5389,1,13,8,3,40,17,23,47
SK Sturm Gra,5389,2,13,4,7,33,29,4,43
LASK Linz,5389,3,10,5,9,31,31,0,35
Rapid Vienna,5389,4,8,10,6,36,29,7,34
Vienna,5389,5,7,5,12,27,40,-13,26
SC Rheindorf,5389,6,6,6,12,21,28,-7,24
Mattersburg,5389,7,5,6,13,30,44,-14,21
FC Salzburg,5390,1,14,7,3,45,18,27,49
SK Sturm Gra,5390,2,13,3,8,32,29,3,42
Rapid Vienna,5390,3,9,10,5,36,27,9,37
LASK Linz,5390,4,8,6,10,25,26,-1,30
Vienna,5390,5,7,6,11,27,40,-13,27
SC Rheindorf,5390,6,6,6,12,19,28,-9,24
Mattersburg,5390,7,5,6,13,28,44,-16,21
FC Salzburg,5391,1,13,8,3,44,20,24,47
Rapid Vienna,5391,2,11,9,4,40,26,14,42
SK Sturm Gra,5391,3,12,3,9,33,31,2,39
LASK Linz,5391,4,9,5,10,31,31,0,32
Vienna,5391,5,7,6,11,29,39,-10,27
Mattersburg,5391,6,5,7,12,29,45,-16,22
SC Rheindorf,5391,7,5,6,13,18,32,-14,21
FC Salzburg,5392,1,13,7,4,43,21,22,46
SK Sturm Gra,5392,2,13,5,6,36,30,6,44
Rapid Vienna,5392,3,8,11,5,37,27,10,35
LASK Linz,5392,4,8,7,9,26,28,-2,31
Mattersburg,5392,5,8,5,11,33,41,-8,29
Vienna,5392,6,6,6,12,24,39,-15,24
SC Rheindorf,5392,7,4,7,13,17,30,-13,19
FC Salzburg,5393,1,14,7,3,45,18,27,49
SK Sturm Gra,5393,2,12,4,8,33,31,2,40
Rapid Vienna,5393,3,7,11,6,32,27,5,32
LASK Linz,5393,4,8,7,9,29,30,-1,31
SC Rheindorf,5393,5,7,5,12,20,28,-8,26
Mattersburg,5393,6,7,5,12,30,41,-11,26
Vienna,5393,7,7,5,12,24,38,-14,26
FC Salzburg,5394,1,16,6,2,50,18,32,54
SK Sturm Gra,5394,2,14,3,7,35,27,8,45
LASK Linz,5394,3,9,6,9,28,29,-1,33
Rapid Vienna,5394,4,7,10,7,36,31,5,31
Mattersburg,5394,5,6,6,12,31,44,-13,24
Vienna,5394,6,6,5,13,23,42,-19,23
SC Rheindorf,5394,7,5,6,13,20,32,-12,21
FC Salzburg,5395,1,16,6,2,49,16,33,54
SK Sturm Gra,5395,2,12,3,9,31,29,2,39
LASK Linz,5395,3,11,5,8,32,26,6,38
Rapid Vienna,5395,4,7,9,8,33,37,-4,30
SC Rheindorf,5395,5,7,5,12,26,31,-5,26
Mattersburg,5395,6,6,5,13,31,45,-14,23
Vienna,5395,7,6,5,13,24,42,-18,23
FC Salzburg,5396,1,16,6,2,49,18,31,54
SK Sturm Gra,5396,2,12,4,8,34,32,2,40
Rapid Vienna,5396,3,9,9,6,37,28,9,36
LASK Linz,5396,4,8,6,10,25,28,-3,30
Mattersburg,5396,5,8,5,11,32,41,-9,29
Vienna,5396,6,6,5,13,26,42,-16,23
SC Rheindorf,5396,7,5,5,14,18,32,-14,20
FC Salzburg,5397,1,13,8,3,44,21,23,47
SK Sturm Gra,5397,2,12,4,8,31,28,3,40
Rapid Vienna,5397,3,9,10,5,37,27,10,37
LASK Linz,5397,4,10,5,9,29,30,-1,35
Mattersburg,5397,5,7,6,11,37,44,-7,27
Vienna,5397,6,7,6,11,28,39,-11,27
SC Rheindorf,5397,7,4,5,15,17,34,-17,17
FC Salzburg,5398,1,14,8,2,46,20,26,50
SK Sturm Gra,5398,2,12,4,8,31,31,0,40
Rapid Vienna,5398,3,8,11,5,38,27,11,35
LASK Linz,5398,4,9,7,8,31,30,1,34
Mattersburg,5398,5,6,7,11,33,42,-9,25
Vienna,5398,6,6,6,12,24,40,-16,24
SC Rheindorf,5398,7,4,7,13,17,30,-13,19
FC Salzburg,5399,1,14,7,3,43,19,24,49
Rapid Vienna,5399,2,10,10,4,37,25,12,40
SK Sturm Gra,5399,3,12,3,9,31,31,0,39
LASK Linz,5399,4,9,6,9,29,26,3,33
Vienna,5399,5,7,5,12,26,39,-13,26
SC Rheindorf,5399,6,6,5,13,18,29,-11,23
Mattersburg,5399,7,5,6,13,26,41,-15,21
FC Salzburg,5400,1,13,8,3,44,21,23,47
SK Sturm Gra,5400,2,13,4,7,34,29,5,43
Rapid Vienna,5400,3,8,10,6,34,27,7,34
LASK Linz,5400,4,9,6,9,29,31,-2,33
Vienna,5400,5,6,7,11,26,40,-14,25
Mattersburg,5400,6,6,6,12,32,41,-9,24
SC Rheindorf,5400,7,6,5,13,20,30,-10,23
FC Salzburg,5401,1,15,6,3,46,19,27,51
SK Sturm Gra,5401,2,13,3,8,34,30,4,42
Rapid Vienna,5401,3,8,9,7,35,30,5,33
LASK Linz,5401,4,9,5,10,26,30,-4,32
Vienna,5401,5,8,5,11,26,37,-11,29
SC Rheindorf,5401,6,6,5,13,20,27,-7,23
Mattersburg,5401,7,6,5,13,31,45,-14,23
FC Salzburg,5402,1,16,6,2,44,15,29,54
SK Sturm Gra,5402,2,14,3,7,39,28,11,45
Rapid Vienna,5402,3,9,9,6,36,29,7,36
LASK Linz,5402,4,7,5,12,26,36,-10,26
Mattersburg,5402,5,7,5,12,32,43,-11,26
Vienna,5402,6,7,5,12,27,40,-13,26
SC Rheindorf,5402,7,5,5,14,18,31,-13,20
FC Salzburg,5403,1,15,7,2,45,15,30,52
SK Sturm Gra,5403,2,11,4,9,29,29,0,37
Rapid Vienna,5403,3,8,11,5,35,30,5,35
LASK Linz,5403,4,7,8,9,24,26,-2,29
SC Rheindorf,5403,5,7,6,11,23,30,-7,27
Mattersburg,5403,6,6,6,12,33,42,-9,24
Vienna,5403,7,6,6,12,25,42,-17,24
FC Salzburg,5404,1,15,6,3,48,17,31,51
SK Sturm Gra,5404,2,12,5,7,33,29,4,41
Rapid Vienna,5404,3,9,10,5,36,28,8,37
LASK Linz,5404,4,8,6,10,28,32,-4,30
Mattersburg,5404,5,6,7,11,30,44,-14,25
Vienna,5404,6,6,6,12,24,39,-15,24
SC Rheindorf,5404,7,5,6,13,18,28,-10,21
FC Salzburg,5405,1,13,8,3,44,19,25,47
SK Sturm Gra,5405,2,13,5,6,34,25,9,44
Rapid Vienna,5405,3,9,9,6,38,29,9,36
LASK Linz,5405,4,8,6,10,28,33,-5,30
Mattersburg,5405,5,6,7,11,32,43,-11,25
Vienna,5405,6,6,7,11,26,40,-14,25
SC Rheindorf,5405,7,4,8,12,18,31,-13,20
FC Salzburg,5406,1,15,6,3,45,17,28,51
Rapid Vienna,5406,2,10,9,5,38,24,14,39
SK Sturm Gra,5406,3,11,4,9,29,32,-3,37
LASK Linz,5406,4,8,7,9,28,30,-2,31
Mattersburg,5406,5,7,6,11,35,42,-7,27
SC Rheindorf,5406,6,6,5,13,20,30,-10,23
Vienna,5406,7,6,5,13,23,43,-20,23
FC Salzburg,5407,1,14,6,4,47,21,26,48
SK Sturm Gra,5407,2,13,5,6,35,29,6,44
LASK Linz,5407,3,10,6,8,30,28,2,36
Rapid Vienna,5407,4,8,9,7,35,30,5,33
Vienna,5407,5,7,6,11,28,41,-13,27
Mattersburg,5407,6,5,7,12,31,44,-13,22
SC Rheindorf,5407,7,4,7,13,21,34,-13,19
FC Salzburg,5408,1,15,6,3,45,17,28,51
SK Sturm Gra,5408,2,12,4,8,31,29,2,40
Rapid Vienna,5408,3,8,11,5,35,28,7,35
LASK Linz,5408,4,8,7,9,26,28,-2,31
Mattersburg,5408,5,7,5,12,31,41,-10,26
Vienna,5408,6,7,5,12,25,39,-14,26
SC Rheindorf,5408,7,4,8,12,17,28,-11,20
FC Salzburg,5409,1,15,6,3,45,19,26,51
SK Sturm Gra,5409,2,13,4,7,32,26,6,43
LASK Linz,5409,3,10,5,9,28,28,0,35
Rapid Vienna,5409,4,8,10,6,34,27,7,34
Vienna,5409,5,7,5,12,26,39,-13,26
SC Rheindorf,5409,6,5,7,12,18,28,-10,22
Mattersburg,5409,7,5,5,14,29,45,-16,20
FC Salzburg,5410,1,16,6,2,52,20,32,54
SK Sturm Gra,5410,2,13,4,7,36,27,9,43
Rapid Vienna,5410,3,8,9,7,34,32,2,33
LASK Linz,5410,4,8,6,10,26,29,-3,30
Vienna,5410,5,7,5,12,26,40,-14,26
Mattersburg,5410,6,6,5,13,30,45,-15,23
SC Rheindorf,5410,7,5,7,12,16,27,-11,22
FC Salzburg,5411,1,14,6,4,44,20,24,48
SK Sturm Gra,5411,2,12,4,8,33,30,3,40
Rapid Vienna,5411,3,9,9,6,37,29,8,36
LASK Linz,5411,4,9,7,8,25,24,1,34
Mattersburg,5411,5,7,6,11,36,43,-7,27
Vienna,5411,6,7,5,12,27,42,-15,26
SC Rheindorf,5411,7,5,5,14,19,33,-14,20
FC Salzburg,5412,1,13,7,4,42,20,22,46
SK Sturm Gra,5412,2,13,3,8,33,30,3,42
LASK Linz,5412,3,11,5,8,31,28,3,38
Rapid Vienna,5412,4,9,9,6,39,29,10,36
Vienna,5412,5,7,6,11,27,39,-12,27
SC Rheindorf,5412,6,5,6,13,18,30,-12,21
Mattersburg,5412,7,5,6,13,29,43,-14,21
FC Salzburg,5413,1,16,6,2,48,15,33,54
SK Sturm Gra,5413,2,12,4,8,29,34,-5,40
Rapid Vienna,5413,3,9,9,6,43,28,15,36
LASK Linz,5413,4,8,8,8,26,26,0,32
Mattersburg,5413,5,6,7,11,28,37,-9,25
Vienna,5413,6,6,5,13,23,43,-20,23
SC Rheindorf,5413,7,4,7,13,15,29,-14,19
FC Salzburg,5414,1,16,6,2,50,17,33,54
SK Sturm Gra,5414,2,12,3,9,33,33,0,39
Rapid Vienna,5414,3,9,10,5,38,32,6,37
LASK Linz,5414,4,8,5,11,27,29,-2,29
Vienna,5414,5,7,5,12,27,40,-13,26
Mattersburg,5414,6,6,6,12,29,43,-14,24
SC Rheindorf,5414,7,5,7,12,21,31,-10,22
FC Salzburg,5415,1,15,7,2,44,17,27,52
Rapid Vienna,5415,2,9,9,6,36,26,10,36
SK Sturm Gra,5415,3,11,3,10,30,33,-3,36
LASK Linz,5415,4,10,5,9,26,26,0,35
Mattersburg,5415,5,7,7,10,32,38,-6,28
Vienna,5415,6,6,6,12,24,39,-15,24
SC Rheindorf,5415,7,5,5,14,18,31,-13,20
FC Salzburg,5416,1,14,7,3,46,20,26,49
SK Sturm Gra,5416,2,12,5,7,32,28,4,41
Rapid Vienna,5416,3,8,12,4,35,26,9,36
LASK Linz,5416,4,8,7,9,29,31,-2,31
Vienna,5416,5,7,5,12,25,40,-15,26
Mattersburg,5416,6,6,6,12,32,43,-11,24
SC Rheindorf,5416,7,5,6,13,19,30,-11,21
FC Salzburg,5417,1,13,8,3,40,17,23,47
SK Sturm Gra,5417,2,13,3,8,30,26,4,42
Rapid Vienna,5417,3,8,10,6,32,25,7,34
LASK Linz,5417,4,9,6,9,28,29,-1,33
Mattersburg,5417,5,7,7,10,35,40,-5,28
Vienna,5417,6,6,6,12,24,41,-17,24
SC Rheindorf,5417,7,5,6,13,18,29,-11,21
FC Salzburg,5418,1,15,7,2,49,19,30,52
SK Sturm Gra,5418,2,13,3,8,34,30,4,42
Rapid Vienna,5418,3,10,9,5,41,28,13,39
LASK Linz,5418,4,7,6,11,26,33,-7,27
Vienna,5418,5,6,7,11,24,38,-14,25
Mattersburg,5418,6,6,6,12,29,41,-12,24
SC Rheindorf,5418,7,5,6,13,18,32,-14,21
FC Salzburg,5419,1,15,6,3,49,19,30,51
SK Sturm Gra,5419,2,11,4,9,33,33,0,37
Rapid Vienna,5419,3,8,10,6,38,33,5,34
LASK Linz,5419,4,9,6,9,30,29,1,33
Vienna,5419,5,8,5,11,28,40,-12,29
Mattersburg,5419,6,6,6,12,31,44,-13,24
SC Rheindorf,5419,7,6,5,13,20,31,-11,23
FC Salzburg,5420,1,15,7,2,46,18,28,52
SK Sturm Gra,5420,2,14,3,7,37,28,9,45
Rapid Vienna,5420,3,8,11,5,37,27,10,35
LASK Linz,5420,4,7,6,11,26,35,-9,27
Mattersburg,5420,5,7,5,12,32,43,-11,26
Vienna,5420,6,6,5,13,25,41,-16,23
SC Rheindorf,5420,7,5,7,12,20,31,-11,22
FC Salzburg,5421,1,15,6,3,44,17,27,51
SK Sturm Gra,5421,2,12,5,7,34,29,5,41
Rapid Vienna,5421,3,8,10,6,35,31,4,34
LASK Linz,5421,4,9,6,9,30,27,3,33
Vienna,5421,5,8,5,11,27,38,-11,29
Mattersburg,5421,6,6,5,13,30,42,-12,23
SC Rheindorf,5421,7,4,7,13,17,33,-16,19
FC Salzburg,5422,1,13,7,4,42,18,24,46
SK Sturm Gra,5422,2,13,4,7,32,26,6,43
Rapid Vienna,5422,3,10,9,5,36,26,10,39
LASK Linz,5422,4,8,5,11,25,29,-4,29
Vienna,5422,5,8,5,11,27,39,-12,29
Mattersburg,5422,6,7,5,12,31,43,-12,26
SC Rheindorf,5422,7,5,5,14,19,31,-12,20
FC Salzburg,5423,1,15,7,2,45,15,30,52
SK Sturm Gra,5423,2,12,5,7,35,32,3,41
Rapid Vienna,5423,3,10,9,5,40,26,14,39
LASK Linz,5423,4,7,7,10,28,32,-4,28
Mattersburg,5423,5,7,5,12,36,44,-8,26
Vienna,5423,6,7,5,12,26,40,-14,26
SC Rheindorf,5423,7,4,6,14,22,43,-21,18
FC Salzburg,5424,1,15,6,3,43,18,25,51
SK Sturm Gra,5424,2,12,5,7,32,29,3,41
Rapid Vienna,5424,3,8,10,6,36,28,8,34
LASK Linz,5424,4,8,6,10,28,31,-3,30
SC Rheindorf,5424,5,7,5,12,20,28,-8,26
Vienna,5424,6,7,5,12,26,40,-14,26
Mattersburg,5424,7,6,5,13,32,43,-11,23
FC Salzburg,5425,1,15,7,2,54,19,35,52
SK Sturm Gra,5425,2,14,3,7,33,32,1,45
Rapid Vienna,5425,3,8,9,7,34,29,5,33
LASK Linz,5425,4,9,5,10,27,30,-3,32
Vienna,5425,5,7,6,11,30,39,-9,27
SC Rheindorf,5425,6,6,5,13,21,30,-9,23
Mattersburg,5425,7,5,5,14,29,49,-20,20
FC Salzburg,5426,1,15,6,3,45,19,26,51
Rapid Vienna,5426,2,11,9,4,38,25,13,42
SK Sturm Gra,5426,3,11,4,9,29,31,-2,37
LASK Linz,5426,4,7,7,10,25,28,-3,28
SC Rheindorf,5426,5,7,5,12,22,27,-5,26
Vienna,5426,6,7,5,12,26,40,-14,26
Mattersburg,5426,7,5,6,13,30,45,-15,21
FC Salzburg,5427,1,14,6,4,43,21,22,48
Rapid Vienna,5427,2,10,10,4,39,24,15,40
SK Sturm Gra,5427,3,12,3,9,30,29,1,39
Vienna,5427,4,8,5,11,30,40,-10,29
LASK Linz,5427,5,7,6,11,25,31,-6,27
Mattersburg,5427,6,6,6,12,33,44,-11,24
SC Rheindorf,5427,7,6,6,12,20,31,-11,24
FC Salzburg,5428,1,13,9,2,43,17,26,48
SK Sturm Gra,5428,2,12,6,6,33,28,5,42
Rapid Vienna,5428,3,8,10,6,39,31,8,34
LASK Linz,5428,4,9,7,8,29,26,3,34
Vienna,5428,5,7,6,11,25,38,-13,27
Mattersburg,5428,6,6,5,13,30,45,-15,23
SC Rheindorf,5428,7,4,7,13,18,32,-14,19
FC Salzburg,5429,1,15,7,2,46,16,30,52
SK Sturm Gra,5429,2,12,5,7,32,28,4,41
Rapid Vienna,5429,3,7,11,6,33,27,6,32
LASK Linz,5429,4,7,8,9,29,31,-2,29
Vienna,5429,5,7,5,12,26,42,-16,26
SC Rheindorf,5429,6,6,6,12,19,28,-9,24
Mattersburg,5429,7,6,6,12,29,42,-13,24
FC Salzburg,5430,1,14,7,3,44,20,24,49
SK Sturm Gra,5430,2,14,3,7,34,28,6,45
LASK Linz,5430,3,10,5,9,28,27,1,35
Rapid Vienna,5430,4,8,10,6,36,28,8,34
Mattersburg,5430,5,7,5,12,31,41,-10,26
Vienna,5430,6,6,5,13,23,39,-16,23
SC Rheindorf,5430,7,5,5,14,17,30,-13,20
FC Salzburg,5431,1,15,6,3,46,17,29,51
SK Sturm Gra,5431,2,13,3,8,32,28,4,42
Rapid Vienna,5431,3,10,9,5,35,25,10,39
Mattersburg,5431,4,7,7,10,35,42,-7,28
LASK Linz,5431,5,7,5,12,24,31,-7,26
Vienna,5431,6,6,6,12,27,43,-16,24
SC Rheindorf,5431,7,5,6,13,17,30,-13,21
FC Salzburg,5432,1,14,7,3,49,20,29,49
SK Sturm Gra,5432,2,13,4,7,37,28,9,43
Rapid Vienna,5432,3,9,10,5,36,27,9,37
LASK Linz,5432,4,8,7,9,26,27,-1,31
Vienna,5432,5,7,6,11,28,41,-13,27
Mattersburg,5432,6,6,6,12,31,46,-15,24
SC Rheindorf,5432,7,4,6,14,16,34,-18,18
FC Salzburg,5433,1,16,6,2,49,16,33,54
SK Sturm Gra,5433,2,12,3,9,32,35,-3,39
Rapid Vienna,5433,3,9,9,6,38,29,9,36
LASK Linz,5433,4,9,6,9,30,33,-3,33
Vienna,5433,5,6,6,12,25,40,-15,24
SC Rheindorf,5433,6,6,5,13,23,30,-7,23
Mattersburg,5433,7,5,7,12,29,43,-14,22
FC Salzburg,5434,1,15,7,2,45,18,27,52
SK Sturm Gra,5434,2,12,5,7,33,27,6,41
Rapid Vienna,5434,3,7,10,7,34,31,3,31
LASK Linz,5434,4,8,6,10,27,30,-3,30
Mattersburg,5434,5,6,7,11,31,40,-9,25
Vienna,5434,6,6,7,11,27,41,-14,25
SC Rheindorf,5434,7,6,6,12,21,31,-10,24
FC Salzburg,5435,1,13,8,3,42,20,22,47
SK Sturm Gra,5435,2,13,3,8,33,29,4,42
Rapid Vienna,5435,3,8,11,5,35,27,8,35
LASK Linz,5435,4,9,6,9,29,28,1,33
Mattersburg,5435,5,7,6,11,35,41,-6,27
Vienna,5435,6,6,6,12,27,44,-17,24
SC Rheindorf,5435,7,5,6,13,17,29,-12,21
FC Salzburg,5436,1,15,6,3,48,17,31,51
SK Sturm Gra,5436,2,13,3,8,32,33,-1,42
Rapid Vienna,5436,3,7,9,8,31,30,1,30
LASK Linz,5436,4,8,6,10,26,28,-2,30
Mattersburg,5436,5,7,6,11,31,40,-9,27
Vienna,5436,6,7,6,11,25,38,-13,27
SC Rheindorf,5436,7,6,6,12,21,28,-7,24
FC Salzburg,5437,1,14,8,2,48,18,30,50
SK Sturm Gra,5437,2,12,6,6,33,28,5,42
Rapid Vienna,5437,3,8,10,6,35,30,5,34
LASK Linz,5437,4,7,9,8,25,26,-1,30
Mattersburg,5437,5,6,7,11,30,42,-12,25
Vienna,5437,6,6,7,11,26,40,-14,25
SC Rheindorf,5437,7,4,7,13,18,31,-13,19
FC Salzburg,5438,1,14,8,2,43,18,25,50
SK Sturm Gra,5438,2,11,6,7,31,30,1,39
Rapid Vienna,5438,3,9,11,4,35,25,10,38
LASK Linz,5438,4,7,6,11,27,32,-5,27
Mattersburg,5438,5,7,5,12,32,42,-10,26
Vienna,5438,6,7,5,12,26,39,-13,26
SC Rheindorf,5438,7,6,5,13,20,28,-8,23
FC Salzburg,5439,1,14,8,2,49,21,28,50
SK Sturm Gra,5439,2,13,4,7,36,31,5,43
Rapid Vienna,5439,3,8,11,5,35,27,8,35
LASK Linz,5439,4,9,6,9,29,29,0,33
Vienna,5439,5,7,5,12,28,40,-12,26
Mattersburg,5439,6,6,6,12,33,49,-16,24
SC Rheindorf,5439,7,4,6,14,20,33,-13,18
FC Salzburg,5440,1,14,8,2,50,21,29,50
SK Sturm Gra,5440,2,13,5,6,35,29,6,44
Rapid Vienna,5440,3,7,11,6,36,30,6,32
LASK Linz,5440,4,8,6,10,29,31,-2,30
Vienna,5440,5,7,5,12,26,40,-14,26
SC Rheindorf,5440,6,6,6,12,21,30,-9,24
Mattersburg,5440,7,6,5,13,31,47,-16,23
FC Salzburg,5441,1,15,7,2,45,18,27,52
SK Sturm Gra,5441,2,12,4,8,32,30,2,40
Rapid Vienna,5441,3,10,9,5,39,27,12,39
LASK Linz,5441,4,8,5,11,29,30,-1,29
Vienna,5441,5,7,6,11,28,38,-10,27
SC Rheindorf,5441,6,6,6,12,20,29,-9,24
Mattersburg,5441,7,5,5,14,29,50,-21,20
FC Salzburg,5442,1,14,7,3,43,18,25,49
Rapid Vienna,5442,2,9,10,5,38,26,12,37
SK Sturm Gra,5442,3,11,3,10,31,36,-5,36
LASK Linz,5442,4,8,5,11,29,33,-4,29
Vienna,5442,5,8,5,11,28,39,-11,29
SC Rheindorf,5442,6,7,6,11,22,28,-6,27
Mattersburg,5442,7,6,6,12,30,41,-11,24
FC Salzburg,5443,1,13,8,3,42,19,23,47
SK Sturm Gra,5443,2,13,4,7,33,29,4,43
LASK Linz,5443,3,11,5,8,35,28,7,38
Rapid Vienna,5443,4,9,9,6,35,28,7,36
Vienna,5443,5,7,6,11,24,37,-13,27
Mattersburg,5443,6,5,6,13,29,43,-14,21
SC Rheindorf,5443,7,4,6,14,17,31,-14,18
FC Salzburg,5444,1,16,6,2,50,17,33,54
SK Sturm Gra,5444,2,12,5,7,33,30,3,41
Rapid Vienna,5444,3,9,10,5,40,27,13,37
LASK Linz,5444,4,8,6,10,28,32,-4,30
Mattersburg,5444,5,7,6,11,31,40,-9,27
Vienna,5444,6,6,5,13,25,43,-18,23
SC Rheindorf,5444,7,4,6,14,16,34,-18,18
FC Salzburg,5445,1,15,6,3,52,19,33,51
SK Sturm Gra,5445,2,13,3,8,34,30,4,42
Rapid Vienna,5445,3,8,9,7,33,34,-1,33
LASK Linz,5445,4,8,5,11,26,28,-2,29
Mattersburg,5445,5,7,6,11,32,43,-11,27
Vienna,5445,6,7,5,12,26,40,-14,26
SC Rheindorf,5445,7,6,6,12,21,30,-9,24
FC Salzburg,5446,1,13,9,2,42,18,24,48
SK Sturm Gra,5446,2,13,4,7,34,28,6,43
Rapid Vienna,5446,3,7,10,7,31,31,0,31
LASK Linz,5446,4,8,6,10,28,33,-5,30
Mattersburg,5446,5,7,6,11,32,42,-10,27
SC Rheindorf,5446,6,7,5,12,26,26,0,26
Vienna,5446,7,6,6,12,25,40,-15,24
FC Salzburg,5447,1,14,8,2,44,19,25,50
SK Sturm Gra,5447,2,12,5,7,32,27,5,41
Rapid Vienna,5447,3,9,11,4,38,25,13,38
LASK Linz,5447,4,9,6,9,28,28,0,33
Vienna,5447,5,6,6,12,25,40,-15,24
Mattersburg,5447,6,5,8,11,31,42,-11,23
SC Rheindorf,5447,7,4,6,14,17,34,-17,18
FC Salzburg,5448,1,15,7,2,46,15,31,52
SK Sturm Gra,5448,2,12,3,9,31,30,1,39
LASK Linz,5448,3,9,7,8,30,26,4,34
Rapid Vienna,5448,4,7,9,8,33,34,-1,30
SC Rheindorf,5448,5,7,6,11,20,27,-7,27
Vienna,5448,6,7,6,11,26,37,-11,27
Mattersburg,5448,7,5,6,13,29,46,-17,21
FC Salzburg,5449,1,15,6,3,48,17,31,51
SK Sturm Gra,5449,2,13,3,8,36,33,3,42
Rapid Vienna,5449,3,9,9,6,36,31,5,36
LASK Linz,5449,4,9,5,10,33,31,2,32
Mattersburg,5449,5,6,6,12,31,45,-14,24
Vienna,5449,6,6,6,12,23,40,-17,24
SC Rheindorf,5449,7,6,5,13,21,31,-10,23
FC Salzburg,5450,1,14,8,2,46,18,28,50
SK Sturm Gra,5450,2,13,4,7,36,28,8,43
Rapid Vienna,5450,3,8,11,5,36,30,6,35
LASK Linz,5450,4,9,7,8,32,28,4,34
Mattersburg,5450,5,6,6,12,31,47,-16,24
Vienna,5450,6,6,5,13,25,42,-17,23
SC Rheindorf,5450,7,4,7,13,18,31,-13,19
FC Salzburg,5451,1,15,6,3,45,18,27,51
SK Sturm Gra,5451,2,13,3,8,37,30,7,42
Rapid Vienna,5451,3,9,9,6,38,32,6,36
LASK Linz,5451,4,9,5,10,28,29,-1,32
Vienna,5451,5,8,5,11,25,37,-12,29
SC Rheindorf,5451,6,6,5,13,20,32,-12,23
Mattersburg,5451,7,5,5,14,28,43,-15,20
FC Salzburg,5452,1,15,6,3,43,18,25,51
Rapid Vienna,5452,2,10,9,5,41,26,15,39
SK Sturm Gra,5452,3,11,4,9,31,30,1,37
LASK Linz,5452,4,8,7,9,29,30,-1,31
Mattersburg,5452,5,7,5,12,29,40,-11,26
Vienna,5452,6,7,5,12,24,38,-14,26
SC Rheindorf,5452,7,5,6,13,18,33,-15,21
FC Salzburg,5453,1,15,6,3,45,17,28,51
SK Sturm Gra,5453,2,12,3,9,30,29,1,39
LASK Linz,5453,3,10,6,8,28,25,3,36
Rapid Vienna,5453,4,8,9,7,34,30,4,33
Vienna,5453,5,8,5,11,26,37,-11,29
Mattersburg,5453,6,6,6,12,30,42,-12,24
SC Rheindorf,5453,7,5,5,14,18,31,-13,20
FC Salzburg,5454,1,13,8,3,45,20,25,47
SK Sturm Gra,5454,2,11,4,9,31,32,-1,37
Rapid Vienna,5454,3,8,11,5,35,27,8,35
LASK Linz,5454,4,9,6,9,28,28,0,33
Mattersburg,5454,5,7,7,10,32,40,-8,28
Vienna,5454,6,6,7,11,25,39,-14,25
SC Rheindorf,5454,7,6,5,13,20,30,-10,23
FC Salzburg,5455,1,13,7,4,42,21,21,46
SK Sturm Gra,5455,2,12,5,7,34,30,4,41
Rapid Vienna,5455,3,9,9,6,36,30,6,36
LASK Linz,5455,4,8,7,9,27,28,-1,31
Vienna,5455,5,7,6,11,26,38,-12,27
SC Rheindorf,5455,6,6,6,12,22,29,-7,24
Mattersburg,5455,7,6,6,12,30,41,-11,24
FC Salzburg,5456,1,14,6,4,42,22,20,48
SK Sturm Gra,5456,2,12,5,7,33,27,6,41
Rapid Vienna,5456,3,8,10,6,35,29,6,34
LASK Linz,5456,4,7,8,9,25,28,-3,29
Mattersburg,5456,5,7,5,12,32,41,-9,26
Vienna,5456,6,7,5,12,26,39,-13,26
SC Rheindorf,5456,7,6,7,11,19,26,-7,25
FC Salzburg,5457,1,14,6,4,42,19,23,48
SK Sturm Gra,5457,2,12,4,8,38,32,6,40
Rapid Vienna,5457,3,9,11,4,37,26,11,38
LASK Linz,5457,4,10,5,9,29,29,0,35
Mattersburg,5457,5,7,6,11,32,40,-8,27
Vienna,5457,6,6,6,12,25,40,-15,24
SC Rheindorf,5457,7,4,6,14,18,35,-17,18
FC Salzburg,5458,1,14,7,3,44,20,24,49
SK Sturm Gra,5458,2,12,5,7,34,29,5,41
Rapid Vienna,5458,3,10,10,4,40,26,14,40
LASK Linz,5458,4,8,5,11,26,30,-4,29
Vienna,5458,5,7,5,12,27,40,-13,26
Mattersburg,5458,6,6,6,12,30,43,-13,24
SC Rheindorf,5458,7,5,6,13,19,32,-13,21
FC Salzburg,5459,1,15,6,3,45,19,26,51
SK Sturm Gra,5459,2,14,3,7,36,27,9,45
LASK Linz,5459,3,10,5,9,30,28,2,35
Rapid Vienna,5459,4,7,10,7,34,31,3,31
Vienna,5459,5,7,5,12,26,40,-14,26
SC Rheindorf,5459,6,5,7,12,20,31,-11,22
Mattersburg,5459,7,5,6,13,26,41,-15,21
FC Salzburg,5460,1,14,8,2,45,16,29,50
SK Sturm Gra,5460,2,13,3,8,33,30,3,42
Rapid Vienna,5460,3,8,10,6,34,28,6,34
LASK Linz,5460,4,9,6,9,29,26,3,33
Vienna,5460,5,7,6,11,27,39,-12,27
Mattersburg,5460,6,6,5,13,33,48,-15,23
SC Rheindorf,5460,7,5,6,13,18,32,-14,21
FC Salzburg,5461,1,14,8,2,42,17,25,50
SK Sturm Gra,5461,2,13,4,7,33,27,6,43
Rapid Vienna,5461,3,7,12,5,35,28,7,33
Mattersburg,5461,4,7,7,10,34,39,-5,28
LASK Linz,5461,5,7,6,11,26,34,-8,27
Vienna,5461,6,6,6,12,27,42,-15,24
SC Rheindorf,5461,7,5,7,12,19,29,-10,22
FC Salzburg,5462,1,15,6,3,53,19,34,51
SK Sturm Gra,5462,2,13,3,8,32,34,-2,42
Rapid Vienna,5462,3,8,9,7,35,31,4,33
LASK Linz,5462,4,8,7,9,28,28,0,31
Vienna,5462,5,7,5,12,25,39,-14,26
Mattersburg,5462,6,6,7,11,30,41,-11,25
SC Rheindorf,5462,7,5,7,12,20,31,-11,22
FC Salzburg,5463,1,15,6,3,49,19,30,51
SK Sturm Gra,5463,2,14,3,7,32,27,5,45
Rapid Vienna,5463,3,10,9,5,39,26,13,39
Mattersburg,5463,4,7,6,11,34,41,-7,27
LASK Linz,5463,5,7,5,12,23,31,-8,26
Vienna,5463,6,6,6,12,25,43,-18,24
SC Rheindorf,5463,7,5,5,14,18,33,-15,20
FC Salzburg,5464,1,14,7,3,46,18,28,49
SK Sturm Gra,5464,2,13,4,7,36,31,5,43
Rapid Vienna,5464,3,8,11,5,36,27,9,35
LASK Linz,5464,4,8,6,10,27,31,-4,30
Mattersburg,5464,5,8,5,11,33,42,-9,29
Vienna,5464,6,6,5,13,24,41,-17,23
SC Rheindorf,5464,7,5,6,13,19,31,-12,21
FC Salzburg,5465,1,13,9,2,42,18,24,48
SK Sturm Gra,5465,2,12,4,8,30,28,2,40
Rapid Vienna,5465,3,9,10,5,37,27,10,37
LASK Linz,5465,4,9,6,9,30,28,2,33
Vienna,5465,5,6,7,11,25,39,-14,25
Mattersburg,5465,6,6,6,12,30,43,-13,24
SC Rheindorf,5465,7,5,6,13,21,32,-11,21
FC Salzburg,5466,1,13,7,4,44,25,19,46
SK Sturm Gra,5466,2,13,4,7,33,29,4,43
Rapid Vienna,5466,3,10,9,5,41,30,11,39
LASK Linz,5466,4,8,5,11,26,29,-3,29
Mattersburg,5466,5,7,6,11,31,39,-8,27
Vienna,5466,6,7,5,12,28,38,-10,26
SC Rheindorf,5466,7,5,6,13,19,32,-13,21
FC Salzburg,5467,1,15,6,3,43,18,25,51
SK Sturm Gra,5467,2,12,4,8,34,31,3,40
Rapid Vienna,5467,3,8,10,6,37,29,8,34
LASK Linz,5467,4,9,5,10,30,33,-3,32
Vienna,5467,5,8,5,11,25,37,-12,29
Mattersburg,5467,6,7,5,12,32,41,-9,26
SC Rheindorf,5467,7,5,5,14,17,29,-12,20
FC Salzburg,5468,1,14,8,2,44,17,27,50
SK Sturm Gra,5468,2,11,5,8,30,31,-1,38
Rapid Vienna,5468,3,9,9,6,39,28,11,36
LASK Linz,5468,4,9,5,10,26,27,-1,32
Mattersburg,5468,5,7,6,11,30,40,-10,27
Vienna,5468,6,6,6,12,24,40,-16,24
SC Rheindorf,5468,7,5,7,12,19,29,-10,22
FC Salzburg,5469,1,14,7,3,44,20,24,49
SK Sturm Gra,5469,2,14,3,7,37,31,6,45
Rapid Vienna,5469,3,8,11,5,38,28,10,35
LASK Linz,5469,4,9,7,8,30,29,1,34
Vienna,5469,5,7,5,12,26,39,-13,26
Mattersburg,5469,6,5,6,13,29,43,-14,21
SC Rheindorf,5469,7,5,5,14,17,31,-14,20
FC Salzburg,5470,1,15,7,2,47,17,30,52
SK Sturm Gra,5470,2,13,4,7,32,28,4,43
Rapid Vienna,5470,3,7,10,7,34,29,5,31
LASK Linz,5470,4,8,5,11,25,29,-4,29
SC Rheindorf,5470,5,7,6,11,21,28,-7,27
Vienna,5470,6,7,5,12,28,42,-14,26
Mattersburg,5470,7,6,5,13,31,45,-14,23
FC Salzburg,5471,1,15,6,3,47,18,29,51
SK Sturm Gra,5471,2,14,4,6,31,24,7,46
Rapid Vienna,5471,3,7,12,5,33,27,6,33
LASK Linz,5471,4,8,6,10,27,32,-5,30
Vienna,5471,5,7,5,12,25,40,-15,26
Mattersburg,5471,6,6,5,13,35,45,-10,23
SC Rheindorf,5471,7,5,6,13,17,29,-12,21
FC Salzburg,5472,1,12,9,3,43,21,22,45
SK Sturm Gra,5472,2,12,5,7,30,26,4,41
Rapid Vienna,5472,3,10,9,5,39,27,12,39
LASK Linz,5472,4,9,7,8,27,26,1,34
Mattersburg,5472,5,6,7,11,30,41,-11,25
Vienna,5472,6,6,6,12,26,41,-15,24
SC Rheindorf,5472,7,5,5,14,18,31,-13,20
FC Salzburg,5473,1,14,8,2,44,17,27,50
SK Sturm Gra,5473,2,12,5,7,32,33,-1,41
Rapid Vienna,5473,3,7,12,5,34,28,6,33
LASK Linz,5473,4,9,6,9,27,27,0,33
Vienna,5473,5,7,5,12,25,40,-15,26
Mattersburg,5473,6,6,6,12,30,41,-11,24
SC Rheindorf,5473,7,5,6,13,25,31,-6,21
FC Salzburg,5474,1,14,7,3,44,20,24,49
SK Sturm Gra,5474,2,13,4,7,33,26,7,43
LASK Linz,5474,3,10,5,9,28,28,0,35
Rapid Vienna,5474,4,8,10,6,34,28,6,34
Mattersburg,5474,5,7,6,11,35,44,-9,27
Vienna,5474,6,6,5,13,25,41,-16,23
SC Rheindorf,5474,7,5,5,14,19,31,-12,20
FC Salzburg,5475,1,15,6,3,50,17,33,51
SK Sturm Gra,5475,2,13,4,7,34,30,4,43
Rapid Vienna,5475,3,8,11,5,36,29,7,35
LASK Linz,5475,4,9,6,9,30,28,2,33
Vienna,5475,5,7,5,12,29,41,-12,26
Mattersburg,5475,6,5,7,12,29,50,-21,22
SC Rheindorf,5475,7,4,7,13,17,30,-13,19
FC Salzburg,5476,1,15,7,2,47,20,27,52
SK Sturm Gra,5476,2,12,4,8,31,29,2,40
Rapid Vienna,5476,3,8,10,6,36,28,8,34
LASK Linz,5476,4,9,6,9,25,25,0,33
Mattersburg,5476,5,7,6,11,33,40,-7,27
Vienna,5476,6,6,6,12,26,42,-16,24
SC Rheindorf,5476,7,4,7,13,17,31,-14,19
FC Salzburg,5477,1,13,7,4,45,21,24,46
SK Sturm Gra,5477,2,12,4,8,35,33,2,40
Rapid Vienna,5477,3,10,9,5,40,26,14,39
Mattersburg,5477,4,7,7,10,35,40,-5,28
LASK Linz,5477,5,7,7,10,28,36,-8,28
Vienna,5477,6,6,7,11,24,38,-14,25
SC Rheindorf,5477,7,6,5,13,19,32,-13,23
FC Salzburg,5478,1,16,6,2,46,16,30,54
Rapid Vienna,5478,2,10,9,5,39,28,11,39
SK Sturm Gra,5478,3,12,3,9,32,31,1,39
Mattersburg,5478,4,7,6,11,30,39,-9,27
LASK Linz,5478,5,7,5,12,25,30,-5,26
Vienna,5478,6,6,6,12,24,41,-17,24
SC Rheindorf,5478,7,6,5,13,20,31,-11,23
FC Salzburg,5479,1,15,6,3,46,16,30,51
SK Sturm Gra,5479,2,14,4,6,33,26,7,46
Rapid Vienna,5479,3,7,10,7,32,28,4,31
Mattersburg,5479,4,8,5,11,35,42,-7,29
LASK Linz,5479,5,7,7,10,27,31,-4,28
Vienna,5479,6,6,5,13,23,42,-19,23
SC Rheindorf,5479,7,5,7,12,19,30,-11,22
FC Salzburg,5480,1,15,7,2,50,21,29,52
SK Sturm Gra,5480,2,12,4,8,31,28,3,40
LASK Linz,5480,3,10,6,8,28,26,2,36
Rapid Vienna,5480,4,8,11,5,35,27,8,35
Mattersburg,5480,5,6,6,12,31,44,-13,24
Vienna,5480,6,6,5,13,26,43,-17,23
SC Rheindorf,5480,7,4,7,13,17,29,-12,19
FC Salzburg,5481,1,15,7,2,44,18,26,52
SK Sturm Gra,5481,2,13,3,8,35,30,5,42
Rapid Vienna,5481,3,9,10,5,37,28,9,37
LASK Linz,5481,4,8,6,10,28,31,-3,30
Vienna,5481,5,6,7,11,24,38,-14,25
Mattersburg,5481,6,5,7,12,31,43,-12,22
SC Rheindorf,5481,7,5,6,13,19,30,-11,21
FC Salzburg,5482,1,13,7,4,43,20,23,46
SK Sturm Gra,5482,2,13,4,7,32,29,3,43
Rapid Vienna,5482,3,9,9,6,33,26,7,36
LASK Linz,5482,4,9,5,10,28,29,-1,32
Vienna,5482,5,8,5,11,28,38,-10,29
Mattersburg,5482,6,7,5,12,31,44,-13,26
SC Rheindorf,5482,7,5,5,14,22,31,-9,20
FC Salzburg,5483,1,15,7,2,46,15,31,52
SK Sturm Gra,5483,2,13,3,8,32,27,5,42
Rapid Vienna,5483,3,8,10,6,34,28,6,34
LASK Linz,5483,4,8,7,9,28,28,0,31
Vienna,5483,5,7,5,12,25,42,-17,26
Mattersburg,5483,6,6,6,12,29,40,-11,24
SC Rheindorf,5483,7,5,6,13,19,33,-14,21
FC Salzburg,5484,1,13,7,4,43,22,21,46
Rapid Vienna,5484,2,11,9,4,46,27,19,42
SK Sturm Gra,5484,3,12,3,9,36,35,1,39
LASK Linz,5484,4,9,5,10,31,34,-3,32
Vienna,5484,5,7,6,11,25,37,-12,27
SC Rheindorf,5484,6,6,5,13,20,32,-12,23
Mattersburg,5484,7,6,5,13,28,42,-14,23
FC Salzburg,5485,1,16,6,2,46,18,28,54
SK Sturm Gra,5485,2,14,3,7,35,26,9,45
Rapid Vienna,5485,3,8,10,6,37,30,7,34
LASK Linz,5485,4,7,6,11,24,32,-8,27
Vienna,5485,5,7,5,12,25,40,-15,26
Mattersburg,5485,6,6,5,13,34,43,-9,23
SC Rheindorf,5485,7,6,5,13,19,31,-12,23
FC Salzburg,5486,1,14,7,3,43,17,26,49
SK Sturm Gra,5486,2,12,4,8,34,31,3,40
Rapid Vienna,5486,3,9,10,5,38,28,10,37
Vienna,5486,4,8,5,11,27,37,-10,29
LASK Linz,5486,5,7,6,11,27,32,-5,27
SC Rheindorf,5486,6,6,6,12,22,31,-9,24
Mattersburg,5486,7,6,6,12,28,43,-15,24
FC Salzburg,5487,1,14,7,3,44,19,25,49
SK Sturm Gra,5487,2,12,4,8,32,30,2,40
LASK Linz,5487,3,10,6,8,32,30,2,36
Rapid Vienna,5487,4,8,9,7,37,32,5,33
Vienna,5487,5,7,6,11,26,38,-12,27
Mattersburg,5487,6,6,5,13,29,43,-14,23
SC Rheindorf,5487,7,5,7,12,20,28,-8,22
FC Salzburg,5488,1,13,7,4,43,18,25,46
SK Sturm Gra,5488,2,12,4,8,32,33,-1,40
LASK Linz,5488,3,11,5,8,32,26,6,38
Rapid Vienna,5488,4,8,11,5,36,28,8,35
Mattersburg,5488,5,8,5,11,35,40,-5,29
Vienna,5488,6,6,5,13,23,44,-21,23
SC Rheindorf,5488,7,5,5,14,20,32,-12,20
FC Salzburg,5489,1,14,8,2,46,16,30,50
SK Sturm Gra,5489,2,12,5,7,35,30,5,41
Rapid Vienna,5489,3,8,9,7,36,35,1,33
LASK Linz,5489,4,8,7,9,27,27,0,31
SC Rheindorf,5489,5,7,5,12,21,28,-7,26
Vienna,5489,6,6,7,11,23,37,-14,25
Mattersburg,5489,7,5,7,12,27,42,-15,22
FC Salzburg,5490,1,14,7,3,46,17,29,49
SK Sturm Gra,5490,2,13,4,7,32,27,5,43
Rapid Vienna,5490,3,9,9,6,33,26,7,36
LASK Linz,5490,4,8,6,10,25,26,-1,30
Mattersburg,5490,5,7,6,11,30,39,-9,27
SC Rheindorf,5490,6,6,5,13,17,28,-11,23
Vienna,5490,7,6,5,13,25,45,-20,23
FC Salzburg,5491,1,14,7,3,43,19,24,49
SK Sturm Gra,5491,2,13,5,6,34,26,8,44
LASK Linz,5491,3,9,6,9,27,28,-1,33
Rapid Vienna,5491,4,7,11,6,34,28,6,32
Mattersburg,5491,5,5,9,10,31,41,-10,24
Vienna,5491,6,6,6,12,24,40,-16,24
SC Rheindorf,5491,7,4,8,12,20,31,-11,20
FC Salzburg,5492,1,14,7,3,44,20,24,49
SK Sturm Gra,5492,2,12,6,6,29,24,5,42
Rapid Vienna,5492,3,9,9,6,36,28,8,36
LASK Linz,5492,4,8,8,8,25,25,0,32
Mattersburg,5492,5,6,7,11,27,37,-10,25
Vienna,5492,6,6,5,13,26,42,-16,23
SC Rheindorf,5492,7,4,8,12,16,27,-11,20
FC Salzburg,5493,1,14,6,4,43,19,24,48
SK Sturm Gra,5493,2,13,4,7,34,28,6,43
Rapid Vienna,5493,3,9,10,5,37,28,9,37
LASK Linz,5493,4,9,5,10,25,27,-2,32
SC Rheindorf,5493,5,7,5,12,21,28,-7,26
Mattersburg,5493,6,6,5,13,29,42,-13,23
Vienna,5493,7,6,5,13,23,40,-17,23
FC Salzburg,5494,1,14,7,3,42,18,24,49
SK Sturm Gra,5494,2,13,4,7,34,27,7,43
LASK Linz,5494,3,9,5,10,27,32,-5,32
Rapid Vienna,5494,4,7,9,8,34,30,4,30
Vienna,5494,5,7,6,11,27,40,-13,27
Mattersburg,5494,6,6,7,11,31,39,-8,25
SC Rheindorf,5494,7,6,6,12,23,32,-9,24
FC Salzburg,5495,1,13,8,3,41,19,22,47
SK Sturm Gra,5495,2,13,4,7,30,26,4,43
Rapid Vienna,5495,3,10,9,5,38,24,14,39
LASK Linz,5495,4,8,5,11,25,30,-5,29
Vienna,5495,5,7,6,11,29,40,-11,27
SC Rheindorf,5495,6,7,5,12,21,28,-7,26
Mattersburg,5495,7,5,5,14,31,48,-17,20
FC Salzburg,5496,1,15,7,2,46,19,27,52
SK Sturm Gra,5496,2,12,5,7,32,27,5,41
Rapid Vienna,5496,3,8,12,4,39,28,11,36
LASK Linz,5496,4,8,7,9,30,31,-1,31
Vienna,5496,5,7,5,12,25,39,-14,26
Mattersburg,5496,6,6,6,12,31,42,-11,24
SC Rheindorf,5496,7,4,6,14,18,35,-17,18
FC Salzburg,5497,1,12,7,5,42,23,19,43
SK Sturm Gra,5497,2,13,4,7,33,28,5,43
Rapid Vienna,5497,3,8,12,4,35,26,9,36
Vienna,5497,4,8,5,11,26,37,-11,29
LASK Linz,5497,5,7,7,10,28,31,-3,28
SC Rheindorf,5497,6,6,7,11,23,29,-6,25
Mattersburg,5497,7,6,6,12,33,46,-13,24
FC Salzburg,5498,1,12,8,4,42,22,20,44
SK Sturm Gra,5498,2,12,6,6,33,26,7,42
Rapid Vienna,5498,3,7,12,5,35,28,7,33
LASK Linz,5498,4,8,7,9,27,28,-1,31
Mattersburg,5498,5,8,6,10,32,38,-6,30
Vienna,5498,6,7,5,12,26,40,-14,26
SC Rheindorf,5498,7,4,8,12,19,32,-13,20
FC Salzburg,5499,1,14,7,3,44,21,23,49
SK Sturm Gra,5499,2,13,3,8,35,31,4,42
Rapid Vienna,5499,3,9,9,6,40,32,8,36
LASK Linz,5499,4,8,6,10,30,30,0,30
Vienna,5499,5,7,6,11,27,38,-11,27
SC Rheindorf,5499,6,6,6,12,21,30,-9,24
Mattersburg,5499,7,5,7,12,29,44,-15,22
FC Salzburg,5500,1,15,7,2,46,17,29,52
SK Sturm Gra,5500,2,13,4,7,33,29,4,43
Rapid Vienna,5500,3,8,11,5,36,28,8,35
LASK Linz,5500,4,8,6,10,30,33,-3,30
Vienna,5500,5,7,6,11,26,39,-13,27
Mattersburg,5500,6,7,5,12,34,43,-9,26
SC Rheindorf,5500,7,4,5,15,19,35,-16,17
FC Salzburg,5501,1,13,8,3,42,18,24,47
SK Sturm Gra,5501,2,13,4,7,35,29,6,43
LASK Linz,5501,3,10,6,8,30,27,3,36
Rapid Vienna,5501,4,8,9,7,34,31,3,33
Vienna,5501,5,7,6,11,24,37,-13,27
Mattersburg,5501,6,6,6,12,30,42,-12,24
SC Rheindorf,5501,7,5,5,14,21,32,-11,20
FC Salzburg,5502,1,15,7,2,47,18,29,52
SK Sturm Gra,5502,2,13,3,8,35,29,6,42
Rapid Vienna,5502,3,9,10,5,36,26,10,37
LASK Linz,5502,4,7,6,11,23,29,-6,27
Vienna,5502,5,7,5,12,26,42,-16,26
Mattersburg,5502,6,6,6,12,31,43,-12,24
SC Rheindorf,5502,7,6,5,13,22,33,-11,23
FC Salzburg,5503,1,15,7,2,49,19,30,52
SK Sturm Gra,5503,2,12,3,9,33,31,2,39
Rapid Vienna,5503,3,8,10,6,37,31,6,34
LASK Linz,5503,4,9,6,9,29,29,0,33
Mattersburg,5503,5,7,6,11,30,39,-9,27
SC Rheindorf,5503,6,6,5,13,20,32,-12,23
Vienna,5503,7,6,5,13,24,41,-17,23
FC Salzburg,5504,1,14,7,3,44,17,27,49
SK Sturm Gra,5504,2,14,3,7,36,27,9,45
Rapid Vienna,5504,3,10,10,4,37,24,13,40
LASK Linz,5504,4,7,7,10,26,32,-6,28
Vienna,5504,5,7,5,12,28,41,-13,26
Mattersburg,5504,6,5,7,12,30,46,-16,22
SC Rheindorf,5504,7,4,7,13,20,34,-14,19
FC Salzburg,5505,1,14,7,3,43,20,23,49
SK Sturm Gra,5505,2,13,3,8,36,32,4,42
Rapid Vienna,5505,3,9,10,5,40,29,11,37
LASK Linz,5505,4,9,5,10,33,32,1,32
Vienna,5505,5,8,5,11,28,38,-10,29
SC Rheindorf,5505,6,6,5,13,21,34,-13,23
Mattersburg,5505,7,5,5,14,29,45,-16,20
FC Salzburg,5506,1,14,7,3,42,18,24,49
SK Sturm Gra,5506,2,12,5,7,33,29,4,41
Rapid Vienna,5506,3,8,10,6,34,27,7,34
LASK Linz,5506,4,9,6,9,28,27,1,33
Mattersburg,5506,5,7,5,12,33,45,-12,26
Vienna,5506,6,7,5,12,26,38,-12,26
SC Rheindorf,5506,7,5,6,13,20,32,-12,21
FC Salzburg,5507,1,15,7,2,46,17,29,52
SK Sturm Gra,5507,2,11,3,10,29,30,-1,36
Rapid Vienna,5507,3,8,11,5,34,26,8,35
LASK Linz,5507,4,9,5,10,26,27,-1,32
SC Rheindorf,5507,5,7,6,11,20,26,-6,27
Vienna,5507,6,7,5,12,25,40,-15,26
Mattersburg,5507,7,6,5,13,29,43,-14,23
FC Salzburg,5508,1,15,6,3,47,21,26,51
SK Sturm Gra,5508,2,13,4,7,37,28,9,43
Rapid Vienna,5508,3,7,11,6,38,33,5,32
SC Rheindorf,5508,4,8,5,11,23,27,-4,29
LASK Linz,5508,5,7,7,10,25,30,-5,28
Vienna,5508,6,7,5,12,27,41,-14,26
Mattersburg,5508,7,5,6,13,30,47,-17,21
FC Salzburg,5509,1,15,7,2,45,18,27,52
SK Sturm Gra,5509,2,13,4,7,31,27,4,43
Rapid Vienna,5509,3,9,9,6,34,26,8,36
LASK Linz,5509,4,7,6,11,23,28,-5,27
Mattersburg,5509,5,7,5,12,32,39,-7,26
Vienna,5509,6,6,6,12,24,41,-17,24
SC Rheindorf,5509,7,6,5,13,18,28,-10,23
FC Salzburg,5510,1,14,7,3,44,17,27,49
SK Sturm Gra,5510,2,13,4,7,32,27,5,43
Rapid Vienna,5510,3,8,11,5,36,28,8,35
LASK Linz,5510,4,10,5,9,27,26,1,35
Vienna,5510,5,7,6,11,25,38,-13,27
Mattersburg,5510,6,5,7,12,28,42,-14,22
SC Rheindorf,5510,7,4,6,14,17,31,-14,18
FC Salzburg,5511,1,15,6,3,43,17,26,51
SK Sturm Gra,5511,2,13,3,8,34,30,4,42
Rapid Vienna,5511,3,10,9,5,38,26,12,39
LASK Linz,5511,4,8,5,11,34,32,2,29
Mattersburg,5511,5,8,5,11,39,42,-3,29
Vienna,5511,6,6,5,13,24,46,-22,23
SC Rheindorf,5511,7,5,5,14,17,36,-19,20
FC Salzburg,5512,1,14,6,4,46,19,27,48
SK Sturm Gra,5512,2,12,5,7,33,30,3,41
Rapid Vienna,5512,3,9,10,5,38,26,12,37
LASK Linz,5512,4,8,5,11,28,36,-8,29
Vienna,5512,5,8,5,11,29,40,-11,29
Mattersburg,5512,6,7,5,12,39,45,-6,26
SC Rheindorf,5512,7,5,6,13,20,37,-17,21
FC Salzburg,5513,1,15,7,2,47,16,31,52
SK Sturm Gra,5513,2,14,3,7,34,27,7,45
Rapid Vienna,5513,3,9,9,6,39,29,10,36
LASK Linz,5513,4,7,7,10,26,31,-5,28
Vienna,5513,5,7,6,11,25,38,-13,27
Mattersburg,5513,6,6,6,12,28,41,-13,24
SC Rheindorf,5513,7,4,6,14,20,37,-17,18
FC Salzburg,5514,1,14,7,3,46,19,27,49
SK Sturm Gra,5514,2,14,4,6,36,27,9,46
Rapid Vienna,5514,3,10,9,5,37,26,11,39
LASK Linz,5514,4,8,5,11,25,30,-5,29
Vienna,5514,5,7,5,12,24,38,-14,26
Mattersburg,5514,6,6,5,13,29,45,-16,23
SC Rheindorf,5514,7,5,5,14,18,30,-12,20
FC Salzburg,5515,1,14,8,2,44,18,26,50
SK Sturm Gra,5515,2,12,5,7,34,28,6,41
Rapid Vienna,5515,3,8,11,5,33,27,6,35
LASK Linz,5515,4,8,6,10,27,29,-2,30
Vienna,5515,5,7,5,12,26,41,-15,26
Mattersburg,5515,6,6,6,12,31,42,-11,24
SC Rheindorf,5515,7,4,9,11,17,27,-10,21
FC Salzburg,5516,1,15,7,2,43,16,27,52
Rapid Vienna,5516,2,10,10,4,40,26,14,40
SK Sturm Gra,5516,3,12,3,9,32,29,3,39
LASK Linz,5516,4,7,5,12,25,34,-9,26
Mattersburg,5516,5,6,7,11,33,41,-8,25
SC Rheindorf,5516,6,6,6,12,20,32,-12,24
Vienna,5516,7,6,6,12,25,40,-15,24
FC Salzburg,5517,1,14,7,3,43,18,25,49
SK Sturm Gra,5517,2,12,4,8,30,29,1,40
Rapid Vienna,5517,3,8,12,4,35,26,9,36
Mattersburg,5517,4,8,6,10,35,38,-3,30
LASK Linz,5517,5,7,6,11,25,33,-8,27
SC Rheindorf,5517,6,6,6,12,23,29,-6,24
Vienna,5517,7,6,5,13,24,42,-18,23
FC Salzburg,5518,1,15,7,2,54,20,34,52
Rapid Vienna,5518,2,9,11,4,37,26,11,38
SK Sturm Gra,5518,3,11,4,9,31,34,-3,37
SC Rheindorf,5518,4,7,6,11,24,27,-3,27
LASK Linz,5518,5,7,6,11,24,32,-8,27
Mattersburg,5518,6,7,5,12,30,44,-14,26
Vienna,5518,7,6,5,13,25,42,-17,23
FC Salzburg,5519,1,14,8,2,45,18,27,50
SK Sturm Gra,5519,2,12,3,9,31,31,0,39
Rapid Vienna,5519,3,8,11,5,38,30,8,35
LASK Linz,5519,4,8,6,10,29,29,0,30
Vienna,5519,5,7,6,11,27,39,-12,27
SC Rheindorf,5519,6,6,6,12,24,32,-8,24
Mattersburg,5519,7,6,6,12,31,46,-15,24
FC Salzburg,5520,1,13,6,5,41,21,20,45
SK Sturm Gra,5520,2,12,4,8,33,31,2,40
Rapid Vienna,5520,3,10,9,5,38,27,11,39
LASK Linz,5520,4,8,6,10,29,29,0,30
Mattersburg,5520,5,7,7,10,31,39,-8,28
Vienna,5520,6,7,6,11,27,39,-12,27
SC Rheindorf,5520,7,5,6,13,20,33,-13,21
FC Salzburg,5521,1,14,6,4,43,19,24,48
SK Sturm Gra,5521,2,12,4,8,31,29,2,40
Rapid Vienna,5521,3,9,11,4,35,25,10,38
Vienna,5521,4,8,5,11,26,38,-12,29
LASK Linz,5521,5,7,6,11,26,30,-4,27
Mattersburg,5521,6,6,6,12,29,40,-11,24
SC Rheindorf,5521,7,5,8,11,18,27,-9,23
FC Salzburg,5522,1,15,7,2,47,18,29,52
SK Sturm Gra,5522,2,12,6,6,34,28,6,42
Rapid Vienna,5522,3,8,9,7,35,28,7,33
LASK Linz,5522,4,8,7,9,26,29,-3,31
Vienna,5522,5,7,5,12,26,39,-13,26
Mattersburg,5522,6,6,6,12,29,43,-14,24
SC Rheindorf,5522,7,5,6,13,20,32,-12,21
FC Salzburg,5523,1,15,7,2,49,20,29,52
SK Sturm Gra,5523,2,12,5,7,32,27,5,41
Rapid Vienna,5523,3,8,11,5,39,27,12,35
LASK Linz,5523,4,8,7,9,27,29,-2,31
Mattersburg,5523,5,7,6,11,33,44,-11,27
Vienna,5523,6,6,6,12,25,40,-15,24
SC Rheindorf,5523,7,4,6,14,16,34,-18,18
FC Salzburg,5524,1,15,7,2,49,17,32,52
Rapid Vienna,5524,2,9,10,5,38,29,9,37
LASK Linz,5524,3,10,6,8,34,29,5,36
SK Sturm Gra,5524,4,11,3,10,30,32,-2,36
Vienna,5524,5,7,5,12,29,39,-10,26
SC Rheindorf,5524,6,6,6,12,19,31,-12,24
Mattersburg,5524,7,5,5,14,30,52,-22,20
FC Salzburg,5525,1,14,7,3,44,20,24,49
SK Sturm Gra,5525,2,12,4,8,32,28,4,40
LASK Linz,5525,3,10,6,8,28,26,2,36
Rapid Vienna,5525,4,8,11,5,36,29,7,35
Vienna,5525,5,7,6,11,28,41,-13,27
Mattersburg,5525,6,6,6,12,31,41,-10,24
SC Rheindorf,5525,7,4,6,14,18,32,-14,18
FC Salzburg,5526,1,15,7,2,48,16,32,52
SK Sturm Gra,5526,2,12,4,8,31,28,3,40
Rapid Vienna,5526,3,8,11,5,35,29,6,35
LASK Linz,5526,4,8,7,9,27,29,-2,31
Vienna,5526,5,7,6,11,25,38,-13,27
Mattersburg,5526,6,6,6,12,32,42,-10,24
SC Rheindorf,5526,7,5,5,14,17,33,-16,20
FC Salzburg,5527,1,15,7,2,48,19,29,52
SK Sturm Gra,5527,2,13,4,7,35,29,6,43
Rapid Vienna,5527,3,9,9,6,38,30,8,36
LASK Linz,5527,4,8,6,10,25,29,-4,30
Vienna,5527,5,7,5,12,27,41,-14,26
Mattersburg,5527,6,6,6,12,31,43,-12,24
SC Rheindorf,5527,7,5,5,14,18,31,-13,20
FC Salzburg,5528,1,13,9,2,44,18,26,48
SK Sturm Gra,5528,2,11,5,8,31,31,0,38
Rapid Vienna,5528,3,8,11,5,34,28,6,35
LASK Linz,5528,4,9,6,9,29,27,2,33
Mattersburg,5528,5,7,6,11,33,39,-6,27
Vienna,5528,6,6,6,12,24,41,-17,24
SC Rheindorf,5528,7,6,5,13,18,29,-11,23
FC Salzburg,5529,1,15,6,3,48,21,27,51
SK Sturm Gra,5529,2,15,3,6,41,27,14,48
Rapid Vienna,5529,3,8,9,7,39,31,8,33
LASK Linz,5529,4,9,5,10,27,29,-2,32
Vienna,5529,5,7,5,12,25,39,-14,26
SC Rheindorf,5529,6,6,5,13,21,34,-13,23
Mattersburg,5529,7,5,5,14,27,47,-20,20
FC Salzburg,5530,1,15,7,2,46,15,31,52
SK Sturm Gra,5530,2,13,4,7,34,28,6,43
Rapid Vienna,5530,3,9,10,5,35,25,10,37
LASK Linz,5530,4,7,6,11,28,37,-9,27
Mattersburg,5530,5,7,5,12,35,47,-12,26
Vienna,5530,6,7,5,12,26,39,-13,26
SC Rheindorf,5530,7,4,7,13,18,31,-13,19
FC Salzburg,5531,1,15,7,2,47,17,30,52
SK Sturm Gra,5531,2,12,3,9,31,30,1,39
Rapid Vienna,5531,3,8,11,5,36,28,8,35
LASK Linz,5531,4,8,6,10,27,28,-1,30
Mattersburg,5531,5,7,5,12,31,40,-9,26
SC Rheindorf,5531,6,7,5,12,19,28,-9,26
Vienna,5531,7,6,5,13,23,43,-20,23
FC Salzburg,5532,1,15,6,3,50,20,30,51
SK Sturm Gra,5532,2,13,3,8,33,29,4,42
Rapid Vienna,5532,3,8,10,6,35,31,4,34
Mattersburg,5532,4,7,6,11,32,42,-10,27
Vienna,5532,5,7,6,11,27,40,-13,27
LASK Linz,5532,6,7,5,12,24,30,-6,26
SC Rheindorf,5532,7,6,6,12,21,30,-9,24
FC Salzburg,5533,1,14,7,3,44,20,24,49
SK Sturm Gra,5533,2,12,6,6,32,27,5,42
LASK Linz,5533,3,9,7,8,29,28,1,34
Rapid Vienna,5533,4,7,11,6,33,27,6,32
Vienna,5533,5,7,6,11,28,41,-13,27
SC Rheindorf,5533,6,5,7,12,19,27,-8,22
Mattersburg,5533,7,5,6,13,32,47,-15,21
FC Salzburg,5534,1,14,8,2,45,17,28,50
SK Sturm Gra,5534,2,13,4,7,34,29,5,43
Rapid Vienna,5534,3,9,10,5,39,30,9,37
LASK Linz,5534,4,8,7,9,28,29,-1,31
Vienna,5534,5,6,7,11,26,40,-14,25
Mattersburg,5534,6,5,7,12,28,42,-14,22
SC Rheindorf,5534,7,4,7,13,18,31,-13,19
FC Salzburg,5535,1,15,7,2,51,21,30,52
SK Sturm Gra,5535,2,13,4,7,32,29,3,43
Rapid Vienna,5535,3,7,10,7,35,31,4,31
LASK Linz,5535,4,8,7,9,27,29,-2,31
Vienna,5535,5,7,5,12,28,41,-13,26
Mattersburg,5535,6,6,6,12,31,44,-13,24
SC Rheindorf,5535,7,6,5,13,21,30,-9,23
FC Salzburg,5536,1,14,6,4,41,19,22,48
SK Sturm Gra,5536,2,12,4,8,30,28,2,40
LASK Linz,5536,3,10,6,8,28,26,2,36
Rapid Vienna,5536,4,8,9,7,36,27,9,33
Mattersburg,5536,5,8,5,11,32,39,-7,29
Vienna,5536,6,7,5,12,26,39,-13,26
SC Rheindorf,5536,7,5,5,14,21,36,-15,20
FC Salzburg,5537,1,13,8,3,42,20,22,47
SK Sturm Gra,5537,2,12,5,7,33,29,4,41
Rapid Vienna,5537,3,8,11,5,36,28,8,35
LASK Linz,5537,4,9,5,10,29,30,-1,32
Mattersburg,5537,5,7,6,11,33,42,-9,27
Vienna,5537,6,7,6,11,27,39,-12,27
SC Rheindorf,5537,7,4,7,13,18,30,-12,19
FC Salzburg,5538,1,15,6,3,46,21,25,51
SK Sturm Gra,5538,2,13,3,8,37,30,7,42
Rapid Vienna,5538,3,10,9,5,37,26,11,39
LASK Linz,5538,4,8,5,11,29,35,-6,29
Mattersburg,5538,5,7,5,12,30,41,-11,26
SC Rheindorf,5538,6,6,5,13,20,30,-10,23
Vienna,5538,7,6,5,13,26,42,-16,23
FC Salzburg,5539,1,14,7,3,45,21,24,49
SK Sturm Gra,5539,2,12,5,7,33,31,2,41
Rapid Vienna,5539,3,9,10,5,39,27,12,37
LASK Linz,5539,4,8,5,11,30,33,-3,29
Mattersburg,5539,5,8,5,11,40,44,-4,29
Vienna,5539,6,6,5,13,26,44,-18,23
SC Rheindorf,5539,7,5,7,12,18,31,-13,22
FC Salzburg,5540,1,14,6,4,44,21,23,48
SK Sturm Gra,5540,2,13,3,8,34,31,3,42
Rapid Vienna,5540,3,7,9,8,36,34,2,30
LASK Linz,5540,4,8,6,10,26,29,-3,30
Mattersburg,5540,5,8,6,10,35,39,-4,30
Vienna,5540,6,7,6,11,26,39,-13,27
SC Rheindorf,5540,7,6,6,12,23,31,-8,24
FC Salzburg,5541,1,15,6,3,47,20,27,51
SK Sturm Gra,5541,2,12,4,8,32,32,0,40
Rapid Vienna,5541,3,7,11,6,35,29,6,32
LASK Linz,5541,4,9,5,10,28,29,-1,32
SC Rheindorf,5541,5,7,6,11,23,28,-5,27
Vienna,5541,6,7,5,12,25,40,-15,26
Mattersburg,5541,7,6,5,13,31,43,-12,23
FC Salzburg,5542,1,14,8,2,45,18,27,50
SK Sturm Gra,5542,2,12,5,7,35,28,7,41
Rapid Vienna,5542,3,8,11,5,36,31,5,35
LASK Linz,5542,4,8,7,9,28,30,-2,31
Mattersburg,5542,5,7,5,12,32,43,-11,26
Vienna,5542,6,6,6,12,24,40,-16,24
SC Rheindorf,5542,7,5,6,13,19,29,-10,21
FC Salzburg,5543,1,15,7,2,45,17,28,52
SK Sturm Gra,5543,2,12,5,7,32,28,4,41
Rapid Vienna,5543,3,8,10,6,34,28,6,34
LASK Linz,5543,4,7,7,10,27,31,-4,28
Vienna,5543,5,7,6,11,25,38,-13,27
Mattersburg,5543,6,7,5,12,34,44,-10,26
SC Rheindorf,5543,7,4,8,12,19,30,-11,20
FC Salzburg,5544,1,14,6,4,46,22,24,48
SK Sturm Gra,5544,2,12,5,7,32,28,4,41
Rapid Vienna,5544,3,9,11,4,33,23,10,38
LASK Linz,5544,4,7,7,10,27,31,-4,28
SC Rheindorf,5544,5,7,5,12,23,31,-8,26
Mattersburg,5544,6,6,6,12,36,47,-11,24
Vienna,5544,7,6,6,12,24,39,-15,24
FC Salzburg,5545,1,14,8,2,45,19,26,50
SK Sturm Gra,5545,2,12,5,7,34,30,4,41
Rapid Vienna,5545,3,9,10,5,38,28,10,37
LASK Linz,5545,4,10,5,9,30,28,2,35
Vienna,5545,5,7,5,12,25,40,-15,26
SC Rheindorf,5545,6,5,6,13,19,32,-13,21
Mattersburg,5545,7,5,5,14,29,43,-14,20
FC Salzburg,5546,1,16,6,2,45,16,29,54
SK Sturm Gra,5546,2,11,5,8,31,29,2,38
Rapid Vienna,5546,3,7,11,6,33,28,5,32
LASK Linz,5546,4,8,8,8,29,29,0,32
Vienna,5546,5,6,6,12,28,43,-15,24
SC Rheindorf,5546,6,5,8,11,18,27,-9,23
Mattersburg,5546,7,5,8,11,32,44,-12,23
FC Salzburg,5547,1,16,6,2,47,15,32,54
SK Sturm Gra,5547,2,14,3,7,34,28,6,45
Rapid Vienna,5547,3,7,11,6,33,28,5,32
LASK Linz,5547,4,8,6,10,25,28,-3,30
Vienna,5547,5,6,6,12,24,39,-15,24
SC Rheindorf,5547,6,5,7,12,18,29,-11,22
Mattersburg,5547,7,5,7,12,29,43,-14,22
FC Salzburg,5548,1,14,7,3,42,17,25,49
Rapid Vienna,5548,2,9,11,4,39,28,11,38
SK Sturm Gra,5548,3,11,5,8,31,30,1,38
LASK Linz,5548,4,8,7,9,29,29,0,31
Mattersburg,5548,5,7,5,12,34,42,-8,26
Vienna,5548,6,6,6,12,24,42,-18,24
SC Rheindorf,5548,7,5,7,12,20,31,-11,22
FC Salzburg,5549,1,15,6,3,49,19,30,51
Rapid Vienna,5549,2,9,10,5,36,28,8,37
SK Sturm Gra,5549,3,11,3,10,28,32,-4,36
LASK Linz,5549,4,10,5,9,29,28,1,35
Mattersburg,5549,5,7,5,12,35,46,-11,26
SC Rheindorf,5549,6,6,6,12,21,29,-8,24
Vienna,5549,7,6,5,13,27,43,-16,23
FC Salzburg,5550,1,15,6,3,45,22,23,51
SK Sturm Gra,5550,2,12,4,8,34,30,4,40
Rapid Vienna,5550,3,7,11,6,38,32,6,32
LASK Linz,5550,4,9,5,10,27,29,-2,32
Vienna,5550,5,8,5,11,27,37,-10,29
Mattersburg,5550,6,6,6,12,30,41,-11,24
SC Rheindorf,5550,7,5,7,12,23,33,-10,22
FC Salzburg,5551,1,14,7,3,48,20,28,49
LASK Linz,5551,2,11,5,8,29,24,5,38
SK Sturm Gra,5551,3,11,4,9,30,31,-1,37
Rapid Vienna,5551,4,8,11,5,37,30,7,35
Mattersburg,5551,5,7,5,12,31,43,-12,26
Vienna,5551,6,7,5,12,27,41,-14,26
SC Rheindorf,5551,7,5,5,14,19,32,-13,20
FC Salzburg,5552,1,13,8,3,44,20,24,47
SK Sturm Gra,5552,2,14,4,6,34,26,8,46
Rapid Vienna,5552,3,9,10,5,35,27,8,37
LASK Linz,5552,4,8,6,10,28,28,0,30
Mattersburg,5552,5,7,6,11,35,43,-8,27
Vienna,5552,6,6,6,12,23,39,-16,24
SC Rheindorf,5552,7,4,6,14,19,35,-16,18
FC Salzburg,5553,1,14,8,2,43,17,26,50
SK Sturm Gra,5553,2,12,5,7,34,29,5,41
Rapid Vienna,5553,3,9,11,4,36,26,10,38
LASK Linz,5553,4,7,8,9,23,25,-2,29
Vienna,5553,5,7,6,11,25,37,-12,27
Mattersburg,5553,6,6,6,12,30,41,-11,24
SC Rheindorf,5553,7,4,6,14,17,33,-16,18
FC Salzburg,5554,1,13,9,2,45,21,24,48
SK Sturm Gra,5554,2,12,4,8,35,36,-1,40
LASK Linz,5554,3,9,7,8,32,30,2,34
Rapid Vienna,5554,4,7,12,5,34,27,7,33
Vienna,5554,5,7,5,12,28,41,-13,26
SC Rheindorf,5554,6,6,6,12,25,29,-4,24
Mattersburg,5554,7,5,7,12,28,43,-15,22
FC Salzburg,5555,1,14,6,4,44,20,24,48
Rapid Vienna,5555,2,9,10,5,36,26,10,37
SK Sturm Gra,5555,3,11,4,9,30,31,-1,37
LASK Linz,5555,4,7,8,9,26,28,-2,29
SC Rheindorf,5555,5,7,6,11,22,28,-6,27
Vienna,5555,6,7,6,11,27,40,-13,27
Mattersburg,5555,7,5,8,11,32,44,-12,23
FC Salzburg,5556,1,14,6,4,45,20,25,48
SK Sturm Gra,5556,2,12,4,8,34,34,0,40
Rapid Vienna,5556,3,9,10,5,36,27,9,37
LASK Linz,5556,4,8,7,9,29,29,0,31
Vienna,5556,5,8,5,11,28,40,-12,29
Mattersburg,5556,6,7,5,12,33,40,-7,26
SC Rheindorf,5556,7,5,5,14,19,34,-15,20
FC Salzburg,5557,1,14,8,2,48,21,27,50
SK Sturm Gra,5557,2,13,3,8,35,33,2,42
Rapid Vienna,5557,3,8,11,5,37,28,9,35
Mattersburg,5557,4,7,7,10,38,41,-3,28
LASK Linz,5557,5,7,7,10,26,34,-8,28
Vienna,5557,6,6,5,13,26,42,-16,23
SC Rheindorf,5557,7,5,7,12,18,29,-11,22
FC Salzburg,5558,1,14,8,2,48,19,29,50
Rapid Vienna,5558,2,9,11,4,36,26,10,38
SK Sturm Gra,5558,3,11,5,8,32,30,2,38
LASK Linz,5558,4,8,7,9,28,29,-1,31
Mattersburg,5558,5,7,5,12,29,40,-11,26
Vienna,5558,6,6,5,13,24,43,-19,23
SC Rheindorf,5558,7,5,7,12,17,27,-10,22
FC Salzburg,5559,1,15,6,3,45,19,26,51
SK Sturm Gra,5559,2,13,4,7,33,29,4,43
Rapid Vienna,5559,3,9,10,5,36,25,11,37
LASK Linz,5559,4,8,7,9,29,28,1,31
Mattersburg,5559,5,6,6,12,30,44,-14,24
Vienna,5559,6,6,5,13,27,44,-17,23
SC Rheindorf,5559,7,5,6,13,20,31,-11,21
FC Salzburg,5560,1,14,6,4,43,20,23,48
SK Sturm Gra,5560,2,15,3,6,35,26,9,48
Rapid Vienna,5560,3,9,9,6,37,27,10,36
LASK Linz,5560,4,9,6,9,31,29,2,33
Vienna,5560,5,7,5,12,27,42,-15,26
Mattersburg,5560,6,5,6,13,31,46,-15,21
SC Rheindorf,5560,7,4,7,13,20,34,-14,19
FC Salzburg,5561,1,15,7,2,42,15,27,52
SK Sturm Gra,5561,2,12,4,8,30,28,2,40
Rapid Vienna,5561,3,9,10,5,34,25,9,37
LASK Linz,5561,4,9,7,8,29,26,3,34
Vienna,5561,5,7,5,12,25,39,-14,26
Mattersburg,5561,6,5,6,13,26,41,-15,21
SC Rheindorf,5561,7,4,7,13,17,29,-12,19
FC Salzburg,5562,1,13,8,3,43,20,23,47
SK Sturm Gra,5562,2,13,4,7,34,26,8,43
Rapid Vienna,5562,3,8,11,5,34,27,7,35
LASK Linz,5562,4,8,7,9,27,29,-2,31
Vienna,5562,5,7,6,11,25,38,-13,27
SC Rheindorf,5562,6,5,7,12,20,29,-9,22
Mattersburg,5562,7,5,7,12,30,44,-14,22
FC Salzburg,5563,1,14,7,3,44,18,26,49
SK Sturm Gra,5563,2,13,5,6,34,28,6,44
Rapid Vienna,5563,3,8,11,5,35,27,8,35
LASK Linz,5563,4,8,7,9,28,29,-1,31
Vienna,5563,5,6,6,12,25,42,-17,24
SC Rheindorf,5563,6,5,7,12,20,30,-10,22
Mattersburg,5563,7,5,7,12,29,41,-12,22
FC Salzburg,5564,1,16,6,2,46,17,29,54
SK Sturm Gra,5564,2,12,4,8,30,30,0,40
Rapid Vienna,5564,3,8,9,7,34,28,6,33
LASK Linz,5564,4,8,6,10,29,31,-2,30
Vienna,5564,5,7,5,12,28,40,-12,26
SC Rheindorf,5564,6,6,6,12,20,28,-8,24
Mattersburg,5564,7,6,6,12,31,44,-13,24
FC Salzburg,5565,1,16,6,2,48,16,32,54
SK Sturm Gra,5565,2,12,4,8,33,31,2,40
Rapid Vienna,5565,3,8,10,6,37,31,6,34
LASK Linz,5565,4,9,6,9,30,30,0,33
Vienna,5565,5,7,5,12,27,40,-13,26
Mattersburg,5565,6,6,6,12,32,46,-14,24
SC Rheindorf,5565,7,4,7,13,18,31,-13,19
FC Salzburg,5566,1,14,7,3,45,23,22,49
SK Sturm Gra,5566,2,11,5,8,33,33,0,38
Rapid Vienna,5566,3,9,10,5,41,30,11,37
LASK Linz,5566,4,9,6,9,31,29,2,33
Vienna,5566,5,7,5,12,27,40,-13,26
Mattersburg,5566,6,6,7,11,32,41,-9,25
SC Rheindorf,5566,7,5,6,13,19,32,-13,21
FC Salzburg,5567,1,14,8,2,43,15,28,50
SK Sturm Gra,5567,2,11,4,9,31,32,-1,37
Rapid Vienna,5567,3,8,12,4,35,25,10,36
LASK Linz,5567,4,8,7,9,28,29,-1,31
Vienna,5567,5,7,6,11,25,38,-13,27
Mattersburg,5567,6,6,6,12,30,41,-11,24
SC Rheindorf,5567,7,6,5,13,19,31,-12,23
FC Salzburg,5568,1,15,7,2,49,18,31,52
SK Sturm Gra,5568,2,12,3,9,30,30,0,39
Rapid Vienna,5568,3,9,9,6,36,30,6,36
LASK Linz,5568,4,8,5,11,28,32,-4,29
Vienna,5568,5,7,6,11,27,40,-13,27
Mattersburg,5568,6,7,5,12,30,43,-13,26
SC Rheindorf,5568,7,6,5,13,22,29,-7,23
FC Salzburg,5569,1,15,7,2,43,17,26,52
SK Sturm Gra,5569,2,13,3,8,34,29,5,42
Rapid Vienna,5569,3,8,10,6,35,29,6,34
LASK Linz,5569,4,8,7,9,27,27,0,31
Vienna,5569,5,7,6,11,27,38,-11,27
SC Rheindorf,5569,6,5,7,12,20,28,-8,22
Mattersburg,5569,7,5,6,13,28,46,-18,21
FC Salzburg,5570,1,13,8,3,43,20,23,47
SK Sturm Gra,5570,2,12,5,7,31,28,3,41
Rapid Vienna,5570,3,8,11,5,35,28,7,35
LASK Linz,5570,4,9,5,10,29,29,0,32
Vienna,5570,5,7,6,11,27,39,-12,27
SC Rheindorf,5570,6,6,6,12,22,30,-8,24
Mattersburg,5570,7,5,7,12,28,41,-13,22
FC Salzburg,5571,1,15,7,2,53,18,35,52
SK Sturm Gra,5571,2,12,3,9,29,30,-1,39
Rapid Vienna,5571,3,8,12,4,37,26,11,36
LASK Linz,5571,4,7,8,9,25,27,-2,29
Mattersburg,5571,5,6,7,11,31,46,-15,25
Vienna,5571,6,6,6,12,26,44,-18,24
SC Rheindorf,5571,7,5,7,12,17,27,-10,22
FC Salzburg,5572,1,13,6,5,42,21,21,45
SK Sturm Gra,5572,2,13,4,7,33,27,6,43
Rapid Vienna,5572,3,9,11,4,34,24,10,38
LASK Linz,5572,4,7,8,9,26,28,-2,29
Vienna,5572,5,8,5,11,27,38,-11,29
Mattersburg,5572,6,6,6,12,29,42,-13,24
SC Rheindorf,5572,7,5,6,13,19,30,-11,21
FC Salzburg,5573,1,14,8,2,44,16,28,50
SK Sturm Gra,5573,2,12,3,9,32,31,1,39
Rapid Vienna,5573,3,8,12,4,36,27,9,36
LASK Linz,5573,4,8,7,9,29,30,-1,31
Vienna,5573,5,7,6,11,25,37,-12,27
Mattersburg,5573,6,6,6,12,29,40,-11,24
SC Rheindorf,5573,7,5,6,13,19,33,-14,21
FC Salzburg,5574,1,13,8,3,43,21,22,47
SK Sturm Gra,5574,2,11,5,8,30,31,-1,38
Rapid Vienna,5574,3,7,12,5,34,28,6,33
LASK Linz,5574,4,8,7,9,25,26,-1,31
Vienna,5574,5,8,5,11,30,37,-7,29
SC Rheindorf,5574,6,7,5,12,22,28,-6,26
Mattersburg,5574,7,6,6,12,29,42,-13,24
FC Salzburg,5575,1,15,7,2,46,17,29,52
SK Sturm Gra,5575,2,12,5,7,34,30,4,41
Rapid Vienna,5575,3,9,9,6,35,27,8,36
LASK Linz,5575,4,9,6,9,29,29,0,33
Mattersburg,5575,5,7,5,12,30,41,-11,26
Vienna,5575,6,6,5,13,23,40,-17,23
SC Rheindorf,5575,7,4,7,13,17,30,-13,19
FC Salzburg,5576,1,13,9,2,43,19,24,48
SK Sturm Gra,5576,2,14,4,6,34,26,8,46
Rapid Vienna,5576,3,7,11,6,33,27,6,32
LASK Linz,5576,4,8,6,10,25,28,-3,30
Vienna,5576,5,7,6,11,29,39,-10,27
SC Rheindorf,5576,6,6,6,12,18,27,-9,24
Mattersburg,5576,7,5,6,13,28,44,-16,21
FC Salzburg,5577,1,15,7,2,48,19,29,52
SK Sturm Gra,5577,2,14,3,7,37,29,8,45
Rapid Vienna,5577,3,7,10,7,34,32,2,31
LASK Linz,5577,4,7,6,11,26,32,-6,27
Mattersburg,5577,5,7,6,11,29,41,-12,27
Vienna,5577,6,7,5,12,28,39,-11,26
SC Rheindorf,5577,7,6,5,13,20,30,-10,23
FC Salzburg,5578,1,16,6,2,47,16,31,54
SK Sturm Gra,5578,2,13,3,8,35,31,4,42
Rapid Vienna,5578,3,8,10,6,33,27,6,34
SC Rheindorf,5578,4,7,6,11,24,27,-3,27
LASK Linz,5578,5,7,5,12,27,34,-7,26
Mattersburg,5578,6,7,5,12,31,44,-13,26
Vienna,5578,7,6,5,13,23,41,-18,23
FC Salzburg,5579,1,14,8,2,46,18,28,50
SK Sturm Gra,5579,2,12,4,8,31,29,2,40
Rapid Vienna,5579,3,8,11,5,35,28,7,35
LASK Linz,5579,4,9,6,9,28,27,1,33
Vienna,5579,5,7,5,12,25,41,-16,26
Mattersburg,5579,6,6,5,13,31,44,-13,23
SC Rheindorf,5579,7,5,7,12,21,30,-9,22
FC Salzburg,5580,1,13,8,3,44,20,24,47
SK Sturm Gra,5580,2,12,5,7,34,30,4,41
Rapid Vienna,5580,3,10,9,5,39,27,12,39
LASK Linz,5580,4,8,6,10,25,30,-5,30
Vienna,5580,5,7,6,11,27,40,-13,27
Mattersburg,5580,6,6,5,13,31,43,-12,23
SC Rheindorf,5580,7,5,7,12,19,29,-10,22
FC Salzburg,5581,1,15,7,2,47,18,29,52
SK Sturm Gra,5581,2,12,5,7,33,28,5,41
Rapid Vienna,5581,3,9,9,6,37,29,8,36
LASK Linz,5581,4,9,5,10,26,29,-3,32
Mattersburg,5581,5,8,5,11,33,41,-8,29
Vienna,5581,6,6,5,13,25,41,-16,23
SC Rheindorf,5581,7,4,6,14,18,33,-15,18
FC Salzburg,5582,1,15,6,3,44,18,26,51
SK Sturm Gra,5582,2,14,3,7,37,31,6,45
Rapid Vienna,5582,3,7,11,6,32,26,6,32
LASK Linz,5582,4,8,7,9,26,28,-2,31
Vienna,5582,5,6,6,12,24,39,-15,24
Mattersburg,5582,6,5,8,11,31,43,-12,23
SC Rheindorf,5582,7,5,7,12,21,30,-9,22
FC Salzburg,5583,1,14,7,3,43,18,25,49
SK Sturm Gra,5583,2,13,4,7,35,27,8,43
LASK Linz,5583,3,8,6,10,27,28,-1,30
Rapid Vienna,5583,4,7,9,8,33,35,-2,30
Mattersburg,5583,5,8,5,11,32,40,-8,29
Vienna,5583,6,7,6,11,27,40,-13,27
SC Rheindorf,5583,7,5,7,12,19,28,-9,22
FC Salzburg,5584,1,14,7,3,45,19,26,49
Rapid Vienna,5584,2,10,10,4,38,26,12,40
SK Sturm Gra,5584,3,11,4,9,30,29,1,37
LASK Linz,5584,4,8,7,9,28,29,-1,31
Mattersburg,5584,5,7,5,12,31,45,-14,26
Vienna,5584,6,6,6,12,26,41,-15,24
SC Rheindorf,5584,7,5,7,12,20,29,-9,22
FC Salzburg,5585,1,15,7,2,47,20,27,52
SK Sturm Gra,5585,2,13,4,7,33,28,5,43
Rapid Vienna,5585,3,9,9,6,35,25,10,36
LASK Linz,5585,4,8,5,11,25,31,-6,29
Mattersburg,5585,5,7,5,12,37,43,-6,26
SC Rheindorf,5585,6,6,5,13,18,29,-11,23
Vienna,5585,7,6,5,13,26,45,-19,23
FC Salzburg,5586,1,14,8,2,44,17,27,50
SK Sturm Gra,5586,2,12,4,8,34,32,2,40
Rapid Vienna,5586,3,8,10,6,36,30,6,34
LASK Linz,5586,4,8,5,11,26,32,-6,29
SC Rheindorf,5586,5,7,6,11,24,29,-5,27
Mattersburg,5586,6,6,7,11,32,40,-8,25
Vienna,5586,7,6,6,12,25,41,-16,24
FC Salzburg,5587,1,14,8,2,50,21,29,50
Rapid Vienna,5587,2,10,10,4,42,27,15,40
SK Sturm Gra,5587,3,12,4,8,32,34,-2,40
LASK Linz,5587,4,8,6,10,29,30,-1,30
Vienna,5587,5,7,6,11,27,40,-13,27
SC Rheindorf,5587,6,5,6,13,17,30,-13,21
Mattersburg,5587,7,5,6,13,28,43,-15,21
FC Salzburg,5588,1,14,7,3,45,19,26,49
SK Sturm Gra,5588,2,11,4,9,28,29,-1,37
Rapid Vienna,5588,3,9,9,6,35,26,9,36
LASK Linz,5588,4,9,7,8,27,26,1,34
Vienna,5588,5,7,6,11,27,40,-13,27
Mattersburg,5588,6,6,7,11,32,42,-10,25
SC Rheindorf,5588,7,5,6,13,18,30,-12,21
FC Salzburg,5589,1,13,8,3,43,20,23,47
SK Sturm Gra,5589,2,11,6,7,31,29,2,39
Rapid Vienna,5589,3,8,11,5,35,27,8,35
LASK Linz,5589,4,7,8,9,27,29,-2,29
SC Rheindorf,5589,5,7,6,11,27,32,-5,27
Vienna,5589,6,6,7,11,24,38,-14,25
Mattersburg,5589,7,5,8,11,28,40,-12,23
FC Salzburg,5590,1,16,6,2,47,15,32,54
Rapid Vienna,5590,2,10,9,5,39,27,12,39
SK Sturm Gra,5590,3,11,4,9,32,32,0,37
LASK Linz,5590,4,8,6,10,27,29,-2,30
SC Rheindorf,5590,5,7,5,12,19,30,-11,26
Mattersburg,5590,6,6,5,13,30,45,-15,23
Vienna,5590,7,6,5,13,26,42,-16,23
FC Salzburg,5591,1,14,7,3,47,23,24,49
SK Sturm Gra,5591,2,12,5,7,33,30,3,41
Rapid Vienna,5591,3,9,11,4,41,26,15,38
LASK Linz,5591,4,8,7,9,25,26,-1,31
Vienna,5591,5,7,6,11,27,40,-13,27
Mattersburg,5591,6,6,5,13,29,44,-15,23
SC Rheindorf,5591,7,5,5,14,18,31,-13,20
FC Salzburg,5592,1,16,6,2,47,20,27,54
SK Sturm Gra,5592,2,12,3,9,32,31,1,39
Rapid Vienna,5592,3,9,9,6,38,28,10,36
LASK Linz,5592,4,8,7,9,27,28,-1,31
Vienna,5592,5,7,5,12,25,39,-14,26
SC Rheindorf,5592,6,6,6,12,21,30,-9,24
Mattersburg,5592,7,5,6,13,29,43,-14,21
FC Salzburg,5593,1,13,6,5,44,20,24,45
SK Sturm Gra,5593,2,13,4,7,33,33,0,43
Rapid Vienna,5593,3,8,9,7,35,27,8,33
Mattersburg,5593,4,8,6,10,31,38,-7,30
LASK Linz,5593,5,8,5,11,27,32,-5,29
Vienna,5593,6,7,6,11,24,37,-13,27
SC Rheindorf,5593,7,6,6,12,22,29,-7,24
FC Salzburg,5594,1,13,8,3,42,18,24,47
Rapid Vienna,5594,2,10,10,4,34,23,11,40
SK Sturm Gra,5594,3,11,7,6,30,26,4,40
LASK Linz,5594,4,8,7,9,28,28,0,31
Mattersburg,5594,5,7,6,11,35,40,-5,27
Vienna,5594,6,6,5,13,23,45,-22,23
SC Rheindorf,5594,7,4,7,13,18,30,-12,19
FC Salzburg,5595,1,14,6,4,44,20,24,48
SK Sturm Gra,5595,2,13,3,8,32,30,2,42
Rapid Vienna,5595,3,10,10,4,39,25,14,40
LASK Linz,5595,4,8,6,10,27,30,-3,30
Mattersburg,5595,5,7,6,11,32,41,-9,27
Vienna,5595,6,6,5,13,23,40,-17,23
SC Rheindorf,5595,7,4,8,12,21,32,-11,20
FC Salzburg,5596,1,14,7,3,42,18,24,49
SK Sturm Gra,5596,2,13,4,7,34,26,8,43
Rapid Vienna,5596,3,8,9,7,33,29,4,33
LASK Linz,5596,4,8,5,11,28,35,-7,29
Mattersburg,5596,5,7,6,11,38,43,-5,27
SC Rheindorf,5596,6,7,5,12,19,28,-9,26
Vienna,5596,7,6,6,12,28,43,-15,24
FC Salzburg,5597,1,14,8,2,46,17,29,50
SK Sturm Gra,5597,2,13,3,8,31,29,2,42
Rapid Vienna,5597,3,8,12,4,37,26,11,36
LASK Linz,5597,4,8,6,10,28,32,-4,30
Vienna,5597,5,7,6,11,29,41,-12,27
Mattersburg,5597,6,6,6,12,35,49,-14,24
SC Rheindorf,5597,7,4,7,13,19,31,-12,19
FC Salzburg,5598,1,15,7,2,44,17,27,52
SK Sturm Gra,5598,2,12,4,8,34,33,1,40
Rapid Vienna,5598,3,7,12,5,36,29,7,33
LASK Linz,5598,4,9,5,10,29,30,-1,32
Vienna,5598,5,7,5,12,27,41,-14,26
SC Rheindorf,5598,6,6,6,12,24,30,-6,24
Mattersburg,5598,7,6,5,13,32,46,-14,23
FC Salzburg,5599,1,14,7,3,44,18,26,49
SK Sturm Gra,5599,2,14,3,7,35,26,9,45
Rapid Vienna,5599,3,8,11,5,35,26,9,35
LASK Linz,5599,4,8,6,10,27,31,-4,30
SC Rheindorf,5599,5,6,6,12,21,31,-10,24
Mattersburg,5599,6,6,6,12,30,42,-12,24
Vienna,5599,7,6,5,13,23,41,-18,23
FC Salzburg,5600,1,14,7,3,44,17,27,49
SK Sturm Gra,5600,2,12,5,7,32,28,4,41
Rapid Vienna,5600,3,9,11,4,37,27,10,38
LASK Linz,5600,4,7,7,10,28,31,-3,28
SC Rheindorf,5600,5,7,5,12,22,29,-7,26
Mattersburg,5600,6,6,6,12,30,44,-14,24
Vienna,5600,7,6,5,13,24,41,-17,23
FC Salzburg,5601,1,15,7,2,46,17,29,52
SK Sturm Gra,5601,2,12,4,8,35,31,4,40
LASK Linz,5601,3,10,6,8,29,26,3,36
Rapid Vienna,5601,4,8,9,7,36,33,3,33
Mattersburg,5601,5,6,7,11,31,41,-10,25
Vienna,5601,6,6,7,11,25,39,-14,25
SC Rheindorf,5601,7,4,6,14,18,33,-15,18
FC Salzburg,5602,1,13,8,3,44,21,23,47
SK Sturm Gra,5602,2,12,4,8,32,28,4,40
Rapid Vienna,5602,3,8,11,5,35,28,7,35
LASK Linz,5602,4,8,7,9,25,27,-2,31
Mattersburg,5602,5,8,6,10,37,38,-1,30
Vienna,5602,6,6,6,12,24,43,-19,24
SC Rheindorf,5602,7,5,6,13,18,30,-12,21
FC Salzburg,5603,1,14,8,2,48,22,26,50
SK Sturm Gra,5603,2,12,4,8,33,29,4,40
Rapid Vienna,5603,3,7,11,6,33,31,2,32
LASK Linz,5603,4,8,8,8,27,25,2,32
Mattersburg,5603,5,6,8,10,30,39,-9,26
Vienna,5603,6,6,6,12,26,41,-15,24
SC Rheindorf,5603,7,5,7,12,16,26,-10,22
FC Salzburg,5604,1,14,7,3,47,23,24,49
SK Sturm Gra,5604,2,14,3,7,39,31,8,45
Rapid Vienna,5604,3,10,9,5,39,27,12,39
LASK Linz,5604,4,9,5,10,28,30,-2,32
Vienna,5604,5,7,6,11,26,39,-13,27
SC Rheindorf,5604,6,5,5,14,18,31,-13,20
Mattersburg,5604,7,5,5,14,28,44,-16,20
FC Salzburg,5605,1,16,6,2,49,18,31,54
SK Sturm Gra,5605,2,12,4,8,35,30,5,40
Rapid Vienna,5605,3,9,9,6,35,28,7,36
Mattersburg,5605,4,8,5,11,34,44,-10,29
LASK Linz,5605,5,7,6,11,24,29,-5,27
SC Rheindorf,5605,6,6,5,13,19,30,-11,23
Vienna,5605,7,6,5,13,26,43,-17,23
FC Salzburg,5606,1,14,7,3,50,20,30,49
SK Sturm Gra,5606,2,14,3,7,33,27,6,45
LASK Linz,5606,3,9,7,8,29,27,2,34
Rapid Vienna,5606,4,7,10,7,36,32,4,31
Mattersburg,5606,5,6,7,11,27,41,-14,25
Vienna,5606,6,6,6,12,24,41,-17,24
SC Rheindorf,5606,7,5,6,13,19,30,-11,21
FC Salzburg,5607,1,14,7,3,42,17,25,49
SK Sturm Gra,5607,2,14,3,7,34,28,6,45
Rapid Vienna,5607,3,9,9,6,37,27,10,36
LASK Linz,5607,4,8,6,10,28,31,-3,30
SC Rheindorf,5607,5,6,6,12,19,27,-8,24
Vienna,5607,6,6,6,12,24,40,-16,24
Mattersburg,5607,7,5,7,12,30,44,-14,22
FC Salzburg,5608,1,13,7,4,41,19,22,46
SK Sturm Gra,5608,2,12,5,7,31,27,4,41
Rapid Vienna,5608,3,9,11,4,35,25,10,38
LASK Linz,5608,4,8,6,10,26,29,-3,30
SC Rheindorf,5608,5,7,5,12,21,27,-6,26
Vienna,5608,6,7,5,12,24,40,-16,26
Mattersburg,5608,7,6,5,13,32,43,-11,23
FC Salzburg,5609,1,12,10,2,44,21,23,46
SK Sturm Gra,5609,2,12,6,6,33,28,5,42
Rapid Vienna,5609,3,7,12,5,36,29,7,33
LASK Linz,5609,4,7,8,9,28,31,-3,29
Mattersburg,5609,5,7,7,10,34,40,-6,28
Vienna,5609,6,6,6,12,24,41,-17,24
SC Rheindorf,5609,7,5,7,12,20,29,-9,22
FC Salzburg,5610,1,16,6,2,47,17,30,54
SK Sturm Gra,5610,2,12,4,8,32,32,0,40
Rapid Vienna,5610,3,9,10,5,36,26,10,37
LASK Linz,5610,4,7,7,10,25,30,-5,28
Vienna,5610,5,6,6,12,26,41,-15,24
Mattersburg,5610,6,6,6,12,31,47,-16,24
SC Rheindorf,5610,7,6,5,13,24,28,-4,23
FC Salzburg,5611,1,15,6,3,46,20,26,51
SK Sturm Gra,5611,2,13,3,8,33,31,2,42
Rapid Vienna,5611,3,9,9,6,41,30,11,36
LASK Linz,5611,4,9,5,10,29,30,-1,32
Mattersburg,5611,5,7,6,11,33,42,-9,27
Vienna,5611,6,6,6,12,24,41,-17,24
SC Rheindorf,5611,7,5,5,14,19,31,-12,20
FC Salzburg,5612,1,15,7,2,47,20,27,52
SK Sturm Gra,5612,2,13,3,8,36,31,5,42
Rapid Vienna,5612,3,9,11,4,37,27,10,38
LASK Linz,5612,4,7,6,11,25,32,-7,27
Vienna,5612,5,7,5,12,27,41,-14,26
SC Rheindorf,5612,6,6,5,13,22,30,-8,23
Mattersburg,5612,7,6,5,13,30,43,-13,23
FC Salzburg,5613,1,15,7,2,48,17,31,52
SK Sturm Gra,5613,2,14,3,7,36,32,4,45
Rapid Vienna,5613,3,9,9,6,38,28,10,36
LASK Linz,5613,4,8,5,11,29,34,-5,29
Mattersburg,5613,5,7,6,11,32,41,-9,27
Vienna,5613,6,6,7,11,24,38,-14,25
SC Rheindorf,5613,7,4,5,15,17,34,-17,17
FC Salzburg,5614,1,15,6,3,50,20,30,51
LASK Linz,5614,2,11,5,8,31,26,5,38
SK Sturm Gra,5614,3,11,4,9,28,31,-3,37
Rapid Vienna,5614,4,9,9,6,34,27,7,36
Vienna,5614,5,7,6,11,26,39,-13,27
Mattersburg,5614,6,5,7,12,33,47,-14,22
SC Rheindorf,5614,7,4,7,13,19,31,-12,19
FC Salzburg,5615,1,15,6,3,48,21,27,51
SK Sturm Gra,5615,2,12,3,9,33,34,-1,39
Rapid Vienna,5615,3,9,9,6,41,31,10,36
LASK Linz,5615,4,9,5,10,29,30,-1,32
Vienna,5615,5,8,5,11,28,40,-12,29
Mattersburg,5615,6,6,6,12,32,43,-11,24
SC Rheindorf,5615,7,5,6,13,21,33,-12,21
FC Salzburg,5616,1,15,7,2,47,18,29,52
SK Sturm Gra,5616,2,12,5,7,33,27,6,41
Rapid Vienna,5616,3,7,10,7,33,32,1,31
LASK Linz,5616,4,8,7,9,27,28,-1,31
Mattersburg,5616,5,7,7,10,36,39,-3,28
Vienna,5616,6,6,5,13,23,43,-20,23
SC Rheindorf,5616,7,5,7,12,19,31,-12,22
FC Salzburg,5617,1,15,7,2,45,18,27,52
SK Sturm Gra,5617,2,13,3,8,31,29,2,42
Rapid Vienna,5617,3,8,9,7,35,28,7,33
Mattersburg,5617,4,8,6,10,33,39,-6,30
LASK Linz,5617,5,8,5,11,25,30,-5,29
SC Rheindorf,5617,6,6,5,13,20,29,-9,23
Vienna,5617,7,6,5,13,25,41,-16,23
FC Salzburg,5618,1,14,7,3,45,21,24,49
SK Sturm Gra,5618,2,12,5,7,31,27,4,41
Rapid Vienna,5618,3,8,11,5,35,28,7,35
Mattersburg,5618,4,8,5,11,36,43,-7,29
LASK Linz,5618,5,7,6,11,25,30,-5,27
Vienna,5618,6,7,5,12,29,43,-14,26
SC Rheindorf,5618,7,5,7,12,19,28,-9,22
FC Salzburg,5619,1,13,7,4,42,19,23,46
SK Sturm Gra,5619,2,14,4,6,35,26,9,46
Rapid Vienna,5619,3,9,11,4,36,26,10,38
LASK Linz,5619,4,7,7,10,26,30,-4,28
Vienna,5619,5,7,6,11,25,38,-13,27
Mattersburg,5619,6,7,5,12,31,41,-10,26
SC Rheindorf,5619,7,4,6,14,20,35,-15,18
FC Salzburg,5620,1,14,6,4,41,18,23,48
SK Sturm Gra,5620,2,14,3,7,36,28,8,45
Rapid Vienna,5620,3,8,9,7,35,30,5,33
LASK Linz,5620,4,9,6,9,30,29,1,33
Vienna,5620,5,8,5,11,27,39,-12,29
Mattersburg,5620,6,7,6,11,34,42,-8,27
SC Rheindorf,5620,7,4,5,15,16,33,-17,17
FC Salzburg,5621,1,14,7,3,43,19,24,49
SK Sturm Gra,5621,2,13,3,8,33,29,4,42
Rapid Vienna,5621,3,8,11,5,36,28,8,35
LASK Linz,5621,4,8,6,10,27,29,-2,30
Vienna,5621,5,8,5,11,27,38,-11,29
Mattersburg,5621,6,7,5,12,29,40,-11,26
SC Rheindorf,5621,7,5,5,14,19,31,-12,20
FC Salzburg,5622,1,15,6,3,48,18,30,51
SK Sturm Gra,5622,2,12,5,7,32,30,2,41
Rapid Vienna,5622,3,9,10,5,37,28,9,37
LASK Linz,5622,4,9,7,8,32,28,4,34
Mattersburg,5622,5,6,7,11,31,41,-10,25
Vienna,5622,6,6,5,13,25,43,-18,23
SC Rheindorf,5622,7,4,6,14,18,35,-17,18
FC Salzburg,5623,1,15,7,2,47,19,28,52
SK Sturm Gra,5623,2,13,4,7,32,27,5,43
Rapid Vienna,5623,3,8,9,7,35,31,4,33
LASK Linz,5623,4,8,8,8,26,26,0,32
Mattersburg,5623,5,7,7,10,34,40,-6,28
Vienna,5623,6,6,5,13,25,42,-17,23
SC Rheindorf,5623,7,4,6,14,18,32,-14,18
FC Salzburg,5624,1,14,7,3,47,19,28,49
SK Sturm Gra,5624,2,14,4,6,37,29,8,46
Rapid Vienna,5624,3,8,10,6,37,30,7,34
LASK Linz,5624,4,8,6,10,25,27,-2,30
SC Rheindorf,5624,5,6,6,12,19,28,-9,24
Mattersburg,5624,6,6,6,12,30,43,-13,24
Vienna,5624,7,6,5,13,24,43,-19,23
FC Salzburg,5625,1,15,6,3,44,17,27,51
SK Sturm Gra,5625,2,13,4,7,35,28,7,43
Rapid Vienna,5625,3,9,9,6,36,29,7,36
LASK Linz,5625,4,9,6,9,27,27,0,33
Mattersburg,5625,5,7,5,12,30,42,-12,26
Vienna,5625,6,6,5,13,24,41,-17,23
SC Rheindorf,5625,7,5,5,14,20,32,-12,20
FC Salzburg,5626,1,14,8,2,46,18,28,50
SK Sturm Gra,5626,2,13,4,7,33,27,6,43
Rapid Vienna,5626,3,8,10,6,35,30,5,34
LASK Linz,5626,4,8,7,9,28,30,-2,31
Mattersburg,5626,5,7,7,10,32,38,-6,28
Vienna,5626,6,6,6,12,23,40,-17,24
SC Rheindorf,5626,7,4,6,14,18,32,-14,18
FC Salzburg,5627,1,14,8,2,49,16,33,50
SK Sturm Gra,5627,2,11,6,7,31,28,3,39
Rapid Vienna,5627,3,8,12,4,37,27,10,36
LASK Linz,5627,4,8,7,9,28,30,-2,31
Vienna,5627,5,7,5,12,27,42,-15,26
Mattersburg,5627,6,7,5,12,30,46,-16,26
SC Rheindorf,5627,7,5,5,14,19,32,-13,20
FC Salzburg,5628,1,14,7,3,42,17,25,49
SK Sturm Gra,5628,2,13,4,7,34,26,8,43
Rapid Vienna,5628,3,8,9,7,35,33,2,33
LASK Linz,5628,4,9,6,9,27,27,0,33
Vienna,5628,5,7,6,11,27,40,-13,27
Mattersburg,5628,6,6,6,12,29,42,-13,24
SC Rheindorf,5628,7,5,6,13,20,29,-9,21
FC Salzburg,5629,1,14,6,4,44,20,24,48
SK Sturm Gra,5629,2,14,3,7,36,29,7,45
Rapid Vienna,5629,3,8,10,6,34,29,5,34
LASK Linz,5629,4,9,5,10,30,28,2,32
SC Rheindorf,5629,5,7,6,11,21,28,-7,27
Vienna,5629,6,6,6,12,26,41,-15,24
Mattersburg,5629,7,5,6,13,27,43,-16,21
FC Salzburg,5630,1,14,7,3,47,21,26,49
SK Sturm Gra,5630,2,13,4,7,36,29,7,43
Rapid Vienna,5630,3,9,9,6,38,32,6,36
LASK Linz,5630,4,10,5,9,30,27,3,35
Vienna,5630,5,7,5,12,27,41,-14,26
Mattersburg,5630,6,6,5,13,30,45,-15,23
SC Rheindorf,5630,7,5,5,14,17,30,-13,20
FC Salzburg,5631,1,15,7,2,44,17,27,52
SK Sturm Gra,5631,2,13,4,7,34,26,8,43
Rapid Vienna,5631,3,7,11,6,35,32,3,32
LASK Linz,5631,4,7,7,10,26,29,-3,28
Mattersburg,5631,5,7,7,10,32,40,-8,28
Vienna,5631,6,6,5,13,25,41,-16,23
SC Rheindorf,5631,7,5,7,12,17,28,-11,22
FC Salzburg,5632,1,14,7,3,43,19,24,49
SK Sturm Gra,5632,2,12,4,8,30,27,3,40
Rapid Vienna,5632,3,10,9,5,39,27,12,39
LASK Linz,5632,4,9,5,10,29,31,-2,32
SC Rheindorf,5632,5,6,6,12,24,34,-10,24
Vienna,5632,6,6,6,12,24,42,-18,24
Mattersburg,5632,7,6,5,13,35,44,-9,23
FC Salzburg,5633,1,16,6,2,51,18,33,54
Rapid Vienna,5633,2,10,9,5,41,29,12,39
SK Sturm Gra,5633,3,11,3,10,31,33,-2,36
LASK Linz,5633,4,9,5,10,26,29,-3,32
SC Rheindorf,5633,5,7,5,12,22,29,-7,26
Vienna,5633,6,6,6,12,26,43,-17,24
Mattersburg,5633,7,5,6,13,27,43,-16,21
FC Salzburg,5634,1,15,6,3,44,18,26,51
Rapid Vienna,5634,2,10,9,5,36,26,10,39
SK Sturm Gra,5634,3,12,3,9,33,31,2,39
LASK Linz,5634,4,8,6,10,26,29,-3,30
Vienna,5634,5,7,5,12,24,38,-14,26
SC Rheindorf,5634,6,6,6,12,21,28,-7,24
Mattersburg,5634,7,6,5,13,28,42,-14,23
FC Salzburg,5635,1,15,7,2,48,19,29,52
SK Sturm Gra,5635,2,12,3,9,31,28,3,39
Rapid Vienna,5635,3,9,11,4,37,24,13,38
LASK Linz,5635,4,8,6,10,29,31,-2,30
Mattersburg,5635,5,6,6,12,34,48,-14,24
Vienna,5635,6,6,6,12,25,41,-16,24
SC Rheindorf,5635,7,6,5,13,19,32,-13,23
FC Salzburg,5636,1,15,6,3,47,20,27,51
SK Sturm Gra,5636,2,12,3,9,32,30,2,39
Rapid Vienna,5636,3,9,10,5,37,28,9,37
LASK Linz,5636,4,9,6,9,28,27,1,33
SC Rheindorf,5636,5,7,5,12,25,30,-5,26
Vienna,5636,6,7,5,12,26,39,-13,26
Mattersburg,5636,7,5,5,14,28,49,-21,20
FC Salzburg,5637,1,16,6,2,51,17,34,54
SK Sturm Gra,5637,2,13,3,8,32,29,3,42
LASK Linz,5637,3,9,5,10,26,27,-1,32
Rapid Vienna,5637,4,7,10,7,32,30,2,31
Mattersburg,5637,5,6,7,11,30,42,-12,25
Vienna,5637,6,6,6,12,24,41,-17,24
SC Rheindorf,5637,7,5,7,12,19,28,-9,22
FC Salzburg,5638,1,15,6,3,46,19,27,51
SK Sturm Gra,5638,2,13,3,8,32,28,4,42
Rapid Vienna,5638,3,9,10,5,33,25,8,37
LASK Linz,5638,4,9,5,10,29,29,0,32
Mattersburg,5638,5,7,5,12,32,43,-11,26
Vienna,5638,6,7,5,12,25,39,-14,26
SC Rheindorf,5638,7,4,6,14,15,29,-14,18
FC Salzburg,5639,1,15,6,3,45,19,26,51
SK Sturm Gra,5639,2,13,3,8,34,31,3,42
Rapid Vienna,5639,3,8,10,6,38,28,10,34
LASK Linz,5639,4,7,7,10,23,28,-5,28
Mattersburg,5639,5,7,6,11,34,39,-5,27
Vienna,5639,6,7,6,11,25,38,-13,27
SC Rheindorf,5639,7,5,6,13,17,33,-16,21
FC Salzburg,5640,1,14,7,3,43,19,24,49
SK Sturm Gra,5640,2,12,4,8,33,30,3,40
LASK Linz,5640,3,9,6,9,29,29,0,33
Rapid Vienna,5640,4,7,11,6,33,29,4,32
Vienna,5640,5,8,5,11,30,40,-10,29
Mattersburg,5640,6,6,6,12,33,44,-11,24
SC Rheindorf,5640,7,4,9,11,18,28,-10,21
FC Salzburg,5641,1,14,8,2,43,18,25,50
Rapid Vienna,5641,2,10,10,4,39,25,14,40
SK Sturm Gra,5641,3,12,4,8,31,26,5,40
LASK Linz,5641,4,8,6,10,30,33,-3,30
Mattersburg,5641,5,7,6,11,32,40,-8,27
Vienna,5641,6,6,6,12,25,40,-15,24
SC Rheindorf,5641,7,4,6,14,16,34,-18,18
FC Salzburg,5642,1,14,7,3,48,21,27,49
SK Sturm Gra,5642,2,14,3,7,38,30,8,45
LASK Linz,5642,3,10,5,9,33,30,3,35
Rapid Vienna,5642,4,8,9,7,37,35,2,33
Vienna,5642,5,8,5,11,29,41,-12,29
Mattersburg,5642,6,6,6,12,32,42,-10,24
SC Rheindorf,5642,7,4,5,15,16,34,-18,17
FC Salzburg,5643,1,16,6,2,49,17,32,54
Rapid Vienna,5643,2,9,10,5,40,29,11,37
SK Sturm Gra,5643,3,11,4,9,30,34,-4,37
LASK Linz,5643,4,7,7,10,25,28,-3,28
Mattersburg,5643,5,7,6,11,33,42,-9,27
SC Rheindorf,5643,6,5,8,11,21,30,-9,23
Vienna,5643,7,6,5,13,25,43,-18,23
FC Salzburg,5644,1,13,8,3,40,16,24,47
SK Sturm Gra,5644,2,12,4,8,31,28,3,40
Rapid Vienna,5644,3,7,12,5,34,28,6,33
LASK Linz,5644,4,9,6,9,28,30,-2,33
SC Rheindorf,5644,5,7,6,11,23,27,-4,27
Mattersburg,5644,6,6,7,11,30,39,-9,25
Vienna,5644,7,6,5,13,24,42,-18,23
FC Salzburg,5645,1,13,7,4,43,21,22,46
SK Sturm Gra,5645,2,13,4,7,35,28,7,43
Rapid Vienna,5645,3,7,11,6,32,29,3,32
LASK Linz,5645,4,8,6,10,26,29,-3,30
SC Rheindorf,5645,5,7,6,11,24,27,-3,27
Vienna,5645,6,7,6,11,26,39,-13,27
Mattersburg,5645,7,6,6,12,32,45,-13,24
FC Salzburg,5646,1,13,7,4,45,20,25,46
SK Sturm Gra,5646,2,14,3,7,33,28,5,45
Rapid Vienna,5646,3,10,9,5,38,27,11,39
LASK Linz,5646,4,8,6,10,26,28,-2,30
Vienna,5646,5,7,5,12,24,41,-17,26
Mattersburg,5646,6,6,7,11,31,39,-8,25
SC Rheindorf,5646,7,5,5,14,18,32,-14,20
FC Salzburg,5647,1,14,6,4,43,20,23,48
SK Sturm Gra,5647,2,13,4,7,34,29,5,43
Rapid Vienna,5647,3,9,10,5,38,27,11,37
LASK Linz,5647,4,8,7,9,30,32,-2,31
Vienna,5647,5,7,6,11,27,39,-12,27
Mattersburg,5647,6,5,7,12,30,43,-13,22
SC Rheindorf,5647,7,5,6,13,16,28,-12,21
FC Salzburg,5648,1,15,7,2,44,15,29,52
SK Sturm Gra,5648,2,13,4,7,35,30,5,43
Rapid Vienna,5648,3,9,9,6,35,28,7,36
LASK Linz,5648,4,7,8,9,27,30,-3,29
Vienna,5648,5,7,6,11,25,38,-13,27
Mattersburg,5648,6,5,7,12,28,41,-13,22
SC Rheindorf,5648,7,4,7,13,18,30,-12,19
FC Salzburg,5649,1,14,7,3,44,19,25,49
Rapid Vienna,5649,2,10,10,4,37,26,11,40
SK Sturm Gra,5649,3,11,4,9,33,33,0,37
LASK Linz,5649,4,9,6,9,30,27,3,33
Mattersburg,5649,5,6,6,12,32,44,-12,24
Vienna,5649,6,6,6,12,26,42,-16,24
SC Rheindorf,5649,7,5,7,12,18,29,-11,22
FC Salzburg,5650,1,14,7,3,44,20,24,49
SK Sturm Gra,5650,2,13,3,8,31,27,4,42
Rapid Vienna,5650,3,7,10,7,34,29,5,31
LASK Linz,5650,4,8,6,10,28,33,-5,30
Mattersburg,5650,5,7,6,11,36,43,-7,27
SC Rheindorf,5650,6,7,5,12,24,30,-6,26
Vienna,5650,7,7,5,12,25,40,-15,26
FC Salzburg,5651,1,16,6,2,45,16,29,54
SK Sturm Gra,5651,2,12,4,8,32,32,0,40
Rapid Vienna,5651,3,9,9,6,37,25,12,36
LASK Linz,5651,4,8,6,10,29,32,-3,30
Mattersburg,5651,5,6,6,12,31,41,-10,24
SC Rheindorf,5651,6,6,6,12,21,31,-10,24
Vienna,5651,7,6,5,13,23,41,-18,23
FC Salzburg,5652,1,15,6,3,46,17,29,51
SK Sturm Gra,5652,2,12,3,9,32,33,-1,39
Rapid Vienna,5652,3,8,11,5,36,28,8,35
Vienna,5652,4,8,5,11,28,38,-10,29
LASK Linz,5652,5,7,6,11,27,32,-5,27
SC Rheindorf,5652,6,7,6,11,21,26,-5,27
Mattersburg,5652,7,6,5,13,30,46,-16,23
FC Salzburg,5653,1,16,6,2,49,19,30,54
SK Sturm Gra,5653,2,13,3,8,37,33,4,42
Rapid Vienna,5653,3,8,10,6,35,29,6,34
LASK Linz,5653,4,8,6,10,28,30,-2,30
Mattersburg,5653,5,6,6,12,33,45,-12,24
SC Rheindorf,5653,6,5,8,11,21,30,-9,23
Vienna,5653,7,6,5,13,25,42,-17,23
FC Salzburg,5654,1,14,8,2,48,19,29,50
SK Sturm Gra,5654,2,12,4,8,36,35,1,40
Rapid Vienna,5654,3,9,10,5,40,29,11,37
LASK Linz,5654,4,8,6,10,28,31,-3,30
Vienna,5654,5,7,6,11,27,40,-13,27
Mattersburg,5654,6,6,6,12,30,42,-12,24
SC Rheindorf,5654,7,5,6,13,20,33,-13,21
FC Salzburg,5655,1,13,7,4,46,18,28,46
SK Sturm Gra,5655,2,13,4,7,31,25,6,43
Rapid Vienna,5655,3,8,10,6,35,29,6,34
Vienna,5655,4,8,5,11,28,38,-10,29
LASK Linz,5655,5,7,7,10,26,29,-3,28
SC Rheindorf,5655,6,7,6,11,20,27,-7,27
Mattersburg,5655,7,6,5,13,29,49,-20,23
FC Salzburg,5656,1,13,6,5,42,20,22,45
SK Sturm Gra,5656,2,13,4,7,35,30,5,43
Rapid Vienna,5656,3,9,9,6,37,31,6,36
LASK Linz,5656,4,8,6,10,29,31,-2,30
Mattersburg,5656,5,8,6,10,35,41,-6,30
SC Rheindorf,5656,6,6,6,12,23,30,-7,24
Vienna,5656,7,6,5,13,24,42,-18,23
FC Salzburg,5657,1,14,6,4,43,20,23,48
SK Sturm Gra,5657,2,12,5,7,33,29,4,41
LASK Linz,5657,3,10,6,8,28,26,2,36
Rapid Vienna,5657,4,8,10,6,36,29,7,34
Mattersburg,5657,5,6,6,12,28,40,-12,24
Vienna,5657,6,6,6,12,24,39,-15,24
SC Rheindorf,5657,7,6,5,13,19,28,-9,23
FC Salzburg,5658,1,14,7,3,44,18,26,49
SK Sturm Gra,5658,2,13,3,8,33,28,5,42
Rapid Vienna,5658,3,9,10,5,40,29,11,37
LASK Linz,5658,4,8,5,11,26,32,-6,29
Mattersburg,5658,5,8,5,11,32,39,-7,29
Vienna,5658,6,7,5,12,24,40,-16,26
SC Rheindorf,5658,7,5,5,14,19,32,-13,20
FC Salzburg,5659,1,16,6,2,45,16,29,54
SK Sturm Gra,5659,2,12,5,7,33,28,5,41
Rapid Vienna,5659,3,8,10,6,33,27,6,34
LASK Linz,5659,4,8,6,10,25,27,-2,30
Mattersburg,5659,5,7,6,11,32,42,-10,27
Vienna,5659,6,6,6,12,24,40,-16,24
SC Rheindorf,5659,7,4,7,13,20,32,-12,19
FC Salzburg,5660,1,13,7,4,42,20,22,46
SK Sturm Gra,5660,2,13,4,7,33,29,4,43
Rapid Vienna,5660,3,8,9,7,35,29,6,33
LASK Linz,5660,4,9,5,10,28,30,-2,32
Mattersburg,5660,5,7,5,12,35,41,-6,26
SC Rheindorf,5660,6,7,5,12,21,29,-8,26
Vienna,5660,7,7,5,12,25,41,-16,26
FC Salzburg,5661,1,13,8,3,42,20,22,47
SK Sturm Gra,5661,2,12,6,6,31,26,5,42
Rapid Vienna,5661,3,9,11,4,38,27,11,38
LASK Linz,5661,4,7,7,10,29,33,-4,28
Mattersburg,5661,5,7,6,11,32,42,-10,27
Vienna,5661,6,7,5,12,29,41,-12,26
SC Rheindorf,5661,7,4,7,13,18,30,-12,19
FC Salzburg,5662,1,14,6,4,44,20,24,48
SK Sturm Gra,5662,2,12,5,7,31,28,3,41
Rapid Vienna,5662,3,8,11,5,33,25,8,35
LASK Linz,5662,4,9,7,8,28,26,2,34
Vienna,5662,5,8,5,11,28,40,-12,29
SC Rheindorf,5662,6,5,7,12,19,27,-8,22
Mattersburg,5662,7,5,5,14,28,45,-17,20
FC Salzburg,5663,1,14,8,2,47,17,30,50
SK Sturm Gra,5663,2,13,4,7,34,26,8,43
LASK Linz,5663,3,10,5,9,30,27,3,35
Rapid Vienna,5663,4,7,10,7,32,29,3,31
Vienna,5663,5,7,5,12,25,39,-14,26
Mattersburg,5663,6,6,6,12,28,44,-16,24
SC Rheindorf,5663,7,5,6,13,18,32,-14,21
FC Salzburg,5664,1,14,8,2,45,18,27,50
SK Sturm Gra,5664,2,12,5,7,32,31,1,41
LASK Linz,5664,3,10,6,8,31,26,5,36
Rapid Vienna,5664,4,8,10,6,35,28,7,34
Vienna,5664,5,7,5,12,27,40,-13,26
SC Rheindorf,5664,6,6,5,13,23,31,-8,23
Mattersburg,5664,7,5,5,14,28,47,-19,20
FC Salzburg,5665,1,14,8,2,45,20,25,50
Rapid Vienna,5665,2,8,12,4,36,26,10,36
SK Sturm Gra,5665,3,11,3,10,32,34,-2,36
LASK Linz,5665,4,9,7,8,28,26,2,34
Vienna,5665,5,7,5,12,27,41,-14,26
SC Rheindorf,5665,6,6,7,11,19,26,-7,25
Mattersburg,5665,7,5,6,13,28,42,-14,21
FC Salzburg,5666,1,14,6,4,46,22,24,48
SK Sturm Gra,5666,2,13,3,8,35,29,6,42
Rapid Vienna,5666,3,10,9,5,39,29,10,39
LASK Linz,5666,4,9,5,10,28,30,-2,32
Mattersburg,5666,5,6,7,11,30,42,-12,25
Vienna,5666,6,6,6,12,24,39,-15,24
SC Rheindorf,5666,7,5,6,13,17,28,-11,21
FC Salzburg,5667,1,14,8,2,48,20,28,50
SK Sturm Gra,5667,2,14,3,7,34,30,4,45
LASK Linz,5667,3,10,5,9,28,25,3,35
Rapid Vienna,5667,4,8,9,7,32,26,6,33
Vienna,5667,5,7,6,11,29,41,-12,27
Mattersburg,5667,6,5,7,12,29,43,-14,22
SC Rheindorf,5667,7,4,6,14,15,30,-15,18
FC Salzburg,5668,1,16,6,2,51,19,32,54
SK Sturm Gra,5668,2,13,4,7,33,27,6,43
Rapid Vienna,5668,3,8,9,7,35,31,4,33
LASK Linz,5668,4,7,6,11,24,29,-5,27
Mattersburg,5668,5,7,6,11,30,40,-10,27
Vienna,5668,6,6,6,12,26,43,-17,24
SC Rheindorf,5668,7,6,5,13,19,29,-10,23
FC Salzburg,5669,1,15,7,2,47,19,28,52
SK Sturm Gra,5669,2,13,3,8,33,32,1,42
LASK Linz,5669,3,10,6,8,34,28,6,36
Rapid Vienna,5669,4,7,11,6,34,29,5,32
Mattersburg,5669,5,6,6,12,33,45,-12,24
Vienna,5669,6,6,5,13,24,41,-17,23
SC Rheindorf,5669,7,5,6,13,20,31,-11,21
FC Salzburg,5670,1,14,7,3,41,17,24,49
SK Sturm Gra,5670,2,12,3,9,29,27,2,39
Rapid Vienna,5670,3,9,10,5,37,26,11,37
LASK Linz,5670,4,9,6,9,27,27,0,33
Vienna,5670,5,8,5,11,29,38,-9,29
Mattersburg,5670,6,6,6,12,31,44,-13,24
SC Rheindorf,5670,7,5,5,14,17,32,-15,20
FC Salzburg,5671,1,13,8,3,46,24,22,47
SK Sturm Gra,5671,2,13,4,7,34,29,5,43
Rapid Vienna,5671,3,9,11,4,38,25,13,38
LASK Linz,5671,4,7,7,10,23,31,-8,28
Mattersburg,5671,5,6,8,10,29,38,-9,26
Vienna,5671,6,6,6,12,25,40,-15,24
SC Rheindorf,5671,7,5,6,13,21,29,-8,21
FC Salzburg,5672,1,14,7,3,44,20,24,49
SK Sturm Gra,5672,2,11,5,8,32,31,1,38
Rapid Vienna,5672,3,8,12,4,37,27,10,36
LASK Linz,5672,4,8,6,10,27,29,-2,30
Mattersburg,5672,5,7,5,12,33,43,-10,26
SC Rheindorf,5672,6,6,7,11,21,29,-8,25
Vienna,5672,7,6,6,12,26,41,-15,24
FC Salzburg,5673,1,15,6,3,42,17,25,51
SK Sturm Gra,5673,2,12,3,9,31,30,1,39
Rapid Vienna,5673,3,9,9,6,36,27,9,36
LASK Linz,5673,4,10,5,9,31,28,3,35
Vienna,5673,5,7,5,12,28,38,-10,26
Mattersburg,5673,6,6,6,12,28,42,-14,24
SC Rheindorf,5673,7,5,6,13,18,32,-14,21
FC Salzburg,5674,1,15,7,2,46,18,28,52
SK Sturm Gra,5674,2,12,3,9,34,34,0,39
Rapid Vienna,5674,3,8,10,6,37,30,7,34
LASK Linz,5674,4,7,6,11,26,32,-6,27
Mattersburg,5674,5,7,6,11,32,41,-9,27
SC Rheindorf,5674,6,7,5,12,23,29,-6,26
Vienna,5674,7,6,7,11,26,40,-14,25
FC Salzburg,5675,1,16,6,2,45,16,29,54
SK Sturm Gra,5675,2,12,4,8,32,29,3,40
Rapid Vienna,5675,3,8,11,5,35,27,8,35
LASK Linz,5675,4,8,7,9,27,28,-1,31
Vienna,5675,5,6,6,12,23,40,-17,24
Mattersburg,5675,6,5,8,11,27,38,-11,23
SC Rheindorf,5675,7,5,6,13,19,30,-11,21
FC Salzburg,5676,1,16,6,2,50,17,33,54
SK Sturm Gra,5676,2,13,4,7,32,27,5,43
Rapid Vienna,5676,3,8,10,6,33,27,6,34
LASK Linz,5676,4,8,8,8,25,25,0,32
Mattersburg,5676,5,7,5,12,33,43,-10,26
Vienna,5676,6,6,5,13,24,43,-19,23
SC Rheindorf,5676,7,4,6,14,17,32,-15,18
FC Salzburg,5677,1,14,7,3,43,20,23,49
Rapid Vienna,5677,2,10,10,4,39,25,14,40
SK Sturm Gra,5677,3,11,7,6,33,29,4,40
Mattersburg,5677,4,8,5,11,36,39,-3,29
LASK Linz,5677,5,7,6,11,30,35,-5,27
Vienna,5677,6,6,5,13,24,42,-18,23
SC Rheindorf,5677,7,5,6,13,18,33,-15,21
FC Salzburg,5678,1,13,7,4,45,23,22,46
SK Sturm Gra,5678,2,13,5,6,37,29,8,44
Rapid Vienna,5678,3,10,10,4,37,25,12,40
Vienna,5678,4,8,5,11,28,38,-10,29
LASK Linz,5678,5,7,6,11,26,35,-9,27
Mattersburg,5678,6,7,5,12,33,42,-9,26
SC Rheindorf,5678,7,4,6,14,17,31,-14,18
FC Salzburg,5679,1,15,7,2,48,18,30,52
SK Sturm Gra,5679,2,13,3,8,36,31,5,42
Rapid Vienna,5679,3,8,10,6,36,30,6,34
LASK Linz,5679,4,9,5,10,33,34,-1,32
Mattersburg,5679,5,7,6,11,36,45,-9,27
Vienna,5679,6,6,5,13,24,43,-19,23
SC Rheindorf,5679,7,5,6,13,21,33,-12,21
FC Salzburg,5680,1,15,7,2,45,17,28,52
SK Sturm Gra,5680,2,12,4,8,30,29,1,40
Rapid Vienna,5680,3,8,10,6,34,27,7,34
LASK Linz,5680,4,9,7,8,28,27,1,34
Vienna,5680,5,7,5,12,26,40,-14,26
Mattersburg,5680,6,6,6,12,29,41,-12,24
SC Rheindorf,5680,7,5,5,14,19,30,-11,20
FC Salzburg,5681,1,14,6,4,41,20,21,48
SK Sturm Gra,5681,2,14,3,7,33,26,7,45
Rapid Vienna,5681,3,10,9,5,39,25,14,39
LASK Linz,5681,4,8,6,10,28,30,-2,30
Mattersburg,5681,5,8,5,11,36,40,-4,29
Vienna,5681,6,6,5,13,24,43,-19,23
SC Rheindorf,5681,7,4,6,14,18,35,-17,18
FC Salzburg,5682,1,14,7,3,47,20,27,49
SK Sturm Gra,5682,2,14,3,7,35,31,4,45
Rapid Vienna,5682,3,9,10,5,39,28,11,37
LASK Linz,5682,4,7,5,12,26,32,-6,26
Mattersburg,5682,5,7,5,12,34,42,-8,26
Vienna,5682,6,7,5,12,25,41,-16,26
SC Rheindorf,5682,7,6,5,13,19,31,-12,23
FC Salzburg,5683,1,15,7,2,46,18,28,52
SK Sturm Gra,5683,2,13,4,7,35,26,9,43
LASK Linz,5683,3,9,5,10,29,31,-2,32
Rapid Vienna,5683,4,7,9,8,34,33,1,30
Mattersburg,5683,5,7,6,11,30,39,-9,27
Vienna,5683,6,7,5,12,25,41,-16,26
SC Rheindorf,5683,7,5,6,13,18,29,-11,21
FC Salzburg,5684,1,14,7,3,42,19,23,49
SK Sturm Gra,5684,2,11,5,8,31,29,2,38
Rapid Vienna,5684,3,9,10,5,37,26,11,37
LASK Linz,5684,4,9,5,10,28,31,-3,32
Vienna,5684,5,7,6,11,27,39,-12,27
Mattersburg,5684,6,6,8,10,33,41,-8,26
SC Rheindorf,5684,7,4,7,13,20,33,-13,19
FC Salzburg,5685,1,14,7,3,42,18,24,49
SK Sturm Gra,5685,2,13,3,8,34,28,6,42
Rapid Vienna,5685,3,9,10,5,34,27,7,37
LASK Linz,5685,4,9,6,9,28,28,0,33
Vienna,5685,5,8,5,11,28,38,-10,29
Mattersburg,5685,6,6,6,12,30,42,-12,24
SC Rheindorf,5685,7,4,5,15,19,34,-15,17
FC Salzburg,5686,1,15,6,3,47,18,29,51
SK Sturm Gra,5686,2,14,3,7,34,28,6,45
LASK Linz,5686,3,9,6,9,31,31,0,33
Rapid Vienna,5686,4,7,11,6,35,30,5,32
Mattersburg,5686,5,7,6,11,31,40,-9,27
Vienna,5686,6,6,5,13,24,41,-17,23
SC Rheindorf,5686,7,4,7,13,18,32,-14,19
FC Salzburg,5687,1,14,6,4,43,22,21,48
SK Sturm Gra,5687,2,14,4,6,35,25,10,46
Rapid Vienna,5687,3,7,10,7,34,31,3,31
LASK Linz,5687,4,8,7,9,30,30,0,31
Vienna,5687,5,8,5,11,28,38,-10,29
SC Rheindorf,5687,6,5,8,11,19,28,-9,23
Mattersburg,5687,7,5,6,13,31,46,-15,21
FC Salzburg,5688,1,13,8,3,41,18,23,47
SK Sturm Gra,5688,2,13,5,6,33,26,7,44
LASK Linz,5688,3,10,5,9,30,27,3,35
Rapid Vienna,5688,4,8,10,6,34,28,6,34
Vienna,5688,5,8,5,11,28,38,-10,29
Mattersburg,5688,6,6,6,12,29,43,-14,24
SC Rheindorf,5688,7,4,5,15,18,33,-15,17
FC Salzburg,5689,1,15,7,2,44,18,26,52
Rapid Vienna,5689,2,9,11,4,37,25,12,38
SK Sturm Gra,5689,3,11,4,9,32,31,1,37
LASK Linz,5689,4,9,5,10,28,30,-2,32
SC Rheindorf,5689,5,6,6,12,21,31,-10,24
Mattersburg,5689,6,6,6,12,31,42,-11,24
Vienna,5689,7,6,5,13,24,40,-16,23
FC Salzburg,5690,1,14,7,3,41,16,25,49
SK Sturm Gra,5690,2,13,5,6,32,26,6,44
Rapid Vienna,5690,3,9,9,6,37,27,10,36
LASK Linz,5690,4,7,6,11,28,35,-7,27
Vienna,5690,5,7,6,11,25,38,-13,27
Mattersburg,5690,6,6,6,12,29,41,-12,24
SC Rheindorf,5690,7,6,5,13,22,31,-9,23
FC Salzburg,5691,1,14,8,2,44,16,28,50
SK Sturm Gra,5691,2,12,5,7,31,28,3,41
Rapid Vienna,5691,3,8,11,5,38,30,8,35
LASK Linz,5691,4,8,6,10,30,32,-2,30
Vienna,5691,5,7,5,12,24,41,-17,26
SC Rheindorf,5691,6,6,6,12,21,30,-9,24
Mattersburg,5691,7,6,5,13,31,42,-11,23
FC Salzburg,5692,1,13,7,4,42,21,21,46
SK Sturm Gra,5692,2,13,3,8,34,30,4,42
Rapid Vienna,5692,3,9,10,5,37,27,10,37
LASK Linz,5692,4,9,6,9,30,27,3,33
Mattersburg,5692,5,6,7,11,30,43,-13,25
Vienna,5692,6,6,7,11,26,40,-14,25
SC Rheindorf,5692,7,5,6,13,19,30,-11,21
FC Salzburg,5693,1,16,6,2,45,18,27,54
SK Sturm Gra,5693,2,12,3,9,31,29,2,39
Rapid Vienna,5693,3,9,10,5,36,27,9,37
LASK Linz,5693,4,9,5,10,25,26,-1,32
Mattersburg,5693,5,6,6,12,29,40,-11,24
Vienna,5693,6,6,6,12,25,40,-15,24
SC Rheindorf,5693,7,5,6,13,18,29,-11,21
FC Salzburg,5694,1,14,8,2,46,19,27,50
SK Sturm Gra,5694,2,11,6,7,32,30,2,39
Rapid Vienna,5694,3,8,11,5,36,30,6,35
LASK Linz,5694,4,8,6,10,28,29,-1,30
Vienna,5694,5,7,5,12,26,40,-14,26
Mattersburg,5694,6,6,6,12,28,39,-11,24
SC Rheindorf,5694,7,5,8,11,16,25,-9,23
FC Salzburg,5695,1,12,7,5,39,19,20,43
SK Sturm Gra,5695,2,13,4,7,34,29,5,43
Rapid Vienna,5695,3,10,9,5,41,27,14,39
LASK Linz,5695,4,10,5,9,29,27,2,35
Vienna,5695,5,7,6,11,24,37,-13,27
Mattersburg,5695,6,5,8,11,28,41,-13,23
SC Rheindorf,5695,7,4,7,13,17,32,-15,19
FC Salzburg,5696,1,15,6,3,45,19,26,51
SK Sturm Gra,5696,2,12,4,8,29,29,0,40
Rapid Vienna,5696,3,8,11,5,37,28,9,35
LASK Linz,5696,4,7,8,9,26,30,-4,29
Mattersburg,5696,5,8,5,11,35,40,-5,29
Vienna,5696,6,6,5,13,23,41,-18,23
SC Rheindorf,5696,7,5,7,12,22,30,-8,22
FC Salzburg,5697,1,15,7,2,48,20,28,52
SK Sturm Gra,5697,2,13,3,8,33,32,1,42
Rapid Vienna,5697,3,8,9,7,35,29,6,33
LASK Linz,5697,4,9,6,9,28,29,-1,33
Mattersburg,5697,5,6,8,10,31,40,-9,26
Vienna,5697,6,6,5,13,24,40,-16,23
SC Rheindorf,5697,7,5,6,13,20,29,-9,21
FC Salzburg,5698,1,15,6,3,45,19,26,51
SK Sturm Gra,5698,2,13,5,6,32,26,6,44
LASK Linz,5698,3,9,6,9,29,28,1,33
Rapid Vienna,5698,4,7,11,6,33,27,6,32
Vienna,5698,5,7,5,12,26,40,-14,26
SC Rheindorf,5698,6,6,6,12,19,29,-10,24
Mattersburg,5698,7,5,5,14,31,46,-15,20
FC Salzburg,5699,1,16,6,2,45,18,27,54
SK Sturm Gra,5699,2,13,3,8,35,31,4,42
Rapid Vienna,5699,3,8,10,6,36,29,7,34
LASK Linz,5699,4,8,7,9,29,30,-1,31
Mattersburg,5699,5,6,7,11,30,38,-8,25
Vienna,5699,6,6,6,12,24,39,-15,24
SC Rheindorf,5699,7,5,5,14,18,32,-14,20
FC Salzburg,5700,1,15,6,3,45,18,27,51
Rapid Vienna,5700,2,10,10,4,39,27,12,40
SK Sturm Gra,5700,3,11,4,9,30,32,-2,37
LASK Linz,5700,4,9,6,9,26,27,-1,33
Vienna,5700,5,7,5,12,26,39,-13,26
Mattersburg,5700,6,6,5,13,27,40,-13,23
SC Rheindorf,5700,7,5,6,13,19,29,-10,21
FC Salzburg,5701,1,13,7,4,44,22,22,46
SK Sturm Gra,5701,2,14,3,7,33,27,6,45
Rapid Vienna,5701,3,8,10,6,37,31,6,34
LASK Linz,5701,4,8,6,10,27,28,-1,30
Mattersburg,5701,5,8,5,11,32,41,-9,29
Vienna,5701,6,7,6,11,26,38,-12,27
SC Rheindorf,5701,7,4,7,13,20,32,-12,19
FC Salzburg,5702,1,13,9,2,45,18,27,48
SK Sturm Gra,5702,2,12,5,7,33,31,2,41
LASK Linz,5702,3,9,6,9,28,29,-1,33
Rapid Vienna,5702,4,7,10,7,33,31,2,31
Mattersburg,5702,5,7,6,11,31,39,-8,27
SC Rheindorf,5702,6,6,6,12,21,28,-7,24
Vienna,5702,7,6,6,12,24,39,-15,24
FC Salzburg,5703,1,14,8,2,47,18,29,50
SK Sturm Gra,5703,2,12,4,8,31,29,2,40
Rapid Vienna,5703,3,7,12,5,33,27,6,33
LASK Linz,5703,4,8,7,9,26,26,0,31
Mattersburg,5703,5,7,7,10,30,38,-8,28
Vienna,5703,6,6,5,13,23,42,-19,23
SC Rheindorf,5703,7,5,7,12,18,28,-10,22
FC Salzburg,5704,1,14,8,2,46,18,28,50
SK Sturm Gra,5704,2,12,4,8,32,29,3,40
Rapid Vienna,5704,3,9,10,5,38,29,9,37
LASK Linz,5704,4,8,6,10,28,31,-3,30
Vienna,5704,5,7,5,12,26,41,-15,26
SC Rheindorf,5704,6,6,6,12,20,30,-10,24
Mattersburg,5704,7,5,7,12,30,42,-12,22
FC Salzburg,5705,1,14,7,3,46,22,24,49
Rapid Vienna,5705,2,11,9,4,41,26,15,42
SK Sturm Gra,5705,3,12,4,8,32,27,5,40
Mattersburg,5705,4,7,6,11,31,41,-10,27
LASK Linz,5705,5,7,5,12,23,33,-10,26
Vienna,5705,6,6,6,12,24,39,-15,24
SC Rheindorf,5705,7,5,7,12,20,29,-9,22
FC Salzburg,5706,1,16,6,2,48,18,30,54
SK Sturm Gra,5706,2,12,3,9,31,29,2,39
Rapid Vienna,5706,3,8,11,5,34,29,5,35
LASK Linz,5706,4,8,6,10,24,27,-3,30
Vienna,5706,5,7,5,12,27,39,-12,26
SC Rheindorf,5706,6,6,6,12,20,30,-10,24
Mattersburg,5706,7,6,5,13,29,41,-12,23
FC Salzburg,5707,1,14,6,4,44,21,23,48
SK Sturm Gra,5707,2,12,4,8,33,30,3,40
Rapid Vienna,5707,3,9,9,6,38,32,6,36
LASK Linz,5707,4,9,5,10,30,28,2,32
Vienna,5707,5,8,5,11,28,38,-10,29
SC Rheindorf,5707,6,7,6,11,23,28,-5,27
Mattersburg,5707,7,5,5,14,31,50,-19,20
FC Salzburg,5708,1,14,7,3,43,19,24,49
SK Sturm Gra,5708,2,13,3,8,35,29,6,42
Rapid Vienna,5708,3,7,10,7,35,32,3,31
LASK Linz,5708,4,8,6,10,27,32,-5,30
Mattersburg,5708,5,7,6,11,33,42,-9,27
SC Rheindorf,5708,6,7,5,12,24,29,-5,26
Vienna,5708,7,7,5,12,26,40,-14,26
FC Salzburg,5709,1,14,6,4,44,22,22,48
Rapid Vienna,5709,2,10,9,5,36,27,9,39
SK Sturm Gra,5709,3,12,3,9,35,32,3,39
LASK Linz,5709,4,8,5,11,27,31,-4,29
SC Rheindorf,5709,5,8,5,11,23,27,-4,29
Vienna,5709,6,8,5,11,27,38,-11,29
Mattersburg,5709,7,5,5,14,29,44,-15,20
FC Salzburg,5710,1,15,7,2,46,18,28,52
SK Sturm Gra,5710,2,12,4,8,33,33,0,40
Rapid Vienna,5710,3,8,10,6,38,30,8,34
LASK Linz,5710,4,8,6,10,27,29,-2,30
Mattersburg,5710,5,8,6,10,37,40,-3,30
Vienna,5710,6,6,5,13,24,41,-17,23
SC Rheindorf,5710,7,5,6,13,18,32,-14,21
FC Salzburg,5711,1,15,7,2,47,17,30,52
SK Sturm Gra,5711,2,13,4,7,35,30,5,43
Rapid Vienna,5711,3,8,11,5,36,28,8,35
LASK Linz,5711,4,9,6,9,29,28,1,33
Vienna,5711,5,7,5,12,28,41,-13,26
Mattersburg,5711,6,6,5,13,30,46,-16,23
SC Rheindorf,5711,7,4,6,14,18,33,-15,18
FC Salzburg,5712,1,15,6,3,46,17,29,51
SK Sturm Gra,5712,2,11,6,7,30,29,1,39
Rapid Vienna,5712,3,8,10,6,35,28,7,34
LASK Linz,5712,4,8,6,10,25,29,-4,30
Mattersburg,5712,5,8,6,10,32,37,-5,30
Vienna,5712,6,6,6,12,24,41,-17,24
SC Rheindorf,5712,7,5,6,13,18,29,-11,21
FC Salzburg,5713,1,14,8,2,46,19,27,50
SK Sturm Gra,5713,2,12,6,6,34,29,5,42
Rapid Vienna,5713,3,9,10,5,39,26,13,37
LASK Linz,5713,4,8,7,9,28,31,-3,31
Vienna,5713,5,7,5,12,26,40,-14,26
Mattersburg,5713,6,6,5,13,28,41,-13,23
SC Rheindorf,5713,7,4,7,13,18,33,-15,19
FC Salzburg,5714,1,15,7,2,48,21,27,52
Rapid Vienna,5714,2,10,10,4,38,26,12,40
SK Sturm Gra,5714,3,12,3,9,36,34,2,39
LASK Linz,5714,4,7,7,10,28,34,-6,28
Vienna,5714,5,7,5,12,27,41,-14,26
SC Rheindorf,5714,6,5,7,12,19,28,-9,22
Mattersburg,5714,7,5,7,12,30,42,-12,22
FC Salzburg,5715,1,14,7,3,46,21,25,49
SK Sturm Gra,5715,2,13,4,7,36,30,6,43
LASK Linz,5715,3,9,5,10,32,31,1,32
Rapid Vienna,5715,4,7,10,7,33,31,2,31
Vienna,5715,5,8,5,11,27,39,-12,29
Mattersburg,5715,6,7,5,12,32,43,-11,26
SC Rheindorf,5715,7,5,6,13,18,29,-11,21
FC Salzburg,5716,1,13,7,4,42,20,22,46
SK Sturm Gra,5716,2,12,5,7,32,28,4,41
Rapid Vienna,5716,3,7,11,6,34,29,5,32
LASK Linz,5716,4,8,6,10,27,28,-1,30
Mattersburg,5716,5,7,7,10,31,39,-8,28
Vienna,5716,6,7,6,11,27,40,-13,27
SC Rheindorf,5716,7,6,6,12,20,29,-9,24
FC Salzburg,5717,1,15,7,2,48,19,29,52
SK Sturm Gra,5717,2,14,3,7,36,26,10,45
Rapid Vienna,5717,3,9,9,6,35,31,4,36
Mattersburg,5717,4,8,5,11,35,41,-6,29
LASK Linz,5717,5,7,6,11,24,31,-7,27
Vienna,5717,6,6,6,12,25,41,-16,24
SC Rheindorf,5717,7,4,6,14,18,32,-14,18
FC Salzburg,5718,1,12,10,2,43,20,23,46
SK Sturm Gra,5718,2,13,5,6,35,29,6,44
Rapid Vienna,5718,3,8,11,5,36,30,6,35
LASK Linz,5718,4,8,6,10,28,28,0,30
Mattersburg,5718,5,7,6,11,31,40,-9,27
Vienna,5718,6,7,6,11,27,40,-13,27
SC Rheindorf,5718,7,4,6,14,19,32,-13,18
FC Salzburg,5719,1,14,7,3,46,21,25,49
SK Sturm Gra,5719,2,12,4,8,35,32,3,40
Rapid Vienna,5719,3,9,10,5,37,29,8,37
LASK Linz,5719,4,9,5,10,31,29,2,32
Mattersburg,5719,5,7,5,12,31,43,-12,26
SC Rheindorf,5719,6,6,6,12,20,29,-9,24
Vienna,5719,7,6,5,13,24,41,-17,23
FC Salzburg,5720,1,15,6,3,49,23,26,51
SK Sturm Gra,5720,2,13,3,8,37,33,4,42
LASK Linz,5720,3,10,5,9,29,29,0,35
Rapid Vienna,5720,4,8,10,6,40,31,9,34
Vienna,5720,5,7,5,12,25,41,-16,26
Mattersburg,5720,6,6,5,13,27,39,-12,23
SC Rheindorf,5720,7,5,6,13,19,30,-11,21
FC Salzburg,5721,1,16,6,2,51,19,32,54
SK Sturm Gra,5721,2,13,3,8,34,27,7,42
Rapid Vienna,5721,3,8,10,6,35,31,4,34
LASK Linz,5721,4,8,7,9,26,26,0,31
Vienna,5721,5,7,5,12,27,41,-14,26
SC Rheindorf,5721,6,5,7,12,17,30,-13,22
Mattersburg,5721,7,5,6,13,29,45,-16,21
FC Salzburg,5722,1,14,6,4,41,20,21,48
SK Sturm Gra,5722,2,13,4,7,35,29,6,43
Rapid Vienna,5722,3,9,10,5,35,26,9,37
LASK Linz,5722,4,9,5,10,29,33,-4,32
SC Rheindorf,5722,5,6,6,12,25,28,-3,24
Mattersburg,5722,6,6,6,12,31,44,-13,24
Vienna,5722,7,6,5,13,24,40,-16,23
SK Sturm Gra,5723,1,14,4,6,33,25,8,46
FC Salzburg,5723,2,12,9,3,39,17,22,45
Rapid Vienna,5723,3,10,9,5,37,24,13,39
Mattersburg,5723,4,7,7,10,33,40,-7,28
LASK Linz,5723,5,7,6,11,26,34,-8,27
Vienna,5723,6,6,6,12,24,39,-15,24
SC Rheindorf,5723,7,5,5,14,20,33,-13,20
FC Salzburg,5724,1,14,6,4,43,23,20,48
SK Sturm Gra,5724,2,12,5,7,32,28,4,41
Rapid Vienna,5724,3,9,10,5,37,26,11,37
LASK Linz,5724,4,7,6,11,25,30,-5,27
Mattersburg,5724,5,7,6,11,29,38,-9,27
Vienna,5724,6,7,5,12,27,39,-12,26
SC Rheindorf,5724,7,5,8,11,16,25,-9,23
FC Salzburg,5725,1,15,6,3,47,17,30,51
SK Sturm Gra,5725,2,14,3,7,33,27,6,45
Rapid Vienna,5725,3,8,9,7,33,29,4,33
LASK Linz,5725,4,9,5,10,26,27,-1,32
Mattersburg,5725,5,7,6,11,32,42,-10,27
Vienna,5725,6,6,6,12,26,42,-16,24
SC Rheindorf,5725,7,5,5,14,17,30,-13,20
FC Salzburg,5726,1,16,6,2,51,15,36,54
SK Sturm Gra,5726,2,13,4,7,35,28,7,43
Rapid Vienna,5726,3,7,10,7,34,34,0,31
LASK Linz,5726,4,8,7,9,27,28,-1,31
SC Rheindorf,5726,5,6,6,12,20,30,-10,24
Mattersburg,5726,6,6,6,12,30,41,-11,24
Vienna,5726,7,6,5,13,23,44,-21,23
FC Salzburg,5727,1,12,9,3,43,21,22,45
SK Sturm Gra,5727,2,12,4,8,35,29,6,40
Rapid Vienna,5727,3,9,9,6,34,26,8,36
LASK Linz,5727,4,8,7,9,27,31,-4,31
SC Rheindorf,5727,5,7,6,11,24,29,-5,27
Mattersburg,5727,6,6,7,11,31,42,-11,25
Vienna,5727,7,6,6,12,24,40,-16,24
FC Salzburg,5728,1,15,6,3,48,19,29,51
SK Sturm Gra,5728,2,12,4,8,33,32,1,40
Rapid Vienna,5728,3,9,9,6,34,27,7,36
LASK Linz,5728,4,9,5,10,27,29,-2,32
Mattersburg,5728,5,8,5,11,33,40,-7,29
Vienna,5728,6,6,5,13,25,42,-17,23
SC Rheindorf,5728,7,5,6,13,19,30,-11,21
FC Salzburg,5729,1,14,8,2,45,18,27,50
SK Sturm Gra,5729,2,11,5,8,31,33,-2,38
Rapid Vienna,5729,3,7,13,4,36,28,8,34
LASK Linz,5729,4,8,7,9,30,28,2,31
Mattersburg,5729,5,8,5,11,35,41,-6,29
Vienna,5729,6,6,6,12,26,41,-15,24
SC Rheindorf,5729,7,4,8,12,19,33,-14,20
FC Salzburg,5730,1,13,8,3,43,18,25,47
Rapid Vienna,5730,2,10,10,4,37,25,12,40
SK Sturm Gra,5730,3,11,6,7,32,32,0,39
LASK Linz,5730,4,7,7,10,27,31,-4,28
Vienna,5730,5,7,6,11,28,41,-13,27
Mattersburg,5730,6,6,7,11,33,43,-10,25
SC Rheindorf,5730,7,5,6,13,20,30,-10,21
FC Salzburg,5731,1,13,8,3,41,21,20,47
SK Sturm Gra,5731,2,14,4,6,33,25,8,46
Rapid Vienna,5731,3,8,10,6,35,28,7,34
LASK Linz,5731,4,8,6,10,28,31,-3,30
Vienna,5731,5,7,6,11,28,38,-10,27
Mattersburg,5731,6,5,8,11,31,42,-11,23
SC Rheindorf,5731,7,4,8,12,18,29,-11,20
FC Salzburg,5732,1,14,6,4,46,19,27,48
SK Sturm Gra,5732,2,12,3,9,30,35,-5,39
Rapid Vienna,5732,3,9,10,5,37,26,11,37
LASK Linz,5732,4,8,7,9,31,31,0,31
Vienna,5732,5,7,6,11,27,38,-11,27
SC Rheindorf,5732,6,6,6,12,20,29,-9,24
Mattersburg,5732,7,5,8,11,28,41,-13,23
FC Salzburg,5733,1,14,6,4,44,20,24,48
SK Sturm Gra,5733,2,14,3,7,36,29,7,45
Rapid Vienna,5733,3,8,10,6,38,31,7,34
Vienna,5733,4,8,5,11,26,38,-12,29
LASK Linz,5733,5,7,6,11,26,33,-7,27
Mattersburg,5733,6,7,5,12,31,41,-10,26
SC Rheindorf,5733,7,6,5,13,21,30,-9,23
FC Salzburg,5734,1,15,7,2,48,17,31,52
SK Sturm Gra,5734,2,12,4,8,33,32,1,40
Rapid Vienna,5734,3,9,10,5,39,31,8,37
LASK Linz,5734,4,9,6,9,29,29,0,33
Vienna,5734,5,7,5,12,27,41,-14,26
Mattersburg,5734,6,5,7,12,30,43,-13,22
SC Rheindorf,5734,7,4,7,13,20,33,-13,19
FC Salzburg,5735,1,15,6,3,45,17,28,51
SK Sturm Gra,5735,2,13,3,8,34,30,4,42
Rapid Vienna,5735,3,9,10,5,36,25,11,37
LASK Linz,5735,4,7,8,9,27,30,-3,29
Mattersburg,5735,5,7,6,11,32,43,-11,27
Vienna,5735,6,6,5,13,24,40,-16,23
SC Rheindorf,5735,7,5,6,13,20,33,-13,21
FC Salzburg,5736,1,14,8,2,45,17,28,50
SK Sturm Gra,5736,2,11,4,9,33,33,0,37
Rapid Vienna,5736,3,8,11,5,33,26,7,35
LASK Linz,5736,4,9,6,9,32,30,2,33
Vienna,5736,5,7,5,12,24,40,-16,26
SC Rheindorf,5736,6,6,7,11,23,31,-8,25
Mattersburg,5736,7,5,7,12,29,42,-13,22
FC Salzburg,5737,1,15,6,3,46,19,27,51
SK Sturm Gra,5737,2,13,3,8,35,30,5,42
Rapid Vienna,5737,3,9,9,6,34,26,8,36
LASK Linz,5737,4,8,6,10,27,29,-2,30
Mattersburg,5737,5,7,5,12,34,46,-12,26
Vienna,5737,6,7,5,12,27,41,-14,26
SC Rheindorf,5737,7,5,6,13,17,29,-12,21
FC Salzburg,5738,1,15,6,3,47,18,29,51
SK Sturm Gra,5738,2,12,4,8,33,31,2,40
Rapid Vienna,5738,3,9,11,4,34,24,10,38
LASK Linz,5738,4,9,6,9,27,28,-1,33
Vienna,5738,5,7,5,12,26,39,-13,26
SC Rheindorf,5738,6,6,5,13,21,30,-9,23
Mattersburg,5738,7,5,5,14,29,47,-18,20
FC Salzburg,5739,1,15,7,2,46,15,31,52
Rapid Vienna,5739,2,10,10,4,38,26,12,40
SK Sturm Gra,5739,3,11,4,9,32,34,-2,37
LASK Linz,5739,4,8,5,11,29,33,-4,29
Mattersburg,5739,5,7,6,11,30,39,-9,27
Vienna,5739,6,6,5,13,24,42,-18,23
SC Rheindorf,5739,7,5,7,12,20,30,-10,22
FC Salzburg,5740,1,16,6,2,48,16,32,54
SK Sturm Gra,5740,2,12,4,8,30,29,1,40
Rapid Vienna,5740,3,8,9,7,35,30,5,33
LASK Linz,5740,4,9,6,9,27,29,-2,33
Mattersburg,5740,5,7,5,12,32,43,-11,26
SC Rheindorf,5740,6,6,5,13,21,29,-8,23
Vienna,5740,7,6,5,13,23,40,-17,23
FC Salzburg,5741,1,14,7,3,46,20,26,49
SK Sturm Gra,5741,2,13,3,8,31,28,3,42
Rapid Vienna,5741,3,7,11,6,33,28,5,32
LASK Linz,5741,4,8,6,10,26,27,-1,30
Mattersburg,5741,5,8,5,11,31,39,-8,29
Vienna,5741,6,7,5,12,25,40,-15,26
SC Rheindorf,5741,7,5,7,12,16,26,-10,22
FC Salzburg,5742,1,15,6,3,47,19,28,51
SK Sturm Gra,5742,2,12,4,8,30,28,2,40
Rapid Vienna,5742,3,10,9,5,35,26,9,39
LASK Linz,5742,4,9,6,9,25,25,0,33
Mattersburg,5742,5,8,5,11,33,41,-8,29
Vienna,5742,6,6,5,13,24,41,-17,23
SC Rheindorf,5742,7,4,5,15,16,30,-14,17
FC Salzburg,5743,1,16,6,2,57,16,41,54
SK Sturm Gra,5743,2,13,3,8,34,33,1,42
Rapid Vienna,5743,3,10,9,5,39,31,8,39
LASK Linz,5743,4,7,7,10,24,28,-4,28
Mattersburg,5743,5,7,6,11,30,40,-10,27
Vienna,5743,6,6,5,13,24,46,-22,23
SC Rheindorf,5743,7,4,6,14,16,30,-14,18
FC Salzburg,5744,1,15,7,2,47,18,29,52
SK Sturm Gra,5744,2,12,4,8,32,29,3,40
Rapid Vienna,5744,3,8,11,5,40,32,8,35
LASK Linz,5744,4,9,7,8,28,27,1,34
Mattersburg,5744,5,6,7,11,33,43,-10,25
Vienna,5744,6,6,6,12,25,41,-16,24
SC Rheindorf,5744,7,4,6,14,18,33,-15,18
FC Salzburg,5745,1,14,8,2,45,19,26,50
SK Sturm Gra,5745,2,12,4,8,31,28,3,40
LASK Linz,5745,3,10,5,9,31,28,3,35
Rapid Vienna,5745,4,8,10,6,40,32,8,34
Mattersburg,5745,5,7,6,11,32,40,-8,27
Vienna,5745,6,6,6,12,25,40,-15,24
SC Rheindorf,5745,7,5,5,14,20,37,-17,20
FC Salzburg,5746,1,14,8,2,45,18,27,50
SK Sturm Gra,5746,2,12,4,8,31,30,1,40
Rapid Vienna,5746,3,8,11,5,35,27,8,35
LASK Linz,5746,4,9,5,10,29,29,0,32
Vienna,5746,5,7,6,11,28,39,-11,27
Mattersburg,5746,6,6,6,12,30,44,-14,24
SC Rheindorf,5746,7,4,8,12,21,32,-11,20
FC Salzburg,5747,1,15,7,2,47,18,29,52
SK Sturm Gra,5747,2,12,4,8,31,27,4,40
Rapid Vienna,5747,3,9,9,6,36,30,6,36
LASK Linz,5747,4,8,5,11,25,30,-5,29
Mattersburg,5747,5,6,7,11,30,40,-10,25
Vienna,5747,6,6,7,11,25,39,-14,25
SC Rheindorf,5747,7,5,7,12,18,28,-10,22
FC Salzburg,5748,1,14,8,2,48,21,27,50
SK Sturm Gra,5748,2,11,5,8,34,33,1,38
LASK Linz,5748,3,10,5,9,29,28,1,35
Rapid Vienna,5748,4,7,10,7,35,33,2,31
SC Rheindorf,5748,5,7,5,12,24,29,-5,26
Vienna,5748,6,7,5,12,25,40,-15,26
Mattersburg,5748,7,6,6,12,33,44,-11,24
FC Salzburg,5749,1,15,7,2,48,18,30,52
SK Sturm Gra,5749,2,13,4,7,31,27,4,43
LASK Linz,5749,3,10,6,8,28,25,3,36
Rapid Vienna,5749,4,8,10,6,35,28,7,34
Vienna,5749,5,7,5,12,27,42,-15,26
SC Rheindorf,5749,6,5,5,14,20,30,-10,20
Mattersburg,5749,7,5,5,14,29,48,-19,20
FC Salzburg,5750,1,16,6,2,45,17,28,54
SK Sturm Gra,5750,2,13,3,8,31,28,3,42
Rapid Vienna,5750,3,8,10,6,35,28,7,34
Mattersburg,5750,4,8,5,11,33,38,-5,29
LASK Linz,5750,5,8,5,11,25,31,-6,29
Vienna,5750,6,6,5,13,23,42,-19,23
SC Rheindorf,5750,7,5,6,13,20,28,-8,21
FC Salzburg,5751,1,15,6,3,42,17,25,51
SK Sturm Gra,5751,2,12,4,8,29,26,3,40
Rapid Vienna,5751,3,9,10,5,36,26,10,37
Mattersburg,5751,4,8,6,10,31,36,-5,30
LASK Linz,5751,5,8,5,11,26,29,-3,29
Vienna,5751,6,6,5,13,24,42,-18,23
SC Rheindorf,5751,7,5,6,13,18,30,-12,21
FC Salzburg,5752,1,16,6,2,51,20,31,54
SK Sturm Gra,5752,2,12,4,8,32,30,2,40
Rapid Vienna,5752,3,8,11,5,38,29,9,35
LASK Linz,5752,4,8,5,11,31,36,-5,29
SC Rheindorf,5752,5,6,7,11,24,31,-7,25
Vienna,5752,6,6,6,12,28,44,-16,24
Mattersburg,5752,7,5,7,12,29,43,-14,22
FC Salzburg,5753,1,16,6,2,48,18,30,54
SK Sturm Gra,5753,2,12,3,9,30,31,-1,39
Rapid Vienna,5753,3,9,9,6,40,28,12,36
LASK Linz,5753,4,8,6,10,29,33,-4,30
SC Rheindorf,5753,5,6,7,11,20,27,-7,25
Mattersburg,5753,6,6,6,12,31,43,-12,24
Vienna,5753,7,6,5,13,25,43,-18,23
FC Salzburg,5754,1,14,7,3,45,18,27,49
SK Sturm Gra,5754,2,12,4,8,31,32,-1,40
Rapid Vienna,5754,3,9,9,6,35,26,9,36
LASK Linz,5754,4,10,5,9,28,27,1,35
SC Rheindorf,5754,5,6,6,12,23,28,-5,24
Vienna,5754,6,6,6,12,25,40,-15,24
Mattersburg,5754,7,5,7,12,28,44,-16,22
FC Salzburg,5755,1,14,6,4,47,20,27,48
SK Sturm Gra,5755,2,13,3,8,32,32,0,42
Rapid Vienna,5755,3,9,9,6,39,30,9,36
LASK Linz,5755,4,8,5,11,26,33,-7,29
Vienna,5755,5,7,6,11,26,39,-13,27
SC Rheindorf,5755,6,7,5,12,23,28,-5,26
Mattersburg,5755,7,6,6,12,30,41,-11,24
FC Salzburg,5756,1,14,6,4,43,20,23,48
SK Sturm Gra,5756,2,12,3,9,31,31,0,39
LASK Linz,5756,3,10,6,8,33,27,6,36
Rapid Vienna,5756,4,8,10,6,36,29,7,34
Vienna,5756,5,8,5,11,26,38,-12,29
SC Rheindorf,5756,6,6,6,12,21,32,-11,24
Mattersburg,5756,7,5,6,13,30,43,-13,21
FC Salzburg,5757,1,14,7,3,44,19,25,49
SK Sturm Gra,5757,2,12,5,7,34,28,6,41
Rapid Vienna,5757,3,8,12,4,33,24,9,36
LASK Linz,5757,4,8,7,9,28,29,-1,31
Vienna,5757,5,8,5,11,29,39,-10,29
Mattersburg,5757,6,6,6,12,30,43,-13,24
SC Rheindorf,5757,7,4,6,14,16,32,-16,18
FC Salzburg,5758,1,14,7,3,45,19,26,49
SK Sturm Gra,5758,2,13,4,7,33,27,6,43
Rapid Vienna,5758,3,9,10,5,36,27,9,37
LASK Linz,5758,4,9,5,10,26,28,-2,32
Vienna,5758,5,6,7,11,25,39,-14,25
SC Rheindorf,5758,6,6,5,13,17,29,-12,23
Mattersburg,5758,7,5,6,13,29,42,-13,21
FC Salzburg,5759,1,15,6,3,44,18,26,51
SK Sturm Gra,5759,2,13,3,8,32,28,4,42
Rapid Vienna,5759,3,9,9,6,34,29,5,36
LASK Linz,5759,4,8,6,10,29,28,1,30
Mattersburg,5759,5,7,6,11,35,41,-6,27
SC Rheindorf,5759,6,6,5,13,18,31,-13,23
Vienna,5759,7,6,5,13,24,41,-17,23
FC Salzburg,5760,1,14,7,3,46,18,28,49
SK Sturm Gra,5760,2,13,4,7,34,30,4,43
Rapid Vienna,5760,3,9,10,5,38,29,9,37
LASK Linz,5760,4,8,6,10,28,30,-2,30
Mattersburg,5760,5,7,6,11,33,45,-12,27
Vienna,5760,6,6,6,12,27,42,-15,24
SC Rheindorf,5760,7,5,5,14,18,30,-12,20
FC Salzburg,5761,1,12,7,5,41,22,19,43
SK Sturm Gra,5761,2,12,5,7,30,27,3,41
Rapid Vienna,5761,3,10,10,4,44,26,18,40
LASK Linz,5761,4,8,6,10,30,30,0,30
Vienna,5761,5,8,5,11,26,37,-11,29
SC Rheindorf,5761,6,6,6,12,22,37,-15,24
Mattersburg,5761,7,6,5,13,29,43,-14,23
FC Salzburg,5762,1,14,6,4,43,20,23,48
Rapid Vienna,5762,2,10,10,4,40,27,13,40
SK Sturm Gra,5762,3,12,3,9,32,31,1,39
Mattersburg,5762,4,8,5,11,34,40,-6,29
LASK Linz,5762,5,7,7,10,26,31,-5,28
Vienna,5762,6,7,5,12,24,39,-15,26
SC Rheindorf,5762,7,5,6,13,18,29,-11,21
FC Salzburg,5763,1,14,6,4,41,17,24,48
SK Sturm Gra,5763,2,12,5,7,33,30,3,41
Rapid Vienna,5763,3,9,11,4,35,25,10,38
LASK Linz,5763,4,8,7,9,27,28,-1,31
Mattersburg,5763,5,7,7,10,30,37,-7,28
Vienna,5763,6,6,6,12,24,39,-15,24
SC Rheindorf,5763,7,4,6,14,18,32,-14,18
FC Salzburg,5764,1,16,6,2,50,19,31,54
SK Sturm Gra,5764,2,12,5,7,33,29,4,41
Rapid Vienna,5764,3,8,9,7,32,32,0,33
LASK Linz,5764,4,8,7,9,30,28,2,31
Vienna,5764,5,7,5,12,28,41,-13,26
SC Rheindorf,5764,6,5,7,12,20,30,-10,22
Mattersburg,5764,7,5,7,12,32,46,-14,22
FC Salzburg,5765,1,15,7,2,49,18,31,52
SK Sturm Gra,5765,2,12,6,6,34,28,6,42
Rapid Vienna,5765,3,7,10,7,33,29,4,31
LASK Linz,5765,4,8,7,9,27,29,-2,31
Mattersburg,5765,5,7,6,11,34,43,-9,27
Vienna,5765,6,6,5,13,25,44,-19,23
SC Rheindorf,5765,7,5,7,12,19,30,-11,22
FC Salzburg,5766,1,15,6,3,54,22,32,51
SK Sturm Gra,5766,2,14,3,7,35,27,8,45
Rapid Vienna,5766,3,8,10,6,36,31,5,34
LASK Linz,5766,4,8,5,11,28,31,-3,29
SC Rheindorf,5766,5,6,6,12,20,29,-9,24
Mattersburg,5766,6,6,6,12,31,45,-14,24
Vienna,5766,7,6,6,12,25,44,-19,24
FC Salzburg,5767,1,15,7,2,44,17,27,52
SK Sturm Gra,5767,2,13,3,8,37,33,4,42
Rapid Vienna,5767,3,8,9,7,35,29,6,33
LASK Linz,5767,4,8,5,11,26,32,-6,29
SC Rheindorf,5767,5,7,5,12,23,29,-6,26
Vienna,5767,6,7,5,12,25,38,-13,26
Mattersburg,5767,7,6,6,12,29,41,-12,24
FC Salzburg,5768,1,14,7,3,45,19,26,49
Rapid Vienna,5768,2,11,9,4,40,24,16,42
SK Sturm Gra,5768,3,12,4,8,35,30,5,40
LASK Linz,5768,4,8,6,10,28,32,-4,30
Mattersburg,5768,5,6,6,12,32,45,-13,24
Vienna,5768,6,6,6,12,25,40,-15,24
SC Rheindorf,5768,7,5,6,13,19,34,-15,21
FC Salzburg,5769,1,15,7,2,45,17,28,52
SK Sturm Gra,5769,2,12,5,7,32,29,3,41
Rapid Vienna,5769,3,7,10,7,36,32,4,31
LASK Linz,5769,4,7,9,8,28,29,-1,30
Mattersburg,5769,5,7,6,11,34,40,-6,27
SC Rheindorf,5769,6,6,6,12,20,30,-10,24
Vienna,5769,7,6,5,13,25,43,-18,23
FC Salzburg,5770,1,14,7,3,47,21,26,49
SK Sturm Gra,5770,2,13,4,7,32,28,4,43
LASK Linz,5770,3,10,6,8,29,27,2,36
Rapid Vienna,5770,4,8,9,7,36,31,5,33
Vienna,5770,5,6,6,12,25,41,-16,24
SC Rheindorf,5770,6,6,5,13,24,31,-7,23
Mattersburg,5770,7,5,7,12,30,44,-14,22
FC Salzburg,5771,1,14,7,3,46,18,28,49
SK Sturm Gra,5771,2,13,5,6,36,28,8,44
Rapid Vienna,5771,3,8,10,6,37,26,11,34
LASK Linz,5771,4,8,8,8,27,27,0,32
Vienna,5771,5,7,6,11,26,39,-13,27
Mattersburg,5771,6,5,7,12,28,44,-16,22
SC Rheindorf,5771,7,4,7,13,16,34,-18,19
FC Salzburg,5772,1,14,7,3,45,19,26,49
SK Sturm Gra,5772,2,11,4,9,33,34,-1,37
Rapid Vienna,5772,3,8,10,6,36,28,8,34
LASK Linz,5772,4,9,6,9,28,28,0,33
Vienna,5772,5,7,6,11,24,37,-13,27
SC Rheindorf,5772,6,7,5,12,22,31,-9,26
Mattersburg,5772,7,5,8,11,30,41,-11,23
FC Salzburg,5773,1,13,7,4,41,21,20,46
SK Sturm Gra,5773,2,13,3,8,33,30,3,42
Rapid Vienna,5773,3,10,10,4,39,26,13,40
LASK Linz,5773,4,8,5,11,26,29,-3,29
Vienna,5773,5,8,5,11,28,38,-10,29
Mattersburg,5773,6,7,5,12,32,41,-9,26
SC Rheindorf,5773,7,5,5,14,18,32,-14,20
FC Salzburg,5774,1,15,7,2,44,16,28,52
SK Sturm Gra,5774,2,12,4,8,32,30,2,40
Rapid Vienna,5774,3,8,10,6,35,27,8,34
LASK Linz,5774,4,8,6,10,26,29,-3,30
Vienna,5774,5,7,6,11,28,39,-11,27
Mattersburg,5774,6,6,6,12,29,43,-14,24
SC Rheindorf,5774,7,4,9,11,17,27,-10,21
FC Salzburg,5775,1,16,6,2,51,19,32,54
Rapid Vienna,5775,2,9,9,6,35,28,7,36
SK Sturm Gra,5775,3,11,3,10,31,32,-1,36
LASK Linz,5775,4,9,7,8,27,26,1,34
Vienna,5775,5,6,6,12,25,40,-15,24
Mattersburg,5775,6,5,8,11,30,44,-14,23
SC Rheindorf,5775,7,5,7,12,19,29,-10,22
FC Salzburg,5776,1,14,7,3,44,18,26,49
SK Sturm Gra,5776,2,14,4,6,34,26,8,46
Rapid Vienna,5776,3,8,10,6,35,29,6,34
LASK Linz,5776,4,7,8,9,26,28,-2,29
Vienna,5776,5,7,6,11,26,38,-12,27
Mattersburg,5776,6,6,6,12,32,44,-12,24
SC Rheindorf,5776,7,5,5,14,18,32,-14,20
FC Salzburg,5777,1,14,7,3,42,17,25,49
SK Sturm Gra,5777,2,12,4,8,30,29,1,40
Rapid Vienna,5777,3,9,10,5,36,26,10,37
LASK Linz,5777,4,7,8,9,27,29,-2,29
Mattersburg,5777,5,7,7,10,34,41,-7,28
Vienna,5777,6,6,6,12,25,40,-15,24
SC Rheindorf,5777,7,5,6,13,19,31,-12,21
FC Salzburg,5778,1,13,8,3,41,20,21,47
SK Sturm Gra,5778,2,14,4,6,34,26,8,46
Rapid Vienna,5778,3,9,10,5,39,27,12,37
LASK Linz,5778,4,7,6,11,25,30,-5,27
Mattersburg,5778,5,6,7,11,28,37,-9,25
Vienna,5778,6,6,7,11,24,38,-14,25
SC Rheindorf,5778,7,5,6,13,18,31,-13,21
FC Salzburg,5779,1,14,7,3,45,20,25,49
SK Sturm Gra,5779,2,12,3,9,30,29,1,39
Rapid Vienna,5779,3,9,10,5,39,29,10,37
LASK Linz,5779,4,10,5,9,29,27,2,35
Mattersburg,5779,5,7,5,12,31,43,-12,26
SC Rheindorf,5779,6,6,5,13,21,30,-9,23
Vienna,5779,7,6,5,13,24,41,-17,23
FC Salzburg,5780,1,15,7,2,46,17,29,52
SK Sturm Gra,5780,2,11,4,9,31,35,-4,37
Rapid Vienna,5780,3,8,11,5,33,25,8,35
LASK Linz,5780,4,8,7,9,29,30,-1,31
SC Rheindorf,5780,5,6,7,11,22,28,-6,25
Vienna,5780,6,6,6,12,26,41,-15,24
Mattersburg,5780,7,5,8,11,29,40,-11,23
FC Salzburg,5781,1,12,9,3,44,24,20,45
SK Sturm Gra,5781,2,13,5,6,36,29,7,44
Rapid Vienna,5781,3,10,9,5,42,28,14,39
LASK Linz,5781,4,8,5,11,28,33,-5,29
Mattersburg,5781,5,6,7,11,29,39,-10,25
Vienna,5781,6,6,7,11,26,40,-14,25
SC Rheindorf,5781,7,5,6,13,18,30,-12,21
FC Salzburg,5782,1,14,8,2,47,20,27,50
SK Sturm Gra,5782,2,13,3,8,33,31,2,42
Rapid Vienna,5782,3,9,10,5,39,30,9,37
LASK Linz,5782,4,8,5,11,27,30,-3,29
Vienna,5782,5,7,6,11,25,38,-13,27
SC Rheindorf,5782,6,6,5,13,20,30,-10,23
Mattersburg,5782,7,6,5,13,32,44,-12,23
FC Salzburg,5783,1,15,6,3,48,18,30,51
SK Sturm Gra,5783,2,12,4,8,34,33,1,40
LASK Linz,5783,3,9,7,8,27,26,1,34
Rapid Vienna,5783,4,8,9,7,35,29,6,33
Mattersburg,5783,5,6,7,11,31,45,-14,25
SC Rheindorf,5783,6,6,6,12,21,29,-8,24
Vienna,5783,7,6,5,13,26,42,-16,23
FC Salzburg,5784,1,13,7,4,43,24,19,46
SK Sturm Gra,5784,2,12,4,8,33,31,2,40
Rapid Vienna,5784,3,9,9,6,38,26,12,36
LASK Linz,5784,4,9,6,9,29,28,1,33
Mattersburg,5784,5,7,6,11,31,41,-10,27
Vienna,5784,6,7,5,12,24,38,-14,26
SC Rheindorf,5784,7,6,5,13,19,29,-10,23
FC Salzburg,5785,1,14,8,2,45,19,26,50
SK Sturm Gra,5785,2,12,5,7,34,30,4,41
Rapid Vienna,5785,3,8,10,6,38,32,6,34
LASK Linz,5785,4,8,6,10,30,33,-3,30
Mattersburg,5785,5,7,6,11,32,40,-8,27
Vienna,5785,6,7,5,12,26,39,-13,26
SC Rheindorf,5785,7,5,6,13,22,34,-12,21
FC Salzburg,5786,1,13,7,4,41,18,23,46
SK Sturm Gra,5786,2,13,3,8,32,28,4,42
Rapid Vienna,5786,3,9,9,6,36,27,9,36
LASK Linz,5786,4,8,7,9,28,30,-2,31
Mattersburg,5786,5,6,8,10,29,38,-9,26
Vienna,5786,6,6,7,11,23,37,-14,25
SC Rheindorf,5786,7,5,7,12,20,31,-11,22
FC Salzburg,5787,1,15,7,2,46,19,27,52
SK Sturm Gra,5787,2,12,5,7,32,29,3,41
Rapid Vienna,5787,3,8,11,5,39,29,10,35
LASK Linz,5787,4,7,8,9,26,28,-2,29
Mattersburg,5787,5,6,8,10,32,40,-8,26
Vienna,5787,6,6,6,12,25,40,-15,24
SC Rheindorf,5787,7,4,7,13,18,33,-15,19
FC Salzburg,5788,1,13,9,2,41,17,24,48
SK Sturm Gra,5788,2,14,3,7,34,28,6,45
Rapid Vienna,5788,3,7,11,6,33,30,3,32
LASK Linz,5788,4,8,7,9,29,27,2,31
Mattersburg,5788,5,6,8,10,30,39,-9,26
Vienna,5788,6,6,7,11,26,40,-14,25
SC Rheindorf,5788,7,4,7,13,20,32,-12,19
FC Salzburg,5789,1,14,6,4,43,20,23,48
SK Sturm Gra,5789,2,14,3,7,38,32,6,45
Rapid Vienna,5789,3,9,9,6,36,28,8,36
LASK Linz,5789,4,9,5,10,31,31,0,32
Mattersburg,5789,5,6,6,12,28,40,-12,24
Vienna,5789,6,6,6,12,24,39,-15,24
SC Rheindorf,5789,7,6,5,13,19,29,-10,23
FC Salzburg,5790,1,14,8,2,47,17,30,50
SK Sturm Gra,5790,2,13,4,7,34,26,8,43
LASK Linz,5790,3,9,6,9,28,28,0,33
Rapid Vienna,5790,4,7,10,7,35,34,1,31
Mattersburg,5790,5,7,5,12,30,43,-13,26
Vienna,5790,6,6,6,12,24,39,-15,24
SC Rheindorf,5790,7,5,7,12,19,30,-11,22
FC Salzburg,5791,1,12,10,2,46,23,23,46
SK Sturm Gra,5791,2,13,4,7,32,26,6,43
Rapid Vienna,5791,3,7,11,6,32,28,4,32
LASK Linz,5791,4,8,5,11,26,28,-2,29
Mattersburg,5791,5,7,6,11,34,43,-9,27
Vienna,5791,6,7,6,11,28,40,-12,27
SC Rheindorf,5791,7,6,6,12,18,28,-10,24
FC Salzburg,5792,1,13,7,4,42,20,22,46
SK Sturm Gra,5792,2,14,3,7,35,27,8,45
Rapid Vienna,5792,3,10,10,4,35,24,11,40
LASK Linz,5792,4,9,5,10,27,29,-2,32
Vienna,5792,5,6,6,12,24,40,-16,24
Mattersburg,5792,6,6,5,13,28,42,-14,23
SC Rheindorf,5792,7,5,6,13,20,29,-9,21
FC Salzburg,5793,1,15,6,3,44,19,25,51
SK Sturm Gra,5793,2,14,4,6,37,29,8,46
Rapid Vienna,5793,3,8,10,6,37,29,8,34
LASK Linz,5793,4,8,7,9,31,32,-1,31
Mattersburg,5793,5,7,6,11,37,42,-5,27
Vienna,5793,6,6,5,13,23,39,-16,23
SC Rheindorf,5793,7,4,6,14,17,36,-19,18
FC Salzburg,5794,1,14,7,3,45,20,25,49
SK Sturm Gra,5794,2,12,5,7,32,27,5,41
Rapid Vienna,5794,3,9,10,5,36,27,9,37
LASK Linz,5794,4,8,6,10,26,29,-3,30
Mattersburg,5794,5,7,5,12,34,45,-11,26
Vienna,5794,6,7,5,12,27,40,-13,26
SC Rheindorf,5794,7,5,6,13,20,32,-12,21
FC Salzburg,5795,1,13,9,2,43,17,26,48
SK Sturm Gra,5795,2,12,4,8,33,28,5,40
Rapid Vienna,5795,3,8,11,5,34,26,8,35
LASK Linz,5795,4,9,5,10,26,29,-3,32
Mattersburg,5795,5,8,5,11,29,39,-10,29
Vienna,5795,6,6,6,12,24,39,-15,24
SC Rheindorf,5795,7,5,6,13,18,29,-11,21
FC Salzburg,5796,1,15,6,3,44,17,27,51
SK Sturm Gra,5796,2,11,5,8,31,31,0,38
Rapid Vienna,5796,3,8,10,6,34,28,6,34
LASK Linz,5796,4,7,8,9,27,29,-2,29
SC Rheindorf,5796,5,7,6,11,22,28,-6,27
Vienna,5796,6,7,5,12,25,39,-14,26
Mattersburg,5796,7,6,6,12,29,40,-11,24
FC Salzburg,5797,1,14,7,3,42,18,24,49
SK Sturm Gra,5797,2,12,3,9,33,31,2,39
Rapid Vienna,5797,3,8,10,6,35,28,7,34
LASK Linz,5797,4,9,6,9,29,28,1,33
Mattersburg,5797,5,8,5,11,30,38,-8,29
Vienna,5797,6,6,6,12,25,40,-15,24
SC Rheindorf,5797,7,6,5,13,19,30,-11,23
FC Salzburg,5798,1,14,7,3,49,20,29,49
SK Sturm Gra,5798,2,13,3,8,35,31,4,42
Rapid Vienna,5798,3,9,10,5,36,27,9,37
LASK Linz,5798,4,8,5,11,27,31,-4,29
Mattersburg,5798,5,7,6,11,32,43,-11,27
Vienna,5798,6,7,6,11,27,40,-13,27
SC Rheindorf,5798,7,5,5,14,17,31,-14,20
FC Salzburg,5799,1,15,6,3,45,17,28,51
SK Sturm Gra,5799,2,12,4,8,33,32,1,40
LASK Linz,5799,3,8,7,9,28,33,-5,31
Rapid Vienna,5799,4,7,9,8,33,30,3,30
SC Rheindorf,5799,5,8,5,11,31,30,1,29
Vienna,5799,6,8,5,11,26,38,-12,29
Mattersburg,5799,7,5,6,13,32,48,-16,21
FC Salzburg,5800,1,15,6,3,46,20,26,51
SK Sturm Gra,5800,2,13,3,8,33,29,4,42
Rapid Vienna,5800,3,8,10,6,34,27,7,34
LASK Linz,5800,4,8,7,9,26,29,-3,31
Mattersburg,5800,5,7,5,12,33,44,-11,26
Vienna,5800,6,7,5,12,28,41,-13,26
SC Rheindorf,5800,7,5,6,13,19,29,-10,21
FC Salzburg,5801,1,14,7,3,45,19,26,49
SK Sturm Gra,5801,2,13,4,7,34,28,6,43
Rapid Vienna,5801,3,9,9,6,35,28,7,36
LASK Linz,5801,4,8,7,9,27,28,-1,31
Mattersburg,5801,5,6,7,11,34,42,-8,25
Vienna,5801,6,6,6,12,26,41,-15,24
SC Rheindorf,5801,7,5,6,13,18,33,-15,21
FC Salzburg,5802,1,13,7,4,42,19,23,46
SK Sturm Gra,5802,2,12,5,7,32,30,2,41
Rapid Vienna,5802,3,8,11,5,34,26,8,35
LASK Linz,5802,4,8,7,9,31,31,0,31
Mattersburg,5802,5,7,6,11,33,44,-11,27
Vienna,5802,6,6,7,11,24,38,-14,25
SC Rheindorf,5802,7,5,7,12,21,29,-8,22
FC Salzburg,5803,1,15,7,2,48,18,30,52
SK Sturm Gra,5803,2,11,5,8,31,29,2,38
Rapid Vienna,5803,3,9,9,6,36,29,7,36
LASK Linz,5803,4,9,7,8,30,28,2,34
Vienna,5803,5,7,5,12,25,41,-16,26
Mattersburg,5803,6,6,5,13,33,46,-13,23
SC Rheindorf,5803,7,5,6,13,19,31,-12,21
FC Salzburg,5804,1,14,6,4,43,20,23,48
SK Sturm Gra,5804,2,14,4,6,37,30,7,46
Rapid Vienna,5804,3,9,10,5,37,27,10,37
LASK Linz,5804,4,7,8,9,27,29,-2,29
Mattersburg,5804,5,6,7,11,31,41,-10,25
Vienna,5804,6,6,5,13,23,40,-17,23
SC Rheindorf,5804,7,4,8,12,20,31,-11,20
FC Salzburg,5805,1,15,7,2,42,15,27,52
Rapid Vienna,5805,2,9,9,6,34,28,6,36
SK Sturm Gra,5805,3,11,3,10,28,28,0,36
LASK Linz,5805,4,10,5,9,31,29,2,35
SC Rheindorf,5805,5,6,6,12,21,29,-8,24
Mattersburg,5805,6,6,6,12,31,42,-11,24
Vienna,5805,7,6,6,12,23,39,-16,24
FC Salzburg,5806,1,13,9,2,43,19,24,48
SK Sturm Gra,5806,2,12,4,8,31,30,1,40
Rapid Vienna,5806,3,9,10,5,34,25,9,37
LASK Linz,5806,4,10,5,9,29,28,1,35
Vienna,5806,5,7,6,11,28,41,-13,27
Mattersburg,5806,6,7,5,12,34,42,-8,26
SC Rheindorf,5806,7,4,5,15,17,31,-14,17
FC Salzburg,5807,1,15,7,2,48,19,29,52
SK Sturm Gra,5807,2,12,3,9,35,33,2,39
Rapid Vienna,5807,3,8,11,5,33,25,8,35
LASK Linz,5807,4,9,7,8,29,27,2,34
Vienna,5807,5,7,5,12,26,40,-14,26
SC Rheindorf,5807,6,5,7,12,19,29,-10,22
Mattersburg,5807,7,5,6,13,28,45,-17,21
FC Salzburg,5808,1,14,8,2,47,19,28,50
SK Sturm Gra,5808,2,12,5,7,37,36,1,41
Rapid Vienna,5808,3,8,12,4,39,27,12,36
LASK Linz,5808,4,7,8,9,25,27,-2,29
Mattersburg,5808,5,7,6,11,31,40,-9,27
Vienna,5808,6,6,5,13,23,42,-19,23
SC Rheindorf,5808,7,5,6,13,21,32,-11,21
FC Salzburg,5809,1,16,6,2,49,18,31,54
SK Sturm Gra,5809,2,13,4,7,37,30,7,43
Rapid Vienna,5809,3,8,10,6,36,27,9,34
LASK Linz,5809,4,9,6,9,30,31,-1,33
Mattersburg,5809,5,7,5,12,31,41,-10,26
Vienna,5809,6,6,5,13,25,43,-18,23
SC Rheindorf,5809,7,4,6,14,17,35,-18,18
FC Salzburg,5810,1,13,8,3,45,21,24,47
SK Sturm Gra,5810,2,12,5,7,37,31,6,41
LASK Linz,5810,3,10,6,8,37,29,8,36
Rapid Vienna,5810,4,7,9,8,34,35,-1,30
Vienna,5810,5,8,5,11,29,40,-11,29
Mattersburg,5810,6,6,6,12,32,44,-12,24
SC Rheindorf,5810,7,6,5,13,22,36,-14,23
FC Salzburg,5811,1,15,6,3,47,16,31,51
Rapid Vienna,5811,2,10,10,4,38,24,14,40
SK Sturm Gra,5811,3,12,4,8,34,31,3,40
LASK Linz,5811,4,8,8,8,29,29,0,32
Vienna,5811,5,7,5,12,24,44,-20,26
Mattersburg,5811,6,5,6,13,28,43,-15,21
SC Rheindorf,5811,7,5,5,14,20,33,-13,20
FC Salzburg,5812,1,14,6,4,41,20,21,48
SK Sturm Gra,5812,2,15,3,6,41,27,14,48
Rapid Vienna,5812,3,9,9,6,35,27,8,36
LASK Linz,5812,4,9,5,10,27,34,-7,32
Mattersburg,5812,5,7,5,12,33,42,-9,26
Vienna,5812,6,6,5,13,25,41,-16,23
SC Rheindorf,5812,7,5,5,14,19,30,-11,20
FC Salzburg,5813,1,15,7,2,46,16,30,52
SK Sturm Gra,5813,2,12,5,7,32,27,5,41
Rapid Vienna,5813,3,8,12,4,36,27,9,36
Mattersburg,5813,4,7,6,11,32,43,-11,27
LASK Linz,5813,5,7,5,12,25,35,-10,26
Vienna,5813,6,6,6,12,24,40,-16,24
SC Rheindorf,5813,7,5,7,12,24,31,-7,22
FC Salzburg,5814,1,14,7,3,43,22,21,49
SK Sturm Gra,5814,2,13,4,7,36,30,6,43
Rapid Vienna,5814,3,8,10,6,37,27,10,34
LASK Linz,5814,4,7,8,9,28,31,-3,29
Vienna,5814,5,7,6,11,27,40,-13,27
SC Rheindorf,5814,6,6,6,12,27,37,-10,24
Mattersburg,5814,7,6,5,13,34,45,-11,23
FC Salzburg,5815,1,16,6,2,53,18,35,54
SK Sturm Gra,5815,2,12,4,8,32,33,-1,40
Rapid Vienna,5815,3,10,9,5,41,28,13,39
LASK Linz,5815,4,7,6,11,25,30,-5,27
Mattersburg,5815,5,7,6,11,31,43,-12,27
Vienna,5815,6,6,6,12,25,41,-16,24
SC Rheindorf,5815,7,4,7,13,17,31,-14,19
FC Salzburg,5816,1,13,8,3,45,20,25,47
SK Sturm Gra,5816,2,12,5,7,35,29,6,41
Rapid Vienna,5816,3,8,12,4,37,27,10,36
Vienna,5816,4,8,5,11,30,40,-10,29
LASK Linz,5816,5,7,7,10,25,31,-6,28
Mattersburg,5816,6,6,6,12,33,48,-15,24
SC Rheindorf,5816,7,5,7,12,19,29,-10,22
FC Salzburg,5817,1,15,7,2,49,17,32,52
SK Sturm Gra,5817,2,14,3,7,37,31,6,45
Rapid Vienna,5817,3,8,10,6,37,31,6,34
LASK Linz,5817,4,8,6,10,28,32,-4,30
Vienna,5817,5,7,5,12,26,41,-15,26
SC Rheindorf,5817,6,6,5,13,20,30,-10,23
Mattersburg,5817,7,5,6,13,27,42,-15,21
FC Salzburg,5818,1,15,7,2,47,17,30,52
Rapid Vienna,5818,2,9,11,4,36,26,10,38
SK Sturm Gra,5818,3,11,4,9,32,33,-1,37
LASK Linz,5818,4,9,6,9,29,28,1,33
Mattersburg,5818,5,6,6,12,28,42,-14,24
Vienna,5818,6,6,5,13,23,40,-17,23
SC Rheindorf,5818,7,5,7,12,20,29,-9,22
FC Salzburg,5819,1,14,7,3,41,19,22,49
SK Sturm Gra,5819,2,13,4,7,36,28,8,43
Rapid Vienna,5819,3,8,11,5,35,28,7,35
LASK Linz,5819,4,9,5,10,30,30,0,32
Vienna,5819,5,7,5,12,26,39,-13,26
Mattersburg,5819,6,6,6,12,30,43,-13,24
SC Rheindorf,5819,7,4,8,12,20,31,-11,20
FC Salzburg,5820,1,15,7,2,47,17,30,52
SK Sturm Gra,5820,2,12,5,7,34,29,5,41
Rapid Vienna,5820,3,8,10,6,36,30,6,34
LASK Linz,5820,4,9,5,10,28,31,-3,32
Mattersburg,5820,5,7,6,11,34,39,-5,27
Vienna,5820,6,6,5,13,24,42,-18,23
SC Rheindorf,5820,7,5,6,13,17,32,-15,21
FC Salzburg,5821,1,14,7,3,43,18,25,49
SK Sturm Gra,5821,2,13,4,7,36,28,8,43
LASK Linz,5821,3,11,5,8,31,26,5,38
Rapid Vienna,5821,4,8,9,7,35,31,4,33
Mattersburg,5821,5,8,5,11,33,40,-7,29
Vienna,5821,6,6,5,13,24,41,-17,23
SC Rheindorf,5821,7,4,5,15,16,34,-18,17
FC Salzburg,5822,1,12,7,5,41,21,20,43
SK Sturm Gra,5822,2,12,5,7,33,26,7,41
Rapid Vienna,5822,3,9,9,6,34,30,4,36
LASK Linz,5822,4,9,7,8,30,27,3,34
Mattersburg,5822,5,7,6,11,33,41,-8,27
Vienna,5822,6,7,6,11,27,40,-13,27
SC Rheindorf,5822,7,5,6,13,20,33,-13,21
FC Salzburg,5823,1,14,6,4,47,22,25,48
SK Sturm Gra,5823,2,13,5,6,35,29,6,44
Rapid Vienna,5823,3,9,11,4,37,26,11,38
LASK Linz,5823,4,9,6,9,27,26,1,33
Vienna,5823,5,7,5,12,28,40,-12,26
Mattersburg,5823,6,6,5,13,27,45,-18,23
SC Rheindorf,5823,7,4,6,14,15,28,-13,18
FC Salzburg,5824,1,13,8,3,42,18,24,47
Rapid Vienna,5824,2,10,10,4,36,25,11,40
SK Sturm Gra,5824,3,11,4,9,30,32,-2,37
LASK Linz,5824,4,9,6,9,30,27,3,33
Vienna,5824,5,8,5,11,26,37,-11,29
SC Rheindorf,5824,6,6,5,13,20,28,-8,23
Mattersburg,5824,7,5,6,13,29,46,-17,21
FC Salzburg,5825,1,14,8,2,44,18,26,50
SK Sturm Gra,5825,2,14,4,6,37,27,10,46
LASK Linz,5825,3,9,5,10,32,32,0,32
Rapid Vienna,5825,4,7,10,7,33,32,1,31
Vienna,5825,5,6,7,11,27,41,-14,25
Mattersburg,5825,6,6,6,12,31,42,-11,24
SC Rheindorf,5825,7,5,6,13,17,29,-12,21
FC Salzburg,5826,1,13,8,3,41,18,23,47
SK Sturm Gra,5826,2,12,6,6,32,27,5,42
Rapid Vienna,5826,3,8,10,6,35,27,8,34
Vienna,5826,4,8,5,11,26,38,-12,29
LASK Linz,5826,5,7,5,12,25,32,-7,26
SC Rheindorf,5826,6,6,7,11,20,28,-8,25
Mattersburg,5826,7,6,7,11,29,38,-9,25
FC Salzburg,5827,1,14,8,2,43,16,27,50
SK Sturm Gra,5827,2,13,3,8,36,30,6,42
Rapid Vienna,5827,3,8,11,5,34,28,6,35
LASK Linz,5827,4,8,6,10,25,29,-4,30
Vienna,5827,5,6,7,11,25,39,-14,25
SC Rheindorf,5827,6,5,8,11,18,27,-9,23
Mattersburg,5827,7,5,7,12,28,40,-12,22
FC Salzburg,5828,1,15,7,2,47,17,30,52
SK Sturm Gra,5828,2,11,5,8,33,32,1,38
Rapid Vienna,5828,3,9,10,5,39,30,9,37
LASK Linz,5828,4,7,7,10,25,29,-4,28
Vienna,5828,5,7,5,12,26,40,-14,26
SC Rheindorf,5828,6,6,7,11,24,30,-6,25
Mattersburg,5828,7,6,5,13,30,46,-16,23
FC Salzburg,5829,1,15,7,2,48,16,32,52
SK Sturm Gra,5829,2,13,4,7,35,27,8,43
Rapid Vienna,5829,3,8,10,6,35,28,7,34
LASK Linz,5829,4,9,5,10,27,30,-3,32
Mattersburg,5829,5,6,6,12,32,45,-13,24
Vienna,5829,6,6,6,12,24,41,-17,24
SC Rheindorf,5829,7,5,6,13,20,34,-14,21
FC Salzburg,5830,1,13,7,4,40,20,20,46
SK Sturm Gra,5830,2,13,5,6,37,30,7,44
Rapid Vienna,5830,3,10,10,4,38,25,13,40
LASK Linz,5830,4,8,5,11,29,32,-3,29
Mattersburg,5830,5,7,7,10,32,40,-8,28
Vienna,5830,6,6,6,12,25,41,-16,24
SC Rheindorf,5830,7,4,6,14,18,31,-13,18
FC Salzburg,5831,1,14,7,3,44,18,26,49
SK Sturm Gra,5831,2,12,5,7,37,31,6,41
Rapid Vienna,5831,3,9,10,5,38,30,8,37
LASK Linz,5831,4,7,6,11,31,36,-5,27
Mattersburg,5831,5,7,6,11,31,42,-11,27
Vienna,5831,6,6,7,11,23,37,-14,25
SC Rheindorf,5831,7,6,5,13,23,33,-10,23
FC Salzburg,5832,1,13,7,4,41,19,22,46
SK Sturm Gra,5832,2,13,4,7,33,27,6,43
Rapid Vienna,5832,3,9,11,4,36,26,10,38
LASK Linz,5832,4,8,6,10,27,29,-2,30
Mattersburg,5832,5,8,5,11,32,39,-7,29
Vienna,5832,6,7,5,12,25,39,-14,26
SC Rheindorf,5832,7,4,6,14,16,31,-15,18
FC Salzburg,5833,1,16,6,2,47,16,31,54
SK Sturm Gra,5833,2,12,5,7,31,29,2,41
Rapid Vienna,5833,3,9,10,5,40,30,10,37
LASK Linz,5833,4,8,5,11,27,32,-5,29
Vienna,5833,5,7,5,12,25,39,-14,26
SC Rheindorf,5833,6,6,6,12,21,29,-8,24
Mattersburg,5833,7,5,5,14,26,42,-16,20
FC Salzburg,5834,1,15,6,3,45,20,25,51
SK Sturm Gra,5834,2,12,5,7,34,28,6,41
Rapid Vienna,5834,3,8,9,7,33,32,1,33
LASK Linz,5834,4,8,6,10,28,28,0,30
Mattersburg,5834,5,7,5,12,31,41,-10,26
Vienna,5834,6,7,5,12,26,40,-14,26
SC Rheindorf,5834,7,6,6,12,19,27,-8,24
FC Salzburg,5835,1,15,6,3,42,16,26,51
SK Sturm Gra,5835,2,13,3,8,34,29,5,42
Rapid Vienna,5835,3,9,9,6,36,29,7,36
LASK Linz,5835,4,9,5,10,28,29,-1,32
Vienna,5835,5,7,5,12,27,40,-13,26
SC Rheindorf,5835,6,6,6,12,21,30,-9,24
Mattersburg,5835,7,5,6,13,29,44,-15,21
FC Salzburg,5836,1,14,7,3,44,21,23,49
SK Sturm Gra,5836,2,11,6,7,30,27,3,39
Rapid Vienna,5836,3,8,11,5,39,30,9,35
LASK Linz,5836,4,9,6,9,25,25,0,33
Mattersburg,5836,5,8,6,10,33,37,-4,30
Vienna,5836,6,6,5,13,23,41,-18,23
SC Rheindorf,5836,7,4,7,13,18,31,-13,19
FC Salzburg,5837,1,12,9,3,42,20,22,45
SK Sturm Gra,5837,2,13,5,6,35,28,7,44
Rapid Vienna,5837,3,9,10,5,34,26,8,37
LASK Linz,5837,4,10,5,9,30,26,4,35
Mattersburg,5837,5,6,7,11,30,40,-10,25
Vienna,5837,6,6,7,11,26,40,-14,25
SC Rheindorf,5837,7,4,5,15,17,34,-17,17
FC Salzburg,5838,1,14,7,3,45,20,25,49
SK Sturm Gra,5838,2,11,6,7,35,32,3,39
Rapid Vienna,5838,3,9,10,5,40,28,12,37
LASK Linz,5838,4,8,6,10,29,31,-2,30
Mattersburg,5838,5,7,6,11,32,40,-8,27
SC Rheindorf,5838,6,6,6,12,20,31,-11,24
Vienna,5838,7,6,5,13,24,43,-19,23
FC Salzburg,5839,1,13,7,4,42,21,21,46
SK Sturm Gra,5839,2,13,4,7,33,29,4,43
Rapid Vienna,5839,3,8,10,6,33,26,7,34
LASK Linz,5839,4,7,7,10,25,28,-3,28
Mattersburg,5839,5,7,6,11,34,42,-8,27
Vienna,5839,6,7,6,11,28,39,-11,27
SC Rheindorf,5839,7,6,6,12,20,30,-10,24
FC Salzburg,5840,1,14,7,3,43,22,21,49
Rapid Vienna,5840,2,11,9,4,41,25,16,42
SK Sturm Gra,5840,3,11,4,9,29,28,1,37
LASK Linz,5840,4,9,6,9,26,26,0,33
Mattersburg,5840,5,6,6,12,30,41,-11,24
SC Rheindorf,5840,6,6,5,13,18,28,-10,23
Vienna,5840,7,6,5,13,23,40,-17,23
FC Salzburg,5841,1,13,9,2,43,17,26,48
SK Sturm Gra,5841,2,12,6,6,31,26,5,42
Rapid Vienna,5841,3,7,11,6,36,32,4,32
LASK Linz,5841,4,7,7,10,25,29,-4,28
Mattersburg,5841,5,7,7,10,33,39,-6,28
Vienna,5841,6,6,7,11,25,39,-14,25
SC Rheindorf,5841,7,5,7,12,20,31,-11,22
FC Salzburg,5842,1,14,8,2,46,17,29,50
SK Sturm Gra,5842,2,13,3,8,32,28,4,42
Rapid Vienna,5842,3,9,10,5,36,27,9,37
LASK Linz,5842,4,9,5,10,28,29,-1,32
Mattersburg,5842,5,8,5,11,33,44,-11,29
Vienna,5842,6,6,6,12,24,40,-16,24
SC Rheindorf,5842,7,4,5,15,16,30,-14,17
FC Salzburg,5843,1,15,7,2,46,17,29,52
SK Sturm Gra,5843,2,11,4,9,31,33,-2,37
Rapid Vienna,5843,3,8,12,4,35,26,9,36
LASK Linz,5843,4,9,5,10,30,28,2,32
Mattersburg,5843,5,8,5,11,33,42,-9,29
Vienna,5843,6,6,5,13,26,42,-16,23
SC Rheindorf,5843,7,5,6,13,19,32,-13,21
FC Salzburg,5844,1,14,6,4,45,20,25,48
SK Sturm Gra,5844,2,13,5,6,36,28,8,44
Rapid Vienna,5844,3,9,11,4,37,27,10,38
LASK Linz,5844,4,7,5,12,25,33,-8,26
SC Rheindorf,5844,5,6,7,11,23,30,-7,25
Mattersburg,5844,6,6,6,12,30,42,-12,24
Vienna,5844,7,6,6,12,24,40,-16,24
FC Salzburg,5845,1,16,6,2,47,15,32,54
SK Sturm Gra,5845,2,13,4,7,36,29,7,43
Rapid Vienna,5845,3,8,10,6,37,28,9,34
LASK Linz,5845,4,9,5,10,30,33,-3,32
Vienna,5845,5,6,6,12,26,43,-17,24
Mattersburg,5845,6,5,7,12,31,45,-14,22
SC Rheindorf,5845,7,5,6,13,21,35,-14,21
FC Salzburg,5846,1,15,6,3,47,22,25,51
Rapid Vienna,5846,2,10,10,4,38,25,13,40
SK Sturm Gra,5846,3,12,3,9,30,28,2,39
LASK Linz,5846,4,10,5,9,27,27,0,35
Mattersburg,5846,5,6,6,12,33,42,-9,24
Vienna,5846,6,6,6,12,27,43,-16,24
SC Rheindorf,5846,7,4,6,14,16,31,-15,18
FC Salzburg,5847,1,14,7,3,45,22,23,49
SK Sturm Gra,5847,2,11,5,8,30,33,-3,38
Rapid Vienna,5847,3,8,9,7,37,32,5,33
LASK Linz,5847,4,8,6,10,28,30,-2,30
SC Rheindorf,5847,5,8,5,11,27,27,0,29
Mattersburg,5847,6,7,5,12,36,43,-7,26
Vienna,5847,7,7,5,12,29,45,-16,26
FC Salzburg,5848,1,14,7,3,46,20,26,49
SK Sturm Gra,5848,2,13,3,8,30,28,2,42
Rapid Vienna,5848,3,9,10,5,37,27,10,37
LASK Linz,5848,4,8,6,10,29,37,-8,30
Mattersburg,5848,5,6,7,11,35,44,-9,25
Vienna,5848,6,6,7,11,27,41,-14,25
SC Rheindorf,5848,7,5,6,13,25,32,-7,21
FC Salzburg,5849,1,15,7,2,48,18,30,52
SK Sturm Gra,5849,2,11,4,9,29,32,-3,37
Rapid Vienna,5849,3,7,13,4,33,25,8,34
LASK Linz,5849,4,9,6,9,29,26,3,33
Mattersburg,5849,5,7,5,12,30,40,-10,26
SC Rheindorf,5849,6,6,6,12,17,26,-9,24
Vienna,5849,7,6,5,13,23,42,-19,23
FC Salzburg,5850,1,15,6,3,49,20,29,51
SK Sturm Gra,5850,2,13,3,8,33,29,4,42
Rapid Vienna,5850,3,9,9,6,39,28,11,36
LASK Linz,5850,4,9,5,10,28,29,-1,32
Vienna,5850,5,7,5,12,27,43,-16,26
SC Rheindorf,5850,6,6,5,13,19,32,-13,23
Mattersburg,5850,7,6,5,13,33,47,-14,23
FC Salzburg,5851,1,15,7,2,45,16,29,52
SK Sturm Gra,5851,2,12,4,8,34,33,1,40
LASK Linz,5851,3,10,6,8,30,25,5,36
Rapid Vienna,5851,4,8,10,6,36,32,4,34
Mattersburg,5851,5,6,7,11,28,39,-11,25
Vienna,5851,6,6,6,12,23,38,-15,24
SC Rheindorf,5851,7,4,6,14,16,29,-13,18
FC Salzburg,5852,1,14,7,3,46,20,26,49
SK Sturm Gra,5852,2,14,3,7,33,29,4,45
Rapid Vienna,5852,3,7,11,6,34,28,6,32
Mattersburg,5852,4,7,6,11,35,41,-6,27
LASK Linz,5852,5,7,6,11,25,34,-9,27
Vienna,5852,6,7,5,12,26,39,-13,26
SC Rheindorf,5852,7,6,6,12,21,29,-8,24
FC Salzburg,5853,1,14,6,4,47,22,25,48
SK Sturm Gra,5853,2,13,5,6,33,27,6,44
Rapid Vienna,5853,3,7,10,7,34,32,2,31
LASK Linz,5853,4,8,7,9,28,27,1,31
Mattersburg,5853,5,7,7,10,36,42,-6,28
Vienna,5853,6,6,6,12,27,44,-17,24
SC Rheindorf,5853,7,6,5,13,19,30,-11,23
FC Salzburg,5854,1,15,7,2,47,17,30,52
SK Sturm Gra,5854,2,13,3,8,33,27,6,42
LASK Linz,5854,3,10,5,9,30,28,2,35
Rapid Vienna,5854,4,8,9,7,33,32,1,33
Vienna,5854,5,6,7,11,24,38,-14,25
Mattersburg,5854,6,6,6,12,28,41,-13,24
SC Rheindorf,5854,7,5,5,14,17,29,-12,20
FC Salzburg,5855,1,15,7,2,48,18,30,52
SK Sturm Gra,5855,2,12,3,9,33,33,0,39
Rapid Vienna,5855,3,9,9,6,38,29,9,36
LASK Linz,5855,4,8,5,11,30,34,-4,29
Mattersburg,5855,5,8,5,11,35,43,-8,29
Vienna,5855,6,6,6,12,26,42,-16,24
SC Rheindorf,5855,7,6,5,13,20,31,-11,23
FC Salzburg,5856,1,13,8,3,45,23,22,47
SK Sturm Gra,5856,2,13,3,8,34,27,7,42
Rapid Vienna,5856,3,8,11,5,34,27,7,35
Mattersburg,5856,4,8,6,10,36,42,-6,30
LASK Linz,5856,5,7,6,11,25,32,-7,27
Vienna,5856,6,7,5,12,28,41,-13,26
SC Rheindorf,5856,7,6,5,13,19,29,-10,23
FC Salzburg,5857,1,16,6,2,48,18,30,54
SK Sturm Gra,5857,2,12,3,9,34,33,1,39
Rapid Vienna,5857,3,9,9,6,38,28,10,36
LASK Linz,5857,4,10,5,9,31,30,1,35
Vienna,5857,5,7,5,12,27,43,-16,26
Mattersburg,5857,6,6,5,13,32,44,-12,23
SC Rheindorf,5857,7,5,5,14,21,35,-14,20
FC Salzburg,5858,1,15,6,3,48,19,29,51
SK Sturm Gra,5858,2,12,5,7,34,31,3,41
Rapid Vienna,5858,3,7,11,6,37,34,3,32
LASK Linz,5858,4,9,5,10,28,29,-1,32
Mattersburg,5858,5,8,6,10,34,41,-7,30
Vienna,5858,6,6,6,12,26,41,-15,24
SC Rheindorf,5858,7,4,7,13,16,28,-12,19
FC Salzburg,5859,1,15,7,2,45,16,29,52
Rapid Vienna,5859,2,9,10,5,35,27,8,37
SK Sturm Gra,5859,3,11,3,10,30,34,-4,36
LASK Linz,5859,4,9,6,9,29,27,2,33
Mattersburg,5859,5,7,5,12,34,43,-9,26
Vienna,5859,6,6,6,12,25,41,-16,24
SC Rheindorf,5859,7,6,5,13,23,33,-10,23
FC Salzburg,5860,1,13,7,4,40,19,21,46
Rapid Vienna,5860,2,9,11,4,40,26,14,38
SK Sturm Gra,5860,3,11,4,9,30,33,-3,37
LASK Linz,5860,4,9,7,8,31,28,3,34
Vienna,5860,5,8,5,11,29,37,-8,29
SC Rheindorf,5860,6,5,7,12,20,32,-12,22
Mattersburg,5860,7,5,7,12,29,44,-15,22
FC Salzburg,5861,1,14,6,4,46,23,23,48
Rapid Vienna,5861,2,10,9,5,38,27,11,39
SK Sturm Gra,5861,3,12,3,9,33,33,0,39
LASK Linz,5861,4,8,6,10,28,32,-4,30
Mattersburg,5861,5,8,5,11,36,42,-6,29
SC Rheindorf,5861,6,6,6,12,22,29,-7,24
Vienna,5861,7,6,5,13,27,44,-17,23
FC Salzburg,5862,1,14,7,3,41,17,24,49
SK Sturm Gra,5862,2,14,3,7,33,26,7,45
LASK Linz,5862,3,10,5,9,27,26,1,35
Rapid Vienna,5862,4,7,11,6,35,30,5,32
Vienna,5862,5,7,6,11,25,38,-13,27
Mattersburg,5862,6,5,7,12,28,40,-12,22
SC Rheindorf,5862,7,4,7,13,18,30,-12,19
FC Salzburg,5863,1,14,7,3,45,19,26,49
SK Sturm Gra,5863,2,13,4,7,34,28,6,43
LASK Linz,5863,3,10,5,9,30,28,2,35
Rapid Vienna,5863,4,8,10,6,36,30,6,34
Mattersburg,5863,5,6,6,12,29,41,-12,24
Vienna,5863,6,6,5,13,24,43,-19,23
SC Rheindorf,5863,7,5,7,12,19,28,-9,22
FC Salzburg,5864,1,14,7,3,44,19,25,49
SK Sturm Gra,5864,2,12,5,7,32,28,4,41
Rapid Vienna,5864,3,9,10,5,37,26,11,37
LASK Linz,5864,4,9,6,9,28,27,1,33
Vienna,5864,5,6,6,12,25,40,-15,24
SC Rheindorf,5864,6,5,7,12,18,30,-12,22
Mattersburg,5864,7,5,7,12,28,42,-14,22
FC Salzburg,5865,1,13,6,5,43,24,19,45
SK Sturm Gra,5865,2,13,5,6,31,25,6,44
Rapid Vienna,5865,3,8,11,5,36,28,8,35
LASK Linz,5865,4,9,6,9,28,28,0,33
Mattersburg,5865,5,7,5,12,35,41,-6,26
Vienna,5865,6,7,5,12,27,41,-14,26
SC Rheindorf,5865,7,5,6,13,19,32,-13,21
FC Salzburg,5866,1,13,8,3,40,17,23,47
SK Sturm Gra,5866,2,11,5,8,30,30,0,38
Rapid Vienna,5866,3,9,10,5,37,26,11,37
LASK Linz,5866,4,9,7,8,30,27,3,34
Vienna,5866,5,8,5,11,26,37,-11,29
SC Rheindorf,5866,6,5,7,12,18,30,-12,22
Mattersburg,5866,7,5,6,13,28,42,-14,21
FC Salzburg,5867,1,15,6,3,46,19,27,51
SK Sturm Gra,5867,2,12,3,9,34,33,1,39
Rapid Vienna,5867,3,9,10,5,39,32,7,37
LASK Linz,5867,4,10,5,9,32,30,2,35
Vienna,5867,5,7,6,11,25,37,-12,27
Mattersburg,5867,6,6,6,12,29,41,-12,24
SC Rheindorf,5867,7,4,6,14,19,32,-13,18
FC Salzburg,5868,1,14,8,2,45,17,28,50
SK Sturm Gra,5868,2,12,4,8,32,32,0,40
Rapid Vienna,5868,3,8,10,6,34,27,7,34
LASK Linz,5868,4,9,6,9,28,27,1,33
Mattersburg,5868,5,6,8,10,29,38,-9,26
Vienna,5868,6,6,6,12,26,42,-16,24
SC Rheindorf,5868,7,5,6,13,17,28,-11,21
FC Salzburg,5869,1,15,7,2,44,17,27,52
SK Sturm Gra,5869,2,12,4,8,31,29,2,40
Rapid Vienna,5869,3,8,10,6,36,27,9,34
LASK Linz,5869,4,8,5,11,26,28,-2,29
Vienna,5869,5,7,5,12,24,38,-14,26
Mattersburg,5869,6,6,7,11,29,39,-10,25
SC Rheindorf,5869,7,6,6,12,17,29,-12,24
FC Salzburg,5870,1,14,6,4,45,19,26,48
Rapid Vienna,5870,2,11,9,4,42,26,16,42
SK Sturm Gra,5870,3,11,4,9,34,36,-2,37
LASK Linz,5870,4,10,5,9,29,28,1,35
Vienna,5870,5,8,5,11,26,38,-12,29
SC Rheindorf,5870,6,5,6,13,20,32,-12,21
Mattersburg,5870,7,5,5,14,27,44,-17,20
FC Salzburg,5871,1,14,7,3,44,19,25,49
SK Sturm Gra,5871,2,12,4,8,31,27,4,40
Rapid Vienna,5871,3,10,9,5,39,27,12,39
LASK Linz,5871,4,9,6,9,29,28,1,33
Vienna,5871,5,7,6,11,25,38,-13,27
SC Rheindorf,5871,6,5,7,12,17,30,-13,22
Mattersburg,5871,7,5,5,14,26,42,-16,20
FC Salzburg,5872,1,15,6,3,44,18,26,51
SK Sturm Gra,5872,2,13,3,8,32,28,4,42
Rapid Vienna,5872,3,9,9,6,36,26,10,36
LASK Linz,5872,4,10,6,8,27,25,2,36
Vienna,5872,5,7,5,12,26,41,-15,26
Mattersburg,5872,6,6,6,12,30,42,-12,24
SC Rheindorf,5872,7,4,5,15,17,32,-15,17
FC Salzburg,5873,1,14,7,3,43,20,23,49
SK Sturm Gra,5873,2,13,3,8,36,31,5,42
Rapid Vienna,5873,3,8,10,6,35,30,5,34
LASK Linz,5873,4,9,5,10,29,31,-2,32
Vienna,5873,5,8,5,11,29,37,-8,29
Mattersburg,5873,6,6,6,12,29,42,-13,24
SC Rheindorf,5873,7,5,6,13,20,30,-10,21
FC Salzburg,5874,1,14,7,3,45,21,24,49
SK Sturm Gra,5874,2,13,5,6,34,27,7,44
Rapid Vienna,5874,3,9,10,5,38,29,9,37
LASK Linz,5874,4,8,8,8,28,27,1,32
Vienna,5874,5,7,5,12,27,40,-13,26
SC Rheindorf,5874,6,5,6,13,18,30,-12,21
Mattersburg,5874,7,5,5,14,27,43,-16,20
FC Salzburg,5875,1,16,6,2,51,18,33,54
SK Sturm Gra,5875,2,12,4,8,30,29,1,40
Rapid Vienna,5875,3,8,10,6,36,28,8,34
LASK Linz,5875,4,7,8,9,25,29,-4,29
Mattersburg,5875,5,8,5,11,33,40,-7,29
Vienna,5875,6,6,5,13,23,42,-19,23
SC Rheindorf,5875,7,5,6,13,17,29,-12,21
FC Salzburg,5876,1,14,6,4,50,22,28,48
SK Sturm Gra,5876,2,12,4,8,33,33,0,40
Rapid Vienna,5876,3,9,10,5,39,29,10,37
LASK Linz,5876,4,9,5,10,28,28,0,32
SC Rheindorf,5876,5,7,5,12,22,29,-7,26
Vienna,5876,6,7,5,12,27,39,-12,26
Mattersburg,5876,7,6,5,13,30,49,-19,23
FC Salzburg,5877,1,16,6,2,53,18,35,54
SK Sturm Gra,5877,2,12,3,9,30,30,0,39
LASK Linz,5877,3,11,5,8,32,26,6,38
Rapid Vienna,5877,4,7,9,8,35,34,1,30
Vienna,5877,5,7,5,12,27,41,-14,26
SC Rheindorf,5877,6,6,5,13,20,32,-12,23
Mattersburg,5877,7,6,5,13,33,49,-16,23
FC Salzburg,5878,1,15,6,3,46,20,26,51
SK Sturm Gra,5878,2,13,3,8,32,30,2,42
Rapid Vienna,5878,3,10,9,5,38,26,12,39
LASK Linz,5878,4,9,5,10,28,27,1,32
Vienna,5878,5,6,6,12,23,39,-16,24
Mattersburg,5878,6,5,7,12,28,42,-14,22
SC Rheindorf,5878,7,5,6,13,19,30,-11,21
FC Salzburg,5879,1,15,6,3,48,22,26,51
SK Sturm Gra,5879,2,14,3,7,36,28,8,45
Rapid Vienna,5879,3,9,9,6,39,32,7,36
LASK Linz,5879,4,9,6,9,28,28,0,33
Mattersburg,5879,5,7,6,11,30,39,-9,27
Vienna,5879,6,6,5,13,25,42,-17,23
SC Rheindorf,5879,7,4,5,15,20,35,-15,17
FC Salzburg,5880,1,14,6,4,43,22,21,48
SK Sturm Gra,5880,2,12,4,8,32,28,4,40
Rapid Vienna,5880,3,8,11,5,37,29,8,35
LASK Linz,5880,4,9,7,8,26,25,1,34
SC Rheindorf,5880,5,7,5,12,23,29,-6,26
Vienna,5880,6,7,5,12,26,40,-14,26
Mattersburg,5880,7,5,6,13,29,43,-14,21
FC Salzburg,5881,1,13,9,2,44,19,25,48
SK Sturm Gra,5881,2,13,4,7,33,29,4,43
Rapid Vienna,5881,3,8,10,6,36,28,8,34
LASK Linz,5881,4,9,5,10,30,29,1,32
Vienna,5881,5,6,7,11,25,39,-14,25
SC Rheindorf,5881,6,6,6,12,20,29,-9,24
Mattersburg,5881,7,5,7,12,27,42,-15,22
FC Salzburg,5882,1,16,6,2,46,16,30,54
SK Sturm Gra,5882,2,13,3,8,34,27,7,42
Rapid Vienna,5882,3,8,9,7,38,31,7,33
LASK Linz,5882,4,8,6,10,28,32,-4,30
Vienna,5882,5,7,5,12,26,40,-14,26
Mattersburg,5882,6,6,6,12,30,43,-13,24
SC Rheindorf,5882,7,6,5,13,19,32,-13,23
FC Salzburg,5883,1,15,7,2,49,17,32,52
SK Sturm Gra,5883,2,12,5,7,36,30,6,41
Rapid Vienna,5883,3,8,11,5,38,29,9,35
LASK Linz,5883,4,9,5,10,32,37,-5,32
Mattersburg,5883,5,6,6,12,29,42,-13,24
Vienna,5883,6,6,5,13,23,41,-18,23
SC Rheindorf,5883,7,5,7,12,17,28,-11,22
FC Salzburg,5884,1,15,7,2,46,16,30,52
SK Sturm Gra,5884,2,13,3,8,32,29,3,42
Rapid Vienna,5884,3,7,11,6,35,29,6,32
LASK Linz,5884,4,8,7,9,27,27,0,31
Mattersburg,5884,5,7,6,11,30,41,-11,27
Vienna,5884,6,6,6,12,23,39,-16,24
SC Rheindorf,5884,7,5,6,13,16,28,-12,21
FC Salzburg,5885,1,14,8,2,44,18,26,50
SK Sturm Gra,5885,2,11,5,8,30,30,0,38
Rapid Vienna,5885,3,8,11,5,35,27,8,35
LASK Linz,5885,4,8,7,9,28,29,-1,31
Mattersburg,5885,5,7,5,12,33,43,-10,26
SC Rheindorf,5885,6,6,6,12,20,28,-8,24
Vienna,5885,7,6,6,12,26,41,-15,24
FC Salzburg,5886,1,16,6,2,44,16,28,54
SK Sturm Gra,5886,2,12,4,8,34,30,4,40
Rapid Vienna,5886,3,9,9,6,33,26,7,36
LASK Linz,5886,4,10,6,8,32,26,6,36
Vienna,5886,5,7,5,12,24,39,-15,26
Mattersburg,5886,6,5,6,13,27,43,-16,21
SC Rheindorf,5886,7,4,6,14,17,31,-14,18
FC Salzburg,5887,1,13,8,3,41,17,24,47
SK Sturm Gra,5887,2,13,3,8,32,28,4,42
Rapid Vienna,5887,3,10,10,4,40,27,13,40
LASK Linz,5887,4,8,5,11,28,33,-5,29
Vienna,5887,5,7,6,11,26,39,-13,27
SC Rheindorf,5887,6,6,5,13,19,29,-10,23
Mattersburg,5887,7,6,5,13,30,43,-13,23
FC Salzburg,5888,1,15,7,2,48,20,28,52
Rapid Vienna,5888,2,10,9,5,37,26,11,39
SK Sturm Gra,5888,3,11,5,8,31,32,-1,38
LASK Linz,5888,4,7,7,10,28,32,-4,28
Mattersburg,5888,5,6,7,11,35,45,-10,25
Vienna,5888,6,6,6,12,26,42,-16,24
SC Rheindorf,5888,7,5,7,12,21,29,-8,22
FC Salzburg,5889,1,14,7,3,47,19,28,49
SK Sturm Gra,5889,2,12,4,8,33,30,3,40
LASK Linz,5889,3,10,6,8,27,25,2,36
Rapid Vienna,5889,4,8,11,5,34,26,8,35
Mattersburg,5889,5,7,5,12,30,42,-12,26
Vienna,5889,6,6,5,13,25,42,-17,23
SC Rheindorf,5889,7,5,6,13,19,31,-12,21
FC Salzburg,5890,1,15,6,3,45,19,26,51
SK Sturm Gra,5890,2,14,3,7,33,27,6,45
Rapid Vienna,5890,3,8,9,7,34,28,6,33
LASK Linz,5890,4,8,5,11,25,29,-4,29
Vienna,5890,5,8,5,11,29,38,-9,29
Mattersburg,5890,6,7,5,12,31,43,-12,26
SC Rheindorf,5890,7,5,5,14,16,29,-13,20
FC Salzburg,5891,1,15,7,2,45,19,26,52
SK Sturm Gra,5891,2,12,3,9,30,30,0,39
LASK Linz,5891,3,10,5,9,30,26,4,35
Rapid Vienna,5891,4,8,10,6,33,28,5,34
Mattersburg,5891,5,6,7,11,32,41,-9,25
Vienna,5891,6,6,6,12,25,40,-15,24
SC Rheindorf,5891,7,5,6,13,19,30,-11,21
FC Salzburg,5892,1,13,7,4,39,17,22,46
SK Sturm Gra,5892,2,13,3,8,33,30,3,42
Rapid Vienna,5892,3,10,10,4,38,25,13,40
LASK Linz,5892,4,9,6,9,27,26,1,33
Mattersburg,5892,5,7,6,11,33,41,-8,27
Vienna,5892,6,6,5,13,25,41,-16,23
SC Rheindorf,5892,7,5,5,14,18,33,-15,20
FC Salzburg,5893,1,13,8,3,42,19,23,47
SK Sturm Gra,5893,2,14,3,7,32,26,6,45
Rapid Vienna,5893,3,8,9,7,36,30,6,33
LASK Linz,5893,4,9,5,10,26,26,0,32
Mattersburg,5893,5,7,6,11,30,38,-8,27
Vienna,5893,6,6,6,12,25,41,-16,24
SC Rheindorf,5893,7,6,5,13,19,30,-11,23
FC Salzburg,5894,1,15,7,2,49,19,30,52
SK Sturm Gra,5894,2,13,4,7,32,28,4,43
Rapid Vienna,5894,3,7,12,5,33,28,5,33
LASK Linz,5894,4,8,5,11,26,27,-1,29
Mattersburg,5894,5,7,5,12,33,46,-13,26
Vienna,5894,6,7,5,12,27,40,-13,26
SC Rheindorf,5894,7,5,6,13,18,30,-12,21
FC Salzburg,5895,1,14,8,2,43,17,26,50
SK Sturm Gra,5895,2,12,4,8,34,32,2,40
Rapid Vienna,5895,3,10,9,5,39,27,12,39
LASK Linz,5895,4,8,6,10,29,33,-4,30
Vienna,5895,5,7,6,11,29,38,-9,27
Mattersburg,5895,6,6,6,12,32,46,-14,24
SC Rheindorf,5895,7,5,5,14,20,33,-13,20
FC Salzburg,5896,1,16,6,2,52,20,32,54
SK Sturm Gra,5896,2,13,4,7,41,30,11,43
LASK Linz,5896,3,10,5,9,31,31,0,35
Rapid Vienna,5896,4,7,9,8,32,33,-1,30
Vienna,5896,5,7,5,12,28,41,-13,26
SC Rheindorf,5896,6,6,6,12,22,30,-8,24
Mattersburg,5896,7,5,5,14,29,50,-21,20
FC Salzburg,5897,1,15,7,2,48,17,31,52
SK Sturm Gra,5897,2,11,5,8,30,31,-1,38
Rapid Vienna,5897,3,9,10,5,39,29,10,37
LASK Linz,5897,4,9,6,9,28,28,0,33
Vienna,5897,5,7,5,12,26,41,-15,26
Mattersburg,5897,6,5,8,11,31,42,-11,23
SC Rheindorf,5897,7,4,7,13,17,31,-14,19
FC Salzburg,5898,1,14,7,3,44,19,25,49
SK Sturm Gra,5898,2,11,5,8,32,30,2,38
Rapid Vienna,5898,3,9,10,5,35,26,9,37
LASK Linz,5898,4,8,7,9,28,29,-1,31
Mattersburg,5898,5,7,6,11,32,40,-8,27
Vienna,5898,6,7,5,12,25,39,-14,26
SC Rheindorf,5898,7,5,6,13,21,34,-13,21
FC Salzburg,5899,1,15,6,3,46,19,27,51
SK Sturm Gra,5899,2,12,4,8,31,28,3,40
LASK Linz,5899,3,9,7,8,28,27,1,34
Rapid Vienna,5899,4,8,9,7,33,27,6,33
Mattersburg,5899,5,7,5,12,32,44,-12,26
Vienna,5899,6,7,5,12,24,38,-14,26
SC Rheindorf,5899,7,5,6,13,19,30,-11,21
FC Salzburg,5900,1,15,6,3,46,17,29,51
SK Sturm Gra,5900,2,12,4,8,31,28,3,40
Rapid Vienna,5900,3,8,9,7,34,29,5,33
LASK Linz,5900,4,9,5,10,28,32,-4,32
Mattersburg,5900,5,7,6,11,35,46,-11,27
Vienna,5900,6,7,5,12,26,39,-13,26
SC Rheindorf,5900,7,5,7,12,21,30,-9,22
FC Salzburg,5901,1,13,7,4,42,20,22,46
SK Sturm Gra,5901,2,12,4,8,31,30,1,40
Rapid Vienna,5901,3,10,9,5,42,28,14,39
LASK Linz,5901,4,9,5,10,32,31,1,32
Vienna,5901,5,7,6,11,26,39,-13,27
Mattersburg,5901,6,6,7,11,29,40,-11,25
SC Rheindorf,5901,7,5,6,13,19,33,-14,21
FC Salzburg,5902,1,15,7,2,47,18,29,52
SK Sturm Gra,5902,2,13,4,7,37,32,5,43
LASK Linz,5902,3,9,7,8,31,27,4,34
Rapid Vienna,5902,4,8,9,7,34,31,3,33
Vienna,5902,5,6,7,11,25,39,-14,25
Mattersburg,5902,6,6,6,12,29,42,-13,24
SC Rheindorf,5902,7,4,6,14,19,33,-14,18
FC Salzburg,5903,1,15,7,2,49,19,30,52
SK Sturm Gra,5903,2,12,5,7,32,29,3,41
Rapid Vienna,5903,3,8,11,5,37,28,9,35
LASK Linz,5903,4,7,8,9,25,28,-3,29
Vienna,5903,5,6,6,12,25,41,-16,24
Mattersburg,5903,6,5,8,11,30,44,-14,23
SC Rheindorf,5903,7,5,7,12,22,31,-9,22
FC Salzburg,5904,1,15,6,3,45,17,28,51
Rapid Vienna,5904,2,9,11,4,35,23,12,38
SK Sturm Gra,5904,3,11,5,8,31,31,0,38
LASK Linz,5904,4,9,7,8,28,26,2,34
Vienna,5904,5,6,6,12,25,41,-16,24
SC Rheindorf,5904,6,6,5,13,20,32,-12,23
Mattersburg,5904,7,5,6,13,27,41,-14,21
FC Salzburg,5905,1,15,7,2,46,18,28,52
SK Sturm Gra,5905,2,13,3,8,33,28,5,42
Rapid Vienna,5905,3,8,10,6,34,30,4,34
LASK Linz,5905,4,9,5,10,27,27,0,32
Vienna,5905,5,7,6,11,27,38,-11,27
SC Rheindorf,5905,6,5,7,12,17,28,-11,22
Mattersburg,5905,7,5,6,13,28,43,-15,21
FC Salzburg,5906,1,13,6,5,39,19,20,45
Rapid Vienna,5906,2,10,10,4,39,25,14,40
SK Sturm Gra,5906,3,11,5,8,29,28,1,38
Vienna,5906,4,8,5,11,25,37,-12,29
LASK Linz,5906,5,7,7,10,29,32,-3,28
Mattersburg,5906,6,7,6,11,31,39,-8,27
SC Rheindorf,5906,7,6,5,13,21,33,-12,23
FC Salzburg,5907,1,14,7,3,49,19,30,49
Rapid Vienna,5907,2,11,9,4,41,26,15,42
SK Sturm Gra,5907,3,11,4,9,31,35,-4,37
LASK Linz,5907,4,9,6,9,33,30,3,33
Vienna,5907,5,6,7,11,26,40,-14,25
Mattersburg,5907,6,6,6,12,30,46,-16,24
SC Rheindorf,5907,7,5,5,14,20,34,-14,20
FC Salzburg,5908,1,13,7,4,42,20,22,46
SK Sturm Gra,5908,2,13,3,8,31,27,4,42
Rapid Vienna,5908,3,9,10,5,36,28,8,37
LASK Linz,5908,4,10,5,9,30,30,0,35
Vienna,5908,5,7,5,12,25,39,-14,26
Mattersburg,5908,6,6,7,11,34,42,-8,25
SC Rheindorf,5908,7,4,7,13,17,29,-12,19
FC Salzburg,5909,1,16,6,2,47,18,29,54
SK Sturm Gra,5909,2,12,4,8,32,28,4,40
Rapid Vienna,5909,3,8,10,6,35,29,6,34
LASK Linz,5909,4,8,8,8,28,28,0,32
Mattersburg,5909,5,7,6,11,33,43,-10,27
Vienna,5909,6,6,5,13,25,42,-17,23
SC Rheindorf,5909,7,4,7,13,17,29,-12,19
FC Salzburg,5910,1,16,6,2,50,19,31,54
SK Sturm Gra,5910,2,11,6,7,33,30,3,39
Rapid Vienna,5910,3,8,10,6,35,30,5,34
LASK Linz,5910,4,9,7,8,31,30,1,34
Mattersburg,5910,5,6,6,12,30,41,-11,24
Vienna,5910,6,6,6,12,25,41,-16,24
SC Rheindorf,5910,7,4,7,13,17,30,-13,19
FC Salzburg,5911,1,14,6,4,45,19,26,48
SK Sturm Gra,5911,2,13,3,8,34,30,4,42
Rapid Vienna,5911,3,9,9,6,36,29,7,36
LASK Linz,5911,4,9,6,9,31,29,2,33
Mattersburg,5911,5,7,5,12,32,44,-12,26
Vienna,5911,6,7,5,12,25,40,-15,26
SC Rheindorf,5911,7,5,6,13,17,29,-12,21
FC Salzburg,5912,1,14,7,3,46,19,27,49
SK Sturm Gra,5912,2,13,4,7,30,28,2,43
Rapid Vienna,5912,3,10,9,5,38,25,13,39
LASK Linz,5912,4,7,7,10,25,29,-4,28
Vienna,5912,5,7,6,11,26,38,-12,27
Mattersburg,5912,6,6,5,13,30,42,-12,23
SC Rheindorf,5912,7,5,6,13,17,31,-14,21
FC Salzburg,5913,1,13,7,4,41,18,23,46
Rapid Vienna,5913,2,11,9,4,36,24,12,42
SK Sturm Gra,5913,3,11,4,9,31,31,0,37
LASK Linz,5913,4,8,6,10,30,33,-3,30
Vienna,5913,5,8,5,11,28,40,-12,29
SC Rheindorf,5913,6,7,5,12,25,30,-5,26
Mattersburg,5913,7,5,6,13,31,46,-15,21
FC Salzburg,5914,1,15,7,2,52,19,33,52
SK Sturm Gra,5914,2,12,4,8,30,29,1,40
Rapid Vienna,5914,3,7,13,4,36,28,8,34
LASK Linz,5914,4,8,6,10,29,31,-2,30
Mattersburg,5914,5,7,5,12,34,47,-13,26
SC Rheindorf,5914,6,6,6,12,23,30,-7,24
Vienna,5914,7,6,5,13,26,46,-20,23
FC Salzburg,5915,1,15,7,2,48,18,30,52
SK Sturm Gra,5915,2,14,3,7,38,34,4,45
Rapid Vienna,5915,3,7,10,7,34,31,3,31
LASK Linz,5915,4,8,7,9,31,31,0,31
Vienna,5915,5,7,5,12,27,40,-13,26
SC Rheindorf,5915,6,5,7,12,17,27,-10,22
Mattersburg,5915,7,5,7,12,29,43,-14,22
FC Salzburg,5916,1,14,8,2,42,16,26,50
SK Sturm Gra,5916,2,11,5,8,30,31,-1,38
Rapid Vienna,5916,3,7,13,4,35,27,8,34
LASK Linz,5916,4,9,6,9,30,28,2,33
Vienna,5916,5,7,5,12,24,38,-14,26
SC Rheindorf,5916,6,6,7,11,21,28,-7,25
Mattersburg,5916,7,5,6,13,27,41,-14,21
FC Salzburg,5917,1,14,7,3,43,19,24,49
SK Sturm Gra,5917,2,14,4,6,36,29,7,46
Rapid Vienna,5917,3,7,11,6,35,29,6,32
LASK Linz,5917,4,8,7,9,27,28,-1,31
Mattersburg,5917,5,6,6,12,29,39,-10,24
SC Rheindorf,5917,6,5,8,11,19,28,-9,23
Vienna,5917,7,6,5,13,24,41,-17,23
FC Salzburg,5918,1,15,7,2,52,18,34,52
SK Sturm Gra,5918,2,13,3,8,31,35,-4,42
Rapid Vienna,5918,3,8,11,5,35,27,8,35
LASK Linz,5918,4,9,6,9,28,27,1,33
SC Rheindorf,5918,5,6,5,13,22,28,-6,23
Mattersburg,5918,6,6,5,13,29,45,-16,23
Vienna,5918,7,6,5,13,25,42,-17,23
FC Salzburg,5919,1,16,6,2,51,16,35,54
SK Sturm Gra,5919,2,12,5,7,29,28,1,41
Rapid Vienna,5919,3,8,9,7,35,28,7,33
LASK Linz,5919,4,9,6,9,27,27,0,33
Vienna,5919,5,7,5,12,25,42,-17,26
Mattersburg,5919,6,6,6,12,30,43,-13,24
SC Rheindorf,5919,7,4,7,13,18,31,-13,19
FC Salzburg,5920,1,15,6,3,47,18,29,51
SK Sturm Gra,5920,2,11,6,7,29,26,3,39
Rapid Vienna,5920,3,8,12,4,34,25,9,36
LASK Linz,5920,4,7,7,10,24,29,-5,28
Mattersburg,5920,5,7,5,12,32,42,-10,26
Vienna,5920,6,7,5,12,26,41,-15,26
SC Rheindorf,5920,7,5,7,12,16,27,-11,22
FC Salzburg,5921,1,14,7,3,44,18,26,49
SK Sturm Gra,5921,2,14,3,7,36,30,6,45
Rapid Vienna,5921,3,8,10,6,35,26,9,34
Mattersburg,5921,4,8,6,10,34,41,-7,30
LASK Linz,5921,5,8,5,11,25,31,-6,29
Vienna,5921,6,6,5,13,26,42,-16,23
SC Rheindorf,5921,7,5,6,13,18,30,-12,21
FC Salzburg,5922,1,14,7,3,43,17,26,49
SK Sturm Gra,5922,2,13,4,7,34,29,5,43
LASK Linz,5922,3,10,5,9,28,26,2,35
Rapid Vienna,5922,4,7,10,7,33,28,5,31
Vienna,5922,5,7,6,11,27,39,-12,27
Mattersburg,5922,6,7,5,12,32,42,-10,26
SC Rheindorf,5922,7,5,5,14,16,32,-16,20
FC Salzburg,5923,1,14,8,2,45,19,26,50
SK Sturm Gra,5923,2,11,5,8,28,27,1,38
Rapid Vienna,5923,3,8,9,7,35,31,4,33
LASK Linz,5923,4,9,5,10,29,28,1,32
Mattersburg,5923,5,7,6,11,32,41,-9,27
Vienna,5923,6,6,7,11,26,40,-14,25
SC Rheindorf,5923,7,6,6,12,19,28,-9,24
FC Salzburg,5924,1,13,7,4,45,23,22,46
SK Sturm Gra,5924,2,14,3,7,35,28,7,45
Mattersburg,5924,3,9,5,10,32,38,-6,32
Rapid Vienna,5924,4,7,9,8,35,34,1,30
LASK Linz,5924,5,8,6,10,26,27,-1,30
SC Rheindorf,5924,6,6,6,12,22,30,-8,24
Vienna,5924,7,6,6,12,25,40,-15,24
FC Salzburg,5925,1,13,8,3,42,19,23,47
Rapid Vienna,5925,2,9,10,5,38,29,9,37
LASK Linz,5925,3,10,6,8,31,28,3,36
SK Sturm Gra,5925,4,11,3,10,32,32,0,36
Vienna,5925,5,8,5,11,30,39,-9,29
Mattersburg,5925,6,5,8,11,30,44,-14,23
SC Rheindorf,5925,7,5,6,13,16,28,-12,21
FC Salzburg,5926,1,15,7,2,50,16,34,52
Rapid Vienna,5926,2,9,11,4,35,25,10,38
SK Sturm Gra,5926,3,11,4,9,29,30,-1,37
LASK Linz,5926,4,9,5,10,28,30,-2,32
SC Rheindorf,5926,5,7,5,12,21,27,-6,26
Mattersburg,5926,6,6,5,13,34,51,-17,23
Vienna,5926,7,6,5,13,26,44,-18,23
FC Salzburg,5927,1,15,6,3,45,17,28,51
SK Sturm Gra,5927,2,14,3,7,34,30,4,45
Rapid Vienna,5927,3,9,9,6,37,30,7,36
Mattersburg,5927,4,7,6,11,32,39,-7,27
LASK Linz,5927,5,7,5,12,25,32,-7,26
Vienna,5927,6,6,6,12,24,39,-15,24
SC Rheindorf,5927,7,6,5,13,20,30,-10,23
FC Salzburg,5928,1,14,7,3,43,17,26,49
SK Sturm Gra,5928,2,13,4,7,32,27,5,43
LASK Linz,5928,3,10,5,9,27,27,0,35
Rapid Vienna,5928,4,8,9,7,36,30,6,33
Vienna,5928,5,7,6,11,26,38,-12,27
SC Rheindorf,5928,6,5,7,12,19,30,-11,22
Mattersburg,5928,7,5,6,13,27,41,-14,21
FC Salzburg,5929,1,13,9,2,41,16,25,48
SK Sturm Gra,5929,2,13,4,7,33,25,8,43
LASK Linz,5929,3,10,5,9,27,27,0,35
Rapid Vienna,5929,4,7,11,6,33,27,6,32
SC Rheindorf,5929,5,6,6,12,21,32,-11,24
Vienna,5929,6,6,6,12,24,40,-16,24
Mattersburg,5929,7,5,7,12,30,42,-12,22
FC Salzburg,5930,1,15,7,2,45,16,29,52
SK Sturm Gra,5930,2,13,3,8,33,29,4,42
LASK Linz,5930,3,9,5,10,29,29,0,32
Rapid Vienna,5930,4,7,9,8,31,32,-1,30
SC Rheindorf,5930,5,7,5,12,24,32,-8,26
Vienna,5930,6,7,5,12,25,38,-13,26
Mattersburg,5930,7,6,6,12,30,41,-11,24
FC Salzburg,5931,1,14,8,2,47,18,29,50
SK Sturm Gra,5931,2,11,4,9,29,30,-1,37
Rapid Vienna,5931,3,9,9,6,33,28,5,36
LASK Linz,5931,4,9,5,10,27,28,-1,32
SC Rheindorf,5931,5,7,5,12,20,28,-8,26
Vienna,5931,6,7,5,12,27,40,-13,26
Mattersburg,5931,7,6,6,12,34,45,-11,24
FC Salzburg,5932,1,13,8,3,40,18,22,47
Rapid Vienna,5932,2,10,10,4,43,27,16,40
SK Sturm Gra,5932,3,11,5,8,31,30,1,38
LASK Linz,5932,4,8,7,9,28,28,0,31
Mattersburg,5932,5,6,6,12,32,41,-9,24
SC Rheindorf,5932,6,6,6,12,20,33,-13,24
Vienna,5932,7,6,6,12,24,41,-17,24
FC Salzburg,5933,1,15,7,2,46,19,27,52
SK Sturm Gra,5933,2,13,3,8,37,34,3,42
Rapid Vienna,5933,3,8,10,6,38,31,7,34
LASK Linz,5933,4,8,6,10,29,32,-3,30
Vienna,5933,5,7,5,12,27,41,-14,26
Mattersburg,5933,6,6,6,12,34,45,-11,24
SC Rheindorf,5933,7,6,5,13,23,32,-9,23
FC Salzburg,5934,1,14,7,3,43,20,23,49
SK Sturm Gra,5934,2,13,4,7,32,26,6,43
Rapid Vienna,5934,3,10,9,5,39,29,10,39
LASK Linz,5934,4,8,6,10,28,30,-2,30
Mattersburg,5934,5,7,5,12,34,45,-11,26
Vienna,5934,6,6,6,12,25,41,-16,24
SC Rheindorf,5934,7,5,5,14,21,31,-10,20
FC Salzburg,5935,1,15,6,3,53,18,35,51
SK Sturm Gra,5935,2,12,3,9,34,38,-4,39
Rapid Vienna,5935,3,9,10,5,35,28,7,37
LASK Linz,5935,4,8,7,9,30,28,2,31
Vienna,5935,5,7,5,12,25,42,-17,26
Mattersburg,5935,6,6,6,12,31,42,-11,24
SC Rheindorf,5935,7,5,7,12,18,30,-12,22
FC Salzburg,5936,1,16,6,2,45,17,28,54
SK Sturm Gra,5936,2,12,4,8,34,31,3,40
Rapid Vienna,5936,3,8,10,6,38,30,8,34
LASK Linz,5936,4,8,6,10,25,29,-4,30
SC Rheindorf,5936,5,7,5,12,22,29,-7,26
Mattersburg,5936,6,6,6,12,28,38,-10,24
Vienna,5936,7,6,5,13,24,42,-18,23
FC Salzburg,5937,1,14,7,3,45,19,26,49
SK Sturm Gra,5937,2,13,4,7,33,28,5,43
LASK Linz,5937,3,9,6,9,26,26,0,33
Rapid Vienna,5937,4,7,11,6,32,26,6,32
Mattersburg,5937,5,7,6,11,32,42,-10,27
Vienna,5937,6,6,5,13,26,43,-17,23
SC Rheindorf,5937,7,5,7,12,21,31,-10,22
FC Salzburg,5938,1,12,9,3,39,17,22,45
SK Sturm Gra,5938,2,14,3,7,37,28,9,45
Rapid Vienna,5938,3,8,10,6,35,28,7,34
LASK Linz,5938,4,9,6,9,30,30,0,33
Vienna,5938,5,7,6,11,26,38,-12,27
Mattersburg,5938,6,6,7,11,30,40,-10,25
SC Rheindorf,5938,7,5,5,14,17,33,-16,20
FC Salzburg,5939,1,14,7,3,45,20,25,49
SK Sturm Gra,5939,2,12,5,7,35,30,5,41
Rapid Vienna,5939,3,7,11,6,36,31,5,32
LASK Linz,5939,4,8,8,8,26,26,0,32
Vienna,5939,5,8,5,11,26,38,-12,29
SC Rheindorf,5939,6,6,6,12,22,31,-9,24
Mattersburg,5939,7,5,6,13,27,41,-14,21
FC Salzburg,5940,1,14,8,2,43,17,26,50
SK Sturm Gra,5940,2,13,4,7,31,27,4,43
Rapid Vienna,5940,3,8,10,6,33,26,7,34
LASK Linz,5940,4,8,6,10,29,30,-1,30
Vienna,5940,5,7,6,11,26,39,-13,27
SC Rheindorf,5940,6,7,5,12,20,26,-6,26
Mattersburg,5940,7,5,5,14,29,46,-17,20
FC Salzburg,5941,1,14,6,4,44,20,24,48
SK Sturm Gra,5941,2,14,4,6,32,25,7,46
Rapid Vienna,5941,3,8,9,7,34,29,5,33
LASK Linz,5941,4,7,6,11,27,32,-5,27
Vienna,5941,5,7,6,11,26,39,-13,27
SC Rheindorf,5941,6,6,7,11,22,26,-4,25
Mattersburg,5941,7,6,6,12,31,45,-14,24
FC Salzburg,5942,1,15,7,2,44,16,28,52
SK Sturm Gra,5942,2,13,4,7,32,26,6,43
Rapid Vienna,5942,3,9,9,6,38,27,11,36
LASK Linz,5942,4,10,5,9,29,26,3,35
Mattersburg,5942,5,6,5,13,31,43,-12,23
Vienna,5942,6,6,5,13,24,42,-18,23
SC Rheindorf,5942,7,5,5,14,19,37,-18,20
FC Salzburg,5943,1,14,8,2,43,18,25,50
SK Sturm Gra,5943,2,12,4,8,32,30,2,40
Rapid Vienna,5943,3,9,10,5,39,29,10,37
SC Rheindorf,5943,4,8,5,11,24,28,-4,29
LASK Linz,5943,5,7,6,11,26,32,-6,27
Vienna,5943,6,7,5,12,25,39,-14,26
Mattersburg,5943,7,5,6,13,28,41,-13,21
FC Salzburg,5944,1,16,6,2,47,16,31,54
SK Sturm Gra,5944,2,13,3,8,30,28,2,42
LASK Linz,5944,3,10,5,9,30,27,3,35
Rapid Vienna,5944,4,8,9,7,35,30,5,33
Mattersburg,5944,5,6,6,12,31,45,-14,24
Vienna,5944,6,6,5,13,26,42,-16,23
SC Rheindorf,5944,7,5,6,13,21,32,-11,21
FC Salzburg,5945,1,15,7,2,45,16,29,52
SK Sturm Gra,5945,2,13,5,6,34,27,7,44
Rapid Vienna,5945,3,8,10,6,34,27,7,34
LASK Linz,5945,4,8,7,9,30,31,-1,31
Vienna,5945,5,7,5,12,24,39,-15,26
Mattersburg,5945,6,6,5,13,33,44,-11,23
SC Rheindorf,5945,7,5,5,14,20,36,-16,20
FC Salzburg,5946,1,15,6,3,49,20,29,51
SK Sturm Gra,5946,2,12,5,7,34,29,5,41
Rapid Vienna,5946,3,8,10,6,37,30,7,34
LASK Linz,5946,4,7,8,9,25,27,-2,29
Mattersburg,5946,5,7,5,12,31,44,-13,26
Vienna,5946,6,7,5,12,26,41,-15,26
SC Rheindorf,5946,7,5,7,12,20,31,-11,22
FC Salzburg,5947,1,15,7,2,47,18,29,52
SK Sturm Gra,5947,2,13,4,7,34,29,5,43
Rapid Vienna,5947,3,8,10,6,37,31,6,34
LASK Linz,5947,4,9,7,8,28,27,1,34
Mattersburg,5947,5,6,6,12,29,40,-11,24
Vienna,5947,6,6,5,13,24,41,-17,23
SC Rheindorf,5947,7,5,5,14,17,30,-13,20
FC Salzburg,5948,1,15,6,3,46,20,26,51
SK Sturm Gra,5948,2,13,4,7,30,25,5,43
Rapid Vienna,5948,3,8,9,7,32,26,6,33
LASK Linz,5948,4,9,6,9,28,29,-1,33
Mattersburg,5948,5,7,6,11,36,46,-10,27
Vienna,5948,6,7,6,11,28,39,-11,27
SC Rheindorf,5948,7,4,5,15,18,33,-15,17
FC Salzburg,5949,1,15,7,2,46,19,27,52
SK Sturm Gra,5949,2,13,4,7,34,26,8,43
Rapid Vienna,5949,3,9,10,5,34,26,8,37
LASK Linz,5949,4,8,6,10,27,32,-5,30
SC Rheindorf,5949,5,6,5,13,20,29,-9,23
Mattersburg,5949,6,6,5,13,32,44,-12,23
Vienna,5949,7,6,5,13,26,43,-17,23
FC Salzburg,5950,1,15,6,3,48,19,29,51
SK Sturm Gra,5950,2,12,4,8,32,31,1,40
Rapid Vienna,5950,3,8,9,7,34,30,4,33
LASK Linz,5950,4,8,6,10,25,28,-3,30
Vienna,5950,5,7,6,11,26,37,-11,27
SC Rheindorf,5950,6,6,7,11,20,28,-8,25
Mattersburg,5950,7,5,8,11,27,39,-12,23
FC Salzburg,5951,1,15,7,2,49,18,31,52
SK Sturm Gra,5951,2,12,4,8,30,29,1,40
Rapid Vienna,5951,3,9,10,5,39,32,7,37
LASK Linz,5951,4,8,8,8,28,28,0,32
Vienna,5951,5,6,7,11,27,41,-14,25
Mattersburg,5951,6,5,8,11,30,42,-12,23
SC Rheindorf,5951,7,4,6,14,17,30,-13,18
FC Salzburg,5952,1,15,7,2,46,17,29,52
SK Sturm Gra,5952,2,11,5,8,29,28,1,38
Rapid Vienna,5952,3,8,10,6,34,28,6,34
LASK Linz,5952,4,8,7,9,28,29,-1,31
SC Rheindorf,5952,5,7,5,12,21,28,-7,26
Mattersburg,5952,6,6,6,12,27,40,-13,24
Vienna,5952,7,6,6,12,24,39,-15,24
FC Salzburg,5953,1,14,7,3,43,18,25,49
SK Sturm Gra,5953,2,12,3,9,30,28,2,39
Rapid Vienna,5953,3,8,11,5,35,27,8,35
Vienna,5953,4,8,5,11,26,38,-12,29
LASK Linz,5953,5,7,7,10,27,31,-4,28
SC Rheindorf,5953,6,7,5,12,19,27,-8,26
Mattersburg,5953,7,6,6,12,30,41,-11,24
FC Salzburg,5954,1,15,6,3,45,17,28,51
SK Sturm Gra,5954,2,13,3,8,32,30,2,42
Rapid Vienna,5954,3,7,11,6,35,29,6,32
LASK Linz,5954,4,7,8,9,28,30,-2,29
Vienna,5954,5,8,5,11,26,37,-11,29
Mattersburg,5954,6,6,6,12,27,40,-13,24
SC Rheindorf,5954,7,5,7,12,19,29,-10,22
FC Salzburg,5955,1,16,6,2,50,17,33,54
Rapid Vienna,5955,2,10,9,5,43,26,17,39
SK Sturm Gra,5955,3,11,4,9,31,32,-1,37
LASK Linz,5955,4,7,7,10,26,34,-8,28
Mattersburg,5955,5,7,6,11,33,43,-10,27
SC Rheindorf,5955,6,6,5,13,17,29,-12,23
Vienna,5955,7,6,5,13,26,45,-19,23
FC Salzburg,5956,1,14,7,3,50,22,28,49
Rapid Vienna,5956,2,10,9,5,39,29,10,39
SK Sturm Gra,5956,3,11,4,9,32,33,-1,37
LASK Linz,5956,4,10,6,8,31,28,3,36
Vienna,5956,5,7,5,12,26,42,-16,26
Mattersburg,5956,6,5,8,11,30,42,-12,23
SC Rheindorf,5956,7,4,7,13,19,31,-12,19
FC Salzburg,5957,1,14,7,3,44,19,25,49
SK Sturm Gra,5957,2,12,5,7,32,28,4,41
Rapid Vienna,5957,3,8,11,5,37,27,10,35
LASK Linz,5957,4,9,6,9,32,31,1,33
Mattersburg,5957,5,8,5,11,35,41,-6,29
Vienna,5957,6,7,5,12,26,41,-15,26
SC Rheindorf,5957,7,4,5,15,16,35,-19,17
FC Salzburg,5958,1,13,7,4,42,18,24,46
SK Sturm Gra,5958,2,14,3,7,34,28,6,45
Rapid Vienna,5958,3,9,10,5,34,26,8,37
LASK Linz,5958,4,9,5,10,28,27,1,32
Vienna,5958,5,7,5,12,27,42,-15,26
SC Rheindorf,5958,6,6,5,13,20,30,-10,23
Mattersburg,5958,7,6,5,13,33,47,-14,23
FC Salzburg,5959,1,14,7,3,41,19,22,49
SK Sturm Gra,5959,2,12,4,8,29,26,3,40
Rapid Vienna,5959,3,9,9,6,36,26,10,36
LASK Linz,5959,4,8,7,9,27,28,-1,31
Mattersburg,5959,5,7,6,11,33,41,-8,27
Vienna,5959,6,6,6,12,24,40,-16,24
SC Rheindorf,5959,7,6,5,13,21,31,-10,23
FC Salzburg,5960,1,14,7,3,44,20,24,49
SK Sturm Gra,5960,2,12,3,9,31,31,0,39
Rapid Vienna,5960,3,9,10,5,38,27,11,37
LASK Linz,5960,4,8,7,9,25,26,-1,31
Vienna,5960,5,7,6,11,27,39,-12,27
SC Rheindorf,5960,6,6,6,12,20,30,-10,24
Mattersburg,5960,7,5,7,12,29,41,-12,22
FC Salzburg,5961,1,16,6,2,46,17,29,54
SK Sturm Gra,5961,2,13,3,8,32,27,5,42
Rapid Vienna,5961,3,8,9,7,34,29,5,33
LASK Linz,5961,4,9,5,10,28,30,-2,32
Mattersburg,5961,5,7,6,11,33,42,-9,27
Vienna,5961,6,6,6,12,25,41,-16,24
SC Rheindorf,5961,7,5,5,14,18,30,-12,20
FC Salzburg,5962,1,15,7,2,45,17,28,52
SK Sturm Gra,5962,2,12,6,6,32,25,7,42
Rapid Vienna,5962,3,8,10,6,35,32,3,34
LASK Linz,5962,4,8,7,9,28,28,0,31
Mattersburg,5962,5,6,7,11,33,42,-9,25
Vienna,5962,6,6,6,12,26,42,-16,24
SC Rheindorf,5962,7,4,7,13,16,29,-13,19
FC Salzburg,5963,1,15,6,3,45,20,25,51
Rapid Vienna,5963,2,11,9,4,38,25,13,42
SK Sturm Gra,5963,3,12,4,8,31,28,3,40
LASK Linz,5963,4,8,6,10,26,29,-3,30
Vienna,5963,5,7,5,12,26,40,-14,26
SC Rheindorf,5963,6,6,5,13,20,28,-8,23
Mattersburg,5963,7,5,5,14,30,46,-16,20
FC Salzburg,5964,1,15,6,3,45,20,25,51
SK Sturm Gra,5964,2,13,4,7,34,28,6,43
LASK Linz,5964,3,10,5,9,32,31,1,35
Rapid Vienna,5964,4,7,10,7,37,32,5,31
Vienna,5964,5,8,5,11,28,37,-9,29
Mattersburg,5964,6,6,5,13,30,43,-13,23
SC Rheindorf,5964,7,4,7,13,18,33,-15,19
FC Salzburg,5965,1,14,7,3,45,18,27,49
SK Sturm Gra,5965,2,13,4,7,34,30,4,43
Rapid Vienna,5965,3,8,9,7,35,29,6,33
LASK Linz,5965,4,8,7,9,26,28,-2,31
SC Rheindorf,5965,5,6,7,11,21,27,-6,25
Vienna,5965,6,6,7,11,24,38,-14,25
Mattersburg,5965,7,5,7,12,27,42,-15,22
FC Salzburg,5966,1,14,7,3,44,19,25,49
SK Sturm Gra,5966,2,13,3,8,31,28,3,42
Rapid Vienna,5966,3,9,10,5,37,29,8,37
LASK Linz,5966,4,9,6,9,31,28,3,33
Vienna,5966,5,7,5,12,26,40,-14,26
Mattersburg,5966,6,6,7,11,31,41,-10,25
SC Rheindorf,5966,7,4,6,14,21,36,-15,18
FC Salzburg,5967,1,15,6,3,46,18,28,51
SK Sturm Gra,5967,2,12,3,9,32,31,1,39
Rapid Vienna,5967,3,8,11,5,34,27,7,35
LASK Linz,5967,4,8,6,10,30,31,-1,30
Vienna,5967,5,8,5,11,29,40,-11,29
Mattersburg,5967,6,7,5,12,33,44,-11,26
SC Rheindorf,5967,7,5,6,13,21,34,-13,21
FC Salzburg,5968,1,14,8,2,44,17,27,50
SK Sturm Gra,5968,2,12,4,8,32,30,2,40
LASK Linz,5968,3,9,7,8,29,27,2,34
Rapid Vienna,5968,4,7,11,6,33,28,5,32
Vienna,5968,5,7,5,12,30,40,-10,26
Mattersburg,5968,6,6,6,12,30,47,-17,24
SC Rheindorf,5968,7,5,7,12,19,28,-9,22
FC Salzburg,5969,1,13,7,4,41,19,22,46
Rapid Vienna,5969,2,9,11,4,40,30,10,38
SK Sturm Gra,5969,3,11,4,9,31,31,0,37
LASK Linz,5969,4,9,5,10,27,29,-2,32
Mattersburg,5969,5,7,6,11,34,37,-3,27
Vienna,5969,6,7,5,12,24,40,-16,26
SC Rheindorf,5969,7,6,6,12,23,34,-11,24
FC Salzburg,5970,1,15,6,3,45,19,26,51
SK Sturm Gra,5970,2,12,4,8,32,29,3,40
LASK Linz,5970,3,10,5,9,30,27,3,35
Rapid Vienna,5970,4,7,10,7,38,37,1,31
Mattersburg,5970,5,7,5,12,32,41,-9,26
Vienna,5970,6,7,5,12,25,39,-14,26
SC Rheindorf,5970,7,5,7,12,22,32,-10,22
FC Salzburg,5971,1,13,8,3,45,21,24,47
SK Sturm Gra,5971,2,12,5,7,31,28,3,41
Rapid Vienna,5971,3,9,10,5,36,26,10,37
LASK Linz,5971,4,7,7,10,25,30,-5,28
Vienna,5971,5,7,6,11,27,38,-11,27
Mattersburg,5971,6,7,5,12,34,45,-11,26
SC Rheindorf,5971,7,5,7,12,17,27,-10,22
FC Salzburg,5972,1,14,7,3,44,18,26,49
Rapid Vienna,5972,2,10,10,4,41,29,12,40
SK Sturm Gra,5972,3,12,4,8,30,30,0,40
LASK Linz,5972,4,7,6,11,26,33,-7,27
Mattersburg,5972,5,7,5,12,33,41,-8,26
SC Rheindorf,5972,6,6,6,12,22,30,-8,24
Vienna,5972,7,6,6,12,24,39,-15,24
FC Salzburg,5973,1,15,7,2,47,19,28,52
SK Sturm Gra,5973,2,11,5,8,29,32,-3,38
Rapid Vienna,5973,3,9,9,6,38,31,7,36
LASK Linz,5973,4,8,7,9,29,28,1,31
Mattersburg,5973,5,8,5,11,32,38,-6,29
Vienna,5973,6,6,5,13,26,43,-17,23
SC Rheindorf,5973,7,5,6,13,20,30,-10,21
FC Salzburg,5974,1,15,6,3,46,18,28,51
SK Sturm Gra,5974,2,12,4,8,31,30,1,40
Rapid Vienna,5974,3,8,9,7,35,31,4,33
LASK Linz,5974,4,8,7,9,30,30,0,31
Mattersburg,5974,5,8,5,11,31,39,-8,29
Vienna,5974,6,7,5,12,25,40,-15,26
SC Rheindorf,5974,7,5,6,13,20,30,-10,21
FC Salzburg,5975,1,14,7,3,44,18,26,49
SK Sturm Gra,5975,2,12,4,8,33,29,4,40
Rapid Vienna,5975,3,8,11,5,36,28,8,35
LASK Linz,5975,4,9,6,9,28,27,1,33
Mattersburg,5975,5,7,6,11,29,39,-10,27
Vienna,5975,6,7,5,12,25,41,-16,26
SC Rheindorf,5975,7,4,7,13,17,30,-13,19
FC Salzburg,5976,1,15,6,3,46,17,29,51
SK Sturm Gra,5976,2,12,3,9,31,35,-4,39
Rapid Vienna,5976,3,8,10,6,36,27,9,34
LASK Linz,5976,4,9,5,10,29,31,-2,32
Mattersburg,5976,5,7,5,12,32,43,-11,26
Vienna,5976,6,7,5,12,25,39,-14,26
SC Rheindorf,5976,7,6,6,12,21,28,-7,24
FC Salzburg,5977,1,15,7,2,46,17,29,52
SK Sturm Gra,5977,2,13,3,8,33,32,1,42
Rapid Vienna,5977,3,9,10,5,37,27,10,37
LASK Linz,5977,4,8,5,11,28,31,-3,29
Vienna,5977,5,7,5,12,26,41,-15,26
Mattersburg,5977,6,6,6,12,31,42,-11,24
SC Rheindorf,5977,7,5,6,13,22,33,-11,21
FC Salzburg,5978,1,13,7,4,41,21,20,46
Rapid Vienna,5978,2,10,9,5,37,25,12,39
SK Sturm Gra,5978,3,11,4,9,28,29,-1,37
LASK Linz,5978,4,8,6,10,26,28,-2,30
Mattersburg,5978,5,7,6,11,29,38,-9,27
SC Rheindorf,5978,6,7,5,12,20,27,-7,26
Vienna,5978,7,7,5,12,26,39,-13,26
FC Salzburg,5979,1,15,7,2,48,17,31,52
SK Sturm Gra,5979,2,12,6,6,32,25,7,42
LASK Linz,5979,3,9,6,9,27,26,1,33
Rapid Vienna,5979,4,7,9,8,33,35,-2,30
Mattersburg,5979,5,6,7,11,31,41,-10,25
Vienna,5979,6,6,6,12,26,44,-18,24
SC Rheindorf,5979,7,5,7,12,20,29,-9,22
FC Salzburg,5980,1,16,6,2,45,16,29,54
SK Sturm Gra,5980,2,13,3,8,35,32,3,42
Rapid Vienna,5980,3,8,9,7,39,34,5,33
LASK Linz,5980,4,9,5,10,28,30,-2,32
Mattersburg,5980,5,7,5,12,29,38,-9,26
SC Rheindorf,5980,6,6,5,13,20,29,-9,23
Vienna,5980,7,6,5,13,23,40,-17,23
FC Salzburg,5981,1,13,8,3,43,20,23,47
SK Sturm Gra,5981,2,13,4,7,37,32,5,43
Rapid Vienna,5981,3,9,10,5,38,28,10,37
Mattersburg,5981,4,8,6,10,36,40,-4,30
LASK Linz,5981,5,7,5,12,24,31,-7,26
Vienna,5981,6,6,6,12,27,43,-16,24
SC Rheindorf,5981,7,5,7,12,19,30,-11,22
FC Salzburg,5982,1,14,6,4,43,21,22,48
SK Sturm Gra,5982,2,13,4,7,34,29,5,43
Rapid Vienna,5982,3,10,10,4,41,27,14,40
LASK Linz,5982,4,8,5,11,28,31,-3,29
SC Rheindorf,5982,5,6,6,12,22,31,-9,24
Vienna,5982,6,6,6,12,26,41,-15,24
Mattersburg,5982,7,5,7,12,31,45,-14,22
FC Salzburg,5983,1,14,8,2,46,20,26,50
SK Sturm Gra,5983,2,12,5,7,35,29,6,41
Rapid Vienna,5983,3,8,11,5,36,28,8,35
LASK Linz,5983,4,8,8,8,31,31,0,32
Mattersburg,5983,5,7,6,11,31,39,-8,27
Vienna,5983,6,6,6,12,24,39,-15,24
SC Rheindorf,5983,7,4,6,14,19,36,-17,18
SK Sturm Gra,5984,1,14,4,6,39,31,8,46
FC Salzburg,5984,2,12,7,5,40,21,19,43
Rapid Vienna,5984,3,8,10,6,34,28,6,34
LASK Linz,5984,4,9,6,9,28,27,1,33
Mattersburg,5984,5,7,6,11,29,38,-9,27
Vienna,5984,6,7,5,12,25,39,-14,26
SC Rheindorf,5984,7,4,8,12,18,29,-11,20
FC Salzburg,5985,1,14,8,2,48,18,30,50
SK Sturm Gra,5985,2,12,3,9,32,32,0,39
LASK Linz,5985,3,10,6,8,32,29,3,36
Rapid Vienna,5985,4,8,10,6,35,29,6,34
Mattersburg,5985,5,6,7,11,34,45,-11,25
Vienna,5985,6,6,7,11,27,41,-14,25
SC Rheindorf,5985,7,5,5,14,19,33,-14,20
FC Salzburg,5986,1,15,7,2,49,17,32,52
SK Sturm Gra,5986,2,14,3,7,36,29,7,45
Rapid Vienna,5986,3,8,11,5,35,27,8,35
Mattersburg,5986,4,7,6,11,33,41,-8,27
LASK Linz,5986,5,7,6,11,27,35,-8,27
Vienna,5986,6,6,5,13,24,43,-19,23
SC Rheindorf,5986,7,5,6,13,18,30,-12,21
FC Salzburg,5987,1,15,7,2,48,19,29,52
SK Sturm Gra,5987,2,12,4,8,35,33,2,40
Rapid Vienna,5987,3,9,9,6,37,29,8,36
LASK Linz,5987,4,7,7,10,26,30,-4,28
Vienna,5987,5,7,6,11,29,39,-10,27
SC Rheindorf,5987,6,6,7,11,20,28,-8,25
Mattersburg,5987,7,5,6,13,29,46,-17,21
FC Salzburg,5988,1,14,7,3,47,19,28,49
SK Sturm Gra,5988,2,11,6,7,31,31,0,39
Rapid Vienna,5988,3,8,11,5,36,28,8,35
LASK Linz,5988,4,9,6,9,27,27,0,33
Mattersburg,5988,5,6,7,11,31,41,-10,25
Vienna,5988,6,6,6,12,24,40,-16,24
SC Rheindorf,5988,7,5,7,12,19,29,-10,22
FC Salzburg,5989,1,15,6,3,46,18,28,51
SK Sturm Gra,5989,2,12,3,9,33,31,2,39
Rapid Vienna,5989,3,9,9,6,35,26,9,36
LASK Linz,5989,4,9,7,8,26,25,1,34
Mattersburg,5989,5,7,6,11,30,41,-11,27
Vienna,5989,6,7,5,12,27,41,-14,26
SC Rheindorf,5989,7,4,6,14,15,30,-15,18
FC Salzburg,5990,1,14,8,2,43,16,27,50
SK Sturm Gra,5990,2,12,4,8,32,28,4,40
Rapid Vienna,5990,3,8,11,5,35,28,7,35
LASK Linz,5990,4,9,7,8,28,27,1,34
Vienna,5990,5,6,7,11,24,38,-14,25
SC Rheindorf,5990,6,5,7,12,19,29,-10,22
Mattersburg,5990,7,5,6,13,27,42,-15,21
FC Salzburg,5991,1,14,8,2,42,17,25,50
SK Sturm Gra,5991,2,12,5,7,34,31,3,41
Rapid Vienna,5991,3,7,11,6,33,32,1,32
LASK Linz,5991,4,9,5,10,31,30,1,32
Mattersburg,5991,5,7,5,12,32,40,-8,26
Vienna,5991,6,7,5,12,24,38,-14,26
SC Rheindorf,5991,7,6,5,13,20,28,-8,23
FC Salzburg,5992,1,15,7,2,44,16,28,52
SK Sturm Gra,5992,2,13,3,8,32,28,4,42
LASK Linz,5992,3,9,6,9,27,28,-1,33
Rapid Vienna,5992,4,7,10,7,31,26,5,31
Mattersburg,5992,5,6,7,11,29,39,-10,25
Vienna,5992,6,6,6,12,24,40,-16,24
SC Rheindorf,5992,7,5,7,12,19,29,-10,22
FC Salzburg,5993,1,14,7,3,44,20,24,49
Rapid Vienna,5993,2,8,12,4,37,28,9,36
SK Sturm Gra,5993,3,11,3,10,30,31,-1,36
LASK Linz,5993,4,9,7,8,28,27,1,34
Mattersburg,5993,5,8,5,11,35,41,-6,29
Vienna,5993,6,6,5,13,27,43,-16,23
SC Rheindorf,5993,7,5,7,12,19,30,-11,22
FC Salzburg,5994,1,14,7,3,43,19,24,49
SK Sturm Gra,5994,2,13,5,6,33,27,6,44
Rapid Vienna,5994,3,8,10,6,37,30,7,34
Mattersburg,5994,4,9,5,10,35,37,-2,32
LASK Linz,5994,5,9,5,10,26,29,-3,32
Vienna,5994,6,6,5,13,24,41,-17,23
SC Rheindorf,5994,7,4,5,15,16,31,-15,17
FC Salzburg,5995,1,14,7,3,41,16,25,49
SK Sturm Gra,5995,2,12,3,9,33,32,1,39
Rapid Vienna,5995,3,9,11,4,38,26,12,38
LASK Linz,5995,4,10,6,8,30,27,3,36
Vienna,5995,5,8,5,11,26,38,-12,29
Mattersburg,5995,6,6,5,13,31,42,-11,23
SC Rheindorf,5995,7,4,5,15,20,38,-18,17
FC Salzburg,5996,1,16,6,2,52,17,35,54
SK Sturm Gra,5996,2,11,5,8,29,30,-1,38
Rapid Vienna,5996,3,7,12,5,32,26,6,33
LASK Linz,5996,4,7,8,9,25,30,-5,29
Vienna,5996,5,7,5,12,27,38,-11,26
SC Rheindorf,5996,6,6,7,11,21,26,-5,25
Mattersburg,5996,7,6,5,13,31,50,-19,23
FC Salzburg,5997,1,13,8,3,39,16,23,47
SK Sturm Gra,5997,2,12,5,7,31,27,4,41
Rapid Vienna,5997,3,8,10,6,34,28,6,34
LASK Linz,5997,4,9,7,8,31,29,2,34
Mattersburg,5997,5,7,6,11,30,39,-9,27
Vienna,5997,6,7,5,12,26,40,-14,26
SC Rheindorf,5997,7,4,7,13,16,28,-12,19
FC Salzburg,5998,1,15,6,3,48,16,32,51
Rapid Vienna,5998,2,9,11,4,38,28,10,38
SK Sturm Gra,5998,3,11,4,9,34,36,-2,37
LASK Linz,5998,4,8,5,11,29,33,-4,29
Mattersburg,5998,5,8,5,11,35,42,-7,29
SC Rheindorf,5998,6,6,6,12,24,31,-7,24
Vienna,5998,7,6,5,13,23,45,-22,23
FC Salzburg,5999,1,15,6,3,44,19,25,51
SK Sturm Gra,5999,2,12,4,8,33,32,1,40
Rapid Vienna,5999,3,8,10,6,35,28,7,34
LASK Linz,5999,4,7,8,9,26,30,-4,29
Mattersburg,5999,5,7,6,11,34,41,-7,27
SC Rheindorf,5999,6,6,7,11,22,28,-6,25
Vienna,5999,7,6,5,13,25,41,-16,23
FC Salzburg,6000,1,16,6,2,48,19,29,54
SK Sturm Gra,6000,2,14,3,7,34,27,7,45
Rapid Vienna,6000,3,8,10,6,35,29,6,34
LASK Linz,6000,4,7,5,12,25,30,-5,26
Vienna,6000,5,7,5,12,29,41,-12,26
Mattersburg,6000,6,6,6,12,29,43,-14,24
SC Rheindorf,6000,7,5,7,12,17,28,-11,22
FC Salzburg,6001,1,15,7,2,47,19,28,52
SK Sturm Gra,6001,2,12,3,9,31,31,0,39
Rapid Vienna,6001,3,8,9,7,37,30,7,33
LASK Linz,6001,4,9,6,9,30,31,-1,33
Mattersburg,6001,5,8,6,10,37,40,-3,30
Vienna,6001,6,6,5,13,25,44,-19,23
SC Rheindorf,6001,7,5,6,13,19,31,-12,21
FC Salzburg,6002,1,16,6,2,52,19,33,54
SK Sturm Gra,6002,2,12,3,9,31,32,-1,39
Rapid Vienna,6002,3,9,9,6,35,27,8,36
LASK Linz,6002,4,8,5,11,28,30,-2,29
Mattersburg,6002,5,8,5,11,35,45,-10,29
SC Rheindorf,6002,6,6,5,13,22,32,-10,23
Vienna,6002,7,6,5,13,27,45,-18,23
SK Sturm Gra,6003,1,14,3,7,35,29,6,45
FC Salzburg,6003,2,12,7,5,42,22,20,43
Rapid Vienna,6003,3,9,10,5,37,26,11,37
LASK Linz,6003,4,8,6,10,28,31,-3,30
Vienna,6003,5,7,6,11,30,40,-10,27
Mattersburg,6003,6,7,5,12,34,46,-12,26
SC Rheindorf,6003,7,6,5,13,19,31,-12,23
FC Salzburg,6004,1,13,8,3,42,19,23,47
SK Sturm Gra,6004,2,14,3,7,33,25,8,45
Rapid Vienna,6004,3,9,10,5,35,26,9,37
LASK Linz,6004,4,7,7,10,25,29,-4,28
Vienna,6004,5,7,6,11,26,38,-12,27
Mattersburg,6004,6,6,6,12,31,43,-12,24
SC Rheindorf,6004,7,5,6,13,20,32,-12,21
FC Salzburg,6005,1,15,7,2,45,17,28,52
SK Sturm Gra,6005,2,12,3,9,33,29,4,39
LASK Linz,6005,3,10,5,9,29,28,1,35
Rapid Vienna,6005,4,7,9,8,31,30,1,30
Vienna,6005,5,7,6,11,26,38,-12,27
Mattersburg,6005,6,7,5,12,31,41,-10,26
SC Rheindorf,6005,7,6,5,13,18,30,-12,23
FC Salzburg,6006,1,13,7,4,45,22,23,46
SK Sturm Gra,6006,2,13,3,8,35,31,4,42
Rapid Vienna,6006,3,8,10,6,38,29,9,34
Mattersburg,6006,4,8,6,10,37,43,-6,30
LASK Linz,6006,5,8,5,11,27,32,-5,29
Vienna,6006,6,7,6,11,28,41,-13,27
SC Rheindorf,6006,7,6,5,13,20,32,-12,23
FC Salzburg,6007,1,15,7,2,46,18,28,52
SK Sturm Gra,6007,2,13,3,8,35,28,7,42
Rapid Vienna,6007,3,8,9,7,33,29,4,33
LASK Linz,6007,4,9,6,9,25,26,-1,33
Vienna,6007,5,7,6,11,27,40,-13,27
SC Rheindorf,6007,6,6,6,12,20,29,-9,24
Mattersburg,6007,7,5,5,14,28,44,-16,20
FC Salzburg,6008,1,16,6,2,44,16,28,54
SK Sturm Gra,6008,2,12,3,9,34,33,1,39
LASK Linz,6008,3,9,6,9,29,29,0,33
Rapid Vienna,6008,4,7,10,7,35,31,4,31
Mattersburg,6008,5,8,5,11,31,38,-7,29
Vienna,6008,6,6,5,13,23,39,-16,23
SC Rheindorf,6008,7,5,7,12,18,28,-10,22
FC Salzburg,6009,1,16,6,2,53,15,38,54
SK Sturm Gra,6009,2,12,4,8,30,27,3,40
Rapid Vienna,6009,3,9,9,6,33,29,4,36
LASK Linz,6009,4,8,6,10,25,27,-2,30
Mattersburg,6009,5,6,7,11,31,44,-13,25
Vienna,6009,6,6,6,12,24,43,-19,24
SC Rheindorf,6009,7,4,8,12,20,31,-11,20
FC Salzburg,6010,1,13,8,3,41,16,25,47
SK Sturm Gra,6010,2,13,4,7,35,29,6,43
LASK Linz,6010,3,9,5,10,29,30,-1,32
Rapid Vienna,6010,4,7,10,7,31,27,4,31
Mattersburg,6010,5,7,5,12,32,42,-10,26
SC Rheindorf,6010,6,7,5,12,20,30,-10,26
Vienna,6010,7,7,5,12,25,39,-14,26
FC Salzburg,6011,1,15,7,2,49,19,30,52
SK Sturm Gra,6011,2,11,7,6,31,27,4,40
Rapid Vienna,6011,3,7,12,5,36,30,6,33
LASK Linz,6011,4,7,9,8,29,30,-1,30
Vienna,6011,5,7,5,12,26,43,-17,26
SC Rheindorf,6011,6,5,8,11,19,28,-9,23
Mattersburg,6011,7,5,6,13,29,42,-13,21
FC Salzburg,6012,1,14,7,3,44,22,22,49
SK Sturm Gra,6012,2,12,3,9,33,32,1,39
LASK Linz,6012,3,10,5,9,31,27,4,35
Rapid Vienna,6012,4,8,9,7,35,28,7,33
SC Rheindorf,6012,5,7,6,11,22,28,-6,27
Vienna,6012,6,7,5,12,27,38,-11,26
Mattersburg,6012,7,5,7,12,29,46,-17,22
FC Salzburg,6013,1,14,8,2,43,16,27,50
SK Sturm Gra,6013,2,13,3,8,35,29,6,42
Rapid Vienna,6013,3,7,11,6,31,27,4,32
LASK Linz,6013,4,8,5,11,26,29,-3,29
SC Rheindorf,6013,5,7,6,11,21,27,-6,27
Vienna,6013,6,7,5,12,26,40,-14,26
Mattersburg,6013,7,6,6,12,29,43,-14,24
FC Salzburg,6014,1,15,7,2,47,19,28,52
SK Sturm Gra,6014,2,12,6,6,35,29,6,42
Rapid Vienna,6014,3,8,10,6,35,28,7,34
LASK Linz,6014,4,9,5,10,26,29,-3,32
Vienna,6014,5,7,5,12,26,41,-15,26
Mattersburg,6014,6,6,5,13,31,44,-13,23
SC Rheindorf,6014,7,5,6,13,20,30,-10,21
FC Salzburg,6015,1,16,6,2,48,17,31,54
SK Sturm Gra,6015,2,12,3,9,33,36,-3,39
Rapid Vienna,6015,3,9,9,6,34,26,8,36
LASK Linz,6015,4,9,5,10,30,30,0,32
SC Rheindorf,6015,5,7,5,12,22,28,-6,26
Vienna,6015,6,6,6,12,25,40,-15,24
Mattersburg,6015,7,5,6,13,27,42,-15,21
FC Salzburg,6016,1,14,8,2,41,16,25,50
SK Sturm Gra,6016,2,12,4,8,35,33,2,40
Rapid Vienna,6016,3,9,10,5,35,25,10,37
LASK Linz,6016,4,8,6,10,28,30,-2,30
SC Rheindorf,6016,5,7,5,12,24,31,-7,26
Vienna,6016,6,6,7,11,26,40,-14,25
Mattersburg,6016,7,5,6,13,29,43,-14,21
FC Salzburg,6017,1,14,7,3,44,19,25,49
SK Sturm Gra,6017,2,11,5,8,30,28,2,38
Rapid Vienna,6017,3,7,13,4,34,26,8,34
LASK Linz,6017,4,8,7,9,30,30,0,31
SC Rheindorf,6017,5,7,6,11,18,25,-7,27
Mattersburg,6017,6,6,6,12,31,43,-12,24
Vienna,6017,7,6,6,12,24,40,-16,24
FC Salzburg,6018,1,13,8,3,45,18,27,47
Rapid Vienna,6018,2,10,10,4,38,27,11,40
SK Sturm Gra,6018,3,11,5,8,30,30,0,38
LASK Linz,6018,4,9,5,10,26,27,-1,32
SC Rheindorf,6018,5,7,5,12,23,29,-6,26
Vienna,6018,6,7,5,12,25,43,-18,26
Mattersburg,6018,7,5,6,13,28,41,-13,21
FC Salzburg,6019,1,13,8,3,42,18,24,47
SK Sturm Gra,6019,2,13,4,7,31,26,5,43
Rapid Vienna,6019,3,8,10,6,35,29,6,34
LASK Linz,6019,4,8,7,9,25,26,-1,31
Vienna,6019,5,7,5,12,26,40,-14,26
SC Rheindorf,6019,6,6,6,12,18,26,-8,24
Mattersburg,6019,7,6,6,12,29,41,-12,24
FC Salzburg,6020,1,15,7,2,46,18,28,52
SK Sturm Gra,6020,2,12,4,8,32,29,3,40
Rapid Vienna,6020,3,9,10,5,35,26,9,37
LASK Linz,6020,4,7,6,11,26,30,-4,27
Vienna,6020,5,7,5,12,26,42,-16,26
Mattersburg,6020,6,6,6,12,31,42,-11,24
SC Rheindorf,6020,7,5,8,11,19,28,-9,23
FC Salzburg,6021,1,14,7,3,46,19,27,49
SK Sturm Gra,6021,2,12,3,9,32,34,-2,39
Rapid Vienna,6021,3,9,11,4,40,28,12,38
LASK Linz,6021,4,8,7,9,27,29,-2,31
Mattersburg,6021,5,7,6,11,30,40,-10,27
Vienna,6021,6,6,6,12,24,39,-15,24
SC Rheindorf,6021,7,5,6,13,20,30,-10,21
FC Salzburg,6022,1,15,6,3,48,21,27,51
SK Sturm Gra,6022,2,13,3,8,34,33,1,42
Rapid Vienna,6022,3,10,10,4,40,25,15,40
LASK Linz,6022,4,8,6,10,28,32,-4,30
Mattersburg,6022,5,6,6,12,30,43,-13,24
Vienna,6022,6,6,6,12,25,40,-15,24
SC Rheindorf,6022,7,5,5,14,21,32,-11,20
FC Salzburg,6023,1,13,7,4,43,20,23,46
Rapid Vienna,6023,2,10,9,5,41,28,13,39
SK Sturm Gra,6023,3,11,3,10,29,32,-3,36
LASK Linz,6023,4,10,5,9,30,31,-1,35
Mattersburg,6023,5,7,6,11,33,42,-9,27
Vienna,6023,6,7,6,11,29,39,-10,27
SC Rheindorf,6023,7,5,6,13,18,31,-13,21
FC Salzburg,6024,1,15,6,3,46,17,29,51
SK Sturm Gra,6024,2,13,3,8,31,30,1,42
Rapid Vienna,6024,3,10,9,5,36,25,11,39
LASK Linz,6024,4,9,5,10,29,28,1,32
Vienna,6024,5,6,6,12,25,40,-15,24
SC Rheindorf,6024,6,6,5,13,18,29,-11,23
Mattersburg,6024,7,5,6,13,28,44,-16,21
FC Salzburg,6025,1,15,7,2,45,19,26,52
SK Sturm Gra,6025,2,13,4,7,36,30,6,43
Rapid Vienna,6025,3,7,10,7,34,30,4,31
LASK Linz,6025,4,7,7,10,27,31,-4,28
SC Rheindorf,6025,5,7,5,12,24,31,-7,26
Vienna,6025,6,7,5,12,29,42,-13,26
Mattersburg,6025,7,6,6,12,32,44,-12,24
FC Salzburg,6026,1,13,8,3,42,19,23,47
SK Sturm Gra,6026,2,14,3,7,34,26,8,45
Rapid Vienna,6026,3,8,11,5,40,30,10,35
LASK Linz,6026,4,7,6,11,28,35,-7,27
Vienna,6026,5,7,6,11,26,38,-12,27
Mattersburg,6026,6,6,7,11,33,44,-11,25
SC Rheindorf,6026,7,5,7,12,19,30,-11,22
FC Salzburg,6027,1,14,6,4,50,21,29,48
SK Sturm Gra,6027,2,13,3,8,33,29,4,42
Rapid Vienna,6027,3,9,10,5,41,27,14,37
LASK Linz,6027,4,8,6,10,28,32,-4,30
Mattersburg,6027,5,8,5,11,33,38,-5,29
Vienna,6027,6,7,5,12,25,46,-21,26
SC Rheindorf,6027,7,5,5,14,18,35,-17,20
FC Salzburg,6028,1,15,7,2,43,16,27,52
SK Sturm Gra,6028,2,13,4,7,32,28,4,43
Rapid Vienna,6028,3,8,11,5,38,28,10,35
LASK Linz,6028,4,9,6,9,27,28,-1,33
Vienna,6028,5,7,5,12,25,40,-15,26
SC Rheindorf,6028,6,5,6,13,17,28,-11,21
Mattersburg,6028,7,5,5,14,28,42,-14,20
FC Salzburg,6029,1,16,6,2,48,18,30,54
SK Sturm Gra,6029,2,13,4,7,34,28,6,43
Rapid Vienna,6029,3,7,10,7,33,29,4,31
LASK Linz,6029,4,8,7,9,27,26,1,31
Mattersburg,6029,5,6,6,12,29,43,-14,24
Vienna,6029,6,6,6,12,25,42,-17,24
SC Rheindorf,6029,7,5,7,12,19,29,-10,22
FC Salzburg,6030,1,15,6,3,43,16,27,51
SK Sturm Gra,6030,2,12,4,8,32,34,-2,40
Rapid Vienna,6030,3,9,10,5,37,28,9,37
LASK Linz,6030,4,8,6,10,31,34,-3,30
Mattersburg,6030,5,8,5,11,33,39,-6,29
Vienna,6030,6,6,5,13,24,40,-16,23
SC Rheindorf,6030,7,5,6,13,22,31,-9,21
FC Salzburg,6031,1,16,6,2,46,17,29,54
SK Sturm Gra,6031,2,11,5,8,32,31,1,38
Rapid Vienna,6031,3,8,10,6,36,28,8,34
LASK Linz,6031,4,9,6,9,30,29,1,33
SC Rheindorf,6031,5,6,6,12,21,29,-8,24
Mattersburg,6031,6,6,6,12,29,42,-13,24
Vienna,6031,7,6,5,13,23,41,-18,23
FC Salzburg,6032,1,16,6,2,49,18,31,54
SK Sturm Gra,6032,2,12,5,7,35,28,7,41
Rapid Vienna,6032,3,8,10,6,37,31,6,34
LASK Linz,6032,4,7,7,10,26,32,-6,28
Mattersburg,6032,5,6,7,11,30,42,-12,25
SC Rheindorf,6032,6,5,8,11,18,27,-9,23
Vienna,6032,7,6,5,13,24,41,-17,23
FC Salzburg,6033,1,14,8,2,45,17,28,50
SK Sturm Gra,6033,2,13,5,6,35,27,8,44
Rapid Vienna,6033,3,7,9,8,34,32,2,30
LASK Linz,6033,4,8,6,10,29,33,-4,30
SC Rheindorf,6033,5,7,6,11,22,27,-5,27
Mattersburg,6033,6,6,7,11,32,41,-9,25
Vienna,6033,7,6,5,13,24,44,-20,23
FC Salzburg,6034,1,15,6,3,49,19,30,51
SK Sturm Gra,6034,2,12,3,9,36,32,4,39
LASK Linz,6034,3,9,7,8,30,27,3,34
Rapid Vienna,6034,4,7,11,6,34,33,1,32
Vienna,6034,5,7,5,12,27,41,-14,26
SC Rheindorf,6034,6,6,7,11,21,28,-7,25
Mattersburg,6034,7,6,5,13,31,48,-17,23
FC Salzburg,6035,1,15,7,2,49,16,33,52
SK Sturm Gra,6035,2,13,4,7,31,31,0,43
Rapid Vienna,6035,3,7,11,6,32,28,4,32
LASK Linz,6035,4,8,7,9,27,26,1,31
Mattersburg,6035,5,7,6,11,31,39,-8,27
Vienna,6035,6,6,5,13,24,42,-18,23
SC Rheindorf,6035,7,4,8,12,16,28,-12,20
FC Salzburg,6036,1,15,6,3,46,20,26,51
SK Sturm Gra,6036,2,13,3,8,32,26,6,42
Rapid Vienna,6036,3,9,10,5,35,26,9,37
LASK Linz,6036,4,8,6,10,26,30,-4,30
Vienna,6036,5,7,6,11,30,41,-11,27
SC Rheindorf,6036,6,5,7,12,18,29,-11,22
Mattersburg,6036,7,5,6,13,29,44,-15,21
FC Salzburg,6037,1,15,7,2,47,17,30,52
SK Sturm Gra,6037,2,11,4,9,32,33,-1,37
LASK Linz,6037,3,9,7,8,29,27,2,34
Rapid Vienna,6037,4,8,9,7,35,29,6,33
Mattersburg,6037,5,6,8,10,30,38,-8,26
SC Rheindorf,6037,6,6,6,12,18,28,-10,24
Vienna,6037,7,6,5,13,25,44,-19,23
FC Salzburg,6038,1,16,6,2,46,16,30,54
SK Sturm Gra,6038,2,13,4,7,33,27,6,43
Rapid Vienna,6038,3,8,11,5,37,28,9,35
LASK Linz,6038,4,8,7,9,28,29,-1,31
Vienna,6038,5,7,5,12,27,41,-14,26
Mattersburg,6038,6,6,5,13,31,46,-15,23
SC Rheindorf,6038,7,4,6,14,19,34,-15,18
FC Salzburg,6039,1,12,8,4,47,27,20,44
SK Sturm Gra,6039,2,12,5,7,36,31,5,41
Rapid Vienna,6039,3,8,11,5,37,30,7,35
LASK Linz,6039,4,10,5,9,30,28,2,35
Vienna,6039,5,7,5,12,27,43,-16,26
SC Rheindorf,6039,6,6,6,12,20,28,-8,24
Mattersburg,6039,7,6,6,12,35,45,-10,24
FC Salzburg,6040,1,15,6,3,46,19,27,51
SK Sturm Gra,6040,2,12,5,7,33,29,4,41
Rapid Vienna,6040,3,8,12,4,38,28,10,36
LASK Linz,6040,4,8,6,10,28,31,-3,30
Mattersburg,6040,5,8,5,11,36,43,-7,29
Vienna,6040,6,6,5,13,27,45,-18,23
SC Rheindorf,6040,7,4,7,13,18,31,-13,19
FC Salzburg,6041,1,15,6,3,46,18,28,51
Rapid Vienna,6041,2,9,10,5,37,27,10,37
SK Sturm Gra,6041,3,11,4,9,32,32,0,37
LASK Linz,6041,4,9,5,10,26,30,-4,32
SC Rheindorf,6041,5,7,5,12,21,28,-7,26
Vienna,6041,6,7,5,12,24,40,-16,26
Mattersburg,6041,7,6,5,13,29,40,-11,23
FC Salzburg,6042,1,13,8,3,42,19,23,47
SK Sturm Gra,6042,2,12,4,8,31,30,1,40
Rapid Vienna,6042,3,8,11,5,35,28,7,35
LASK Linz,6042,4,8,6,10,27,29,-2,30
Mattersburg,6042,5,8,5,11,33,41,-8,29
SC Rheindorf,6042,6,6,6,12,23,29,-6,24
Vienna,6042,7,6,6,12,25,40,-15,24
FC Salzburg,6043,1,14,7,3,44,18,26,49
SK Sturm Gra,6043,2,12,6,6,38,29,9,42
Rapid Vienna,6043,3,7,10,7,34,35,-1,31
LASK Linz,6043,4,8,7,9,27,30,-3,31
Vienna,6043,5,8,5,11,27,37,-10,29
SC Rheindorf,6043,6,6,6,12,21,29,-8,24
Mattersburg,6043,7,6,5,13,29,42,-13,23
FC Salzburg,6044,1,15,6,3,47,19,28,51
SK Sturm Gra,6044,2,14,3,7,34,27,7,45
Rapid Vienna,6044,3,9,9,6,37,29,8,36
LASK Linz,6044,4,9,6,9,30,28,2,33
Vienna,6044,5,7,5,12,26,40,-14,26
SC Rheindorf,6044,6,5,6,13,18,30,-12,21
Mattersburg,6044,7,5,5,14,29,48,-19,20
FC Salzburg,6045,1,14,7,3,46,21,25,49
SK Sturm Gra,6045,2,12,3,9,33,34,-1,39
LASK Linz,6045,3,10,5,9,30,29,1,35
Rapid Vienna,6045,4,8,10,6,34,26,8,34
Mattersburg,6045,5,6,7,11,30,40,-10,25
SC Rheindorf,6045,6,6,6,12,24,31,-7,24
Vienna,6045,7,6,6,12,27,43,-16,24
FC Salzburg,6046,1,16,6,2,48,17,31,54
SK Sturm Gra,6046,2,13,3,8,37,31,6,42
Rapid Vienna,6046,3,7,11,6,32,27,5,32
LASK Linz,6046,4,8,7,9,28,28,0,31
Vienna,6046,5,7,5,12,24,40,-16,26
SC Rheindorf,6046,6,6,6,12,20,32,-12,24
Mattersburg,6046,7,5,6,13,30,44,-14,21
FC Salzburg,6047,1,14,7,3,45,18,27,49
SK Sturm Gra,6047,2,14,3,7,35,30,5,45
Rapid Vienna,6047,3,8,9,7,34,30,4,33
LASK Linz,6047,4,9,5,10,27,29,-2,32
Mattersburg,6047,5,7,6,11,32,39,-7,27
Vienna,6047,6,7,5,12,26,40,-14,26
SC Rheindorf,6047,7,5,5,14,19,32,-13,20
SK Sturm Gra,6048,1,15,3,6,35,24,11,48
FC Salzburg,6048,2,13,7,4,39,18,21,46
Rapid Vienna,6048,3,9,10,5,35,25,10,37
LASK Linz,6048,4,8,5,11,27,30,-3,29
Mattersburg,6048,5,8,5,11,35,41,-6,29
Vienna,6048,6,6,6,12,24,39,-15,24
SC Rheindorf,6048,7,4,6,14,17,35,-18,18
FC Salzburg,6049,1,14,7,3,43,22,21,49
SK Sturm Gra,6049,2,12,5,7,34,28,6,41
Rapid Vienna,6049,3,10,9,5,38,27,11,39
LASK Linz,6049,4,8,7,9,29,28,1,31
Mattersburg,6049,5,6,6,12,32,45,-13,24
Vienna,6049,6,6,5,13,27,43,-16,23
SC Rheindorf,6049,7,5,7,12,19,29,-10,22
FC Salzburg,6050,1,13,7,4,41,20,21,46
Rapid Vienna,6050,2,11,9,4,40,26,14,42
SK Sturm Gra,6050,3,11,4,9,30,29,1,37
LASK Linz,6050,4,8,6,10,28,31,-3,30
Vienna,6050,5,8,5,11,27,38,-11,29
Mattersburg,6050,6,6,6,12,29,41,-12,24
SC Rheindorf,6050,7,6,5,13,22,32,-10,23
FC Salzburg,6051,1,14,7,3,45,20,25,49
Rapid Vienna,6051,2,10,9,5,38,25,13,39
SK Sturm Gra,6051,3,11,4,9,28,29,-1,37
LASK Linz,6051,4,9,6,9,26,26,0,33
Mattersburg,6051,5,7,6,11,35,40,-5,27
SC Rheindorf,6051,6,6,5,13,17,29,-12,23
Vienna,6051,7,6,5,13,23,43,-20,23
FC Salzburg,6052,1,14,6,4,44,20,24,48
SK Sturm Gra,6052,2,12,4,8,30,29,1,40
Rapid Vienna,6052,3,8,10,6,34,28,6,34
LASK Linz,6052,4,9,7,8,28,26,2,34
Mattersburg,6052,5,7,5,12,31,40,-9,26
Vienna,6052,6,7,5,12,25,40,-15,26
SC Rheindorf,6052,7,5,7,12,21,30,-9,22
FC Salzburg,6053,1,13,9,2,44,19,25,48
SK Sturm Gra,6053,2,13,4,7,35,27,8,43
Rapid Vienna,6053,3,7,12,5,36,31,5,33
LASK Linz,6053,4,9,6,9,30,28,2,33
Vienna,6053,5,7,5,12,28,39,-11,26
Mattersburg,6053,6,6,6,12,31,47,-16,24
SC Rheindorf,6053,7,5,6,13,18,31,-13,21
FC Salzburg,6054,1,15,7,2,48,19,29,52
SK Sturm Gra,6054,2,14,3,7,34,26,8,45
Rapid Vienna,6054,3,7,11,6,34,29,5,32
LASK Linz,6054,4,8,7,9,27,27,0,31
Vienna,6054,5,6,7,11,27,41,-14,25
Mattersburg,6054,6,5,7,12,28,43,-15,22
SC Rheindorf,6054,7,5,6,13,18,31,-13,21
FC Salzburg,6055,1,15,7,2,49,17,32,52
SK Sturm Gra,6055,2,12,3,9,32,38,-6,39
Rapid Vienna,6055,3,8,11,5,38,29,9,35
LASK Linz,6055,4,9,6,9,33,29,4,33
Mattersburg,6055,5,7,5,12,34,42,-8,26
Vienna,6055,6,7,5,12,24,40,-16,26
SC Rheindorf,6055,7,4,7,13,18,33,-15,19
FC Salzburg,6056,1,13,8,3,44,21,23,47
SK Sturm Gra,6056,2,12,5,7,33,29,4,41
LASK Linz,6056,3,9,5,10,30,30,0,32
Rapid Vienna,6056,4,7,10,7,33,30,3,31
Mattersburg,6056,5,7,6,11,32,41,-9,27
Vienna,6056,6,7,5,12,26,40,-14,26
SC Rheindorf,6056,7,6,7,11,22,29,-7,25
FC Salzburg,6057,1,14,7,3,45,20,25,49
SK Sturm Gra,6057,2,13,5,6,34,25,9,44
Rapid Vienna,6057,3,9,9,6,38,29,9,36
LASK Linz,6057,4,8,7,9,28,32,-4,31
Mattersburg,6057,5,7,5,12,36,47,-11,26
Vienna,6057,6,6,5,13,25,41,-16,23
SC Rheindorf,6057,7,5,6,13,19,31,-12,21
FC Salzburg,6058,1,15,6,3,50,18,32,51
SK Sturm Gra,6058,2,13,3,8,36,35,1,42
Rapid Vienna,6058,3,9,9,6,36,30,6,36
LASK Linz,6058,4,8,5,11,25,30,-5,29
Mattersburg,6058,5,7,7,10,34,39,-5,28
Vienna,6058,6,6,6,12,24,41,-17,24
SC Rheindorf,6058,7,5,6,13,20,32,-12,21
FC Salzburg,6059,1,14,6,4,46,20,26,48
SK Sturm Gra,6059,2,14,3,7,35,28,7,45
Rapid Vienna,6059,3,7,9,8,34,33,1,30
LASK Linz,6059,4,8,5,11,26,35,-9,29
Vienna,6059,5,8,5,11,28,38,-10,29
SC Rheindorf,6059,6,7,5,12,23,30,-7,26
Mattersburg,6059,7,7,5,12,33,41,-8,26
FC Salzburg,6060,1,13,6,5,44,22,22,45
SK Sturm Gra,6060,2,13,3,8,33,30,3,42
Rapid Vienna,6060,3,8,10,6,37,30,7,34
LASK Linz,6060,4,8,7,9,26,28,-2,31
Vienna,6060,5,8,5,11,26,38,-12,29
Mattersburg,6060,6,6,7,11,30,40,-10,25
SC Rheindorf,6060,7,6,6,12,20,28,-8,24
FC Salzburg,6061,1,15,6,3,43,17,26,51
SK Sturm Gra,6061,2,12,4,8,33,29,4,40
Rapid Vienna,6061,3,8,11,5,34,26,8,35
LASK Linz,6061,4,8,7,9,27,28,-1,31
Vienna,6061,5,7,5,12,25,39,-14,26
Mattersburg,6061,6,6,7,11,30,40,-10,25
SC Rheindorf,6061,7,5,6,13,16,29,-13,21
FC Salzburg,6062,1,15,6,3,49,20,29,51
SK Sturm Gra,6062,2,11,6,7,29,28,1,39
Rapid Vienna,6062,3,9,10,5,36,27,9,37
LASK Linz,6062,4,8,6,10,26,28,-2,30
Mattersburg,6062,5,7,5,12,36,45,-9,26
Vienna,6062,6,7,5,12,26,43,-17,26
SC Rheindorf,6062,7,5,6,13,17,28,-11,21
FC Salzburg,6063,1,16,6,2,53,17,36,54
SK Sturm Gra,6063,2,14,3,7,37,32,5,45
Rapid Vienna,6063,3,9,9,6,34,27,7,36
LASK Linz,6063,4,8,5,11,27,31,-4,29
Mattersburg,6063,5,7,6,11,30,40,-10,27
Vienna,6063,6,6,5,13,23,44,-21,23
SC Rheindorf,6063,7,4,6,14,18,31,-13,18
FC Salzburg,6064,1,13,7,4,43,20,23,46
SK Sturm Gra,6064,2,13,3,8,39,33,6,42
Rapid Vienna,6064,3,10,9,5,37,29,8,39
LASK Linz,6064,4,9,6,9,32,30,2,33
Mattersburg,6064,5,7,6,11,32,41,-9,27
Vienna,6064,6,6,6,12,25,42,-17,24
SC Rheindorf,6064,7,5,5,14,19,32,-13,20
FC Salzburg,6065,1,16,6,2,46,16,30,54
SK Sturm Gra,6065,2,13,4,7,32,26,6,43
Rapid Vienna,6065,3,9,9,6,36,28,8,36
LASK Linz,6065,4,7,6,11,30,35,-5,27
Mattersburg,6065,5,6,7,11,32,42,-10,25
Vienna,6065,6,6,6,12,24,41,-17,24
SC Rheindorf,6065,7,5,6,13,19,31,-12,21
FC Salzburg,6066,1,13,8,3,49,21,28,47
Rapid Vienna,6066,2,10,10,4,37,25,12,40
SK Sturm Gra,6066,3,12,3,9,32,36,-4,39
LASK Linz,6066,4,9,5,10,27,28,-1,32
Mattersburg,6066,5,8,5,11,34,40,-6,29
Vienna,6066,6,6,6,12,24,40,-16,24
SC Rheindorf,6066,7,5,5,14,17,30,-13,20
FC Salzburg,6067,1,13,8,3,46,21,25,47
Rapid Vienna,6067,2,10,10,4,39,27,12,40
SK Sturm Gra,6067,3,11,5,8,34,34,0,38
LASK Linz,6067,4,7,8,9,28,31,-3,29
Vienna,6067,5,7,6,11,25,38,-13,27
SC Rheindorf,6067,6,6,6,12,23,29,-6,24
Mattersburg,6067,7,6,5,13,29,44,-15,23
FC Salzburg,6068,1,15,6,3,46,19,27,51
SK Sturm Gra,6068,2,13,4,7,32,27,5,43
Rapid Vienna,6068,3,8,9,7,35,28,7,33
LASK Linz,6068,4,8,6,10,26,29,-3,30
Mattersburg,6068,5,7,6,11,32,38,-6,27
Vienna,6068,6,6,6,12,25,41,-16,24
SC Rheindorf,6068,7,6,5,13,18,32,-14,23
FC Salzburg,6069,1,15,7,2,43,16,27,52
SK Sturm Gra,6069,2,12,4,8,32,29,3,40
Rapid Vienna,6069,3,9,10,5,37,28,9,37
LASK Linz,6069,4,8,7,9,28,31,-3,31
Mattersburg,6069,5,8,5,11,35,39,-4,29
Vienna,6069,6,6,5,13,23,40,-17,23
SC Rheindorf,6069,7,4,6,14,18,33,-15,18
FC Salzburg,6070,1,14,6,4,42,18,24,48
SK Sturm Gra,6070,2,14,3,7,36,29,7,45
Rapid Vienna,6070,3,9,9,6,38,28,10,36
LASK Linz,6070,4,8,5,11,26,30,-4,29
Mattersburg,6070,5,7,6,11,30,39,-9,27
Vienna,6070,6,6,6,12,24,39,-15,24
SC Rheindorf,6070,7,6,5,13,19,32,-13,23
FC Salzburg,6071,1,14,8,2,43,17,26,50
SK Sturm Gra,6071,2,13,4,7,33,28,5,43
LASK Linz,6071,3,9,5,10,33,30,3,32
Rapid Vienna,6071,4,7,11,6,33,32,1,32
SC Rheindorf,6071,5,6,6,12,22,30,-8,24
Mattersburg,6071,6,6,6,12,31,42,-11,24
Vienna,6071,7,6,6,12,24,40,-16,24
FC Salzburg,6072,1,14,7,3,43,17,26,49
SK Sturm Gra,6072,2,13,5,6,34,27,7,44
LASK Linz,6072,3,10,6,8,29,27,2,36
Rapid Vienna,6072,4,8,9,7,35,31,4,33
Vienna,6072,5,8,5,11,25,37,-12,29
Mattersburg,6072,6,5,6,13,28,41,-13,21
SC Rheindorf,6072,7,4,6,14,17,31,-14,18
FC Salzburg,6073,1,15,7,2,50,19,31,52
SK Sturm Gra,6073,2,12,4,8,34,33,1,40
Rapid Vienna,6073,3,8,10,6,37,30,7,34
LASK Linz,6073,4,8,7,9,26,27,-1,31
Mattersburg,6073,5,6,7,11,31,43,-12,25
Vienna,6073,6,6,7,11,26,40,-14,25
SC Rheindorf,6073,7,5,6,13,19,31,-12,21
FC Salzburg,6074,1,15,7,2,46,18,28,52
SK Sturm Gra,6074,2,11,5,8,32,30,2,38
Rapid Vienna,6074,3,7,12,5,35,30,5,33
LASK Linz,6074,4,9,6,9,30,29,1,33
Mattersburg,6074,5,6,7,11,30,41,-11,25
Vienna,6074,6,6,6,12,26,41,-15,24
SC Rheindorf,6074,7,5,7,12,21,31,-10,22
FC Salzburg,6075,1,14,8,2,43,17,26,50
SK Sturm Gra,6075,2,12,4,8,33,29,4,40
Rapid Vienna,6075,3,9,10,5,37,26,11,37
LASK Linz,6075,4,8,7,9,28,29,-1,31
Vienna,6075,5,7,6,11,25,38,-13,27
Mattersburg,6075,6,6,6,12,29,40,-11,24
SC Rheindorf,6075,7,5,5,14,16,32,-16,20
FC Salzburg,6076,1,15,6,3,45,17,28,51
SK Sturm Gra,6076,2,13,4,7,31,26,5,43
Rapid Vienna,6076,3,9,9,6,34,27,7,36
LASK Linz,6076,4,9,5,10,30,29,1,32
Mattersburg,6076,5,7,5,12,29,40,-11,26
Vienna,6076,6,6,5,13,24,41,-17,23
SC Rheindorf,6076,7,5,6,13,19,32,-13,21
FC Salzburg,6077,1,14,8,2,44,17,27,50
SK Sturm Gra,6077,2,12,4,8,32,27,5,40
Rapid Vienna,6077,3,9,11,4,36,25,11,38
LASK Linz,6077,4,7,8,9,26,30,-4,29
Mattersburg,6077,5,7,6,11,33,42,-9,27
Vienna,6077,6,6,5,13,24,42,-18,23
SC Rheindorf,6077,7,5,6,13,20,32,-12,21
FC Salzburg,6078,1,16,6,2,47,19,28,54
SK Sturm Gra,6078,2,11,5,8,31,29,2,38
Rapid Vienna,6078,3,9,10,5,36,26,10,37
LASK Linz,6078,4,8,6,10,26,30,-4,30
Mattersburg,6078,5,6,6,12,30,41,-11,24
Vienna,6078,6,6,6,12,26,41,-15,24
SC Rheindorf,6078,7,6,5,13,21,31,-10,23
FC Salzburg,6079,1,14,7,3,43,18,25,49
SK Sturm Gra,6079,2,12,3,9,32,28,4,39
Rapid Vienna,6079,3,9,9,6,34,30,4,36
LASK Linz,6079,4,10,5,9,31,29,2,35
Vienna,6079,5,7,6,11,28,41,-13,27
Mattersburg,6079,6,7,5,12,34,44,-10,26
SC Rheindorf,6079,7,5,5,14,18,30,-12,20
FC Salzburg,6080,1,15,7,2,47,16,31,52
Rapid Vienna,6080,2,10,10,4,38,24,14,40
SK Sturm Gra,6080,3,12,4,8,31,31,0,40
Mattersburg,6080,4,8,5,11,32,41,-9,29
LASK Linz,6080,5,7,6,11,26,31,-5,27
Vienna,6080,6,6,5,13,25,42,-17,23
SC Rheindorf,6080,7,4,7,13,17,31,-14,19
FC Salzburg,6081,1,12,8,4,40,19,21,44
SK Sturm Gra,6081,2,12,5,7,30,27,3,41
Rapid Vienna,6081,3,9,10,5,34,25,9,37
LASK Linz,6081,4,8,6,10,26,31,-5,30
Vienna,6081,5,7,6,11,25,37,-12,27
Mattersburg,6081,6,7,5,12,33,44,-11,26
SC Rheindorf,6081,7,6,6,12,21,26,-5,24
FC Salzburg,6082,1,15,6,3,47,18,29,51
SK Sturm Gra,6082,2,13,3,8,34,30,4,42
Rapid Vienna,6082,3,8,9,7,37,33,4,33
LASK Linz,6082,4,9,5,10,28,29,-1,32
Mattersburg,6082,5,7,5,12,31,42,-11,26
Vienna,6082,6,7,5,12,24,39,-15,26
SC Rheindorf,6082,7,6,5,13,19,29,-10,23
FC Salzburg,6083,1,15,7,2,44,17,27,52
SK Sturm Gra,6083,2,13,3,8,34,30,4,42
Rapid Vienna,6083,3,7,9,8,31,28,3,30
LASK Linz,6083,4,8,5,11,25,32,-7,29
SC Rheindorf,6083,5,7,6,11,23,28,-5,27
Vienna,6083,6,7,6,11,26,38,-12,27
Mattersburg,6083,7,6,6,12,31,41,-10,24
FC Salzburg,6084,1,13,9,2,43,19,24,48
SK Sturm Gra,6084,2,13,4,7,34,29,5,43
Rapid Vienna,6084,3,9,10,5,38,29,9,37
LASK Linz,6084,4,8,5,11,26,34,-8,29
Vienna,6084,5,7,6,11,28,40,-12,27
SC Rheindorf,6084,6,7,5,12,25,27,-2,26
Mattersburg,6084,7,5,5,14,29,45,-16,20
FC Salzburg,6085,1,13,7,4,43,19,24,46
SK Sturm Gra,6085,2,14,3,7,32,29,3,45
Rapid Vienna,6085,3,8,10,6,37,29,8,34
LASK Linz,6085,4,8,7,9,27,28,-1,31
Mattersburg,6085,5,7,6,11,30,39,-9,27
Vienna,6085,6,7,6,11,26,39,-13,27
SC Rheindorf,6085,7,4,7,13,17,29,-12,19
FC Salzburg,6086,1,15,7,2,46,18,28,52
SK Sturm Gra,6086,2,14,3,7,37,28,9,45
LASK Linz,6086,3,10,5,9,33,28,5,35
Rapid Vienna,6086,4,8,10,6,32,29,3,34
Mattersburg,6086,5,6,6,12,31,45,-14,24
Vienna,6086,6,6,5,13,24,41,-17,23
SC Rheindorf,6086,7,4,6,14,18,32,-14,18
FC Salzburg,6087,1,14,7,3,44,19,25,49
SK Sturm Gra,6087,2,13,5,6,36,26,10,44
Rapid Vienna,6087,3,7,11,6,32,28,4,32
LASK Linz,6087,4,7,6,11,24,31,-7,27
Mattersburg,6087,5,7,6,11,32,40,-8,27
Vienna,6087,6,7,6,11,24,37,-13,27
SC Rheindorf,6087,7,5,7,12,17,28,-11,22
FC Salzburg,6088,1,14,7,3,42,17,25,49
Rapid Vienna,6088,2,9,9,6,34,26,8,36
SK Sturm Gra,6088,3,11,3,10,29,31,-2,36
LASK Linz,6088,4,9,5,10,26,28,-2,32
SC Rheindorf,6088,5,8,5,11,23,27,-4,29
Vienna,6088,6,6,7,11,24,38,-14,25
Mattersburg,6088,7,6,6,12,29,40,-11,24
FC Salzburg,6089,1,13,8,3,40,18,22,47
Rapid Vienna,6089,2,9,10,5,35,27,8,37
SK Sturm Gra,6089,3,11,4,9,29,32,-3,37
LASK Linz,6089,4,10,6,8,29,25,4,36
Vienna,6089,5,7,6,11,26,38,-12,27
Mattersburg,6089,6,5,8,11,29,40,-11,23
SC Rheindorf,6089,7,5,6,13,21,29,-8,21
FC Salzburg,6090,1,15,7,2,45,17,28,52
SK Sturm Gra,6090,2,13,3,8,32,28,4,42
Rapid Vienna,6090,3,10,9,5,38,27,11,39
LASK Linz,6090,4,8,5,11,30,31,-1,29
Mattersburg,6090,5,6,6,12,29,44,-15,24
SC Rheindorf,6090,6,6,5,13,20,29,-9,23
Vienna,6090,7,6,5,13,23,41,-18,23
FC Salzburg,6091,1,14,6,4,46,21,25,48
SK Sturm Gra,6091,2,12,4,8,35,31,4,40
Rapid Vienna,6091,3,10,9,5,37,27,10,39
LASK Linz,6091,4,8,6,10,26,29,-3,30
Vienna,6091,5,7,5,12,27,38,-11,26
Mattersburg,6091,6,7,5,12,29,44,-15,26
SC Rheindorf,6091,7,6,5,13,18,28,-10,23
FC Salzburg,6092,1,14,6,4,42,19,23,48
SK Sturm Gra,6092,2,13,3,8,32,29,3,42
Rapid Vienna,6092,3,8,11,5,35,28,7,35
LASK Linz,6092,4,9,6,9,27,26,1,33
Vienna,6092,5,7,6,11,25,37,-12,27
Mattersburg,6092,6,6,6,12,29,38,-9,24
SC Rheindorf,6092,7,5,6,13,18,31,-13,21
FC Salzburg,6093,1,13,8,3,42,21,21,47
SK Sturm Gra,6093,2,13,5,6,34,27,7,44
Rapid Vienna,6093,3,10,9,5,40,26,14,39
LASK Linz,6093,4,8,5,11,27,33,-6,29
Mattersburg,6093,5,7,7,10,33,38,-5,28
Vienna,6093,6,6,5,13,23,41,-18,23
SC Rheindorf,6093,7,4,7,13,17,30,-13,19
FC Salzburg,6094,1,15,7,2,46,18,28,52
SK Sturm Gra,6094,2,12,3,9,30,29,1,39
Rapid Vienna,6094,3,8,9,7,34,28,6,33
LASK Linz,6094,4,8,5,11,28,32,-4,29
SC Rheindorf,6094,5,8,5,11,24,28,-4,29
Vienna,6094,6,7,5,12,28,42,-14,26
Mattersburg,6094,7,6,6,12,35,48,-13,24
FC Salzburg,6095,1,13,6,5,41,22,19,45
SK Sturm Gra,6095,2,13,5,6,37,29,8,44
LASK Linz,6095,3,10,6,8,30,27,3,36
Rapid Vienna,6095,4,8,10,6,34,28,6,34
Vienna,6095,5,7,5,12,27,39,-12,26
Mattersburg,6095,6,6,5,13,31,44,-13,23
SC Rheindorf,6095,7,5,7,12,18,29,-11,22
SK Sturm Gra,6096,1,14,4,6,36,27,9,46
FC Salzburg,6096,2,13,6,5,45,25,20,45
Rapid Vienna,6096,3,9,11,4,38,27,11,38
Vienna,6096,4,8,5,11,28,37,-9,29
LASK Linz,6096,5,7,6,11,28,32,-4,27
Mattersburg,6096,6,6,6,12,34,46,-12,24
SC Rheindorf,6096,7,5,6,13,18,33,-15,21
FC Salzburg,6097,1,15,7,2,47,20,27,52
SK Sturm Gra,6097,2,13,3,8,33,31,2,42
Rapid Vienna,6097,3,8,9,7,38,31,7,33
LASK Linz,6097,4,9,6,9,29,29,0,33
Mattersburg,6097,5,6,7,11,33,42,-9,25
Vienna,6097,6,6,7,11,28,42,-14,25
SC Rheindorf,6097,7,5,5,14,19,32,-13,20
FC Salzburg,6098,1,14,8,2,47,18,29,50
SK Sturm Gra,6098,2,13,4,7,37,29,8,43
Rapid Vienna,6098,3,8,10,6,33,29,4,34
LASK Linz,6098,4,8,5,11,27,32,-5,29
Vienna,6098,5,7,6,11,27,40,-13,27
Mattersburg,6098,6,7,5,12,34,45,-11,26
SC Rheindorf,6098,7,5,6,13,21,33,-12,21
FC Salzburg,6099,1,13,9,2,43,17,26,48
SK Sturm Gra,6099,2,13,4,7,31,27,4,43
Rapid Vienna,6099,3,9,10,5,36,25,11,37
Mattersburg,6099,4,7,7,10,34,42,-8,28
LASK Linz,6099,5,7,6,11,25,30,-5,27
Vienna,6099,6,6,6,12,25,42,-17,24
SC Rheindorf,6099,7,5,6,13,22,33,-11,21
FC Salzburg,6100,1,16,6,2,45,16,29,54
SK Sturm Gra,6100,2,12,4,8,35,31,4,40
Rapid Vienna,6100,3,8,10,6,35,26,9,34
LASK Linz,6100,4,9,5,10,29,29,0,32
Mattersburg,6100,5,7,5,12,32,41,-9,26
Vienna,6100,6,7,5,12,25,40,-15,26
SC Rheindorf,6100,7,5,5,14,17,35,-18,20
FC Salzburg,6101,1,14,6,4,44,19,25,48
SK Sturm Gra,6101,2,13,5,6,32,25,7,44
Rapid Vienna,6101,3,8,12,4,35,26,9,36
LASK Linz,6101,4,7,7,10,26,30,-4,28
Mattersburg,6101,5,7,5,12,32,42,-10,26
SC Rheindorf,6101,6,6,6,12,18,28,-10,24
Vienna,6101,7,6,5,13,23,40,-17,23
FC Salzburg,6102,1,15,7,2,49,19,30,52
SK Sturm Gra,6102,2,12,4,8,32,29,3,40
Rapid Vienna,6102,3,8,11,5,36,28,8,35
LASK Linz,6102,4,8,7,9,28,29,-1,31
Vienna,6102,5,7,5,12,26,40,-14,26
Mattersburg,6102,6,6,6,12,29,44,-15,24
SC Rheindorf,6102,7,5,6,13,19,30,-11,21
FC Salzburg,6103,1,16,6,2,51,19,32,54
SK Sturm Gra,6103,2,11,4,9,34,37,-3,37
Rapid Vienna,6103,3,9,9,6,38,29,9,36
LASK Linz,6103,4,9,6,9,31,29,2,33
Vienna,6103,5,7,5,12,26,43,-17,26
SC Rheindorf,6103,6,6,5,13,22,33,-11,23
Mattersburg,6103,7,6,5,13,33,45,-12,23
FC Salzburg,6104,1,16,6,2,53,17,36,54
SK Sturm Gra,6104,2,13,3,8,33,32,1,42
Rapid Vienna,6104,3,10,9,5,38,28,10,39
LASK Linz,6104,4,8,6,10,27,29,-2,30
Vienna,6104,5,7,5,12,24,41,-17,26
Mattersburg,6104,6,6,6,12,29,43,-14,24
SC Rheindorf,6104,7,4,5,15,17,31,-14,17
FC Salzburg,6105,1,14,8,2,44,16,28,50
SK Sturm Gra,6105,2,12,4,8,33,31,2,40
Rapid Vienna,6105,3,8,10,6,34,27,7,34
LASK Linz,6105,4,9,6,9,30,29,1,33
Vienna,6105,5,7,6,11,25,38,-13,27
Mattersburg,6105,6,6,5,13,28,41,-13,23
SC Rheindorf,6105,7,5,7,12,22,34,-12,22
FC Salzburg,6106,1,14,7,3,50,23,27,49
SK Sturm Gra,6106,2,12,5,7,32,27,5,41
Rapid Vienna,6106,3,8,11,5,34,27,7,35
LASK Linz,6106,4,9,7,8,29,28,1,34
Mattersburg,6106,5,7,5,12,34,46,-12,26
Vienna,6106,6,6,6,12,26,41,-15,24
SC Rheindorf,6106,7,4,7,13,17,30,-13,19
FC Salzburg,6107,1,13,7,4,42,20,22,46
SK Sturm Gra,6107,2,14,3,7,33,30,3,45
Rapid Vienna,6107,3,8,11,5,37,26,11,35
Mattersburg,6107,4,9,5,10,31,37,-6,32
LASK Linz,6107,5,7,7,10,26,29,-3,28
Vienna,6107,6,6,6,12,23,38,-15,24
SC Rheindorf,6107,7,4,7,13,17,29,-12,19
FC Salzburg,6108,1,14,8,2,45,19,26,50
SK Sturm Gra,6108,2,11,6,7,32,30,2,39
Rapid Vienna,6108,3,8,12,4,34,25,9,36
LASK Linz,6108,4,8,7,9,28,29,-1,31
Vienna,6108,5,7,5,12,26,41,-15,26
Mattersburg,6108,6,6,5,13,34,46,-12,23
SC Rheindorf,6108,7,5,7,12,22,31,-9,22
FC Salzburg,6109,1,13,9,2,40,15,25,48
SK Sturm Gra,6109,2,12,4,8,31,30,1,40
Rapid Vienna,6109,3,8,11,5,35,26,9,35
LASK Linz,6109,4,9,6,9,30,30,0,33
Vienna,6109,5,6,7,11,25,39,-14,25
Mattersburg,6109,6,5,8,11,30,42,-12,23
SC Rheindorf,6109,7,5,7,12,20,29,-9,22
FC Salzburg,6110,1,14,8,2,46,18,28,50
SK Sturm Gra,6110,2,13,3,8,34,28,6,42
LASK Linz,6110,3,9,6,9,29,29,0,33
Rapid Vienna,6110,4,7,11,6,34,30,4,32
SC Rheindorf,6110,5,6,7,11,21,29,-8,25
Vienna,6110,6,6,6,12,23,40,-17,24
Mattersburg,6110,7,5,7,12,27,40,-13,22
FC Salzburg,6111,1,13,9,2,44,20,24,48
SK Sturm Gra,6111,2,12,5,7,33,29,4,41
LASK Linz,6111,3,10,6,8,31,28,3,36
Rapid Vienna,6111,4,7,10,7,35,32,3,31
SC Rheindorf,6111,5,7,5,12,27,33,-6,26
Vienna,6111,6,7,5,12,28,40,-12,26
Mattersburg,6111,7,5,6,13,32,48,-16,21
FC Salzburg,6112,1,12,9,3,42,20,22,45
Rapid Vienna,6112,2,10,10,4,36,25,11,40
SK Sturm Gra,6112,3,11,7,6,30,26,4,40
LASK Linz,6112,4,7,7,10,25,29,-4,28
Vienna,6112,5,7,6,11,25,38,-13,27
Mattersburg,6112,6,6,7,11,32,39,-7,25
SC Rheindorf,6112,7,5,6,13,18,31,-13,21
FC Salzburg,6113,1,16,6,2,44,16,28,54
SK Sturm Gra,6113,2,12,5,7,32,28,4,41
Rapid Vienna,6113,3,8,11,5,36,28,8,35
LASK Linz,6113,4,7,7,10,25,28,-3,28
Mattersburg,6113,5,7,5,12,31,41,-10,26
Vienna,6113,6,6,5,13,24,41,-17,23
SC Rheindorf,6113,7,5,7,12,22,32,-10,22
FC Salzburg,6114,1,15,6,3,43,18,25,51
SK Sturm Gra,6114,2,12,3,9,30,29,1,39
Rapid Vienna,6114,3,9,10,5,36,27,9,37
LASK Linz,6114,4,8,6,10,28,30,-2,30
Mattersburg,6114,5,7,5,12,34,41,-7,26
Vienna,6114,6,7,5,12,25,39,-14,26
SC Rheindorf,6114,7,5,7,12,19,31,-12,22
FC Salzburg,6115,1,14,8,2,50,19,31,50
Rapid Vienna,6115,2,9,11,4,35,25,10,38
SK Sturm Gra,6115,3,11,4,9,33,32,1,37
LASK Linz,6115,4,8,7,9,27,28,-1,31
Mattersburg,6115,5,6,7,11,32,45,-13,25
Vienna,6115,6,6,6,12,24,41,-17,24
SC Rheindorf,6115,7,5,7,12,17,28,-11,22
FC Salzburg,6116,1,15,6,3,46,18,28,51
Rapid Vienna,6116,2,10,10,4,37,25,12,40
SK Sturm Gra,6116,3,12,4,8,29,27,2,40
LASK Linz,6116,4,8,5,11,26,29,-3,29
Vienna,6116,5,7,5,12,24,39,-15,26
Mattersburg,6116,6,6,6,12,30,43,-13,24
SC Rheindorf,6116,7,5,6,13,18,29,-11,21
FC Salzburg,6117,1,16,6,2,48,19,29,54
SK Sturm Gra,6117,2,13,3,8,33,29,4,42
Rapid Vienna,6117,3,8,9,7,35,30,5,33
LASK Linz,6117,4,8,5,11,27,34,-7,29
SC Rheindorf,6117,5,7,5,12,21,28,-7,26
Vienna,6117,6,7,5,12,28,42,-14,26
Mattersburg,6117,7,6,5,13,35,45,-10,23
FC Salzburg,6118,1,15,7,2,47,20,27,52
SK Sturm Gra,6118,2,13,4,7,33,27,6,43
Rapid Vienna,6118,3,7,12,5,36,30,6,33
Mattersburg,6118,4,8,5,11,33,38,-5,29
LASK Linz,6118,5,7,6,11,26,32,-6,27
Vienna,6118,6,6,6,12,25,40,-15,24
SC Rheindorf,6118,7,5,6,13,18,31,-13,21
FC Salzburg,6119,1,13,8,3,47,26,21,47
SK Sturm Gra,6119,2,11,4,9,31,31,0,37
Rapid Vienna,6119,3,8,11,5,39,30,9,35
LASK Linz,6119,4,8,7,9,28,30,-2,31
Vienna,6119,5,7,6,11,28,40,-12,27
SC Rheindorf,6119,6,7,5,12,22,29,-7,26
Mattersburg,6119,7,7,5,12,35,44,-9,26
FC Salzburg,6120,1,13,9,2,44,19,25,48
Rapid Vienna,6120,2,10,10,4,41,25,16,40
SK Sturm Gra,6120,3,11,5,8,30,29,1,38
LASK Linz,6120,4,10,5,9,28,30,-2,35
Vienna,6120,5,7,6,11,27,39,-12,27
Mattersburg,6120,6,6,5,13,30,43,-13,23
SC Rheindorf,6120,7,4,6,14,17,32,-15,18
FC Salzburg,6121,1,15,6,3,47,18,29,51
SK Sturm Gra,6121,2,12,5,7,31,27,4,41
Rapid Vienna,6121,3,10,10,4,37,24,13,40
LASK Linz,6121,4,7,8,9,28,31,-3,29
Mattersburg,6121,5,6,7,11,31,43,-12,25
Vienna,6121,6,6,6,12,24,41,-17,24
SC Rheindorf,6121,7,4,6,14,18,32,-14,18
FC Salzburg,6122,1,15,6,3,43,17,26,51
SK Sturm Gra,6122,2,11,6,7,36,33,3,39
Rapid Vienna,6122,3,9,10,5,41,29,12,37
LASK Linz,6122,4,9,6,9,30,30,0,33
Vienna,6122,5,8,5,11,26,38,-12,29
SC Rheindorf,6122,6,5,6,13,19,33,-14,21
Mattersburg,6122,7,5,5,14,27,42,-15,20
FC Salzburg,6123,1,14,7,3,43,19,24,49
SK Sturm Gra,6123,2,12,5,7,32,28,4,41
Rapid Vienna,6123,3,9,10,5,38,28,10,37
LASK Linz,6123,4,8,7,9,26,30,-4,31
Vienna,6123,5,7,5,12,25,39,-14,26
SC Rheindorf,6123,6,6,6,12,21,28,-7,24
Mattersburg,6123,7,5,6,13,31,44,-13,21
FC Salzburg,6124,1,13,7,4,41,18,23,46
Rapid Vienna,6124,2,9,11,4,34,24,10,38
SK Sturm Gra,6124,3,11,5,8,30,29,1,38
LASK Linz,6124,4,8,7,9,29,32,-3,31
Mattersburg,6124,5,8,5,11,36,40,-4,29
Vienna,6124,6,7,5,12,26,42,-16,26
SC Rheindorf,6124,7,5,6,13,20,31,-11,21
FC Salzburg,6125,1,14,6,4,41,19,22,48
Rapid Vienna,6125,2,10,9,5,36,28,8,39
SK Sturm Gra,6125,3,12,3,9,33,31,2,39
LASK Linz,6125,4,9,6,9,32,29,3,33
Vienna,6125,5,8,5,11,30,41,-11,29
SC Rheindorf,6125,6,5,7,12,20,30,-10,22
Mattersburg,6125,7,5,6,13,33,47,-14,21
FC Salzburg,6126,1,16,6,2,44,16,28,54
SK Sturm Gra,6126,2,12,3,9,30,29,1,39
Rapid Vienna,6126,3,9,9,6,37,28,9,36
LASK Linz,6126,4,8,5,11,27,32,-5,29
Mattersburg,6126,5,7,6,11,35,43,-8,27
SC Rheindorf,6126,6,6,6,12,24,32,-8,24
Vienna,6126,7,6,5,13,24,41,-17,23
FC Salzburg,6127,1,12,10,2,43,20,23,46
SK Sturm Gra,6127,2,13,4,7,33,30,3,43
Rapid Vienna,6127,3,8,11,5,35,27,8,35
LASK Linz,6127,4,9,6,9,28,28,0,33
Vienna,6127,5,6,7,11,24,38,-14,25
SC Rheindorf,6127,6,6,5,13,20,28,-8,23
Mattersburg,6127,7,5,7,12,30,42,-12,22
FC Salzburg,6128,1,13,8,3,43,19,24,47
Rapid Vienna,6128,2,10,10,4,40,25,15,40
SK Sturm Gra,6128,3,12,4,8,33,34,-1,40
LASK Linz,6128,4,9,5,10,27,28,-1,32
Vienna,6128,5,6,7,11,27,41,-14,25
Mattersburg,6128,6,5,8,11,31,43,-12,23
SC Rheindorf,6128,7,4,8,12,18,29,-11,20
FC Salzburg,6129,1,15,7,2,47,19,28,52
SK Sturm Gra,6129,2,12,4,8,33,32,1,40
LASK Linz,6129,3,10,5,9,29,27,2,35
Rapid Vienna,6129,4,8,9,7,36,29,7,33
Vienna,6129,5,7,5,12,25,39,-14,26
Mattersburg,6129,6,6,6,12,32,44,-12,24
SC Rheindorf,6129,7,5,6,13,19,31,-12,21
FC Salzburg,6130,1,15,6,3,46,20,26,51
SK Sturm Gra,6130,2,14,3,7,34,30,4,45
Rapid Vienna,6130,3,9,9,6,37,28,9,36
LASK Linz,6130,4,8,5,11,26,31,-5,29
Vienna,6130,5,7,5,12,27,40,-13,26
SC Rheindorf,6130,6,6,5,13,21,29,-8,23
Mattersburg,6130,7,6,5,13,33,46,-13,23
FC Salzburg,6131,1,14,7,3,44,19,25,49
Rapid Vienna,6131,2,10,9,5,39,30,9,39
SK Sturm Gra,6131,3,12,3,9,34,29,5,39
LASK Linz,6131,4,9,5,10,28,32,-4,32
Vienna,6131,5,7,6,11,30,39,-9,27
SC Rheindorf,6131,6,7,5,12,24,29,-5,26
Mattersburg,6131,7,5,5,14,28,49,-21,20
FC Salzburg,6132,1,16,6,2,48,16,32,54
SK Sturm Gra,6132,2,12,5,7,34,29,5,41
Rapid Vienna,6132,3,7,11,6,37,31,6,32
LASK Linz,6132,4,7,8,9,28,30,-2,29
Mattersburg,6132,5,6,7,11,32,43,-11,25
Vienna,6132,6,6,6,12,25,43,-18,24
SC Rheindorf,6132,7,6,5,13,19,31,-12,23
FC Salzburg,6133,1,15,7,2,50,19,31,52
SK Sturm Gra,6133,2,12,3,9,33,34,-1,39
LASK Linz,6133,3,10,6,8,31,29,2,36
Rapid Vienna,6133,4,7,11,6,34,28,6,32
SC Rheindorf,6133,5,6,6,12,22,30,-8,24
Vienna,6133,6,6,6,12,23,40,-17,24
Mattersburg,6133,7,5,7,12,30,43,-13,22
FC Salzburg,6134,1,15,6,3,47,24,23,51
SK Sturm Gra,6134,2,12,4,8,32,29,3,40
Rapid Vienna,6134,3,9,10,5,42,29,13,37
LASK Linz,6134,4,8,6,10,28,31,-3,30
Vienna,6134,5,7,5,12,26,42,-16,26
Mattersburg,6134,6,6,6,12,32,40,-8,24
SC Rheindorf,6134,7,6,5,13,21,33,-12,23
FC Salzburg,6135,1,13,9,2,43,19,24,48
SK Sturm Gra,6135,2,13,4,7,32,28,4,43
Rapid Vienna,6135,3,8,11,5,36,26,10,35
LASK Linz,6135,4,8,6,10,26,29,-3,30
Vienna,6135,5,6,7,11,26,40,-14,25
Mattersburg,6135,6,5,8,11,35,46,-11,23
SC Rheindorf,6135,7,5,7,12,21,31,-10,22
FC Salzburg,6136,1,15,6,3,46,22,24,51
SK Sturm Gra,6136,2,12,4,8,35,29,6,40
Rapid Vienna,6136,3,10,9,5,45,32,13,39
LASK Linz,6136,4,9,5,10,31,35,-4,32
Vienna,6136,5,7,5,12,25,40,-15,26
Mattersburg,6136,6,6,5,13,34,44,-10,23
SC Rheindorf,6136,7,5,6,13,17,31,-14,21
FC Salzburg,6137,1,14,8,2,44,18,26,50
SK Sturm Gra,6137,2,12,4,8,32,28,4,40
Rapid Vienna,6137,3,9,9,6,35,30,5,36
LASK Linz,6137,4,10,6,8,33,28,5,36
Vienna,6137,5,7,6,11,32,42,-10,27
SC Rheindorf,6137,6,5,6,13,19,30,-11,21
Mattersburg,6137,7,5,5,14,30,49,-19,20
FC Salzburg,6138,1,13,8,3,43,19,24,47
SK Sturm Gra,6138,2,12,3,9,30,28,2,39
Rapid Vienna,6138,3,9,10,5,35,25,10,37
LASK Linz,6138,4,10,5,9,27,26,1,35
Mattersburg,6138,5,6,8,10,31,40,-9,26
Vienna,6138,6,6,6,12,26,42,-16,24
SC Rheindorf,6138,7,5,6,13,19,31,-12,21
FC Salzburg,6139,1,15,6,3,46,18,28,51
SK Sturm Gra,6139,2,14,3,7,39,34,5,45
Rapid Vienna,6139,3,8,10,6,35,28,7,34
LASK Linz,6139,4,8,5,11,28,32,-4,29
Vienna,6139,5,8,5,11,28,39,-11,29
Mattersburg,6139,6,7,5,12,33,44,-11,26
SC Rheindorf,6139,7,4,6,14,19,33,-14,18
FC Salzburg,6140,1,14,7,3,44,17,27,49
SK Sturm Gra,6140,2,13,4,7,34,27,7,43
Rapid Vienna,6140,3,7,11,6,33,29,4,32
LASK Linz,6140,4,8,6,10,28,31,-3,30
Vienna,6140,5,7,5,12,26,40,-14,26
SC Rheindorf,6140,6,6,7,11,25,30,-5,25
Mattersburg,6140,7,6,6,12,32,48,-16,24
FC Salzburg,6141,1,14,8,2,46,18,28,50
SK Sturm Gra,6141,2,14,3,7,36,27,9,45
LASK Linz,6141,3,9,5,10,28,31,-3,32
Rapid Vienna,6141,4,7,10,7,32,31,1,31
Mattersburg,6141,5,7,7,10,33,38,-5,28
Vienna,6141,6,6,6,12,23,39,-16,24
SC Rheindorf,6141,7,4,7,13,17,31,-14,19
FC Salzburg,6142,1,15,7,2,44,16,28,52
SK Sturm Gra,6142,2,11,5,8,31,31,0,38
LASK Linz,6142,3,9,6,9,28,28,0,33
Rapid Vienna,6142,4,7,11,6,33,27,6,32
Mattersburg,6142,5,7,6,11,32,39,-7,27
Vienna,6142,6,6,6,12,25,40,-15,24
SC Rheindorf,6142,7,5,7,12,19,31,-12,22
FC Salzburg,6143,1,14,7,3,42,18,24,49
SK Sturm Gra,6143,2,12,4,8,33,30,3,40
Rapid Vienna,6143,3,8,12,4,35,26,9,36
LASK Linz,6143,4,7,6,11,25,31,-6,27
Mattersburg,6143,5,7,6,11,30,40,-10,27
Vienna,6143,6,7,5,12,26,39,-13,26
SC Rheindorf,6143,7,6,6,12,23,30,-7,24
FC Salzburg,6144,1,15,6,3,45,19,26,51
SK Sturm Gra,6144,2,13,3,8,34,30,4,42
Rapid Vienna,6144,3,9,9,6,37,31,6,36
LASK Linz,6144,4,8,5,11,27,31,-4,29
Mattersburg,6144,5,7,6,11,33,42,-9,27
Vienna,6144,6,6,6,12,25,40,-15,24
SC Rheindorf,6144,7,6,5,13,20,28,-8,23
FC Salzburg,6145,1,15,7,2,47,20,27,52
SK Sturm Gra,6145,2,14,3,7,35,28,7,45
Rapid Vienna,6145,3,8,9,7,34,29,5,33
LASK Linz,6145,4,7,5,12,26,32,-6,26
SC Rheindorf,6145,5,7,5,12,21,29,-8,26
Vienna,6145,6,6,7,11,25,39,-14,25
Mattersburg,6145,7,6,6,12,31,42,-11,24
FC Salzburg,6146,1,15,6,3,48,21,27,51
SK Sturm Gra,6146,2,13,4,7,33,29,4,43
Rapid Vienna,6146,3,7,11,6,34,28,6,32
LASK Linz,6146,4,8,5,11,25,32,-7,29
Vienna,6146,5,8,5,11,29,40,-11,29
SC Rheindorf,6146,6,6,6,12,22,28,-6,24
Mattersburg,6146,7,6,5,13,30,43,-13,23
FC Salzburg,6147,1,15,7,2,51,20,31,52
SK Sturm Gra,6147,2,12,3,9,32,33,-1,39
Rapid Vienna,6147,3,8,10,6,36,32,4,34
LASK Linz,6147,4,9,5,10,30,30,0,32
Mattersburg,6147,5,7,6,11,35,42,-7,27
Vienna,6147,6,6,6,12,25,42,-17,24
SC Rheindorf,6147,7,5,7,12,21,31,-10,22
FC Salzburg,6148,1,15,7,2,45,18,27,52
SK Sturm Gra,6148,2,11,6,7,35,32,3,39
Rapid Vienna,6148,3,8,10,6,36,29,7,34
LASK Linz,6148,4,7,7,10,24,27,-3,28
SC Rheindorf,6148,5,7,6,11,23,29,-6,27
Mattersburg,6148,6,6,6,12,28,41,-13,24
Vienna,6148,7,6,6,12,25,40,-15,24
FC Salzburg,6149,1,13,7,4,39,17,22,46
SK Sturm Gra,6149,2,14,4,6,35,26,9,46
Rapid Vienna,6149,3,8,11,5,35,27,8,35
LASK Linz,6149,4,7,6,11,25,32,-7,27
Vienna,6149,5,7,6,11,24,37,-13,27
Mattersburg,6149,6,6,7,11,30,39,-9,25
SC Rheindorf,6149,7,5,7,12,19,29,-10,22
FC Salzburg,6150,1,15,6,3,45,18,27,51
SK Sturm Gra,6150,2,13,4,7,37,29,8,43
Rapid Vienna,6150,3,9,11,4,36,26,10,38
LASK Linz,6150,4,8,6,10,26,31,-5,30
Mattersburg,6150,5,7,5,12,31,42,-11,26
Vienna,6150,6,6,5,13,24,41,-17,23
SC Rheindorf,6150,7,5,5,14,18,30,-12,20
FC Salzburg,6151,1,14,7,3,42,19,23,49
SK Sturm Gra,6151,2,12,5,7,32,28,4,41
Rapid Vienna,6151,3,7,10,7,34,32,2,31
LASK Linz,6151,4,8,5,11,27,30,-3,29
Vienna,6151,5,8,5,11,32,38,-6,29
SC Rheindorf,6151,6,7,6,11,25,30,-5,27
Mattersburg,6151,7,6,6,12,32,47,-15,24
FC Salzburg,6152,1,13,8,3,47,21,26,47
SK Sturm Gra,6152,2,13,4,7,35,29,6,43
Rapid Vienna,6152,3,8,10,6,34,27,7,34
LASK Linz,6152,4,9,5,10,25,26,-1,32
SC Rheindorf,6152,5,7,5,12,21,29,-8,26
Vienna,6152,6,7,5,12,27,40,-13,26
Mattersburg,6152,7,6,5,13,28,45,-17,23
FC Salzburg,6153,1,15,7,2,46,17,29,52
Rapid Vienna,6153,2,10,9,5,37,29,8,39
SK Sturm Gra,6153,3,11,3,10,31,33,-2,36
LASK Linz,6153,4,8,6,10,27,27,0,30
SC Rheindorf,6153,5,7,5,12,22,28,-6,26
Mattersburg,6153,6,6,6,12,34,42,-8,24
Vienna,6153,7,6,6,12,25,46,-21,24
FC Salzburg,6154,1,14,7,3,47,21,26,49
SK Sturm Gra,6154,2,13,5,6,39,28,11,44
Rapid Vienna,6154,3,9,9,6,38,33,5,36
Mattersburg,6154,4,7,6,11,31,42,-11,27
LASK Linz,6154,5,7,5,12,26,33,-7,26
Vienna,6154,6,7,5,12,26,40,-14,26
SC Rheindorf,6154,7,5,7,12,18,28,-10,22
FC Salzburg,6155,1,13,7,4,46,23,23,46
SK Sturm Gra,6155,2,13,4,7,39,30,9,43
Rapid Vienna,6155,3,9,10,5,41,30,11,37
LASK Linz,6155,4,9,5,10,28,31,-3,32
Mattersburg,6155,5,7,6,11,34,46,-12,27
Vienna,6155,6,7,6,11,26,38,-12,27
SC Rheindorf,6155,7,4,6,14,21,37,-16,18
FC Salzburg,6156,1,15,6,3,46,19,27,51
SK Sturm Gra,6156,2,14,4,6,37,26,11,46
Rapid Vienna,6156,3,7,11,6,33,29,4,32
LASK Linz,6156,4,8,8,8,26,26,0,32
Vienna,6156,5,7,5,12,27,43,-16,26
SC Rheindorf,6156,6,5,6,13,17,29,-12,21
Mattersburg,6156,7,5,6,13,30,44,-14,21
FC Salzburg,6157,1,14,7,3,43,19,24,49
SK Sturm Gra,6157,2,11,6,7,32,30,2,39
Rapid Vienna,6157,3,9,10,5,40,29,11,37
Vienna,6157,4,8,5,11,29,37,-8,29
LASK Linz,6157,5,7,7,10,29,35,-6,28
SC Rheindorf,6157,6,6,6,12,21,29,-8,24
Mattersburg,6157,7,6,5,13,31,46,-15,23
FC Salzburg,6158,1,14,8,2,44,18,26,50
SK Sturm Gra,6158,2,13,4,7,32,26,6,43
Rapid Vienna,6158,3,8,10,6,36,29,7,34
LASK Linz,6158,4,8,6,10,26,28,-2,30
Mattersburg,6158,5,7,6,11,30,41,-11,27
Vienna,6158,6,6,5,13,24,41,-17,23
SC Rheindorf,6158,7,5,7,12,21,30,-9,22
FC Salzburg,6159,1,13,8,3,40,17,23,47
SK Sturm Gra,6159,2,11,6,7,30,28,2,39
Rapid Vienna,6159,3,9,10,5,36,24,12,37
Vienna,6159,4,8,5,11,26,38,-12,29
LASK Linz,6159,5,7,6,11,24,30,-6,27
Mattersburg,6159,6,6,7,11,29,39,-10,25
SC Rheindorf,6159,7,5,8,11,19,28,-9,23
FC Salzburg,6160,1,15,6,3,45,18,27,51
SK Sturm Gra,6160,2,11,5,8,35,34,1,38
Rapid Vienna,6160,3,8,10,6,33,29,4,34
LASK Linz,6160,4,9,5,10,28,27,1,32
Mattersburg,6160,5,8,5,11,30,38,-8,29
Vienna,6160,6,7,5,12,25,39,-14,26
SC Rheindorf,6160,7,5,6,13,19,30,-11,21
FC Salzburg,6161,1,15,7,2,44,17,27,52
SK Sturm Gra,6161,2,12,4,8,31,28,3,40
Rapid Vienna,6161,3,9,9,6,33,28,5,36
LASK Linz,6161,4,8,6,10,28,28,0,30
SC Rheindorf,6161,5,7,5,12,20,28,-8,26
Vienna,6161,6,7,5,12,27,40,-13,26
Mattersburg,6161,7,5,6,13,28,42,-14,21
FC Salzburg,6162,1,14,7,3,46,19,27,49
Rapid Vienna,6162,2,10,9,5,41,30,11,39
SK Sturm Gra,6162,3,11,4,9,29,28,1,37
LASK Linz,6162,4,10,5,9,30,29,1,35
Vienna,6162,5,8,5,11,27,38,-11,29
Mattersburg,6162,6,6,5,13,29,42,-13,23
SC Rheindorf,6162,7,5,5,14,18,34,-16,20
FC Salzburg,6163,1,14,6,4,45,22,23,48
SK Sturm Gra,6163,2,12,4,8,34,32,2,40
Rapid Vienna,6163,3,8,11,5,36,29,7,35
LASK Linz,6163,4,9,6,9,29,30,-1,33
Mattersburg,6163,5,7,5,12,34,42,-8,26
Vienna,6163,6,7,5,12,28,42,-14,26
SC Rheindorf,6163,7,5,7,12,18,27,-9,22
FC Salzburg,6164,1,15,6,3,45,20,25,51
Rapid Vienna,6164,2,10,9,5,37,26,11,39
SK Sturm Gra,6164,3,12,3,9,34,31,3,39
LASK Linz,6164,4,8,5,11,27,31,-4,29
Mattersburg,6164,5,7,5,12,33,43,-10,26
Vienna,6164,6,7,5,12,28,41,-13,26
SC Rheindorf,6164,7,6,5,13,19,31,-12,23
FC Salzburg,6165,1,14,7,3,45,20,25,49
SK Sturm Gra,6165,2,14,3,7,37,31,6,45
Rapid Vienna,6165,3,7,11,6,35,30,5,32
LASK Linz,6165,4,8,6,10,27,29,-2,30
Mattersburg,6165,5,6,7,11,31,43,-12,25
SC Rheindorf,6165,6,6,6,12,23,30,-7,24
Vienna,6165,7,6,6,12,26,41,-15,24
FC Salzburg,6166,1,14,8,2,44,18,26,50
SK Sturm Gra,6166,2,12,5,7,34,28,6,41
Rapid Vienna,6166,3,8,11,5,35,26,9,35
LASK Linz,6166,4,10,5,9,30,31,-1,35
Mattersburg,6166,5,7,5,12,33,44,-11,26
Vienna,6166,6,6,5,13,24,40,-16,23
SC Rheindorf,6166,7,5,5,14,19,32,-13,20
FC Salzburg,6167,1,14,6,4,46,18,28,48
SK Sturm Gra,6167,2,13,4,7,35,29,6,43
Rapid Vienna,6167,3,10,10,4,36,24,12,40
LASK Linz,6167,4,8,5,11,26,29,-3,29
Mattersburg,6167,5,6,6,12,29,44,-15,24
Vienna,6167,6,6,6,12,24,40,-16,24
SC Rheindorf,6167,7,6,5,13,18,30,-12,23
FC Salzburg,6168,1,15,6,3,44,19,25,51
SK Sturm Gra,6168,2,14,4,6,34,26,8,46
Rapid Vienna,6168,3,7,12,5,34,27,7,33
LASK Linz,6168,4,7,8,9,26,29,-3,29
Mattersburg,6168,5,6,7,11,34,44,-10,25
Vienna,6168,6,6,5,13,25,41,-16,23
SC Rheindorf,6168,7,4,8,12,19,30,-11,20
FC Salzburg,6169,1,13,8,3,46,19,27,47
SK Sturm Gra,6169,2,13,4,7,34,29,5,43
LASK Linz,6169,3,8,7,9,29,26,3,31
Rapid Vienna,6169,4,7,10,7,35,34,1,31
Mattersburg,6169,5,7,6,11,34,46,-12,27
Vienna,6169,6,6,7,11,27,41,-14,25
SC Rheindorf,6169,7,6,6,12,20,30,-10,24
FC Salzburg,6170,1,14,8,2,45,18,27,50
SK Sturm Gra,6170,2,13,3,8,35,33,2,42
Rapid Vienna,6170,3,7,10,7,34,30,4,31
LASK Linz,6170,4,8,6,10,30,32,-2,30
SC Rheindorf,6170,5,7,6,11,25,31,-6,27
Mattersburg,6170,6,7,5,12,32,40,-8,26
Vienna,6170,7,6,6,12,23,40,-17,24
FC Salzburg,6171,1,14,7,3,43,16,27,49
SK Sturm Gra,6171,2,13,3,8,32,28,4,42
Rapid Vienna,6171,3,9,9,6,35,32,3,36
LASK Linz,6171,4,9,6,9,31,28,3,33
Vienna,6171,5,7,6,11,26,37,-11,27
Mattersburg,6171,6,6,7,11,30,42,-12,25
SC Rheindorf,6171,7,4,6,14,21,35,-14,18
FC Salzburg,6172,1,14,8,2,44,17,27,50
SK Sturm Gra,6172,2,12,3,9,30,30,0,39
Rapid Vienna,6172,3,7,10,7,34,30,4,31
LASK Linz,6172,4,8,6,10,26,31,-5,30
Vienna,6172,5,7,6,11,32,38,-6,27
Mattersburg,6172,6,7,6,11,33,46,-13,27
SC Rheindorf,6172,7,7,5,12,22,29,-7,26
FC Salzburg,6173,1,15,7,2,45,17,28,52
SK Sturm Gra,6173,2,13,4,7,36,31,5,43
Rapid Vienna,6173,3,8,9,7,35,30,5,33
LASK Linz,6173,4,8,5,11,27,32,-5,29
Vienna,6173,5,7,5,12,24,38,-14,26
SC Rheindorf,6173,6,6,6,12,21,30,-9,24
Mattersburg,6173,7,6,6,12,29,39,-10,24
FC Salzburg,6174,1,15,7,2,48,16,32,52
SK Sturm Gra,6174,2,12,4,8,30,30,0,40
Rapid Vienna,6174,3,9,9,6,36,28,8,36
LASK Linz,6174,4,8,6,10,27,29,-2,30
SC Rheindorf,6174,5,7,5,12,23,27,-4,26
Vienna,6174,6,7,5,12,25,40,-15,26
Mattersburg,6174,7,5,6,13,30,49,-19,21
FC Salzburg,6175,1,14,7,3,45,18,27,49
SK Sturm Gra,6175,2,12,3,9,32,31,1,39
Rapid Vienna,6175,3,9,9,6,34,27,7,36
SC Rheindorf,6175,4,8,5,11,21,25,-4,29
LASK Linz,6175,5,8,5,11,25,30,-5,29
Vienna,6175,6,7,6,11,26,38,-12,27
Mattersburg,6175,7,6,5,13,30,44,-14,23
FC Salzburg,6176,1,15,6,3,47,18,29,51
SK Sturm Gra,6176,2,14,3,7,36,30,6,45
Rapid Vienna,6176,3,8,10,6,33,29,4,34
LASK Linz,6176,4,8,6,10,27,29,-2,30
Vienna,6176,5,7,5,12,25,39,-14,26
SC Rheindorf,6176,6,6,5,13,20,29,-9,23
Mattersburg,6176,7,6,5,13,27,41,-14,23
FC Salzburg,6177,1,13,9,2,43,19,24,48
SK Sturm Gra,6177,2,12,5,7,32,28,4,41
Rapid Vienna,6177,3,8,11,5,35,27,8,35
LASK Linz,6177,4,9,7,8,27,26,1,34
Mattersburg,6177,5,6,7,11,33,42,-9,25
Vienna,6177,6,6,7,11,26,40,-14,25
SC Rheindorf,6177,7,4,6,14,19,33,-14,18
FC Salzburg,6178,1,12,8,4,38,18,20,44
SK Sturm Gra,6178,2,11,6,7,30,27,3,39
Rapid Vienna,6178,3,9,11,4,35,24,11,38
LASK Linz,6178,4,8,6,10,25,30,-5,30
Mattersburg,6178,5,8,5,11,34,39,-5,29
Vienna,6178,6,7,6,11,25,38,-13,27
SC Rheindorf,6178,7,5,6,13,19,30,-11,21
FC Salzburg,6179,1,14,7,3,45,20,25,49
SK Sturm Gra,6179,2,14,3,7,33,27,6,45
Rapid Vienna,6179,3,9,9,6,38,28,10,36
LASK Linz,6179,4,10,5,9,30,28,2,35
Vienna,6179,5,7,6,11,28,41,-13,27
Mattersburg,6179,6,6,5,13,32,46,-14,23
SC Rheindorf,6179,7,4,5,15,16,32,-16,17
FC Salzburg,6180,1,13,9,2,45,17,28,48
SK Sturm Gra,6180,2,12,4,8,32,30,2,40
Rapid Vienna,6180,3,8,11,5,36,27,9,35
LASK Linz,6180,4,9,7,8,29,27,2,34
Vienna,6180,5,7,6,11,27,39,-12,27
Mattersburg,6180,6,6,6,12,30,46,-16,24
SC Rheindorf,6180,7,5,5,14,20,33,-13,20
FC Salzburg,6181,1,15,6,3,47,20,27,51
SK Sturm Gra,6181,2,13,3,8,34,30,4,42
Rapid Vienna,6181,3,8,9,7,35,30,5,33
LASK Linz,6181,4,8,7,9,29,32,-3,31
Vienna,6181,5,7,5,12,28,42,-14,26
Mattersburg,6181,6,6,7,11,32,42,-10,25
SC Rheindorf,6181,7,5,7,12,18,27,-9,22
FC Salzburg,6182,1,13,7,4,42,22,20,46
SK Sturm Gra,6182,2,14,3,7,38,29,9,45
Rapid Vienna,6182,3,9,9,6,41,31,10,36
LASK Linz,6182,4,10,5,9,31,30,1,35
Vienna,6182,5,7,5,12,28,40,-12,26
Mattersburg,6182,6,6,6,12,31,44,-13,24
SC Rheindorf,6182,7,5,5,14,19,34,-15,20
FC Salzburg,6183,1,15,6,3,46,18,28,51
SK Sturm Gra,6183,2,12,4,8,32,29,3,40
LASK Linz,6183,3,10,5,9,29,27,2,35
Rapid Vienna,6183,4,8,9,7,33,27,6,33
Vienna,6183,5,7,5,12,27,41,-14,26
SC Rheindorf,6183,6,6,6,12,22,30,-8,24
Mattersburg,6183,7,6,5,13,31,48,-17,23
FC Salzburg,6184,1,14,6,4,45,21,24,48
SK Sturm Gra,6184,2,12,4,8,33,29,4,40
Rapid Vienna,6184,3,10,9,5,34,25,9,39
LASK Linz,6184,4,7,6,11,25,30,-5,27
SC Rheindorf,6184,5,7,5,12,22,29,-7,26
Mattersburg,6184,6,7,5,12,28,40,-12,26
Vienna,6184,7,7,5,12,28,41,-13,26
FC Salzburg,6185,1,15,6,3,47,20,27,51
SK Sturm Gra,6185,2,13,3,8,32,29,3,42
Rapid Vienna,6185,3,8,10,6,33,26,7,34
LASK Linz,6185,4,9,6,9,28,26,2,33
Mattersburg,6185,5,7,6,11,32,41,-9,27
Vienna,6185,6,6,5,13,24,42,-18,23
SC Rheindorf,6185,7,5,6,13,19,31,-12,21
FC Salzburg,6186,1,15,6,3,44,19,25,51
SK Sturm Gra,6186,2,13,4,7,32,29,3,43
Rapid Vienna,6186,3,8,9,7,38,30,8,33
LASK Linz,6186,4,8,7,9,28,31,-3,31
Vienna,6186,5,7,5,12,28,39,-11,26
Mattersburg,6186,6,6,6,12,28,42,-14,24
SC Rheindorf,6186,7,6,5,13,20,28,-8,23
FC Salzburg,6187,1,14,7,3,47,22,25,49
SK Sturm Gra,6187,2,13,4,7,32,28,4,43
Rapid Vienna,6187,3,8,10,6,36,29,7,34
LASK Linz,6187,4,9,5,10,29,31,-2,32
Vienna,6187,5,6,7,11,27,41,-14,25
Mattersburg,6187,6,6,6,12,33,42,-9,24
SC Rheindorf,6187,7,6,5,13,20,31,-11,23
FC Salzburg,6188,1,13,9,2,40,16,24,48
SK Sturm Gra,6188,2,13,4,7,36,31,5,43
Rapid Vienna,6188,3,9,11,4,35,24,11,38
LASK Linz,6188,4,8,6,10,27,30,-3,30
Vienna,6188,5,7,6,11,26,37,-11,27
Mattersburg,6188,6,5,7,12,28,44,-16,22
SC Rheindorf,6188,7,5,5,14,23,33,-10,20
FC Salzburg,6189,1,14,7,3,45,19,26,49
Rapid Vienna,6189,2,9,10,5,35,25,10,37
SK Sturm Gra,6189,3,11,4,9,31,32,-1,37
LASK Linz,6189,4,8,7,9,27,27,0,31
Vienna,6189,5,8,5,11,28,38,-10,29
SC Rheindorf,6189,6,7,5,12,22,29,-7,26
Mattersburg,6189,7,5,6,13,28,46,-18,21
FC Salzburg,6190,1,14,6,4,46,22,24,48
SK Sturm Gra,6190,2,12,5,7,34,30,4,41
Rapid Vienna,6190,3,9,10,5,36,27,9,37
Mattersburg,6190,4,8,5,11,37,40,-3,29
LASK Linz,6190,5,7,7,10,25,31,-6,28
SC Rheindorf,6190,6,6,6,12,21,28,-7,24
Vienna,6190,7,6,5,13,24,45,-21,23
FC Salzburg,6191,1,15,7,2,45,17,28,52
SK Sturm Gra,6191,2,13,3,8,38,27,11,42
Rapid Vienna,6191,3,8,9,7,35,31,4,33
LASK Linz,6191,4,8,6,10,26,31,-5,30
Mattersburg,6191,5,7,6,11,30,40,-10,27
Vienna,6191,6,6,7,11,25,39,-14,25
SC Rheindorf,6191,7,5,6,13,17,31,-14,21
FC Salzburg,6192,1,14,7,3,41,17,24,49
Rapid Vienna,6192,2,10,10,4,35,24,11,40
SK Sturm Gra,6192,3,11,4,9,29,31,-2,37
LASK Linz,6192,4,9,6,9,31,30,1,33
Mattersburg,6192,5,7,5,12,34,42,-8,26
Vienna,6192,6,7,5,12,25,39,-14,26
SC Rheindorf,6192,7,5,5,14,22,34,-12,20
FC Salzburg,6193,1,15,7,2,44,17,27,52
SK Sturm Gra,6193,2,12,4,8,30,27,3,40
Rapid Vienna,6193,3,9,10,5,38,27,11,37
LASK Linz,6193,4,8,6,10,26,31,-5,30
Vienna,6193,5,7,5,12,26,41,-15,26
SC Rheindorf,6193,6,6,5,13,19,29,-10,23
Mattersburg,6193,7,6,5,13,31,42,-11,23
FC Salzburg,6194,1,14,7,3,46,19,27,49
SK Sturm Gra,6194,2,13,3,8,30,28,2,42
LASK Linz,6194,3,10,5,9,27,25,2,35
Rapid Vienna,6194,4,8,10,6,34,27,7,34
Vienna,6194,5,7,5,12,26,41,-15,26
SC Rheindorf,6194,6,5,7,12,18,29,-11,22
Mattersburg,6194,7,5,7,12,29,41,-12,22
FC Salzburg,6195,1,13,8,3,46,22,24,47
SK Sturm Gra,6195,2,12,4,8,35,32,3,40
Rapid Vienna,6195,3,7,13,4,36,28,8,34
LASK Linz,6195,4,8,7,9,25,28,-3,31
Mattersburg,6195,5,7,6,11,33,39,-6,27
Vienna,6195,6,7,6,11,27,40,-13,27
SC Rheindorf,6195,7,5,6,13,18,31,-13,21
FC Salzburg,6196,1,14,6,4,44,18,26,48
SK Sturm Gra,6196,2,12,4,8,30,27,3,40
Rapid Vienna,6196,3,9,10,5,35,26,9,37
LASK Linz,6196,4,7,8,9,26,29,-3,29
Vienna,6196,5,7,5,12,26,40,-14,26
Mattersburg,6196,6,6,7,11,30,41,-11,25
SC Rheindorf,6196,7,6,6,12,20,30,-10,24
FC Salzburg,6197,1,14,7,3,49,21,28,49
SK Sturm Gra,6197,2,12,4,8,30,32,-2,40
Rapid Vienna,6197,3,9,9,6,37,28,9,36
LASK Linz,6197,4,8,6,10,24,26,-2,30
Mattersburg,6197,5,7,6,11,31,39,-8,27
Vienna,6197,6,6,7,11,25,39,-14,25
SC Rheindorf,6197,7,5,7,12,17,28,-11,22
FC Salzburg,6198,1,15,6,3,45,19,26,51
SK Sturm Gra,6198,2,12,5,7,31,27,4,41
Rapid Vienna,6198,3,10,10,4,38,25,13,40
LASK Linz,6198,4,7,6,11,26,31,-5,27
Mattersburg,6198,5,6,7,11,32,42,-10,25
Vienna,6198,6,6,5,13,24,41,-17,23
SC Rheindorf,6198,7,5,7,12,18,29,-11,22
FC Salzburg,6199,1,15,6,3,49,22,27,51
Rapid Vienna,6199,2,10,10,4,41,25,16,40
SK Sturm Gra,6199,3,12,3,9,31,35,-4,39
LASK Linz,6199,4,7,6,11,26,31,-5,27
Vienna,6199,5,7,5,12,26,40,-14,26
SC Rheindorf,6199,6,6,6,12,18,27,-9,24
Mattersburg,6199,7,6,6,12,31,42,-11,24
FC Salzburg,6200,1,14,6,4,43,20,23,48
SK Sturm Gra,6200,2,12,4,8,34,30,4,40
Rapid Vienna,6200,3,10,9,5,38,26,12,39
LASK Linz,6200,4,8,6,10,25,28,-3,30
Mattersburg,6200,5,8,5,11,30,38,-8,29
Vienna,6200,6,7,5,12,26,40,-14,26
SC Rheindorf,6200,7,5,5,14,18,32,-14,20
FC Salzburg,6201,1,14,7,3,45,21,24,49
SK Sturm Gra,6201,2,12,3,9,31,29,2,39
Rapid Vienna,6201,3,8,10,6,36,28,8,34
Mattersburg,6201,4,8,5,11,34,39,-5,29
LASK Linz,6201,5,8,5,11,24,29,-5,29
SC Rheindorf,6201,6,7,5,12,20,28,-8,26
Vienna,6201,7,7,5,12,25,41,-16,26
FC Salzburg,6202,1,16,6,2,51,17,34,54
SK Sturm Gra,6202,2,12,4,8,34,34,0,40
Rapid Vienna,6202,3,7,11,6,34,31,3,32
LASK Linz,6202,4,8,8,8,29,29,0,32
Vienna,6202,5,6,6,12,26,41,-15,24
Mattersburg,6202,6,5,8,11,31,43,-12,23
SC Rheindorf,6202,7,5,7,12,22,32,-10,22
FC Salzburg,6203,1,14,6,4,43,19,24,48
SK Sturm Gra,6203,2,12,5,7,36,31,5,41
Rapid Vienna,6203,3,9,10,5,36,26,10,37
LASK Linz,6203,4,8,8,8,29,29,0,32
Mattersburg,6203,5,6,6,12,28,41,-13,24
SC Rheindorf,6203,6,5,8,11,19,27,-8,23
Vienna,6203,7,6,5,13,23,41,-18,23
FC Salzburg,6204,1,14,6,4,46,21,25,48
Rapid Vienna,6204,2,11,9,4,41,26,15,42
SK Sturm Gra,6204,3,12,4,8,29,27,2,40
Vienna,6204,4,8,5,11,28,38,-10,29
LASK Linz,6204,5,7,5,12,23,30,-7,26
Mattersburg,6204,6,6,6,12,30,46,-16,24
SC Rheindorf,6204,7,5,7,12,22,31,-9,22
FC Salzburg,6205,1,14,7,3,44,18,26,49
SK Sturm Gra,6205,2,12,3,9,30,30,0,39
Rapid Vienna,6205,3,9,9,6,35,26,9,36
LASK Linz,6205,4,8,6,10,26,29,-3,30
SC Rheindorf,6205,5,8,5,11,21,25,-4,29
Vienna,6205,6,7,5,12,27,42,-15,26
Mattersburg,6205,7,5,7,12,29,42,-13,22
FC Salzburg,6206,1,14,7,3,43,16,27,49
SK Sturm Gra,6206,2,14,3,7,36,29,7,45
Rapid Vienna,6206,3,9,9,6,37,28,9,36
LASK Linz,6206,4,8,5,11,25,32,-7,29
Vienna,6206,5,7,6,11,25,38,-13,27
SC Rheindorf,6206,6,6,5,13,24,34,-10,23
Mattersburg,6206,7,6,5,13,33,46,-13,23
FC Salzburg,6207,1,14,8,2,45,19,26,50
SK Sturm Gra,6207,2,12,4,8,31,29,2,40
Rapid Vienna,6207,3,8,10,6,34,27,7,34
LASK Linz,6207,4,9,5,10,32,33,-1,32
Mattersburg,6207,5,6,7,11,32,41,-9,25
Vienna,6207,6,6,7,11,25,39,-14,25
SC Rheindorf,6207,7,6,5,13,22,33,-11,23
FC Salzburg,6208,1,14,7,3,44,18,26,49
SK Sturm Gra,6208,2,13,5,6,32,24,8,44
Rapid Vienna,6208,3,7,10,7,32,29,3,31
LASK Linz,6208,4,8,7,9,27,29,-2,31
Vienna,6208,5,7,5,12,26,42,-16,26
SC Rheindorf,6208,6,6,6,12,20,29,-9,24
Mattersburg,6208,7,6,6,12,32,42,-10,24
FC Salzburg,6209,1,14,6,4,44,18,26,48
SK Sturm Gra,6209,2,14,3,7,32,27,5,45
Rapid Vienna,6209,3,8,10,6,33,26,7,34
LASK Linz,6209,4,9,5,10,28,29,-1,32
Mattersburg,6209,5,8,5,11,36,44,-8,29
Vienna,6209,6,7,5,12,25,40,-15,26
SC Rheindorf,6209,7,4,6,14,17,31,-14,18
FC Salzburg,6210,1,13,8,3,42,18,24,47
SK Sturm Gra,6210,2,14,4,6,35,27,8,46
Rapid Vienna,6210,3,8,11,5,35,27,8,35
LASK Linz,6210,4,9,6,9,28,27,1,33
Vienna,6210,5,7,6,11,28,41,-13,27
Mattersburg,6210,6,5,6,13,29,43,-14,21
SC Rheindorf,6210,7,4,7,13,16,30,-14,19
FC Salzburg,6211,1,16,6,2,51,17,34,54
SK Sturm Gra,6211,2,13,4,7,38,28,10,43
LASK Linz,6211,3,9,7,8,28,27,1,34
Rapid Vienna,6211,4,8,9,7,36,38,-2,33
Vienna,6211,5,7,5,12,27,42,-15,26
SC Rheindorf,6211,6,5,6,13,17,28,-11,21
Mattersburg,6211,7,5,5,14,29,46,-17,20
FC Salzburg,6212,1,13,8,3,41,17,24,47
Rapid Vienna,6212,2,11,9,4,36,24,12,42
SK Sturm Gra,6212,3,12,4,8,33,28,5,40
LASK Linz,6212,4,8,5,11,25,33,-8,29
Vienna,6212,5,7,5,12,27,39,-12,26
Mattersburg,6212,6,6,6,12,30,43,-13,24
SC Rheindorf,6212,7,6,5,13,20,28,-8,23
FC Salzburg,6213,1,15,6,3,48,20,28,51
SK Sturm Gra,6213,2,12,6,6,33,27,6,42
Rapid Vienna,6213,3,7,11,6,32,27,5,32
LASK Linz,6213,4,7,7,10,26,31,-5,28
SC Rheindorf,6213,5,7,6,11,22,28,-6,27
Mattersburg,6213,6,7,5,12,31,42,-11,26
Vienna,6213,7,6,5,13,24,41,-17,23
FC Salzburg,6214,1,14,6,4,42,20,22,48
SK Sturm Gra,6214,2,13,4,7,33,28,5,43
Rapid Vienna,6214,3,10,9,5,39,29,10,39
LASK Linz,6214,4,8,7,9,28,29,-1,31
Vienna,6214,5,7,6,11,27,39,-12,27
Mattersburg,6214,6,6,7,11,33,42,-9,25
SC Rheindorf,6214,7,4,5,15,16,31,-15,17
FC Salzburg,6215,1,15,6,3,46,21,25,51
SK Sturm Gra,6215,2,13,3,8,34,27,7,42
Rapid Vienna,6215,3,9,9,6,37,28,9,36
LASK Linz,6215,4,8,5,11,25,29,-4,29
Mattersburg,6215,5,8,5,11,35,43,-8,29
SC Rheindorf,6215,6,6,5,13,20,31,-11,23
Vienna,6215,7,6,5,13,24,42,-18,23
FC Salzburg,6216,1,15,6,3,49,17,32,51
SK Sturm Gra,6216,2,13,4,7,33,26,7,43
LASK Linz,6216,3,9,6,9,30,29,1,33
Rapid Vienna,6216,4,7,11,6,32,28,4,32
SC Rheindorf,6216,5,7,5,12,19,29,-10,26
Vienna,6216,6,7,5,12,26,42,-16,26
Mattersburg,6216,7,5,5,14,30,48,-18,20
FC Salzburg,6217,1,15,7,2,48,17,31,52
SK Sturm Gra,6217,2,11,5,8,32,34,-2,38
Rapid Vienna,6217,3,8,12,4,38,28,10,36
LASK Linz,6217,4,8,7,9,29,29,0,31
SC Rheindorf,6217,5,6,7,11,22,28,-6,25
Mattersburg,6217,6,6,5,13,28,43,-15,23
Vienna,6217,7,6,5,13,23,41,-18,23
FC Salzburg,6218,1,14,8,2,43,17,26,50
SK Sturm Gra,6218,2,13,5,6,31,25,6,44
Rapid Vienna,6218,3,7,12,5,35,28,7,33
LASK Linz,6218,4,7,6,11,27,31,-4,27
Mattersburg,6218,5,7,6,11,31,41,-10,27
Vienna,6218,6,6,6,12,25,40,-15,24
SC Rheindorf,6218,7,6,5,13,19,29,-10,23
FC Salzburg,6219,1,15,7,2,49,17,32,52
Rapid Vienna,6219,2,9,11,4,36,25,11,38
SK Sturm Gra,6219,3,11,4,9,30,30,0,37
LASK Linz,6219,4,8,6,10,30,33,-3,30
SC Rheindorf,6219,5,6,6,12,19,28,-9,24
Mattersburg,6219,6,6,6,12,33,46,-13,24
Vienna,6219,7,6,6,12,24,42,-18,24
FC Salzburg,6220,1,14,7,3,45,19,26,49
SK Sturm Gra,6220,2,13,4,7,32,28,4,43
Rapid Vienna,6220,3,9,9,6,37,34,3,36
LASK Linz,6220,4,9,5,10,32,27,5,32
Vienna,6220,5,7,6,11,26,38,-12,27
Mattersburg,6220,6,6,5,13,31,44,-13,23
SC Rheindorf,6220,7,5,6,13,18,31,-13,21
FC Salzburg,6221,1,16,6,2,49,19,30,54
SK Sturm Gra,6221,2,12,4,8,32,29,3,40
LASK Linz,6221,3,10,5,9,29,29,0,35
Rapid Vienna,6221,4,8,9,7,34,28,6,33
SC Rheindorf,6221,5,6,6,12,19,27,-8,24
Mattersburg,6221,6,6,5,13,31,43,-12,23
Vienna,6221,7,6,5,13,23,42,-19,23
FC Salzburg,6222,1,15,7,2,48,17,31,52
SK Sturm Gra,6222,2,11,5,8,33,35,-2,38
Rapid Vienna,6222,3,8,10,6,37,31,6,34
LASK Linz,6222,4,9,6,9,32,31,1,33
Mattersburg,6222,5,6,7,11,29,40,-11,25
Vienna,6222,6,6,6,12,26,41,-15,24
SC Rheindorf,6222,7,5,7,12,21,31,-10,22
FC Salzburg,6223,1,16,6,2,49,16,33,54
SK Sturm Gra,6223,2,11,5,8,29,30,-1,38
Rapid Vienna,6223,3,9,10,5,37,27,10,37
LASK Linz,6223,4,8,6,10,27,30,-3,30
Mattersburg,6223,5,6,6,12,30,41,-11,24
Vienna,6223,6,6,6,12,23,40,-17,24
SC Rheindorf,6223,7,6,5,13,18,29,-11,23
FC Salzburg,6224,1,16,6,2,47,20,27,54
SK Sturm Gra,6224,2,12,3,9,31,32,-1,39
LASK Linz,6224,3,10,5,9,29,28,1,35
Rapid Vienna,6224,4,8,9,7,35,27,8,33
Mattersburg,6224,5,7,6,11,37,43,-6,27
Vienna,6224,6,6,5,13,25,44,-19,23
SC Rheindorf,6224,7,5,6,13,22,32,-10,21
FC Salzburg,6225,1,14,7,3,45,20,25,49
SK Sturm Gra,6225,2,12,4,8,35,32,3,40
Rapid Vienna,6225,3,10,9,5,39,29,10,39
LASK Linz,6225,4,8,5,11,28,30,-2,29
SC Rheindorf,6225,5,7,5,12,20,29,-9,26
Mattersburg,6225,6,6,6,12,29,41,-12,24
Vienna,6225,7,6,6,12,23,38,-15,24
FC Salzburg,6226,1,14,7,3,44,20,24,49
Rapid Vienna,6226,2,9,11,4,38,25,13,38
SK Sturm Gra,6226,3,11,5,8,33,34,-1,38
LASK Linz,6226,4,7,7,10,24,27,-3,28
Vienna,6226,5,7,6,11,27,39,-12,27
SC Rheindorf,6226,6,6,7,11,21,28,-7,25
Mattersburg,6226,7,5,7,12,30,44,-14,22
FC Salzburg,6227,1,15,7,2,47,19,28,52
SK Sturm Gra,6227,2,14,3,7,33,28,5,45
Rapid Vienna,6227,3,7,10,7,35,30,5,31
LASK Linz,6227,4,8,7,9,30,31,-1,31
Vienna,6227,5,7,5,12,26,40,-14,26
SC Rheindorf,6227,6,5,7,12,21,31,-10,22
Mattersburg,6227,7,5,7,12,32,45,-13,22
FC Salzburg,6228,1,15,7,2,47,17,30,52
SK Sturm Gra,6228,2,12,5,7,33,31,2,41
Rapid Vienna,6228,3,8,9,7,33,29,4,33
LASK Linz,6228,4,8,6,10,27,33,-6,30
Vienna,6228,5,7,6,11,27,40,-13,27
SC Rheindorf,6228,6,6,6,12,22,27,-5,24
Mattersburg,6228,7,6,5,13,31,43,-12,23
FC Salzburg,6229,1,15,6,3,45,18,27,51
SK Sturm Gra,6229,2,14,3,7,38,29,9,45
Rapid Vienna,6229,3,9,9,6,37,29,8,36
LASK Linz,6229,4,9,5,10,32,34,-2,32
Mattersburg,6229,5,7,6,11,33,43,-10,27
Vienna,6229,6,6,6,12,24,39,-15,24
SC Rheindorf,6229,7,4,5,15,17,34,-17,17
FC Salzburg,6230,1,13,7,4,43,21,22,46
SK Sturm Gra,6230,2,13,4,7,34,29,5,43
Rapid Vienna,6230,3,8,10,6,33,27,6,34
LASK Linz,6230,4,8,5,11,27,32,-5,29
Mattersburg,6230,5,7,7,10,35,39,-4,28
Vienna,6230,6,7,5,12,24,39,-15,26
SC Rheindorf,6230,7,5,8,11,20,29,-9,23
FC Salzburg,6231,1,12,10,2,46,23,23,46
SK Sturm Gra,6231,2,11,5,8,31,30,1,38
Rapid Vienna,6231,3,8,12,4,36,27,9,36
LASK Linz,6231,4,9,7,8,27,25,2,34
Mattersburg,6231,5,6,7,11,32,42,-10,25
Vienna,6231,6,6,7,11,27,41,-14,25
SC Rheindorf,6231,7,5,6,13,18,29,-11,21
FC Salzburg,6232,1,14,8,2,50,18,32,50
SK Sturm Gra,6232,2,11,5,8,34,33,1,38
Rapid Vienna,6232,3,7,11,6,36,31,5,32
LASK Linz,6232,4,9,5,10,26,28,-2,32
Vienna,6232,5,7,6,11,28,38,-10,27
Mattersburg,6232,6,7,5,12,30,48,-18,26
SC Rheindorf,6232,7,6,6,12,24,32,-8,24
FC Salzburg,6233,1,15,7,2,45,17,28,52
SK Sturm Gra,6233,2,13,4,7,33,29,4,43
Rapid Vienna,6233,3,9,9,6,36,27,9,36
LASK Linz,6233,4,7,7,10,27,31,-4,28
Mattersburg,6233,5,6,7,11,33,41,-8,25
Vienna,6233,6,6,7,11,26,40,-14,25
SC Rheindorf,6233,7,4,7,13,18,33,-15,19
FC Salzburg,6234,1,13,8,3,42,19,23,47
SK Sturm Gra,6234,2,13,5,6,36,29,7,44
LASK Linz,6234,3,10,6,8,32,27,5,36
Rapid Vienna,6234,4,8,10,6,37,28,9,34
Mattersburg,6234,5,7,5,12,34,43,-9,26
Vienna,6234,6,6,5,13,23,41,-18,23
SC Rheindorf,6234,7,5,5,14,19,36,-17,20
FC Salzburg,6235,1,14,8,2,44,17,27,50
SK Sturm Gra,6235,2,12,4,8,33,29,4,40
LASK Linz,6235,3,10,6,8,29,25,4,36
Rapid Vienna,6235,4,8,9,7,33,30,3,33
Vienna,6235,5,7,6,11,31,38,-7,27
SC Rheindorf,6235,6,6,6,12,17,27,-10,24
Mattersburg,6235,7,5,5,14,26,47,-21,20
FC Salzburg,6236,1,16,6,2,47,19,28,54
SK Sturm Gra,6236,2,13,3,8,35,29,6,42
Rapid Vienna,6236,3,9,9,6,36,28,8,36
LASK Linz,6236,4,10,5,9,32,30,2,35
Mattersburg,6236,5,6,6,12,33,47,-14,24
Vienna,6236,6,6,6,12,26,41,-15,24
SC Rheindorf,6236,7,4,5,15,21,36,-15,17
FC Salzburg,6237,1,15,6,3,45,18,27,51
SK Sturm Gra,6237,2,12,4,8,31,29,2,40
Rapid Vienna,6237,3,8,10,6,32,25,7,34
LASK Linz,6237,4,9,6,9,26,26,0,33
Mattersburg,6237,5,7,6,11,29,39,-10,27
Vienna,6237,6,7,5,12,26,40,-14,26
SC Rheindorf,6237,7,4,7,13,16,28,-12,19
FC Salzburg,6238,1,15,7,2,52,23,29,52
SK Sturm Gra,6238,2,12,5,7,35,31,4,41
Rapid Vienna,6238,3,7,12,5,38,31,7,33
LASK Linz,6238,4,8,5,11,28,32,-4,29
Vienna,6238,5,7,5,12,26,41,-15,26
Mattersburg,6238,6,6,6,12,33,46,-13,24
SC Rheindorf,6238,7,5,8,11,22,30,-8,23
FC Salzburg,6239,1,12,7,5,42,23,19,43
SK Sturm Gra,6239,2,12,4,8,35,32,3,40
Rapid Vienna,6239,3,9,10,5,35,26,9,37
LASK Linz,6239,4,8,6,10,25,28,-3,30
Mattersburg,6239,5,8,5,11,33,40,-7,29
SC Rheindorf,6239,6,7,5,12,23,29,-6,26
Vienna,6239,7,7,5,12,24,39,-15,26
FC Salzburg,6240,1,15,6,3,51,21,30,51
SK Sturm Gra,6240,2,12,5,7,33,26,7,41
Rapid Vienna,6240,3,8,9,7,36,34,2,33
LASK Linz,6240,4,8,7,9,25,26,-1,31
SC Rheindorf,6240,5,6,7,11,19,27,-8,25
Vienna,6240,6,6,6,12,26,44,-18,24
Mattersburg,6240,7,5,8,11,31,43,-12,23
FC Salzburg,6241,1,15,6,3,45,20,25,51
SK Sturm Gra,6241,2,13,4,7,33,28,5,43
LASK Linz,6241,3,9,6,9,27,26,1,33
Rapid Vienna,6241,4,7,10,7,32,27,5,31
Vienna,6241,5,8,5,11,27,39,-12,29
Mattersburg,6241,6,6,6,12,30,40,-10,24
SC Rheindorf,6241,7,4,7,13,17,31,-14,19
SK Sturm Gra,6242,1,14,3,7,32,26,6,45
FC Salzburg,6242,2,12,7,5,39,19,20,43
Rapid Vienna,6242,3,9,9,6,36,28,8,36
LASK Linz,6242,4,8,7,9,27,27,0,31
Mattersburg,6242,5,7,7,10,31,39,-8,28
Vienna,6242,6,7,5,12,25,39,-14,26
SC Rheindorf,6242,7,5,6,13,20,32,-12,21
FC Salzburg,6243,1,13,9,2,44,18,26,48
SK Sturm Gra,6243,2,13,5,6,35,27,8,44
Rapid Vienna,6243,3,7,11,6,33,29,4,32
LASK Linz,6243,4,8,6,10,26,29,-3,30
Mattersburg,6243,5,7,7,10,33,39,-6,28
Vienna,6243,6,6,6,12,25,42,-17,24
SC Rheindorf,6243,7,5,6,13,18,30,-12,21
FC Salzburg,6244,1,14,7,3,47,20,27,49
SK Sturm Gra,6244,2,13,4,7,35,32,3,43
Rapid Vienna,6244,3,8,9,7,34,29,5,33
LASK Linz,6244,4,9,5,10,26,27,-1,32
Vienna,6244,5,7,6,11,27,40,-13,27
SC Rheindorf,6244,6,6,6,12,21,30,-9,24
Mattersburg,6244,7,6,5,13,31,43,-12,23
FC Salzburg,6245,1,13,8,3,43,20,23,47
SK Sturm Gra,6245,2,13,3,8,34,30,4,42
Rapid Vienna,6245,3,10,9,5,36,24,12,39
LASK Linz,6245,4,9,5,10,30,28,2,32
Vienna,6245,5,6,7,11,25,39,-14,25
SC Rheindorf,6245,6,6,5,13,20,29,-9,23
Mattersburg,6245,7,5,7,12,30,48,-18,22
FC Salzburg,6246,1,13,8,3,44,18,26,47
SK Sturm Gra,6246,2,11,5,8,31,29,2,38
Rapid Vienna,6246,3,9,10,5,35,26,9,37
LASK Linz,6246,4,9,6,9,28,27,1,33
Mattersburg,6246,5,7,5,12,34,42,-8,26
Vienna,6246,6,7,5,12,25,40,-15,26
SC Rheindorf,6246,7,6,5,13,17,32,-15,23
FC Salzburg,6247,1,15,6,3,45,19,26,51
SK Sturm Gra,6247,2,12,5,7,36,30,6,41
Rapid Vienna,6247,3,8,11,5,36,28,8,35
LASK Linz,6247,4,8,7,9,28,29,-1,31
Mattersburg,6247,5,6,6,12,30,41,-11,24
SC Rheindorf,6247,6,6,6,12,22,33,-11,24
Vienna,6247,7,6,5,13,24,41,-17,23
FC Salzburg,6248,1,13,7,4,48,22,26,46
SK Sturm Gra,6248,2,12,4,8,30,29,1,40
Rapid Vienna,6248,3,10,9,5,39,27,12,39
LASK Linz,6248,4,9,6,9,26,26,0,33
Vienna,6248,5,7,5,12,24,42,-18,26
SC Rheindorf,6248,6,6,6,12,23,30,-7,24
Mattersburg,6248,7,5,7,12,30,44,-14,22
FC Salzburg,6249,1,15,7,2,52,17,35,52
SK Sturm Gra,6249,2,13,4,7,33,32,1,43
Rapid Vienna,6249,3,8,10,6,36,32,4,34
LASK Linz,6249,4,7,7,10,28,31,-3,28
Vienna,6249,5,6,7,11,26,40,-14,25
Mattersburg,6249,6,5,8,11,29,42,-13,23
SC Rheindorf,6249,7,4,9,11,19,29,-10,21
FC Salzburg,6250,1,14,8,2,42,16,26,50
SK Sturm Gra,6250,2,12,4,8,33,29,4,40
Rapid Vienna,6250,3,8,12,4,35,25,10,36
LASK Linz,6250,4,8,5,11,26,33,-7,29
Vienna,6250,5,7,5,12,25,38,-13,26
SC Rheindorf,6250,6,6,6,12,19,27,-8,24
Mattersburg,6250,7,6,6,12,29,41,-12,24
FC Salzburg,6251,1,14,7,3,44,18,26,49
SK Sturm Gra,6251,2,15,3,6,36,25,11,48
Rapid Vienna,6251,3,7,9,8,32,30,2,30
LASK Linz,6251,4,8,6,10,25,30,-5,30
SC Rheindorf,6251,5,7,5,12,22,28,-6,26
Vienna,6251,6,7,5,12,27,41,-14,26
Mattersburg,6251,7,5,7,12,29,43,-14,22
FC Salzburg,6252,1,14,7,3,43,19,24,49
SK Sturm Gra,6252,2,13,3,8,33,30,3,42
Rapid Vienna,6252,3,9,9,6,36,29,7,36
LASK Linz,6252,4,8,6,10,25,26,-1,30
SC Rheindorf,6252,5,7,5,12,20,27,-7,26
Vienna,6252,6,7,5,12,26,39,-13,26
Mattersburg,6252,7,5,7,12,27,40,-13,22
FC Salzburg,6253,1,15,7,2,45,19,26,52
SK Sturm Gra,6253,2,14,3,7,37,28,9,45
Rapid Vienna,6253,3,7,10,7,36,34,2,31
LASK Linz,6253,4,8,7,9,30,30,0,31
Mattersburg,6253,5,7,6,11,34,41,-7,27
Vienna,6253,6,6,5,13,24,40,-16,23
SC Rheindorf,6253,7,5,6,13,16,30,-14,21
FC Salzburg,6254,1,14,6,4,43,19,24,48
SK Sturm Gra,6254,2,12,4,8,32,31,1,40
LASK Linz,6254,3,9,6,9,27,28,-1,33
Rapid Vienna,6254,4,7,10,7,35,31,4,31
Vienna,6254,5,8,5,11,28,39,-11,29
Mattersburg,6254,6,7,5,12,33,43,-10,26
SC Rheindorf,6254,7,6,6,12,24,31,-7,24
FC Salzburg,6255,1,14,6,4,44,22,22,48
Rapid Vienna,6255,2,9,10,5,39,30,9,37
LASK Linz,6255,3,10,6,8,29,25,4,36
SK Sturm Gra,6255,4,11,3,10,35,35,0,36
Vienna,6255,5,8,5,11,30,41,-11,29
SC Rheindorf,6255,6,6,6,12,22,31,-9,24
Mattersburg,6255,7,5,6,13,31,46,-15,21
FC Salzburg,6256,1,14,8,2,46,18,28,50
SK Sturm Gra,6256,2,12,4,8,34,32,2,40
Rapid Vienna,6256,3,8,10,6,35,29,6,34
LASK Linz,6256,4,8,5,11,28,33,-5,29
Mattersburg,6256,5,7,6,11,33,41,-8,27
Vienna,6256,6,6,7,11,26,40,-14,25
SC Rheindorf,6256,7,6,6,12,20,29,-9,24
FC Salzburg,6257,1,14,7,3,42,18,24,49
SK Sturm Gra,6257,2,13,4,7,36,30,6,43
Rapid Vienna,6257,3,8,11,5,35,27,8,35
LASK Linz,6257,4,8,7,9,28,27,1,31
Vienna,6257,5,7,5,12,24,38,-14,26
Mattersburg,6257,6,6,6,12,28,41,-13,24
SC Rheindorf,6257,7,5,6,13,19,31,-12,21
FC Salzburg,6258,1,14,7,3,44,19,25,49
SK Sturm Gra,6258,2,13,3,8,34,30,4,42
Rapid Vienna,6258,3,8,10,6,33,29,4,34
LASK Linz,6258,4,9,6,9,31,29,2,33
Vienna,6258,5,6,7,11,24,38,-14,25
Mattersburg,6258,6,6,6,12,29,40,-11,24
SC Rheindorf,6258,7,5,7,12,16,26,-10,22
FC Salzburg,6259,1,12,10,2,40,17,23,46
SK Sturm Gra,6259,2,12,4,8,34,30,4,40
Rapid Vienna,6259,3,8,12,4,34,25,9,36
LASK Linz,6259,4,8,7,9,27,27,0,31
Mattersburg,6259,5,6,8,10,30,39,-9,26
Vienna,6259,6,6,6,12,24,39,-15,24
SC Rheindorf,6259,7,5,7,12,19,31,-12,22
FC Salzburg,6260,1,15,7,2,51,18,33,52
SK Sturm Gra,6260,2,11,4,9,29,32,-3,37
Rapid Vienna,6260,3,9,9,6,38,29,9,36
LASK Linz,6260,4,9,6,9,28,26,2,33
Mattersburg,6260,5,7,6,11,31,41,-10,27
Vienna,6260,6,7,5,12,26,41,-15,26
SC Rheindorf,6260,7,5,5,14,17,33,-16,20
FC Salzburg,6261,1,13,8,3,43,20,23,47
SK Sturm Gra,6261,2,11,6,7,31,28,3,39
Rapid Vienna,6261,3,7,12,5,35,28,7,33
LASK Linz,6261,4,8,8,8,28,28,0,32
Mattersburg,6261,5,7,6,11,31,40,-9,27
Vienna,6261,6,7,5,12,24,38,-14,26
SC Rheindorf,6261,7,5,7,12,18,28,-10,22
FC Salzburg,6262,1,12,7,5,39,20,19,43
SK Sturm Gra,6262,2,12,5,7,31,28,3,41
Rapid Vienna,6262,3,8,11,5,36,30,6,35
LASK Linz,6262,4,8,8,8,29,27,2,32
Mattersburg,6262,5,7,6,11,32,39,-7,27
Vienna,6262,6,7,6,11,25,38,-13,27
SC Rheindorf,6262,7,5,7,12,22,32,-10,22
FC Salzburg,6263,1,15,7,2,47,19,28,52
SK Sturm Gra,6263,2,12,3,9,34,33,1,39
Rapid Vienna,6263,3,9,11,4,37,25,12,38
LASK Linz,6263,4,9,5,10,27,28,-1,32
Mattersburg,6263,5,6,6,12,31,42,-11,24
Vienna,6263,6,6,6,12,25,40,-15,24
SC Rheindorf,6263,7,5,6,13,16,30,-14,21
FC Salzburg,6264,1,14,7,3,46,20,26,49
SK Sturm Gra,6264,2,14,3,7,32,26,6,45
LASK Linz,6264,3,10,5,9,30,28,2,35
Rapid Vienna,6264,4,8,10,6,35,29,6,34
Vienna,6264,5,7,5,12,29,42,-13,26
Mattersburg,6264,6,6,5,13,32,47,-15,23
SC Rheindorf,6264,7,5,5,14,18,30,-12,20
SK Sturm Gra,6265,1,15,3,6,37,26,11,48
FC Salzburg,6265,2,12,7,5,41,21,20,43
Rapid Vienna,6265,3,9,9,6,35,27,8,36
LASK Linz,6265,4,8,6,10,28,30,-2,30
Mattersburg,6265,5,7,7,10,32,40,-8,28
Vienna,6265,6,7,5,12,25,39,-14,26
SC Rheindorf,6265,7,5,5,14,17,32,-15,20
FC Salzburg,6266,1,16,6,2,48,16,32,54
SK Sturm Gra,6266,2,12,3,9,33,34,-1,39
Rapid Vienna,6266,3,9,10,5,37,26,11,37
LASK Linz,6266,4,8,6,10,27,30,-3,30
Vienna,6266,5,7,5,12,27,40,-13,26
Mattersburg,6266,6,6,6,12,31,45,-14,24
SC Rheindorf,6266,7,5,6,13,21,33,-12,21
FC Salzburg,6267,1,16,6,2,49,16,33,54
SK Sturm Gra,6267,2,12,4,8,33,36,-3,40
LASK Linz,6267,3,9,6,9,27,27,0,33
Rapid Vienna,6267,4,7,11,6,32,27,5,32
SC Rheindorf,6267,5,6,7,11,24,30,-6,25
Mattersburg,6267,6,6,5,13,31,43,-12,23
Vienna,6267,7,6,5,13,24,41,-17,23
FC Salzburg,6268,1,15,6,3,47,21,26,51
SK Sturm Gra,6268,2,13,4,7,33,28,5,43
Rapid Vienna,6268,3,9,10,5,36,25,11,37
LASK Linz,6268,4,8,7,9,28,28,0,31
Mattersburg,6268,5,6,6,12,29,41,-12,24
Vienna,6268,6,6,5,13,23,43,-20,23
SC Rheindorf,6268,7,5,6,13,18,28,-10,21
FC Salzburg,6269,1,14,6,4,42,18,24,48
SK Sturm Gra,6269,2,13,3,8,32,28,4,42
LASK Linz,6269,3,11,5,8,31,27,4,38
Rapid Vienna,6269,4,8,10,6,34,27,7,34
Mattersburg,6269,5,7,5,12,35,42,-7,26
Vienna,6269,6,6,5,13,25,42,-17,23
SC Rheindorf,6269,7,5,6,13,18,33,-15,21
FC Salzburg,6270,1,16,6,2,50,18,32,54
SK Sturm Gra,6270,2,13,4,7,33,27,6,43
Rapid Vienna,6270,3,7,10,7,33,29,4,31
LASK Linz,6270,4,8,6,10,27,30,-3,30
Vienna,6270,5,7,5,12,27,39,-12,26
SC Rheindorf,6270,6,6,7,11,22,29,-7,25
Mattersburg,6270,7,5,6,13,28,48,-20,21
FC Salzburg,6271,1,14,7,3,45,22,23,49
SK Sturm Gra,6271,2,12,3,9,33,31,2,39
Rapid Vienna,6271,3,9,10,5,37,27,10,37
LASK Linz,6271,4,9,5,10,28,28,0,32
Mattersburg,6271,5,7,5,12,35,46,-11,26
SC Rheindorf,6271,6,6,6,12,20,28,-8,24
Vienna,6271,7,6,6,12,25,41,-16,24
FC Salzburg,6272,1,13,7,4,41,18,23,46
Rapid Vienna,6272,2,9,11,4,36,25,11,38
SK Sturm Gra,6272,3,11,5,8,30,29,1,38
LASK Linz,6272,4,10,5,9,31,28,3,35
Mattersburg,6272,5,7,6,11,30,40,-10,27
Vienna,6272,6,6,5,13,25,42,-17,23
SC Rheindorf,6272,7,5,7,12,20,31,-11,22
FC Salzburg,6273,1,14,7,3,45,18,27,49
SK Sturm Gra,6273,2,12,3,9,33,32,1,39
Rapid Vienna,6273,3,8,11,5,34,26,8,35
LASK Linz,6273,4,9,7,8,27,26,1,34
Vienna,6273,5,7,5,12,26,39,-13,26
Mattersburg,6273,6,6,7,11,30,41,-11,25
SC Rheindorf,6273,7,5,6,13,19,32,-13,21
FC Salzburg,6274,1,15,6,3,44,19,25,51
SK Sturm Gra,6274,2,13,3,8,33,31,2,42
Rapid Vienna,6274,3,10,9,5,39,24,15,39
LASK Linz,6274,4,9,5,10,27,30,-3,32
Vienna,6274,5,7,5,12,27,40,-13,26
SC Rheindorf,6274,6,6,5,13,21,31,-10,23
Mattersburg,6274,7,5,5,14,31,47,-16,20
FC Salzburg,6275,1,13,6,5,46,21,25,45
Rapid Vienna,6275,2,10,9,5,38,29,9,39
SK Sturm Gra,6275,3,12,3,9,29,33,-4,39
LASK Linz,6275,4,8,6,10,27,27,0,30
Mattersburg,6275,5,7,7,10,33,40,-7,28
Vienna,6275,6,7,5,12,25,40,-15,26
SC Rheindorf,6275,7,6,6,12,21,29,-8,24
FC Salzburg,6276,1,14,7,3,47,21,26,49
SK Sturm Gra,6276,2,12,4,8,32,31,1,40
Rapid Vienna,6276,3,10,9,5,37,26,11,39
SC Rheindorf,6276,4,7,6,11,25,26,-1,27
LASK Linz,6276,5,7,5,12,25,33,-8,26
Mattersburg,6276,6,7,5,12,32,43,-11,26
Vienna,6276,7,6,6,12,24,42,-18,24
FC Salzburg,6277,1,13,7,4,43,22,21,46
SK Sturm Gra,6277,2,12,4,8,32,31,1,40
Rapid Vienna,6277,3,9,9,6,38,29,9,36
LASK Linz,6277,4,8,7,9,27,26,1,31
Vienna,6277,5,8,5,11,28,39,-11,29
Mattersburg,6277,6,6,7,11,32,42,-10,25
SC Rheindorf,6277,7,5,7,12,18,29,-11,22
FC Salzburg,6278,1,14,7,3,45,19,26,49
SK Sturm Gra,6278,2,13,3,8,33,29,4,42
Rapid Vienna,6278,3,10,10,4,40,28,12,40
LASK Linz,6278,4,9,5,10,31,31,0,32
SC Rheindorf,6278,5,6,5,13,20,30,-10,23
Mattersburg,6278,6,6,5,13,30,45,-15,23
Vienna,6278,7,6,5,13,25,42,-17,23
FC Salzburg,6279,1,13,8,3,44,22,22,47
SK Sturm Gra,6279,2,13,4,7,33,26,7,43
Rapid Vienna,6279,3,8,12,4,37,27,10,36
LASK Linz,6279,4,8,6,10,27,32,-5,30
Vienna,6279,5,7,6,11,28,40,-12,27
Mattersburg,6279,6,6,6,12,32,43,-11,24
SC Rheindorf,6279,7,4,8,12,16,27,-11,20
FC Salzburg,6280,1,15,6,3,48,19,29,51
SK Sturm Gra,6280,2,12,4,8,33,30,3,40
Rapid Vienna,6280,3,9,9,6,35,30,5,36
LASK Linz,6280,4,9,5,10,30,32,-2,32
Vienna,6280,5,7,5,12,26,41,-15,26
SC Rheindorf,6280,6,6,6,12,21,26,-5,24
Mattersburg,6280,7,6,5,13,28,43,-15,23
FC Salzburg,6281,1,15,7,2,45,19,26,52
SK Sturm Gra,6281,2,12,3,9,31,29,2,39
Rapid Vienna,6281,3,9,9,6,35,26,9,36
LASK Linz,6281,4,8,6,10,24,28,-4,30
Mattersburg,6281,5,6,7,11,31,40,-9,25
Vienna,6281,6,6,7,11,27,41,-14,25
SC Rheindorf,6281,7,5,7,12,18,28,-10,22
FC Salzburg,6282,1,14,6,4,45,21,24,48
SK Sturm Gra,6282,2,13,4,7,36,31,5,43
Rapid Vienna,6282,3,10,9,5,40,28,12,39
LASK Linz,6282,4,7,7,10,28,33,-5,28
Mattersburg,6282,5,7,6,11,33,41,-8,27
Vienna,6282,6,7,5,12,26,40,-14,26
SC Rheindorf,6282,7,5,5,14,18,32,-14,20
FC Salzburg,6283,1,14,8,2,44,18,26,50
SK Sturm Gra,6283,2,12,6,6,32,27,5,42
Rapid Vienna,6283,3,7,11,6,36,31,5,32
LASK Linz,6283,4,7,8,9,26,28,-2,29
SC Rheindorf,6283,5,6,7,11,21,28,-7,25
Mattersburg,6283,6,6,6,12,29,41,-12,24
Vienna,6283,7,6,6,12,24,39,-15,24
FC Salzburg,6284,1,14,7,3,45,18,27,49
SK Sturm Gra,6284,2,14,3,7,36,28,8,45
Rapid Vienna,6284,3,10,9,5,40,28,12,39
LASK Linz,6284,4,8,6,10,28,30,-2,30
Mattersburg,6284,5,7,6,11,32,41,-9,27
Vienna,6284,6,6,5,13,24,42,-18,23
SC Rheindorf,6284,7,4,6,14,19,37,-18,18
FC Salzburg,6285,1,14,6,4,40,18,22,48
Rapid Vienna,6285,2,10,9,5,38,25,13,39
SK Sturm Gra,6285,3,11,5,8,29,27,2,38
LASK Linz,6285,4,8,7,9,28,32,-4,31
Vienna,6285,5,7,5,12,25,39,-14,26
Mattersburg,6285,6,6,7,11,30,40,-10,25
SC Rheindorf,6285,7,5,7,12,19,28,-9,22
FC Salzburg,6286,1,16,6,2,46,16,30,54
SK Sturm Gra,6286,2,13,4,7,36,29,7,43
Rapid Vienna,6286,3,7,11,6,35,31,4,32
LASK Linz,6286,4,8,8,8,30,29,1,32
Mattersburg,6286,5,6,5,13,27,42,-15,23
Vienna,6286,6,6,5,13,24,40,-16,23
SC Rheindorf,6286,7,5,7,12,23,34,-11,22
FC Salzburg,6287,1,15,6,3,48,19,29,51
SK Sturm Gra,6287,2,13,4,7,33,27,6,43
Rapid Vienna,6287,3,10,9,5,39,28,11,39
LASK Linz,6287,4,7,7,10,26,31,-5,28
Mattersburg,6287,5,6,7,11,31,41,-10,25
Vienna,6287,6,6,5,13,24,43,-19,23
SC Rheindorf,6287,7,5,6,13,19,31,-12,21
FC Salzburg,6288,1,13,6,5,43,18,25,45
SK Sturm Gra,6288,2,13,5,6,32,26,6,44
Rapid Vienna,6288,3,8,11,5,35,27,8,35
LASK Linz,6288,4,7,8,9,29,31,-2,29
Vienna,6288,5,7,6,11,26,39,-13,27
SC Rheindorf,6288,6,6,7,11,19,26,-7,25
Mattersburg,6288,7,5,7,12,30,47,-17,22
FC Salzburg,6289,1,14,6,4,46,22,24,48
SK Sturm Gra,6289,2,13,3,8,34,31,3,42
Rapid Vienna,6289,3,8,9,7,34,29,5,33
LASK Linz,6289,4,9,5,10,30,29,1,32
Mattersburg,6289,5,7,6,11,32,42,-10,27
Vienna,6289,6,7,6,11,29,41,-12,27
SC Rheindorf,6289,7,6,5,13,18,29,-11,23
FC Salzburg,6290,1,15,7,2,46,18,28,52
SK Sturm Gra,6290,2,12,5,7,30,26,4,41
Rapid Vienna,6290,3,8,9,7,33,28,5,33
LASK Linz,6290,4,8,6,10,29,32,-3,30
Mattersburg,6290,5,7,6,11,31,40,-9,27
SC Rheindorf,6290,6,6,6,12,21,28,-7,24
Vienna,6290,7,6,5,13,24,42,-18,23
FC Salzburg,6291,1,13,8,3,46,23,23,47
SK Sturm Gra,6291,2,12,3,9,30,28,2,39
Rapid Vienna,6291,3,9,10,5,40,28,12,37
LASK Linz,6291,4,8,7,9,26,27,-1,31
Vienna,6291,5,8,5,11,27,39,-12,29
Mattersburg,6291,6,5,8,11,31,42,-11,23
SC Rheindorf,6291,7,5,7,12,17,30,-13,22
FC Salzburg,6292,1,15,6,3,44,17,27,51
Rapid Vienna,6292,2,11,9,4,43,26,17,42
SK Sturm Gra,6292,3,11,4,9,31,35,-4,37
LASK Linz,6292,4,8,6,10,30,30,0,30
Mattersburg,6292,5,7,6,11,31,40,-9,27
Vienna,6292,6,6,5,13,23,40,-17,23
SC Rheindorf,6292,7,5,6,13,21,35,-14,21
FC Salzburg,6293,1,13,9,2,43,17,26,48
SK Sturm Gra,6293,2,14,4,6,40,29,11,46
Rapid Vienna,6293,3,8,10,6,35,31,4,34
LASK Linz,6293,4,9,6,9,28,30,-2,33
Vienna,6293,5,7,6,11,25,38,-13,27
Mattersburg,6293,6,5,7,12,30,42,-12,22
SC Rheindorf,6293,7,4,6,14,17,31,-14,18
FC Salzburg,6294,1,14,7,3,48,24,24,49
SK Sturm Gra,6294,2,14,3,7,31,26,5,45
Rapid Vienna,6294,3,8,9,7,36,30,6,33
LASK Linz,6294,4,8,5,11,27,29,-2,29
Mattersburg,6294,5,7,6,11,35,45,-10,27
Vienna,6294,6,6,7,11,28,42,-14,25
SC Rheindorf,6294,7,6,5,13,21,30,-9,23
FC Salzburg,6295,1,15,7,2,49,19,30,52
SK Sturm Gra,6295,2,13,3,8,33,30,3,42
Rapid Vienna,6295,3,10,10,4,37,25,12,40
LASK Linz,6295,4,8,5,11,27,32,-5,29
Mattersburg,6295,5,7,6,11,34,43,-9,27
Vienna,6295,6,6,5,13,24,42,-18,23
SC Rheindorf,6295,7,4,6,14,19,32,-13,18
FC Salzburg,6296,1,15,6,3,49,17,32,51
SK Sturm Gra,6296,2,13,3,8,31,31,0,42
Rapid Vienna,6296,3,10,9,5,38,26,12,39
LASK Linz,6296,4,8,7,9,27,29,-2,31
Vienna,6296,5,7,5,12,26,41,-15,26
Mattersburg,6296,6,6,6,12,31,45,-14,24
SC Rheindorf,6296,7,4,6,14,17,30,-13,18
FC Salzburg,6297,1,15,6,3,52,22,30,51
SK Sturm Gra,6297,2,11,4,9,32,34,-2,37
LASK Linz,6297,3,9,7,8,29,28,1,34
Rapid Vienna,6297,4,8,9,7,37,32,5,33
Mattersburg,6297,5,7,7,10,32,39,-7,28
Vienna,6297,6,6,6,12,24,42,-18,24
SC Rheindorf,6297,7,6,5,13,22,31,-9,23
FC Salzburg,6298,1,14,6,4,42,17,25,48
SK Sturm Gra,6298,2,12,4,8,34,30,4,40
Rapid Vienna,6298,3,9,10,5,40,29,11,37
Mattersburg,6298,4,7,7,10,34,42,-8,28
LASK Linz,6298,5,7,6,11,28,35,-7,27
Vienna,6298,6,7,6,11,26,39,-13,27
SC Rheindorf,6298,7,6,5,13,19,31,-12,23
FC Salzburg,6299,1,12,10,2,45,22,23,46
SK Sturm Gra,6299,2,12,5,7,30,26,4,41
Rapid Vienna,6299,3,7,11,6,34,28,6,32
LASK Linz,6299,4,9,5,10,25,28,-3,32
Mattersburg,6299,5,7,7,10,37,42,-5,28
Vienna,6299,6,6,7,11,27,41,-14,25
SC Rheindorf,6299,7,6,5,13,18,29,-11,23
FC Salzburg,6300,1,14,7,3,43,19,24,49
SK Sturm Gra,6300,2,13,3,8,32,29,3,42
Rapid Vienna,6300,3,8,10,6,40,33,7,34
LASK Linz,6300,4,9,7,8,31,29,2,34
Vienna,6300,5,7,6,11,24,37,-13,27
Mattersburg,6300,6,6,5,13,31,43,-12,23
SC Rheindorf,6300,7,5,6,13,22,33,-11,21
FC Salzburg,6301,1,15,7,2,47,17,30,52
SK Sturm Gra,6301,2,11,5,8,32,34,-2,38
Rapid Vienna,6301,3,8,11,5,39,29,10,35
LASK Linz,6301,4,9,6,9,26,28,-2,33
Vienna,6301,5,7,5,12,24,38,-14,26
Mattersburg,6301,6,6,6,12,27,38,-11,24
SC Rheindorf,6301,7,5,6,13,18,29,-11,21
FC Salzburg,6302,1,14,7,3,47,24,23,49
SK Sturm Gra,6302,2,13,4,7,37,32,5,43
Rapid Vienna,6302,3,8,10,6,41,31,10,34
LASK Linz,6302,4,9,7,8,29,27,2,34
Vienna,6302,5,7,6,11,26,39,-13,27
SC Rheindorf,6302,6,5,7,12,22,33,-11,22
Mattersburg,6302,7,5,5,14,28,44,-16,20
FC Salzburg,6303,1,15,6,3,46,17,29,51
SK Sturm Gra,6303,2,12,4,8,32,34,-2,40
Rapid Vienna,6303,3,8,10,6,37,28,9,34
LASK Linz,6303,4,7,7,10,26,31,-5,28
SC Rheindorf,6303,5,7,6,11,22,27,-5,27
Vienna,6303,6,7,6,11,26,39,-13,27
Mattersburg,6303,7,5,7,12,28,41,-13,22
FC Salzburg,6304,1,13,7,4,42,22,20,46
SK Sturm Gra,6304,2,12,6,6,34,28,6,42
Rapid Vienna,6304,3,9,10,5,35,24,11,37
LASK Linz,6304,4,8,6,10,27,29,-2,30
Mattersburg,6304,5,8,5,11,36,40,-4,29
Vienna,6304,6,6,6,12,25,41,-16,24
SC Rheindorf,6304,7,5,6,13,19,34,-15,21
FC Salzburg,6305,1,13,9,2,47,18,29,48
SK Sturm Gra,6305,2,14,4,6,33,24,9,46
Rapid Vienna,6305,3,7,11,6,33,28,5,32
LASK Linz,6305,4,8,7,9,28,30,-2,31
Vienna,6305,5,7,5,12,26,44,-18,26
Mattersburg,6305,6,6,7,11,32,42,-10,25
SC Rheindorf,6305,7,4,7,13,17,30,-13,19
FC Salzburg,6306,1,15,7,2,49,22,27,52
SK Sturm Gra,6306,2,14,3,7,34,28,6,45
Rapid Vienna,6306,3,8,10,6,40,30,10,34
LASK Linz,6306,4,7,7,10,28,33,-5,28
Vienna,6306,5,7,6,11,27,40,-13,27
Mattersburg,6306,6,7,5,12,35,43,-8,26
SC Rheindorf,6306,7,4,6,14,18,35,-17,18
FC Salzburg,6307,1,14,6,4,47,21,26,48
SK Sturm Gra,6307,2,13,4,7,35,32,3,43
Rapid Vienna,6307,3,9,9,6,38,31,7,36
LASK Linz,6307,4,9,6,9,33,29,4,33
Vienna,6307,5,7,5,12,30,40,-10,26
SC Rheindorf,6307,6,6,5,13,21,30,-9,23
Mattersburg,6307,7,6,5,13,31,52,-21,23
FC Salzburg,6308,1,15,7,2,47,18,29,52
SK Sturm Gra,6308,2,11,4,9,30,29,1,37
Rapid Vienna,6308,3,8,10,6,35,30,5,34
LASK Linz,6308,4,9,6,9,30,28,2,33
Vienna,6308,5,7,6,11,27,39,-12,27
Mattersburg,6308,6,6,6,12,32,46,-14,24
SC Rheindorf,6308,7,6,5,13,18,29,-11,23
FC Salzburg,6309,1,15,7,2,50,18,32,52
SK Sturm Gra,6309,2,12,5,7,33,28,5,41
Rapid Vienna,6309,3,7,10,7,33,29,4,31
LASK Linz,6309,4,8,7,9,26,27,-1,31
Mattersburg,6309,5,6,7,11,30,44,-14,25
Vienna,6309,6,6,6,12,25,42,-17,24
SC Rheindorf,6309,7,5,8,11,19,28,-9,23
FC Salzburg,6310,1,13,6,5,41,20,21,45
Rapid Vienna,6310,2,10,9,5,38,28,10,39
SK Sturm Gra,6310,3,12,3,9,32,32,0,39
LASK Linz,6310,4,8,6,10,27,30,-3,30
Vienna,6310,5,8,5,11,29,40,-11,29
Mattersburg,6310,6,6,7,11,30,40,-10,25
SC Rheindorf,6310,7,6,6,12,23,30,-7,24
FC Salzburg,6311,1,16,6,2,49,18,31,54
SK Sturm Gra,6311,2,12,5,7,33,29,4,41
Rapid Vienna,6311,3,7,12,5,37,30,7,33
LASK Linz,6311,4,8,8,8,29,29,0,32
Vienna,6311,5,7,5,12,25,39,-14,26
Mattersburg,6311,6,6,5,13,29,44,-15,23
SC Rheindorf,6311,7,4,7,13,17,30,-13,19
FC Salzburg,6312,1,15,7,2,45,17,28,52
SK Sturm Gra,6312,2,11,5,8,30,28,2,38
Rapid Vienna,6312,3,7,12,5,34,28,6,33
LASK Linz,6312,4,8,7,9,27,28,-1,31
Mattersburg,6312,5,7,5,12,32,41,-9,26
Vienna,6312,6,7,5,12,27,41,-14,26
SC Rheindorf,6312,7,5,7,12,19,31,-12,22
FC Salzburg,6313,1,14,6,4,46,22,24,48
SK Sturm Gra,6313,2,13,3,8,33,30,3,42
Rapid Vienna,6313,3,8,10,6,35,29,6,34
LASK Linz,6313,4,9,6,9,27,26,1,33
Mattersburg,6313,5,7,6,11,30,40,-10,27
Vienna,6313,6,7,6,11,27,40,-13,27
SC Rheindorf,6313,7,5,5,14,17,28,-11,20
FC Salzburg,6314,1,16,6,2,46,18,28,54
SK Sturm Gra,6314,2,13,3,8,30,27,3,42
LASK Linz,6314,3,9,6,9,27,27,0,33
Rapid Vienna,6314,4,7,10,7,32,27,5,31
Vienna,6314,5,7,5,12,27,39,-12,26
SC Rheindorf,6314,6,6,7,11,20,27,-7,25
Mattersburg,6314,7,5,5,14,30,47,-17,20
FC Salzburg,6315,1,16,6,2,47,17,30,54
SK Sturm Gra,6315,2,13,4,7,34,29,5,43
LASK Linz,6315,3,10,6,8,28,25,3,36
Rapid Vienna,6315,4,7,10,7,34,31,3,31
Mattersburg,6315,5,6,5,13,30,45,-15,23
Vienna,6315,6,6,5,13,25,42,-17,23
SC Rheindorf,6315,7,5,6,13,20,29,-9,21
FC Salzburg,6316,1,14,7,3,43,18,25,49
SK Sturm Gra,6316,2,12,4,8,31,31,0,40
LASK Linz,6316,3,10,6,8,31,26,5,36
Rapid Vienna,6316,4,7,10,7,32,27,5,31
Vienna,6316,5,8,5,11,29,38,-9,29
Mattersburg,6316,6,6,6,12,29,44,-15,24
SC Rheindorf,6316,7,5,6,13,20,31,-11,21
FC Salzburg,6317,1,13,8,3,47,24,23,47
SK Sturm Gra,6317,2,12,4,8,31,29,2,40
Rapid Vienna,6317,3,9,10,5,37,27,10,37
LASK Linz,6317,4,10,5,9,29,27,2,35
Vienna,6317,5,7,6,11,30,43,-13,27
Mattersburg,6317,6,6,6,12,34,44,-10,24
SC Rheindorf,6317,7,5,5,14,16,30,-14,20
FC Salzburg,6318,1,15,7,2,48,16,32,52
SK Sturm Gra,6318,2,12,5,7,33,32,1,41
Rapid Vienna,6318,3,9,10,5,35,27,8,37
LASK Linz,6318,4,7,5,12,28,35,-7,26
Vienna,6318,5,7,5,12,28,39,-11,26
Mattersburg,6318,6,6,7,11,32,45,-13,25
SC Rheindorf,6318,7,5,7,12,23,33,-10,22
FC Salzburg,6319,1,14,8,2,46,20,26,50
SK Sturm Gra,6319,2,13,4,7,34,28,6,43
Rapid Vienna,6319,3,8,10,6,35,28,7,34
LASK Linz,6319,4,9,6,9,29,30,-1,33
Vienna,6319,5,6,6,12,25,41,-16,24
Mattersburg,6319,6,5,8,11,29,44,-15,23
SC Rheindorf,6319,7,5,6,13,22,29,-7,21
FC Salzburg,6320,1,16,6,2,48,18,30,54
SK Sturm Gra,6320,2,12,4,8,31,29,2,40
Rapid Vienna,6320,3,7,10,7,34,32,2,31
LASK Linz,6320,4,8,6,10,26,28,-2,30
Mattersburg,6320,5,8,5,11,33,40,-7,29
SC Rheindorf,6320,6,6,6,12,18,27,-9,24
Vienna,6320,7,6,5,13,24,40,-16,23
FC Salzburg,6321,1,16,6,2,45,16,29,54
SK Sturm Gra,6321,2,13,4,7,32,27,5,43
Rapid Vienna,6321,3,7,11,6,35,29,6,32
LASK Linz,6321,4,8,7,9,29,28,1,31
Vienna,6321,5,7,5,12,27,39,-12,26
SC Rheindorf,6321,6,5,7,12,19,31,-12,22
Mattersburg,6321,7,5,6,13,28,45,-17,21
FC Salzburg,6322,1,15,6,3,45,18,27,51
Rapid Vienna,6322,2,9,9,6,34,25,9,36
SK Sturm Gra,6322,3,11,3,10,29,34,-5,36
LASK Linz,6322,4,9,6,9,28,27,1,33
SC Rheindorf,6322,5,7,5,12,21,28,-7,26
Vienna,6322,6,7,5,12,28,41,-13,26
Mattersburg,6322,7,6,6,12,30,42,-12,24
FC Salzburg,6323,1,15,7,2,46,17,29,52
SK Sturm Gra,6323,2,13,3,8,33,29,4,42
Rapid Vienna,6323,3,8,10,6,33,29,4,34
SC Rheindorf,6323,4,7,6,11,21,28,-7,27
LASK Linz,6323,5,7,5,12,25,31,-6,26
Mattersburg,6323,6,6,7,11,31,40,-9,25
Vienna,6323,7,6,6,12,23,38,-15,24
FC Salzburg,6324,1,13,6,5,43,24,19,45
SK Sturm Gra,6324,2,13,4,7,37,29,8,43
Rapid Vienna,6324,3,8,11,5,37,31,6,35
LASK Linz,6324,4,8,7,9,27,28,-1,31
Mattersburg,6324,5,8,5,11,31,40,-9,29
Vienna,6324,6,7,5,12,28,39,-11,26
SC Rheindorf,6324,7,5,6,13,19,31,-12,21
FC Salzburg,6325,1,13,6,5,41,25,16,45
SK Sturm Gra,6325,2,12,3,9,31,30,1,39
Rapid Vienna,6325,3,9,10,5,37,25,12,37
LASK Linz,6325,4,9,6,9,26,26,0,33
Vienna,6325,5,8,5,11,30,39,-9,29
Mattersburg,6325,6,7,5,12,34,44,-10,26
SC Rheindorf,6325,7,5,7,12,22,32,-10,22
FC Salzburg,6326,1,15,6,3,45,18,27,51
SK Sturm Gra,6326,2,12,3,9,32,32,0,39
Rapid Vienna,6326,3,8,9,7,34,28,6,33
LASK Linz,6326,4,9,5,10,29,29,0,32
Vienna,6326,5,8,5,11,27,38,-11,29
SC Rheindorf,6326,6,7,5,12,23,30,-7,26
Mattersburg,6326,7,6,5,13,32,47,-15,23
FC Salzburg,6327,1,14,8,2,45,20,25,50
SK Sturm Gra,6327,2,12,4,8,31,30,1,40
Rapid Vienna,6327,3,8,10,6,37,30,7,34
LASK Linz,6327,4,7,7,10,24,28,-4,28
Vienna,6327,5,7,6,11,27,39,-12,27
SC Rheindorf,6327,6,7,5,12,25,30,-5,26
Mattersburg,6327,7,6,6,12,32,44,-12,24
FC Salzburg,6328,1,14,7,3,42,18,24,49
SK Sturm Gra,6328,2,12,5,7,32,28,4,41
Rapid Vienna,6328,3,10,9,5,39,28,11,39
LASK Linz,6328,4,9,6,9,33,30,3,33
Mattersburg,6328,5,7,5,12,34,43,-9,26
Vienna,6328,6,6,5,13,24,41,-17,23
SC Rheindorf,6328,7,5,5,14,20,36,-16,20
FC Salzburg,6329,1,13,8,3,42,19,23,47
SK Sturm Gra,6329,2,12,4,8,34,32,2,40
Rapid Vienna,6329,3,8,12,4,35,26,9,36
LASK Linz,6329,4,9,6,9,29,26,3,33
Mattersburg,6329,5,9,5,10,31,36,-5,32
Vienna,6329,6,6,6,12,25,40,-15,24
SC Rheindorf,6329,7,4,5,15,17,34,-17,17
FC Salzburg,6330,1,14,6,4,44,21,23,48
SK Sturm Gra,6330,2,13,3,8,33,33,0,42
Rapid Vienna,6330,3,7,11,6,33,28,5,32
LASK Linz,6330,4,8,6,10,28,27,1,30
Mattersburg,6330,5,8,6,10,35,41,-6,30
Vienna,6330,6,7,5,12,27,40,-13,26
SC Rheindorf,6330,7,5,7,12,21,31,-10,22
FC Salzburg,6331,1,15,7,2,45,18,27,52
SK Sturm Gra,6331,2,11,6,7,31,29,2,39
Rapid Vienna,6331,3,8,10,6,36,27,9,34
LASK Linz,6331,4,9,6,9,28,29,-1,33
Mattersburg,6331,5,8,6,10,41,41,0,30
Vienna,6331,6,6,5,13,24,41,-17,23
SC Rheindorf,6331,7,4,6,14,18,38,-20,18
FC Salzburg,6332,1,14,6,4,44,21,23,48
SK Sturm Gra,6332,2,12,4,8,34,31,3,40
Rapid Vienna,6332,3,9,10,5,38,28,10,37
LASK Linz,6332,4,8,6,10,28,31,-3,30
Mattersburg,6332,5,8,5,11,32,38,-6,29
SC Rheindorf,6332,6,6,6,12,22,31,-9,24
Vienna,6332,7,6,5,13,23,41,-18,23
FC Salzburg,6333,1,14,7,3,45,18,27,49
SK Sturm Gra,6333,2,11,5,8,30,28,2,38
Rapid Vienna,6333,3,8,11,5,34,28,6,35
LASK Linz,6333,4,9,6,9,26,27,-1,33
Mattersburg,6333,5,7,6,11,31,41,-10,27
Vienna,6333,6,6,7,11,25,39,-14,25
SC Rheindorf,6333,7,5,6,13,20,30,-10,21
FC Salzburg,6334,1,14,6,4,46,18,28,48
SK Sturm Gra,6334,2,14,4,6,36,25,11,46
Rapid Vienna,6334,3,10,9,5,35,27,8,39
LASK Linz,6334,4,7,6,11,24,32,-8,27
Mattersburg,6334,5,6,7,11,30,42,-12,25
Vienna,6334,6,6,6,12,25,42,-17,24
SC Rheindorf,6334,7,5,6,13,20,30,-10,21
FC Salzburg,6335,1,13,6,5,45,22,23,45
SK Sturm Gra,6335,2,13,4,7,32,28,4,43
Rapid Vienna,6335,3,11,9,4,40,25,15,42
LASK Linz,6335,4,8,5,11,26,29,-3,29
Vienna,6335,5,8,5,11,28,39,-11,29
Mattersburg,6335,6,6,5,13,33,47,-14,23
SC Rheindorf,6335,7,5,6,13,16,30,-14,21
FC Salzburg,6336,1,14,8,2,47,18,29,50
SK Sturm Gra,6336,2,12,4,8,33,30,3,40
Rapid Vienna,6336,3,9,10,5,36,28,8,37
LASK Linz,6336,4,9,6,9,30,29,1,33
SC Rheindorf,6336,5,6,6,12,24,33,-9,24
Vienna,6336,6,6,6,12,24,41,-17,24
Mattersburg,6336,7,5,6,13,30,45,-15,21
FC Salzburg,6337,1,13,7,4,42,20,22,46
SK Sturm Gra,6337,2,14,3,7,37,30,7,45
Rapid Vienna,6337,3,10,9,5,37,27,10,39
LASK Linz,6337,4,8,6,10,29,32,-3,30
Mattersburg,6337,5,7,6,11,34,42,-8,27
Vienna,6337,6,6,6,12,25,41,-16,24
SC Rheindorf,6337,7,5,5,14,20,32,-12,20
FC Salzburg,6338,1,14,7,3,45,17,28,49
SK Sturm Gra,6338,2,13,5,6,36,28,8,44
LASK Linz,6338,3,9,7,8,28,26,2,34
Rapid Vienna,6338,4,7,10,7,34,32,2,31
Vienna,6338,5,7,5,12,25,39,-14,26
Mattersburg,6338,6,6,6,12,29,42,-13,24
SC Rheindorf,6338,7,5,6,13,17,30,-13,21
FC Salzburg,6339,1,15,6,3,48,17,31,51
SK Sturm Gra,6339,2,12,5,7,31,27,4,41
Rapid Vienna,6339,3,8,11,5,34,27,7,35
LASK Linz,6339,4,7,7,10,23,27,-4,28
Mattersburg,6339,5,7,5,12,31,43,-12,26
Vienna,6339,6,7,5,12,26,41,-15,26
SC Rheindorf,6339,7,5,7,12,17,28,-11,22
FC Salzburg,6340,1,13,8,3,41,18,23,47
SK Sturm Gra,6340,2,12,4,8,30,29,1,40
Rapid Vienna,6340,3,10,9,5,37,26,11,39
LASK Linz,6340,4,9,5,10,30,28,2,32
Vienna,6340,5,7,5,12,26,40,-14,26
Mattersburg,6340,6,6,7,11,30,41,-11,25
SC Rheindorf,6340,7,5,6,13,18,30,-12,21
FC Salzburg,6341,1,12,8,4,41,20,21,44
SK Sturm Gra,6341,2,11,5,8,29,28,1,38
Rapid Vienna,6341,3,9,10,5,34,25,9,37
LASK Linz,6341,4,10,5,9,28,28,0,35
Mattersburg,6341,5,8,5,11,39,41,-2,29
Vienna,6341,6,7,6,11,29,42,-13,27
SC Rheindorf,6341,7,5,5,14,18,34,-16,20
FC Salzburg,6342,1,15,6,3,43,17,26,51
SK Sturm Gra,6342,2,13,4,7,32,27,5,43
Rapid Vienna,6342,3,8,11,5,35,27,8,35
LASK Linz,6342,4,9,6,9,25,25,0,33
Mattersburg,6342,5,7,5,12,29,38,-9,26
Vienna,6342,6,7,5,12,24,38,-14,26
SC Rheindorf,6342,7,4,5,15,16,32,-16,17
FC Salzburg,6343,1,15,6,3,46,18,28,51
SK Sturm Gra,6343,2,13,4,7,35,29,6,43
Rapid Vienna,6343,3,9,10,5,35,26,9,37
LASK Linz,6343,4,8,5,11,25,29,-4,29
Vienna,6343,5,7,5,12,25,40,-15,26
SC Rheindorf,6343,6,5,8,11,19,28,-9,23
Mattersburg,6343,7,5,6,13,28,43,-15,21
FC Salzburg,6344,1,16,6,2,45,18,27,54
SK Sturm Gra,6344,2,11,6,7,31,28,3,39
Rapid Vienna,6344,3,7,10,7,34,31,3,31
LASK Linz,6344,4,8,7,9,30,31,-1,31
Mattersburg,6344,5,7,6,11,32,40,-8,27
SC Rheindorf,6344,6,5,8,11,20,28,-8,23
Vienna,6344,7,6,5,13,23,39,-16,23
FC Salzburg,6345,1,14,7,3,43,18,25,49
SK Sturm Gra,6345,2,13,4,7,34,29,5,43
Rapid Vienna,6345,3,9,10,5,39,29,10,37
LASK Linz,6345,4,8,6,10,27,29,-2,30
Vienna,6345,5,7,5,12,28,41,-13,26
SC Rheindorf,6345,6,5,7,12,20,30,-10,22
Mattersburg,6345,7,5,7,12,30,45,-15,22
FC Salzburg,6346,1,16,6,2,49,16,33,54
SK Sturm Gra,6346,2,12,4,8,32,31,1,40
LASK Linz,6346,3,9,6,9,31,30,1,33
Rapid Vienna,6346,4,7,11,6,35,30,5,32
Vienna,6346,5,7,5,12,26,40,-14,26
SC Rheindorf,6346,6,5,7,12,19,29,-10,22
Mattersburg,6346,7,5,7,12,28,44,-16,22
FC Salzburg,6347,1,14,7,3,44,18,26,49
SK Sturm Gra,6347,2,11,4,9,30,30,0,37
Rapid Vienna,6347,3,8,11,5,34,27,7,35
Mattersburg,6347,4,9,5,10,35,40,-5,32
LASK Linz,6347,5,7,7,10,24,28,-4,28
SC Rheindorf,6347,6,7,5,12,19,26,-7,26
Vienna,6347,7,6,5,13,26,43,-17,23
FC Salzburg,6348,1,13,8,3,46,18,28,47
SK Sturm Gra,6348,2,12,4,8,32,30,2,40
Rapid Vienna,6348,3,9,11,4,38,27,11,38
Vienna,6348,4,8,5,11,26,38,-12,29
LASK Linz,6348,5,7,7,10,26,29,-3,28
SC Rheindorf,6348,6,7,5,12,22,30,-8,26
Mattersburg,6348,7,5,6,13,29,47,-18,21
FC Salzburg,6349,1,14,7,3,43,18,25,49
Rapid Vienna,6349,2,9,11,4,37,26,11,38
SK Sturm Gra,6349,3,11,4,9,31,30,1,37
LASK Linz,6349,4,8,7,9,26,28,-2,31
Mattersburg,6349,5,6,7,11,29,40,-11,25
Vienna,6349,6,6,7,11,24,38,-14,25
SC Rheindorf,6349,7,5,7,12,19,29,-10,22
FC Salzburg,6350,1,15,7,2,45,17,28,52
Rapid Vienna,6350,2,10,10,4,38,25,13,40
SK Sturm Gra,6350,3,11,4,9,31,31,0,37
LASK Linz,6350,4,8,7,9,27,30,-3,31
Vienna,6350,5,7,5,12,27,39,-12,26
Mattersburg,6350,6,6,5,13,30,46,-16,23
SC Rheindorf,6350,7,5,6,13,19,29,-10,21
FC Salzburg,6351,1,12,9,3,41,20,21,45
SK Sturm Gra,6351,2,12,4,8,32,30,2,40
LASK Linz,6351,3,11,5,8,30,25,5,38
Rapid Vienna,6351,4,8,10,6,35,28,7,34
Vienna,6351,5,7,5,12,25,38,-13,26
Mattersburg,6351,6,6,6,12,30,42,-12,24
SC Rheindorf,6351,7,6,5,13,20,30,-10,23
FC Salzburg,6352,1,15,6,3,45,17,28,51
SK Sturm Gra,6352,2,12,4,8,30,33,-3,40
Rapid Vienna,6352,3,9,9,6,34,27,7,36
LASK Linz,6352,4,9,6,9,30,28,2,33
SC Rheindorf,6352,5,7,5,12,24,28,-4,26
Mattersburg,6352,6,6,5,13,29,42,-13,23
Vienna,6352,7,6,5,13,24,41,-17,23
FC Salzburg,6353,1,15,7,2,44,16,28,52
SK Sturm Gra,6353,2,12,5,7,33,29,4,41
Rapid Vienna,6353,3,8,11,5,37,30,7,35
LASK Linz,6353,4,9,5,10,31,31,0,32
Vienna,6353,5,7,5,12,24,39,-15,26
Mattersburg,6353,6,6,5,13,28,40,-12,23
SC Rheindorf,6353,7,5,6,13,17,29,-12,21
FC Salzburg,6354,1,15,7,2,47,16,31,52
SK Sturm Gra,6354,2,12,3,9,31,30,1,39
Rapid Vienna,6354,3,8,10,6,33,30,3,34
LASK Linz,6354,4,9,5,10,30,29,1,32
SC Rheindorf,6354,5,7,5,12,23,30,-7,26
Vienna,6354,6,7,5,12,26,41,-15,26
Mattersburg,6354,7,6,5,13,33,47,-14,23
FC Salzburg,6355,1,15,7,2,50,20,30,52
SK Sturm Gra,6355,2,12,4,8,34,33,1,40
Rapid Vienna,6355,3,9,10,5,43,29,14,37
LASK Linz,6355,4,9,6,9,26,28,-2,33
Mattersburg,6355,5,7,5,12,36,45,-9,26
Vienna,6355,6,6,5,13,26,45,-19,23
SC Rheindorf,6355,7,5,5,14,20,35,-15,20
FC Salzburg,6356,1,13,7,4,43,23,20,46
SK Sturm Gra,6356,2,12,4,8,31,29,2,40
Rapid Vienna,6356,3,9,11,4,39,26,13,38
LASK Linz,6356,4,7,6,11,25,30,-5,27
Vienna,6356,5,7,6,11,27,39,-12,27
SC Rheindorf,6356,6,7,5,12,21,29,-8,26
Mattersburg,6356,7,6,7,11,31,41,-10,25
FC Salzburg,6357,1,15,6,3,44,18,26,51
SK Sturm Gra,6357,2,14,3,7,33,27,6,45
Rapid Vienna,6357,3,9,9,6,37,27,10,36
LASK Linz,6357,4,8,6,10,25,28,-3,30
Mattersburg,6357,5,7,5,12,31,41,-10,26
Vienna,6357,6,7,5,12,27,39,-12,26
SC Rheindorf,6357,7,4,6,14,17,34,-17,18
FC Salzburg,6358,1,15,6,3,44,17,27,51
Rapid Vienna,6358,2,9,11,4,38,27,11,38
SK Sturm Gra,6358,3,11,5,8,32,31,1,38
LASK Linz,6358,4,7,8,9,26,30,-4,29
SC Rheindorf,6358,5,7,5,12,24,30,-6,26
Vienna,6358,6,6,6,12,23,39,-16,24
Mattersburg,6358,7,5,7,12,27,40,-13,22
FC Salzburg,6359,1,14,7,3,44,18,26,49
SK Sturm Gra,6359,2,13,3,8,32,27,5,42
Rapid Vienna,6359,3,8,11,5,34,26,8,35
LASK Linz,6359,4,8,6,10,25,30,-5,30
SC Rheindorf,6359,5,7,5,12,22,28,-6,26
Vienna,6359,6,7,5,12,25,38,-13,26
Mattersburg,6359,7,6,5,13,30,45,-15,23
FC Salzburg,6360,1,16,6,2,45,15,30,54
SK Sturm Gra,6360,2,12,4,8,31,27,4,40
Rapid Vienna,6360,3,8,11,5,34,26,8,35
LASK Linz,6360,4,8,6,10,26,30,-4,30
Mattersburg,6360,5,6,6,12,29,42,-13,24
Vienna,6360,6,6,6,12,24,39,-15,24
SC Rheindorf,6360,7,5,7,12,17,27,-10,22
FC Salzburg,6361,1,14,8,2,44,19,25,50
SK Sturm Gra,6361,2,12,5,7,30,26,4,41
Rapid Vienna,6361,3,10,10,4,36,23,13,40
LASK Linz,6361,4,8,6,10,27,31,-4,30
Vienna,6361,5,7,5,12,28,41,-13,26
Mattersburg,6361,6,6,5,13,28,43,-15,23
SC Rheindorf,6361,7,5,5,14,20,30,-10,20
FC Salzburg,6362,1,13,6,5,41,21,20,45
Rapid Vienna,6362,2,11,9,4,37,23,14,42
SK Sturm Gra,6362,3,12,4,8,31,30,1,40
Mattersburg,6362,4,7,6,11,34,40,-6,27
LASK Linz,6362,5,7,6,11,27,36,-9,27
Vienna,6362,6,7,5,12,26,39,-13,26
SC Rheindorf,6362,7,6,6,12,23,30,-7,24
FC Salzburg,6363,1,12,9,3,43,22,21,45
SK Sturm Gra,6363,2,11,5,8,35,34,1,38
Rapid Vienna,6363,3,9,10,5,36,27,9,37
LASK Linz,6363,4,9,6,9,27,26,1,33
SC Rheindorf,6363,5,7,6,11,21,26,-5,27
Vienna,6363,6,6,7,11,25,39,-14,25
Mattersburg,6363,7,5,7,12,28,41,-13,22
FC Salzburg,6364,1,14,6,4,43,20,23,48
SK Sturm Gra,6364,2,12,4,8,32,30,2,40
LASK Linz,6364,3,11,5,8,30,25,5,38
Rapid Vienna,6364,4,8,10,6,34,27,7,34
Vienna,6364,5,8,5,11,28,39,-11,29
SC Rheindorf,6364,6,5,7,12,16,26,-10,22
Mattersburg,6364,7,5,5,14,28,44,-16,20
FC Salzburg,6365,1,16,6,2,46,15,31,54
SK Sturm Gra,6365,2,11,6,7,30,29,1,39
Rapid Vienna,6365,3,8,10,6,36,26,10,34
LASK Linz,6365,4,8,8,8,26,26,0,32
Vienna,6365,5,7,5,12,28,40,-12,26
Mattersburg,6365,6,5,7,12,29,45,-16,22
SC Rheindorf,6365,7,4,8,12,18,32,-14,20
FC Salzburg,6366,1,16,6,2,48,16,32,54
SK Sturm Gra,6366,2,12,3,9,33,33,0,39
Rapid Vienna,6366,3,8,9,7,35,31,4,33
LASK Linz,6366,4,8,6,10,27,31,-4,30
Mattersburg,6366,5,7,6,11,31,40,-9,27
SC Rheindorf,6366,6,6,7,11,20,27,-7,25
Vienna,6366,7,6,5,13,23,39,-16,23
FC Salzburg,6367,1,15,7,2,49,19,30,52
SK Sturm Gra,6367,2,13,3,8,33,30,3,42
Rapid Vienna,6367,3,9,9,6,34,28,6,36
LASK Linz,6367,4,8,6,10,25,27,-2,30
Mattersburg,6367,5,6,8,10,32,41,-9,26
Vienna,6367,6,6,6,12,26,43,-17,24
SC Rheindorf,6367,7,5,5,14,19,30,-11,20
FC Salzburg,6368,1,14,6,4,42,18,24,48
SK Sturm Gra,6368,2,13,4,7,35,30,5,43
Rapid Vienna,6368,3,9,9,6,36,28,8,36
LASK Linz,6368,4,8,5,11,27,33,-6,29
Vienna,6368,5,8,5,11,27,37,-10,29
SC Rheindorf,6368,6,6,6,12,20,28,-8,24
Mattersburg,6368,7,6,5,13,29,42,-13,23
FC Salzburg,6369,1,15,6,3,48,20,28,51
Rapid Vienna,6369,2,10,9,5,37,27,10,39
SK Sturm Gra,6369,3,11,4,9,32,31,1,37
LASK Linz,6369,4,9,6,9,31,27,4,33
Vienna,6369,5,7,6,11,27,39,-12,27
Mattersburg,6369,6,6,6,12,30,47,-17,24
SC Rheindorf,6369,7,5,5,14,21,35,-14,20
FC Salzburg,6370,1,16,6,2,49,17,32,54
SK Sturm Gra,6370,2,14,3,7,35,28,7,45
Rapid Vienna,6370,3,8,10,6,34,28,6,34
LASK Linz,6370,4,8,6,10,27,30,-3,30
Mattersburg,6370,5,6,7,11,32,42,-10,25
Vienna,6370,6,6,6,12,25,42,-17,24
SC Rheindorf,6370,7,4,6,14,16,31,-15,18
FC Salzburg,6371,1,15,7,2,44,15,29,52
SK Sturm Gra,6371,2,13,3,8,32,30,2,42
Rapid Vienna,6371,3,7,10,7,34,29,5,31
LASK Linz,6371,4,8,7,9,26,28,-2,31
SC Rheindorf,6371,5,6,7,11,20,27,-7,25
Mattersburg,6371,6,6,7,11,31,40,-9,25
Vienna,6371,7,6,5,13,24,42,-18,23
FC Salzburg,6372,1,14,8,2,43,17,26,50
SK Sturm Gra,6372,2,11,5,8,29,28,1,38
LASK Linz,6372,3,10,5,9,31,29,2,35
Rapid Vienna,6372,4,8,10,6,35,28,7,34
Vienna,6372,5,7,5,12,25,39,-14,26
Mattersburg,6372,6,6,6,12,31,43,-12,24
SC Rheindorf,6372,7,6,5,13,21,31,-10,23
FC Salzburg,6373,1,14,7,3,43,18,25,49
SK Sturm Gra,6373,2,12,6,6,32,27,5,42
Rapid Vienna,6373,3,7,12,5,34,29,5,33
LASK Linz,6373,4,8,7,9,30,30,0,31
Mattersburg,6373,5,6,6,12,30,41,-11,24
Vienna,6373,6,6,6,12,24,39,-15,24
SC Rheindorf,6373,7,5,8,11,17,26,-9,23
FC Salzburg,6374,1,15,6,3,43,19,24,51
SK Sturm Gra,6374,2,14,4,6,36,25,11,46
Rapid Vienna,6374,3,7,10,7,36,32,4,31
LASK Linz,6374,4,8,6,10,29,33,-4,30
Vienna,6374,5,7,5,12,25,39,-14,26
SC Rheindorf,6374,6,6,6,12,18,29,-11,24
Mattersburg,6374,7,6,5,13,32,42,-10,23
FC Salzburg,6375,1,13,7,4,47,24,23,46
SK Sturm Gra,6375,2,14,4,6,34,27,7,46
Rapid Vienna,6375,3,9,10,5,35,26,9,37
Vienna,6375,4,8,5,11,27,39,-12,29
LASK Linz,6375,5,7,7,10,26,29,-3,28
SC Rheindorf,6375,6,6,5,13,18,28,-10,23
Mattersburg,6375,7,5,6,13,30,44,-14,21
FC Salzburg,6376,1,14,7,3,46,20,26,49
SK Sturm Gra,6376,2,11,4,9,30,31,-1,37
LASK Linz,6376,3,9,7,8,29,27,2,34
Rapid Vienna,6376,4,7,11,6,33,27,6,32
Mattersburg,6376,5,7,6,11,31,40,-9,27
Vienna,6376,6,7,6,11,26,39,-13,27
SC Rheindorf,6376,7,6,5,13,21,32,-11,23
FC Salzburg,6377,1,15,7,2,45,16,29,52
SK Sturm Gra,6377,2,12,4,8,34,33,1,40
Rapid Vienna,6377,3,8,10,6,38,29,9,34
LASK Linz,6377,4,8,6,10,26,29,-3,30
SC Rheindorf,6377,5,7,6,11,20,27,-7,27
Vienna,6377,6,6,6,12,25,40,-15,24
Mattersburg,6377,7,5,7,12,30,44,-14,22
FC Salzburg,6378,1,15,7,2,45,18,27,52
SK Sturm Gra,6378,2,12,4,8,33,29,4,40
Rapid Vienna,6378,3,8,11,5,34,26,8,35
LASK Linz,6378,4,8,6,10,26,30,-4,30
Vienna,6378,5,6,7,11,25,39,-14,25
SC Rheindorf,6378,6,6,6,12,21,27,-6,24
Mattersburg,6378,7,5,7,12,28,43,-15,22
FC Salzburg,6379,1,15,7,2,44,17,27,52
SK Sturm Gra,6379,2,12,3,9,31,29,2,39
Rapid Vienna,6379,3,8,10,6,36,29,7,34
LASK Linz,6379,4,9,6,9,27,27,0,33
Mattersburg,6379,5,7,6,11,28,37,-9,27
SC Rheindorf,6379,6,6,5,13,17,28,-11,23
Vienna,6379,7,6,5,13,23,39,-16,23
FC Salzburg,6380,1,14,6,4,44,22,22,48
SK Sturm Gra,6380,2,13,3,8,32,29,3,42
Rapid Vienna,6380,3,9,9,6,36,28,8,36
LASK Linz,6380,4,9,5,10,29,29,0,32
Vienna,6380,5,8,5,11,30,39,-9,29
SC Rheindorf,6380,6,6,5,13,20,30,-10,23
Mattersburg,6380,7,6,5,13,32,46,-14,23
FC Salzburg,6381,1,13,8,3,44,20,24,47
SK Sturm Gra,6381,2,14,4,6,38,28,10,46
Rapid Vienna,6381,3,8,11,5,35,28,7,35
LASK Linz,6381,4,8,6,10,26,28,-2,30
Mattersburg,6381,5,6,8,10,32,40,-8,26
Vienna,6381,6,6,6,12,25,42,-17,24
SC Rheindorf,6381,7,4,7,13,16,30,-14,19
FC Salzburg,6382,1,13,8,3,42,19,23,47
SK Sturm Gra,6382,2,12,4,8,33,30,3,40
Rapid Vienna,6382,3,9,10,5,34,25,9,37
LASK Linz,6382,4,8,5,11,24,30,-6,29
Vienna,6382,5,7,6,11,25,38,-13,27
SC Rheindorf,6382,6,6,7,11,24,31,-7,25
Mattersburg,6382,7,6,6,12,32,41,-9,24
FC Salzburg,6383,1,14,6,4,46,20,26,48
SK Sturm Gra,6383,2,13,4,7,32,29,3,43
Rapid Vienna,6383,3,9,9,6,35,28,7,36
LASK Linz,6383,4,9,6,9,29,29,0,33
Mattersburg,6383,5,8,6,10,35,38,-3,30
Vienna,6383,6,6,6,12,25,42,-17,24
SC Rheindorf,6383,7,4,5,15,15,31,-16,17
FC Salzburg,6384,1,14,6,4,41,18,23,48
SK Sturm Gra,6384,2,14,3,7,33,30,3,45
Rapid Vienna,6384,3,7,11,6,33,28,5,32
LASK Linz,6384,4,7,7,10,25,31,-6,28
Vienna,6384,5,7,6,11,24,37,-13,27
Mattersburg,6384,6,6,7,11,30,37,-7,25
SC Rheindorf,6384,7,5,8,11,22,27,-5,23
FC Salzburg,6385,1,16,6,2,47,17,30,54
SK Sturm Gra,6385,2,11,5,8,30,29,1,38
Rapid Vienna,6385,3,8,10,6,34,28,6,34
LASK Linz,6385,4,8,5,11,28,32,-4,29
Mattersburg,6385,5,7,5,12,32,42,-10,26
Vienna,6385,6,7,5,12,27,42,-15,26
SC Rheindorf,6385,7,6,6,12,21,29,-8,24
FC Salzburg,6386,1,13,7,4,45,25,20,46
SK Sturm Gra,6386,2,12,4,8,33,30,3,40
Rapid Vienna,6386,3,8,9,7,34,32,2,33
LASK Linz,6386,4,9,6,9,28,26,2,33
Mattersburg,6386,5,7,7,10,30,38,-8,28
Vienna,6386,6,7,6,11,29,40,-11,27
SC Rheindorf,6386,7,5,7,12,19,27,-8,22
FC Salzburg,6387,1,13,8,3,44,20,24,47
SK Sturm Gra,6387,2,12,4,8,32,32,0,40
Rapid Vienna,6387,3,7,11,6,36,31,5,32
LASK Linz,6387,4,8,7,9,28,28,0,31
SC Rheindorf,6387,5,7,6,11,24,29,-5,27
Mattersburg,6387,6,7,5,12,32,41,-9,26
Vienna,6387,7,7,5,12,25,40,-15,26
FC Salzburg,6388,1,15,6,3,46,20,26,51
SK Sturm Gra,6388,2,11,4,9,32,32,0,37
Rapid Vienna,6388,3,9,9,6,39,31,8,36
LASK Linz,6388,4,10,6,8,32,29,3,36
Vienna,6388,5,7,5,12,26,40,-14,26
SC Rheindorf,6388,6,6,7,11,23,27,-4,25
Mattersburg,6388,7,5,5,14,28,47,-19,20
FC Salzburg,6389,1,15,6,3,46,17,29,51
SK Sturm Gra,6389,2,12,4,8,36,32,4,40
Rapid Vienna,6389,3,9,11,4,40,29,11,38
LASK Linz,6389,4,10,6,8,33,31,2,36
Vienna,6389,5,7,5,12,27,42,-15,26
Mattersburg,6389,6,5,6,13,31,46,-15,21
SC Rheindorf,6389,7,4,6,14,17,33,-16,18
FC Salzburg,6390,1,15,7,2,44,15,29,52
SK Sturm Gra,6390,2,12,5,7,33,27,6,41
LASK Linz,6390,3,10,6,8,32,27,5,36
Rapid Vienna,6390,4,7,9,8,33,33,0,30
Vienna,6390,5,7,5,12,25,38,-13,26
SC Rheindorf,6390,6,5,8,11,21,28,-7,23
Mattersburg,6390,7,5,6,13,28,48,-20,21
FC Salzburg,6391,1,14,8,2,46,18,28,50
SK Sturm Gra,6391,2,13,4,7,34,27,7,43
Rapid Vienna,6391,3,7,11,6,31,27,4,32
LASK Linz,6391,4,7,7,10,25,31,-6,28
Vienna,6391,5,7,6,11,28,38,-10,27
SC Rheindorf,6391,6,6,6,12,19,27,-8,24
Mattersburg,6391,7,6,6,12,30,45,-15,24
FC Salzburg,6392,1,14,7,3,44,20,24,49
SK Sturm Gra,6392,2,13,4,7,33,27,6,43
Rapid Vienna,6392,3,8,12,4,38,28,10,36
LASK Linz,6392,4,7,6,11,26,32,-6,27
Vienna,6392,5,7,6,11,28,38,-10,27
SC Rheindorf,6392,6,6,6,12,23,31,-8,24
Mattersburg,6392,7,6,5,13,31,47,-16,23
FC Salzburg,6393,1,14,8,2,44,18,26,50
SK Sturm Gra,6393,2,12,4,8,31,28,3,40
LASK Linz,6393,3,8,8,8,30,28,2,32
Rapid Vienna,6393,4,7,9,8,37,36,1,30
Vienna,6393,5,7,6,11,27,39,-12,27
SC Rheindorf,6393,6,6,7,11,20,28,-8,25
Mattersburg,6393,7,5,8,11,30,42,-12,23
FC Salzburg,6394,1,14,7,3,47,21,26,49
SK Sturm Gra,6394,2,12,5,7,34,30,4,41
LASK Linz,6394,3,11,5,8,32,26,6,38
Rapid Vienna,6394,4,8,10,6,35,29,6,34
Vienna,6394,5,7,5,12,25,40,-15,26
Mattersburg,6394,6,6,5,13,30,44,-14,23
SC Rheindorf,6394,7,4,7,13,15,28,-13,19
FC Salzburg,6395,1,15,6,3,45,20,25,51
SK Sturm Gra,6395,2,13,4,7,32,27,5,43
Rapid Vienna,6395,3,8,11,5,35,26,9,35
LASK Linz,6395,4,8,5,11,26,31,-5,29
Mattersburg,6395,5,7,5,12,34,44,-10,26
Vienna,6395,6,7,5,12,26,40,-14,26
SC Rheindorf,6395,7,5,6,13,20,30,-10,21
FC Salzburg,6396,1,14,6,4,43,19,24,48
SK Sturm Gra,6396,2,13,4,7,37,32,5,43
Rapid Vienna,6396,3,10,9,5,38,28,10,39
LASK Linz,6396,4,8,6,10,29,31,-2,30
Mattersburg,6396,5,6,7,11,30,42,-12,25
Vienna,6396,6,6,6,12,25,41,-16,24
SC Rheindorf,6396,7,5,6,13,23,32,-9,21
FC Salzburg,6397,1,13,6,5,42,19,23,45
SK Sturm Gra,6397,2,13,4,7,32,27,5,43
Rapid Vienna,6397,3,10,9,5,34,24,10,39
LASK Linz,6397,4,8,7,9,28,29,-1,31
Mattersburg,6397,5,7,7,10,34,42,-8,28
Vienna,6397,6,6,6,12,26,43,-17,24
SC Rheindorf,6397,7,4,7,13,17,29,-12,19
FC Salzburg,6398,1,14,8,2,49,17,32,50
SK Sturm Gra,6398,2,12,3,9,29,31,-2,39
Rapid Vienna,6398,3,8,11,5,33,25,8,35
LASK Linz,6398,4,9,6,9,27,26,1,33
Mattersburg,6398,5,7,5,12,35,46,-11,26
Vienna,6398,6,6,6,12,25,41,-16,24
SC Rheindorf,6398,7,5,7,12,18,30,-12,22
FC Salzburg,6399,1,13,7,4,41,19,22,46
SK Sturm Gra,6399,2,14,3,7,32,27,5,45
Rapid Vienna,6399,3,7,11,6,34,28,6,32
LASK Linz,6399,4,8,7,9,27,27,0,31
Vienna,6399,5,7,6,11,27,40,-13,27
SC Rheindorf,6399,6,6,7,11,20,27,-7,25
Mattersburg,6399,7,5,7,12,29,42,-13,22
FC Salzburg,6400,1,15,7,2,46,16,30,52
SK Sturm Gra,6400,2,13,4,7,31,29,2,43
Rapid Vienna,6400,3,9,9,6,37,27,10,36
LASK Linz,6400,4,8,6,10,27,32,-5,30
Mattersburg,6400,5,7,6,11,29,38,-9,27
Vienna,6400,6,6,6,12,24,39,-15,24
SC Rheindorf,6400,7,4,6,14,15,28,-13,18
FC Salzburg,6401,1,14,8,2,45,20,25,50
SK Sturm Gra,6401,2,12,6,6,34,29,5,42
Rapid Vienna,6401,3,8,10,6,36,29,7,34
LASK Linz,6401,4,8,5,11,30,33,-3,29
Mattersburg,6401,5,7,6,11,33,41,-8,27
Vienna,6401,6,7,5,12,25,39,-14,26
SC Rheindorf,6401,7,5,6,13,19,31,-12,21
FC Salzburg,6402,1,14,7,3,50,21,29,49
Rapid Vienna,6402,2,10,10,4,39,25,14,40
SK Sturm Gra,6402,3,11,5,8,32,33,-1,38
LASK Linz,6402,4,8,7,9,25,28,-3,31
Mattersburg,6402,5,7,5,12,31,43,-12,26
Vienna,6402,6,7,5,12,26,41,-15,26
SC Rheindorf,6402,7,5,5,14,18,30,-12,20
FC Salzburg,6403,1,14,6,4,47,22,25,48
SK Sturm Gra,6403,2,13,4,7,31,31,0,43
Rapid Vienna,6403,3,10,10,4,41,27,14,40
LASK Linz,6403,4,8,5,11,30,30,0,29
Mattersburg,6403,5,7,5,12,31,44,-13,26
Vienna,6403,6,7,5,12,26,40,-14,26
SC Rheindorf,6403,7,5,5,14,19,31,-12,20
FC Salzburg,6404,1,16,6,2,50,18,32,54
SK Sturm Gra,6404,2,12,3,9,30,30,0,39
Rapid Vienna,6404,3,8,10,6,34,27,7,34
LASK Linz,6404,4,7,6,11,24,32,-8,27
SC Rheindorf,6404,5,7,5,12,21,27,-6,26
Mattersburg,6404,6,7,5,12,32,42,-10,26
Vienna,6404,7,7,5,12,28,43,-15,26
FC Salzburg,6405,1,14,7,3,43,20,23,49
SK Sturm Gra,6405,2,14,3,7,34,26,8,45
Rapid Vienna,6405,3,9,9,6,37,30,7,36
LASK Linz,6405,4,9,5,10,28,28,0,32
Vienna,6405,5,7,5,12,25,39,-14,26
Mattersburg,6405,6,5,7,12,29,41,-12,22
SC Rheindorf,6405,7,5,6,13,19,31,-12,21
FC Salzburg,6406,1,14,7,3,46,21,25,49
SK Sturm Gra,6406,2,13,3,8,36,30,6,42
Rapid Vienna,6406,3,8,9,7,34,29,5,33
LASK Linz,6406,4,8,6,10,27,31,-4,30
Vienna,6406,5,7,6,11,28,40,-12,27
SC Rheindorf,6406,6,6,7,11,20,28,-8,25
Mattersburg,6406,7,6,6,12,32,44,-12,24
FC Salzburg,6407,1,12,7,5,40,24,16,43
SK Sturm Gra,6407,2,13,4,7,34,28,6,43
LASK Linz,6407,3,11,5,8,31,26,5,38
Rapid Vienna,6407,4,7,12,5,32,26,6,33
Mattersburg,6407,5,7,6,11,33,40,-7,27
Vienna,6407,6,7,6,11,27,38,-11,27
SC Rheindorf,6407,7,4,6,14,16,31,-15,18
FC Salzburg,6408,1,15,6,3,48,21,27,51
SK Sturm Gra,6408,2,13,3,8,33,30,3,42
Rapid Vienna,6408,3,9,9,6,36,29,7,36
LASK Linz,6408,4,10,5,9,28,27,1,35
Vienna,6408,5,6,6,12,25,40,-15,24
SC Rheindorf,6408,6,6,5,13,20,29,-9,23
Mattersburg,6408,7,5,6,13,27,41,-14,21
FC Salzburg,6409,1,15,6,3,47,20,27,51
SK Sturm Gra,6409,2,12,4,8,33,31,2,40
Rapid Vienna,6409,3,9,11,4,39,27,12,38
LASK Linz,6409,4,8,7,9,28,28,0,31
Vienna,6409,5,7,5,12,26,40,-14,26
Mattersburg,6409,6,6,5,13,30,46,-16,23
SC Rheindorf,6409,7,5,6,13,21,32,-11,21
FC Salzburg,6410,1,15,6,3,46,19,27,51
SK Sturm Gra,6410,2,14,3,7,41,33,8,45
Rapid Vienna,6410,3,8,9,7,36,28,8,33
Vienna,6410,4,8,5,11,26,38,-12,29
LASK Linz,6410,5,7,7,10,25,32,-7,28
Mattersburg,6410,6,6,6,12,32,42,-10,24
SC Rheindorf,6410,7,5,6,13,18,32,-14,21
FC Salzburg,6411,1,16,6,2,49,16,33,54
SK Sturm Gra,6411,2,12,4,8,31,31,0,40
Rapid Vienna,6411,3,7,11,6,34,29,5,32
LASK Linz,6411,4,7,7,10,26,31,-5,28
SC Rheindorf,6411,5,6,7,11,22,28,-6,25
Mattersburg,6411,6,6,7,11,31,42,-11,25
Vienna,6411,7,6,6,12,24,40,-16,24
FC Salzburg,6412,1,14,7,3,47,19,28,49
SK Sturm Gra,6412,2,12,3,9,34,32,2,39
Rapid Vienna,6412,3,8,11,5,36,28,8,35
LASK Linz,6412,4,9,5,10,27,29,-2,32
Vienna,6412,5,7,5,12,24,41,-17,26
SC Rheindorf,6412,6,6,7,11,20,27,-7,25
Mattersburg,6412,7,6,6,12,27,39,-12,24
FC Salzburg,6413,1,14,6,4,43,23,20,48
SK Sturm Gra,6413,2,12,5,7,32,28,4,41
Rapid Vienna,6413,3,9,10,5,37,27,10,37
LASK Linz,6413,4,7,7,10,25,29,-4,28
Vienna,6413,5,7,5,12,24,38,-14,26
Mattersburg,6413,6,6,7,11,32,40,-8,25
SC Rheindorf,6413,7,6,6,12,21,29,-8,24
FC Salzburg,6414,1,13,7,4,44,25,19,46
SK Sturm Gra,6414,2,12,5,7,33,29,4,41
Rapid Vienna,6414,3,9,9,6,36,26,10,36
LASK Linz,6414,4,8,8,8,24,24,0,32
Vienna,6414,5,7,6,11,26,38,-12,27
Mattersburg,6414,6,6,7,11,31,41,-10,25
SC Rheindorf,6414,7,5,6,13,19,30,-11,21
FC Salzburg,6415,1,15,6,3,46,20,26,51
SK Sturm Gra,6415,2,12,4,8,30,33,-3,40
Rapid Vienna,6415,3,8,11,5,35,27,8,35
LASK Linz,6415,4,7,7,10,26,29,-3,28
Vienna,6415,5,7,5,12,25,38,-13,26
Mattersburg,6415,6,6,7,11,33,44,-11,25
SC Rheindorf,6415,7,6,6,12,23,27,-4,24
FC Salzburg,6416,1,15,7,2,41,15,26,52
SK Sturm Gra,6416,2,13,3,8,32,30,2,42
Rapid Vienna,6416,3,10,10,4,39,25,14,40
LASK Linz,6416,4,7,7,10,28,31,-3,28
Vienna,6416,5,7,5,12,27,39,-12,26
Mattersburg,6416,6,6,6,12,31,44,-13,24
SC Rheindorf,6416,7,4,6,14,17,31,-14,18
FC Salzburg,6417,1,13,7,4,45,21,24,46
SK Sturm Gra,6417,2,14,3,7,32,28,4,45
Rapid Vienna,6417,3,9,10,5,38,28,10,37
LASK Linz,6417,4,8,5,11,25,29,-4,29
Mattersburg,6417,5,8,5,11,33,42,-9,29
SC Rheindorf,6417,6,6,5,13,21,28,-7,23
Vienna,6417,7,6,5,13,24,42,-18,23
FC Salzburg,6418,1,15,6,3,46,21,25,51
SK Sturm Gra,6418,2,13,3,8,33,27,6,42
Rapid Vienna,6418,3,9,9,6,37,28,9,36
LASK Linz,6418,4,7,6,11,28,35,-7,27
Vienna,6418,5,7,6,11,27,39,-12,27
Mattersburg,6418,6,6,7,11,33,43,-10,25
SC Rheindorf,6418,7,6,5,13,20,31,-11,23
FC Salzburg,6419,1,15,7,2,47,19,28,52
SK Sturm Gra,6419,2,12,4,8,33,29,4,40
Rapid Vienna,6419,3,8,10,6,34,27,7,34
LASK Linz,6419,4,9,7,8,28,27,1,34
Mattersburg,6419,5,7,6,11,31,40,-9,27
Vienna,6419,6,6,5,13,23,41,-18,23
SC Rheindorf,6419,7,4,7,13,16,29,-13,19
FC Salzburg,6420,1,14,7,3,41,16,25,49
SK Sturm Gra,6420,2,13,4,7,32,26,6,43
Rapid Vienna,6420,3,8,9,7,35,29,6,33
LASK Linz,6420,4,9,6,9,30,31,-1,33
Mattersburg,6420,5,7,6,11,31,41,-10,27
Vienna,6420,6,6,6,12,24,39,-15,24
SC Rheindorf,6420,7,5,6,13,21,32,-11,21
FC Salzburg,6421,1,16,6,2,46,15,31,54
SK Sturm Gra,6421,2,14,3,7,35,26,9,45
Rapid Vienna,6421,3,8,10,6,34,28,6,34
Mattersburg,6421,4,8,5,11,36,42,-6,29
LASK Linz,6421,5,7,6,11,27,33,-6,27
Vienna,6421,6,6,5,13,24,45,-21,23
SC Rheindorf,6421,7,4,7,13,17,30,-13,19
FC Salzburg,6422,1,15,6,3,45,17,28,51
SK Sturm Gra,6422,2,11,5,8,30,29,1,38
Rapid Vienna,6422,3,9,9,6,36,32,4,36
Mattersburg,6422,4,8,6,10,33,38,-5,30
LASK Linz,6422,5,7,6,11,26,33,-7,27
SC Rheindorf,6422,6,6,6,12,22,28,-6,24
Vienna,6422,7,6,6,12,23,38,-15,24
SK Sturm Gra,6423,1,15,3,6,39,27,12,48
FC Salzburg,6423,2,13,7,4,44,24,20,46
Rapid Vienna,6423,3,8,10,6,36,30,6,34
LASK Linz,6423,4,9,5,10,29,30,-1,32
Mattersburg,6423,5,7,5,12,31,40,-9,26
Vienna,6423,6,7,5,12,25,39,-14,26
SC Rheindorf,6423,7,5,5,14,16,30,-14,20
FC Salzburg,6424,1,14,8,2,46,18,28,50
SK Sturm Gra,6424,2,11,4,9,32,31,1,37
Rapid Vienna,6424,3,8,11,5,35,29,6,35
LASK Linz,6424,4,9,7,8,29,26,3,34
Vienna,6424,5,6,6,12,25,40,-15,24
SC Rheindorf,6424,6,5,8,11,18,27,-9,23
Mattersburg,6424,7,5,8,11,28,42,-14,23
FC Salzburg,6425,1,14,8,2,44,15,29,50
Rapid Vienna,6425,2,9,10,5,38,26,12,37
SK Sturm Gra,6425,3,11,4,9,30,35,-5,37
LASK Linz,6425,4,8,7,9,28,29,-1,31
Mattersburg,6425,5,6,7,11,30,40,-10,25
Vienna,6425,6,6,7,11,24,38,-14,25
SC Rheindorf,6425,7,6,5,13,22,33,-11,23
FC Salzburg,6426,1,14,8,2,43,17,26,50
SK Sturm Gra,6426,2,13,4,7,35,26,9,43
Rapid Vienna,6426,3,9,10,5,37,29,8,37
LASK Linz,6426,4,7,8,9,25,27,-2,29
Mattersburg,6426,5,6,7,11,32,41,-9,25
Vienna,6426,6,6,7,11,24,38,-14,25
SC Rheindorf,6426,7,4,6,14,17,35,-18,18
FC Salzburg,6427,1,16,6,2,47,17,30,54
SK Sturm Gra,6427,2,11,5,8,31,30,1,38
Rapid Vienna,6427,3,8,11,5,35,28,7,35
LASK Linz,6427,4,7,8,9,27,29,-2,29
Vienna,6427,5,7,5,12,27,39,-12,26
Mattersburg,6427,6,6,6,12,30,43,-13,24
SC Rheindorf,6427,7,5,7,12,19,30,-11,22
FC Salzburg,6428,1,14,8,2,44,17,27,50
SK Sturm Gra,6428,2,12,5,7,33,27,6,41
Rapid Vienna,6428,3,8,9,7,34,30,4,33
LASK Linz,6428,4,8,6,10,29,31,-2,30
Vienna,6428,5,7,6,11,26,39,-13,27
SC Rheindorf,6428,6,6,6,12,18,28,-10,24
Mattersburg,6428,7,6,6,12,30,42,-12,24
FC Salzburg,6429,1,13,8,3,40,18,22,47
SK Sturm Gra,6429,2,13,5,6,34,27,7,44
Rapid Vienna,6429,3,9,10,5,35,26,9,37
LASK Linz,6429,4,7,5,12,25,30,-5,26
Mattersburg,6429,5,6,7,11,31,42,-11,25
Vienna,6429,6,6,7,11,25,39,-14,25
SC Rheindorf,6429,7,6,6,12,20,28,-8,24
FC Salzburg,6430,1,13,8,3,41,18,23,47
SK Sturm Gra,6430,2,13,4,7,33,27,6,43
Rapid Vienna,6430,3,8,9,7,37,30,7,33
LASK Linz,6430,4,9,6,9,32,31,1,33
Mattersburg,6430,5,6,8,10,30,39,-9,26
Vienna,6430,6,6,7,11,25,39,-14,25
SC Rheindorf,6430,7,5,6,13,18,32,-14,21
FC Salzburg,6431,1,14,6,4,42,20,22,48
Rapid Vienna,6431,2,10,10,4,41,27,14,40
SK Sturm Gra,6431,3,12,4,8,34,32,2,40
LASK Linz,6431,4,8,6,10,28,27,1,30
Vienna,6431,5,7,5,12,25,39,-14,26
Mattersburg,6431,6,6,6,12,28,40,-12,24
SC Rheindorf,6431,7,6,5,13,17,30,-13,23
FC Salzburg,6432,1,15,7,2,46,18,28,52
SK Sturm Gra,6432,2,12,4,8,30,27,3,40
Rapid Vienna,6432,3,9,11,4,40,27,13,38
LASK Linz,6432,4,9,6,9,28,29,-1,33
Vienna,6432,5,7,5,12,25,39,-14,26
SC Rheindorf,6432,6,5,6,13,19,30,-11,21
Mattersburg,6432,7,5,5,14,26,44,-18,20
FC Salzburg,6433,1,14,7,3,45,18,27,49
SK Sturm Gra,6433,2,13,4,7,34,26,8,43
Rapid Vienna,6433,3,10,10,4,36,24,12,40
Mattersburg,6433,4,8,5,11,34,43,-9,29
LASK Linz,6433,5,7,6,11,24,31,-7,27
Vienna,6433,6,6,5,13,24,40,-16,23
SC Rheindorf,6433,7,4,7,13,16,31,-15,19
FC Salzburg,6434,1,15,6,3,51,23,28,51
Rapid Vienna,6434,2,10,10,4,38,27,11,40
SK Sturm Gra,6434,3,12,4,8,32,29,3,40
LASK Linz,6434,4,7,6,11,25,31,-6,27
Mattersburg,6434,5,7,5,12,35,44,-9,26
Vienna,6434,6,7,5,12,28,43,-15,26
SC Rheindorf,6434,7,5,6,13,17,29,-12,21
FC Salzburg,6435,1,12,7,5,41,21,20,43
SK Sturm Gra,6435,2,12,4,8,30,28,2,40
Rapid Vienna,6435,3,10,9,5,37,27,10,39
LASK Linz,6435,4,9,5,10,29,31,-2,32
Mattersburg,6435,5,9,5,10,39,42,-3,32
Vienna,6435,6,6,6,12,25,40,-15,24
SC Rheindorf,6435,7,5,6,13,21,33,-12,21
FC Salzburg,6436,1,14,7,3,44,19,25,49
SK Sturm Gra,6436,2,13,4,7,35,31,4,43
Rapid Vienna,6436,3,9,11,4,41,28,13,38
LASK Linz,6436,4,8,5,11,28,34,-6,29
Vienna,6436,5,7,5,12,26,40,-14,26
SC Rheindorf,6436,6,6,5,13,18,28,-10,23
Mattersburg,6436,7,6,5,13,30,42,-12,23
FC Salzburg,6437,1,15,6,3,49,19,30,51
SK Sturm Gra,6437,2,12,3,9,31,29,2,39
Rapid Vienna,6437,3,8,10,6,35,28,7,34
LASK Linz,6437,4,9,6,9,27,30,-3,33
Mattersburg,6437,5,7,6,11,35,42,-7,27
SC Rheindorf,6437,6,5,8,11,19,28,-9,23
Vienna,6437,7,6,5,13,25,45,-20,23
FC Salzburg,6438,1,16,6,2,49,18,31,54
Rapid Vienna,6438,2,10,9,5,39,31,8,39
SK Sturm Gra,6438,3,11,4,9,31,30,1,37
LASK Linz,6438,4,8,5,11,27,30,-3,29
Mattersburg,6438,5,7,6,11,34,44,-10,27
Vienna,6438,6,6,5,13,24,40,-16,23
SC Rheindorf,6438,7,5,7,12,20,31,-11,22
FC Salzburg,6439,1,14,8,2,45,18,27,50
SK Sturm Gra,6439,2,11,5,8,30,29,1,38
Rapid Vienna,6439,3,8,11,5,37,30,7,35
LASK Linz,6439,4,8,7,9,25,29,-4,31
SC Rheindorf,6439,5,6,7,11,24,27,-3,25
Mattersburg,6439,6,6,7,11,29,39,-10,25
Vienna,6439,7,6,5,13,23,41,-18,23
FC Salzburg,6440,1,14,7,3,48,22,26,49
SK Sturm Gra,6440,2,13,4,7,36,30,6,43
Rapid Vienna,6440,3,9,10,5,37,28,9,37
LASK Linz,6440,4,7,6,11,25,32,-7,27
Vienna,6440,5,7,6,11,28,39,-11,27
Mattersburg,6440,6,7,5,12,33,44,-11,26
SC Rheindorf,6440,7,4,8,12,19,31,-12,20
FC Salzburg,6441,1,14,7,3,46,16,30,49
SK Sturm Gra,6441,2,12,4,8,33,30,3,40
Rapid Vienna,6441,3,8,11,5,35,29,6,35
LASK Linz,6441,4,10,5,9,30,29,1,35
Mattersburg,6441,5,7,6,11,31,39,-8,27
Vienna,6441,6,6,5,13,24,44,-20,23
SC Rheindorf,6441,7,5,6,13,16,28,-12,21
FC Salzburg,6442,1,15,7,2,45,18,27,52
SK Sturm Gra,6442,2,12,5,7,36,32,4,41
Rapid Vienna,6442,3,8,12,4,35,25,10,36
LASK Linz,6442,4,9,7,8,28,27,1,34
Vienna,6442,5,7,5,12,26,41,-15,26
SC Rheindorf,6442,6,5,5,14,19,31,-12,20
Mattersburg,6442,7,5,5,14,31,46,-15,20
FC Salzburg,6443,1,14,6,4,44,21,23,48
SK Sturm Gra,6443,2,11,5,8,31,30,1,38
Rapid Vienna,6443,3,8,10,6,35,29,6,34
LASK Linz,6443,4,8,6,10,27,31,-4,30
SC Rheindorf,6443,5,8,5,11,22,27,-5,29
Vienna,6443,6,8,5,11,28,38,-10,29
Mattersburg,6443,7,6,5,13,29,40,-11,23
FC Salzburg,6444,1,16,6,2,48,18,30,54
SK Sturm Gra,6444,2,12,3,9,29,30,-1,39
Rapid Vienna,6444,3,8,11,5,35,27,8,35
LASK Linz,6444,4,8,7,9,27,27,0,31
Mattersburg,6444,5,7,5,12,34,44,-10,26
Vienna,6444,6,7,5,12,28,43,-15,26
SC Rheindorf,6444,7,4,7,13,17,29,-12,19
FC Salzburg,6445,1,15,6,3,46,21,25,51
SK Sturm Gra,6445,2,12,4,8,35,29,6,40
Rapid Vienna,6445,3,9,10,5,42,32,10,37
LASK Linz,6445,4,7,9,8,26,27,-1,30
Vienna,6445,5,7,6,11,25,37,-12,27
Mattersburg,6445,6,5,8,11,28,40,-12,23
SC Rheindorf,6445,7,4,7,13,19,35,-16,19
FC Salzburg,6446,1,14,7,3,44,18,26,49
SK Sturm Gra,6446,2,12,3,9,30,32,-2,39
Rapid Vienna,6446,3,9,9,6,35,27,8,36
LASK Linz,6446,4,9,6,9,28,27,1,33
Vienna,6446,5,7,6,11,25,38,-13,27
SC Rheindorf,6446,6,6,6,12,24,29,-5,24
Mattersburg,6446,7,6,5,13,30,45,-15,23
FC Salzburg,6447,1,14,8,2,41,15,26,50
SK Sturm Gra,6447,2,11,5,8,30,28,2,38
Rapid Vienna,6447,3,9,10,5,35,27,8,37
LASK Linz,6447,4,8,6,10,27,29,-2,30
Mattersburg,6447,5,7,5,12,30,41,-11,26
Vienna,6447,6,7,5,12,25,38,-13,26
SC Rheindorf,6447,7,6,5,13,21,31,-10,23
FC Salzburg,6448,1,14,7,3,42,18,24,49
SK Sturm Gra,6448,2,12,4,8,30,28,2,40
Rapid Vienna,6448,3,7,11,6,34,29,5,32
LASK Linz,6448,4,8,6,10,26,27,-1,30
Mattersburg,6448,5,7,7,10,30,37,-7,28
SC Rheindorf,6448,6,6,7,11,21,28,-7,25
Vienna,6448,7,6,6,12,24,40,-16,24
FC Salzburg,6449,1,14,7,3,48,20,28,49
SK Sturm Gra,6449,2,12,4,8,32,32,0,40
Rapid Vienna,6449,3,8,11,5,39,28,11,35
LASK Linz,6449,4,9,5,10,28,30,-2,32
Vienna,6449,5,8,5,11,28,40,-12,29
Mattersburg,6449,6,6,5,13,32,42,-10,23
SC Rheindorf,6449,7,6,5,13,19,34,-15,23
FC Salzburg,6450,1,14,8,2,45,19,26,50
SK Sturm Gra,6450,2,11,6,7,32,30,2,39
Rapid Vienna,6450,3,9,9,6,39,31,8,36
LASK Linz,6450,4,7,6,11,26,31,-5,27
SC Rheindorf,6450,5,7,6,11,22,27,-5,27
Vienna,6450,6,6,7,11,25,39,-14,25
Mattersburg,6450,7,6,6,12,29,41,-12,24
FC Salzburg,6451,1,14,7,3,44,19,25,49
Rapid Vienna,6451,2,9,11,4,37,27,10,38
SK Sturm Gra,6451,3,11,4,9,29,29,0,37
LASK Linz,6451,4,9,7,8,30,28,2,34
SC Rheindorf,6451,5,6,6,12,22,31,-9,24
Vienna,6451,6,6,6,12,26,42,-16,24
Mattersburg,6451,7,5,7,12,32,44,-12,22
FC Salzburg,6452,1,14,8,2,50,23,27,50
Rapid Vienna,6452,2,10,10,4,37,25,12,40
SK Sturm Gra,6452,3,12,4,8,32,29,3,40
LASK Linz,6452,4,8,6,10,26,28,-2,30
Vienna,6452,5,7,5,12,29,43,-14,26
Mattersburg,6452,6,5,7,12,30,44,-14,22
SC Rheindorf,6452,7,5,6,13,17,29,-12,21
FC Salzburg,6453,1,14,7,3,51,23,28,49
SK Sturm Gra,6453,2,13,4,7,34,27,7,43
Rapid Vienna,6453,3,9,10,5,38,30,8,37
LASK Linz,6453,4,8,5,11,27,30,-3,29
Vienna,6453,5,7,5,12,27,41,-14,26
SC Rheindorf,6453,6,6,6,12,22,31,-9,24
Mattersburg,6453,7,6,5,13,31,48,-17,23
FC Salzburg,6454,1,15,7,2,44,17,27,52
SK Sturm Gra,6454,2,13,4,7,34,28,6,43
Rapid Vienna,6454,3,9,9,6,36,28,8,36
LASK Linz,6454,4,7,7,10,31,35,-4,28
Mattersburg,6454,5,6,6,12,31,42,-11,24
Vienna,6454,6,6,6,12,25,40,-15,24
SC Rheindorf,6454,7,6,5,13,21,32,-11,23
FC Salzburg,6455,1,15,7,2,44,18,26,52
SK Sturm Gra,6455,2,12,5,7,33,31,2,41
Rapid Vienna,6455,3,8,10,6,35,28,7,34
LASK Linz,6455,4,7,8,9,27,29,-2,29
Mattersburg,6455,5,7,6,11,32,40,-8,27
SC Rheindorf,6455,6,6,5,13,19,28,-9,23
Vienna,6455,7,6,5,13,24,40,-16,23
FC Salzburg,6456,1,14,8,2,49,18,31,50
SK Sturm Gra,6456,2,11,5,8,31,32,-1,38
LASK Linz,6456,3,9,7,8,29,27,2,34
Rapid Vienna,6456,4,7,10,7,33,35,-2,31
Mattersburg,6456,5,6,8,10,32,41,-9,26
Vienna,6456,6,6,7,11,26,40,-14,25
SC Rheindorf,6456,7,6,5,13,23,30,-7,23
FC Salzburg,6457,1,13,7,4,46,23,23,46
SK Sturm Gra,6457,2,11,3,10,32,35,-3,36
Rapid Vienna,6457,3,8,10,6,38,30,8,34
LASK Linz,6457,4,9,5,10,27,29,-2,32
Mattersburg,6457,5,8,6,10,34,40,-6,30
SC Rheindorf,6457,6,7,6,11,24,29,-5,27
Vienna,6457,7,7,5,12,25,40,-15,26
FC Salzburg,6458,1,13,7,4,42,19,23,46
SK Sturm Gra,6458,2,13,4,7,34,27,7,43
Rapid Vienna,6458,3,8,9,7,36,32,4,33
LASK Linz,6458,4,9,5,10,25,27,-2,32
Mattersburg,6458,5,9,5,10,34,40,-6,32
Vienna,6458,6,6,6,12,27,42,-15,24
SC Rheindorf,6458,7,5,6,13,21,32,-11,21
FC Salzburg,6459,1,13,8,3,45,21,24,47
SK Sturm Gra,6459,2,12,6,6,31,26,5,42
Rapid Vienna,6459,3,8,12,4,35,24,11,36
LASK Linz,6459,4,7,6,11,24,28,-4,27
Vienna,6459,5,7,6,11,27,40,-13,27
SC Rheindorf,6459,6,6,7,11,21,29,-8,25
Mattersburg,6459,7,6,5,13,29,44,-15,23
FC Salzburg,6460,1,15,6,3,45,19,26,51
SK Sturm Gra,6460,2,14,3,7,37,27,10,45
LASK Linz,6460,3,10,6,8,29,26,3,36
Rapid Vienna,6460,4,7,11,6,34,30,4,32
Mattersburg,6460,5,7,5,12,32,42,-10,26
Vienna,6460,6,6,5,13,25,42,-17,23
SC Rheindorf,6460,7,4,6,14,17,33,-16,18
FC Salzburg,6461,1,15,6,3,48,19,29,51
SK Sturm Gra,6461,2,14,3,7,35,28,7,45
Rapid Vienna,6461,3,10,9,5,34,24,10,39
LASK Linz,6461,4,7,6,11,25,32,-7,27
Mattersburg,6461,5,7,5,12,30,42,-12,26
Vienna,6461,6,7,5,12,30,43,-13,26
SC Rheindorf,6461,7,4,6,14,16,30,-14,18
FC Salzburg,6462,1,15,6,3,52,20,32,51
SK Sturm Gra,6462,2,12,5,7,34,31,3,41
Rapid Vienna,6462,3,8,11,5,35,26,9,35
LASK Linz,6462,4,7,6,11,24,30,-6,27
Vienna,6462,5,7,6,11,27,40,-13,27
Mattersburg,6462,6,6,7,11,32,46,-14,25
SC Rheindorf,6462,7,5,7,12,20,31,-11,22
FC Salzburg,6463,1,14,7,3,44,19,25,49
Rapid Vienna,6463,2,11,9,4,41,26,15,42
SK Sturm Gra,6463,3,11,4,9,33,33,0,37
Mattersburg,6463,4,8,6,10,37,39,-2,30
LASK Linz,6463,5,7,7,10,25,29,-4,28
Vienna,6463,6,6,5,13,26,44,-18,23
SC Rheindorf,6463,7,5,6,13,21,37,-16,21
FC Salzburg,6464,1,13,8,3,47,20,27,47
SK Sturm Gra,6464,2,13,3,8,31,27,4,42
Rapid Vienna,6464,3,9,11,4,38,28,10,38
LASK Linz,6464,4,8,7,9,28,29,-1,31
Mattersburg,6464,5,8,5,11,39,44,-5,29
Vienna,6464,6,6,6,12,26,46,-20,24
SC Rheindorf,6464,7,4,6,14,17,32,-15,18
FC Salzburg,6465,1,14,6,4,47,21,26,48
SK Sturm Gra,6465,2,13,4,7,31,25,6,43
Rapid Vienna,6465,3,8,10,6,33,31,2,34
LASK Linz,6465,4,8,6,10,28,29,-1,30
Vienna,6465,5,7,6,11,27,40,-13,27
Mattersburg,6465,6,6,7,11,34,42,-8,25
SC Rheindorf,6465,7,6,5,13,19,31,-12,23
FC Salzburg,6466,1,15,6,3,49,18,31,51
SK Sturm Gra,6466,2,11,4,9,29,30,-1,37
Rapid Vienna,6466,3,7,11,6,32,29,3,32
LASK Linz,6466,4,9,5,10,32,33,-1,32
Vienna,6466,5,8,5,11,27,38,-11,29
Mattersburg,6466,6,7,5,12,33,45,-12,26
SC Rheindorf,6466,7,6,6,12,20,29,-9,24
FC Salzburg,6467,1,13,8,3,43,18,25,47
SK Sturm Gra,6467,2,12,5,7,32,29,3,41
Rapid Vienna,6467,3,8,11,5,36,28,8,35
LASK Linz,6467,4,8,6,10,27,30,-3,30
Vienna,6467,5,8,5,11,25,37,-12,29
Mattersburg,6467,6,7,5,12,33,41,-8,26
SC Rheindorf,6467,7,4,8,12,17,30,-13,20
FC Salzburg,6468,1,15,7,2,48,21,27,52
Rapid Vienna,6468,2,9,10,5,39,27,12,37
SK Sturm Gra,6468,3,11,4,9,31,33,-2,37
LASK Linz,6468,4,9,6,9,30,29,1,33
Vienna,6468,5,7,5,12,25,40,-15,26
Mattersburg,6468,6,6,6,12,30,42,-12,24
SC Rheindorf,6468,7,4,8,12,19,30,-11,20
FC Salzburg,6469,1,14,7,3,44,19,25,49
SK Sturm Gra,6469,2,13,4,7,35,28,7,43
Rapid Vienna,6469,3,9,9,6,35,27,8,36
LASK Linz,6469,4,8,6,10,26,29,-3,30
Vienna,6469,5,7,5,12,28,38,-10,26
Mattersburg,6469,6,7,5,12,30,45,-15,26
SC Rheindorf,6469,7,5,6,13,18,30,-12,21
FC Salzburg,6470,1,14,7,3,49,21,28,49
SK Sturm Gra,6470,2,13,3,8,36,34,2,42
Rapid Vienna,6470,3,10,9,5,39,28,11,39
LASK Linz,6470,4,7,7,10,26,29,-3,28
Mattersburg,6470,5,6,7,11,32,40,-8,25
SC Rheindorf,6470,6,6,6,12,23,32,-9,24
Vienna,6470,7,6,5,13,24,45,-21,23
FC Salzburg,6471,1,13,7,4,46,24,22,46
SK Sturm Gra,6471,2,12,4,8,32,30,2,40
Rapid Vienna,6471,3,9,9,6,38,29,9,36
LASK Linz,6471,4,9,6,9,28,29,-1,33
Vienna,6471,5,8,5,11,27,39,-12,29
SC Rheindorf,6471,6,7,5,12,22,29,-7,26
Mattersburg,6471,7,5,6,13,30,43,-13,21
FC Salzburg,6472,1,16,6,2,48,16,32,54
SK Sturm Gra,6472,2,12,4,8,31,30,1,40
LASK Linz,6472,3,10,6,8,32,26,6,36
Rapid Vienna,6472,4,8,9,7,34,31,3,33
Vienna,6472,5,7,5,12,28,42,-14,26
Mattersburg,6472,6,5,6,13,29,45,-16,21
SC Rheindorf,6472,7,4,8,12,18,30,-12,20
FC Salzburg,6473,1,15,6,3,43,18,25,51
Rapid Vienna,6473,2,9,11,4,38,27,11,38
SK Sturm Gra,6473,3,11,5,8,31,29,2,38
LASK Linz,6473,4,7,7,10,26,30,-4,28
Vienna,6473,5,7,5,12,25,39,-14,26
Mattersburg,6473,6,6,6,12,27,39,-12,24
SC Rheindorf,6473,7,5,8,11,18,26,-8,23
FC Salzburg,6474,1,14,8,2,45,18,27,50
SK Sturm Gra,6474,2,12,4,8,31,28,3,40
Rapid Vienna,6474,3,9,11,4,38,27,11,38
LASK Linz,6474,4,9,6,9,28,28,0,33
Vienna,6474,5,7,5,12,26,42,-16,26
Mattersburg,6474,6,6,5,13,30,42,-12,23
SC Rheindorf,6474,7,5,5,14,17,30,-13,20
FC Salzburg,6475,1,15,7,2,44,17,27,52
SK Sturm Gra,6475,2,12,4,8,30,27,3,40
Rapid Vienna,6475,3,8,10,6,37,30,7,34
Mattersburg,6475,4,8,5,11,33,39,-6,29
LASK Linz,6475,5,8,5,11,25,31,-6,29
Vienna,6475,6,6,6,12,23,39,-16,24
SC Rheindorf,6475,7,6,5,13,19,28,-9,23
FC Salzburg,6476,1,15,6,3,46,20,26,51
Rapid Vienna,6476,2,10,10,4,39,25,14,40
SK Sturm Gra,6476,3,12,4,8,32,32,0,40
Mattersburg,6476,4,8,5,11,31,39,-8,29
LASK Linz,6476,5,7,5,12,27,32,-5,26
SC Rheindorf,6476,6,6,5,13,22,33,-11,23
Vienna,6476,7,6,5,13,23,39,-16,23
FC Salzburg,6477,1,14,6,4,44,18,26,48
SK Sturm Gra,6477,2,13,5,6,33,27,6,44
Rapid Vienna,6477,3,9,11,4,39,28,11,38
LASK Linz,6477,4,8,6,10,26,29,-3,30
Mattersburg,6477,5,7,6,11,31,41,-10,27
Vienna,6477,6,6,6,12,25,40,-15,24
SC Rheindorf,6477,7,4,6,14,17,32,-15,18
FC Salzburg,6478,1,15,7,2,44,15,29,52
SK Sturm Gra,6478,2,11,5,8,30,28,2,38
Rapid Vienna,6478,3,9,9,6,33,27,6,36
LASK Linz,6478,4,7,6,11,26,34,-8,27
Mattersburg,6478,5,7,6,11,31,40,-9,27
Vienna,6478,6,7,5,12,26,40,-14,26
SC Rheindorf,6478,7,6,6,12,22,28,-6,24
FC Salzburg,6479,1,15,7,2,50,18,32,52
SK Sturm Gra,6479,2,13,3,8,36,29,7,42
Rapid Vienna,6479,3,8,9,7,35,32,3,33
LASK Linz,6479,4,8,6,10,28,33,-5,30
Mattersburg,6479,5,6,7,11,34,47,-13,25
Vienna,6479,6,6,7,11,25,39,-14,25
SC Rheindorf,6479,7,5,7,12,17,27,-10,22
FC Salzburg,6480,1,14,8,2,45,19,26,50
SK Sturm Gra,6480,2,12,5,7,31,26,5,41
Rapid Vienna,6480,3,7,11,6,34,29,5,32
LASK Linz,6480,4,8,5,11,25,31,-6,29
SC Rheindorf,6480,5,6,7,11,22,28,-6,25
Mattersburg,6480,6,6,7,11,34,44,-10,25
Vienna,6480,7,6,7,11,26,40,-14,25
FC Salzburg,6481,1,15,7,2,48,19,29,52
SK Sturm Gra,6481,2,12,6,6,34,28,6,42
Rapid Vienna,6481,3,9,9,6,40,30,10,36
LASK Linz,6481,4,7,7,10,25,30,-5,28
SC Rheindorf,6481,5,6,6,12,19,30,-11,24
Mattersburg,6481,6,6,6,12,29,42,-13,24
Vienna,6481,7,6,5,13,24,40,-16,23
FC Salzburg,6482,1,15,7,2,48,17,31,52
SK Sturm Gra,6482,2,12,5,7,36,32,4,41
Rapid Vienna,6482,3,8,12,4,39,30,9,36
LASK Linz,6482,4,7,7,10,30,34,-4,28
Vienna,6482,5,7,5,12,24,41,-17,26
Mattersburg,6482,6,6,6,12,29,40,-11,24
SC Rheindorf,6482,7,5,6,13,21,33,-12,21
FC Salzburg,6483,1,14,6,4,45,22,23,48
SK Sturm Gra,6483,2,14,3,7,34,29,5,45
Rapid Vienna,6483,3,10,9,5,38,25,13,39
LASK Linz,6483,4,8,5,11,26,29,-3,29
Mattersburg,6483,5,7,6,11,33,43,-10,27
Vienna,6483,6,6,6,12,25,40,-15,24
SC Rheindorf,6483,7,5,5,14,19,32,-13,20
FC Salzburg,6484,1,14,7,3,46,16,30,49
SK Sturm Gra,6484,2,12,5,7,32,30,2,41
Rapid Vienna,6484,3,7,12,5,33,26,7,33
LASK Linz,6484,4,8,7,9,26,30,-4,31
Vienna,6484,5,8,5,11,27,39,-12,29
Mattersburg,6484,6,6,5,13,32,45,-13,23
SC Rheindorf,6484,7,5,7,12,22,32,-10,22
FC Salzburg,6485,1,15,7,2,44,16,28,52
SK Sturm Gra,6485,2,12,4,8,34,30,4,40
Rapid Vienna,6485,3,8,10,6,36,30,6,34
LASK Linz,6485,4,9,7,8,29,28,1,34
Vienna,6485,5,7,5,12,25,40,-15,26
Mattersburg,6485,6,5,7,12,30,42,-12,22
SC Rheindorf,6485,7,5,6,13,21,33,-12,21
FC Salzburg,6486,1,15,6,3,42,17,25,51
Rapid Vienna,6486,2,10,10,4,38,25,13,40
SK Sturm Gra,6486,3,12,3,9,29,28,1,39
SC Rheindorf,6486,4,7,6,11,24,29,-5,27
LASK Linz,6486,5,7,5,12,24,31,-7,26
Mattersburg,6486,6,7,5,12,31,40,-9,26
Vienna,6486,7,6,5,13,23,41,-18,23
FC Salzburg,6487,1,15,7,2,49,19,30,52
SK Sturm Gra,6487,2,14,4,6,36,26,10,46
Rapid Vienna,6487,3,8,9,7,35,33,2,33
SC Rheindorf,6487,4,7,5,12,25,31,-6,26
LASK Linz,6487,5,7,5,12,26,34,-8,26
Mattersburg,6487,6,7,5,12,35,45,-10,26
Vienna,6487,7,6,5,13,25,43,-18,23
FC Salzburg,6488,1,15,7,2,49,19,30,52
SK Sturm Gra,6488,2,13,4,7,34,26,8,43
Rapid Vienna,6488,3,9,10,5,38,30,8,37
LASK Linz,6488,4,7,6,11,24,31,-7,27
Mattersburg,6488,5,7,6,11,31,43,-12,27
Vienna,6488,6,6,5,13,25,41,-16,23
SC Rheindorf,6488,7,4,8,12,17,28,-11,20
FC Salzburg,6489,1,15,7,2,47,17,30,52
SK Sturm Gra,6489,2,13,4,7,34,30,4,43
Rapid Vienna,6489,3,8,11,5,36,27,9,35
LASK Linz,6489,4,8,6,10,26,29,-3,30
Vienna,6489,5,7,5,12,25,40,-15,26
SC Rheindorf,6489,6,5,7,12,20,30,-10,22
Mattersburg,6489,7,5,6,13,26,41,-15,21
FC Salzburg,6490,1,13,6,5,43,23,20,45
SK Sturm Gra,6490,2,13,4,7,35,27,8,43
Rapid Vienna,6490,3,10,9,5,39,28,11,39
LASK Linz,6490,4,9,6,9,27,28,-1,33
Mattersburg,6490,5,7,5,12,30,39,-9,26
Vienna,6490,6,7,5,12,25,40,-15,26
SC Rheindorf,6490,7,5,5,14,16,30,-14,20
FC Salzburg,6491,1,14,7,3,41,21,20,49
SK Sturm Gra,6491,2,12,5,7,32,27,5,41
Rapid Vienna,6491,3,9,10,5,42,25,17,37
LASK Linz,6491,4,8,7,9,25,30,-5,31
Mattersburg,6491,5,7,6,11,36,41,-5,27
Vienna,6491,6,7,5,12,26,38,-12,26
SC Rheindorf,6491,7,4,6,14,16,36,-20,18
FC Salzburg,6492,1,13,8,3,45,20,25,47
SK Sturm Gra,6492,2,13,4,7,39,31,8,43
Rapid Vienna,6492,3,9,11,4,38,27,11,38
LASK Linz,6492,4,8,6,10,28,31,-3,30
Vienna,6492,5,7,5,12,26,40,-14,26
Mattersburg,6492,6,6,6,12,32,45,-13,24
SC Rheindorf,6492,7,5,6,13,18,32,-14,21
FC Salzburg,6493,1,15,7,2,44,18,26,52
SK Sturm Gra,6493,2,13,3,8,36,30,6,42
Rapid Vienna,6493,3,8,10,6,35,32,3,34
LASK Linz,6493,4,9,5,10,30,29,1,32
Vienna,6493,5,7,5,12,26,38,-12,26
SC Rheindorf,6493,6,6,5,13,18,28,-10,23
Mattersburg,6493,7,6,5,13,28,42,-14,23
FC Salzburg,6494,1,16,6,2,50,17,33,54
SK Sturm Gra,6494,2,11,4,9,29,30,-1,37
Rapid Vienna,6494,3,8,10,6,35,29,6,34
LASK Linz,6494,4,9,6,9,28,29,-1,33
Mattersburg,6494,5,7,6,11,32,42,-10,27
Vienna,6494,6,6,6,12,25,41,-16,24
SC Rheindorf,6494,7,5,6,13,19,30,-11,21
FC Salzburg,6495,1,14,7,3,41,17,24,49
SK Sturm Gra,6495,2,12,4,8,34,31,3,40
Rapid Vienna,6495,3,8,9,7,34,30,4,33
LASK Linz,6495,4,8,6,10,27,30,-3,30
SC Rheindorf,6495,5,7,6,11,25,29,-4,27
Mattersburg,6495,6,7,6,11,31,40,-9,27
Vienna,6495,7,6,6,12,25,40,-15,24
FC Salzburg,6496,1,14,7,3,42,17,25,49
SK Sturm Gra,6496,2,12,4,8,34,31,3,40
Rapid Vienna,6496,3,10,9,5,35,26,9,39
LASK Linz,6496,4,8,7,9,29,30,-1,31
Mattersburg,6496,5,7,6,11,31,39,-8,27
Vienna,6496,6,6,6,12,24,39,-15,24
SC Rheindorf,6496,7,4,7,13,17,30,-13,19
FC Salzburg,6497,1,16,6,2,49,18,31,54
SK Sturm Gra,6497,2,13,4,7,39,30,9,43
Rapid Vienna,6497,3,8,9,7,35,30,5,33
LASK Linz,6497,4,9,5,10,28,33,-5,32
Mattersburg,6497,5,6,7,11,33,43,-10,25
Vienna,6497,6,6,6,12,25,42,-17,24
SC Rheindorf,6497,7,4,7,13,18,31,-13,19
FC Salzburg,6498,1,14,6,4,45,18,27,48
SK Sturm Gra,6498,2,12,5,7,32,29,3,41
Rapid Vienna,6498,3,8,9,7,32,27,5,33
LASK Linz,6498,4,9,6,9,31,29,2,33
Vienna,6498,5,8,5,11,27,38,-11,29
SC Rheindorf,6498,6,6,7,11,21,28,-7,25
Mattersburg,6498,7,5,6,13,28,47,-19,21
FC Salzburg,6499,1,14,7,3,42,17,25,49
SK Sturm Gra,6499,2,13,3,8,33,31,2,42
Rapid Vienna,6499,3,10,10,4,38,24,14,40
LASK Linz,6499,4,8,6,10,28,31,-3,30
Vienna,6499,5,7,5,12,26,40,-14,26
Mattersburg,6499,6,6,6,12,31,42,-11,24
SC Rheindorf,6499,7,4,7,13,19,32,-13,19
FC Salzburg,6500,1,16,6,2,47,17,30,54
SK Sturm Gra,6500,2,13,3,8,33,28,5,42
Rapid Vienna,6500,3,7,11,6,33,29,4,32
LASK Linz,6500,4,7,7,10,26,31,-5,28
Mattersburg,6500,5,7,5,12,37,46,-9,26
Vienna,6500,6,7,5,12,27,40,-13,26
SC Rheindorf,6500,7,5,7,12,19,31,-12,22
FC Salzburg,6501,1,15,6,3,49,20,29,51
SK Sturm Gra,6501,2,13,3,8,32,30,2,42
Rapid Vienna,6501,3,10,10,4,38,25,13,40
LASK Linz,6501,4,8,5,11,26,29,-3,29
Mattersburg,6501,5,7,5,12,33,41,-8,26
Vienna,6501,6,6,5,13,25,45,-20,23
SC Rheindorf,6501,7,5,6,13,16,29,-13,21
FC Salzburg,6502,1,16,6,2,46,17,29,54
Rapid Vienna,6502,2,10,9,5,39,27,12,39
SK Sturm Gra,6502,3,12,3,9,33,30,3,39
LASK Linz,6502,4,7,6,11,25,32,-7,27
Vienna,6502,5,7,5,12,26,40,-14,26
SC Rheindorf,6502,6,6,6,12,18,28,-10,24
Mattersburg,6502,7,5,7,12,31,44,-13,22
FC Salzburg,6503,1,16,6,2,46,17,29,54
SK Sturm Gra,6503,2,12,5,7,34,30,4,41
Rapid Vienna,6503,3,8,11,5,34,27,7,35
LASK Linz,6503,4,7,5,12,27,34,-7,26
Vienna,6503,5,7,5,12,24,38,-14,26
Mattersburg,6503,6,6,6,12,30,40,-10,24
SC Rheindorf,6503,7,5,8,11,20,29,-9,23
FC Salzburg,6504,1,14,6,4,43,17,26,48
SK Sturm Gra,6504,2,14,3,7,32,28,4,45
Rapid Vienna,6504,3,9,9,6,36,31,5,36
LASK Linz,6504,4,8,7,9,29,28,1,31
Vienna,6504,5,7,5,12,24,40,-16,26
SC Rheindorf,6504,6,5,7,12,23,30,-7,22
Mattersburg,6504,7,5,7,12,29,42,-13,22
FC Salzburg,6505,1,14,8,2,45,17,28,50
SK Sturm Gra,6505,2,13,3,8,33,30,3,42
Rapid Vienna,6505,3,8,11,5,34,26,8,35
LASK Linz,6505,4,8,7,9,27,28,-1,31
Vienna,6505,5,7,6,11,27,40,-13,27
SC Rheindorf,6505,6,5,7,12,17,28,-11,22
Mattersburg,6505,7,5,6,13,29,43,-14,21
FC Salzburg,6506,1,14,7,3,46,19,27,49
SK Sturm Gra,6506,2,13,4,7,31,25,6,43
LASK Linz,6506,3,10,5,9,30,27,3,35
Rapid Vienna,6506,4,8,9,7,34,30,4,33
SC Rheindorf,6506,5,7,5,12,19,28,-9,26
Vienna,6506,6,6,6,12,24,42,-18,24
Mattersburg,6506,7,5,6,13,29,42,-13,21
FC Salzburg,6507,1,15,6,3,43,16,27,51
SK Sturm Gra,6507,2,12,4,8,31,28,3,40
Rapid Vienna,6507,3,8,10,6,36,29,7,34
LASK Linz,6507,4,8,7,9,28,30,-2,31
Mattersburg,6507,5,7,5,12,31,41,-10,26
Vienna,6507,6,7,5,12,24,38,-14,26
SC Rheindorf,6507,7,6,5,13,19,30,-11,23
FC Salzburg,6508,1,16,6,2,49,16,33,54
SK Sturm Gra,6508,2,12,3,9,30,33,-3,39
LASK Linz,6508,3,9,6,9,27,27,0,33
Rapid Vienna,6508,4,7,11,6,35,31,4,32
Mattersburg,6508,5,7,5,12,31,42,-11,26
SC Rheindorf,6508,6,6,6,12,22,28,-6,24
Vienna,6508,7,6,5,13,24,41,-17,23
FC Salzburg,6509,1,15,7,2,43,16,27,52
SK Sturm Gra,6509,2,13,5,6,34,26,8,44
Rapid Vienna,6509,3,7,11,6,32,26,6,32
LASK Linz,6509,4,7,6,11,26,32,-6,27
Mattersburg,6509,5,7,6,11,34,42,-8,27
SC Rheindorf,6509,6,5,8,11,20,29,-9,23
Vienna,6509,7,6,5,13,25,43,-18,23
FC Salzburg,6510,1,14,7,3,43,20,23,49
Rapid Vienna,6510,2,10,10,4,36,23,13,40
SK Sturm Gra,6510,3,12,4,8,32,29,3,40
Mattersburg,6510,4,8,6,10,31,36,-5,30
LASK Linz,6510,5,7,8,9,23,26,-3,29
Vienna,6510,6,6,5,13,23,40,-17,23
SC Rheindorf,6510,7,4,6,14,15,29,-14,18
FC Salzburg,6511,1,15,6,3,45,19,26,51
SK Sturm Gra,6511,2,12,4,8,31,30,1,40
Rapid Vienna,6511,3,9,10,5,35,25,10,37
LASK Linz,6511,4,8,6,10,26,28,-2,30
Mattersburg,6511,5,6,7,11,29,39,-10,25
Vienna,6511,6,6,6,12,25,41,-16,24
SC Rheindorf,6511,7,6,5,13,20,29,-9,23
FC Salzburg,6512,1,16,6,2,45,17,28,54
SK Sturm Gra,6512,2,13,3,8,33,30,3,42
LASK Linz,6512,3,9,6,9,27,28,-1,33
Rapid Vienna,6512,4,7,9,8,34,30,4,30
Vienna,6512,5,7,5,12,24,38,-14,26
Mattersburg,6512,6,6,6,12,28,38,-10,24
SC Rheindorf,6512,7,5,7,12,18,28,-10,22
FC Salzburg,6513,1,14,8,2,48,18,30,50
SK Sturm Gra,6513,2,11,5,8,32,30,2,38
Rapid Vienna,6513,3,9,10,5,39,29,10,37
LASK Linz,6513,4,8,6,10,27,33,-6,30
Mattersburg,6513,5,8,5,11,35,41,-6,29
SC Rheindorf,6513,6,6,5,13,20,32,-12,23
Vienna,6513,7,6,5,13,24,42,-18,23
FC Salzburg,6514,1,15,6,3,46,17,29,51
SK Sturm Gra,6514,2,12,5,7,35,30,5,41
Rapid Vienna,6514,3,9,10,5,37,28,9,37
LASK Linz,6514,4,10,5,9,29,29,0,35
Vienna,6514,5,7,5,12,26,43,-17,26
Mattersburg,6514,6,6,5,13,30,42,-12,23
SC Rheindorf,6514,7,4,6,14,17,31,-14,18
FC Salzburg,6515,1,15,6,3,45,17,28,51
SK Sturm Gra,6515,2,13,4,7,32,29,3,43
Rapid Vienna,6515,3,8,9,7,37,28,9,33
LASK Linz,6515,4,8,5,11,27,33,-6,29
SC Rheindorf,6515,5,7,6,11,22,27,-5,27
Mattersburg,6515,6,6,6,12,30,44,-14,24
Vienna,6515,7,6,6,12,24,39,-15,24
FC Salzburg,6516,1,14,8,2,46,19,27,50
SK Sturm Gra,6516,2,13,3,8,32,28,4,42
Rapid Vienna,6516,3,8,12,4,35,26,9,36
LASK Linz,6516,4,7,7,10,26,30,-4,28
Vienna,6516,5,7,5,12,26,40,-14,26
Mattersburg,6516,6,6,7,11,30,42,-12,25
SC Rheindorf,6516,7,5,6,13,18,28,-10,21
FC Salzburg,6517,1,14,7,3,45,20,25,49
SK Sturm Gra,6517,2,11,5,8,32,30,2,38
Rapid Vienna,6517,3,8,12,4,33,24,9,36
LASK Linz,6517,4,8,7,9,27,28,-1,31
Vienna,6517,5,7,6,11,28,39,-11,27
Mattersburg,6517,6,7,5,12,32,45,-13,26
SC Rheindorf,6517,7,5,6,13,18,29,-11,21
FC Salzburg,6518,1,15,6,3,47,20,27,51
Rapid Vienna,6518,2,10,9,5,39,26,13,39
SK Sturm Gra,6518,3,12,3,9,32,31,1,39
LASK Linz,6518,4,10,5,9,29,28,1,35
Vienna,6518,5,7,5,12,25,40,-15,26
Mattersburg,6518,6,6,5,13,31,46,-15,23
SC Rheindorf,6518,7,5,5,14,21,33,-12,20
FC Salzburg,6519,1,15,6,3,44,17,27,51
SK Sturm Gra,6519,2,12,5,7,32,27,5,41
Rapid Vienna,6519,3,8,11,5,35,28,7,35
LASK Linz,6519,4,8,8,8,28,28,0,32
Mattersburg,6519,5,7,6,11,28,38,-10,27
Vienna,6519,6,7,5,12,26,40,-14,26
SC Rheindorf,6519,7,4,5,15,18,33,-15,17
FC Salzburg,6520,1,15,6,3,46,18,28,51
SK Sturm Gra,6520,2,12,3,9,33,33,0,39
Rapid Vienna,6520,3,9,9,6,34,27,7,36
LASK Linz,6520,4,9,6,9,28,27,1,33
Mattersburg,6520,5,6,7,11,31,42,-11,25
SC Rheindorf,6520,6,6,6,12,19,28,-9,24
Vienna,6520,7,6,5,13,25,41,-16,23
FC Salzburg,6521,1,15,6,3,47,19,28,51
SK Sturm Gra,6521,2,12,4,8,32,31,1,40
Rapid Vienna,6521,3,9,10,5,40,31,9,37
LASK Linz,6521,4,9,6,9,32,32,0,33
Vienna,6521,5,7,5,12,25,40,-15,26
Mattersburg,6521,6,6,7,11,28,38,-10,25
SC Rheindorf,6521,7,4,6,14,18,31,-13,18
FC Salzburg,6522,1,14,8,2,47,16,31,50
SK Sturm Gra,6522,2,12,4,8,31,36,-5,40
Rapid Vienna,6522,3,9,10,5,36,27,9,37
LASK Linz,6522,4,8,6,10,28,32,-4,30
Mattersburg,6522,5,7,5,12,31,41,-10,26
Vienna,6522,6,6,6,12,25,40,-15,24
SC Rheindorf,6522,7,6,5,13,22,28,-6,23
FC Salzburg,6523,1,15,7,2,50,19,31,52
SK Sturm Gra,6523,2,12,3,9,31,31,0,39
Rapid Vienna,6523,3,9,10,5,37,28,9,37
LASK Linz,6523,4,8,5,11,26,33,-7,29
Mattersburg,6523,5,7,7,10,34,42,-8,28
Vienna,6523,6,6,6,12,24,39,-15,24
SC Rheindorf,6523,7,5,6,13,21,31,-10,21
FC Salzburg,6524,1,15,7,2,44,18,26,52
SK Sturm Gra,6524,2,13,3,8,36,29,7,42
Rapid Vienna,6524,3,8,10,6,33,26,7,34
LASK Linz,6524,4,8,5,11,27,32,-5,29
Vienna,6524,5,6,7,11,24,38,-14,25
SC Rheindorf,6524,6,6,6,12,22,31,-9,24
Mattersburg,6524,7,6,6,12,33,45,-12,24
FC Salzburg,6525,1,14,6,4,42,18,24,48
SK Sturm Gra,6525,2,14,4,6,35,26,9,46
Rapid Vienna,6525,3,8,10,6,35,30,5,34
LASK Linz,6525,4,9,5,10,26,29,-3,32
Vienna,6525,5,8,5,11,26,37,-11,29
SC Rheindorf,6525,6,5,7,12,19,29,-10,22
Mattersburg,6525,7,5,5,14,27,41,-14,20
FC Salzburg,6526,1,15,6,3,46,18,28,51
SK Sturm Gra,6526,2,13,5,6,33,27,6,44
Rapid Vienna,6526,3,7,12,5,35,28,7,33
LASK Linz,6526,4,8,7,9,27,28,-1,31
Mattersburg,6526,5,8,5,11,33,42,-9,29
Vienna,6526,6,6,5,13,24,42,-18,23
SC Rheindorf,6526,7,4,6,14,21,34,-13,18
FC Salzburg,6527,1,14,8,2,47,21,26,50
SK Sturm Gra,6527,2,13,4,7,31,26,5,43
LASK Linz,6527,3,9,6,9,29,26,3,33
Rapid Vienna,6527,4,7,10,7,33,28,5,31
SC Rheindorf,6527,5,6,7,11,22,30,-8,25
Mattersburg,6527,6,6,6,12,37,49,-12,24
Vienna,6527,7,6,5,13,26,45,-19,23
FC Salzburg,6528,1,14,6,4,44,20,24,48
SK Sturm Gra,6528,2,13,4,7,30,26,4,43
Rapid Vienna,6528,3,8,11,5,34,26,8,35
LASK Linz,6528,4,8,7,9,28,28,0,31
Vienna,6528,5,8,5,11,27,39,-12,29
Mattersburg,6528,6,6,5,13,34,44,-10,23
SC Rheindorf,6528,7,5,6,13,16,30,-14,21
FC Salzburg,6529,1,13,7,4,44,21,23,46
SK Sturm Gra,6529,2,13,3,8,33,30,3,42
Rapid Vienna,6529,3,9,10,5,38,28,10,37
LASK Linz,6529,4,10,5,9,30,28,2,35
Mattersburg,6529,5,7,6,11,34,41,-7,27
Vienna,6529,6,7,6,11,27,40,-13,27
SC Rheindorf,6529,7,4,5,15,15,33,-18,17
FC Salzburg,6530,1,15,6,3,48,22,26,51
SK Sturm Gra,6530,2,12,5,7,30,26,4,41
Rapid Vienna,6530,3,8,11,5,34,27,7,35
LASK Linz,6530,4,8,8,8,26,26,0,32
Vienna,6530,5,7,5,12,26,40,-14,26
Mattersburg,6530,6,6,6,12,34,41,-7,24
SC Rheindorf,6530,7,5,5,14,16,32,-16,20
FC Salzburg,6531,1,14,7,3,41,19,22,49
SK Sturm Gra,6531,2,14,3,7,37,27,10,45
LASK Linz,6531,3,9,5,10,27,27,0,32
Rapid Vienna,6531,4,7,9,8,31,28,3,30
Vienna,6531,5,8,5,11,28,37,-9,29
Mattersburg,6531,6,6,7,11,30,41,-11,25
SC Rheindorf,6531,7,5,6,13,19,34,-15,21
FC Salzburg,6532,1,13,7,4,43,21,22,46
SK Sturm Gra,6532,2,12,4,8,33,31,2,40
Rapid Vienna,6532,3,9,11,4,40,28,12,38
Vienna,6532,4,8,5,11,26,38,-12,29
LASK Linz,6532,5,7,6,11,25,31,-6,27
SC Rheindorf,6532,6,6,7,11,23,30,-7,25
Mattersburg,6532,7,6,6,12,33,44,-11,24
FC Salzburg,6533,1,14,6,4,48,23,25,48
SK Sturm Gra,6533,2,14,4,6,35,25,10,46
LASK Linz,6533,3,8,7,9,30,31,-1,31
Rapid Vienna,6533,4,7,9,8,35,35,0,30
Vienna,6533,5,8,5,11,29,41,-12,29
SC Rheindorf,6533,6,6,6,12,19,27,-8,24
Mattersburg,6533,7,5,7,12,31,45,-14,22
FC Salzburg,6534,1,14,6,4,43,21,22,48
SK Sturm Gra,6534,2,13,4,7,33,26,7,43
Rapid Vienna,6534,3,10,10,4,39,25,14,40
LASK Linz,6534,4,8,5,11,26,29,-3,29
Mattersburg,6534,5,7,6,11,32,40,-8,27
Vienna,6534,6,7,5,12,25,40,-15,26
SC Rheindorf,6534,7,4,6,14,16,33,-17,18
FC Salzburg,6535,1,15,7,2,49,19,30,52
SK Sturm Gra,6535,2,11,4,9,31,30,1,37
Rapid Vienna,6535,3,8,10,6,34,29,5,34
LASK Linz,6535,4,8,7,9,27,29,-2,31
Mattersburg,6535,5,7,5,12,36,44,-8,26
Vienna,6535,6,7,5,12,28,43,-15,26
SC Rheindorf,6535,7,6,6,12,20,31,-11,24
FC Salzburg,6536,1,15,7,2,48,19,29,52
SK Sturm Gra,6536,2,11,6,7,34,33,1,39
Rapid Vienna,6536,3,7,11,6,34,29,5,32
LASK Linz,6536,4,7,7,10,26,29,-3,28
Vienna,6536,5,7,5,12,27,41,-14,26
SC Rheindorf,6536,6,6,7,11,19,27,-8,25
Mattersburg,6536,7,6,7,11,32,42,-10,25
FC Salzburg,6537,1,14,7,3,44,21,23,49
SK Sturm Gra,6537,2,12,5,7,34,29,5,41
Rapid Vienna,6537,3,9,10,5,36,27,9,37
LASK Linz,6537,4,8,6,10,27,29,-2,30
Vienna,6537,5,7,6,11,28,39,-11,27
Mattersburg,6537,6,6,5,13,31,44,-13,23
SC Rheindorf,6537,7,5,7,12,20,31,-11,22
FC Salzburg,6538,1,14,7,3,47,21,26,49
SK Sturm Gra,6538,2,13,4,7,31,27,4,43
Rapid Vienna,6538,3,8,11,5,37,28,9,35
LASK Linz,6538,4,8,7,9,28,30,-2,31
Vienna,6538,5,7,5,12,24,38,-14,26
Mattersburg,6538,6,6,7,11,31,41,-10,25
SC Rheindorf,6538,7,4,7,13,16,29,-13,19
FC Salzburg,6539,1,15,7,2,44,17,27,52
SK Sturm Gra,6539,2,13,3,8,33,28,5,42
Rapid Vienna,6539,3,9,9,6,34,26,8,36
LASK Linz,6539,4,7,6,11,23,29,-6,27
SC Rheindorf,6539,5,7,5,12,20,27,-7,26
Mattersburg,6539,6,6,6,12,28,39,-11,24
Vienna,6539,7,6,6,12,23,39,-16,24
FC Salzburg,6540,1,15,7,2,51,17,34,52
SK Sturm Gra,6540,2,12,4,8,31,31,0,40
Rapid Vienna,6540,3,9,11,4,41,27,14,38
LASK Linz,6540,4,8,6,10,28,30,-2,30
Vienna,6540,5,7,5,12,25,41,-16,26
Mattersburg,6540,6,6,5,13,29,45,-16,23
SC Rheindorf,6540,7,5,6,13,18,32,-14,21
FC Salzburg,6541,1,15,7,2,46,19,27,52
SK Sturm Gra,6541,2,13,5,6,34,26,8,44
Rapid Vienna,6541,3,8,11,5,37,27,10,35
LASK Linz,6541,4,7,7,10,29,33,-4,28
Vienna,6541,5,7,5,12,25,40,-15,26
SC Rheindorf,6541,6,6,5,13,19,32,-13,23
Mattersburg,6541,7,5,6,13,32,45,-13,21
FC Salzburg,6542,1,16,6,2,47,17,30,54
SK Sturm Gra,6542,2,12,4,8,31,27,4,40
Rapid Vienna,6542,3,8,9,7,36,33,3,33
LASK Linz,6542,4,8,6,10,25,28,-3,30
Mattersburg,6542,5,7,5,12,33,41,-8,26
SC Rheindorf,6542,6,6,7,11,21,29,-8,25
Vienna,6542,7,6,5,13,23,41,-18,23
FC Salzburg,6543,1,14,7,3,44,19,25,49
SK Sturm Gra,6543,2,12,4,8,31,29,2,40
Rapid Vienna,6543,3,7,11,6,34,28,6,32
LASK Linz,6543,4,7,8,9,28,30,-2,29
Vienna,6543,5,8,5,11,27,38,-11,29
Mattersburg,6543,6,7,5,12,34,45,-11,26
SC Rheindorf,6543,7,6,6,12,21,30,-9,24
FC Salzburg,6544,1,15,7,2,48,19,29,52
SK Sturm Gra,6544,2,12,4,8,34,31,3,40
Rapid Vienna,6544,3,8,12,4,41,31,10,36
LASK Linz,6544,4,8,6,10,28,32,-4,30
SC Rheindorf,6544,5,7,5,12,22,30,-8,26
Vienna,6544,6,7,5,12,26,40,-14,26
Mattersburg,6544,7,5,5,14,30,46,-16,20
FC Salzburg,6545,1,15,7,2,47,16,31,52
SK Sturm Gra,6545,2,13,4,7,33,28,5,43
Rapid Vienna,6545,3,9,9,6,39,29,10,36
LASK Linz,6545,4,9,5,10,27,31,-4,32
Vienna,6545,5,7,5,12,29,40,-11,26
Mattersburg,6545,6,6,5,13,28,47,-19,23
SC Rheindorf,6545,7,5,5,14,16,28,-12,20
FC Salzburg,6546,1,13,9,2,45,19,26,48
SK Sturm Gra,6546,2,13,4,7,35,30,5,43
Rapid Vienna,6546,3,8,11,5,35,26,9,35
Vienna,6546,4,7,6,11,25,38,-13,27
LASK Linz,6546,5,7,5,12,25,34,-9,26
Mattersburg,6546,6,6,7,11,33,43,-10,25
SC Rheindorf,6546,7,5,8,11,21,29,-8,23
FC Salzburg,6547,1,15,7,2,43,17,26,52
SK Sturm Gra,6547,2,11,4,9,30,30,0,37
Rapid Vienna,6547,3,8,10,6,33,26,7,34
LASK Linz,6547,4,8,6,10,26,27,-1,30
SC Rheindorf,6547,5,7,6,11,19,26,-7,27
Vienna,6547,6,6,7,11,25,39,-14,25
Mattersburg,6547,7,5,8,11,29,40,-11,23
FC Salzburg,6548,1,13,8,3,44,18,26,47
SK Sturm Gra,6548,2,12,5,7,33,32,1,41
Rapid Vienna,6548,3,7,12,5,32,26,6,33
LASK Linz,6548,4,7,9,8,26,27,-1,30
Mattersburg,6548,5,6,8,10,31,39,-8,26
Vienna,6548,6,6,7,11,24,38,-14,25
SC Rheindorf,6548,7,4,9,11,17,27,-10,21
FC Salzburg,6549,1,13,6,5,42,20,22,45
SK Sturm Gra,6549,2,14,3,7,31,26,5,45
Rapid Vienna,6549,3,9,9,6,34,26,8,36
Mattersburg,6549,4,9,5,10,35,38,-3,32
LASK Linz,6549,5,8,5,11,24,29,-5,29
SC Rheindorf,6549,6,6,5,13,20,29,-9,23
Vienna,6549,7,6,5,13,24,42,-18,23
FC Salzburg,6550,1,14,7,3,44,18,26,49
SK Sturm Gra,6550,2,12,6,6,34,29,5,42
Rapid Vienna,6550,3,7,12,5,35,30,5,33
LASK Linz,6550,4,8,8,8,29,29,0,32
Mattersburg,6550,5,7,5,12,40,44,-4,26
Vienna,6550,6,7,5,12,25,43,-18,26
SC Rheindorf,6550,7,4,7,13,18,32,-14,19
FC Salzburg,6551,1,14,6,4,42,18,24,48
SK Sturm Gra,6551,2,12,5,7,34,28,6,41
Rapid Vienna,6551,3,10,10,4,38,25,13,40
Vienna,6551,4,8,5,11,28,40,-12,29
LASK Linz,6551,5,7,7,10,27,35,-8,28
SC Rheindorf,6551,6,6,5,13,23,31,-8,23
Mattersburg,6551,7,5,6,13,30,45,-15,21
FC Salzburg,6552,1,15,6,3,43,18,25,51
SK Sturm Gra,6552,2,13,3,8,31,30,1,42
LASK Linz,6552,3,10,6,8,29,25,4,36
Rapid Vienna,6552,4,8,9,7,34,28,6,33
Vienna,6552,5,7,5,12,26,39,-13,26
Mattersburg,6552,6,6,6,12,29,40,-11,24
SC Rheindorf,6552,7,4,7,13,16,28,-12,19
FC Salzburg,6553,1,13,7,4,42,21,21,46
SK Sturm Gra,6553,2,13,4,7,32,27,5,43
Rapid Vienna,6553,3,8,11,5,36,28,8,35
Mattersburg,6553,4,8,5,11,36,40,-4,29
LASK Linz,6553,5,8,5,11,27,33,-6,29
Vienna,6553,6,7,5,12,25,42,-17,26
SC Rheindorf,6553,7,5,7,12,22,29,-7,22
FC Salzburg,6554,1,16,6,2,48,17,31,54
SK Sturm Gra,6554,2,12,4,8,32,29,3,40
Rapid Vienna,6554,3,7,12,5,33,26,7,33
LASK Linz,6554,4,7,7,10,24,28,-4,28
Mattersburg,6554,5,6,7,11,29,42,-13,25
SC Rheindorf,6554,6,6,6,12,21,30,-9,24
Vienna,6554,7,6,6,12,23,38,-15,24
FC Salzburg,6555,1,13,7,4,43,18,25,46
SK Sturm Gra,6555,2,14,3,7,35,26,9,45
Rapid Vienna,6555,3,8,10,6,34,30,4,34
LASK Linz,6555,4,8,5,11,26,29,-3,29
SC Rheindorf,6555,5,7,5,12,21,30,-9,26
Mattersburg,6555,6,7,5,12,30,40,-10,26
Vienna,6555,7,7,5,12,25,41,-16,26
FC Salzburg,6556,1,14,6,4,45,20,25,48
SK Sturm Gra,6556,2,13,5,6,34,27,7,44
Rapid Vienna,6556,3,9,11,4,35,25,10,38
LASK Linz,6556,4,7,7,10,25,28,-3,28
Mattersburg,6556,5,7,6,11,29,38,-9,27
Vienna,6556,6,6,5,13,23,42,-19,23
SC Rheindorf,6556,7,5,6,13,16,27,-11,21
FC Salzburg,6557,1,15,7,2,47,18,29,52
SK Sturm Gra,6557,2,12,5,7,32,27,5,41
Rapid Vienna,6557,3,8,11,5,37,26,11,35
LASK Linz,6557,4,8,6,10,28,31,-3,30
Mattersburg,6557,5,7,6,11,33,43,-10,27
Vienna,6557,6,6,5,13,27,44,-17,23
SC Rheindorf,6557,7,5,6,13,19,34,-15,21
FC Salzburg,6558,1,15,6,3,46,21,25,51
SK Sturm Gra,6558,2,14,3,7,35,28,7,45
Rapid Vienna,6558,3,7,10,7,35,31,4,31
Mattersburg,6558,4,7,6,11,31,40,-9,27
LASK Linz,6558,5,7,6,11,24,34,-10,27
SC Rheindorf,6558,6,7,5,12,27,29,-2,26
Vienna,6558,7,6,6,12,24,39,-15,24
FC Salzburg,6559,1,13,9,2,42,18,24,48
SK Sturm Gra,6559,2,13,4,7,35,28,7,43
Rapid Vienna,6559,3,9,10,5,35,26,9,37
LASK Linz,6559,4,8,5,11,26,31,-5,29
Vienna,6559,5,7,6,11,29,38,-9,27
Mattersburg,6559,6,6,6,12,30,44,-14,24
SC Rheindorf,6559,7,5,6,13,19,31,-12,21
FC Salzburg,6560,1,15,6,3,43,20,23,51
SK Sturm Gra,6560,2,12,4,8,33,28,5,40
Rapid Vienna,6560,3,8,9,7,35,31,4,33
Mattersburg,6560,4,9,5,10,35,38,-3,32
LASK Linz,6560,5,8,7,9,27,28,-1,31
Vienna,6560,6,6,5,13,23,40,-17,23
SC Rheindorf,6560,7,5,6,13,17,28,-11,21
FC Salzburg,6561,1,15,6,3,45,17,28,51
SK Sturm Gra,6561,2,12,4,8,31,32,-1,40
Rapid Vienna,6561,3,10,9,5,36,26,10,39
LASK Linz,6561,4,9,6,9,30,28,2,33
Mattersburg,6561,5,7,6,11,35,43,-8,27
Vienna,6561,6,6,5,13,23,41,-18,23
SC Rheindorf,6561,7,4,6,14,20,33,-13,18
FC Salzburg,6562,1,14,8,2,45,20,25,50
SK Sturm Gra,6562,2,13,4,7,33,28,5,43
Rapid Vienna,6562,3,8,11,5,35,27,8,35
LASK Linz,6562,4,8,6,10,28,29,-1,30
Mattersburg,6562,5,7,7,10,34,41,-7,28
Vienna,6562,6,6,6,12,25,40,-15,24
SC Rheindorf,6562,7,4,6,14,17,32,-15,18
FC Salzburg,6563,1,16,6,2,46,16,30,54
SK Sturm Gra,6563,2,12,4,8,34,30,4,40
Rapid Vienna,6563,3,9,9,6,35,28,7,36
LASK Linz,6563,4,9,5,10,28,29,-1,32
Vienna,6563,5,7,5,12,24,38,-14,26
Mattersburg,6563,6,6,5,13,29,42,-13,23
SC Rheindorf,6563,7,5,6,13,19,32,-13,21
FC Salzburg,6564,1,13,8,3,39,16,23,47
SK Sturm Gra,6564,2,12,5,7,32,31,1,41
Rapid Vienna,6564,3,7,12,5,33,28,5,33
LASK Linz,6564,4,9,6,9,31,28,3,33
Vienna,6564,5,7,6,11,26,38,-12,27
Mattersburg,6564,6,6,6,12,31,43,-12,24
SC Rheindorf,6564,7,5,7,12,21,29,-8,22
FC Salzburg,6565,1,15,7,2,45,19,26,52
SK Sturm Gra,6565,2,14,3,7,35,27,8,45
Rapid Vienna,6565,3,8,9,7,33,28,5,33
LASK Linz,6565,4,9,5,10,28,28,0,32
Vienna,6565,5,7,6,11,24,37,-13,27
SC Rheindorf,6565,6,6,5,13,19,31,-12,23
Mattersburg,6565,7,5,5,14,31,45,-14,20
FC Salzburg,6566,1,14,6,4,42,21,21,48
SK Sturm Gra,6566,2,14,3,7,37,27,10,45
Rapid Vienna,6566,3,8,10,6,34,27,7,34
LASK Linz,6566,4,8,6,10,25,29,-4,30
Vienna,6566,5,8,5,11,29,38,-9,29
Mattersburg,6566,6,6,6,12,29,43,-14,24
SC Rheindorf,6566,7,4,8,12,21,32,-11,20
FC Salzburg,6567,1,13,9,2,43,19,24,48
SK Sturm Gra,6567,2,12,5,7,34,29,5,41
Rapid Vienna,6567,3,8,11,5,37,28,9,35
LASK Linz,6567,4,10,5,9,30,28,2,35
Mattersburg,6567,5,7,5,12,31,42,-11,26
Vienna,6567,6,6,6,12,26,41,-15,24
SC Rheindorf,6567,7,5,5,14,19,33,-14,20
FC Salzburg,6568,1,16,6,2,45,17,28,54
SK Sturm Gra,6568,2,12,4,8,36,32,4,40
Rapid Vienna,6568,3,9,10,5,39,28,11,37
Mattersburg,6568,4,7,6,11,31,39,-8,27
LASK Linz,6568,5,7,6,11,26,35,-9,27
Vienna,6568,6,6,5,13,23,41,-18,23
SC Rheindorf,6568,7,5,7,12,23,31,-8,22
FC Salzburg,6569,1,15,7,2,48,17,31,52
SK Sturm Gra,6569,2,13,3,8,35,30,5,42
Rapid Vienna,6569,3,8,10,6,38,32,6,34
LASK Linz,6569,4,8,7,9,29,29,0,31
Vienna,6569,5,7,5,12,25,39,-14,26
Mattersburg,6569,6,5,8,11,28,39,-11,23
SC Rheindorf,6569,7,5,6,13,19,36,-17,21
FC Salzburg,6570,1,15,6,3,43,17,26,51
SK Sturm Gra,6570,2,12,3,9,31,30,1,39
Rapid Vienna,6570,3,9,9,6,35,26,9,36
LASK Linz,6570,4,9,5,10,28,29,-1,32
Mattersburg,6570,5,7,6,11,31,40,-9,27
Vienna,6570,6,6,6,12,24,40,-16,24
SC Rheindorf,6570,7,6,5,13,23,33,-10,23
FC Salzburg,6571,1,15,7,2,46,17,29,52
SK Sturm Gra,6571,2,12,3,9,29,32,-3,39
Rapid Vienna,6571,3,8,11,5,39,28,11,35
LASK Linz,6571,4,9,6,9,28,27,1,33
Mattersburg,6571,5,7,6,11,31,39,-8,27
Vienna,6571,6,6,5,13,23,40,-17,23
SC Rheindorf,6571,7,5,6,13,19,32,-13,21
FC Salzburg,6572,1,15,6,3,43,17,26,51
SK Sturm Gra,6572,2,12,3,9,33,30,3,39
Rapid Vienna,6572,3,9,9,6,37,29,8,36
LASK Linz,6572,4,9,6,9,27,26,1,33
Mattersburg,6572,5,8,5,11,33,39,-6,29
Vienna,6572,6,6,5,13,24,42,-18,23
SC Rheindorf,6572,7,5,6,13,16,30,-14,21
FC Salzburg,6573,1,14,7,3,46,22,24,49
SK Sturm Gra,6573,2,12,4,8,33,30,3,40
Rapid Vienna,6573,3,8,11,5,36,28,8,35
LASK Linz,6573,4,7,7,10,25,28,-3,28
Vienna,6573,5,7,5,12,28,40,-12,26
SC Rheindorf,6573,6,6,7,11,22,30,-8,25
Mattersburg,6573,7,6,7,11,29,41,-12,25
FC Salzburg,6574,1,13,8,3,44,20,24,47
SK Sturm Gra,6574,2,12,4,8,32,30,2,40
Rapid Vienna,6574,3,9,10,5,40,29,11,37
LASK Linz,6574,4,9,5,10,28,29,-1,32
Mattersburg,6574,5,7,6,11,37,42,-5,27
Vienna,6574,6,6,6,12,24,41,-17,24
SC Rheindorf,6574,7,6,5,13,18,32,-14,23
FC Salzburg,6575,1,14,7,3,41,17,24,49
SK Sturm Gra,6575,2,12,4,8,31,28,3,40
Rapid Vienna,6575,3,9,11,4,37,26,11,38
LASK Linz,6575,4,9,6,9,29,29,0,33
Mattersburg,6575,5,7,5,12,31,42,-11,26
Vienna,6575,6,6,5,13,24,40,-16,23
SC Rheindorf,6575,7,5,6,13,19,30,-11,21
FC Salzburg,6576,1,14,7,3,45,20,25,49
SK Sturm Gra,6576,2,11,6,7,30,28,2,39
Rapid Vienna,6576,3,9,10,5,42,29,13,37
LASK Linz,6576,4,8,7,9,29,31,-2,31
Mattersburg,6576,5,7,6,11,30,39,-9,27
Vienna,6576,6,7,6,11,27,40,-13,27
SC Rheindorf,6576,7,4,6,14,16,32,-16,18
FC Salzburg,6577,1,14,6,4,47,18,29,48
SK Sturm Gra,6577,2,11,5,8,33,32,1,38
Rapid Vienna,6577,3,9,10,5,37,28,9,37
LASK Linz,6577,4,10,5,9,29,27,2,35
Vienna,6577,5,8,5,11,25,37,-12,29
Mattersburg,6577,6,6,5,13,28,45,-17,23
SC Rheindorf,6577,7,5,6,13,20,32,-12,21
FC Salzburg,6578,1,16,6,2,47,16,31,54
SK Sturm Gra,6578,2,13,3,8,33,30,3,42
Rapid Vienna,6578,3,9,10,5,35,26,9,37
LASK Linz,6578,4,8,5,11,28,33,-5,29
Mattersburg,6578,5,6,7,11,31,39,-8,25
Vienna,6578,6,6,6,12,23,41,-18,24
SC Rheindorf,6578,7,4,7,13,16,28,-12,19
FC Salzburg,6579,1,15,7,2,46,18,28,52
SK Sturm Gra,6579,2,11,5,8,30,30,0,38
Rapid Vienna,6579,3,9,10,5,37,26,11,37
LASK Linz,6579,4,8,7,9,26,29,-3,31
Vienna,6579,5,7,5,12,25,39,-14,26
Mattersburg,6579,6,6,6,12,32,42,-10,24
SC Rheindorf,6579,7,4,8,12,17,29,-12,20
FC Salzburg,6580,1,14,7,3,43,18,25,49
SK Sturm Gra,6580,2,12,5,7,35,30,5,41
Rapid Vienna,6580,3,10,10,4,37,26,11,40
Mattersburg,6580,4,7,7,10,32,37,-5,28
LASK Linz,6580,5,7,6,11,25,31,-6,27
Vienna,6580,6,6,6,12,23,39,-16,24
SC Rheindorf,6580,7,4,7,13,18,32,-14,19
FC Salzburg,6581,1,15,6,3,45,19,26,51
SK Sturm Gra,6581,2,12,3,9,32,29,3,39
Rapid Vienna,6581,3,9,11,4,37,26,11,38
LASK Linz,6581,4,9,6,9,31,33,-2,33
Mattersburg,6581,5,8,5,11,37,42,-5,29
Vienna,6581,6,6,5,13,23,41,-18,23
SC Rheindorf,6581,7,4,6,14,17,32,-15,18
FC Salzburg,6582,1,12,8,4,41,20,21,44
Rapid Vienna,6582,2,10,10,4,42,26,16,40
SK Sturm Gra,6582,3,11,4,9,30,32,-2,37
LASK Linz,6582,4,9,5,10,28,30,-2,32
Mattersburg,6582,5,8,5,11,34,39,-5,29
Vienna,6582,6,8,5,11,26,38,-12,29
SC Rheindorf,6582,7,5,5,14,18,34,-16,20
FC Salzburg,6583,1,15,6,3,45,18,27,51
SK Sturm Gra,6583,2,13,4,7,34,29,5,43
Rapid Vienna,6583,3,8,10,6,36,30,6,34
LASK Linz,6583,4,9,7,8,31,30,1,34
Vienna,6583,5,7,5,12,25,40,-15,26
Mattersburg,6583,6,6,5,13,31,43,-12,23
SC Rheindorf,6583,7,5,5,14,17,29,-12,20
FC Salzburg,6584,1,14,8,2,43,16,27,50
SK Sturm Gra,6584,2,14,4,6,36,27,9,46
LASK Linz,6584,3,9,6,9,27,28,-1,33
Rapid Vienna,6584,4,7,10,7,34,31,3,31
Vienna,6584,5,7,5,12,25,40,-15,26
Mattersburg,6584,6,5,7,12,27,40,-13,22
SC Rheindorf,6584,7,5,6,13,18,28,-10,21
FC Salzburg,6585,1,15,6,3,45,19,26,51
SK Sturm Gra,6585,2,12,5,7,30,26,4,41
Rapid Vienna,6585,3,9,10,5,38,27,11,37
LASK Linz,6585,4,8,6,10,26,30,-4,30
SC Rheindorf,6585,5,7,5,12,20,27,-7,26
Mattersburg,6585,6,6,5,13,28,40,-12,23
Vienna,6585,7,6,5,13,25,43,-18,23
FC Salzburg,6586,1,14,6,4,42,18,24,48
SK Sturm Gra,6586,2,13,3,8,31,28,3,42
LASK Linz,6586,3,10,6,8,29,25,4,36
Rapid Vienna,6586,4,8,11,5,33,25,8,35
Mattersburg,6586,5,7,6,11,33,40,-7,27
Vienna,6586,6,6,5,13,24,43,-19,23
SC Rheindorf,6586,7,4,7,13,19,32,-13,19
FC Salzburg,6587,1,13,8,3,45,22,23,47
SK Sturm Gra,6587,2,13,5,6,38,30,8,44
Rapid Vienna,6587,3,8,11,5,36,27,9,35
LASK Linz,6587,4,7,7,10,24,28,-4,28
Mattersburg,6587,5,6,7,11,29,39,-10,25
Vienna,6587,6,6,7,11,24,38,-14,25
SC Rheindorf,6587,7,5,7,12,19,31,-12,22
FC Salzburg,6588,1,13,8,3,44,19,25,47
SK Sturm Gra,6588,2,12,3,9,29,30,-1,39
Rapid Vienna,6588,3,9,9,6,35,27,8,36
LASK Linz,6588,4,10,6,8,31,27,4,36
Mattersburg,6588,5,7,6,11,31,41,-10,27
Vienna,6588,6,6,6,12,25,41,-16,24
SC Rheindorf,6588,7,5,6,13,19,29,-10,21
FC Salzburg,6589,1,14,8,2,44,17,27,50
SK Sturm Gra,6589,2,11,6,7,33,30,3,39
Rapid Vienna,6589,3,9,11,4,39,29,10,38
LASK Linz,6589,4,8,7,9,33,31,2,31
Mattersburg,6589,5,6,6,12,29,44,-15,24
Vienna,6589,6,6,5,13,25,42,-17,23
SC Rheindorf,6589,7,5,7,12,20,30,-10,22
FC Salzburg,6590,1,14,8,2,44,18,26,50
Rapid Vienna,6590,2,9,10,5,38,29,9,37
SK Sturm Gra,6590,3,11,4,9,28,29,-1,37
Mattersburg,6590,4,8,6,10,34,40,-6,30
LASK Linz,6590,5,8,5,11,26,30,-4,29
SC Rheindorf,6590,6,6,6,12,22,30,-8,24
Vienna,6590,7,6,5,13,26,42,-16,23
FC Salzburg,6591,1,15,6,3,43,18,25,51
SK Sturm Gra,6591,2,13,3,8,32,28,4,42
Rapid Vienna,6591,3,9,9,6,35,27,8,36
Mattersburg,6591,4,8,6,10,34,38,-4,30
LASK Linz,6591,5,8,5,11,27,33,-6,29
Vienna,6591,6,6,5,13,23,40,-17,23
SC Rheindorf,6591,7,5,6,13,18,28,-10,21
FC Salzburg,6592,1,14,6,4,41,19,22,48
SK Sturm Gra,6592,2,13,4,7,32,27,5,43
Rapid Vienna,6592,3,9,9,6,36,28,8,36
LASK Linz,6592,4,7,6,11,25,30,-5,27
Mattersburg,6592,5,7,6,11,33,41,-8,27
Vienna,6592,6,7,6,11,28,39,-11,27
SC Rheindorf,6592,7,6,5,13,21,32,-11,23
FC Salzburg,6593,1,15,6,3,51,20,31,51
SK Sturm Gra,6593,2,13,3,8,34,32,2,42
Rapid Vienna,6593,3,9,10,5,35,25,10,37
LASK Linz,6593,4,8,5,11,27,33,-6,29
Vienna,6593,5,8,5,11,27,38,-11,29
Mattersburg,6593,6,6,6,12,31,45,-14,24
SC Rheindorf,6593,7,4,7,13,16,28,-12,19
FC Salzburg,6594,1,16,6,2,45,16,29,54
Rapid Vienna,6594,2,9,9,6,37,26,11,36
SK Sturm Gra,6594,3,11,3,10,30,33,-3,36
LASK Linz,6594,4,9,5,10,28,33,-5,32
Mattersburg,6594,5,7,6,11,34,39,-5,27
Vienna,6594,6,6,6,12,26,41,-15,24
SC Rheindorf,6594,7,6,5,13,19,31,-12,23
FC Salzburg,6595,1,14,8,2,48,19,29,50
SK Sturm Gra,6595,2,12,6,6,33,28,5,42
LASK Linz,6595,3,10,5,9,29,27,2,35
Rapid Vienna,6595,4,7,12,5,35,29,6,33
Vienna,6595,5,7,5,12,27,43,-16,26
Mattersburg,6595,6,6,5,13,30,44,-14,23
SC Rheindorf,6595,7,4,7,13,22,34,-12,19
FC Salzburg,6596,1,13,8,3,44,20,24,47
Rapid Vienna,6596,2,10,9,5,34,25,9,39
SK Sturm Gra,6596,3,11,4,9,30,30,0,37
LASK Linz,6596,4,9,6,9,27,26,1,33
Vienna,6596,5,8,5,11,28,39,-11,29
SC Rheindorf,6596,6,6,5,13,20,30,-10,23
Mattersburg,6596,7,5,7,12,29,42,-13,22
FC Salzburg,6597,1,14,6,4,47,21,26,48
Rapid Vienna,6597,2,10,10,4,36,25,11,40
SK Sturm Gra,6597,3,11,4,9,31,31,0,37
LASK Linz,6597,4,8,7,9,29,30,-1,31
Mattersburg,6597,5,7,6,11,31,41,-10,27
Vienna,6597,6,7,6,11,25,38,-13,27
SC Rheindorf,6597,7,5,5,14,18,31,-13,20
FC Salzburg,6598,1,15,7,2,45,16,29,52
SK Sturm Gra,6598,2,12,4,8,31,30,1,40
Rapid Vienna,6598,3,8,11,5,36,27,9,35
LASK Linz,6598,4,9,5,10,31,30,1,32
Mattersburg,6598,5,8,5,11,32,41,-9,29
Vienna,6598,6,6,5,13,23,39,-16,23
SC Rheindorf,6598,7,5,5,14,18,33,-15,20
FC Salzburg,6599,1,14,6,4,43,19,24,48
SK Sturm Gra,6599,2,12,4,8,34,30,4,40
Rapid Vienna,6599,3,8,9,7,34,32,2,33
LASK Linz,6599,4,9,6,9,27,27,0,33
Mattersburg,6599,5,7,6,11,31,39,-8,27
Vienna,6599,6,7,5,12,25,40,-15,26
SC Rheindorf,6599,7,6,6,12,19,26,-7,24
FC Salzburg,6600,1,14,8,2,42,16,26,50
SK Sturm Gra,6600,2,13,4,7,33,26,7,43
Rapid Vienna,6600,3,9,10,5,37,28,9,37
LASK Linz,6600,4,8,5,11,28,30,-2,29
Vienna,6600,5,7,5,12,26,38,-12,26
Mattersburg,6600,6,6,6,12,28,42,-14,24
SC Rheindorf,6600,7,5,6,13,17,31,-14,21
FC Salzburg,6601,1,14,6,4,45,21,24,48
SK Sturm Gra,6601,2,13,4,7,32,27,5,43
Rapid Vienna,6601,3,9,11,4,35,25,10,38
LASK Linz,6601,4,8,7,9,27,26,1,31
Vienna,6601,5,7,5,12,25,39,-14,26
Mattersburg,6601,6,6,6,12,29,43,-14,24
SC Rheindorf,6601,7,4,7,13,16,28,-12,19
FC Salzburg,6602,1,14,6,4,43,18,25,48
SK Sturm Gra,6602,2,14,3,7,34,29,5,45
Rapid Vienna,6602,3,9,10,5,35,27,8,37
LASK Linz,6602,4,8,6,10,32,31,1,30
Mattersburg,6602,5,7,5,12,34,45,-11,26
SC Rheindorf,6602,6,6,5,13,20,27,-7,23
Vienna,6602,7,6,5,13,25,46,-21,23
FC Salzburg,6603,1,13,9,2,51,20,31,48
SK Sturm Gra,6603,2,12,5,7,31,26,5,41
Rapid Vienna,6603,3,9,10,5,37,28,9,37
LASK Linz,6603,4,10,5,9,31,29,2,35
Vienna,6603,5,6,6,12,24,39,-15,24
Mattersburg,6603,6,6,6,12,29,49,-20,24
SC Rheindorf,6603,7,4,7,13,19,31,-12,19
FC Salzburg,6604,1,14,7,3,43,19,24,49
Rapid Vienna,6604,2,10,9,5,43,26,17,39
SK Sturm Gra,6604,3,11,4,9,30,29,1,37
LASK Linz,6604,4,8,7,9,32,32,0,31
Vienna,6604,5,8,5,11,27,37,-10,29
Mattersburg,6604,6,6,7,11,33,44,-11,25
SC Rheindorf,6604,7,5,5,14,18,39,-21,20
FC Salzburg,6605,1,14,7,3,47,20,27,49
SK Sturm Gra,6605,2,13,4,7,32,29,3,43
Rapid Vienna,6605,3,9,9,6,36,27,9,36
LASK Linz,6605,4,9,6,9,27,26,1,33
Vienna,6605,5,7,6,11,26,39,-13,27
SC Rheindorf,6605,6,5,6,13,19,30,-11,21
Mattersburg,6605,7,5,6,13,30,46,-16,21
FC Salzburg,6606,1,14,7,3,47,20,27,49
Rapid Vienna,6606,2,11,9,4,39,24,15,42
SK Sturm Gra,6606,3,12,3,9,30,32,-2,39
LASK Linz,6606,4,9,5,10,28,28,0,32
Vienna,6606,5,7,5,12,26,40,-14,26
Mattersburg,6606,6,6,6,12,33,45,-12,24
SC Rheindorf,6606,7,5,5,14,19,33,-14,20
FC Salzburg,6607,1,13,7,4,42,20,22,46
SK Sturm Gra,6607,2,14,3,7,34,27,7,45
Rapid Vienna,6607,3,9,11,4,38,26,12,38
LASK Linz,6607,4,8,6,10,27,29,-2,30
Vienna,6607,5,8,5,11,26,38,-12,29
Mattersburg,6607,6,7,5,12,31,39,-8,26
SC Rheindorf,6607,7,4,5,15,19,38,-19,17
FC Salzburg,6608,1,15,6,3,43,17,26,51
SK Sturm Gra,6608,2,12,4,8,33,29,4,40
Rapid Vienna,6608,3,9,10,5,38,28,10,37
SC Rheindorf,6608,4,7,6,11,24,31,-7,27
LASK Linz,6608,5,7,6,11,26,35,-9,27
Mattersburg,6608,6,7,5,12,34,39,-5,26
Vienna,6608,7,6,5,13,24,43,-19,23
FC Salzburg,6609,1,13,8,3,41,18,23,47
SK Sturm Gra,6609,2,12,4,8,31,29,2,40
Rapid Vienna,6609,3,9,10,5,36,26,10,37
LASK Linz,6609,4,10,6,8,32,27,5,36
Vienna,6609,5,8,5,11,29,38,-9,29
Mattersburg,6609,6,5,7,12,30,47,-17,22
SC Rheindorf,6609,7,4,6,14,16,30,-14,18
FC Salzburg,6610,1,16,6,2,52,17,35,54
SK Sturm Gra,6610,2,12,3,9,31,32,-1,39
Rapid Vienna,6610,3,9,10,5,38,29,9,37
LASK Linz,6610,4,8,5,11,26,30,-4,29
Mattersburg,6610,5,7,5,12,32,45,-13,26
Vienna,6610,6,7,5,12,26,42,-16,26
SC Rheindorf,6610,7,5,6,13,21,31,-10,21
FC Salzburg,6611,1,14,6,4,44,19,25,48
SK Sturm Gra,6611,2,14,3,7,33,27,6,45
Rapid Vienna,6611,3,8,9,7,35,31,4,33
LASK Linz,6611,4,8,5,11,27,32,-5,29
SC Rheindorf,6611,5,7,5,12,23,28,-5,26
Mattersburg,6611,6,7,5,12,33,43,-10,26
Vienna,6611,7,7,5,12,27,42,-15,26
FC Salzburg,6612,1,16,6,2,46,16,30,54
SK Sturm Gra,6612,2,12,5,7,33,30,3,41
LASK Linz,6612,3,9,7,8,31,29,2,34
Rapid Vienna,6612,4,7,10,7,34,30,4,31
Vienna,6612,5,6,6,12,23,38,-15,24
SC Rheindorf,6612,6,5,7,12,22,33,-11,22
Mattersburg,6612,7,5,7,12,28,41,-13,22
FC Salzburg,6613,1,16,6,2,48,18,30,54
SK Sturm Gra,6613,2,11,3,10,31,32,-1,36
Rapid Vienna,6613,3,8,11,5,35,28,7,35
LASK Linz,6613,4,8,6,10,26,28,-2,30
Mattersburg,6613,5,7,5,12,31,44,-13,26
Vienna,6613,6,7,5,12,27,40,-13,26
SC Rheindorf,6613,7,6,6,12,20,28,-8,24
FC Salzburg,6614,1,16,6,2,46,16,30,54
SK Sturm Gra,6614,2,12,3,9,32,30,2,39
Rapid Vienna,6614,3,7,11,6,32,29,3,32
LASK Linz,6614,4,8,8,8,27,27,0,32
Vienna,6614,5,7,5,12,25,39,-14,26
SC Rheindorf,6614,6,5,8,11,19,27,-8,23
Mattersburg,6614,7,5,7,12,29,42,-13,22
FC Salzburg,6615,1,16,6,2,47,17,30,54
Rapid Vienna,6615,2,10,9,5,38,26,12,39
SK Sturm Gra,6615,3,11,5,8,30,29,1,38
LASK Linz,6615,4,8,6,10,27,29,-2,30
Mattersburg,6615,5,6,6,12,32,44,-12,24
Vienna,6615,6,6,6,12,27,43,-16,24
SC Rheindorf,6615,7,5,6,13,20,33,-13,21
FC Salzburg,6616,1,15,7,2,45,16,29,52
Rapid Vienna,6616,2,10,10,4,37,25,12,40
SK Sturm Gra,6616,3,11,5,8,28,28,0,38
LASK Linz,6616,4,8,6,10,25,27,-2,30
Vienna,6616,5,6,6,12,24,41,-17,24
SC Rheindorf,6616,6,5,7,12,19,29,-10,22
Mattersburg,6616,7,5,7,12,30,42,-12,22
FC Salzburg,6617,1,13,7,4,43,21,22,46
SK Sturm Gra,6617,2,14,3,7,37,28,9,45
Rapid Vienna,6617,3,9,10,5,34,25,9,37
Mattersburg,6617,4,9,5,10,36,41,-5,32
LASK Linz,6617,5,8,5,11,27,33,-6,29
Vienna,6617,6,6,5,13,25,41,-16,23
SC Rheindorf,6617,7,5,5,14,17,30,-13,20
FC Salzburg,6618,1,14,6,4,45,20,25,48
SK Sturm Gra,6618,2,13,5,6,33,27,6,44
Rapid Vienna,6618,3,8,9,7,36,29,7,33
Mattersburg,6618,4,7,7,10,32,39,-7,28
LASK Linz,6618,5,7,6,11,25,31,-6,27
SC Rheindorf,6618,6,6,7,11,21,29,-8,25
Vienna,6618,7,6,6,12,27,44,-17,24
FC Salzburg,6619,1,15,7,2,47,16,31,52
SK Sturm Gra,6619,2,13,4,7,34,29,5,43
Rapid Vienna,6619,3,9,9,6,35,27,8,36
LASK Linz,6619,4,9,5,10,28,30,-2,32
Vienna,6619,5,7,5,12,25,40,-15,26
SC Rheindorf,6619,6,6,5,13,19,28,-9,23
Mattersburg,6619,7,5,5,14,29,47,-18,20
FC Salzburg,6620,1,14,8,2,47,17,30,50
Rapid Vienna,6620,2,9,11,4,36,25,11,38
SK Sturm Gra,6620,3,11,5,8,30,30,0,38
LASK Linz,6620,4,8,6,10,28,28,0,30
Mattersburg,6620,5,7,6,11,32,45,-13,27
Vienna,6620,6,6,6,12,25,40,-15,24
SC Rheindorf,6620,7,5,6,13,17,30,-13,21
FC Salzburg,6621,1,14,6,4,44,23,21,48
SK Sturm Gra,6621,2,13,4,7,36,29,7,43
Rapid Vienna,6621,3,8,10,6,35,30,5,34
LASK Linz,6621,4,8,6,10,30,31,-1,30
SC Rheindorf,6621,5,7,6,11,22,26,-4,27
Mattersburg,6621,6,7,5,12,33,45,-12,26
Vienna,6621,7,6,5,13,27,43,-16,23
FC Salzburg,6622,1,14,6,4,47,22,25,48
SK Sturm Gra,6622,2,13,5,6,37,28,9,44
LASK Linz,6622,3,10,6,8,31,28,3,36
Rapid Vienna,6622,4,8,9,7,36,33,3,33
Mattersburg,6622,5,7,6,11,33,41,-8,27
Vienna,6622,6,6,6,12,25,43,-18,24
SC Rheindorf,6622,7,4,6,14,18,32,-14,18
FC Salzburg,6623,1,13,8,3,42,19,23,47
SK Sturm Gra,6623,2,12,5,7,35,31,4,41
Rapid Vienna,6623,3,9,10,5,40,30,10,37
LASK Linz,6623,4,9,5,10,29,29,0,32
Mattersburg,6623,5,6,6,12,28,39,-11,24
SC Rheindorf,6623,6,6,6,12,21,32,-11,24
Vienna,6623,7,6,6,12,23,38,-15,24
FC Salzburg,6624,1,14,7,3,43,18,25,49
SK Sturm Gra,6624,2,13,4,7,33,29,4,43
Rapid Vienna,6624,3,9,11,4,39,26,13,38
LASK Linz,6624,4,9,5,10,27,29,-2,32
Vienna,6624,5,7,6,11,26,38,-12,27
Mattersburg,6624,6,5,7,12,29,42,-13,22
SC Rheindorf,6624,7,4,6,14,18,33,-15,18
FC Salzburg,6625,1,14,7,3,42,19,23,49
SK Sturm Gra,6625,2,13,5,6,33,26,7,44
Rapid Vienna,6625,3,7,10,7,34,32,2,31
LASK Linz,6625,4,7,8,9,28,30,-2,29
Vienna,6625,5,8,5,11,28,37,-9,29
SC Rheindorf,6625,6,6,7,11,22,28,-6,25
Mattersburg,6625,7,5,6,13,27,42,-15,21
FC Salzburg,6626,1,13,8,3,40,17,23,47
SK Sturm Gra,6626,2,13,4,7,37,29,8,43
Rapid Vienna,6626,3,7,12,5,35,30,5,33
LASK Linz,6626,4,7,8,9,26,29,-3,29
Vienna,6626,5,8,5,11,27,38,-11,29
Mattersburg,6626,6,7,6,11,32,41,-9,27
SC Rheindorf,6626,7,4,7,13,19,32,-13,19
FC Salzburg,6627,1,15,7,2,46,18,28,52
SK Sturm Gra,6627,2,14,3,7,34,27,7,45
Rapid Vienna,6627,3,9,10,5,37,26,11,37
LASK Linz,6627,4,8,5,11,25,30,-5,29
Mattersburg,6627,5,6,7,11,32,42,-10,25
Vienna,6627,6,6,6,12,24,39,-15,24
SC Rheindorf,6627,7,4,6,14,17,33,-16,18
FC Salzburg,6628,1,15,7,2,47,18,29,52
SK Sturm Gra,6628,2,13,4,7,37,32,5,43
LASK Linz,6628,3,10,5,9,32,28,4,35
Rapid Vienna,6628,4,8,9,7,36,33,3,33
Mattersburg,6628,5,7,5,12,35,43,-8,26
Vienna,6628,6,6,6,12,25,41,-16,24
SC Rheindorf,6628,7,4,6,14,18,35,-17,18
FC Salzburg,6629,1,14,7,3,47,20,27,49
SK Sturm Gra,6629,2,12,5,7,34,32,2,41
Rapid Vienna,6629,3,8,11,5,34,26,8,35
LASK Linz,6629,4,9,6,9,31,27,4,33
Mattersburg,6629,5,7,6,11,32,41,-9,27
Vienna,6629,6,6,5,13,26,43,-17,23
SC Rheindorf,6629,7,5,6,13,19,34,-15,21
FC Salzburg,6630,1,14,8,2,43,17,26,50
SK Sturm Gra,6630,2,11,6,7,31,28,3,39
Rapid Vienna,6630,3,8,12,4,36,27,9,36
LASK Linz,6630,4,8,7,9,29,27,2,31
Vienna,6630,5,7,5,12,26,38,-12,26
Mattersburg,6630,6,6,5,13,28,45,-17,23
SC Rheindorf,6630,7,5,7,12,17,28,-11,22
FC Salzburg,6631,1,14,7,3,45,19,26,49
SK Sturm Gra,6631,2,13,3,8,34,30,4,42
Rapid Vienna,6631,3,9,10,5,39,31,8,37
LASK Linz,6631,4,9,6,9,31,29,2,33
Mattersburg,6631,5,7,6,11,32,39,-7,27
Vienna,6631,6,6,6,12,25,42,-17,24
SC Rheindorf,6631,7,4,6,14,18,34,-16,18
FC Salzburg,6632,1,16,6,2,53,16,37,54
SK Sturm Gra,6632,2,11,4,9,31,38,-7,37
Rapid Vienna,6632,3,7,12,5,35,30,5,33
LASK Linz,6632,4,8,6,10,31,31,0,30
SC Rheindorf,6632,5,7,6,11,24,29,-5,27
Mattersburg,6632,6,7,5,12,34,46,-12,26
Vienna,6632,7,6,5,13,23,41,-18,23
FC Salzburg,6633,1,13,8,3,47,22,25,47
SK Sturm Gra,6633,2,13,5,6,33,27,6,44
Rapid Vienna,6633,3,9,10,5,41,28,13,37
LASK Linz,6633,4,8,6,10,24,26,-2,30
Mattersburg,6633,5,7,5,12,32,45,-13,26
Vienna,6633,6,6,5,13,23,41,-18,23
SC Rheindorf,6633,7,5,7,12,22,33,-11,22
FC Salzburg,6634,1,14,6,4,47,20,27,48
Rapid Vienna,6634,2,11,9,4,37,23,14,42
SK Sturm Gra,6634,3,13,3,8,31,27,4,42
LASK Linz,6634,4,7,6,11,25,30,-5,27
Mattersburg,6634,5,6,7,11,33,45,-12,25
Vienna,6634,6,6,6,12,25,42,-17,24
SC Rheindorf,6634,7,6,5,13,19,30,-11,23
FC Salzburg,6635,1,15,7,2,46,17,29,52
SK Sturm Gra,6635,2,11,5,8,30,32,-2,38
Rapid Vienna,6635,3,8,10,6,35,29,6,34
LASK Linz,6635,4,9,5,10,32,32,0,32
Mattersburg,6635,5,6,7,11,31,42,-11,25
Vienna,6635,6,6,7,11,27,41,-14,25
SC Rheindorf,6635,7,5,7,12,23,31,-8,22
FC Salzburg,6636,1,15,7,2,45,18,27,52
SK Sturm Gra,6636,2,13,5,6,35,29,6,44
LASK Linz,6636,3,9,6,9,33,29,4,33
Rapid Vienna,6636,4,7,10,7,33,31,2,31
SC Rheindorf,6636,5,6,6,12,25,31,-6,24
Mattersburg,6636,6,6,5,13,34,49,-15,23
Vienna,6636,7,6,5,13,24,42,-18,23
FC Salzburg,6637,1,15,6,3,47,21,26,51
SK Sturm Gra,6637,2,12,3,9,32,31,1,39
Rapid Vienna,6637,3,9,10,5,36,26,10,37
LASK Linz,6637,4,8,5,11,28,31,-3,29
Mattersburg,6637,5,8,5,11,36,44,-8,29
Vienna,6637,6,7,5,12,28,42,-14,26
SC Rheindorf,6637,7,5,6,13,19,31,-12,21
FC Salzburg,6638,1,15,7,2,52,18,34,52
SK Sturm Gra,6638,2,14,3,7,38,30,8,45
Rapid Vienna,6638,3,9,10,5,37,30,7,37
LASK Linz,6638,4,8,5,11,28,32,-4,29
Mattersburg,6638,5,6,6,12,29,42,-13,24
Vienna,6638,6,6,5,13,23,43,-20,23
SC Rheindorf,6638,7,5,6,13,17,29,-12,21
FC Salzburg,6639,1,12,9,3,40,20,20,45
SK Sturm Gra,6639,2,13,5,6,35,26,9,44
Rapid Vienna,6639,3,9,11,4,38,25,13,38
Vienna,6639,4,7,6,11,28,38,-10,27
LASK Linz,6639,5,7,5,12,23,32,-9,26
SC Rheindorf,6639,6,6,6,12,19,28,-9,24
Mattersburg,6639,7,6,6,12,28,42,-14,24
FC Salzburg,6640,1,15,6,3,43,16,27,51
SK Sturm Gra,6640,2,12,4,8,32,29,3,40
Rapid Vienna,6640,3,8,9,7,36,31,5,33
Vienna,6640,4,8,5,11,27,38,-11,29
LASK Linz,6640,5,7,7,10,25,31,-6,28
SC Rheindorf,6640,6,6,7,11,19,27,-8,25
Mattersburg,6640,7,6,6,12,32,42,-10,24
FC Salzburg,6641,1,15,6,3,45,17,28,51
SK Sturm Gra,6641,2,14,3,7,33,27,6,45
Rapid Vienna,6641,3,8,9,7,35,29,6,33
LASK Linz,6641,4,8,6,10,26,29,-3,30
Mattersburg,6641,5,7,6,11,29,39,-10,27
Vienna,6641,6,7,5,12,26,40,-14,26
SC Rheindorf,6641,7,5,5,14,18,31,-13,20
FC Salzburg,6642,1,15,6,3,46,19,27,51
SK Sturm Gra,6642,2,13,3,8,33,34,-1,42
Rapid Vienna,6642,3,9,9,6,36,27,9,36
LASK Linz,6642,4,9,5,10,31,29,2,32
Vienna,6642,5,8,5,11,29,40,-11,29
Mattersburg,6642,6,6,5,13,34,44,-10,23
SC Rheindorf,6642,7,5,5,14,19,35,-16,20
FC Salzburg,6643,1,14,8,2,47,19,28,50
SK Sturm Gra,6643,2,12,3,9,33,34,-1,39
Rapid Vienna,6643,3,8,10,6,38,30,8,34
LASK Linz,6643,4,9,5,10,29,31,-2,32
Mattersburg,6643,5,8,6,10,31,38,-7,30
SC Rheindorf,6643,6,6,5,13,21,29,-8,23
Vienna,6643,7,6,5,13,25,43,-18,23
FC Salzburg,6644,1,15,7,2,46,17,29,52
SK Sturm Gra,6644,2,14,4,6,37,27,10,46
Rapid Vienna,6644,3,9,9,6,36,30,6,36
LASK Linz,6644,4,9,5,10,28,31,-3,32
Vienna,6644,5,7,5,12,25,38,-13,26
Mattersburg,6644,6,6,5,13,32,44,-12,23
SC Rheindorf,6644,7,4,5,15,17,34,-17,17
FC Salzburg,6645,1,15,7,2,47,18,29,52
SK Sturm Gra,6645,2,12,4,8,30,29,1,40
LASK Linz,6645,3,9,6,9,27,28,-1,33
Rapid Vienna,6645,4,7,11,6,33,28,5,32
Vienna,6645,5,7,6,11,25,38,-13,27
Mattersburg,6645,6,7,5,12,32,40,-8,26
SC Rheindorf,6645,7,4,7,13,15,28,-13,19
FC Salzburg,6646,1,14,8,2,42,17,25,50
SK Sturm Gra,6646,2,12,5,7,33,31,2,41
Rapid Vienna,6646,3,8,9,7,34,28,6,33
LASK Linz,6646,4,9,6,9,30,30,0,33
SC Rheindorf,6646,5,6,6,12,20,27,-7,24
Mattersburg,6646,6,6,6,12,29,40,-11,24
Vienna,6646,7,6,6,12,25,40,-15,24
FC Salzburg,6647,1,15,6,3,50,21,29,51
SK Sturm Gra,6647,2,13,3,8,32,29,3,42
Rapid Vienna,6647,3,8,10,6,35,29,6,34
LASK Linz,6647,4,8,6,10,28,29,-1,30
Mattersburg,6647,5,6,7,11,36,43,-7,25
SC Rheindorf,6647,6,6,6,12,19,33,-14,24
Vienna,6647,7,6,6,12,26,42,-16,24
FC Salzburg,6648,1,15,6,3,42,16,26,51
SK Sturm Gra,6648,2,15,3,6,37,25,12,48
Rapid Vienna,6648,3,8,10,6,35,31,4,34
LASK Linz,6648,4,7,7,10,29,32,-3,28
Vienna,6648,5,7,5,12,27,40,-13,26
Mattersburg,6648,6,6,6,12,33,45,-12,24
SC Rheindorf,6648,7,4,7,13,17,31,-14,19
FC Salzburg,6649,1,15,6,3,47,18,29,51
SK Sturm Gra,6649,2,11,5,8,31,30,1,38
Rapid Vienna,6649,3,9,10,5,39,30,9,37
LASK Linz,6649,4,8,6,10,29,36,-7,30
Mattersburg,6649,5,8,5,11,32,41,-9,29
SC Rheindorf,6649,6,6,5,13,23,30,-7,23
Vienna,6649,7,6,5,13,25,41,-16,23
FC Salzburg,6650,1,14,6,4,43,20,23,48
SK Sturm Gra,6650,2,13,4,7,33,30,3,43
Rapid Vienna,6650,3,9,10,5,37,27,10,37
LASK Linz,6650,4,9,7,8,29,26,3,34
Vienna,6650,5,6,6,12,24,39,-15,24
Mattersburg,6650,6,5,7,12,27,39,-12,22
SC Rheindorf,6650,7,5,6,13,19,31,-12,21
FC Salzburg,6651,1,15,7,2,48,20,28,52
SK Sturm Gra,6651,2,12,4,8,31,29,2,40
Rapid Vienna,6651,3,8,10,6,34,26,8,34
LASK Linz,6651,4,8,6,10,25,29,-4,30
Vienna,6651,5,7,5,12,29,43,-14,26
Mattersburg,6651,6,6,6,12,33,43,-10,24
SC Rheindorf,6651,7,6,6,12,18,28,-10,24
FC Salzburg,6652,1,13,7,4,41,20,21,46
SK Sturm Gra,6652,2,13,4,7,33,27,6,43
Rapid Vienna,6652,3,9,10,5,36,26,10,37
LASK Linz,6652,4,9,6,9,30,30,0,33
Mattersburg,6652,5,7,5,12,32,44,-12,26
Vienna,6652,6,6,6,12,25,40,-15,24
SC Rheindorf,6652,7,5,6,13,18,28,-10,21
FC Salzburg,6653,1,15,6,3,47,18,29,51
SK Sturm Gra,6653,2,13,3,8,33,34,-1,42
Rapid Vienna,6653,3,9,9,6,39,31,8,36
LASK Linz,6653,4,9,5,10,28,28,0,32
Mattersburg,6653,5,7,5,12,31,42,-11,26
Vienna,6653,6,7,5,12,25,40,-15,26
SC Rheindorf,6653,7,5,5,14,25,35,-10,20
FC Salzburg,6654,1,15,7,2,50,17,33,52
SK Sturm Gra,6654,2,12,3,9,31,33,-2,39
Rapid Vienna,6654,3,8,11,5,35,26,9,35
LASK Linz,6654,4,9,7,8,30,26,4,34
Mattersburg,6654,5,7,5,12,31,45,-14,26
Vienna,6654,6,6,5,13,23,40,-17,23
SC Rheindorf,6654,7,5,6,13,18,31,-13,21
FC Salzburg,6655,1,15,6,3,46,19,27,51
SK Sturm Gra,6655,2,13,4,7,37,31,6,43
LASK Linz,6655,3,10,6,8,30,27,3,36
Rapid Vienna,6655,4,7,11,6,33,28,5,32
Vienna,6655,5,7,5,12,27,39,-12,26
SC Rheindorf,6655,6,5,7,12,17,27,-10,22
Mattersburg,6655,7,5,5,14,26,45,-19,20
FC Salzburg,6656,1,15,7,2,47,17,30,52
SK Sturm Gra,6656,2,12,5,7,31,28,3,41
Rapid Vienna,6656,3,8,9,7,35,30,5,33
LASK Linz,6656,4,8,6,10,27,27,0,30
Mattersburg,6656,5,6,7,11,27,40,-13,25
SC Rheindorf,6656,6,6,6,12,18,27,-9,24
Vienna,6656,7,6,6,12,23,39,-16,24
FC Salzburg,6657,1,14,8,2,49,16,33,50
SK Sturm Gra,6657,2,13,5,6,34,27,7,44
Rapid Vienna,6657,3,8,10,6,33,30,3,34
LASK Linz,6657,4,8,8,8,30,27,3,32
Mattersburg,6657,5,7,6,11,30,45,-15,27
Vienna,6657,6,6,5,13,24,42,-18,23
SC Rheindorf,6657,7,4,6,14,16,29,-13,18
FC Salzburg,6658,1,14,6,4,46,19,27,48
SK Sturm Gra,6658,2,13,4,7,31,26,5,43
Rapid Vienna,6658,3,9,10,5,34,27,7,37
LASK Linz,6658,4,9,5,10,29,29,0,32
Mattersburg,6658,5,7,5,12,33,45,-12,26
Vienna,6658,6,7,5,12,26,39,-13,26
SC Rheindorf,6658,7,4,7,13,16,30,-14,19
FC Salzburg,6659,1,16,6,2,47,19,28,54
SK Sturm Gra,6659,2,13,3,8,31,30,1,42
Rapid Vienna,6659,3,8,9,7,33,30,3,33
LASK Linz,6659,4,9,5,10,29,27,2,32
Mattersburg,6659,5,7,6,11,33,40,-7,27
Vienna,6659,6,6,6,12,26,41,-15,24
SC Rheindorf,6659,7,5,5,14,19,31,-12,20
FC Salzburg,6660,1,12,7,5,41,23,18,43
SK Sturm Gra,6660,2,12,5,7,30,27,3,41
Rapid Vienna,6660,3,9,11,4,38,26,12,38
LASK Linz,6660,4,8,8,8,27,27,0,32
Vienna,6660,5,7,6,11,25,38,-13,27
Mattersburg,6660,6,6,6,12,30,40,-10,24
SC Rheindorf,6660,7,4,9,11,18,28,-10,21
FC Salzburg,6661,1,15,7,2,48,18,30,52
SK Sturm Gra,6661,2,12,5,7,29,26,3,41
Rapid Vienna,6661,3,7,12,5,33,26,7,33
LASK Linz,6661,4,7,6,11,26,33,-7,27
Mattersburg,6661,5,7,5,12,36,46,-10,26
Vienna,6661,6,7,5,12,26,41,-15,26
SC Rheindorf,6661,7,6,6,12,20,28,-8,24
FC Salzburg,6662,1,15,7,2,46,17,29,52
SK Sturm Gra,6662,2,12,5,7,33,29,4,41
LASK Linz,6662,3,9,7,8,28,26,2,34
Rapid Vienna,6662,4,7,10,7,33,29,4,31
Mattersburg,6662,5,6,6,12,30,42,-12,24
Vienna,6662,6,6,6,12,25,40,-15,24
SC Rheindorf,6662,7,6,5,13,20,32,-12,23
FC Salzburg,6663,1,13,9,2,44,20,24,48
SK Sturm Gra,6663,2,13,4,7,33,28,5,43
Rapid Vienna,6663,3,7,11,6,33,28,5,32
LASK Linz,6663,4,7,8,9,27,30,-3,29
Vienna,6663,5,7,6,11,29,40,-11,27
SC Rheindorf,6663,6,6,6,12,20,28,-8,24
Mattersburg,6663,7,6,6,12,31,43,-12,24
FC Salzburg,6664,1,15,7,2,43,16,27,52
SK Sturm Gra,6664,2,11,5,8,35,33,2,38
Rapid Vienna,6664,3,9,10,5,35,26,9,37
LASK Linz,6664,4,9,7,8,30,27,3,34
Vienna,6664,5,7,5,12,26,39,-13,26
SC Rheindorf,6664,6,5,7,12,21,31,-10,22
Mattersburg,6664,7,5,5,14,27,45,-18,20
FC Salzburg,6665,1,13,7,4,43,21,22,46
SK Sturm Gra,6665,2,12,5,7,32,27,5,41
Rapid Vienna,6665,3,7,12,5,34,28,6,33
LASK Linz,6665,4,9,5,10,28,30,-2,32
Mattersburg,6665,5,8,5,11,33,39,-6,29
Vienna,6665,6,8,5,11,26,38,-12,29
SC Rheindorf,6665,7,4,7,13,17,30,-13,19
FC Salzburg,6666,1,14,7,3,43,18,25,49
SK Sturm Gra,6666,2,11,7,6,33,29,4,40
LASK Linz,6666,3,10,6,8,33,25,8,36
Rapid Vienna,6666,4,7,11,6,34,30,4,32
Vienna,6666,5,7,5,12,24,41,-17,26
Mattersburg,6666,6,6,5,13,31,42,-11,23
SC Rheindorf,6666,7,5,7,12,17,30,-13,22
FC Salzburg,6667,1,15,7,2,44,16,28,52
SK Sturm Gra,6667,2,11,5,8,32,30,2,38
Rapid Vienna,6667,3,8,10,6,35,28,7,34
LASK Linz,6667,4,7,8,9,28,33,-5,29
Mattersburg,6667,5,7,6,11,33,41,-8,27
Vienna,6667,6,6,6,12,24,39,-15,24
SC Rheindorf,6667,7,5,8,11,20,29,-9,23
FC Salzburg,6668,1,15,6,3,43,17,26,51
SK Sturm Gra,6668,2,12,5,7,31,28,3,41
Rapid Vienna,6668,3,9,9,6,37,28,9,36
LASK Linz,6668,4,8,6,10,26,28,-2,30
Mattersburg,6668,5,7,5,12,29,39,-10,26
Vienna,6668,6,7,5,12,24,38,-14,26
SC Rheindorf,6668,7,5,6,13,22,34,-12,21
FC Salzburg,6669,1,14,7,3,46,20,26,49
SK Sturm Gra,6669,2,12,5,7,33,29,4,41
Rapid Vienna,6669,3,8,9,7,35,29,6,33
LASK Linz,6669,4,9,6,9,30,29,1,33
Mattersburg,6669,5,8,6,10,35,39,-4,30
Vienna,6669,6,6,5,13,23,42,-19,23
SC Rheindorf,6669,7,5,6,13,18,32,-14,21
FC Salzburg,6670,1,16,6,2,46,17,29,54
SK Sturm Gra,6670,2,13,3,8,33,29,4,42
Rapid Vienna,6670,3,8,10,6,38,29,9,34
LASK Linz,6670,4,8,6,10,28,34,-6,30
Mattersburg,6670,5,6,7,11,31,40,-9,25
Vienna,6670,6,6,6,12,23,38,-15,24
SC Rheindorf,6670,7,5,6,13,19,31,-12,21
FC Salzburg,6671,1,13,9,2,44,19,25,48
SK Sturm Gra,6671,2,12,3,9,33,33,0,39
Rapid Vienna,6671,3,8,10,6,34,27,7,34
LASK Linz,6671,4,9,6,9,29,29,0,33
Vienna,6671,5,6,7,11,26,40,-14,25
SC Rheindorf,6671,6,6,6,12,21,29,-8,24
Mattersburg,6671,7,5,9,10,29,39,-10,24
FC Salzburg,6672,1,16,6,2,49,20,29,54
SK Sturm Gra,6672,2,12,4,8,35,30,5,40
LASK Linz,6672,3,9,6,9,28,28,0,33
Rapid Vienna,6672,4,7,10,7,33,31,2,31
SC Rheindorf,6672,5,7,6,11,21,28,-7,27
Vienna,6672,6,7,5,12,27,38,-11,26
Mattersburg,6672,7,5,5,14,32,50,-18,20
FC Salzburg,6673,1,15,6,3,46,20,26,51
Rapid Vienna,6673,2,10,10,4,40,27,13,40
SK Sturm Gra,6673,3,11,4,9,31,32,-1,37
LASK Linz,6673,4,8,6,10,28,33,-5,30
Vienna,6673,5,7,5,12,27,41,-14,26
Mattersburg,6673,6,6,6,12,31,40,-9,24
SC Rheindorf,6673,7,4,9,11,19,29,-10,21
FC Salzburg,6674,1,14,6,4,45,18,27,48
SK Sturm Gra,6674,2,13,3,8,32,31,1,42
Rapid Vienna,6674,3,8,10,6,34,28,6,34
LASK Linz,6674,4,9,6,9,26,25,1,33
Vienna,6674,5,7,6,11,27,40,-13,27
Mattersburg,6674,6,6,6,12,31,41,-10,24
SC Rheindorf,6674,7,6,5,13,19,31,-12,23
FC Salzburg,6675,1,15,6,3,45,20,25,51
Rapid Vienna,6675,2,10,10,4,39,25,14,40
SK Sturm Gra,6675,3,12,3,9,32,34,-2,39
LASK Linz,6675,4,9,5,10,28,29,-1,32
Mattersburg,6675,5,7,5,12,35,43,-8,26
Vienna,6675,6,6,5,13,25,42,-17,23
SC Rheindorf,6675,7,5,6,13,19,30,-11,21
FC Salzburg,6676,1,15,7,2,46,20,26,52
SK Sturm Gra,6676,2,12,4,8,33,31,2,40
Rapid Vienna,6676,3,9,10,5,36,26,10,37
LASK Linz,6676,4,8,7,9,29,29,0,31
Mattersburg,6676,5,7,5,12,32,42,-10,26
Vienna,6676,6,7,5,12,25,39,-14,26
SC Rheindorf,6676,7,4,6,14,17,31,-14,18
FC Salzburg,6677,1,13,9,2,45,20,25,48
SK Sturm Gra,6677,2,12,6,6,35,29,6,42
Rapid Vienna,6677,3,8,12,4,36,27,9,36
LASK Linz,6677,4,8,7,9,26,30,-4,31
Vienna,6677,5,7,5,12,27,42,-15,26
Mattersburg,6677,6,5,7,12,31,43,-12,22
SC Rheindorf,6677,7,5,6,13,21,30,-9,21
FC Salzburg,6678,1,15,7,2,52,19,33,52
SK Sturm Gra,6678,2,13,4,7,34,28,6,43
Rapid Vienna,6678,3,8,11,5,34,26,8,35
LASK Linz,6678,4,8,6,10,25,28,-3,30
Vienna,6678,5,7,5,12,27,44,-17,26
Mattersburg,6678,6,5,7,12,30,44,-14,22
SC Rheindorf,6678,7,5,6,13,17,30,-13,21
FC Salzburg,6679,1,12,9,3,41,19,22,45
SK Sturm Gra,6679,2,12,4,8,31,29,2,40
Rapid Vienna,6679,3,9,10,5,38,28,10,37
LASK Linz,6679,4,10,5,9,33,28,5,35
Mattersburg,6679,5,8,6,10,36,41,-5,30
Vienna,6679,6,6,7,11,27,41,-14,25
SC Rheindorf,6679,7,4,5,15,16,36,-20,17
FC Salzburg,6680,1,15,7,2,47,19,28,52
SK Sturm Gra,6680,2,13,4,7,34,29,5,43
Rapid Vienna,6680,3,8,10,6,39,31,8,34
LASK Linz,6680,4,8,6,10,28,30,-2,30
Vienna,6680,5,7,5,12,28,43,-15,26
SC Rheindorf,6680,6,6,6,12,20,29,-9,24
Mattersburg,6680,7,5,6,13,28,43,-15,21
FC Salzburg,6681,1,13,8,3,44,20,24,47
SK Sturm Gra,6681,2,14,4,6,34,26,8,46
LASK Linz,6681,3,9,7,8,32,27,5,34
Rapid Vienna,6681,4,7,10,7,35,34,1,31
Mattersburg,6681,5,7,6,11,33,40,-7,27
Vienna,6681,6,6,6,12,25,40,-15,24
SC Rheindorf,6681,7,5,5,14,18,34,-16,20
FC Salzburg,6682,1,14,8,2,45,16,29,50
Rapid Vienna,6682,2,10,10,4,39,26,13,40
SK Sturm Gra,6682,3,12,4,8,33,29,4,40
LASK Linz,6682,4,7,6,11,25,32,-7,27
Vienna,6682,5,7,5,12,28,43,-15,26
Mattersburg,6682,6,6,6,12,31,45,-14,24
SC Rheindorf,6682,7,6,5,13,22,32,-10,23
FC Salzburg,6683,1,14,7,3,43,18,25,49
SK Sturm Gra,6683,2,14,4,6,34,27,7,46
LASK Linz,6683,3,10,6,8,30,27,3,36
Rapid Vienna,6683,4,8,10,6,36,29,7,34
Mattersburg,6683,5,6,6,12,30,42,-12,24
Vienna,6683,6,6,5,13,24,41,-17,23
SC Rheindorf,6683,7,4,6,14,19,32,-13,18
FC Salzburg,6684,1,15,7,2,42,16,26,52
SK Sturm Gra,6684,2,14,3,7,36,29,7,45
Rapid Vienna,6684,3,7,11,6,35,30,5,32
Mattersburg,6684,4,8,5,11,31,39,-8,29
LASK Linz,6684,5,7,6,11,24,30,-6,27
Vienna,6684,6,6,6,12,24,39,-15,24
SC Rheindorf,6684,7,5,6,13,21,30,-9,21
FC Salzburg,6685,1,15,6,3,46,17,29,51
SK Sturm Gra,6685,2,12,4,8,30,29,1,40
LASK Linz,6685,3,9,6,9,30,30,0,33
Rapid Vienna,6685,4,7,11,6,34,29,5,32
Mattersburg,6685,5,8,6,10,33,39,-6,30
Vienna,6685,6,6,5,13,23,41,-18,23
SC Rheindorf,6685,7,4,8,12,19,30,-11,20
FC Salzburg,6686,1,15,7,2,45,18,27,52
SK Sturm Gra,6686,2,12,4,8,33,33,0,40
Rapid Vienna,6686,3,8,9,7,36,32,4,33
LASK Linz,6686,4,9,6,9,28,27,1,33
Mattersburg,6686,5,7,6,11,33,38,-5,27
Vienna,6686,6,6,6,12,24,39,-15,24
SC Rheindorf,6686,7,5,6,13,18,30,-12,21
FC Salzburg,6687,1,15,6,3,43,18,25,51
SK Sturm Gra,6687,2,12,3,9,33,33,0,39
Rapid Vienna,6687,3,9,10,5,34,25,9,37
LASK Linz,6687,4,9,5,10,27,29,-2,32
Mattersburg,6687,5,6,7,11,28,38,-10,25
Vienna,6687,6,6,6,12,24,39,-15,24
SC Rheindorf,6687,7,5,7,12,21,28,-7,22
FC Salzburg,6688,1,15,6,3,48,19,29,51
SK Sturm Gra,6688,2,14,3,7,36,30,6,45
Rapid Vienna,6688,3,8,9,7,35,29,6,33
LASK Linz,6688,4,9,5,10,28,30,-2,32
Vienna,6688,5,8,5,11,29,39,-10,29
SC Rheindorf,6688,6,5,6,13,20,32,-12,21
Mattersburg,6688,7,5,6,13,28,45,-17,21
FC Salzburg,6689,1,13,6,5,44,21,23,45
SK Sturm Gra,6689,2,13,3,8,35,29,6,42
Rapid Vienna,6689,3,9,9,6,37,28,9,36
LASK Linz,6689,4,9,7,8,30,29,1,34
Vienna,6689,5,7,5,12,26,41,-15,26
SC Rheindorf,6689,6,6,6,12,19,30,-11,24
Mattersburg,6689,7,6,6,12,31,44,-13,24
FC Salzburg,6690,1,15,6,3,48,21,27,51
SK Sturm Gra,6690,2,13,3,8,35,31,4,42
Rapid Vienna,6690,3,9,10,5,38,29,9,37
Mattersburg,6690,4,7,6,11,35,43,-8,27
LASK Linz,6690,5,7,5,12,25,33,-8,26
Vienna,6690,6,7,5,12,25,38,-13,26
SC Rheindorf,6690,7,5,7,12,20,31,-11,22
FC Salzburg,6691,1,15,6,3,44,18,26,51
SK Sturm Gra,6691,2,14,3,7,34,25,9,45
Rapid Vienna,6691,3,9,9,6,34,28,6,36
LASK Linz,6691,4,8,5,11,25,28,-3,29
Vienna,6691,5,7,5,12,24,38,-14,26
Mattersburg,6691,6,6,5,13,32,44,-12,23
SC Rheindorf,6691,7,6,5,13,20,32,-12,23
FC Salzburg,6692,1,16,6,2,48,17,31,54
SK Sturm Gra,6692,2,14,3,7,31,25,6,45
Rapid Vienna,6692,3,8,9,7,36,29,7,33
LASK Linz,6692,4,9,5,10,26,26,0,32
Mattersburg,6692,5,6,6,12,30,44,-14,24
Vienna,6692,6,6,5,13,25,42,-17,23
SC Rheindorf,6692,7,5,6,13,17,30,-13,21
FC Salzburg,6693,1,12,8,4,42,22,20,44
Rapid Vienna,6693,2,10,10,4,39,24,15,40
SK Sturm Gra,6693,3,11,4,9,30,33,-3,37
LASK Linz,6693,4,9,6,9,26,28,-2,33
Vienna,6693,5,8,5,11,27,38,-11,29
SC Rheindorf,6693,6,7,5,12,24,28,-4,26
Mattersburg,6693,7,5,6,13,29,44,-15,21
FC Salzburg,6694,1,15,7,2,45,17,28,52
SK Sturm Gra,6694,2,12,4,8,33,30,3,40
Rapid Vienna,6694,3,9,10,5,40,28,12,37
LASK Linz,6694,4,9,6,9,32,27,5,33
Mattersburg,6694,5,6,6,12,33,47,-14,24
Vienna,6694,6,6,6,12,26,42,-16,24
SC Rheindorf,6694,7,4,7,13,19,37,-18,19
FC Salzburg,6695,1,14,7,3,43,18,25,49
SK Sturm Gra,6695,2,11,6,7,31,28,3,39
Rapid Vienna,6695,3,8,12,4,35,26,9,36
LASK Linz,6695,4,7,8,9,27,29,-2,29
Vienna,6695,5,7,6,11,28,39,-11,27
Mattersburg,6695,6,7,5,12,32,43,-11,26
SC Rheindorf,6695,7,4,8,12,17,30,-13,20
FC Salzburg,6696,1,14,7,3,45,23,22,49
Rapid Vienna,6696,2,10,10,4,42,26,16,40
SK Sturm Gra,6696,3,11,5,8,33,32,1,38
Mattersburg,6696,4,8,5,11,33,37,-4,29
LASK Linz,6696,5,8,5,11,25,32,-7,29
SC Rheindorf,6696,6,6,5,13,18,28,-10,23
Vienna,6696,7,6,5,13,24,42,-18,23
FC Salzburg,6697,1,15,7,2,43,15,28,52
SK Sturm Gra,6697,2,12,4,8,30,29,1,40
Rapid Vienna,6697,3,8,10,6,35,30,5,34
LASK Linz,6697,4,9,6,9,29,26,3,33
Vienna,6697,5,7,5,12,24,39,-15,26
SC Rheindorf,6697,6,6,5,13,21,31,-10,23
Mattersburg,6697,7,6,5,13,29,41,-12,23
FC Salzburg,6698,1,13,9,2,46,18,28,48
SK Sturm Gra,6698,2,13,5,6,32,26,6,44
Rapid Vienna,6698,3,7,12,5,35,28,7,33
LASK Linz,6698,4,8,7,9,29,30,-1,31
Mattersburg,6698,5,7,6,11,33,38,-5,27
Vienna,6698,6,6,5,13,23,46,-23,23
SC Rheindorf,6698,7,5,6,13,18,30,-12,21
FC Salzburg,6699,1,15,7,2,45,17,28,52
SK Sturm Gra,6699,2,12,4,8,34,34,0,40
Rapid Vienna,6699,3,7,12,5,34,27,7,33
LASK Linz,6699,4,8,8,8,29,29,0,32
Vienna,6699,5,7,5,12,29,40,-11,26
Mattersburg,6699,6,6,6,12,29,43,-14,24
SC Rheindorf,6699,7,5,6,13,20,30,-10,21
FC Salzburg,6700,1,13,8,3,43,20,23,47
SK Sturm Gra,6700,2,12,3,9,32,30,2,39
Rapid Vienna,6700,3,9,11,4,36,26,10,38
LASK Linz,6700,4,7,7,10,27,30,-3,28
SC Rheindorf,6700,5,6,7,11,21,28,-7,25
Mattersburg,6700,6,6,7,11,31,42,-11,25
Vienna,6700,7,6,7,11,26,40,-14,25
FC Salzburg,6701,1,15,6,3,49,22,27,51
SK Sturm Gra,6701,2,13,3,8,33,32,1,42
Rapid Vienna,6701,3,8,10,6,38,28,10,34
LASK Linz,6701,4,8,6,10,29,30,-1,30
SC Rheindorf,6701,5,8,5,11,25,26,-1,29
Vienna,6701,6,6,6,12,26,41,-15,24
Mattersburg,6701,7,5,6,13,27,48,-21,21
FC Salzburg,6702,1,14,7,3,42,18,24,49
SK Sturm Gra,6702,2,11,5,8,30,28,2,38
Rapid Vienna,6702,3,8,10,6,33,27,6,34
Mattersburg,6702,4,9,5,10,34,38,-4,32
LASK Linz,6702,5,8,7,9,28,28,0,31
Vienna,6702,6,6,6,12,25,41,-16,24
SC Rheindorf,6702,7,5,6,13,18,30,-12,21
FC Salzburg,6703,1,13,8,3,45,18,27,47
SK Sturm Gra,6703,2,13,4,7,32,27,5,43
Rapid Vienna,6703,3,9,9,6,34,26,8,36
LASK Linz,6703,4,9,5,10,30,32,-2,32
Vienna,6703,5,6,7,11,24,38,-14,25
SC Rheindorf,6703,6,6,6,12,21,27,-6,24
Mattersburg,6703,7,5,7,12,29,47,-18,22
FC Salzburg,6704,1,12,10,2,42,19,23,46
SK Sturm Gra,6704,2,12,4,8,36,31,5,40
LASK Linz,6704,3,9,6,9,27,27,0,33
Rapid Vienna,6704,4,7,10,7,33,30,3,31
Mattersburg,6704,5,7,6,11,33,41,-8,27
Vienna,6704,6,7,6,11,24,37,-13,27
SC Rheindorf,6704,7,6,6,12,20,30,-10,24
FC Salzburg,6705,1,14,6,4,48,24,24,48
SK Sturm Gra,6705,2,13,5,6,35,28,7,44
Rapid Vienna,6705,3,9,10,5,37,27,10,37
LASK Linz,6705,4,10,6,8,30,27,3,36
Vienna,6705,5,6,6,12,26,42,-16,24
Mattersburg,6705,6,5,7,12,32,46,-14,22
SC Rheindorf,6705,7,4,6,14,20,34,-14,18
FC Salzburg,6706,1,16,6,2,55,18,37,54
SK Sturm Gra,6706,2,12,3,9,31,33,-2,39
LASK Linz,6706,3,10,5,9,30,27,3,35
Rapid Vienna,6706,4,7,10,7,34,32,2,31
Mattersburg,6706,5,7,6,11,35,47,-12,27
Vienna,6706,6,6,6,12,27,43,-16,24
SC Rheindorf,6706,7,5,6,13,19,31,-12,21
FC Salzburg,6707,1,16,6,2,47,16,31,54
SK Sturm Gra,6707,2,12,4,8,35,34,1,40
Rapid Vienna,6707,3,8,11,5,36,29,7,35
LASK Linz,6707,4,8,7,9,28,28,0,31
Mattersburg,6707,5,6,6,12,32,47,-15,24
SC Rheindorf,6707,6,6,5,13,23,30,-7,23
Vienna,6707,7,6,5,13,24,41,-17,23
FC Salzburg,6708,1,13,7,4,45,24,21,46
SK Sturm Gra,6708,2,13,4,7,35,28,7,43
Rapid Vienna,6708,3,9,11,4,41,26,15,38
Mattersburg,6708,4,8,6,10,34,39,-5,30
LASK Linz,6708,5,7,6,11,26,33,-7,27
SC Rheindorf,6708,6,6,5,13,22,35,-13,23
Vienna,6708,7,6,5,13,24,42,-18,23
FC Salzburg,6709,1,14,7,3,42,18,24,49
SK Sturm Gra,6709,2,12,6,6,33,26,7,42
Rapid Vienna,6709,3,8,11,5,37,27,10,35
LASK Linz,6709,4,8,8,8,27,27,0,32
Vienna,6709,5,8,5,11,28,38,-10,29
Mattersburg,6709,6,6,5,13,29,42,-13,23
SC Rheindorf,6709,7,4,6,14,16,34,-18,18
FC Salzburg,6710,1,15,7,2,44,18,26,52
SK Sturm Gra,6710,2,11,4,9,30,31,-1,37
LASK Linz,6710,3,9,6,9,31,30,1,33
Rapid Vienna,6710,4,7,11,6,35,30,5,32
Vienna,6710,5,7,5,12,30,40,-10,26
Mattersburg,6710,6,6,7,11,32,45,-13,25
SC Rheindorf,6710,7,6,6,12,21,29,-8,24
FC Salzburg,6711,1,15,7,2,46,17,29,52
SK Sturm Gra,6711,2,13,3,8,35,30,5,42
Rapid Vienna,6711,3,8,11,5,35,26,9,35
LASK Linz,6711,4,10,5,9,30,31,-1,35
Mattersburg,6711,5,6,6,12,33,44,-11,24
Vienna,6711,6,6,5,13,24,41,-17,23
SC Rheindorf,6711,7,4,7,13,18,32,-14,19
FC Salzburg,6712,1,16,6,2,48,17,31,54
SK Sturm Gra,6712,2,12,4,8,35,33,2,40
LASK Linz,6712,3,11,5,8,33,29,4,38
Rapid Vienna,6712,4,8,10,6,35,31,4,34
Mattersburg,6712,5,7,5,12,31,40,-9,26
Vienna,6712,6,6,5,13,24,40,-16,23
SC Rheindorf,6712,7,4,5,15,16,32,-16,17
FC Salzburg,6713,1,14,7,3,45,20,25,49
SK Sturm Gra,6713,2,13,3,8,35,30,5,42
Rapid Vienna,6713,3,9,10,5,36,27,9,37
LASK Linz,6713,4,8,7,9,28,28,0,31
Vienna,6713,5,7,5,12,24,38,-14,26
Mattersburg,6713,6,6,7,11,30,41,-11,25
SC Rheindorf,6713,7,4,7,13,17,31,-14,19
FC Salzburg,6714,1,15,7,2,46,16,30,52
SK Sturm Gra,6714,2,13,3,8,33,32,1,42
Rapid Vienna,6714,3,7,10,7,32,28,4,31
LASK Linz,6714,4,8,6,10,28,28,0,30
Mattersburg,6714,5,8,6,10,32,38,-6,30
SC Rheindorf,6714,6,6,5,13,20,31,-11,23
Vienna,6714,7,6,5,13,23,41,-18,23
FC Salzburg,6715,1,14,7,3,44,20,24,49
SK Sturm Gra,6715,2,13,5,6,39,31,8,44
Rapid Vienna,6715,3,8,11,5,39,32,7,35
LASK Linz,6715,4,9,6,9,30,28,2,33
Mattersburg,6715,5,6,6,12,28,41,-13,24
Vienna,6715,6,6,6,12,24,39,-15,24
SC Rheindorf,6715,7,5,5,14,19,32,-13,20
FC Salzburg,6716,1,15,7,2,45,16,29,52
SK Sturm Gra,6716,2,12,5,7,35,30,5,41
Rapid Vienna,6716,3,7,12,5,33,26,7,33
LASK Linz,6716,4,9,5,10,27,30,-3,32
Mattersburg,6716,5,6,6,12,31,43,-12,24
SC Rheindorf,6716,6,5,8,11,22,31,-9,23
Vienna,6716,7,6,5,13,25,42,-17,23
FC Salzburg,6717,1,14,7,3,45,19,26,49
SK Sturm Gra,6717,2,12,5,7,31,28,3,41
Rapid Vienna,6717,3,10,10,4,40,26,14,40
LASK Linz,6717,4,8,5,11,27,30,-3,29
Vienna,6717,5,6,6,12,26,44,-18,24
Mattersburg,6717,6,5,8,11,28,40,-12,23
SC Rheindorf,6717,7,5,7,12,18,28,-10,22
FC Salzburg,6718,1,16,6,2,53,17,36,54
SK Sturm Gra,6718,2,13,3,8,30,27,3,42
Rapid Vienna,6718,3,10,9,5,39,29,10,39
LASK Linz,6718,4,7,6,11,26,33,-7,27
Mattersburg,6718,5,6,6,12,31,44,-13,24
SC Rheindorf,6718,6,6,5,13,20,29,-9,23
Vienna,6718,7,6,5,13,24,44,-20,23
FC Salzburg,6719,1,15,7,2,44,18,26,52
SK Sturm Gra,6719,2,11,4,9,31,30,1,37
Rapid Vienna,6719,3,8,11,5,34,26,8,35
LASK Linz,6719,4,9,7,8,30,29,1,34
Mattersburg,6719,5,7,6,11,32,39,-7,27
Vienna,6719,6,6,5,13,25,41,-16,23
SC Rheindorf,6719,7,5,6,13,17,30,-13,21
FC Salzburg,6720,1,14,7,3,46,17,29,49
SK Sturm Gra,6720,2,13,4,7,33,27,6,43
Rapid Vienna,6720,3,10,9,5,35,27,8,39
LASK Linz,6720,4,8,6,10,26,29,-3,30
Vienna,6720,5,7,5,12,24,41,-17,26
Mattersburg,6720,6,6,7,11,29,39,-10,25
SC Rheindorf,6720,7,4,6,14,17,30,-13,18
FC Salzburg,6721,1,15,6,3,47,20,27,51
SK Sturm Gra,6721,2,12,4,8,35,30,5,40
Rapid Vienna,6721,3,9,10,5,36,30,6,37
LASK Linz,6721,4,9,6,9,29,27,2,33
Vienna,6721,5,7,5,12,27,40,-13,26
SC Rheindorf,6721,6,4,9,11,18,28,-10,21
Mattersburg,6721,7,5,6,13,28,45,-17,21
FC Salzburg,6722,1,14,6,4,46,19,27,48
SK Sturm Gra,6722,2,12,4,8,32,32,0,40
Rapid Vienna,6722,3,8,10,6,35,33,2,34
LASK Linz,6722,4,9,6,9,30,26,4,33
Mattersburg,6722,5,9,5,10,34,38,-4,32
Vienna,6722,6,6,5,13,23,42,-19,23
SC Rheindorf,6722,7,5,6,13,21,31,-10,21
FC Salzburg,6723,1,13,7,4,41,20,21,46
SK Sturm Gra,6723,2,12,5,7,32,30,2,41
Rapid Vienna,6723,3,9,10,5,36,25,11,37
LASK Linz,6723,4,9,7,8,32,29,3,34
Mattersburg,6723,5,7,7,10,32,40,-8,28
Vienna,6723,6,6,5,13,23,40,-17,23
SC Rheindorf,6723,7,4,7,13,21,33,-12,19
FC Salzburg,6724,1,13,6,5,45,21,24,45
SK Sturm Gra,6724,2,11,5,8,30,31,-1,38
Rapid Vienna,6724,3,8,11,5,35,29,6,35
LASK Linz,6724,4,9,6,9,30,27,3,33
Mattersburg,6724,5,8,5,11,34,40,-6,29
Vienna,6724,6,8,5,11,27,39,-12,29
SC Rheindorf,6724,7,5,6,13,18,32,-14,21
FC Salzburg,6725,1,14,8,2,46,19,27,50
Rapid Vienna,6725,2,9,10,5,38,27,11,37
SK Sturm Gra,6725,3,11,4,9,31,32,-1,37
Mattersburg,6725,4,8,6,10,35,40,-5,30
LASK Linz,6725,5,8,5,11,26,31,-5,29
Vienna,6725,6,6,6,12,23,40,-17,24
SC Rheindorf,6725,7,6,5,13,21,31,-10,23
FC Salzburg,6726,1,14,7,3,44,20,24,49
SK Sturm Gra,6726,2,12,5,7,32,28,4,41
Rapid Vienna,6726,3,9,9,6,33,25,8,36
LASK Linz,6726,4,10,5,9,28,26,2,35
Vienna,6726,5,8,5,11,31,41,-10,29
Mattersburg,6726,6,6,5,13,31,46,-15,23
SC Rheindorf,6726,7,4,6,14,18,31,-13,18
FC Salzburg,6727,1,14,7,3,46,22,24,49
Rapid Vienna,6727,2,11,9,4,41,28,13,42
SK Sturm Gra,6727,3,12,3,9,34,31,3,39
LASK Linz,6727,4,8,5,11,27,32,-5,29
Vienna,6727,5,7,6,11,27,40,-13,27
Mattersburg,6727,6,7,5,12,33,44,-11,26
SC Rheindorf,6727,7,5,5,14,21,32,-11,20
FC Salzburg,6728,1,14,7,3,43,19,24,49
SK Sturm Gra,6728,2,12,3,9,33,31,2,39
Rapid Vienna,6728,3,9,9,6,36,27,9,36
LASK Linz,6728,4,9,5,10,31,30,1,32
SC Rheindorf,6728,5,7,6,11,21,28,-7,27
Mattersburg,6728,6,6,7,11,31,42,-11,25
Vienna,6728,7,6,5,13,24,42,-18,23
FC Salzburg,6729,1,14,7,3,40,17,23,49
SK Sturm Gra,6729,2,12,4,8,31,27,4,40
Rapid Vienna,6729,3,8,10,6,35,28,7,34
Mattersburg,6729,4,8,6,10,36,37,-1,30
LASK Linz,6729,5,7,7,10,26,30,-4,28
SC Rheindorf,6729,6,7,5,12,20,30,-10,26
Vienna,6729,7,6,5,13,23,42,-19,23
FC Salzburg,6730,1,13,8,3,46,23,23,47
SK Sturm Gra,6730,2,13,4,7,32,28,4,43
Rapid Vienna,6730,3,7,11,6,33,28,5,32
LASK Linz,6730,4,8,6,10,30,31,-1,30
Mattersburg,6730,5,8,5,11,37,44,-7,29
SC Rheindorf,6730,6,6,6,12,21,30,-9,24
Vienna,6730,7,6,6,12,27,42,-15,24
FC Salzburg,6731,1,14,7,3,43,16,27,49
SK Sturm Gra,6731,2,12,4,8,31,30,1,40
Rapid Vienna,6731,3,8,11,5,34,27,7,35
LASK Linz,6731,4,8,6,10,26,28,-2,30
Mattersburg,6731,5,7,5,12,34,43,-9,26
Vienna,6731,6,7,5,12,26,41,-15,26
SC Rheindorf,6731,7,6,6,12,20,29,-9,24
FC Salzburg,6732,1,13,8,3,45,22,23,47
SK Sturm Gra,6732,2,12,3,9,33,35,-2,39
Rapid Vienna,6732,3,9,10,5,35,26,9,37
LASK Linz,6732,4,9,6,9,30,28,2,33
Mattersburg,6732,5,7,6,11,31,40,-9,27
Vienna,6732,6,7,5,12,29,41,-12,26
SC Rheindorf,6732,7,5,6,13,19,30,-11,21
FC Salzburg,6733,1,15,6,3,45,21,24,51
SK Sturm Gra,6733,2,12,4,8,31,30,1,40
LASK Linz,6733,3,9,6,9,29,29,0,33
Rapid Vienna,6733,4,7,10,7,32,31,1,31
SC Rheindorf,6733,5,7,5,12,24,27,-3,26
Vienna,6733,6,7,5,12,26,41,-15,26
Mattersburg,6733,7,6,6,12,33,41,-8,24
FC Salzburg,6734,1,13,7,4,45,22,23,46
SK Sturm Gra,6734,2,12,4,8,35,34,1,40
Rapid Vienna,6734,3,8,10,6,36,29,7,34
LASK Linz,6734,4,9,7,8,29,27,2,34
Vienna,6734,5,8,5,11,30,40,-10,29
Mattersburg,6734,6,6,6,12,31,44,-13,24
SC Rheindorf,6734,7,6,5,13,22,32,-10,23
FC Salzburg,6735,1,14,7,3,42,19,23,49
Rapid Vienna,6735,2,10,9,5,37,26,11,39
SK Sturm Gra,6735,3,11,5,8,29,29,0,38
LASK Linz,6735,4,8,8,8,26,25,1,32
SC Rheindorf,6735,5,6,6,12,22,30,-8,24
Mattersburg,6735,6,6,6,12,28,39,-11,24
Vienna,6735,7,6,5,13,24,40,-16,23
FC Salzburg,6736,1,15,7,2,48,17,31,52
SK Sturm Gra,6736,2,13,4,7,35,30,5,43
LASK Linz,6736,3,10,6,8,32,29,3,36
Rapid Vienna,6736,4,7,11,6,33,29,4,32
Vienna,6736,5,7,5,12,25,41,-16,26
SC Rheindorf,6736,6,5,6,13,21,31,-10,21
Mattersburg,6736,7,5,5,14,29,46,-17,20
FC Salzburg,6737,1,15,6,3,47,18,29,51
Rapid Vienna,6737,2,9,10,5,35,26,9,37
SK Sturm Gra,6737,3,11,4,9,28,31,-3,37
LASK Linz,6737,4,8,7,9,26,27,-1,31
Vienna,6737,5,7,5,12,27,40,-13,26
Mattersburg,6737,6,6,6,12,29,42,-13,24
SC Rheindorf,6737,7,5,8,11,18,26,-8,23
FC Salzburg,6738,1,13,7,4,46,19,27,46
SK Sturm Gra,6738,2,12,5,7,32,28,4,41
LASK Linz,6738,3,10,6,8,28,24,4,36
Rapid Vienna,6738,4,8,10,6,34,29,5,34
Mattersburg,6738,5,7,6,11,31,43,-12,27
Vienna,6738,6,6,6,12,24,40,-16,24
SC Rheindorf,6738,7,5,6,13,18,30,-12,21
FC Salzburg,6739,1,16,6,2,46,16,30,54
SK Sturm Gra,6739,2,11,6,7,29,26,3,39
Rapid Vienna,6739,3,7,11,6,35,29,6,32
LASK Linz,6739,4,7,7,10,28,32,-4,28
Vienna,6739,5,7,5,12,27,39,-12,26
SC Rheindorf,6739,6,6,7,11,19,26,-7,25
Mattersburg,6739,7,6,6,12,28,44,-16,24
FC Salzburg,6740,1,15,6,3,46,18,28,51
SK Sturm Gra,6740,2,12,3,9,31,31,0,39
LASK Linz,6740,3,9,6,9,27,28,-1,33
Rapid Vienna,6740,4,7,10,7,34,29,5,31
Mattersburg,6740,5,7,7,10,33,41,-8,28
SC Rheindorf,6740,6,6,6,12,22,29,-7,24
Vienna,6740,7,6,6,12,26,43,-17,24
FC Salzburg,6741,1,13,7,4,41,18,23,46
SK Sturm Gra,6741,2,13,4,7,38,32,6,43
Rapid Vienna,6741,3,8,9,7,36,30,6,33
LASK Linz,6741,4,9,6,9,32,30,2,33
SC Rheindorf,6741,5,7,5,12,22,30,-8,26
Vienna,6741,6,6,7,11,24,38,-14,25
Mattersburg,6741,7,6,6,12,30,45,-15,24
FC Salzburg,6742,1,15,6,3,45,19,26,51
SK Sturm Gra,6742,2,14,3,7,33,29,4,45
LASK Linz,6742,3,9,6,9,29,27,2,33
Rapid Vienna,6742,4,7,9,8,32,29,3,30
SC Rheindorf,6742,5,7,6,11,21,26,-5,27
Mattersburg,6742,6,6,5,13,34,46,-12,23
Vienna,6742,7,6,5,13,25,43,-18,23
FC Salzburg,6743,1,16,6,2,49,17,32,54
SK Sturm Gra,6743,2,13,3,8,33,32,1,42
Rapid Vienna,6743,3,9,9,6,37,29,8,36
LASK Linz,6743,4,7,5,12,26,31,-5,26
Vienna,6743,5,7,5,12,26,41,-15,26
SC Rheindorf,6743,6,6,6,12,22,31,-9,24
Mattersburg,6743,7,6,6,12,32,44,-12,24
FC Salzburg,6744,1,14,7,3,42,18,24,49
SK Sturm Gra,6744,2,12,4,8,30,28,2,40
Rapid Vienna,6744,3,10,9,5,36,26,10,39
Vienna,6744,4,8,5,11,32,39,-7,29
LASK Linz,6744,5,7,6,11,26,30,-4,27
Mattersburg,6744,6,7,6,11,31,44,-13,27
SC Rheindorf,6744,7,4,7,13,16,28,-12,19
FC Salzburg,6745,1,15,6,3,43,17,26,51
SK Sturm Gra,6745,2,12,5,7,32,29,3,41
Rapid Vienna,6745,3,9,10,5,34,24,10,37
LASK Linz,6745,4,8,7,9,28,29,-1,31
Mattersburg,6745,5,7,5,12,31,42,-11,26
Vienna,6745,6,7,5,12,27,39,-12,26
SC Rheindorf,6745,7,4,6,14,18,33,-15,18
FC Salzburg,6746,1,15,7,2,45,16,29,52
SK Sturm Gra,6746,2,12,5,7,33,29,4,41
LASK Linz,6746,3,10,6,8,28,25,3,36
Rapid Vienna,6746,4,8,10,6,33,28,5,34
Mattersburg,6746,5,6,6,12,31,43,-12,24
Vienna,6746,6,6,5,13,26,43,-17,23
SC Rheindorf,6746,7,4,7,13,18,30,-12,19
FC Salzburg,6747,1,15,7,2,48,21,27,52
SK Sturm Gra,6747,2,13,3,8,33,30,3,42
Rapid Vienna,6747,3,9,9,6,38,29,9,36
LASK Linz,6747,4,8,7,9,29,30,-1,31
Mattersburg,6747,5,6,7,11,33,42,-9,25
Vienna,6747,6,6,5,13,27,45,-18,23
SC Rheindorf,6747,7,5,6,13,19,30,-11,21
FC Salzburg,6748,1,14,7,3,47,18,29,49
SK Sturm Gra,6748,2,12,3,9,32,32,0,39
Rapid Vienna,6748,3,9,10,5,35,27,8,37
LASK Linz,6748,4,8,6,10,27,32,-5,30
Vienna,6748,5,7,6,11,25,38,-13,27
Mattersburg,6748,6,7,5,12,33,42,-9,26
SC Rheindorf,6748,7,6,5,13,18,28,-10,23
FC Salzburg,6749,1,14,7,3,43,19,24,49
SK Sturm Gra,6749,2,11,5,8,32,30,2,38
Rapid Vienna,6749,3,8,11,5,38,27,11,35
LASK Linz,6749,4,8,6,10,28,32,-4,30
SC Rheindorf,6749,5,8,5,11,21,27,-6,29
Vienna,6749,6,8,5,11,28,37,-9,29
Mattersburg,6749,7,5,5,14,28,46,-18,20
FC Salzburg,6750,1,15,6,3,49,20,29,51
SK Sturm Gra,6750,2,12,4,8,31,29,2,40
Rapid Vienna,6750,3,9,10,5,39,30,9,37
LASK Linz,6750,4,9,6,9,29,29,0,33
Mattersburg,6750,5,8,5,11,32,40,-8,29
Vienna,6750,6,6,5,13,24,42,-18,23
SC Rheindorf,6750,7,4,6,14,17,31,-14,18
FC Salzburg,6751,1,13,7,4,43,22,21,46
Rapid Vienna,6751,2,10,10,4,40,24,16,40
SK Sturm Gra,6751,3,12,4,8,32,28,4,40
LASK Linz,6751,4,8,5,11,26,32,-6,29
Mattersburg,6751,5,6,8,10,35,43,-8,26
SC Rheindorf,6751,6,6,6,12,21,32,-11,24
Vienna,6751,7,6,6,12,26,42,-16,24
FC Salzburg,6752,1,16,6,2,44,15,29,54
SK Sturm Gra,6752,2,12,5,7,35,29,6,41
Rapid Vienna,6752,3,8,11,5,36,27,9,35
LASK Linz,6752,4,8,7,9,29,29,0,31
Mattersburg,6752,5,6,6,12,31,43,-12,24
Vienna,6752,6,6,5,13,24,42,-18,23
SC Rheindorf,6752,7,5,6,13,18,32,-14,21
FC Salzburg,6753,1,13,8,3,44,20,24,47
SK Sturm Gra,6753,2,11,5,8,30,34,-4,38
Rapid Vienna,6753,3,8,11,5,37,30,7,35
LASK Linz,6753,4,9,6,9,29,27,2,33
Mattersburg,6753,5,7,6,11,33,42,-9,27
Vienna,6753,6,7,5,12,25,40,-15,26
SC Rheindorf,6753,7,5,7,12,23,28,-5,22
FC Salzburg,6754,1,16,6,2,50,17,33,54
SK Sturm Gra,6754,2,12,3,9,32,31,1,39
LASK Linz,6754,3,10,5,9,29,25,4,35
Rapid Vienna,6754,4,8,10,6,33,32,1,34
SC Rheindorf,6754,5,6,6,12,18,27,-9,24
Mattersburg,6754,6,6,5,13,28,39,-11,23
Vienna,6754,7,6,5,13,24,43,-19,23
FC Salzburg,6755,1,15,7,2,45,17,28,52
SK Sturm Gra,6755,2,12,3,9,30,31,-1,39
Rapid Vienna,6755,3,7,10,7,34,30,4,31
LASK Linz,6755,4,8,6,10,28,29,-1,30
Mattersburg,6755,5,7,7,10,33,40,-7,28
SC Rheindorf,6755,6,7,6,11,20,26,-6,27
Vienna,6755,7,6,5,13,23,40,-17,23
FC Salzburg,6756,1,15,6,3,48,18,30,51
SK Sturm Gra,6756,2,15,3,6,34,26,8,48
LASK Linz,6756,3,9,5,10,26,28,-2,32
Rapid Vienna,6756,4,7,9,8,32,28,4,30
Vienna,6756,5,7,5,12,28,39,-11,26
SC Rheindorf,6756,6,6,6,12,20,28,-8,24
Mattersburg,6756,7,5,6,13,28,49,-21,21
FC Salzburg,6757,1,15,6,3,49,21,28,51
Rapid Vienna,6757,2,10,9,5,37,26,11,39
SK Sturm Gra,6757,3,11,4,9,31,34,-3,37
LASK Linz,6757,4,9,6,9,31,30,1,33
SC Rheindorf,6757,5,7,5,12,24,30,-6,26
Vienna,6757,6,7,5,12,25,39,-14,26
Mattersburg,6757,7,5,5,14,31,48,-17,20
FC Salzburg,6758,1,15,6,3,45,20,25,51
SK Sturm Gra,6758,2,13,3,8,34,30,4,42
Rapid Vienna,6758,3,8,9,7,37,34,3,33
LASK Linz,6758,4,9,6,9,31,28,3,33
Vienna,6758,5,7,5,12,25,38,-13,26
Mattersburg,6758,6,6,6,12,31,42,-11,24
SC Rheindorf,6758,7,6,5,13,22,33,-11,23
FC Salzburg,6759,1,15,7,2,48,17,31,52
SK Sturm Gra,6759,2,11,4,9,30,30,0,37
Rapid Vienna,6759,3,8,11,5,35,29,6,35
LASK Linz,6759,4,10,5,9,31,27,4,35
Mattersburg,6759,5,8,5,11,37,43,-6,29
Vienna,6759,6,6,5,13,23,43,-20,23
SC Rheindorf,6759,7,5,5,14,20,35,-15,20
FC Salzburg,6760,1,16,6,2,51,16,35,54
SK Sturm Gra,6760,2,13,4,7,33,27,6,43
LASK Linz,6760,3,9,6,9,28,29,-1,33
Rapid Vienna,6760,4,7,10,7,33,31,2,31
Mattersburg,6760,5,7,5,12,33,45,-12,26
Vienna,6760,6,6,5,13,26,44,-18,23
SC Rheindorf,6760,7,4,8,12,17,29,-12,20
FC Salzburg,6761,1,14,8,2,43,17,26,50
SK Sturm Gra,6761,2,13,4,7,37,30,7,43
LASK Linz,6761,3,9,6,9,31,30,1,33
Rapid Vienna,6761,4,7,10,7,35,33,2,31
Vienna,6761,5,7,6,11,29,40,-11,27
SC Rheindorf,6761,6,6,7,11,26,32,-6,25
Mattersburg,6761,7,5,5,14,27,46,-19,20
FC Salzburg,6762,1,15,6,3,45,18,27,51
SK Sturm Gra,6762,2,14,3,7,33,26,7,45
Rapid Vienna,6762,3,10,9,5,39,26,13,39
LASK Linz,6762,4,9,5,10,28,32,-4,32
Vienna,6762,5,7,5,12,26,40,-14,26
SC Rheindorf,6762,6,5,5,14,21,34,-13,20
Mattersburg,6762,7,5,5,14,31,47,-16,20
FC Salzburg,6763,1,15,6,3,50,21,29,51
SK Sturm Gra,6763,2,13,3,8,36,28,8,42
Rapid Vienna,6763,3,8,10,6,38,33,5,34
LASK Linz,6763,4,9,7,8,31,29,2,34
Vienna,6763,5,7,5,12,24,40,-16,26
Mattersburg,6763,6,5,7,12,30,46,-16,22
SC Rheindorf,6763,7,5,6,13,20,32,-12,21
FC Salzburg,6764,1,15,7,2,47,19,28,52
SK Sturm Gra,6764,2,13,4,7,32,28,4,43
LASK Linz,6764,3,9,6,9,28,27,1,33
Rapid Vienna,6764,4,7,10,7,34,30,4,31
Mattersburg,6764,5,7,5,12,30,41,-11,26
Vienna,6764,6,6,6,12,26,41,-15,24
SC Rheindorf,6764,7,5,6,13,18,29,-11,21
FC Salzburg,6765,1,15,6,3,46,20,26,51
SK Sturm Gra,6765,2,11,6,7,30,27,3,39
Rapid Vienna,6765,3,9,11,4,37,27,10,38
LASK Linz,6765,4,9,7,8,30,28,2,34
Vienna,6765,5,6,6,12,24,39,-15,24
SC Rheindorf,6765,6,5,6,13,18,30,-12,21
Mattersburg,6765,7,5,6,13,29,43,-14,21
FC Salzburg,6766,1,14,8,2,48,17,31,50
SK Sturm Gra,6766,2,13,3,8,34,31,3,42
Rapid Vienna,6766,3,8,11,5,39,32,7,35
SC Rheindorf,6766,4,7,6,11,23,27,-4,27
Vienna,6766,5,7,6,11,27,38,-11,27
LASK Linz,6766,6,7,5,12,24,34,-10,26
Mattersburg,6766,7,6,5,13,29,45,-16,23
FC Salzburg,6767,1,15,6,3,47,19,28,51
SK Sturm Gra,6767,2,12,4,8,32,30,2,40
Rapid Vienna,6767,3,9,9,6,35,29,6,36
LASK Linz,6767,4,9,6,9,29,28,1,33
Vienna,6767,5,8,5,11,29,40,-11,29
SC Rheindorf,6767,6,5,6,13,19,31,-12,21
Mattersburg,6767,7,5,6,13,31,45,-14,21
FC Salzburg,6768,1,16,6,2,50,18,32,54
SK Sturm Gra,6768,2,14,3,7,40,31,9,45
Rapid Vienna,6768,3,8,9,7,38,31,7,33
LASK Linz,6768,4,9,5,10,32,31,1,32
Mattersburg,6768,5,7,5,12,30,43,-13,26
Vienna,6768,6,6,5,13,24,43,-19,23
SC Rheindorf,6768,7,5,5,14,17,34,-17,20
FC Salzburg,6769,1,14,6,4,40,18,22,48
SK Sturm Gra,6769,2,12,4,8,33,29,4,40
Rapid Vienna,6769,3,7,11,6,33,28,5,32
LASK Linz,6769,4,7,9,8,29,30,-1,30
Mattersburg,6769,5,7,6,11,32,41,-9,27
Vienna,6769,6,7,5,12,25,39,-14,26
SC Rheindorf,6769,7,6,7,11,24,31,-7,25
FC Salzburg,6770,1,14,7,3,42,18,24,49
SK Sturm Gra,6770,2,12,3,9,30,28,2,39
Rapid Vienna,6770,3,9,11,4,35,25,10,38
LASK Linz,6770,4,8,5,11,26,29,-3,29
Vienna,6770,5,7,6,11,26,39,-13,27
SC Rheindorf,6770,6,6,6,12,20,29,-9,24
Mattersburg,6770,7,6,6,12,31,42,-11,24
FC Salzburg,6771,1,14,6,4,46,18,28,48
Rapid Vienna,6771,2,10,10,4,36,25,11,40
SK Sturm Gra,6771,3,11,4,9,32,34,-2,37
LASK Linz,6771,4,8,7,9,28,29,-1,31
Vienna,6771,5,7,6,11,28,41,-13,27
Mattersburg,6771,6,6,7,11,32,45,-13,25
SC Rheindorf,6771,7,5,6,13,19,29,-10,21
FC Salzburg,6772,1,15,7,2,48,19,29,52
SK Sturm Gra,6772,2,12,4,8,37,34,3,40
Rapid Vienna,6772,3,7,12,5,34,29,5,33
LASK Linz,6772,4,8,7,9,27,28,-1,31
Mattersburg,6772,5,6,7,11,31,41,-10,25
Vienna,6772,6,6,6,12,24,40,-16,24
SC Rheindorf,6772,7,5,7,12,19,29,-10,22
FC Salzburg,6773,1,14,6,4,47,23,24,48
SK Sturm Gra,6773,2,12,4,8,33,32,1,40
Rapid Vienna,6773,3,9,10,5,40,30,10,37
LASK Linz,6773,4,9,5,10,29,28,1,32
Mattersburg,6773,5,7,5,12,33,42,-9,26
Vienna,6773,6,7,5,12,25,41,-16,26
SC Rheindorf,6773,7,6,5,13,20,31,-11,23
FC Salzburg,6774,1,15,6,3,48,19,29,51
SK Sturm Gra,6774,2,13,3,8,35,31,4,42
Rapid Vienna,6774,3,9,11,4,39,29,10,38
LASK Linz,6774,4,7,7,10,27,31,-4,28
SC Rheindorf,6774,5,6,6,12,22,31,-9,24
Mattersburg,6774,6,6,6,12,30,42,-12,24
Vienna,6774,7,6,5,13,24,42,-18,23
FC Salzburg,6775,1,15,6,3,47,19,28,51
SK Sturm Gra,6775,2,13,4,7,34,30,4,43
Rapid Vienna,6775,3,9,9,6,39,27,12,36
LASK Linz,6775,4,8,8,8,28,28,0,32
Mattersburg,6775,5,7,6,11,32,40,-8,27
Vienna,6775,6,6,5,13,23,41,-18,23
SC Rheindorf,6775,7,4,6,14,17,35,-18,18
FC Salzburg,6776,1,14,7,3,44,17,27,49
SK Sturm Gra,6776,2,13,5,6,33,25,8,44
Rapid Vienna,6776,3,10,9,5,38,26,12,39
LASK Linz,6776,4,8,5,11,26,32,-6,29
Vienna,6776,5,7,5,12,26,42,-16,26
SC Rheindorf,6776,6,6,6,12,19,28,-9,24
Mattersburg,6776,7,5,5,14,29,45,-16,20
FC Salzburg,6777,1,15,7,2,43,15,28,52
SK Sturm Gra,6777,2,13,4,7,34,27,7,43
Rapid Vienna,6777,3,7,10,7,32,28,4,31
LASK Linz,6777,4,8,7,9,26,28,-2,31
Mattersburg,6777,5,6,8,10,32,38,-6,26
Vienna,6777,6,6,6,12,24,41,-17,24
SC Rheindorf,6777,7,4,8,12,16,30,-14,20
FC Salzburg,6778,1,14,7,3,41,17,24,49
Rapid Vienna,6778,2,11,9,4,38,25,13,42
SK Sturm Gra,6778,3,11,6,7,30,27,3,39
LASK Linz,6778,4,8,6,10,27,28,-1,30
Mattersburg,6778,5,7,5,12,29,40,-11,26
Vienna,6778,6,7,5,12,26,40,-14,26
SC Rheindorf,6778,7,4,6,14,15,29,-14,18
FC Salzburg,6779,1,14,8,2,44,18,26,50
SK Sturm Gra,6779,2,13,4,7,37,30,7,43
Rapid Vienna,6779,3,7,11,6,35,31,4,32
LASK Linz,6779,4,8,8,8,28,28,0,32
Vienna,6779,5,7,5,12,27,41,-14,26
SC Rheindorf,6779,6,5,7,12,20,30,-10,22
Mattersburg,6779,7,5,7,12,32,45,-13,22
FC Salzburg,6780,1,15,6,3,47,19,28,51
SK Sturm Gra,6780,2,11,3,10,30,33,-3,36
LASK Linz,6780,3,10,5,9,31,29,2,35
Rapid Vienna,6780,4,8,10,6,35,29,6,34
Vienna,6780,5,8,5,11,30,41,-11,29
Mattersburg,6780,6,6,6,12,33,45,-12,24
SC Rheindorf,6780,7,5,7,12,20,30,-10,22
FC Salzburg,6781,1,15,6,3,50,18,32,51
Rapid Vienna,6781,2,9,10,5,35,29,6,37
SK Sturm Gra,6781,3,11,3,10,32,35,-3,36
LASK Linz,6781,4,8,6,10,28,31,-3,30
Mattersburg,6781,5,7,6,11,31,40,-9,27
Vienna,6781,6,7,6,11,26,39,-13,27
SC Rheindorf,6781,7,6,5,13,22,32,-10,23
FC Salzburg,6782,1,15,6,3,46,19,27,51
SK Sturm Gra,6782,2,12,3,9,31,32,-1,39
Rapid Vienna,6782,3,8,10,6,33,26,7,34
LASK Linz,6782,4,8,7,9,28,28,0,31
Mattersburg,6782,5,7,6,11,30,39,-9,27
Vienna,6782,6,7,5,12,25,40,-15,26
SC Rheindorf,6782,7,5,7,12,18,27,-9,22
FC Salzburg,6783,1,13,8,3,44,21,23,47
SK Sturm Gra,6783,2,14,3,7,37,28,9,45
Rapid Vienna,6783,3,8,11,5,40,31,9,35
LASK Linz,6783,4,7,7,10,25,30,-5,28
Mattersburg,6783,5,7,5,12,33,40,-7,26
SC Rheindorf,6783,6,6,6,12,24,35,-11,24
Vienna,6783,7,6,6,12,24,42,-18,24
FC Salzburg,6784,1,15,6,3,46,17,29,51
SK Sturm Gra,6784,2,15,3,6,35,27,8,48
Rapid Vienna,6784,3,8,9,7,38,33,5,33
LASK Linz,6784,4,9,6,9,27,26,1,33
Mattersburg,6784,5,6,5,13,29,41,-12,23
Vienna,6784,6,6,5,13,24,45,-21,23
SC Rheindorf,6784,7,5,6,13,20,30,-10,21
FC Salzburg,6785,1,14,8,2,50,24,26,50
SK Sturm Gra,6785,2,11,4,9,33,36,-3,37
Rapid Vienna,6785,3,8,11,5,37,28,9,35
LASK Linz,6785,4,8,7,9,25,27,-2,31
Vienna,6785,5,7,6,11,27,38,-11,27
SC Rheindorf,6785,6,6,6,12,22,29,-7,24
Mattersburg,6785,7,6,6,12,32,44,-12,24
FC Salzburg,6786,1,15,7,2,47,17,30,52
SK Sturm Gra,6786,2,11,5,8,31,29,2,38
Rapid Vienna,6786,3,8,11,5,33,25,8,35
LASK Linz,6786,4,9,5,10,28,28,0,32
Mattersburg,6786,5,7,5,12,33,43,-10,26
SC Rheindorf,6786,6,6,6,12,19,31,-12,24
Vienna,6786,7,6,5,13,23,41,-18,23
FC Salzburg,6787,1,15,6,3,46,19,27,51
SK Sturm Gra,6787,2,13,3,8,33,28,5,42
Rapid Vienna,6787,3,9,10,5,36,27,9,37
LASK Linz,6787,4,7,7,10,26,30,-4,28
Mattersburg,6787,5,6,7,11,31,42,-11,25
Vienna,6787,6,6,6,12,25,40,-15,24
SC Rheindorf,6787,7,5,7,12,18,29,-11,22
FC Salzburg,6788,1,13,8,3,45,21,24,47
SK Sturm Gra,6788,2,14,4,6,34,26,8,46
Rapid Vienna,6788,3,9,10,5,39,30,9,37
LASK Linz,6788,4,9,5,10,27,28,-1,32
Vienna,6788,5,7,6,11,26,39,-13,27
SC Rheindorf,6788,6,5,6,13,19,30,-11,21
Mattersburg,6788,7,5,5,14,28,44,-16,20
FC Salzburg,6789,1,15,6,3,47,25,22,51
Rapid Vienna,6789,2,10,9,5,42,26,16,39
SK Sturm Gra,6789,3,11,5,8,34,36,-2,38
LASK Linz,6789,4,8,6,10,26,27,-1,30
Vienna,6789,5,7,5,12,30,41,-11,26
SC Rheindorf,6789,6,6,6,12,25,33,-8,24
Mattersburg,6789,7,6,5,13,31,47,-16,23
FC Salzburg,6790,1,13,8,3,41,17,24,47
SK Sturm Gra,6790,2,13,5,6,34,27,7,44
Rapid Vienna,6790,3,7,11,6,37,32,5,32
LASK Linz,6790,4,8,6,10,29,33,-4,30
Vienna,6790,5,7,5,12,24,39,-15,26
SC Rheindorf,6790,6,6,7,11,20,28,-8,25
Mattersburg,6790,7,6,6,12,31,40,-9,24
FC Salzburg,6791,1,13,9,2,43,19,24,48
SK Sturm Gra,6791,2,14,4,6,34,26,8,46
Rapid Vienna,6791,3,7,12,5,35,29,6,33
LASK Linz,6791,4,7,7,10,26,29,-3,28
Vienna,6791,5,7,6,11,25,38,-13,27
SC Rheindorf,6791,6,6,6,12,20,29,-9,24
Mattersburg,6791,7,5,6,13,29,42,-13,21
FC Salzburg,6792,1,15,7,2,46,19,27,52
SK Sturm Gra,6792,2,12,3,9,35,30,5,39
LASK Linz,6792,3,10,6,8,30,27,3,36
Rapid Vienna,6792,4,7,10,7,32,32,0,31
Mattersburg,6792,5,6,7,11,31,41,-10,25
SC Rheindorf,6792,6,5,8,11,18,26,-8,23
Vienna,6792,7,6,5,13,24,41,-17,23
FC Salzburg,6793,1,14,7,3,42,18,24,49
SK Sturm Gra,6793,2,13,4,7,35,28,7,43
Rapid Vienna,6793,3,9,11,4,37,27,10,38
LASK Linz,6793,4,7,6,11,24,30,-6,27
Vienna,6793,5,7,6,11,25,38,-13,27
Mattersburg,6793,6,7,5,12,31,39,-8,26
SC Rheindorf,6793,7,5,5,14,21,35,-14,20
FC Salzburg,6794,1,14,7,3,45,18,27,49
SK Sturm Gra,6794,2,12,5,7,31,28,3,41
Rapid Vienna,6794,3,9,9,6,35,29,6,36
LASK Linz,6794,4,9,6,9,29,26,3,33
Mattersburg,6794,5,6,6,12,29,42,-13,24
Vienna,6794,6,6,6,12,26,41,-15,24
SC Rheindorf,6794,7,5,7,12,18,29,-11,22
FC Salzburg,6795,1,15,6,3,44,19,25,51
SK Sturm Gra,6795,2,13,5,6,31,24,7,44
Rapid Vienna,6795,3,9,9,6,36,28,8,36
LASK Linz,6795,4,9,6,9,28,28,0,33
Vienna,6795,5,7,5,12,27,40,-13,26
Mattersburg,6795,6,6,5,13,29,43,-14,23
SC Rheindorf,6795,7,4,6,14,17,30,-13,18
FC Salzburg,6796,1,13,7,4,43,21,22,46
SK Sturm Gra,6796,2,14,3,7,34,28,6,45
Rapid Vienna,6796,3,7,12,5,33,26,7,33
Vienna,6796,4,8,5,11,28,38,-10,29
LASK Linz,6796,5,7,6,11,24,29,-5,27
SC Rheindorf,6796,6,7,6,11,19,25,-6,27
Mattersburg,6796,7,6,5,13,28,42,-14,23
FC Salzburg,6797,1,15,7,2,48,20,28,52
SK Sturm Gra,6797,2,12,4,8,31,29,2,40
Rapid Vienna,6797,3,8,10,6,37,30,7,34
LASK Linz,6797,4,8,6,10,27,30,-3,30
Mattersburg,6797,5,8,5,11,32,39,-7,29
SC Rheindorf,6797,6,6,5,13,20,30,-10,23
Vienna,6797,7,6,5,13,25,42,-17,23
FC Salzburg,6798,1,14,7,3,45,20,25,49
SK Sturm Gra,6798,2,12,5,7,32,26,6,41
LASK Linz,6798,3,9,7,8,30,28,2,34
Rapid Vienna,6798,4,8,9,7,36,33,3,33
Mattersburg,6798,5,7,5,12,30,41,-11,26
Vienna,6798,6,6,6,12,23,38,-15,24
SC Rheindorf,6798,7,5,7,12,19,29,-10,22
FC Salzburg,6799,1,16,6,2,52,17,35,54
Rapid Vienna,6799,2,9,10,5,37,29,8,37
SK Sturm Gra,6799,3,11,3,10,29,33,-4,36
LASK Linz,6799,4,9,5,10,27,29,-2,32
SC Rheindorf,6799,5,6,6,12,22,28,-6,24
Vienna,6799,6,6,6,12,27,42,-15,24
Mattersburg,6799,7,6,6,12,32,48,-16,24
FC Salzburg,6800,1,14,7,3,44,18,26,49
SK Sturm Gra,6800,2,14,3,7,33,29,4,45
Rapid Vienna,6800,3,8,10,6,35,28,7,34
LASK Linz,6800,4,8,6,10,26,28,-2,30
Vienna,6800,5,8,5,11,29,39,-10,29
Mattersburg,6800,6,7,5,12,34,45,-11,26
SC Rheindorf,6800,7,4,6,14,19,33,-14,18
FC Salzburg,6801,1,15,6,3,47,21,26,51
SK Sturm Gra,6801,2,13,5,6,35,28,7,44
Rapid Vienna,6801,3,8,10,6,36,30,6,34
LASK Linz,6801,4,8,7,9,27,28,-1,31
Vienna,6801,5,7,5,12,25,40,-15,26
SC Rheindorf,6801,6,5,7,12,19,28,-9,22
Mattersburg,6801,7,5,6,13,28,42,-14,21
FC Salzburg,6802,1,14,6,4,50,23,27,48
SK Sturm Gra,6802,2,13,4,7,35,28,7,43
Rapid Vienna,6802,3,8,10,6,34,31,3,34
LASK Linz,6802,4,7,7,10,28,31,-3,28
SC Rheindorf,6802,5,7,5,12,19,27,-8,26
Mattersburg,6802,6,7,5,12,35,45,-10,26
Vienna,6802,7,7,5,12,27,43,-16,26
FC Salzburg,6803,1,16,6,2,47,20,27,54
SK Sturm Gra,6803,2,13,4,7,35,27,8,43
Rapid Vienna,6803,3,7,11,6,35,29,6,32
LASK Linz,6803,4,8,8,8,26,26,0,32
Mattersburg,6803,5,6,6,12,31,42,-11,24
Vienna,6803,6,6,6,12,27,42,-15,24
SC Rheindorf,6803,7,4,7,13,18,33,-15,19
FC Salzburg,6804,1,14,6,4,46,23,23,48
Rapid Vienna,6804,2,9,11,4,37,27,10,38
SK Sturm Gra,6804,3,11,4,9,31,31,0,37
LASK Linz,6804,4,8,6,10,25,27,-2,30
Vienna,6804,5,8,5,11,28,38,-10,29
SC Rheindorf,6804,6,7,6,11,21,28,-7,27
Mattersburg,6804,7,5,6,13,28,42,-14,21
FC Salzburg,6805,1,14,6,4,47,20,27,48
SK Sturm Gra,6805,2,13,3,8,33,27,6,42
Rapid Vienna,6805,3,9,10,5,35,26,9,37
LASK Linz,6805,4,8,6,10,24,27,-3,30
Mattersburg,6805,5,8,6,10,33,40,-7,30
Vienna,6805,6,6,5,13,24,43,-19,23
SC Rheindorf,6805,7,4,8,12,17,30,-13,20
FC Salzburg,6806,1,13,7,4,42,19,23,46
SK Sturm Gra,6806,2,13,4,7,31,26,5,43
LASK Linz,6806,3,9,7,8,29,25,4,34
Rapid Vienna,6806,4,7,12,5,31,24,7,33
Vienna,6806,5,7,6,11,24,37,-13,27
Mattersburg,6806,6,6,6,12,29,43,-14,24
SC Rheindorf,6806,7,5,6,13,18,30,-12,21
FC Salzburg,6807,1,14,8,2,46,19,27,50
SK Sturm Gra,6807,2,12,4,8,33,35,-2,40
Rapid Vienna,6807,3,8,11,5,33,25,8,35
Mattersburg,6807,4,7,7,10,35,39,-4,28
LASK Linz,6807,5,7,7,10,24,30,-6,28
Vienna,6807,6,6,6,12,25,40,-15,24
SC Rheindorf,6807,7,6,5,13,25,33,-8,23
FC Salzburg,6808,1,15,6,3,43,17,26,51
SK Sturm Gra,6808,2,13,3,8,34,28,6,42
Rapid Vienna,6808,3,8,9,7,34,31,3,33
LASK Linz,6808,4,8,7,9,28,29,-1,31
Mattersburg,6808,5,6,7,11,29,39,-10,25
SC Rheindorf,6808,6,6,6,12,20,29,-9,24
Vienna,6808,7,6,6,12,24,39,-15,24
FC Salzburg,6809,1,13,6,5,42,20,22,45
SK Sturm Gra,6809,2,12,5,7,32,28,4,41
Rapid Vienna,6809,3,8,12,4,37,28,9,36
LASK Linz,6809,4,8,6,10,25,29,-4,30
Vienna,6809,5,8,5,11,27,39,-12,29
SC Rheindorf,6809,6,6,7,11,21,28,-7,25
Mattersburg,6809,7,6,5,13,33,45,-12,23
FC Salzburg,6810,1,13,6,5,43,23,20,45
SK Sturm Gra,6810,2,14,3,7,32,26,6,45
LASK Linz,6810,3,11,5,8,30,24,6,38
Rapid Vienna,6810,4,7,9,8,36,34,2,30
Vienna,6810,5,7,6,11,26,38,-12,27
Mattersburg,6810,6,6,7,11,31,41,-10,25
SC Rheindorf,6810,7,5,6,13,19,31,-12,21
FC Salzburg,6811,1,15,6,3,47,17,30,51
SK Sturm Gra,6811,2,12,5,7,34,29,5,41
Rapid Vienna,6811,3,8,11,5,36,29,7,35
LASK Linz,6811,4,8,6,10,26,29,-3,30
Mattersburg,6811,5,7,5,12,31,43,-12,26
Vienna,6811,6,7,5,12,25,41,-16,26
SC Rheindorf,6811,7,4,8,12,20,31,-11,20
FC Salzburg,6812,1,15,6,3,44,18,26,51
SK Sturm Gra,6812,2,13,4,7,35,32,3,43
Rapid Vienna,6812,3,8,9,7,34,29,5,33
LASK Linz,6812,4,9,5,10,35,33,2,32
Vienna,6812,5,7,5,12,25,39,-14,26
SC Rheindorf,6812,6,6,6,12,20,29,-9,24
Mattersburg,6812,7,6,5,13,30,43,-13,23
FC Salzburg,6813,1,15,6,3,45,22,23,51
SK Sturm Gra,6813,2,12,3,9,32,28,4,39
Rapid Vienna,6813,3,9,9,6,41,31,10,36
LASK Linz,6813,4,9,5,10,29,32,-3,32
SC Rheindorf,6813,5,7,5,12,23,29,-6,26
Mattersburg,6813,6,7,5,12,35,45,-10,26
Vienna,6813,7,6,5,13,28,46,-18,23
FC Salzburg,6814,1,14,7,3,44,18,26,49
SK Sturm Gra,6814,2,12,5,7,35,29,6,41
Rapid Vienna,6814,3,8,10,6,38,31,7,34
LASK Linz,6814,4,8,6,10,25,31,-6,30
Mattersburg,6814,5,7,5,12,31,39,-8,26
Vienna,6814,6,7,5,12,26,40,-14,26
SC Rheindorf,6814,7,6,6,12,18,29,-11,24
FC Salzburg,6815,1,14,8,2,45,18,27,50
SK Sturm Gra,6815,2,12,3,9,32,31,1,39
LASK Linz,6815,3,9,7,8,30,29,1,34
Rapid Vienna,6815,4,7,11,6,33,28,5,32
SC Rheindorf,6815,5,7,6,11,21,28,-7,27
Vienna,6815,6,6,7,11,24,38,-14,25
Mattersburg,6815,7,5,6,13,28,41,-13,21
FC Salzburg,6816,1,15,6,3,44,17,27,51
SK Sturm Gra,6816,2,12,5,7,32,30,2,41
Rapid Vienna,6816,3,9,10,5,37,28,9,37
LASK Linz,6816,4,7,8,9,27,29,-2,29
Vienna,6816,5,7,5,12,27,40,-13,26
Mattersburg,6816,6,6,6,12,32,44,-12,24
SC Rheindorf,6816,7,5,6,13,19,30,-11,21
FC Salzburg,6817,1,13,8,3,45,17,28,47
SK Sturm Gra,6817,2,12,5,7,31,27,4,41
Rapid Vienna,6817,3,9,10,5,34,24,10,37
LASK Linz,6817,4,8,7,9,25,27,-2,31
Mattersburg,6817,5,7,6,11,31,44,-13,27
Vienna,6817,6,7,5,12,25,40,-15,26
SC Rheindorf,6817,7,5,5,14,18,30,-12,20
FC Salzburg,6818,1,15,6,3,42,16,26,51
SK Sturm Gra,6818,2,14,3,7,31,25,6,45
LASK Linz,6818,3,10,5,9,27,28,-1,35
Rapid Vienna,6818,4,8,9,7,34,27,7,33
Vienna,6818,5,7,5,12,25,40,-15,26
Mattersburg,6818,6,6,6,12,31,40,-9,24
SC Rheindorf,6818,7,4,6,14,16,30,-14,18
FC Salzburg,6819,1,15,6,3,48,18,30,51
SK Sturm Gra,6819,2,12,3,9,31,30,1,39
Rapid Vienna,6819,3,8,11,5,33,26,7,35
LASK Linz,6819,4,9,6,9,28,27,1,33
Mattersburg,6819,5,7,6,11,33,42,-9,27
Vienna,6819,6,6,6,12,27,43,-16,24
SC Rheindorf,6819,7,5,6,13,17,31,-14,21
FC Salzburg,6820,1,12,10,2,41,18,23,46
SK Sturm Gra,6820,2,12,4,8,33,28,5,40
Rapid Vienna,6820,3,8,10,6,35,31,4,34
LASK Linz,6820,4,9,6,9,28,28,0,33
SC Rheindorf,6820,5,7,5,12,22,28,-6,26
Vienna,6820,6,6,7,11,24,38,-14,25
Mattersburg,6820,7,5,8,11,30,42,-12,23
FC Salzburg,6821,1,15,7,2,46,20,26,52
SK Sturm Gra,6821,2,12,5,7,30,28,2,41
Rapid Vienna,6821,3,8,9,7,36,31,5,33
LASK Linz,6821,4,9,5,10,27,29,-2,32
Vienna,6821,5,7,5,12,25,39,-14,26
SC Rheindorf,6821,6,6,6,12,23,28,-5,24
Mattersburg,6821,7,6,5,13,30,42,-12,23
FC Salzburg,6822,1,15,7,2,45,18,27,52
SK Sturm Gra,6822,2,13,5,6,35,28,7,44
Rapid Vienna,6822,3,7,11,6,34,28,6,32
LASK Linz,6822,4,7,7,10,29,36,-7,28
Mattersburg,6822,5,6,7,11,37,44,-7,25
Vienna,6822,6,6,6,12,24,39,-15,24
SC Rheindorf,6822,7,5,7,12,22,33,-11,22
FC Salzburg,6823,1,15,7,2,44,18,26,52
SK Sturm Gra,6823,2,12,3,9,33,32,1,39
LASK Linz,6823,3,11,5,8,33,26,7,38
Rapid Vienna,6823,4,8,9,7,35,32,3,33
Vienna,6823,5,7,5,12,26,40,-14,26
Mattersburg,6823,6,5,7,12,30,43,-13,22
SC Rheindorf,6823,7,5,6,13,20,30,-10,21
FC Salzburg,6824,1,13,7,4,44,19,25,46
SK Sturm Gra,6824,2,12,5,7,33,28,5,41
Rapid Vienna,6824,3,10,9,5,40,27,13,39
Mattersburg,6824,4,9,5,10,36,39,-3,32
LASK Linz,6824,5,8,6,10,28,31,-3,30
Vienna,6824,6,6,5,13,24,45,-21,23
SC Rheindorf,6824,7,5,5,14,19,35,-16,20
FC Salzburg,6825,1,15,6,3,46,19,27,51
SK Sturm Gra,6825,2,13,3,8,33,32,1,42
Rapid Vienna,6825,3,8,11,5,35,26,9,35
LASK Linz,6825,4,8,7,9,27,27,0,31
Mattersburg,6825,5,7,5,12,32,41,-9,26
Vienna,6825,6,6,5,13,24,43,-19,23
SC Rheindorf,6825,7,5,7,12,19,28,-9,22
FC Salzburg,6826,1,15,7,2,47,17,30,52
SK Sturm Gra,6826,2,12,3,9,31,29,2,39
LASK Linz,6826,3,11,5,8,31,26,5,38
Rapid Vienna,6826,4,8,10,6,35,29,6,34
Vienna,6826,5,7,5,12,26,40,-14,26
SC Rheindorf,6826,6,6,5,13,18,29,-11,23
Mattersburg,6826,7,5,5,14,27,45,-18,20
FC Salzburg,6827,1,15,6,3,46,21,25,51
SK Sturm Gra,6827,2,12,5,7,31,28,3,41
Rapid Vienna,6827,3,8,12,4,34,24,10,36
LASK Linz,6827,4,8,7,9,29,29,0,31
Mattersburg,6827,5,6,6,12,29,41,-12,24
Vienna,6827,6,6,6,12,25,40,-15,24
SC Rheindorf,6827,7,4,8,12,20,31,-11,20
SK Sturm Gra,6828,1,13,4,7,32,27,5,43
FC Salzburg,6828,2,12,6,6,39,22,17,42
Rapid Vienna,6828,3,9,10,5,36,25,11,37
Mattersburg,6828,4,8,6,10,34,41,-7,30
LASK Linz,6828,5,7,6,11,26,30,-4,27
SC Rheindorf,6828,6,7,5,12,22,30,-8,26
Vienna,6828,7,7,5,12,26,40,-14,26
FC Salzburg,6829,1,13,8,3,42,17,25,47
SK Sturm Gra,6829,2,13,4,7,34,26,8,43
Rapid Vienna,6829,3,9,11,4,36,26,10,38
LASK Linz,6829,4,7,8,9,27,30,-3,29
Vienna,6829,5,7,6,11,27,38,-11,27
SC Rheindorf,6829,6,6,5,13,20,32,-12,23
Mattersburg,6829,7,5,6,13,28,45,-17,21
FC Salzburg,6830,1,14,7,3,45,20,25,49
SK Sturm Gra,6830,2,14,3,7,36,29,7,45
Rapid Vienna,6830,3,9,10,5,35,26,9,37
LASK Linz,6830,4,8,6,10,26,30,-4,30
Vienna,6830,5,7,5,12,24,38,-14,26
Mattersburg,6830,6,6,6,12,31,41,-10,24
SC Rheindorf,6830,7,5,5,14,19,32,-13,20
FC Salzburg,6831,1,16,6,2,46,17,29,54
SK Sturm Gra,6831,2,11,4,9,32,35,-3,37
Rapid Vienna,6831,3,8,11,5,35,25,10,35
LASK Linz,6831,4,9,7,8,33,30,3,34
Vienna,6831,5,7,5,12,24,38,-14,26
Mattersburg,6831,6,6,6,12,33,42,-9,24
SC Rheindorf,6831,7,5,5,14,22,38,-16,20
FC Salzburg,6832,1,15,7,2,47,19,28,52
SK Sturm Gra,6832,2,13,4,7,36,31,5,43
LASK Linz,6832,3,9,7,8,27,26,1,34
Rapid Vienna,6832,4,7,10,7,36,32,4,31
Vienna,6832,5,7,5,12,27,42,-15,26
Mattersburg,6832,6,6,6,12,31,42,-11,24
SC Rheindorf,6832,7,5,5,14,19,31,-12,20
FC Salzburg,6833,1,14,7,3,44,18,26,49
Rapid Vienna,6833,2,11,9,4,36,23,13,42
SK Sturm Gra,6833,3,12,3,9,31,29,2,39
LASK Linz,6833,4,10,5,9,28,27,1,35
Vienna,6833,5,6,6,12,24,41,-17,24
Mattersburg,6833,6,6,5,13,30,43,-13,23
SC Rheindorf,6833,7,5,5,14,19,31,-12,20
FC Salzburg,6834,1,15,7,2,46,17,29,52
SK Sturm Gra,6834,2,12,5,7,31,27,4,41
LASK Linz,6834,3,9,6,9,26,27,-1,33
Rapid Vienna,6834,4,7,11,6,32,27,5,32
Mattersburg,6834,5,7,5,12,31,41,-10,26
Vienna,6834,6,6,5,13,25,43,-18,23
SC Rheindorf,6834,7,5,7,12,19,28,-9,22
FC Salzburg,6835,1,14,8,2,43,18,25,50
SK Sturm Gra,6835,2,12,5,7,31,27,4,41
Rapid Vienna,6835,3,9,10,5,35,26,9,37
Mattersburg,6835,4,7,7,10,33,38,-5,28
LASK Linz,6835,5,7,6,11,25,31,-6,27
Vienna,6835,6,6,6,12,24,40,-16,24
SC Rheindorf,6835,7,5,6,13,20,31,-11,21
FC Salzburg,6836,1,14,8,2,43,18,25,50
SK Sturm Gra,6836,2,13,3,8,31,28,3,42
Rapid Vienna,6836,3,8,9,7,37,31,6,33
LASK Linz,6836,4,8,5,11,27,31,-4,29
Mattersburg,6836,5,7,6,11,32,41,-9,27
Vienna,6836,6,7,6,11,26,38,-12,27
SC Rheindorf,6836,7,6,5,13,20,29,-9,23
FC Salzburg,6837,1,15,7,2,43,16,27,52
SK Sturm Gra,6837,2,12,4,8,33,30,3,40
LASK Linz,6837,3,11,5,8,33,27,6,38
Rapid Vienna,6837,4,7,11,6,33,27,6,32
Vienna,6837,5,7,5,12,26,39,-13,26
Mattersburg,6837,6,6,5,13,29,45,-16,23
SC Rheindorf,6837,7,4,7,13,17,30,-13,19
FC Salzburg,6838,1,15,7,2,47,18,29,52
SK Sturm Gra,6838,2,11,5,8,31,30,1,38
LASK Linz,6838,3,10,5,9,27,26,1,35
Rapid Vienna,6838,4,8,9,7,34,27,7,33
Vienna,6838,5,7,5,12,25,40,-15,26
SC Rheindorf,6838,6,6,6,12,19,27,-8,24
Mattersburg,6838,7,6,5,13,30,45,-15,23
FC Salzburg,6839,1,15,6,3,51,21,30,51
SK Sturm Gra,6839,2,14,3,7,36,33,3,45
Rapid Vienna,6839,3,10,9,5,41,30,11,39
LASK Linz,6839,4,7,5,12,23,30,-7,26
Mattersburg,6839,5,7,5,12,29,39,-10,26
Vienna,6839,6,7,5,12,25,38,-13,26
SC Rheindorf,6839,7,5,5,14,17,31,-14,20
FC Salzburg,6840,1,15,6,3,43,18,25,51
Rapid Vienna,6840,2,10,10,4,38,25,13,40
SK Sturm Gra,6840,3,11,4,9,30,30,0,37
LASK Linz,6840,4,7,7,10,29,33,-4,28
Vienna,6840,5,7,5,12,28,39,-11,26
SC Rheindorf,6840,6,6,7,11,21,28,-7,25
Mattersburg,6840,7,5,7,12,29,45,-16,22
FC Salzburg,6841,1,15,7,2,45,17,28,52
SK Sturm Gra,6841,2,11,6,7,30,28,2,39
Rapid Vienna,6841,3,9,10,5,36,26,10,37
LASK Linz,6841,4,7,6,11,24,30,-6,27
Vienna,6841,5,7,5,12,28,40,-12,26
SC Rheindorf,6841,6,6,6,12,21,30,-9,24
Mattersburg,6841,7,6,6,12,32,45,-13,24
FC Salzburg,6842,1,14,8,2,44,17,27,50
SK Sturm Gra,6842,2,11,7,6,32,28,4,40
Rapid Vienna,6842,3,9,11,4,36,26,10,38
LASK Linz,6842,4,9,6,9,27,26,1,33
Mattersburg,6842,5,6,6,12,32,44,-12,24
Vienna,6842,6,6,6,12,26,42,-16,24
SC Rheindorf,6842,7,4,6,14,21,35,-14,18
FC Salzburg,6843,1,14,8,2,44,19,25,50
SK Sturm Gra,6843,2,13,4,7,31,27,4,43
Rapid Vienna,6843,3,8,10,6,34,27,7,34
LASK Linz,6843,4,8,5,11,25,28,-3,29
Mattersburg,6843,5,7,5,12,33,40,-7,26
SC Rheindorf,6843,6,7,5,12,20,28,-8,26
Vienna,6843,7,6,5,13,24,42,-18,23
FC Salzburg,6844,1,16,6,2,52,18,34,54
SK Sturm Gra,6844,2,12,5,7,36,32,4,41
Rapid Vienna,6844,3,8,10,6,34,30,4,34
LASK Linz,6844,4,7,9,8,29,30,-1,30
Mattersburg,6844,5,6,7,11,31,43,-12,25
Vienna,6844,6,6,6,12,25,42,-17,24
SC Rheindorf,6844,7,4,7,13,19,31,-12,19
FC Salzburg,6845,1,14,8,2,48,21,27,50
SK Sturm Gra,6845,2,11,5,8,32,33,-1,38
Rapid Vienna,6845,3,8,11,5,36,28,8,35
LASK Linz,6845,4,9,7,8,27,26,1,34
Mattersburg,6845,5,7,6,11,34,43,-9,27
Vienna,6845,6,6,6,12,28,43,-15,24
SC Rheindorf,6845,7,5,5,14,18,29,-11,20
FC Salzburg,6846,1,14,7,3,42,16,26,49
SK Sturm Gra,6846,2,13,5,6,34,27,7,44
Rapid Vienna,6846,3,8,10,6,36,27,9,34
LASK Linz,6846,4,9,5,10,33,31,2,32
Mattersburg,6846,5,8,5,11,33,41,-8,29
Vienna,6846,6,6,5,13,24,41,-17,23
SC Rheindorf,6846,7,5,5,14,20,39,-19,20
FC Salzburg,6847,1,15,7,2,51,18,33,52
SK Sturm Gra,6847,2,12,5,7,31,31,0,41
Rapid Vienna,6847,3,9,11,4,37,25,12,38
Mattersburg,6847,4,7,6,11,37,44,-7,27
LASK Linz,6847,5,7,5,12,25,35,-10,26
Vienna,6847,6,6,5,13,24,42,-18,23
SC Rheindorf,6847,7,5,7,12,20,30,-10,22
FC Salzburg,6848,1,16,6,2,46,18,28,54
SK Sturm Gra,6848,2,11,5,8,32,30,2,38
LASK Linz,6848,3,9,6,9,26,26,0,33
Rapid Vienna,6848,4,7,10,7,33,28,5,31
Mattersburg,6848,5,7,6,11,31,41,-10,27
SC Rheindorf,6848,6,5,8,11,19,28,-9,23
Vienna,6848,7,6,5,13,25,41,-16,23
FC Salzburg,6849,1,14,7,3,43,19,24,49
SK Sturm Gra,6849,2,13,4,7,31,26,5,43
Rapid Vienna,6849,3,7,11,6,36,30,6,32
LASK Linz,6849,4,8,5,11,25,32,-7,29
Mattersburg,6849,5,7,6,11,31,38,-7,27
Vienna,6849,6,7,6,11,25,38,-13,27
SC Rheindorf,6849,7,5,7,12,18,26,-8,22
FC Salzburg,6850,1,14,8,2,44,15,29,50
SK Sturm Gra,6850,2,13,4,7,31,28,3,43
Rapid Vienna,6850,3,8,10,6,32,25,7,34
LASK Linz,6850,4,8,5,11,25,29,-4,29
Mattersburg,6850,5,7,5,12,31,42,-11,26
SC Rheindorf,6850,6,6,6,12,18,27,-9,24
Vienna,6850,7,6,6,12,24,39,-15,24
FC Salzburg,6851,1,13,9,2,44,20,24,48
SK Sturm Gra,6851,2,13,5,6,35,29,6,44
Rapid Vienna,6851,3,8,11,5,37,28,9,35
LASK Linz,6851,4,8,7,9,27,28,-1,31
Mattersburg,6851,5,6,7,11,32,43,-11,25
Vienna,6851,6,6,6,12,26,41,-15,24
SC Rheindorf,6851,7,5,5,14,18,30,-12,20
FC Salzburg,6852,1,16,6,2,48,17,31,54
SK Sturm Gra,6852,2,13,3,8,35,34,1,42
Rapid Vienna,6852,3,9,10,5,41,30,11,37
LASK Linz,6852,4,8,5,11,30,34,-4,29
Vienna,6852,5,7,5,12,27,40,-13,26
Mattersburg,6852,6,6,6,12,28,42,-14,24
SC Rheindorf,6852,7,4,7,13,18,30,-12,19
FC Salzburg,6853,1,15,7,2,48,19,29,52
SK Sturm Gra,6853,2,14,3,7,37,27,10,45
Rapid Vienna,6853,3,7,11,6,34,31,3,32
LASK Linz,6853,4,8,7,9,26,27,-1,31
Vienna,6853,5,6,6,12,25,42,-17,24
SC Rheindorf,6853,6,5,7,12,17,28,-11,22
Mattersburg,6853,7,5,7,12,29,42,-13,22
FC Salzburg,6854,1,14,7,3,45,18,27,49
Rapid Vienna,6854,2,10,10,4,36,24,12,40
SK Sturm Gra,6854,3,11,3,10,29,33,-4,36
LASK Linz,6854,4,8,6,10,27,29,-2,30
Mattersburg,6854,5,7,7,10,30,38,-8,28
SC Rheindorf,6854,6,6,6,12,19,26,-7,24
Vienna,6854,7,6,5,13,23,41,-18,23
FC Salzburg,6855,1,15,6,3,44,17,27,51
SK Sturm Gra,6855,2,14,3,7,40,28,12,45
Rapid Vienna,6855,3,9,10,5,35,29,6,37
LASK Linz,6855,4,7,8,9,26,31,-5,29
Mattersburg,6855,5,6,7,11,32,43,-11,25
Vienna,6855,6,6,6,12,25,40,-15,24
SC Rheindorf,6855,7,4,6,14,18,32,-14,18
FC Salzburg,6856,1,13,6,5,41,20,21,45
SK Sturm Gra,6856,2,13,3,8,33,27,6,42
LASK Linz,6856,3,10,6,8,31,29,2,36
Rapid Vienna,6856,4,8,9,7,36,32,4,33
Mattersburg,6856,5,7,5,12,29,39,-10,26
Vienna,6856,6,7,5,12,25,38,-13,26
SC Rheindorf,6856,7,6,6,12,23,33,-10,24
FC Salzburg,6857,1,16,6,2,50,19,31,54
Rapid Vienna,6857,2,9,9,6,37,27,10,36
SK Sturm Gra,6857,3,11,3,10,31,35,-4,36
LASK Linz,6857,4,9,6,9,30,30,0,33
SC Rheindorf,6857,5,7,5,12,19,29,-10,26
Vienna,6857,6,7,5,12,26,38,-12,26
Mattersburg,6857,7,5,6,13,33,48,-15,21
FC Salzburg,6858,1,14,8,2,46,19,27,50
SK Sturm Gra,6858,2,14,4,6,36,28,8,46
Rapid Vienna,6858,3,9,9,6,33,26,7,36
LASK Linz,6858,4,7,5,12,23,33,-10,26
Mattersburg,6858,5,7,5,12,30,42,-12,26
Vienna,6858,6,6,6,12,26,41,-15,24
SC Rheindorf,6858,7,6,5,13,24,29,-5,23
FC Salzburg,6859,1,15,7,2,47,20,27,52
SK Sturm Gra,6859,2,12,3,9,33,30,3,39
Rapid Vienna,6859,3,9,10,5,38,29,9,37
LASK Linz,6859,4,10,5,9,33,28,5,35
Mattersburg,6859,5,7,5,12,30,42,-12,26
Vienna,6859,6,6,5,13,24,40,-16,23
SC Rheindorf,6859,7,5,5,14,17,33,-16,20
FC Salzburg,6860,1,15,7,2,49,19,30,52
SK Sturm Gra,6860,2,12,5,7,34,31,3,41
Rapid Vienna,6860,3,9,10,5,37,28,9,37
LASK Linz,6860,4,9,5,10,27,27,0,32
Vienna,6860,5,7,6,11,26,39,-13,27
Mattersburg,6860,6,6,5,13,28,44,-16,23
SC Rheindorf,6860,7,4,6,14,18,31,-13,18
FC Salzburg,6861,1,14,7,3,46,20,26,49
SK Sturm Gra,6861,2,15,3,6,37,26,11,48
Rapid Vienna,6861,3,9,10,5,38,30,8,37
LASK Linz,6861,4,8,6,10,30,31,-1,30
Vienna,6861,5,7,5,12,25,38,-13,26
Mattersburg,6861,6,5,6,13,28,46,-18,21
SC Rheindorf,6861,7,4,7,13,20,33,-13,19
FC Salzburg,6862,1,13,8,3,42,19,23,47
SK Sturm Gra,6862,2,12,5,7,32,28,4,41
Rapid Vienna,6862,3,8,10,6,34,30,4,34
LASK Linz,6862,4,8,7,9,28,28,0,31
Vienna,6862,5,8,5,11,27,39,-12,29
Mattersburg,6862,6,6,6,12,32,42,-10,24
SC Rheindorf,6862,7,5,7,12,19,28,-9,22
FC Salzburg,6863,1,13,9,2,42,18,24,48
SK Sturm Gra,6863,2,12,5,7,32,30,2,41
Rapid Vienna,6863,3,9,10,5,37,26,11,37
LASK Linz,6863,4,7,6,11,24,30,-6,27
Mattersburg,6863,5,7,6,11,32,42,-10,27
Vienna,6863,6,7,5,12,27,39,-12,26
SC Rheindorf,6863,7,6,5,13,20,29,-9,23
FC Salzburg,6864,1,16,6,2,49,18,31,54
SK Sturm Gra,6864,2,12,3,9,32,32,0,39
Rapid Vienna,6864,3,8,10,6,34,27,7,34
LASK Linz,6864,4,7,6,11,27,31,-4,27
Mattersburg,6864,5,7,6,11,31,39,-8,27
SC Rheindorf,6864,6,7,5,12,22,31,-9,26
Vienna,6864,7,6,6,12,23,40,-17,24
FC Salzburg,6865,1,16,6,2,49,18,31,54
Rapid Vienna,6865,2,9,10,5,39,29,10,37
SK Sturm Gra,6865,3,11,3,10,31,37,-6,36
LASK Linz,6865,4,8,7,9,29,30,-1,31
Mattersburg,6865,5,7,5,12,33,46,-13,26
SC Rheindorf,6865,6,6,6,12,25,30,-5,24
Vienna,6865,7,6,5,13,25,41,-16,23
FC Salzburg,6866,1,15,7,2,51,17,34,52
SK Sturm Gra,6866,2,12,4,8,32,34,-2,40
Rapid Vienna,6866,3,9,10,5,37,29,8,37
Mattersburg,6866,4,7,7,10,33,41,-8,28
LASK Linz,6866,5,7,5,12,27,35,-8,26
SC Rheindorf,6866,6,6,6,12,22,29,-7,24
Vienna,6866,7,6,5,13,24,41,-17,23
FC Salzburg,6867,1,15,6,3,48,16,32,51
SK Sturm Gra,6867,2,11,5,8,31,34,-3,38
Rapid Vienna,6867,3,8,11,5,38,30,8,35
LASK Linz,6867,4,8,7,9,27,28,-1,31
Mattersburg,6867,5,7,5,12,35,42,-7,26
Vienna,6867,6,7,5,12,24,42,-18,26
SC Rheindorf,6867,7,6,5,13,21,32,-11,23
FC Salzburg,6868,1,15,6,3,49,20,29,51
SK Sturm Gra,6868,2,14,3,7,36,28,8,45
Rapid Vienna,6868,3,8,10,6,38,30,8,34
LASK Linz,6868,4,7,7,10,26,31,-5,28
SC Rheindorf,6868,5,7,5,12,22,29,-7,26
Vienna,6868,6,7,5,12,24,39,-15,26
Mattersburg,6868,7,5,6,13,28,46,-18,21
FC Salzburg,6869,1,14,8,2,47,18,29,50
SK Sturm Gra,6869,2,11,5,8,30,29,1,38
Rapid Vienna,6869,3,9,10,5,37,27,10,37
LASK Linz,6869,4,9,7,8,26,25,1,34
Vienna,6869,5,6,6,12,24,39,-15,24
SC Rheindorf,6869,6,5,7,12,18,28,-10,22
Mattersburg,6869,7,5,7,12,28,44,-16,22
FC Salzburg,6870,1,14,8,2,44,18,26,50
SK Sturm Gra,6870,2,13,4,7,35,28,7,43
Rapid Vienna,6870,3,7,11,6,35,30,5,32
LASK Linz,6870,4,8,7,9,24,26,-2,31
Mattersburg,6870,5,6,7,11,30,39,-9,25
Vienna,6870,6,6,6,12,24,40,-16,24
SC Rheindorf,6870,7,5,7,12,17,28,-11,22
FC Salzburg,6871,1,13,8,3,41,18,23,47
SK Sturm Gra,6871,2,12,6,6,32,27,5,42
Rapid Vienna,6871,3,7,13,4,34,26,8,34
Vienna,6871,4,8,5,11,29,41,-12,29
LASK Linz,6871,5,7,7,10,24,31,-7,28
Mattersburg,6871,6,7,5,12,34,40,-6,26
SC Rheindorf,6871,7,4,8,12,20,31,-11,20
FC Salzburg,6872,1,15,7,2,53,22,31,52
SK Sturm Gra,6872,2,11,5,8,33,33,0,38
Rapid Vienna,6872,3,8,10,6,36,32,4,34
LASK Linz,6872,4,8,7,9,31,30,1,31
Mattersburg,6872,5,7,5,12,33,46,-13,26
Vienna,6872,6,6,6,12,26,41,-15,24
SC Rheindorf,6872,7,5,8,11,20,28,-8,23
FC Salzburg,6873,1,13,8,3,44,21,23,47
SK Sturm Gra,6873,2,12,6,6,37,30,7,42
Rapid Vienna,6873,3,9,10,5,40,28,12,37
LASK Linz,6873,4,8,6,10,30,35,-5,30
Vienna,6873,5,6,7,11,25,39,-14,25
Mattersburg,6873,6,6,6,12,29,42,-13,24
SC Rheindorf,6873,7,5,7,12,19,29,-10,22
FC Salzburg,6874,1,14,7,3,47,21,26,49
SK Sturm Gra,6874,2,13,4,7,31,28,3,43
Rapid Vienna,6874,3,9,11,4,35,24,11,38
LASK Linz,6874,4,8,5,11,26,28,-2,29
Vienna,6874,5,7,6,11,27,40,-13,27
Mattersburg,6874,6,6,5,13,28,44,-16,23
SC Rheindorf,6874,7,5,6,13,20,29,-9,21
FC Salzburg,6875,1,13,8,3,41,21,20,47
SK Sturm Gra,6875,2,12,6,6,34,28,6,42
LASK Linz,6875,3,9,6,9,30,28,2,33
Rapid Vienna,6875,4,7,10,7,34,30,4,31
Mattersburg,6875,5,8,6,10,30,37,-7,30
Vienna,6875,6,7,5,12,29,40,-11,26
SC Rheindorf,6875,7,4,7,13,16,30,-14,19
FC Salzburg,6876,1,15,7,2,54,20,34,52
SK Sturm Gra,6876,2,12,5,7,31,30,1,41
Rapid Vienna,6876,3,8,11,5,35,26,9,35
LASK Linz,6876,4,7,6,11,23,31,-8,27
Mattersburg,6876,5,7,5,12,34,47,-13,26
SC Rheindorf,6876,6,6,6,12,20,28,-8,24
Vienna,6876,7,6,6,12,24,39,-15,24
FC Salzburg,6877,1,13,7,4,41,19,22,46
Rapid Vienna,6877,2,10,10,4,37,24,13,40
SK Sturm Gra,6877,3,11,4,9,31,32,-1,37
LASK Linz,6877,4,9,7,8,28,26,2,34
Vienna,6877,5,7,6,11,27,40,-13,27
Mattersburg,6877,6,5,8,11,31,42,-11,23
SC Rheindorf,6877,7,5,6,13,19,31,-12,21
FC Salzburg,6878,1,15,7,2,51,17,34,52
SK Sturm Gra,6878,2,13,4,7,37,28,9,43
LASK Linz,6878,3,10,5,9,34,31,3,35
Rapid Vienna,6878,4,8,10,6,39,34,5,34
Vienna,6878,5,7,5,12,26,44,-18,26
Mattersburg,6878,6,5,6,13,29,47,-18,21
SC Rheindorf,6878,7,4,7,13,23,38,-15,19
FC Salzburg,6879,1,14,8,2,43,18,25,50
SK Sturm Gra,6879,2,12,4,8,32,29,3,40
Rapid Vienna,6879,3,10,9,5,38,26,12,39
LASK Linz,6879,4,8,5,11,26,31,-5,29
Vienna,6879,5,7,6,11,26,39,-13,27
SC Rheindorf,6879,6,6,5,13,18,28,-10,23
Mattersburg,6879,7,6,5,13,31,43,-12,23
FC Salzburg,6880,1,13,7,4,44,22,22,46
SK Sturm Gra,6880,2,12,5,7,32,31,1,41
Rapid Vienna,6880,3,8,11,5,34,27,7,35
LASK Linz,6880,4,9,7,8,28,26,2,34
Mattersburg,6880,5,7,6,11,32,41,-9,27
Vienna,6880,6,6,6,12,28,43,-15,24
SC Rheindorf,6880,7,5,6,13,20,28,-8,21
FC Salzburg,6881,1,13,6,5,42,23,19,45
SK Sturm Gra,6881,2,13,5,6,33,26,7,44
Rapid Vienna,6881,3,8,12,4,35,25,10,36
LASK Linz,6881,4,7,8,9,27,29,-2,29
Vienna,6881,5,7,5,12,28,40,-12,26
Mattersburg,6881,6,6,7,11,32,44,-12,25
SC Rheindorf,6881,7,5,7,12,20,30,-10,22
FC Salzburg,6882,1,14,7,3,43,17,26,49
SK Sturm Gra,6882,2,13,3,8,34,30,4,42
Rapid Vienna,6882,3,9,10,5,38,28,10,37
LASK Linz,6882,4,9,6,9,31,30,1,33
Vienna,6882,5,7,5,12,24,39,-15,26
SC Rheindorf,6882,6,6,5,13,19,28,-9,23
Mattersburg,6882,7,5,6,13,26,43,-17,21
FC Salzburg,6883,1,14,8,2,47,20,27,50
SK Sturm Gra,6883,2,11,5,8,31,31,0,38
Rapid Vienna,6883,3,8,11,5,36,29,7,35
LASK Linz,6883,4,8,6,10,25,27,-2,30
Mattersburg,6883,5,6,8,10,32,41,-9,26
SC Rheindorf,6883,6,6,6,12,24,32,-8,24
Vienna,6883,7,6,6,12,28,43,-15,24
FC Salzburg,6884,1,13,8,3,41,18,23,47
SK Sturm Gra,6884,2,13,3,8,33,28,5,42
Rapid Vienna,6884,3,8,12,4,34,25,9,36
LASK Linz,6884,4,9,6,9,28,26,2,33
Mattersburg,6884,5,8,5,11,33,38,-5,29
Vienna,6884,6,6,6,12,25,40,-15,24
SC Rheindorf,6884,7,4,6,14,15,34,-19,18
FC Salzburg,6885,1,13,7,4,44,21,23,46
SK Sturm Gra,6885,2,14,3,7,36,27,9,45
Rapid Vienna,6885,3,11,9,4,43,29,14,42
Mattersburg,6885,4,7,7,10,31,38,-7,28
LASK Linz,6885,5,7,6,11,25,33,-8,27
Vienna,6885,6,6,5,13,23,41,-18,23
SC Rheindorf,6885,7,5,5,14,20,33,-13,20
FC Salzburg,6886,1,12,10,2,42,19,23,46
SK Sturm Gra,6886,2,11,6,7,31,28,3,39
Rapid Vienna,6886,3,9,10,5,38,28,10,37
LASK Linz,6886,4,7,7,10,27,31,-4,28
Mattersburg,6886,5,7,6,11,34,41,-7,27
Vienna,6886,6,7,6,11,27,40,-13,27
SC Rheindorf,6886,7,5,7,12,18,30,-12,22
FC Salzburg,6887,1,13,7,4,44,20,24,46
SK Sturm Gra,6887,2,14,4,6,39,28,11,46
Rapid Vienna,6887,3,9,9,6,36,29,7,36
LASK Linz,6887,4,9,6,9,28,31,-3,33
Mattersburg,6887,5,6,7,11,34,43,-9,25
Vienna,6887,6,6,7,11,27,41,-14,25
SC Rheindorf,6887,7,4,6,14,20,36,-16,18
FC Salzburg,6888,1,12,8,4,39,18,21,44
SK Sturm Gra,6888,2,12,4,8,33,29,4,40
Rapid Vienna,6888,3,9,10,5,35,26,9,37
LASK Linz,6888,4,7,7,10,27,31,-4,28
SC Rheindorf,6888,5,7,6,11,21,28,-7,27
Mattersburg,6888,6,7,6,11,30,39,-9,27
Vienna,6888,7,6,7,11,24,38,-14,25
FC Salzburg,6889,1,14,8,2,44,19,25,50
SK Sturm Gra,6889,2,11,5,8,31,29,2,38
LASK Linz,6889,3,10,6,8,30,28,2,36
Rapid Vienna,6889,4,8,11,5,37,29,8,35
Vienna,6889,5,7,6,11,29,38,-9,27
Mattersburg,6889,6,6,5,13,32,48,-16,23
SC Rheindorf,6889,7,5,5,14,18,30,-12,20
FC Salzburg,6890,1,15,6,3,46,17,29,51
SK Sturm Gra,6890,2,12,4,8,31,31,0,40
Rapid Vienna,6890,3,7,11,6,36,31,5,32
LASK Linz,6890,4,8,6,10,28,31,-3,30
Vienna,6890,5,8,5,11,26,37,-11,29
Mattersburg,6890,6,7,5,12,30,41,-11,26
SC Rheindorf,6890,7,5,7,12,19,28,-9,22
FC Salzburg,6891,1,13,8,3,45,18,27,47
SK Sturm Gra,6891,2,13,5,6,38,29,9,44
LASK Linz,6891,3,9,7,8,32,28,4,34
Rapid Vienna,6891,4,8,9,7,33,31,2,33
Vienna,6891,5,7,5,12,25,43,-18,26
Mattersburg,6891,6,6,6,12,30,40,-10,24
SC Rheindorf,6891,7,5,6,13,19,33,-14,21
FC Salzburg,6892,1,16,6,2,47,17,30,54
SK Sturm Gra,6892,2,13,4,7,36,29,7,43
Rapid Vienna,6892,3,8,11,5,37,28,9,35
LASK Linz,6892,4,8,6,10,35,35,0,30
Vienna,6892,5,6,6,12,24,40,-16,24
Mattersburg,6892,6,6,6,12,30,47,-17,24
SC Rheindorf,6892,7,4,7,13,16,29,-13,19
FC Salzburg,6893,1,14,7,3,45,18,27,49
SK Sturm Gra,6893,2,13,5,6,34,25,9,44
Rapid Vienna,6893,3,7,12,5,33,28,5,33
LASK Linz,6893,4,8,6,10,30,33,-3,30
Mattersburg,6893,5,7,5,12,31,43,-12,26
Vienna,6893,6,7,5,12,25,40,-15,26
SC Rheindorf,6893,7,5,6,13,20,31,-11,21
FC Salzburg,6894,1,15,6,3,48,20,28,51
SK Sturm Gra,6894,2,13,4,7,37,30,7,43
Rapid Vienna,6894,3,10,9,5,40,29,11,39
LASK Linz,6894,4,8,5,11,25,31,-6,29
Vienna,6894,5,7,5,12,26,39,-13,26
SC Rheindorf,6894,6,6,6,12,20,29,-9,24
Mattersburg,6894,7,5,5,14,27,45,-18,20
FC Salzburg,6895,1,14,7,3,46,20,26,49
SK Sturm Gra,6895,2,11,5,8,32,30,2,38
Rapid Vienna,6895,3,8,10,6,36,29,7,34
LASK Linz,6895,4,9,7,8,31,29,2,34
Vienna,6895,5,7,5,12,26,41,-15,26
SC Rheindorf,6895,6,6,6,12,18,27,-9,24
Mattersburg,6895,7,6,6,12,30,43,-13,24
FC Salzburg,6896,1,15,7,2,48,17,31,52
SK Sturm Gra,6896,2,13,4,7,34,27,7,43
Rapid Vienna,6896,3,9,10,5,36,28,8,37
LASK Linz,6896,4,7,6,11,27,32,-5,27
Mattersburg,6896,5,7,6,11,35,46,-11,27
Vienna,6896,6,6,5,13,25,43,-18,23
SC Rheindorf,6896,7,5,6,13,19,31,-12,21
FC Salzburg,6897,1,16,6,2,48,17,31,54
SK Sturm Gra,6897,2,13,3,8,32,27,5,42
Rapid Vienna,6897,3,9,9,6,33,28,5,36
LASK Linz,6897,4,8,7,9,27,28,-1,31
Mattersburg,6897,5,6,6,12,30,45,-15,24
Vienna,6897,6,6,5,13,25,41,-16,23
SC Rheindorf,6897,7,5,6,13,19,28,-9,21
FC Salzburg,6898,1,16,6,2,45,16,29,54
SK Sturm Gra,6898,2,12,3,9,29,28,1,39
Rapid Vienna,6898,3,9,9,6,34,27,7,36
LASK Linz,6898,4,8,7,9,26,27,-1,31
Vienna,6898,5,6,6,12,23,38,-15,24
Mattersburg,6898,6,5,8,11,31,42,-11,23
SC Rheindorf,6898,7,5,7,12,21,31,-10,22
FC Salzburg,6899,1,15,7,2,46,18,28,52
SK Sturm Gra,6899,2,13,3,8,34,33,1,42
Rapid Vienna,6899,3,7,10,7,35,31,4,31
LASK Linz,6899,4,7,7,10,27,30,-3,28
Vienna,6899,5,7,5,12,27,41,-14,26
SC Rheindorf,6899,6,6,7,11,23,29,-6,25
Mattersburg,6899,7,6,7,11,34,44,-10,25
FC Salzburg,6900,1,13,9,2,44,20,24,48
SK Sturm Gra,6900,2,14,4,6,38,27,11,46
Rapid Vienna,6900,3,9,9,6,35,30,5,36
LASK Linz,6900,4,7,6,11,26,31,-5,27
Vienna,6900,5,7,6,11,27,39,-12,27
Mattersburg,6900,6,6,7,11,33,43,-10,25
SC Rheindorf,6900,7,5,5,14,19,32,-13,20
FC Salzburg,6901,1,13,8,3,41,18,23,47
SK Sturm Gra,6901,2,13,4,7,33,26,7,43
Rapid Vienna,6901,3,10,10,4,37,25,12,40
LASK Linz,6901,4,9,6,9,28,28,0,33
Mattersburg,6901,5,7,6,11,32,39,-7,27
Vienna,6901,6,6,5,13,24,42,-18,23
SC Rheindorf,6901,7,4,5,15,17,34,-17,17
FC Salzburg,6902,1,15,6,3,41,17,24,51
SK Sturm Gra,6902,2,12,4,8,33,30,3,40
Rapid Vienna,6902,3,8,10,6,33,27,6,34
LASK Linz,6902,4,8,7,9,28,28,0,31
Vienna,6902,5,7,6,11,26,38,-12,27
Mattersburg,6902,6,5,8,11,31,42,-11,23
SC Rheindorf,6902,7,5,7,12,21,31,-10,22
FC Salzburg,6903,1,13,7,4,40,18,22,46
SK Sturm Gra,6903,2,14,3,7,31,26,5,45
Rapid Vienna,6903,3,10,9,5,35,25,10,39
LASK Linz,6903,4,9,5,10,27,29,-2,32
Vienna,6903,5,7,6,11,26,39,-13,27
Mattersburg,6903,6,6,5,13,32,41,-9,23
SC Rheindorf,6903,7,5,5,14,18,31,-13,20
FC Salzburg,6904,1,14,8,2,43,17,26,50
SK Sturm Gra,6904,2,11,5,8,32,30,2,38
Rapid Vienna,6904,3,7,11,6,34,29,5,32
LASK Linz,6904,4,8,7,9,27,29,-2,31
Vienna,6904,5,7,6,11,25,38,-13,27
Mattersburg,6904,6,7,5,12,32,42,-10,26
SC Rheindorf,6904,7,6,6,12,22,30,-8,24
FC Salzburg,6905,1,15,6,3,46,21,25,51
SK Sturm Gra,6905,2,13,3,8,33,28,5,42
LASK Linz,6905,3,9,6,9,29,28,1,33
Rapid Vienna,6905,4,7,9,8,32,32,0,30
Vienna,6905,5,8,5,11,27,37,-10,29
Mattersburg,6905,6,6,6,12,32,42,-10,24
SC Rheindorf,6905,7,6,5,13,17,28,-11,23
FC Salzburg,6906,1,16,6,2,45,16,29,54
SK Sturm Gra,6906,2,12,3,9,30,31,-1,39
Rapid Vienna,6906,3,8,9,7,34,30,4,33
SC Rheindorf,6906,4,8,5,11,23,25,-2,29
LASK Linz,6906,5,8,5,11,27,30,-3,29
Mattersburg,6906,6,7,5,12,30,41,-11,26
Vienna,6906,7,6,5,13,25,41,-16,23
FC Salzburg,6907,1,15,6,3,48,19,29,51
SK Sturm Gra,6907,2,13,3,8,35,31,4,42
Rapid Vienna,6907,3,9,9,6,36,34,2,36
LASK Linz,6907,4,10,5,9,32,28,4,35
Mattersburg,6907,5,7,5,12,32,40,-8,26
Vienna,6907,6,6,5,13,24,42,-18,23
SC Rheindorf,6907,7,5,5,14,18,31,-13,20
FC Salzburg,6908,1,15,7,2,47,19,28,52
SK Sturm Gra,6908,2,12,4,8,30,26,4,40
Rapid Vienna,6908,3,10,9,5,39,28,11,39
LASK Linz,6908,4,9,5,10,27,28,-1,32
Vienna,6908,5,7,5,12,24,39,-15,26
SC Rheindorf,6908,6,5,6,13,16,28,-12,21
Mattersburg,6908,7,5,6,13,27,42,-15,21
FC Salzburg,6909,1,15,7,2,48,18,30,52
SK Sturm Gra,6909,2,13,4,7,34,28,6,43
Rapid Vienna,6909,3,9,10,5,35,27,8,37
LASK Linz,6909,4,7,6,11,25,32,-7,27
Vienna,6909,5,7,5,12,26,43,-17,26
SC Rheindorf,6909,6,6,5,13,21,27,-6,23
Mattersburg,6909,7,6,5,13,30,44,-14,23
FC Salzburg,6910,1,13,7,4,41,22,19,46
SK Sturm Gra,6910,2,12,4,8,33,29,4,40
Rapid Vienna,6910,3,9,9,6,35,29,6,36
LASK Linz,6910,4,10,5,9,32,29,3,35
Vienna,6910,5,8,5,11,28,37,-9,29
SC Rheindorf,6910,6,6,5,13,19,30,-11,23
Mattersburg,6910,7,6,5,13,30,42,-12,23
FC Salzburg,6911,1,16,6,2,48,19,29,54
SK Sturm Gra,6911,2,11,4,9,29,31,-2,37
Rapid Vienna,6911,3,9,9,6,37,28,9,36
LASK Linz,6911,4,10,6,8,28,25,3,36
Vienna,6911,5,7,5,12,26,40,-14,26
SC Rheindorf,6911,6,6,5,13,21,31,-10,23
Mattersburg,6911,7,5,5,14,27,42,-15,20
FC Salzburg,6912,1,14,7,3,43,19,24,49
SK Sturm Gra,6912,2,12,5,7,32,28,4,41
Rapid Vienna,6912,3,9,10,5,37,30,7,37
LASK Linz,6912,4,8,6,10,27,27,0,30
Vienna,6912,5,7,5,12,25,39,-14,26
Mattersburg,6912,6,6,6,12,32,43,-11,24
SC Rheindorf,6912,7,5,7,12,21,31,-10,22
FC Salzburg,6913,1,15,6,3,45,18,27,51
SK Sturm Gra,6913,2,12,5,7,32,28,4,41
Rapid Vienna,6913,3,9,9,6,35,25,10,36
LASK Linz,6913,4,9,6,9,25,26,-1,33
Mattersburg,6913,5,7,5,12,31,42,-11,26
Vienna,6913,6,7,5,12,26,40,-14,26
SC Rheindorf,6913,7,4,6,14,18,33,-15,18
FC Salzburg,6914,1,15,6,3,48,19,29,51
SK Sturm Gra,6914,2,13,4,7,34,28,6,43
Rapid Vienna,6914,3,9,9,6,35,30,5,36
LASK Linz,6914,4,8,5,11,24,30,-6,29
Vienna,6914,5,7,6,11,26,39,-13,27
Mattersburg,6914,6,6,7,11,33,42,-9,25
SC Rheindorf,6914,7,4,7,13,17,29,-12,19
FC Salzburg,6915,1,15,7,2,49,18,31,52
SK Sturm Gra,6915,2,13,3,8,32,30,2,42
Rapid Vienna,6915,3,8,10,6,37,30,7,34
LASK Linz,6915,4,8,5,11,27,30,-3,29
SC Rheindorf,6915,5,7,5,12,22,29,-7,26
Vienna,6915,6,7,5,12,26,39,-13,26
Mattersburg,6915,7,6,5,13,29,46,-17,23
FC Salzburg,6916,1,14,7,3,50,18,32,49
SK Sturm Gra,6916,2,14,4,6,36,26,10,46
Rapid Vienna,6916,3,10,9,5,38,26,12,39
LASK Linz,6916,4,7,7,10,24,31,-7,28
Vienna,6916,5,7,5,12,25,41,-16,26
SC Rheindorf,6916,6,5,6,13,18,30,-12,21
Mattersburg,6916,7,5,6,13,28,47,-19,21
FC Salzburg,6917,1,15,7,2,50,19,31,52
SK Sturm Gra,6917,2,12,4,8,32,31,1,40
Rapid Vienna,6917,3,8,12,4,36,27,9,36
Mattersburg,6917,4,8,5,11,33,41,-8,29
LASK Linz,6917,5,7,5,12,25,33,-8,26
SC Rheindorf,6917,6,6,6,12,21,28,-7,24
Vienna,6917,7,6,5,13,24,42,-18,23
FC Salzburg,6918,1,15,7,2,44,17,27,52
SK Sturm Gra,6918,2,11,5,8,31,29,2,38
Rapid Vienna,6918,3,7,13,4,34,26,8,34
LASK Linz,6918,4,7,8,9,28,30,-2,29
Mattersburg,6918,5,7,6,11,32,41,-9,27
SC Rheindorf,6918,6,5,8,11,21,30,-9,23
Vienna,6918,7,6,5,13,23,40,-17,23
FC Salzburg,6919,1,16,6,2,51,18,33,54
SK Sturm Gra,6919,2,13,3,8,33,29,4,42
Rapid Vienna,6919,3,9,9,6,35,27,8,36
LASK Linz,6919,4,8,5,11,26,30,-4,29
Mattersburg,6919,5,6,6,12,27,41,-14,24
Vienna,6919,6,6,6,12,24,41,-17,24
SC Rheindorf,6919,7,6,5,13,20,30,-10,23
FC Salzburg,6920,1,14,6,4,45,21,24,48
SK Sturm Gra,6920,2,13,4,7,35,30,5,43
Rapid Vienna,6920,3,11,9,4,38,24,14,42
Mattersburg,6920,4,7,6,11,31,40,-9,27
LASK Linz,6920,5,7,5,12,25,33,-8,26
Vienna,6920,6,6,6,12,26,43,-17,24
SC Rheindorf,6920,7,5,6,13,22,31,-9,21
SK Sturm Gra,6921,1,15,3,6,40,30,10,48
FC Salzburg,6921,2,12,8,4,42,21,21,44
Rapid Vienna,6921,3,7,11,6,35,31,4,32
LASK Linz,6921,4,8,7,9,28,29,-1,31
Vienna,6921,5,7,6,11,26,39,-13,27
Mattersburg,6921,6,6,7,11,31,41,-10,25
SC Rheindorf,6921,7,4,8,12,21,32,-11,20
FC Salzburg,6922,1,14,7,3,52,23,29,49
Rapid Vienna,6922,2,10,9,5,40,29,11,39
SK Sturm Gra,6922,3,11,4,9,33,38,-5,37
LASK Linz,6922,4,9,6,9,28,27,1,33
Vienna,6922,5,8,5,11,28,38,-10,29
Mattersburg,6922,6,5,8,11,30,43,-13,23
SC Rheindorf,6922,7,4,7,13,19,32,-13,19
FC Salzburg,6923,1,15,7,2,45,17,28,52
SK Sturm Gra,6923,2,12,4,8,31,30,1,40
Rapid Vienna,6923,3,8,10,6,33,26,7,34
LASK Linz,6923,4,8,7,9,29,30,-1,31
Mattersburg,6923,5,6,8,10,34,42,-8,26
Vienna,6923,6,6,6,12,25,40,-15,24
SC Rheindorf,6923,7,5,6,13,20,32,-12,21
FC Salzburg,6924,1,14,7,3,42,17,25,49
SK Sturm Gra,6924,2,11,5,8,30,29,1,38
Rapid Vienna,6924,3,9,9,6,34,26,8,36
LASK Linz,6924,4,9,6,9,28,27,1,33
Mattersburg,6924,5,7,6,11,33,41,-8,27
Vienna,6924,6,6,7,11,25,39,-14,25
SC Rheindorf,6924,7,5,6,13,18,31,-13,21
FC Salzburg,6925,1,14,6,4,42,18,24,48
SK Sturm Gra,6925,2,15,3,6,37,27,10,48
Rapid Vienna,6925,3,7,10,7,32,28,4,31
LASK Linz,6925,4,8,6,10,31,33,-2,30
Vienna,6925,5,8,5,11,27,39,-12,29
SC Rheindorf,6925,6,5,7,12,21,32,-11,22
Mattersburg,6925,7,5,7,12,32,45,-13,22
FC Salzburg,6926,1,13,7,4,42,20,22,46
SK Sturm Gra,6926,2,14,3,7,36,28,8,45
Rapid Vienna,6926,3,9,11,4,36,26,10,38
LASK Linz,6926,4,8,6,10,26,32,-6,30
Vienna,6926,5,7,5,12,27,41,-14,26
Mattersburg,6926,6,6,7,11,32,40,-8,25
SC Rheindorf,6926,7,4,7,13,16,28,-12,19
FC Salzburg,6927,1,16,6,2,48,16,32,54
SK Sturm Gra,6927,2,12,4,8,30,28,2,40
LASK Linz,6927,3,10,5,9,31,30,1,35
Rapid Vienna,6927,4,8,10,6,36,29,7,34
Vienna,6927,5,7,5,12,26,41,-15,26
Mattersburg,6927,6,6,5,13,33,47,-14,23
SC Rheindorf,6927,7,5,5,14,20,33,-13,20
FC Salzburg,6928,1,13,7,4,47,22,25,46
SK Sturm Gra,6928,2,13,4,7,34,28,6,43
Rapid Vienna,6928,3,11,9,4,41,26,15,42
LASK Linz,6928,4,9,6,9,29,27,2,33
Vienna,6928,5,7,6,11,25,37,-12,27
Mattersburg,6928,6,6,5,13,30,46,-16,23
SC Rheindorf,6928,7,4,5,15,16,36,-20,17
FC Salzburg,6929,1,14,7,3,44,19,25,49
SK Sturm Gra,6929,2,12,4,8,31,30,1,40
Rapid Vienna,6929,3,7,12,5,32,25,7,33
LASK Linz,6929,4,8,8,8,28,27,1,32
SC Rheindorf,6929,5,6,7,11,22,27,-5,25
Mattersburg,6929,6,6,6,12,32,44,-12,24
Vienna,6929,7,6,6,12,25,42,-17,24
FC Salzburg,6930,1,15,7,2,49,18,31,52
SK Sturm Gra,6930,2,12,4,8,31,32,-1,40
Rapid Vienna,6930,3,8,10,6,36,28,8,34
LASK Linz,6930,4,9,6,9,30,29,1,33
SC Rheindorf,6930,5,7,5,12,22,30,-8,26
Vienna,6930,6,7,5,12,28,41,-13,26
Mattersburg,6930,7,5,5,14,29,47,-18,20
FC Salzburg,6931,1,13,7,4,46,23,23,46
SK Sturm Gra,6931,2,12,4,8,33,31,2,40
Rapid Vienna,6931,3,9,9,6,35,27,8,36
LASK Linz,6931,4,8,6,10,27,30,-3,30
Vienna,6931,5,8,5,11,28,40,-12,29
Mattersburg,6931,6,7,6,11,32,40,-8,27
SC Rheindorf,6931,7,6,5,13,20,30,-10,23
FC Salzburg,6932,1,15,7,2,45,16,29,52
SK Sturm Gra,6932,2,11,5,8,30,28,2,38
Rapid Vienna,6932,3,8,10,6,33,29,4,34
LASK Linz,6932,4,9,6,9,30,30,0,33
Vienna,6932,5,7,5,12,26,41,-15,26
SC Rheindorf,6932,6,6,6,12,21,30,-9,24
Mattersburg,6932,7,6,5,13,34,45,-11,23
FC Salzburg,6933,1,13,8,3,43,19,24,47
SK Sturm Gra,6933,2,13,4,7,32,28,4,43
Rapid Vienna,6933,3,9,9,6,39,31,8,36
LASK Linz,6933,4,8,6,10,28,29,-1,30
Mattersburg,6933,5,6,7,11,29,41,-12,25
Vienna,6933,6,6,7,11,26,40,-14,25
SC Rheindorf,6933,7,5,7,12,22,31,-9,22
FC Salzburg,6934,1,15,7,2,44,18,26,52
SK Sturm Gra,6934,2,12,3,9,34,32,2,39
Rapid Vienna,6934,3,8,10,6,38,29,9,34
LASK Linz,6934,4,7,7,10,25,31,-6,28
SC Rheindorf,6934,5,7,5,12,21,30,-9,26
Vienna,6934,6,7,5,12,26,40,-14,26
Mattersburg,6934,7,6,7,11,34,42,-8,25
FC Salzburg,6935,1,14,6,4,42,18,24,48
SK Sturm Gra,6935,2,12,5,7,32,31,1,41
Rapid Vienna,6935,3,7,11,6,33,27,6,32
LASK Linz,6935,4,9,5,10,29,29,0,32
Vienna,6935,5,7,6,11,27,40,-13,27
Mattersburg,6935,6,6,7,11,31,42,-11,25
SC Rheindorf,6935,7,5,8,11,20,27,-7,23
FC Salzburg,6936,1,15,6,3,48,21,27,51
SK Sturm Gra,6936,2,13,4,7,34,29,5,43
Rapid Vienna,6936,3,8,10,6,36,29,7,34
LASK Linz,6936,4,9,7,8,30,27,3,34
Vienna,6936,5,7,5,12,25,41,-16,26
Mattersburg,6936,6,6,5,13,29,41,-12,23
SC Rheindorf,6936,7,4,7,13,17,31,-14,19
FC Salzburg,6937,1,15,7,2,45,17,28,52
SK Sturm Gra,6937,2,13,3,8,36,33,3,42
Rapid Vienna,6937,3,8,10,6,33,28,5,34
LASK Linz,6937,4,9,5,10,27,28,-1,32
Mattersburg,6937,5,7,5,12,34,43,-9,26
Vienna,6937,6,7,5,12,30,41,-11,26
SC Rheindorf,6937,7,5,5,14,19,34,-15,20
FC Salzburg,6938,1,14,8,2,44,18,26,50
SK Sturm Gra,6938,2,13,5,6,38,28,10,44
Rapid Vienna,6938,3,8,10,6,39,32,7,34
LASK Linz,6938,4,9,5,10,29,34,-5,32
Mattersburg,6938,5,7,6,11,35,43,-8,27
Vienna,6938,6,7,5,12,28,40,-12,26
SC Rheindorf,6938,7,4,5,15,18,36,-18,17
FC Salzburg,6939,1,14,6,4,46,23,23,48
SK Sturm Gra,6939,2,14,3,7,34,28,6,45
Rapid Vienna,6939,3,10,9,5,38,28,10,39
LASK Linz,6939,4,8,5,11,24,29,-5,29
Vienna,6939,5,8,5,11,28,38,-10,29
SC Rheindorf,6939,6,5,6,13,18,28,-10,21
Mattersburg,6939,7,5,6,13,30,44,-14,21
FC Salzburg,6940,1,13,8,3,45,22,23,47
SK Sturm Gra,6940,2,13,3,8,35,31,4,42
Rapid Vienna,6940,3,9,10,5,36,29,7,37
LASK Linz,6940,4,7,7,10,27,30,-3,28
Mattersburg,6940,5,7,6,11,33,40,-7,27
Vienna,6940,6,7,6,11,26,39,-13,27
SC Rheindorf,6940,7,5,6,13,21,32,-11,21
FC Salzburg,6941,1,14,7,3,47,19,28,49
SK Sturm Gra,6941,2,12,5,7,34,29,5,41
Rapid Vienna,6941,3,8,11,5,33,26,7,35
LASK Linz,6941,4,8,6,10,26,28,-2,30
Vienna,6941,5,7,5,12,25,41,-16,26
SC Rheindorf,6941,6,6,7,11,22,30,-8,25
Mattersburg,6941,7,6,5,13,32,46,-14,23
FC Salzburg,6942,1,14,6,4,44,23,21,48
SK Sturm Gra,6942,2,11,5,8,35,34,1,38
Rapid Vienna,6942,3,9,10,5,38,28,10,37
LASK Linz,6942,4,9,7,8,33,29,4,34
Mattersburg,6942,5,7,7,10,34,42,-8,28
Vienna,6942,6,6,6,12,25,40,-15,24
SC Rheindorf,6942,7,4,7,13,18,31,-13,19
FC Salzburg,6943,1,15,6,3,50,21,29,51
SK Sturm Gra,6943,2,12,3,9,31,30,1,39
Rapid Vienna,6943,3,9,9,6,39,30,9,36
LASK Linz,6943,4,10,6,8,31,28,3,36
Mattersburg,6943,5,6,6,12,33,44,-11,24
Vienna,6943,6,6,6,12,24,42,-18,24
SC Rheindorf,6943,7,5,6,13,18,31,-13,21
FC Salzburg,6944,1,15,7,2,46,18,28,52
SK Sturm Gra,6944,2,13,3,8,35,29,6,42
Rapid Vienna,6944,3,8,10,6,36,30,6,34
LASK Linz,6944,4,9,6,9,27,28,-1,33
Vienna,6944,5,6,6,12,25,41,-16,24
Mattersburg,6944,6,5,8,11,29,40,-11,23
SC Rheindorf,6944,7,5,6,13,19,31,-12,21
FC Salzburg,6945,1,14,7,3,43,18,25,49
SK Sturm Gra,6945,2,14,3,7,33,26,7,45
Rapid Vienna,6945,3,8,10,6,34,27,7,34
LASK Linz,6945,4,9,6,9,27,28,-1,33
Mattersburg,6945,5,7,5,12,31,39,-8,26
Vienna,6945,6,7,5,12,27,42,-15,26
SC Rheindorf,6945,7,4,6,14,18,33,-15,18
FC Salzburg,6946,1,13,7,4,41,22,19,46
SK Sturm Gra,6946,2,12,5,7,31,29,2,41
Rapid Vienna,6946,3,9,9,6,38,29,9,36
LASK Linz,6946,4,9,6,9,29,29,0,33
Vienna,6946,5,8,5,11,30,38,-8,29
SC Rheindorf,6946,6,6,5,13,24,30,-6,23
Mattersburg,6946,7,6,5,13,29,45,-16,23
FC Salzburg,6947,1,15,7,2,47,16,31,52
SK Sturm Gra,6947,2,12,4,8,33,33,0,40
Rapid Vienna,6947,3,8,11,5,38,30,8,35
Mattersburg,6947,4,7,6,11,34,45,-11,27
LASK Linz,6947,5,7,5,12,30,38,-8,26
Vienna,6947,6,6,7,11,25,39,-14,25
SC Rheindorf,6947,7,6,6,12,25,31,-6,24
FC Salzburg,6948,1,14,7,3,43,18,25,49
Rapid Vienna,6948,2,11,9,4,45,25,20,42
SK Sturm Gra,6948,3,11,6,7,31,31,0,39
LASK Linz,6948,4,7,7,10,26,30,-4,28
Vienna,6948,5,7,5,12,25,39,-14,26
SC Rheindorf,6948,6,6,6,12,20,30,-10,24
Mattersburg,6948,7,5,6,13,26,43,-17,21
FC Salzburg,6949,1,15,7,2,48,19,29,52
SK Sturm Gra,6949,2,13,4,7,38,32,6,43
Rapid Vienna,6949,3,8,9,7,37,32,5,33
LASK Linz,6949,4,9,6,9,31,33,-2,33
Mattersburg,6949,5,7,5,12,33,43,-10,26
Vienna,6949,6,6,6,12,24,39,-15,24
SC Rheindorf,6949,7,5,5,14,20,33,-13,20
FC Salzburg,6950,1,13,8,3,47,23,24,47
SK Sturm Gra,6950,2,12,5,7,32,27,5,41
LASK Linz,6950,3,10,6,8,29,25,4,36
Rapid Vienna,6950,4,7,11,6,33,29,4,32
Vienna,6950,5,8,5,11,30,41,-11,29
Mattersburg,6950,6,6,5,13,29,44,-15,23
SC Rheindorf,6950,7,5,6,13,16,27,-11,21
FC Salzburg,6951,1,13,7,4,44,21,23,46
SK Sturm Gra,6951,2,13,5,6,34,28,6,44
Rapid Vienna,6951,3,9,9,6,36,32,4,36
LASK Linz,6951,4,8,6,10,34,33,1,30
Mattersburg,6951,5,8,5,11,37,45,-8,29
Vienna,6951,6,7,5,12,26,39,-13,26
SC Rheindorf,6951,7,5,5,14,20,33,-13,20
FC Salzburg,6952,1,15,6,3,45,17,28,51
SK Sturm Gra,6952,2,12,4,8,33,31,2,40
Rapid Vienna,6952,3,9,9,6,33,25,8,36
LASK Linz,6952,4,8,7,9,28,31,-3,31
Vienna,6952,5,7,5,12,29,39,-10,26
SC Rheindorf,6952,6,6,6,12,21,29,-8,24
Mattersburg,6952,7,6,5,13,31,48,-17,23
FC Salzburg,6953,1,14,8,2,45,19,26,50
SK Sturm Gra,6953,2,12,4,8,33,30,3,40
Rapid Vienna,6953,3,9,11,4,37,26,11,38
LASK Linz,6953,4,9,7,8,27,26,1,34
Mattersburg,6953,5,6,6,12,29,40,-11,24
Vienna,6953,6,6,5,13,25,42,-17,23
SC Rheindorf,6953,7,5,5,14,17,30,-13,20
FC Salzburg,6954,1,15,7,2,44,16,28,52
SK Sturm Gra,6954,2,13,4,7,32,28,4,43
Rapid Vienna,6954,3,7,10,7,34,31,3,31
LASK Linz,6954,4,8,6,10,27,30,-3,30
Mattersburg,6954,5,7,6,11,34,40,-6,27
Vienna,6954,6,6,7,11,24,38,-14,25
SC Rheindorf,6954,7,4,8,12,18,30,-12,20
FC Salzburg,6955,1,15,7,2,47,17,30,52
Rapid Vienna,6955,2,9,10,5,38,29,9,37
SK Sturm Gra,6955,3,11,4,9,33,34,-1,37
LASK Linz,6955,4,8,6,10,28,29,-1,30
Mattersburg,6955,5,8,6,10,32,38,-6,30
Vienna,6955,6,6,5,13,25,44,-19,23
SC Rheindorf,6955,7,5,6,13,18,30,-12,21
FC Salzburg,6956,1,15,7,2,48,19,29,52
SK Sturm Gra,6956,2,14,3,7,35,29,6,45
Rapid Vienna,6956,3,8,9,7,34,31,3,33
LASK Linz,6956,4,9,6,9,29,29,0,33
Vienna,6956,5,7,6,11,26,39,-13,27
Mattersburg,6956,6,5,6,13,30,43,-13,21
SC Rheindorf,6956,7,5,5,14,19,31,-12,20
FC Salzburg,6957,1,15,7,2,45,16,29,52
SK Sturm Gra,6957,2,13,5,6,33,27,6,44
Rapid Vienna,6957,3,7,11,6,34,30,4,32
LASK Linz,6957,4,8,7,9,31,29,2,31
Vienna,6957,5,7,5,12,25,38,-13,26
Mattersburg,6957,6,5,7,12,29,43,-14,22
SC Rheindorf,6957,7,4,8,12,19,33,-14,20
FC Salzburg,6958,1,15,7,2,46,20,26,52
Rapid Vienna,6958,2,9,10,5,38,29,9,37
SK Sturm Gra,6958,3,11,4,9,32,31,1,37
LASK Linz,6958,4,8,7,9,26,27,-1,31
Mattersburg,6958,5,7,7,10,32,40,-8,28
Vienna,6958,6,6,5,13,26,42,-16,23
SC Rheindorf,6958,7,5,6,13,19,30,-11,21
FC Salzburg,6959,1,14,6,4,45,21,24,48
SK Sturm Gra,6959,2,13,4,7,36,29,7,43
Rapid Vienna,6959,3,9,9,6,35,31,4,36
LASK Linz,6959,4,8,6,10,27,28,-1,30
Mattersburg,6959,5,7,5,12,35,43,-8,26
Vienna,6959,6,7,5,12,26,42,-16,26
SC Rheindorf,6959,7,6,5,13,19,29,-10,23
FC Salzburg,6960,1,14,6,4,43,20,23,48
Rapid Vienna,6960,2,10,10,4,36,25,11,40
SK Sturm Gra,6960,3,12,3,9,31,29,2,39
LASK Linz,6960,4,8,8,8,28,28,0,32
Vienna,6960,5,7,6,11,26,38,-12,27
Mattersburg,6960,6,6,7,11,30,40,-10,25
SC Rheindorf,6960,7,4,6,14,16,30,-14,18
FC Salzburg,6961,1,14,8,2,44,18,26,50
SK Sturm Gra,6961,2,12,3,9,33,32,1,39
Rapid Vienna,6961,3,9,9,6,35,27,8,36
LASK Linz,6961,4,9,6,9,31,31,0,33
Mattersburg,6961,5,6,8,10,33,42,-9,26
Vienna,6961,6,6,6,12,25,40,-15,24
SC Rheindorf,6961,7,5,6,13,21,32,-11,21
FC Salzburg,6962,1,16,6,2,49,17,32,54
SK Sturm Gra,6962,2,13,3,8,34,30,4,42
LASK Linz,6962,3,9,7,8,29,25,4,34
Rapid Vienna,6962,4,8,9,7,35,31,4,33
Vienna,6962,5,7,5,12,27,40,-13,26
Mattersburg,6962,6,6,6,12,32,47,-15,24
SC Rheindorf,6962,7,4,6,14,17,33,-16,18
FC Salzburg,6963,1,14,8,2,44,18,26,50
SK Sturm Gra,6963,2,12,5,7,31,27,4,41
Rapid Vienna,6963,3,9,9,6,36,28,8,36
LASK Linz,6963,4,7,8,9,23,25,-2,29
Vienna,6963,5,7,5,12,26,40,-14,26
Mattersburg,6963,6,6,7,11,31,41,-10,25
SC Rheindorf,6963,7,5,6,13,19,31,-12,21
FC Salzburg,6964,1,14,7,3,46,18,28,49
SK Sturm Gra,6964,2,13,5,6,36,27,9,44
Rapid Vienna,6964,3,8,10,6,35,30,5,34
LASK Linz,6964,4,8,6,10,28,31,-3,30
Mattersburg,6964,5,7,6,11,31,43,-12,27
Vienna,6964,6,6,6,12,23,38,-15,24
SC Rheindorf,6964,7,5,6,13,18,30,-12,21
FC Salzburg,6965,1,12,10,2,43,20,23,46
SK Sturm Gra,6965,2,13,5,6,32,26,6,44
LASK Linz,6965,3,9,6,9,26,26,0,33
Rapid Vienna,6965,4,7,11,6,33,27,6,32
Vienna,6965,5,6,7,11,25,39,-14,25
SC Rheindorf,6965,6,6,6,12,23,32,-9,24
Mattersburg,6965,7,5,7,12,32,44,-12,22
FC Salzburg,6966,1,13,7,4,42,20,22,46
SK Sturm Gra,6966,2,13,5,6,37,30,7,44
Rapid Vienna,6966,3,7,11,6,36,30,6,32
LASK Linz,6966,4,8,7,9,30,31,-1,31
Vienna,6966,5,7,6,11,24,37,-13,27
Mattersburg,6966,6,7,5,12,29,40,-11,26
SC Rheindorf,6966,7,5,7,12,22,32,-10,22
FC Salzburg,6967,1,14,7,3,47,18,29,49
SK Sturm Gra,6967,2,11,5,8,31,34,-3,38
Rapid Vienna,6967,3,9,10,5,37,27,10,37
Mattersburg,6967,4,8,6,10,33,40,-7,30
LASK Linz,6967,5,7,8,9,26,28,-2,29
Vienna,6967,6,6,6,12,26,41,-15,24
SC Rheindorf,6967,7,5,6,13,17,29,-12,21
FC Salzburg,6968,1,15,7,2,45,16,29,52
SK Sturm Gra,6968,2,12,4,8,33,30,3,40
Rapid Vienna,6968,3,7,9,8,33,30,3,30
LASK Linz,6968,4,8,6,10,27,30,-3,30
SC Rheindorf,6968,5,8,5,11,23,29,-6,29
Vienna,6968,6,6,7,11,25,39,-14,25
Mattersburg,6968,7,6,6,12,29,41,-12,24
FC Salzburg,6969,1,16,6,2,50,18,32,54
SK Sturm Gra,6969,2,12,3,9,31,30,1,39
Rapid Vienna,6969,3,9,9,6,36,28,8,36
LASK Linz,6969,4,8,6,10,26,31,-5,30
Mattersburg,6969,5,7,6,11,32,42,-10,27
SC Rheindorf,6969,6,6,5,13,21,28,-7,23
Vienna,6969,7,6,5,13,24,43,-19,23
FC Salzburg,6970,1,15,6,3,47,18,29,51
SK Sturm Gra,6970,2,13,5,6,35,29,6,44
Rapid Vienna,6970,3,7,11,6,35,30,5,32
LASK Linz,6970,4,9,5,10,29,31,-2,32
SC Rheindorf,6970,5,6,7,11,23,27,-4,25
Vienna,6970,6,6,6,12,26,42,-16,24
Mattersburg,6970,7,5,6,13,30,48,-18,21
FC Salzburg,6971,1,13,7,4,40,18,22,46
SK Sturm Gra,6971,2,14,3,7,33,26,7,45
Rapid Vienna,6971,3,9,11,4,34,23,11,38
LASK Linz,6971,4,8,6,10,25,29,-4,30
Mattersburg,6971,5,7,6,11,29,38,-9,27
Vienna,6971,6,7,5,12,26,39,-13,26
SC Rheindorf,6971,7,4,6,14,15,29,-14,18
FC Salzburg,6972,1,14,8,2,43,17,26,50
SK Sturm Gra,6972,2,12,4,8,31,28,3,40
Rapid Vienna,6972,3,8,10,6,35,28,7,34
LASK Linz,6972,4,9,6,9,28,27,1,33
Mattersburg,6972,5,6,8,10,35,39,-4,26
Vienna,6972,6,6,6,12,24,40,-16,24
SC Rheindorf,6972,7,5,6,13,19,36,-17,21
FC Salzburg,6973,1,14,6,4,45,21,24,48
SK Sturm Gra,6973,2,13,3,8,33,27,6,42
Rapid Vienna,6973,3,10,10,4,39,25,14,40
LASK Linz,6973,4,9,6,9,30,29,1,33
Vienna,6973,5,7,5,12,28,41,-13,26
Mattersburg,6973,6,6,5,13,31,46,-15,23
SC Rheindorf,6973,7,5,5,14,19,36,-17,20
FC Salzburg,6974,1,16,6,2,46,18,28,54
SK Sturm Gra,6974,2,12,5,7,31,27,4,41
Rapid Vienna,6974,3,8,11,5,36,28,8,35
LASK Linz,6974,4,7,7,10,25,28,-3,28
Vienna,6974,5,7,5,12,25,40,-15,26
SC Rheindorf,6974,6,5,7,12,20,30,-10,22
Mattersburg,6974,7,5,7,12,28,40,-12,22
FC Salzburg,6975,1,14,7,3,44,19,25,49
SK Sturm Gra,6975,2,12,5,7,33,29,4,41
Rapid Vienna,6975,3,7,12,5,33,26,7,33
LASK Linz,6975,4,9,6,9,27,27,0,33
Vienna,6975,5,8,5,11,29,41,-12,29
Mattersburg,6975,6,6,6,12,29,41,-12,24
SC Rheindorf,6975,7,4,7,13,22,34,-12,19
FC Salzburg,6976,1,13,8,3,42,21,21,47
SK Sturm Gra,6976,2,13,4,7,35,28,7,43
Rapid Vienna,6976,3,9,10,5,38,28,10,37
LASK Linz,6976,4,9,7,8,27,26,1,34
Mattersburg,6976,5,6,7,11,32,41,-9,25
Vienna,6976,6,6,6,12,24,40,-16,24
SC Rheindorf,6976,7,4,6,14,17,31,-14,18
FC Salzburg,6977,1,13,7,4,41,20,21,46
SK Sturm Gra,6977,2,13,4,7,38,32,6,43
LASK Linz,6977,3,10,5,9,34,31,3,35
Rapid Vienna,6977,4,8,10,6,35,29,6,34
Mattersburg,6977,5,6,7,11,32,43,-11,25
Vienna,6977,6,6,6,12,24,39,-15,24
SC Rheindorf,6977,7,5,7,12,17,27,-10,22
FC Salzburg,6978,1,16,6,2,44,15,29,54
SK Sturm Gra,6978,2,13,4,7,34,29,5,43
Rapid Vienna,6978,3,8,11,5,35,26,9,35
LASK Linz,6978,4,7,7,10,27,31,-4,28
Mattersburg,6978,5,6,7,11,32,40,-8,25
Vienna,6978,6,6,5,13,24,44,-20,23
SC Rheindorf,6978,7,4,8,12,19,30,-11,20
FC Salzburg,6979,1,14,7,3,42,18,24,49
SK Sturm Gra,6979,2,11,4,9,34,34,0,37
Rapid Vienna,6979,3,8,11,5,36,28,8,35
LASK Linz,6979,4,8,7,9,29,29,0,31
Mattersburg,6979,5,8,5,11,32,41,-9,29
SC Rheindorf,6979,6,6,7,11,19,26,-7,25
Vienna,6979,7,6,5,13,23,39,-16,23
FC Salzburg,6980,1,16,6,2,52,18,34,54
SK Sturm Gra,6980,2,13,4,7,32,28,4,43
Rapid Vienna,6980,3,9,10,5,37,29,8,37
LASK Linz,6980,4,7,5,12,25,33,-8,26
Mattersburg,6980,5,7,5,12,30,41,-11,26
Vienna,6980,6,7,5,12,24,39,-15,26
SC Rheindorf,6980,7,5,5,14,17,29,-12,20
FC Salzburg,6981,1,14,7,3,48,20,28,49
SK Sturm Gra,6981,2,14,3,7,36,29,7,45
LASK Linz,6981,3,9,6,9,30,30,0,33
Rapid Vienna,6981,4,7,11,6,36,30,6,32
Vienna,6981,5,8,5,11,28,38,-10,29
Mattersburg,6981,6,6,5,13,30,48,-18,23
SC Rheindorf,6981,7,5,5,14,19,32,-13,20
FC Salzburg,6982,1,15,6,3,43,16,27,51
SK Sturm Gra,6982,2,13,4,7,35,28,7,43
Rapid Vienna,6982,3,8,10,6,35,28,7,34
LASK Linz,6982,4,8,5,11,29,31,-2,29
Mattersburg,6982,5,8,5,11,31,42,-11,29
Vienna,6982,6,6,5,13,24,42,-18,23
SC Rheindorf,6982,7,5,7,12,18,28,-10,22
FC Salzburg,6983,1,16,6,2,46,17,29,54
SK Sturm Gra,6983,2,13,3,8,31,27,4,42
Rapid Vienna,6983,3,10,9,5,37,27,10,39
LASK Linz,6983,4,8,5,11,27,29,-2,29
Mattersburg,6983,5,6,6,12,30,42,-12,24
Vienna,6983,6,6,6,12,25,41,-16,24
SC Rheindorf,6983,7,5,5,14,16,29,-13,20
FC Salzburg,6984,1,15,7,2,48,20,28,52
SK Sturm Gra,6984,2,13,4,7,34,27,7,43
Rapid Vienna,6984,3,8,12,4,39,27,12,36
LASK Linz,6984,4,8,7,9,32,29,3,31
Vienna,6984,5,7,5,12,26,40,-14,26
Mattersburg,6984,6,6,5,13,29,49,-20,23
SC Rheindorf,6984,7,4,6,14,16,32,-16,18
FC Salzburg,6985,1,15,7,2,48,20,28,52
SK Sturm Gra,6985,2,13,4,7,35,28,7,43
Rapid Vienna,6985,3,8,10,6,35,29,6,34
LASK Linz,6985,4,9,6,9,29,30,-1,33
Mattersburg,6985,5,6,6,12,30,41,-11,24
Vienna,6985,6,6,6,12,25,41,-16,24
SC Rheindorf,6985,7,4,7,13,18,31,-13,19
FC Salzburg,6986,1,15,7,2,48,20,28,52
SK Sturm Gra,6986,2,13,3,8,33,30,3,42
Rapid Vienna,6986,3,8,10,6,37,31,6,34
LASK Linz,6986,4,7,6,11,25,30,-5,27
SC Rheindorf,6986,5,7,5,12,23,29,-6,26
Vienna,6986,6,6,7,11,25,39,-14,25
Mattersburg,6986,7,6,6,12,32,44,-12,24
FC Salzburg,6987,1,16,6,2,48,18,30,54
SK Sturm Gra,6987,2,12,3,9,30,32,-2,39
Rapid Vienna,6987,3,8,11,5,37,28,9,35
LASK Linz,6987,4,8,6,10,28,28,0,30
Vienna,6987,5,7,5,12,29,42,-13,26
SC Rheindorf,6987,6,6,6,12,21,29,-8,24
Mattersburg,6987,7,6,5,13,28,44,-16,23
FC Salzburg,6988,1,13,8,3,44,21,23,47
SK Sturm Gra,6988,2,12,5,7,32,28,4,41
Rapid Vienna,6988,3,9,10,5,39,29,10,37
LASK Linz,6988,4,8,6,10,28,30,-2,30
Vienna,6988,5,7,5,12,25,38,-13,26
SC Rheindorf,6988,6,6,6,12,24,33,-9,24
Mattersburg,6988,7,6,6,12,32,45,-13,24
FC Salzburg,6989,1,15,6,3,46,18,28,51
SK Sturm Gra,6989,2,11,4,9,28,30,-2,37
Rapid Vienna,6989,3,9,9,6,35,26,9,36
LASK Linz,6989,4,9,6,9,26,25,1,33
Mattersburg,6989,5,7,5,12,32,43,-11,26
Vienna,6989,6,7,5,12,25,41,-16,26
SC Rheindorf,6989,7,5,7,12,18,27,-9,22
FC Salzburg,6990,1,14,6,4,43,23,20,48
SK Sturm Gra,6990,2,11,5,8,32,30,2,38
Rapid Vienna,6990,3,8,10,6,36,28,8,34
Mattersburg,6990,4,9,5,10,34,39,-5,32
LASK Linz,6990,5,8,6,10,28,29,-1,30
SC Rheindorf,6990,6,7,5,12,19,27,-8,26
Vienna,6990,7,6,5,13,25,41,-16,23
FC Salzburg,6991,1,14,6,4,43,19,24,48
SK Sturm Gra,6991,2,11,4,9,31,32,-1,37
Rapid Vienna,6991,3,7,12,5,33,27,6,33
LASK Linz,6991,4,8,6,10,25,27,-2,30
Mattersburg,6991,5,8,5,11,31,40,-9,29
Vienna,6991,6,8,5,11,26,37,-11,29
SC Rheindorf,6991,7,6,6,12,21,28,-7,24
FC Salzburg,6992,1,14,7,3,42,18,24,49
SK Sturm Gra,6992,2,13,4,7,36,29,7,43
Rapid Vienna,6992,3,10,9,5,41,27,14,39
LASK Linz,6992,4,9,5,10,29,33,-4,32
Vienna,6992,5,7,6,11,26,38,-12,27
Mattersburg,6992,6,6,5,13,30,43,-13,23
SC Rheindorf,6992,7,4,6,14,16,32,-16,18
FC Salzburg,6993,1,13,8,3,42,20,22,47
SK Sturm Gra,6993,2,13,5,6,33,26,7,44
Rapid Vienna,6993,3,8,9,7,36,30,6,33
LASK Linz,6993,4,9,5,10,29,29,0,32
Mattersburg,6993,5,8,5,11,35,40,-5,29
Vienna,6993,6,6,6,12,24,41,-17,24
SC Rheindorf,6993,7,5,6,13,21,34,-13,21
FC Salzburg,6994,1,15,7,2,48,17,31,52
SK Sturm Gra,6994,2,12,3,9,31,31,0,39
Rapid Vienna,6994,3,9,10,5,35,25,10,37
LASK Linz,6994,4,8,6,10,24,29,-5,30
Mattersburg,6994,5,7,6,11,30,40,-10,27
Vienna,6994,6,6,6,12,27,42,-15,24
SC Rheindorf,6994,7,5,6,13,16,27,-11,21
FC Salzburg,6995,1,15,7,2,49,20,29,52
SK Sturm Gra,6995,2,14,3,7,34,30,4,45
Rapid Vienna,6995,3,8,9,7,37,31,6,33
Vienna,6995,4,7,6,11,26,38,-12,27
LASK Linz,6995,5,7,5,12,23,32,-9,26
SC Rheindorf,6995,6,6,6,12,21,28,-7,24
Mattersburg,6995,7,6,6,12,29,40,-11,24
FC Salzburg,6996,1,15,6,3,49,17,32,51
SK Sturm Gra,6996,2,11,5,8,29,33,-4,38
Rapid Vienna,6996,3,7,12,5,34,28,6,33
LASK Linz,6996,4,8,7,9,27,28,-1,31
Mattersburg,6996,5,7,7,10,31,39,-8,28
Vienna,6996,6,6,6,12,24,39,-15,24
SC Rheindorf,6996,7,4,9,11,19,29,-10,21
FC Salzburg,6997,1,13,7,4,44,21,23,46
SK Sturm Gra,6997,2,14,4,6,36,27,9,46
Rapid Vienna,6997,3,8,11,5,33,25,8,35
LASK Linz,6997,4,9,6,9,31,31,0,33
Mattersburg,6997,5,8,5,11,34,41,-7,29
Vienna,6997,6,6,5,13,24,42,-18,23
SC Rheindorf,6997,7,4,6,14,19,34,-15,18
FC Salzburg,6998,1,14,8,2,45,20,25,50
SK Sturm Gra,6998,2,13,4,7,33,27,6,43
Rapid Vienna,6998,3,8,10,6,36,31,5,34
LASK Linz,6998,4,9,6,9,30,28,2,33
Vienna,6998,5,7,6,11,25,38,-13,27
SC Rheindorf,6998,6,5,6,13,19,29,-10,21
Mattersburg,6998,7,5,6,13,28,43,-15,21
FC Salzburg,6999,1,14,7,3,47,19,28,49
SK Sturm Gra,6999,2,13,4,7,34,31,3,43
Rapid Vienna,6999,3,7,12,5,33,26,7,33
LASK Linz,6999,4,8,7,9,29,30,-1,31
Vienna,6999,5,8,5,11,27,38,-11,29
SC Rheindorf,6999,6,5,7,12,19,28,-9,22
Mattersburg,6999,7,5,6,13,29,46,-17,21
FC Salzburg,7000,1,15,6,3,52,20,32,51
Rapid Vienna,7000,2,11,9,4,40,27,13,42
SK Sturm Gra,7000,3,11,4,9,31,31,0,37
LASK Linz,7000,4,9,6,9,25,25,0,33
Vienna,7000,5,6,6,12,24,40,-16,24
Mattersburg,7000,6,5,7,12,27,46,-19,22
SC Rheindorf,7000,7,5,6,13,19,29,-10,21
FC Salzburg,7001,1,13,9,2,42,17,25,48
SK Sturm Gra,7001,2,12,4,8,30,30,0,40
Rapid Vienna,7001,3,8,12,4,35,24,11,36
LASK Linz,7001,4,8,7,9,29,29,0,31
Mattersburg,7001,5,7,6,11,35,43,-8,27
Vienna,7001,6,6,6,12,25,40,-15,24
SC Rheindorf,7001,7,4,8,12,18,31,-13,20
FC Salzburg,7002,1,14,7,3,45,19,26,49
SK Sturm Gra,7002,2,12,4,8,31,29,2,40
Rapid Vienna,7002,3,9,10,5,38,28,10,37
LASK Linz,7002,4,10,6,8,30,26,4,36
Vienna,7002,5,7,5,12,24,40,-16,26
SC Rheindorf,7002,6,6,5,13,18,29,-11,23
Mattersburg,7002,7,5,5,14,28,43,-15,20
FC Salzburg,7003,1,15,6,3,45,19,26,51
SK Sturm Gra,7003,2,14,3,7,34,27,7,45
Rapid Vienna,7003,3,9,9,6,40,30,10,36
Vienna,7003,4,8,5,11,27,38,-11,29
LASK Linz,7003,5,7,5,12,24,31,-7,26
Mattersburg,7003,6,7,5,12,30,40,-10,26
SC Rheindorf,7003,7,5,5,14,19,34,-15,20
FC Salzburg,7004,1,14,8,2,45,17,28,50
Rapid Vienna,7004,2,10,10,4,38,25,13,40
SK Sturm Gra,7004,3,11,3,10,28,34,-6,36
LASK Linz,7004,4,8,7,9,28,28,0,31
Vienna,7004,5,7,6,11,25,38,-13,27
Mattersburg,7004,6,6,6,12,30,41,-11,24
SC Rheindorf,7004,7,5,6,13,19,30,-11,21
FC Salzburg,7005,1,15,6,3,43,17,26,51
SK Sturm Gra,7005,2,13,4,7,34,26,8,43
Rapid Vienna,7005,3,9,10,5,36,27,9,37
LASK Linz,7005,4,9,6,9,32,29,3,33
Vienna,7005,5,6,6,12,24,39,-15,24
Mattersburg,7005,6,5,7,12,30,45,-15,22
SC Rheindorf,7005,7,5,5,14,20,36,-16,20
FC Salzburg,7006,1,14,8,2,49,20,29,50
SK Sturm Gra,7006,2,11,5,8,32,31,1,38
Rapid Vienna,7006,3,9,10,5,36,25,11,37
LASK Linz,7006,4,8,6,10,24,26,-2,30
Vienna,7006,5,7,5,12,26,42,-16,26
SC Rheindorf,7006,6,6,6,12,18,28,-10,24
Mattersburg,7006,7,6,6,12,28,41,-13,24
FC Salzburg,7007,1,12,7,5,41,21,20,43
SK Sturm Gra,7007,2,13,4,7,33,29,4,43
Rapid Vienna,7007,3,8,11,5,35,27,8,35
LASK Linz,7007,4,9,5,10,29,29,0,32
Mattersburg,7007,5,7,7,10,33,40,-7,28
Vienna,7007,6,7,6,11,24,37,-13,27
SC Rheindorf,7007,7,5,6,13,19,31,-12,21
FC Salzburg,7008,1,15,6,3,49,21,28,51
SK Sturm Gra,7008,2,11,5,8,32,32,0,38
Rapid Vienna,7008,3,9,10,5,41,30,11,37
LASK Linz,7008,4,8,6,10,26,32,-6,30
SC Rheindorf,7008,5,7,5,12,22,28,-6,26
Vienna,7008,6,7,5,12,25,42,-17,26
Mattersburg,7008,7,6,5,13,32,42,-10,23
FC Salzburg,7009,1,15,7,2,48,18,30,52
SK Sturm Gra,7009,2,12,5,7,35,32,3,41
Rapid Vienna,7009,3,8,11,5,36,27,9,35
LASK Linz,7009,4,8,7,9,29,30,-1,31
Mattersburg,7009,5,6,6,12,28,41,-13,24
Vienna,7009,6,6,6,12,25,42,-17,24
SC Rheindorf,7009,7,4,8,12,19,30,-11,20
FC Salzburg,7010,1,14,8,2,42,17,25,50
SK Sturm Gra,7010,2,12,6,6,33,28,5,42
Rapid Vienna,7010,3,9,10,5,36,25,11,37
LASK Linz,7010,4,8,6,10,25,28,-3,30
Vienna,7010,5,7,6,11,25,37,-12,27
SC Rheindorf,7010,6,5,7,12,20,30,-10,22
Mattersburg,7010,7,5,5,14,27,43,-16,20
FC Salzburg,7011,1,15,7,2,50,19,31,52
SK Sturm Gra,7011,2,12,4,8,33,34,-1,40
Rapid Vienna,7011,3,8,10,6,38,30,8,34
LASK Linz,7011,4,9,6,9,27,28,-1,33
Mattersburg,7011,5,8,5,11,34,40,-6,29
Vienna,7011,6,6,5,13,24,41,-17,23
SC Rheindorf,7011,7,5,5,14,19,33,-14,20
FC Salzburg,7012,1,15,7,2,48,21,27,52
SK Sturm Gra,7012,2,12,5,7,34,28,6,41
Rapid Vienna,7012,3,9,10,5,35,26,9,37
Mattersburg,7012,4,8,5,11,33,39,-6,29
LASK Linz,7012,5,7,6,11,25,34,-9,27
Vienna,7012,6,6,5,13,25,42,-17,23
SC Rheindorf,7012,7,5,6,13,17,27,-10,21
FC Salzburg,7013,1,16,6,2,50,17,33,54
SK Sturm Gra,7013,2,12,5,7,34,30,4,41
Rapid Vienna,7013,3,8,10,6,32,27,5,34
LASK Linz,7013,4,9,7,8,32,29,3,34
Mattersburg,7013,5,6,6,12,30,45,-15,24
Vienna,7013,6,6,6,12,25,42,-17,24
SC Rheindorf,7013,7,4,6,14,18,31,-13,18
FC Salzburg,7014,1,16,6,2,48,16,32,54
SK Sturm Gra,7014,2,11,6,7,30,30,0,39
LASK Linz,7014,3,10,6,8,31,26,5,36
Rapid Vienna,7014,4,8,10,6,34,25,9,34
Vienna,7014,5,7,5,12,25,40,-15,26
SC Rheindorf,7014,6,5,6,13,18,34,-16,21
Mattersburg,7014,7,5,5,14,27,42,-15,20
FC Salzburg,7015,1,14,8,2,43,18,25,50
SK Sturm Gra,7015,2,11,6,7,28,25,3,39
Rapid Vienna,7015,3,7,12,5,34,28,6,33
LASK Linz,7015,4,8,7,9,25,25,0,31
Mattersburg,7015,5,6,7,11,29,39,-10,25
SC Rheindorf,7015,6,6,6,12,18,27,-9,24
Vienna,7015,7,6,6,12,26,41,-15,24
FC Salzburg,7016,1,16,6,2,48,19,29,54
SK Sturm Gra,7016,2,13,3,8,32,28,4,42
LASK Linz,7016,3,9,6,9,29,28,1,33
Rapid Vienna,7016,4,7,9,8,34,30,4,30
Vienna,7016,5,7,5,12,26,40,-14,26
SC Rheindorf,7016,6,6,6,12,20,32,-12,24
Mattersburg,7016,7,6,5,13,31,43,-12,23
FC Salzburg,7017,1,14,6,4,41,18,23,48
SK Sturm Gra,7017,2,12,5,7,31,27,4,41
Rapid Vienna,7017,3,8,10,6,33,26,7,34
LASK Linz,7017,4,9,5,10,28,32,-4,32
Vienna,7017,5,7,5,12,25,39,-14,26
SC Rheindorf,7017,6,6,7,11,21,28,-7,25
Mattersburg,7017,7,6,6,12,34,43,-9,24
FC Salzburg,7018,1,14,7,3,48,21,27,49
SK Sturm Gra,7018,2,13,3,8,36,30,6,42
Rapid Vienna,7018,3,10,9,5,36,26,10,39
LASK Linz,7018,4,9,5,10,28,29,-1,32
Mattersburg,7018,5,6,6,12,30,45,-15,24
Vienna,7018,6,6,6,12,26,41,-15,24
SC Rheindorf,7018,7,5,6,13,18,30,-12,21
FC Salzburg,7019,1,15,6,3,47,21,26,51
SK Sturm Gra,7019,2,13,5,6,37,30,7,44
Rapid Vienna,7019,3,7,11,6,36,32,4,32
LASK Linz,7019,4,7,9,8,28,29,-1,30
Vienna,7019,5,7,5,12,27,41,-14,26
Mattersburg,7019,6,6,6,12,31,42,-11,24
SC Rheindorf,7019,7,5,6,13,19,30,-11,21
FC Salzburg,7020,1,15,6,3,45,20,25,51
SK Sturm Gra,7020,2,14,4,6,36,29,7,46
Rapid Vienna,7020,3,8,10,6,37,28,9,34
LASK Linz,7020,4,9,6,9,30,30,0,33
Vienna,7020,5,7,5,12,27,41,-14,26
SC Rheindorf,7020,6,5,6,13,18,31,-13,21
Mattersburg,7020,7,5,5,14,30,44,-14,20
FC Salzburg,7021,1,16,6,2,48,15,33,54
SK Sturm Gra,7021,2,12,3,9,34,35,-1,39
Rapid Vienna,7021,3,8,10,6,32,28,4,34
LASK Linz,7021,4,8,6,10,28,28,0,30
Vienna,7021,5,7,5,12,25,42,-17,26
SC Rheindorf,7021,6,6,7,11,22,29,-7,25
Mattersburg,7021,7,5,7,12,30,42,-12,22
FC Salzburg,7022,1,14,6,4,42,19,23,48
SK Sturm Gra,7022,2,12,5,7,32,27,5,41
Rapid Vienna,7022,3,10,9,5,37,27,10,39
LASK Linz,7022,4,7,8,9,24,27,-3,29
Mattersburg,7022,5,7,6,11,32,41,-9,27
Vienna,7022,6,7,5,12,25,39,-14,26
SC Rheindorf,7022,7,4,7,13,19,31,-12,19
FC Salzburg,7023,1,15,6,3,50,21,29,51
SK Sturm Gra,7023,2,13,3,8,34,32,2,42
Rapid Vienna,7023,3,7,10,7,34,33,1,31
LASK Linz,7023,4,8,7,9,27,30,-3,31
Vienna,7023,5,8,5,11,26,38,-12,29
SC Rheindorf,7023,6,7,5,12,24,27,-3,26
Mattersburg,7023,7,5,6,13,31,45,-14,21
FC Salzburg,7024,1,16,6,2,53,19,34,54
SK Sturm Gra,7024,2,13,3,8,33,28,5,42
Rapid Vienna,7024,3,7,11,6,33,27,6,32
Mattersburg,7024,4,8,5,11,31,43,-12,29
LASK Linz,7024,5,7,6,11,25,30,-5,27
SC Rheindorf,7024,6,6,6,12,18,27,-9,24
Vienna,7024,7,6,5,13,26,45,-19,23
FC Salzburg,7025,1,16,6,2,50,17,33,54
SK Sturm Gra,7025,2,12,4,8,34,33,1,40
Rapid Vienna,7025,3,8,10,6,35,28,7,34
LASK Linz,7025,4,8,6,10,27,31,-4,30
Mattersburg,7025,5,7,5,12,31,41,-10,26
Vienna,7025,6,7,5,12,25,39,-14,26
SC Rheindorf,7025,7,5,6,13,19,32,-13,21
FC Salzburg,7026,1,14,8,2,46,20,26,50
SK Sturm Gra,7026,2,13,4,7,33,26,7,43
Rapid Vienna,7026,3,8,11,5,37,30,7,35
LASK Linz,7026,4,7,7,10,24,28,-4,28
Vienna,7026,5,7,6,11,27,39,-12,27
SC Rheindorf,7026,6,5,7,12,18,28,-10,22
Mattersburg,7026,7,5,7,12,31,45,-14,22
FC Salzburg,7027,1,15,7,2,48,16,32,52
SK Sturm Gra,7027,2,12,6,6,32,27,5,42
Rapid Vienna,7027,3,8,11,5,36,29,7,35
LASK Linz,7027,4,9,7,8,27,26,1,34
Mattersburg,7027,5,7,5,12,29,41,-12,26
Vienna,7027,6,6,5,13,23,41,-18,23
SC Rheindorf,7027,7,4,5,15,15,30,-15,17
FC Salzburg,7028,1,15,7,2,53,18,35,52
SK Sturm Gra,7028,2,12,4,8,33,33,0,40
Rapid Vienna,7028,3,9,10,5,37,31,6,37
LASK Linz,7028,4,9,7,8,31,28,3,34
Vienna,7028,5,7,6,11,26,38,-12,27
Mattersburg,7028,6,6,5,13,32,46,-14,23
SC Rheindorf,7028,7,4,5,15,16,34,-18,17
FC Salzburg,7029,1,14,6,4,45,19,26,48
SK Sturm Gra,7029,2,14,3,7,36,28,8,45
Rapid Vienna,7029,3,9,9,6,40,29,11,36
LASK Linz,7029,4,9,5,10,27,34,-7,32
Mattersburg,7029,5,7,5,12,32,44,-12,26
SC Rheindorf,7029,6,6,5,13,22,31,-9,23
Vienna,7029,7,6,5,13,24,41,-17,23
FC Salzburg,7030,1,14,8,2,42,16,26,50
SK Sturm Gra,7030,2,12,5,7,32,26,6,41
Rapid Vienna,7030,3,8,9,7,34,30,4,33
LASK Linz,7030,4,8,6,10,26,28,-2,30
Mattersburg,7030,5,7,7,10,32,40,-8,28
SC Rheindorf,7030,6,6,6,12,22,32,-10,24
Vienna,7030,7,6,5,13,25,41,-16,23
FC Salzburg,7031,1,14,8,2,43,17,26,50
SK Sturm Gra,7031,2,12,4,8,30,28,2,40
Rapid Vienna,7031,3,8,10,6,34,27,7,34
LASK Linz,7031,4,8,7,9,25,26,-1,31
Mattersburg,7031,5,7,7,10,32,40,-8,28
Vienna,7031,6,6,6,12,26,41,-15,24
SC Rheindorf,7031,7,5,6,13,21,32,-11,21
FC Salzburg,7032,1,15,6,3,46,18,28,51
SK Sturm Gra,7032,2,13,3,8,34,30,4,42
Rapid Vienna,7032,3,8,9,7,38,32,6,33
LASK Linz,7032,4,9,6,9,29,29,0,33
Mattersburg,7032,5,7,6,11,33,42,-9,27
SC Rheindorf,7032,6,6,5,13,23,34,-11,23
Vienna,7032,7,6,5,13,24,42,-18,23
FC Salzburg,7033,1,14,8,2,47,21,26,50
Rapid Vienna,7033,2,9,11,4,40,27,13,38
SK Sturm Gra,7033,3,11,5,8,32,30,2,38
LASK Linz,7033,4,8,6,10,24,27,-3,30
Mattersburg,7033,5,8,5,11,34,41,-7,29
Vienna,7033,6,6,5,13,24,41,-17,23
SC Rheindorf,7033,7,5,6,13,18,32,-14,21
FC Salzburg,7034,1,15,7,2,48,18,30,52
SK Sturm Gra,7034,2,12,5,7,37,32,5,41
Rapid Vienna,7034,3,9,10,5,40,32,8,37
LASK Linz,7034,4,9,6,9,33,31,2,33
Vienna,7034,5,7,5,12,25,42,-17,26
Mattersburg,7034,6,5,6,13,28,41,-13,21
SC Rheindorf,7034,7,4,7,13,17,32,-15,19
FC Salzburg,7035,1,14,6,4,46,20,26,48
SK Sturm Gra,7035,2,13,5,6,38,30,8,44
Rapid Vienna,7035,3,9,10,5,40,34,6,37
LASK Linz,7035,4,8,5,11,27,32,-5,29
Mattersburg,7035,5,7,5,12,30,42,-12,26
SC Rheindorf,7035,6,6,6,12,25,30,-5,24
Vienna,7035,7,6,5,13,23,41,-18,23
FC Salzburg,7036,1,15,7,2,47,17,30,52
SK Sturm Gra,7036,2,13,4,7,33,27,6,43
Rapid Vienna,7036,3,8,9,7,34,30,4,33
LASK Linz,7036,4,8,6,10,28,32,-4,30
Mattersburg,7036,5,7,7,10,31,38,-7,28
Vienna,7036,6,6,5,13,24,42,-18,23
SC Rheindorf,7036,7,4,8,12,18,29,-11,20
FC Salzburg,7037,1,14,7,3,45,21,24,49
SK Sturm Gra,7037,2,13,4,7,32,27,5,43
LASK Linz,7037,3,10,5,9,27,26,1,35
Rapid Vienna,7037,4,8,9,7,33,27,6,33
Vienna,7037,5,6,7,11,24,38,-14,25
Mattersburg,7037,6,6,6,12,31,40,-9,24
SC Rheindorf,7037,7,5,6,13,16,29,-13,21
FC Salzburg,7038,1,15,6,3,45,17,28,51
SK Sturm Gra,7038,2,13,4,7,32,26,6,43
Rapid Vienna,7038,3,10,9,5,36,26,10,39
LASK Linz,7038,4,7,6,11,23,28,-5,27
Vienna,7038,5,7,5,12,27,39,-12,26
Mattersburg,7038,6,7,5,12,31,44,-13,26
SC Rheindorf,7038,7,5,5,14,18,32,-14,20
FC Salzburg,7039,1,14,8,2,48,19,29,50
SK Sturm Gra,7039,2,12,6,6,31,26,5,42
LASK Linz,7039,3,10,6,8,29,26,3,36
Rapid Vienna,7039,4,7,9,8,35,32,3,30
Mattersburg,7039,5,7,5,12,32,45,-13,26
Vienna,7039,6,6,6,12,26,41,-15,24
SC Rheindorf,7039,7,5,6,13,18,30,-12,21
FC Salzburg,7040,1,14,8,2,48,22,26,50
SK Sturm Gra,7040,2,12,6,6,34,29,5,42
LASK Linz,7040,3,10,5,9,28,26,2,35
Rapid Vienna,7040,4,7,11,6,34,29,5,32
Vienna,7040,5,6,6,12,25,41,-16,24
Mattersburg,7040,6,5,8,11,31,42,-11,23
SC Rheindorf,7040,7,4,8,12,20,31,-11,20
FC Salzburg,7041,1,13,7,4,45,21,24,46
SK Sturm Gra,7041,2,12,5,7,32,27,5,41
Rapid Vienna,7041,3,9,10,5,35,27,8,37
LASK Linz,7041,4,8,8,8,29,28,1,32
Vienna,7041,5,7,6,11,28,40,-12,27
Mattersburg,7041,6,6,7,11,32,45,-13,25
SC Rheindorf,7041,7,5,5,14,20,33,-13,20
FC Salzburg,7042,1,13,7,4,42,21,21,46
SK Sturm Gra,7042,2,12,4,8,30,26,4,40
Rapid Vienna,7042,3,10,9,5,39,27,12,39
LASK Linz,7042,4,9,7,8,30,29,1,34
Mattersburg,7042,5,6,7,11,31,41,-10,25
Vienna,7042,6,6,6,12,24,39,-15,24
SC Rheindorf,7042,7,4,8,12,15,28,-13,20
FC Salzburg,7043,1,14,8,2,49,21,28,50
SK Sturm Gra,7043,2,12,5,7,36,31,5,41
Rapid Vienna,7043,3,9,11,4,38,28,10,38
LASK Linz,7043,4,9,6,9,30,28,2,33
Vienna,7043,5,7,6,11,27,39,-12,27
Mattersburg,7043,6,6,5,13,30,47,-17,23
SC Rheindorf,7043,7,4,5,15,19,35,-16,17
FC Salzburg,7044,1,14,6,4,49,23,26,48
SK Sturm Gra,7044,2,12,3,9,35,36,-1,39
Rapid Vienna,7044,3,9,9,6,37,30,7,36
LASK Linz,7044,4,10,6,8,31,27,4,36
Vienna,7044,5,8,5,11,28,38,-10,29
SC Rheindorf,7044,6,6,6,12,20,28,-8,24
Mattersburg,7044,7,5,5,14,27,45,-18,20
FC Salzburg,7045,1,15,6,3,44,18,26,51
SK Sturm Gra,7045,2,13,4,7,30,29,1,43
Rapid Vienna,7045,3,8,9,7,37,29,8,33
LASK Linz,7045,4,8,7,9,26,26,0,31
Vienna,7045,5,7,5,12,29,40,-11,26
SC Rheindorf,7045,6,6,6,12,19,27,-8,24
Mattersburg,7045,7,5,7,12,29,45,-16,22
FC Salzburg,7046,1,15,7,2,46,18,28,52
SK Sturm Gra,7046,2,13,4,7,36,28,8,43
LASK Linz,7046,3,9,6,9,33,28,5,33
Rapid Vienna,7046,4,7,11,6,33,31,2,32
Mattersburg,7046,5,6,6,12,31,44,-13,24
Vienna,7046,6,6,5,13,26,44,-18,23
SC Rheindorf,7046,7,5,7,12,17,29,-12,22
FC Salzburg,7047,1,14,7,3,48,20,28,49
SK Sturm Gra,7047,2,12,5,7,35,32,3,41
Rapid Vienna,7047,3,9,10,5,43,33,10,37
LASK Linz,7047,4,8,6,10,28,31,-3,30
Mattersburg,7047,5,7,6,11,32,41,-9,27
Vienna,7047,6,6,5,13,24,42,-18,23
SC Rheindorf,7047,7,5,7,12,19,30,-11,22
FC Salzburg,7048,1,15,6,3,46,18,28,51
SK Sturm Gra,7048,2,13,4,7,31,27,4,43
LASK Linz,7048,3,9,5,10,30,29,1,32
Rapid Vienna,7048,4,7,10,7,33,32,1,31
Mattersburg,7048,5,8,5,11,33,40,-7,29
Vienna,7048,6,7,5,12,26,40,-14,26
SC Rheindorf,7048,7,4,7,13,16,29,-13,19
FC Salzburg,7049,1,14,7,3,47,19,28,49
SK Sturm Gra,7049,2,13,4,7,32,28,4,43
Rapid Vienna,7049,3,8,9,7,34,29,5,33
LASK Linz,7049,4,9,6,9,29,29,0,33
Vienna,7049,5,8,5,11,26,38,-12,29
Mattersburg,7049,6,5,7,12,28,40,-12,22
SC Rheindorf,7049,7,5,6,13,17,30,-13,21
FC Salzburg,7050,1,15,7,2,46,18,28,52
SK Sturm Gra,7050,2,13,4,7,34,28,6,43
Rapid Vienna,7050,3,8,10,6,37,30,7,34
LASK Linz,7050,4,8,6,10,28,30,-2,30
Vienna,7050,5,7,5,12,29,40,-11,26
Mattersburg,7050,6,6,6,12,31,45,-14,24
SC Rheindorf,7050,7,5,6,13,16,30,-14,21
FC Salzburg,7051,1,15,7,2,48,17,31,52
SK Sturm Gra,7051,2,12,5,7,31,28,3,41
Rapid Vienna,7051,3,9,9,6,35,27,8,36
LASK Linz,7051,4,8,6,10,27,28,-1,30
SC Rheindorf,7051,5,6,6,12,19,30,-11,24
Vienna,7051,6,6,6,12,25,43,-18,24
Mattersburg,7051,7,5,7,12,30,42,-12,22
FC Salzburg,7052,1,15,7,2,45,18,27,52
SK Sturm Gra,7052,2,13,4,7,35,29,6,43
Rapid Vienna,7052,3,8,12,4,39,29,10,36
LASK Linz,7052,4,8,5,11,30,35,-5,29
Mattersburg,7052,5,7,5,12,32,42,-10,26
Vienna,7052,6,7,5,12,25,38,-13,26
SC Rheindorf,7052,7,4,6,14,18,33,-15,18
FC Salzburg,7053,1,16,6,2,46,17,29,54
SK Sturm Gra,7053,2,13,3,8,35,29,6,42
Rapid Vienna,7053,3,7,11,6,34,31,3,32
LASK Linz,7053,4,8,8,8,26,26,0,32
Vienna,7053,5,6,6,12,26,41,-15,24
SC Rheindorf,7053,6,5,7,12,19,30,-11,22
Mattersburg,7053,7,5,7,12,32,44,-12,22
FC Salzburg,7054,1,15,6,3,45,18,27,51
SK Sturm Gra,7054,2,13,4,7,32,28,4,43
Rapid Vienna,7054,3,9,9,6,36,29,7,36
LASK Linz,7054,4,9,7,8,32,30,2,34
Vienna,7054,5,7,5,12,26,41,-15,26
Mattersburg,7054,6,5,7,12,32,44,-12,22
SC Rheindorf,7054,7,4,6,14,18,31,-13,18
FC Salzburg,7055,1,15,6,3,43,16,27,51
SK Sturm Gra,7055,2,11,5,8,31,30,1,38
Rapid Vienna,7055,3,9,10,5,37,29,8,37
LASK Linz,7055,4,8,7,9,30,29,1,31
Mattersburg,7055,5,7,6,11,35,44,-9,27
SC Rheindorf,7055,6,6,5,13,18,29,-11,23
Vienna,7055,7,6,5,13,26,43,-17,23
FC Salzburg,7056,1,13,6,5,44,22,22,45
SK Sturm Gra,7056,2,11,4,9,30,33,-3,37
Rapid Vienna,7056,3,9,9,6,34,27,7,36
LASK Linz,7056,4,9,6,9,27,26,1,33
Mattersburg,7056,5,8,5,11,33,41,-8,29
Vienna,7056,6,8,5,11,31,39,-8,29
SC Rheindorf,7056,7,5,7,12,19,30,-11,22
FC Salzburg,7057,1,15,7,2,44,18,26,52
SK Sturm Gra,7057,2,12,4,8,33,29,4,40
Rapid Vienna,7057,3,10,9,5,35,25,10,39
LASK Linz,7057,4,8,6,10,25,28,-3,30
Mattersburg,7057,5,7,6,11,33,41,-8,27
Vienna,7057,6,6,5,13,25,41,-16,23
SC Rheindorf,7057,7,4,7,13,17,30,-13,19
FC Salzburg,7058,1,13,8,3,43,17,26,47
Rapid Vienna,7058,2,10,9,5,39,27,12,39
SK Sturm Gra,7058,3,11,5,8,31,32,-1,38
LASK Linz,7058,4,8,6,10,24,27,-3,30
SC Rheindorf,7058,5,7,5,12,25,29,-4,26
Vienna,7058,6,6,7,11,24,38,-14,25
Mattersburg,7058,7,6,6,12,29,45,-16,24
FC Salzburg,7059,1,15,6,3,47,21,26,51
SK Sturm Gra,7059,2,14,4,6,35,27,8,46
Rapid Vienna,7059,3,7,11,6,35,29,6,32
LASK Linz,7059,4,7,8,9,24,26,-2,29
Mattersburg,7059,5,7,6,11,31,39,-8,27
Vienna,7059,6,6,5,13,25,43,-18,23
SC Rheindorf,7059,7,4,8,12,19,31,-12,20
FC Salzburg,7060,1,15,7,2,47,18,29,52
SK Sturm Gra,7060,2,12,3,9,30,32,-2,39
LASK Linz,7060,3,11,5,8,33,27,6,38
Rapid Vienna,7060,4,7,10,7,33,29,4,31
Mattersburg,7060,5,7,5,12,32,43,-11,26
Vienna,7060,6,6,6,12,25,40,-15,24
SC Rheindorf,7060,7,5,6,13,17,28,-11,21
FC Salzburg,7061,1,14,7,3,45,22,23,49
SK Sturm Gra,7061,2,12,5,7,33,27,6,41
Rapid Vienna,7061,3,9,10,5,37,24,13,37
LASK Linz,7061,4,8,7,9,26,30,-4,31
Vienna,7061,5,6,6,12,25,40,-15,24
Mattersburg,7061,6,5,8,11,31,44,-13,23
SC Rheindorf,7061,7,4,9,11,18,28,-10,21
FC Salzburg,7062,1,14,6,4,42,19,23,48
SK Sturm Gra,7062,2,14,4,6,35,26,9,46
Rapid Vienna,7062,3,8,9,7,33,28,5,33
LASK Linz,7062,4,9,5,10,29,31,-2,32
Vienna,7062,5,8,5,11,27,39,-12,29
Mattersburg,7062,6,6,6,12,31,42,-11,24
SC Rheindorf,7062,7,4,7,13,16,28,-12,19
FC Salzburg,7063,1,13,8,3,43,19,24,47
SK Sturm Gra,7063,2,12,6,6,32,27,5,42
Rapid Vienna,7063,3,9,11,4,37,27,10,38
LASK Linz,7063,4,9,5,10,28,27,1,32
Vienna,7063,5,8,5,11,28,38,-10,29
Mattersburg,7063,6,6,5,13,32,46,-14,23
SC Rheindorf,7063,7,4,6,14,17,33,-16,18
FC Salzburg,7064,1,15,6,3,47,17,30,51
SK Sturm Gra,7064,2,12,5,7,33,27,6,41
Rapid Vienna,7064,3,10,9,5,36,26,10,39
LASK Linz,7064,4,7,8,9,24,27,-3,29
Mattersburg,7064,5,6,7,11,30,43,-13,25
Vienna,7064,6,6,5,13,24,42,-18,23
SC Rheindorf,7064,7,4,8,12,17,29,-12,20
FC Salzburg,7065,1,14,8,2,42,17,25,50
SK Sturm Gra,7065,2,13,4,7,34,31,3,43
Rapid Vienna,7065,3,8,10,6,34,30,4,34
LASK Linz,7065,4,9,5,10,29,29,0,32
Vienna,7065,5,7,5,12,25,38,-13,26
SC Rheindorf,7065,6,6,5,13,24,30,-6,23
Mattersburg,7065,7,6,5,13,29,42,-13,23
FC Salzburg,7066,1,14,7,3,46,21,25,49
SK Sturm Gra,7066,2,14,3,7,36,27,9,45
Rapid Vienna,7066,3,9,9,6,34,27,7,36
LASK Linz,7066,4,8,5,11,25,32,-7,29
Mattersburg,7066,5,7,7,10,34,39,-5,28
Vienna,7066,6,6,5,13,27,45,-18,23
SC Rheindorf,7066,7,5,6,13,18,29,-11,21
FC Salzburg,7067,1,13,9,2,43,18,25,48
SK Sturm Gra,7067,2,11,5,8,29,27,2,38
Rapid Vienna,7067,3,9,10,5,36,28,8,37
LASK Linz,7067,4,8,8,8,28,27,1,32
Mattersburg,7067,5,6,7,11,30,41,-11,25
Vienna,7067,6,6,7,11,25,39,-14,25
SC Rheindorf,7067,7,5,6,13,19,30,-11,21
FC Salzburg,7068,1,13,8,3,44,20,24,47
SK Sturm Gra,7068,2,12,6,6,32,26,6,42
Rapid Vienna,7068,3,9,9,6,35,29,6,36
LASK Linz,7068,4,8,7,9,29,30,-1,31
Vienna,7068,5,6,7,11,25,39,-14,25
SC Rheindorf,7068,6,6,6,12,21,28,-7,24
Mattersburg,7068,7,5,7,12,31,45,-14,22
FC Salzburg,7069,1,15,7,2,45,17,28,52
SK Sturm Gra,7069,2,12,4,8,32,29,3,40
LASK Linz,7069,3,9,6,9,29,30,-1,33
Rapid Vienna,7069,4,7,11,6,33,28,5,32
SC Rheindorf,7069,5,7,6,11,20,26,-6,27
Vienna,7069,6,7,5,12,25,38,-13,26
Mattersburg,7069,7,5,5,14,27,43,-16,20
FC Salzburg,7070,1,15,7,2,45,17,28,52
Rapid Vienna,7070,2,9,10,5,37,29,8,37
SK Sturm Gra,7070,3,11,3,10,31,33,-2,36
LASK Linz,7070,4,9,6,9,27,27,0,33
Vienna,7070,5,7,5,12,25,38,-13,26
Mattersburg,7070,6,6,6,12,29,41,-12,24
SC Rheindorf,7070,7,5,7,12,20,29,-9,22
FC Salzburg,7071,1,13,8,3,44,20,24,47
SK Sturm Gra,7071,2,13,3,8,32,29,3,42
Rapid Vienna,7071,3,8,10,6,35,29,6,34
LASK Linz,7071,4,9,5,10,30,31,-1,32
SC Rheindorf,7071,5,7,5,12,22,29,-7,26
Vienna,7071,6,7,5,12,28,41,-13,26
Mattersburg,7071,7,6,6,12,31,43,-12,24
FC Salzburg,7072,1,14,8,2,47,17,30,50
SK Sturm Gra,7072,2,14,3,7,33,29,4,45
Rapid Vienna,7072,3,8,11,5,34,26,8,35
LASK Linz,7072,4,8,6,10,31,32,-1,30
Mattersburg,7072,5,7,5,12,32,43,-11,26
Vienna,7072,6,6,6,12,25,40,-15,24
SC Rheindorf,7072,7,4,7,13,18,33,-15,19
FC Salzburg,7073,1,15,6,3,46,20,26,51
SK Sturm Gra,7073,2,12,3,9,29,29,0,39
Rapid Vienna,7073,3,8,10,6,35,29,6,34
LASK Linz,7073,4,8,5,11,24,30,-6,29
Mattersburg,7073,5,7,6,11,32,43,-11,27
Vienna,7073,6,7,5,12,30,40,-10,26
SC Rheindorf,7073,7,6,7,11,22,27,-5,25
FC Salzburg,7074,1,14,7,3,41,18,23,49
SK Sturm Gra,7074,2,11,5,8,30,28,2,38
Rapid Vienna,7074,3,8,12,4,36,26,10,36
LASK Linz,7074,4,8,8,8,27,27,0,32
Mattersburg,7074,5,7,7,10,33,39,-6,28
Vienna,7074,6,6,5,13,23,40,-17,23
SC Rheindorf,7074,7,4,8,12,17,29,-12,20
FC Salzburg,7075,1,13,6,5,40,19,21,45
SK Sturm Gra,7075,2,12,4,8,33,29,4,40
LASK Linz,7075,3,10,5,9,32,28,4,35
Rapid Vienna,7075,4,8,10,6,34,30,4,34
Mattersburg,7075,5,7,7,10,34,41,-7,28
Vienna,7075,6,7,6,11,26,39,-13,27
SC Rheindorf,7075,7,5,6,13,19,32,-13,21
FC Salzburg,7076,1,15,6,3,42,17,25,51
SK Sturm Gra,7076,2,12,4,8,29,28,1,40
Rapid Vienna,7076,3,9,10,5,37,26,11,37
LASK Linz,7076,4,8,7,9,29,30,-1,31
Mattersburg,7076,5,7,6,11,32,39,-7,27
Vienna,7076,6,6,5,13,24,40,-16,23
SC Rheindorf,7076,7,4,8,12,17,30,-13,20
FC Salzburg,7077,1,15,6,3,46,18,28,51
SK Sturm Gra,7077,2,12,3,9,31,31,0,39
Rapid Vienna,7077,3,9,9,6,38,30,8,36
LASK Linz,7077,4,9,5,10,30,28,2,32
Vienna,7077,5,8,5,11,27,39,-12,29
Mattersburg,7077,6,7,5,12,30,42,-12,26
SC Rheindorf,7077,7,5,5,14,18,32,-14,20
FC Salzburg,7078,1,15,7,2,51,19,32,52
SK Sturm Gra,7078,2,11,4,9,29,33,-4,37
LASK Linz,7078,3,10,6,8,30,26,4,36
Rapid Vienna,7078,4,8,10,6,35,26,9,34
Mattersburg,7078,5,7,5,12,31,43,-12,26
Vienna,7078,6,6,5,13,23,44,-21,23
SC Rheindorf,7078,7,5,7,12,19,27,-8,22
FC Salzburg,7079,1,14,8,2,46,18,28,50
SK Sturm Gra,7079,2,14,3,7,36,28,8,45
Rapid Vienna,7079,3,7,11,6,34,29,5,32
LASK Linz,7079,4,9,5,10,29,30,-1,32
Vienna,7079,5,7,5,12,28,45,-17,26
SC Rheindorf,7079,6,5,7,12,19,29,-10,22
Mattersburg,7079,7,5,7,12,30,43,-13,22
FC Salzburg,7080,1,14,7,3,46,21,25,49
SK Sturm Gra,7080,2,13,3,8,34,31,3,42
Rapid Vienna,7080,3,8,10,6,37,30,7,34
LASK Linz,7080,4,8,6,10,26,28,-2,30
Vienna,7080,5,7,6,11,27,40,-13,27
Mattersburg,7080,6,6,7,11,30,40,-10,25
SC Rheindorf,7080,7,6,5,13,20,30,-10,23
FC Salzburg,7081,1,15,7,2,41,15,26,52
Rapid Vienna,7081,2,9,11,4,35,24,11,38
SK Sturm Gra,7081,3,11,3,10,28,30,-2,36
LASK Linz,7081,4,8,6,10,25,28,-3,30
Mattersburg,7081,5,7,6,11,29,37,-8,27
SC Rheindorf,7081,6,6,6,12,18,26,-8,24
Vienna,7081,7,6,5,13,23,39,-16,23
FC Salzburg,7082,1,15,6,3,43,18,25,51
SK Sturm Gra,7082,2,14,3,7,36,28,8,45
Rapid Vienna,7082,3,7,9,8,34,31,3,30
LASK Linz,7082,4,8,5,11,27,32,-5,29
SC Rheindorf,7082,5,8,5,11,22,27,-5,29
Mattersburg,7082,6,7,5,12,30,40,-10,26
Vienna,7082,7,6,5,13,24,40,-16,23
FC Salzburg,7083,1,16,6,2,50,16,34,54
SK Sturm Gra,7083,2,11,5,8,30,32,-2,38
Rapid Vienna,7083,3,8,10,6,34,30,4,34
LASK Linz,7083,4,9,7,8,28,24,4,34
Vienna,7083,5,7,5,12,26,40,-14,26
Mattersburg,7083,6,6,5,13,29,44,-15,23
SC Rheindorf,7083,7,5,6,13,18,29,-11,21
FC Salzburg,7084,1,14,7,3,41,18,23,49
SK Sturm Gra,7084,2,11,5,8,31,29,2,38
Rapid Vienna,7084,3,8,10,6,34,27,7,34
LASK Linz,7084,4,8,8,8,29,26,3,32
Mattersburg,7084,5,7,6,11,31,42,-11,27
Vienna,7084,6,7,5,12,25,38,-13,26
SC Rheindorf,7084,7,5,7,12,20,31,-11,22
FC Salzburg,7085,1,15,7,2,43,16,27,52
Rapid Vienna,7085,2,9,10,5,36,25,11,37
SK Sturm Gra,7085,3,11,4,9,31,32,-1,37
LASK Linz,7085,4,9,6,9,30,29,1,33
Vienna,7085,5,7,5,12,25,39,-14,26
Mattersburg,7085,6,6,6,12,30,40,-10,24
SC Rheindorf,7085,7,5,6,13,17,31,-14,21
FC Salzburg,7086,1,16,6,2,51,18,33,54
SK Sturm Gra,7086,2,12,4,8,33,31,2,40
LASK Linz,7086,3,10,6,8,32,26,6,36
Rapid Vienna,7086,4,7,10,7,35,32,3,31
Vienna,7086,5,7,5,12,25,43,-18,26
SC Rheindorf,7086,6,6,6,12,22,32,-10,24
Mattersburg,7086,7,5,5,14,29,45,-16,20
FC Salzburg,7087,1,14,8,2,44,19,25,50
SK Sturm Gra,7087,2,13,4,7,34,29,5,43
Rapid Vienna,7087,3,8,11,5,36,28,8,35
LASK Linz,7087,4,9,5,10,27,29,-2,32
Mattersburg,7087,5,7,6,11,34,40,-6,27
Vienna,7087,6,6,7,11,26,40,-14,25
SC Rheindorf,7087,7,4,5,15,17,33,-16,17
FC Salzburg,7088,1,16,6,2,50,17,33,54
SK Sturm Gra,7088,2,14,3,7,35,30,5,45
Rapid Vienna,7088,3,8,10,6,36,28,8,34
LASK Linz,7088,4,9,6,9,28,28,0,33
Vienna,7088,5,6,6,12,27,43,-16,24
Mattersburg,7088,6,5,7,12,29,45,-16,22
SC Rheindorf,7088,7,4,6,14,16,30,-14,18
FC Salzburg,7089,1,14,7,3,46,19,27,49
SK Sturm Gra,7089,2,12,6,6,32,27,5,42
Rapid Vienna,7089,3,8,10,6,36,30,6,34
LASK Linz,7089,4,7,7,10,25,30,-5,28
Vienna,7089,5,7,5,12,26,39,-13,26
SC Rheindorf,7089,6,6,7,11,20,28,-8,25
Mattersburg,7089,7,6,6,12,29,41,-12,24
FC Salzburg,7090,1,14,6,4,44,21,23,48
SK Sturm Gra,7090,2,13,4,7,33,27,6,43
Rapid Vienna,7090,3,9,10,5,37,27,10,37
LASK Linz,7090,4,8,6,10,27,30,-3,30
Vienna,7090,5,8,5,11,29,39,-10,29
Mattersburg,7090,6,6,6,12,30,44,-14,24
SC Rheindorf,7090,7,5,5,14,17,29,-12,20
FC Salzburg,7091,1,16,6,2,51,18,33,54
SK Sturm Gra,7091,2,13,3,8,31,29,2,42
Rapid Vienna,7091,3,8,10,6,32,26,6,34
LASK Linz,7091,4,8,5,11,25,28,-3,29
Mattersburg,7091,5,7,5,12,36,41,-5,26
SC Rheindorf,7091,6,6,6,12,19,31,-12,24
Vienna,7091,7,6,5,13,25,46,-21,23
FC Salzburg,7092,1,15,6,3,45,18,27,51
SK Sturm Gra,7092,2,11,4,9,29,29,0,37
Rapid Vienna,7092,3,7,12,5,33,27,6,33
LASK Linz,7092,4,9,6,9,25,25,0,33
Mattersburg,7092,5,7,6,11,31,39,-8,27
Vienna,7092,6,7,5,12,27,42,-15,26
SC Rheindorf,7092,7,5,7,12,18,28,-10,22
FC Salzburg,7093,1,14,8,2,44,17,27,50
Rapid Vienna,7093,2,9,10,5,35,26,9,37
SK Sturm Gra,7093,3,11,4,9,29,31,-2,37
LASK Linz,7093,4,8,6,10,27,28,-1,30
Vienna,7093,5,7,6,11,29,39,-10,27
Mattersburg,7093,6,7,6,11,29,40,-11,27
SC Rheindorf,7093,7,4,8,12,18,30,-12,20
FC Salzburg,7094,1,13,8,3,45,19,26,47
SK Sturm Gra,7094,2,12,4,8,30,28,2,40
LASK Linz,7094,3,11,5,8,33,29,4,38
Rapid Vienna,7094,4,9,9,6,37,28,9,36
Vienna,7094,5,6,7,11,28,42,-14,25
SC Rheindorf,7094,6,6,5,13,22,33,-11,23
Mattersburg,7094,7,5,6,13,31,47,-16,21
FC Salzburg,7095,1,14,7,3,43,19,24,49
SK Sturm Gra,7095,2,12,5,7,31,28,3,41
Rapid Vienna,7095,3,7,10,7,33,29,4,31
LASK Linz,7095,4,7,9,8,29,30,-1,30
Vienna,7095,5,8,5,11,30,38,-8,29
SC Rheindorf,7095,6,7,6,11,25,30,-5,27
Mattersburg,7095,7,5,6,13,32,49,-17,21
FC Salzburg,7096,1,12,8,4,41,20,21,44
SK Sturm Gra,7096,2,12,5,7,35,27,8,41
Rapid Vienna,7096,3,10,10,4,35,24,11,40
Mattersburg,7096,4,7,7,10,34,37,-3,28
LASK Linz,7096,5,7,6,11,24,33,-9,27
Vienna,7096,6,6,7,11,25,39,-14,25
SC Rheindorf,7096,7,6,5,13,18,32,-14,23
FC Salzburg,7097,1,16,6,2,45,18,27,54
SK Sturm Gra,7097,2,11,4,9,30,31,-1,37
Rapid Vienna,7097,3,8,11,5,36,25,11,35
LASK Linz,7097,4,8,5,11,25,31,-6,29
Mattersburg,7097,5,7,6,11,32,41,-9,27
SC Rheindorf,7097,6,6,6,12,20,27,-7,24
Vienna,7097,7,6,6,12,27,42,-15,24
FC Salzburg,7098,1,14,7,3,47,17,30,49
SK Sturm Gra,7098,2,12,5,7,30,26,4,41
Rapid Vienna,7098,3,9,9,6,36,28,8,36
LASK Linz,7098,4,9,5,10,29,32,-3,32
SC Rheindorf,7098,5,6,6,12,20,29,-9,24
Mattersburg,7098,6,6,6,12,32,44,-12,24
Vienna,7098,7,6,6,12,24,42,-18,24
FC Salzburg,7099,1,13,7,4,41,19,22,46
SK Sturm Gra,7099,2,14,3,7,32,25,7,45
Rapid Vienna,7099,3,9,9,6,34,28,6,36
LASK Linz,7099,4,8,5,11,27,29,-2,29
SC Rheindorf,7099,5,7,5,12,19,26,-7,26
Mattersburg,7099,6,6,7,11,30,40,-10,25
Vienna,7099,7,6,6,12,24,40,-16,24
FC Salzburg,7100,1,15,7,2,45,17,28,52
SK Sturm Gra,7100,2,12,4,8,32,30,2,40
Rapid Vienna,7100,3,8,10,6,38,34,4,34
LASK Linz,7100,4,8,6,10,27,29,-2,30
Vienna,7100,5,7,5,12,25,39,-14,26
SC Rheindorf,7100,6,6,6,12,20,27,-7,24
Mattersburg,7100,7,6,6,12,29,40,-11,24
FC Salzburg,7101,1,16,6,2,48,16,32,54
LASK Linz,7101,2,11,5,8,32,26,6,38
SK Sturm Gra,7101,3,11,3,10,30,35,-5,36
Rapid Vienna,7101,4,8,9,7,37,29,8,33
Vienna,7101,5,7,5,12,25,39,-14,26
SC Rheindorf,7101,6,6,5,13,18,31,-13,23
Mattersburg,7101,7,6,5,13,27,41,-14,23
SK Sturm Gra,7102,1,15,3,6,34,25,9,48
FC Salzburg,7102,2,13,8,3,47,22,25,47
LASK Linz,7102,3,9,6,9,29,26,3,33
Rapid Vienna,7102,4,7,9,8,33,32,1,30
Vienna,7102,5,6,7,11,27,41,-14,25
Mattersburg,7102,6,5,8,11,30,44,-14,23
SC Rheindorf,7102,7,5,7,12,19,29,-10,22
FC Salzburg,7103,1,14,6,4,45,24,21,48
Rapid Vienna,7103,2,10,10,4,38,25,13,40
SK Sturm Gra,7103,3,12,3,9,32,32,0,39
LASK Linz,7103,4,7,7,10,28,32,-4,28
Mattersburg,7103,5,7,5,12,31,40,-9,26
Vienna,7103,6,7,5,12,27,39,-12,26
SC Rheindorf,7103,7,6,6,12,20,29,-9,24
FC Salzburg,7104,1,15,6,3,48,18,30,51
SK Sturm Gra,7104,2,12,5,7,32,28,4,41
Rapid Vienna,7104,3,8,10,6,33,26,7,34
LASK Linz,7104,4,9,6,9,30,29,1,33
Mattersburg,7104,5,7,6,11,34,45,-11,27
Vienna,7104,6,6,6,12,25,42,-17,24
SC Rheindorf,7104,7,4,7,13,16,30,-14,19
FC Salzburg,7105,1,15,7,2,52,20,32,52
SK Sturm Gra,7105,2,12,4,8,32,30,2,40
Rapid Vienna,7105,3,8,11,5,34,26,8,35
LASK Linz,7105,4,9,5,10,27,27,0,32
SC Rheindorf,7105,5,7,5,12,21,29,-8,26
Vienna,7105,6,7,5,12,26,43,-17,26
Mattersburg,7105,7,5,5,14,31,48,-17,20
FC Salzburg,7106,1,13,7,4,45,21,24,46
SK Sturm Gra,7106,2,12,5,7,33,31,2,41
Rapid Vienna,7106,3,7,11,6,32,29,3,32
LASK Linz,7106,4,8,7,9,28,29,-1,31
Vienna,7106,5,8,5,11,29,37,-8,29
Mattersburg,7106,6,6,7,11,30,43,-13,25
SC Rheindorf,7106,7,5,8,11,19,26,-7,23
FC Salzburg,7107,1,14,6,4,45,23,22,48
SK Sturm Gra,7107,2,13,4,7,36,30,6,43
Rapid Vienna,7107,3,9,10,5,38,29,9,37
LASK Linz,7107,4,8,6,10,30,33,-3,30
Vienna,7107,5,7,5,12,27,41,-14,26
Mattersburg,7107,6,6,6,12,33,43,-10,24
SC Rheindorf,7107,7,5,7,12,22,32,-10,22
FC Salzburg,7108,1,14,6,4,43,20,23,48
SK Sturm Gra,7108,2,12,5,7,32,30,2,41
LASK Linz,7108,3,9,7,8,29,28,1,34
Rapid Vienna,7108,4,8,9,7,35,29,6,33
Vienna,7108,5,7,6,11,28,40,-12,27
Mattersburg,7108,6,6,6,12,34,42,-8,24
SC Rheindorf,7108,7,5,7,12,20,32,-12,22
FC Salzburg,7109,1,15,7,2,46,18,28,52
SK Sturm Gra,7109,2,13,4,7,34,26,8,43
Rapid Vienna,7109,3,9,10,5,37,29,8,37
LASK Linz,7109,4,7,6,11,26,31,-5,27
Mattersburg,7109,5,7,5,12,30,39,-9,26
Vienna,7109,6,7,5,12,27,43,-16,26
SC Rheindorf,7109,7,4,7,13,15,29,-14,19
FC Salzburg,7110,1,14,7,3,46,20,26,49
SK Sturm Gra,7110,2,13,4,7,35,30,5,43
LASK Linz,7110,3,10,6,8,33,29,4,36
Rapid Vienna,7110,4,7,10,7,35,31,4,31
Vienna,7110,5,7,5,12,26,41,-15,26
SC Rheindorf,7110,6,6,6,12,20,30,-10,24
Mattersburg,7110,7,5,6,13,31,45,-14,21
FC Salzburg,7111,1,15,7,2,52,18,34,52
SK Sturm Gra,7111,2,12,5,7,32,31,1,41
Rapid Vienna,7111,3,8,10,6,38,31,7,34
LASK Linz,7111,4,8,7,9,26,27,-1,31
Mattersburg,7111,5,7,5,12,32,42,-10,26
Vienna,7111,6,7,5,12,25,43,-18,26
SC Rheindorf,7111,7,4,7,13,17,30,-13,19
FC Salzburg,7112,1,15,6,3,44,18,26,51
Rapid Vienna,7112,2,11,9,4,41,26,15,42
SK Sturm Gra,7112,3,13,3,8,33,29,4,42
Mattersburg,7112,4,7,6,11,30,40,-10,27
LASK Linz,7112,5,7,5,12,26,32,-6,26
Vienna,7112,6,6,6,12,24,40,-16,24
SC Rheindorf,7112,7,5,5,14,18,31,-13,20
FC Salzburg,7113,1,14,7,3,41,17,24,49
SK Sturm Gra,7113,2,14,3,7,34,27,7,45
Rapid Vienna,7113,3,9,9,6,37,29,8,36
LASK Linz,7113,4,9,5,10,28,31,-3,32
Mattersburg,7113,5,7,5,12,31,40,-9,26
Vienna,7113,6,6,6,12,23,39,-16,24
SC Rheindorf,7113,7,5,5,14,19,30,-11,20
FC Salzburg,7114,1,13,6,5,43,22,21,45
SK Sturm Gra,7114,2,12,5,7,32,28,4,41
Rapid Vienna,7114,3,9,11,4,39,28,11,38
LASK Linz,7114,4,9,6,9,29,30,-1,33
Vienna,7114,5,7,6,11,25,37,-12,27
Mattersburg,7114,6,6,6,12,29,42,-13,24
SC Rheindorf,7114,7,5,6,13,23,33,-10,21
FC Salzburg,7115,1,14,7,3,44,19,25,49
SK Sturm Gra,7115,2,14,4,6,38,27,11,46
Rapid Vienna,7115,3,7,9,8,33,29,4,30
LASK Linz,7115,4,8,6,10,27,31,-4,30
Mattersburg,7115,5,8,5,11,32,43,-11,29
SC Rheindorf,7115,6,6,6,12,22,30,-8,24
Vienna,7115,7,6,5,13,23,40,-17,23
FC Salzburg,7116,1,12,8,4,42,21,21,44
SK Sturm Gra,7116,2,13,4,7,35,29,6,43
Rapid Vienna,7116,3,9,9,6,36,28,8,36
LASK Linz,7116,4,9,5,10,29,30,-1,32
Vienna,7116,5,7,6,11,25,38,-13,27
Mattersburg,7116,6,6,7,11,30,41,-11,25
SC Rheindorf,7116,7,6,5,13,22,32,-10,23
FC Salzburg,7117,1,15,7,2,46,18,28,52
SK Sturm Gra,7117,2,11,6,7,31,29,2,39
Rapid Vienna,7117,3,7,12,5,36,30,6,33
LASK Linz,7117,4,8,8,8,26,26,0,32
Mattersburg,7117,5,6,6,12,34,46,-12,24
SC Rheindorf,7117,6,5,8,11,21,29,-8,23
Vienna,7117,7,6,5,13,27,43,-16,23
FC Salzburg,7118,1,14,7,3,46,20,26,49
SK Sturm Gra,7118,2,13,5,6,36,27,9,44
Rapid Vienna,7118,3,9,10,5,34,28,6,37
LASK Linz,7118,4,8,5,11,25,31,-6,29
Mattersburg,7118,5,7,6,11,32,39,-7,27
Vienna,7118,6,7,5,12,26,39,-13,26
SC Rheindorf,7118,7,4,6,14,16,31,-15,18
FC Salzburg,7119,1,13,8,3,42,20,22,47
SK Sturm Gra,7119,2,13,4,7,34,27,7,43
Rapid Vienna,7119,3,8,10,6,37,31,6,34
LASK Linz,7119,4,9,6,9,29,30,-1,33
SC Rheindorf,7119,5,6,6,12,21,29,-8,24
Mattersburg,7119,6,6,6,12,31,41,-10,24
Vienna,7119,7,6,6,12,24,40,-16,24
FC Salzburg,7120,1,14,8,2,43,16,27,50
SK Sturm Gra,7120,2,11,5,8,30,29,1,38
Rapid Vienna,7120,3,8,11,5,35,27,8,35
LASK Linz,7120,4,8,6,10,26,29,-3,30
Mattersburg,7120,5,7,7,10,35,39,-4,28
Vienna,7120,6,6,6,12,23,39,-16,24
SC Rheindorf,7120,7,6,5,13,20,33,-13,23
FC Salzburg,7121,1,13,8,3,47,18,29,47
SK Sturm Gra,7121,2,13,5,6,33,26,7,44
Rapid Vienna,7121,3,8,11,5,35,25,10,35
LASK Linz,7121,4,9,7,8,30,26,4,34
Vienna,7121,5,8,5,11,28,37,-9,29
Mattersburg,7121,6,6,5,13,28,49,-21,23
SC Rheindorf,7121,7,4,5,15,17,37,-20,17
FC Salzburg,7122,1,15,7,2,45,16,29,52
SK Sturm Gra,7122,2,12,4,8,32,31,1,40
LASK Linz,7122,3,10,5,9,26,25,1,35
Rapid Vienna,7122,4,8,10,6,33,26,7,34
Mattersburg,7122,5,7,6,11,32,40,-8,27
Vienna,7122,6,6,5,13,24,42,-18,23
SC Rheindorf,7122,7,4,7,13,18,30,-12,19
SK Sturm Gra,7123,1,14,4,6,38,27,11,46
FC Salzburg,7123,2,13,6,5,42,21,21,45
Rapid Vienna,7123,3,9,9,6,40,33,7,36
LASK Linz,7123,4,9,5,10,29,31,-2,32
Mattersburg,7123,5,7,6,11,34,42,-8,27
Vienna,7123,6,7,6,11,27,40,-13,27
SC Rheindorf,7123,7,4,6,14,15,31,-16,18
FC Salzburg,7124,1,15,6,3,43,17,26,51
SK Sturm Gra,7124,2,11,5,8,29,27,2,38
Rapid Vienna,7124,3,9,10,5,38,26,12,37
LASK Linz,7124,4,7,8,9,26,29,-3,29
Vienna,7124,5,8,5,11,28,39,-11,29
Mattersburg,7124,6,6,5,13,32,46,-14,23
SC Rheindorf,7124,7,5,7,12,18,30,-12,22
FC Salzburg,7125,1,14,7,3,42,16,26,49
SK Sturm Gra,7125,2,13,4,7,32,26,6,43
Rapid Vienna,7125,3,7,11,6,33,30,3,32
LASK Linz,7125,4,9,5,10,30,31,-1,32
Vienna,7125,5,7,6,11,26,39,-13,27
Mattersburg,7125,6,7,5,12,31,41,-10,26
SC Rheindorf,7125,7,5,6,13,18,29,-11,21
FC Salzburg,7126,1,13,8,3,43,21,22,47
SK Sturm Gra,7126,2,12,5,7,30,26,4,41
Rapid Vienna,7126,3,7,13,4,37,29,8,34
LASK Linz,7126,4,8,6,10,25,27,-2,30
Vienna,7126,5,8,5,11,29,40,-11,29
SC Rheindorf,7126,6,6,6,12,19,29,-10,24
Mattersburg,7126,7,6,5,13,30,41,-11,23
FC Salzburg,7127,1,14,6,4,45,20,25,48
SK Sturm Gra,7127,2,14,4,6,38,29,9,46
Rapid Vienna,7127,3,9,10,5,36,28,8,37
LASK Linz,7127,4,8,7,9,29,29,0,31
Vienna,7127,5,7,5,12,25,40,-15,26
Mattersburg,7127,6,6,5,13,31,43,-12,23
SC Rheindorf,7127,7,5,5,14,18,33,-15,20
FC Salzburg,7128,1,15,7,2,43,17,26,52
SK Sturm Gra,7128,2,12,5,7,36,30,6,41
Rapid Vienna,7128,3,9,10,5,37,28,9,37
LASK Linz,7128,4,7,7,10,29,32,-3,28
Mattersburg,7128,5,7,7,10,35,41,-6,28
Vienna,7128,6,6,5,13,26,43,-17,23
SC Rheindorf,7128,7,5,5,14,19,34,-15,20
FC Salzburg,7129,1,16,6,2,47,16,31,54
SK Sturm Gra,7129,2,11,5,8,31,30,1,38
Rapid Vienna,7129,3,8,11,5,38,30,8,35
LASK Linz,7129,4,9,6,9,30,29,1,33
Vienna,7129,5,7,5,12,25,39,-14,26
SC Rheindorf,7129,6,5,7,12,22,32,-10,22
Mattersburg,7129,7,5,6,13,28,45,-17,21
FC Salzburg,7130,1,15,7,2,46,20,26,52
SK Sturm Gra,7130,2,13,3,8,34,29,5,42
Rapid Vienna,7130,3,9,10,5,38,29,9,37
LASK Linz,7130,4,9,5,10,29,30,-1,32
Vienna,7130,5,7,5,12,25,39,-14,26
Mattersburg,7130,6,6,6,12,30,41,-11,24
SC Rheindorf,7130,7,4,6,14,16,30,-14,18
FC Salzburg,7131,1,13,8,3,43,20,23,47
SK Sturm Gra,7131,2,14,4,6,37,28,9,46
Rapid Vienna,7131,3,9,10,5,39,29,10,37
LASK Linz,7131,4,9,5,10,27,29,-2,32
Vienna,7131,5,6,6,12,24,39,-15,24
Mattersburg,7131,6,5,7,12,29,44,-15,22
SC Rheindorf,7131,7,5,6,13,19,29,-10,21
FC Salzburg,7132,1,16,6,2,45,16,29,54
SK Sturm Gra,7132,2,12,5,7,31,27,4,41
Rapid Vienna,7132,3,8,10,6,33,28,5,34
LASK Linz,7132,4,8,5,11,28,30,-2,29
Mattersburg,7132,5,7,5,12,30,43,-13,26
SC Rheindorf,7132,6,6,6,12,22,29,-7,24
Vienna,7132,7,6,5,13,25,41,-16,23
FC Salzburg,7133,1,15,7,2,44,15,29,52
SK Sturm Gra,7133,2,12,4,8,30,29,1,40
Rapid Vienna,7133,3,8,10,6,34,31,3,34
LASK Linz,7133,4,9,6,9,31,27,4,33
Vienna,7133,5,7,5,12,24,39,-15,26
Mattersburg,7133,6,6,6,12,31,43,-12,24
SC Rheindorf,7133,7,5,6,13,22,32,-10,21
FC Salzburg,7134,1,15,6,3,48,17,31,51
Rapid Vienna,7134,2,9,11,4,37,27,10,38
SK Sturm Gra,7134,3,11,5,8,30,31,-1,38
LASK Linz,7134,4,8,6,10,28,30,-2,30
Mattersburg,7134,5,7,5,12,33,46,-13,26
Vienna,7134,6,7,5,12,27,41,-14,26
SC Rheindorf,7134,7,4,8,12,20,31,-11,20
FC Salzburg,7135,1,14,8,2,45,18,27,50
SK Sturm Gra,7135,2,12,4,8,30,30,0,40
Rapid Vienna,7135,3,8,10,6,36,28,8,34
LASK Linz,7135,4,8,6,10,28,31,-3,30
Mattersburg,7135,5,7,6,11,32,40,-8,27
SC Rheindorf,7135,6,6,6,12,20,29,-9,24
Vienna,7135,7,6,6,12,24,39,-15,24
FC Salzburg,7136,1,15,6,3,53,20,33,51
SK Sturm Gra,7136,2,12,4,8,30,32,-2,40
Rapid Vienna,7136,3,9,10,5,37,28,9,37
LASK Linz,7136,4,8,7,9,25,26,-1,31
Mattersburg,7136,5,8,5,11,33,43,-10,29
Vienna,7136,6,6,5,13,26,42,-16,23
SC Rheindorf,7136,7,5,5,14,16,29,-13,20
FC Salzburg,7137,1,16,6,2,51,22,29,54
SK Sturm Gra,7137,2,12,3,9,33,33,0,39
LASK Linz,7137,3,8,8,8,25,25,0,32
Rapid Vienna,7137,4,7,10,7,35,31,4,31
SC Rheindorf,7137,5,7,6,11,22,26,-4,27
Vienna,7137,6,6,6,12,24,39,-15,24
Mattersburg,7137,7,5,7,12,29,43,-14,22
FC Salzburg,7138,1,14,7,3,45,18,27,49
SK Sturm Gra,7138,2,13,4,7,35,30,5,43
Rapid Vienna,7138,3,9,10,5,38,30,8,37
LASK Linz,7138,4,8,7,9,28,30,-2,31
Vienna,7138,5,6,6,12,24,39,-15,24
SC Rheindorf,7138,6,6,5,13,21,32,-11,23
Mattersburg,7138,7,6,5,13,31,43,-12,23
FC Salzburg,7139,1,14,7,3,43,19,24,49
SK Sturm Gra,7139,2,13,4,7,34,26,8,43
LASK Linz,7139,3,9,6,9,29,31,-2,33
Rapid Vienna,7139,4,7,11,6,34,28,6,32
Mattersburg,7139,5,7,6,11,31,39,-8,27
Vienna,7139,6,7,5,12,25,40,-15,26
SC Rheindorf,7139,7,4,7,13,19,32,-13,19
FC Salzburg,7140,1,14,7,3,45,18,27,49
SK Sturm Gra,7140,2,12,4,8,34,32,2,40
Rapid Vienna,7140,3,8,11,5,35,27,8,35
LASK Linz,7140,4,8,6,10,26,30,-4,30
SC Rheindorf,7140,5,7,5,12,24,31,-7,26
Vienna,7140,6,6,7,11,26,40,-14,25
Mattersburg,7140,7,6,6,12,32,44,-12,24
FC Salzburg,7141,1,14,6,4,43,19,24,48
SK Sturm Gra,7141,2,12,5,7,33,30,3,41
Rapid Vienna,7141,3,10,10,4,38,26,12,40
LASK Linz,7141,4,7,6,11,25,30,-5,27
Vienna,7141,5,7,6,11,27,39,-12,27
Mattersburg,7141,6,6,7,11,29,40,-11,25
SC Rheindorf,7141,7,5,6,13,18,29,-11,21
FC Salzburg,7142,1,14,8,2,44,17,27,50
SK Sturm Gra,7142,2,12,3,9,32,33,-1,39
Rapid Vienna,7142,3,8,12,4,37,28,9,36
LASK Linz,7142,4,8,6,10,28,30,-2,30
Mattersburg,7142,5,8,6,10,33,40,-7,30
Vienna,7142,6,6,5,13,24,40,-16,23
SC Rheindorf,7142,7,5,6,13,22,32,-10,21
FC Salzburg,7143,1,15,6,3,48,18,30,51
SK Sturm Gra,7143,2,13,3,8,36,34,2,42
Rapid Vienna,7143,3,10,9,5,37,26,11,39
LASK Linz,7143,4,10,5,9,30,29,1,35
Mattersburg,7143,5,7,5,12,31,41,-10,26
Vienna,7143,6,6,5,13,24,41,-17,23
SC Rheindorf,7143,7,4,5,15,17,34,-17,17
FC Salzburg,7144,1,15,7,2,47,18,29,52
SK Sturm Gra,7144,2,12,4,8,33,32,1,40
Rapid Vienna,7144,3,9,10,5,40,29,11,37
LASK Linz,7144,4,8,7,9,26,27,-1,31
Mattersburg,7144,5,6,8,10,31,39,-8,26
Vienna,7144,6,6,5,13,25,42,-17,23
SC Rheindorf,7144,7,4,7,13,20,35,-15,19
FC Salzburg,7145,1,13,7,4,42,21,21,46
SK Sturm Gra,7145,2,13,5,6,32,26,6,44
Rapid Vienna,7145,3,9,10,5,38,28,10,37
Mattersburg,7145,4,7,6,11,33,40,-7,27
LASK Linz,7145,5,7,6,11,26,34,-8,27
Vienna,7145,6,7,6,11,25,37,-12,27
SC Rheindorf,7145,7,5,6,13,22,32,-10,21
FC Salzburg,7146,1,15,6,3,49,19,30,51
SK Sturm Gra,7146,2,14,3,7,32,28,4,45
LASK Linz,7146,3,9,5,10,29,30,-1,32
Rapid Vienna,7146,4,7,10,7,32,28,4,31
Vienna,7146,5,8,5,11,26,38,-12,29
SC Rheindorf,7146,6,6,6,12,19,27,-8,24
Mattersburg,7146,7,5,5,14,30,47,-17,20
FC Salzburg,7147,1,13,8,3,41,18,23,47
SK Sturm Gra,7147,2,13,4,7,33,27,6,43
Rapid Vienna,7147,3,9,10,5,34,24,10,37
LASK Linz,7147,4,7,6,11,25,32,-7,27
Mattersburg,7147,5,7,6,11,31,39,-8,27
Vienna,7147,6,6,7,11,26,40,-14,25
SC Rheindorf,7147,7,6,5,13,20,30,-10,23
FC Salzburg,7148,1,14,8,2,46,20,26,50
SK Sturm Gra,7148,2,14,4,6,37,28,9,46
Rapid Vienna,7148,3,9,10,5,39,28,11,37
LASK Linz,7148,4,7,5,12,26,32,-6,26
Mattersburg,7148,5,7,5,12,31,40,-9,26
SC Rheindorf,7148,6,6,5,13,20,33,-13,23
Vienna,7148,7,6,5,13,24,42,-18,23
FC Salzburg,7149,1,15,6,3,48,20,28,51
SK Sturm Gra,7149,2,13,4,7,34,30,4,43
Rapid Vienna,7149,3,9,9,6,39,30,9,36
LASK Linz,7149,4,8,5,11,26,28,-2,29
Mattersburg,7149,5,7,6,11,30,41,-11,27
Vienna,7149,6,6,6,12,24,39,-15,24
SC Rheindorf,7149,7,5,6,13,18,31,-13,21
FC Salzburg,7150,1,14,7,3,43,19,24,49
SK Sturm Gra,7150,2,13,4,7,37,29,8,43
Rapid Vienna,7150,3,9,11,4,37,26,11,38
LASK Linz,7150,4,7,7,10,26,30,-4,28
Vienna,7150,5,7,5,12,26,40,-14,26
Mattersburg,7150,6,6,6,12,29,41,-12,24
SC Rheindorf,7150,7,5,6,13,18,31,-13,21
FC Salzburg,7151,1,15,7,2,48,20,28,52
SK Sturm Gra,7151,2,14,3,7,35,28,7,45
Rapid Vienna,7151,3,7,12,5,36,29,7,33
LASK Linz,7151,4,8,6,10,28,32,-4,30
Vienna,7151,5,7,5,12,26,41,-15,26
Mattersburg,7151,6,6,6,12,34,44,-10,24
SC Rheindorf,7151,7,4,7,13,17,30,-13,19
FC Salzburg,7152,1,13,9,2,41,16,25,48
SK Sturm Gra,7152,2,13,4,7,36,29,7,43
Rapid Vienna,7152,3,8,11,5,36,27,9,35
LASK Linz,7152,4,9,6,9,28,30,-2,33
Vienna,7152,5,6,6,12,25,40,-15,24
SC Rheindorf,7152,6,6,5,13,21,31,-10,23
Mattersburg,7152,7,6,5,13,28,42,-14,23
FC Salzburg,7153,1,15,6,3,47,19,28,51
SK Sturm Gra,7153,2,11,4,9,30,34,-4,37
Rapid Vienna,7153,3,8,11,5,37,28,9,35
LASK Linz,7153,4,8,8,8,27,25,2,32
SC Rheindorf,7153,5,7,6,11,22,28,-6,27
Vienna,7153,6,7,5,12,25,39,-14,26
Mattersburg,7153,7,5,6,13,29,44,-15,21
FC Salzburg,7154,1,14,8,2,47,19,28,50
SK Sturm Gra,7154,2,12,4,8,33,29,4,40
Rapid Vienna,7154,3,7,12,5,34,27,7,33
LASK Linz,7154,4,7,7,10,26,31,-5,28
Mattersburg,7154,5,7,6,11,35,43,-8,27
Vienna,7154,6,7,5,12,29,45,-16,26
SC Rheindorf,7154,7,6,6,12,23,33,-10,24
FC Salzburg,7155,1,14,6,4,43,19,24,48
SK Sturm Gra,7155,2,13,4,7,32,27,5,43
LASK Linz,7155,3,11,5,8,29,25,4,38
Rapid Vienna,7155,4,7,9,8,33,29,4,30
Vienna,7155,5,8,5,11,25,37,-12,29
Mattersburg,7155,6,6,5,13,35,43,-8,23
SC Rheindorf,7155,7,5,6,13,20,37,-17,21
FC Salzburg,7156,1,13,8,3,44,20,24,47
SK Sturm Gra,7156,2,12,5,7,34,30,4,41
Rapid Vienna,7156,3,9,10,5,38,29,9,37
LASK Linz,7156,4,9,5,10,26,27,-1,32
Mattersburg,7156,5,7,6,11,31,41,-10,27
Vienna,7156,6,6,6,12,26,41,-15,24
SC Rheindorf,7156,7,4,8,12,18,29,-11,20
FC Salzburg,7157,1,14,6,4,44,19,25,48
SK Sturm Gra,7157,2,15,3,6,35,26,9,48
Rapid Vienna,7157,3,8,9,7,34,31,3,33
LASK Linz,7157,4,7,6,11,24,28,-4,27
Vienna,7157,5,7,6,11,26,39,-13,27
Mattersburg,7157,6,6,7,11,31,42,-11,25
SC Rheindorf,7157,7,5,7,12,18,27,-9,22
FC Salzburg,7158,1,13,7,4,46,23,23,46
SK Sturm Gra,7158,2,11,5,8,31,30,1,38
Rapid Vienna,7158,3,9,10,5,39,31,8,37
LASK Linz,7158,4,10,6,8,32,28,4,36
Vienna,7158,5,8,5,11,29,40,-11,29
Mattersburg,7158,6,6,5,13,31,45,-14,23
SC Rheindorf,7158,7,5,6,13,20,31,-11,21
FC Salzburg,7159,1,13,8,3,40,17,23,47
SK Sturm Gra,7159,2,12,5,7,30,27,3,41
Rapid Vienna,7159,3,9,11,4,39,25,14,38
LASK Linz,7159,4,9,7,8,27,25,2,34
Vienna,7159,5,8,5,11,25,37,-12,29
Mattersburg,7159,6,5,6,13,28,42,-14,21
SC Rheindorf,7159,7,4,6,14,18,34,-16,18
FC Salzburg,7160,1,13,7,4,42,21,21,46
SK Sturm Gra,7160,2,13,4,7,34,28,6,43
Rapid Vienna,7160,3,9,10,5,38,28,10,37
Mattersburg,7160,4,7,7,10,30,37,-7,28
LASK Linz,7160,5,7,6,11,26,33,-7,27
Vienna,7160,6,7,5,12,25,39,-14,26
SC Rheindorf,7160,7,5,7,12,17,26,-9,22
FC Salzburg,7161,1,14,7,3,45,17,28,49
SK Sturm Gra,7161,2,12,4,8,34,31,3,40
Rapid Vienna,7161,3,9,11,4,40,27,13,38
LASK Linz,7161,4,9,7,8,28,27,1,34
Vienna,7161,5,7,5,12,26,44,-18,26
Mattersburg,7161,6,5,8,11,30,41,-11,23
SC Rheindorf,7161,7,4,6,14,18,34,-16,18
FC Salzburg,7162,1,12,10,2,41,18,23,46
SK Sturm Gra,7162,2,14,4,6,34,27,7,46
Rapid Vienna,7162,3,7,10,7,35,33,2,31
LASK Linz,7162,4,8,6,10,31,31,0,30
Mattersburg,7162,5,7,6,11,32,40,-8,27
Vienna,7162,6,7,6,11,27,39,-12,27
SC Rheindorf,7162,7,5,6,13,20,32,-12,21
FC Salzburg,7163,1,13,7,4,42,18,24,46
SK Sturm Gra,7163,2,12,6,6,30,25,5,42
Rapid Vienna,7163,3,8,10,6,32,26,6,34
LASK Linz,7163,4,9,6,9,28,29,-1,33
Mattersburg,7163,5,7,6,11,38,46,-8,27
Vienna,7163,6,6,6,12,26,43,-17,24
SC Rheindorf,7163,7,6,5,13,23,32,-9,23
FC Salzburg,7164,1,15,6,3,44,19,25,51
SK Sturm Gra,7164,2,12,3,9,36,32,4,39
Rapid Vienna,7164,3,9,10,5,36,27,9,37
LASK Linz,7164,4,8,6,10,30,34,-4,30
Mattersburg,7164,5,7,5,12,33,40,-7,26
Vienna,7164,6,7,5,12,24,38,-14,26
SC Rheindorf,7164,7,5,7,12,17,30,-13,22
FC Salzburg,7165,1,15,6,3,46,19,27,51
SK Sturm Gra,7165,2,13,4,7,31,28,3,43
Rapid Vienna,7165,3,9,9,6,37,29,8,36
LASK Linz,7165,4,8,6,10,26,28,-2,30
Vienna,7165,5,7,5,12,27,41,-14,26
SC Rheindorf,7165,6,6,5,13,19,29,-10,23
Mattersburg,7165,7,6,5,13,32,44,-12,23
FC Salzburg,7166,1,15,6,3,42,17,25,51
SK Sturm Gra,7166,2,12,5,7,32,28,4,41
Rapid Vienna,7166,3,7,12,5,34,27,7,33
LASK Linz,7166,4,8,7,9,27,28,-1,31
Mattersburg,7166,5,7,5,12,33,42,-9,26
Vienna,7166,6,7,5,12,25,39,-14,26
SC Rheindorf,7166,7,5,6,13,23,35,-12,21
FC Salzburg,7167,1,13,6,5,44,23,21,45
SK Sturm Gra,7167,2,12,4,8,32,32,0,40
Rapid Vienna,7167,3,9,9,6,40,28,12,36
LASK Linz,7167,4,9,6,9,27,27,0,33
SC Rheindorf,7167,5,7,5,12,22,31,-9,26
Mattersburg,7167,6,7,5,12,29,40,-11,26
Vienna,7167,7,7,5,12,25,38,-13,26
FC Salzburg,7168,1,14,7,3,42,19,23,49
SK Sturm Gra,7168,2,12,4,8,29,27,2,40
Rapid Vienna,7168,3,9,10,5,37,26,11,37
LASK Linz,7168,4,9,6,9,30,29,1,33
SC Rheindorf,7168,5,7,5,12,20,29,-9,26
Vienna,7168,6,7,5,12,26,40,-14,26
Mattersburg,7168,7,5,5,14,32,46,-14,20
FC Salzburg,7169,1,15,6,3,44,19,25,51
SK Sturm Gra,7169,2,11,5,8,30,28,2,38
Rapid Vienna,7169,3,9,10,5,39,29,10,37
LASK Linz,7169,4,10,6,8,31,28,3,36
Mattersburg,7169,5,6,6,12,31,43,-12,24
Vienna,7169,6,6,5,13,26,43,-17,23
SC Rheindorf,7169,7,5,6,13,20,31,-11,21
FC Salzburg,7170,1,14,6,4,47,25,22,48
SK Sturm Gra,7170,2,13,4,7,34,28,6,43
Rapid Vienna,7170,3,11,9,4,46,25,21,42
LASK Linz,7170,4,8,6,10,27,29,-2,30
Vienna,7170,5,6,6,12,27,43,-16,24
SC Rheindorf,7170,6,5,7,12,17,32,-15,22
Mattersburg,7170,7,5,6,13,29,45,-16,21
FC Salzburg,7171,1,14,8,2,44,17,27,50
SK Sturm Gra,7171,2,12,6,6,31,26,5,42
LASK Linz,7171,3,9,7,8,31,28,3,34
Rapid Vienna,7171,4,7,11,6,31,28,3,32
Vienna,7171,5,7,5,12,26,40,-14,26
Mattersburg,7171,6,5,8,11,32,44,-12,23
SC Rheindorf,7171,7,4,7,13,18,30,-12,19
FC Salzburg,7172,1,14,7,3,43,18,25,49
Rapid Vienna,7172,2,10,9,5,38,25,13,39
SK Sturm Gra,7172,3,12,3,9,31,31,0,39
LASK Linz,7172,4,10,6,8,30,26,4,36
Vienna,7172,5,6,7,11,25,39,-14,25
SC Rheindorf,7172,6,5,6,13,18,30,-12,21
Mattersburg,7172,7,5,6,13,29,45,-16,21
FC Salzburg,7173,1,15,7,2,46,17,29,52
SK Sturm Gra,7173,2,13,4,7,31,26,5,43
Rapid Vienna,7173,3,8,9,7,32,27,5,33
LASK Linz,7173,4,8,6,10,25,27,-2,30
SC Rheindorf,7173,5,7,6,11,20,25,-5,27
Vienna,7173,6,7,5,12,26,41,-15,26
Mattersburg,7173,7,5,5,14,30,47,-17,20
FC Salzburg,7174,1,14,7,3,42,18,24,49
SK Sturm Gra,7174,2,14,3,7,34,29,5,45
Rapid Vienna,7174,3,9,9,6,36,26,10,36
LASK Linz,7174,4,8,5,11,27,32,-5,29
Vienna,7174,5,7,6,11,27,38,-11,27
SC Rheindorf,7174,6,6,5,13,20,31,-11,23
Mattersburg,7174,7,6,5,13,31,43,-12,23
FC Salzburg,7175,1,12,9,3,40,18,22,45
SK Sturm Gra,7175,2,13,3,8,31,28,3,42
Rapid Vienna,7175,3,8,10,6,35,28,7,34
LASK Linz,7175,4,9,5,10,26,28,-2,32
Mattersburg,7175,5,7,7,10,30,38,-8,28
Vienna,7175,6,6,7,11,26,40,-14,25
SC Rheindorf,7175,7,6,5,13,20,28,-8,23
FC Salzburg,7176,1,15,6,3,44,18,26,51
SK Sturm Gra,7176,2,12,4,8,33,31,2,40
Rapid Vienna,7176,3,9,9,6,35,27,8,36
LASK Linz,7176,4,8,5,11,26,28,-2,29
Vienna,7176,5,8,5,11,27,38,-11,29
SC Rheindorf,7176,6,6,7,11,20,28,-8,25
Mattersburg,7176,7,5,6,13,28,43,-15,21
FC Salzburg,7177,1,15,6,3,47,16,31,51
SK Sturm Gra,7177,2,12,4,8,33,31,2,40
Rapid Vienna,7177,3,8,11,5,33,25,8,35
LASK Linz,7177,4,7,8,9,27,31,-4,29
SC Rheindorf,7177,5,7,6,11,20,25,-5,27
Vienna,7177,6,6,6,12,25,42,-17,24
Mattersburg,7177,7,5,7,12,29,44,-15,22
FC Salzburg,7178,1,16,6,2,46,15,31,54
SK Sturm Gra,7178,2,11,4,9,29,29,0,37
Rapid Vienna,7178,3,9,9,6,36,30,6,36
LASK Linz,7178,4,9,6,9,28,26,2,33
Mattersburg,7178,5,8,5,11,31,40,-9,29
Vienna,7178,6,6,5,13,24,42,-18,23
SC Rheindorf,7178,7,4,7,13,18,30,-12,19
FC Salzburg,7179,1,13,8,3,43,20,23,47
SK Sturm Gra,7179,2,14,3,7,36,26,10,45
Rapid Vienna,7179,3,8,10,6,37,31,6,34
Mattersburg,7179,4,8,6,10,33,40,-7,30
LASK Linz,7179,5,7,6,11,24,30,-6,27
Vienna,7179,6,6,7,11,25,39,-14,25
SC Rheindorf,7179,7,5,6,13,20,32,-12,21
FC Salzburg,7180,1,16,6,2,50,17,33,54
SK Sturm Gra,7180,2,13,3,8,33,28,5,42
Rapid Vienna,7180,3,10,9,5,38,27,11,39
Mattersburg,7180,4,7,6,11,38,44,-6,27
LASK Linz,7180,5,7,6,11,27,36,-9,27
Vienna,7180,6,6,5,13,24,44,-20,23
SC Rheindorf,7180,7,4,7,13,22,36,-14,19
FC Salzburg,7181,1,16,6,2,45,16,29,54
SK Sturm Gra,7181,2,12,5,7,31,27,4,41
Rapid Vienna,7181,3,8,10,6,32,25,7,34
LASK Linz,7181,4,9,5,10,26,27,-1,32
Mattersburg,7181,5,6,6,12,32,38,-6,24
Vienna,7181,6,6,6,12,24,41,-17,24
SC Rheindorf,7181,7,5,6,13,17,33,-16,21
FC Salzburg,7182,1,13,8,3,44,20,24,47
SK Sturm Gra,7182,2,12,5,7,32,27,5,41
Rapid Vienna,7182,3,9,10,5,37,30,7,37
LASK Linz,7182,4,8,5,11,28,32,-4,29
Mattersburg,7182,5,7,6,11,32,41,-9,27
Vienna,7182,6,6,7,11,25,39,-14,25
SC Rheindorf,7182,7,5,7,12,21,30,-9,22
FC Salzburg,7183,1,14,7,3,49,21,28,49
SK Sturm Gra,7183,2,11,6,7,34,32,2,39
Rapid Vienna,7183,3,9,10,5,39,27,12,37
Mattersburg,7183,4,8,5,11,30,38,-8,29
LASK Linz,7183,5,7,6,11,25,34,-9,27
Vienna,7183,6,7,5,12,25,42,-17,26
SC Rheindorf,7183,7,5,7,12,20,28,-8,22
FC Salzburg,7184,1,13,6,5,42,20,22,45
SK Sturm Gra,7184,2,13,5,6,31,25,6,44
Rapid Vienna,7184,3,9,9,6,38,28,10,36
LASK Linz,7184,4,8,7,9,27,29,-2,31
Mattersburg,7184,5,8,5,11,35,41,-6,29
Vienna,7184,6,7,5,12,26,40,-14,26
SC Rheindorf,7184,7,4,7,13,18,34,-16,19
FC Salzburg,7185,1,16,6,2,46,18,28,54
SK Sturm Gra,7185,2,13,4,7,36,30,6,43
Rapid Vienna,7185,3,8,10,6,35,29,6,34
LASK Linz,7185,4,8,6,10,29,32,-3,30
Vienna,7185,5,7,5,12,26,39,-13,26
Mattersburg,7185,6,6,5,13,30,43,-13,23
SC Rheindorf,7185,7,5,6,13,18,29,-11,21
FC Salzburg,7186,1,14,7,3,44,20,24,49
SK Sturm Gra,7186,2,15,3,6,36,27,9,48
Rapid Vienna,7186,3,7,10,7,35,30,5,31
LASK Linz,7186,4,8,6,10,29,31,-2,30
Mattersburg,7186,5,6,7,11,30,41,-11,25
Vienna,7186,6,6,7,11,26,40,-14,25
SC Rheindorf,7186,7,5,6,13,21,32,-11,21
FC Salzburg,7187,1,15,7,2,51,21,30,52
SK Sturm Gra,7187,2,12,4,8,31,30,1,40
Rapid Vienna,7187,3,9,11,4,35,24,11,38
LASK Linz,7187,4,7,6,11,24,31,-7,27
SC Rheindorf,7187,5,6,6,12,23,29,-6,24
Mattersburg,7187,6,6,6,12,36,49,-13,24
Vienna,7187,7,6,6,12,28,44,-16,24
FC Salzburg,7188,1,16,6,2,46,18,28,54
SK Sturm Gra,7188,2,13,4,7,32,26,6,43
Rapid Vienna,7188,3,8,10,6,36,27,9,34
LASK Linz,7188,4,7,6,11,26,33,-7,27
Mattersburg,7188,5,6,7,11,29,39,-10,25
Vienna,7188,6,6,6,12,24,40,-16,24
SC Rheindorf,7188,7,5,7,12,18,28,-10,22
FC Salzburg,7189,1,14,8,2,45,18,27,50
SK Sturm Gra,7189,2,12,4,8,33,30,3,40
Rapid Vienna,7189,3,8,11,5,34,27,7,35
LASK Linz,7189,4,9,7,8,27,25,2,34
Vienna,7189,5,7,6,11,26,37,-11,27
Mattersburg,7189,6,6,5,13,28,44,-16,23
SC Rheindorf,7189,7,4,7,13,16,28,-12,19
FC Salzburg,7190,1,15,6,3,45,18,27,51
Rapid Vienna,7190,2,9,10,5,37,29,8,37
SK Sturm Gra,7190,3,11,4,9,35,34,1,37
LASK Linz,7190,4,8,7,9,30,31,-1,31
Mattersburg,7190,5,7,6,11,38,44,-6,27
SC Rheindorf,7190,6,6,6,12,21,30,-9,24
Vienna,7190,7,6,5,13,25,45,-20,23
FC Salzburg,7191,1,13,7,4,43,21,22,46
SK Sturm Gra,7191,2,14,3,7,33,26,7,45
Rapid Vienna,7191,3,9,9,6,36,26,10,36
LASK Linz,7191,4,8,5,11,26,31,-5,29
Vienna,7191,5,7,6,11,26,39,-13,27
SC Rheindorf,7191,6,7,5,12,18,26,-8,26
Mattersburg,7191,7,6,5,13,30,43,-13,23
FC Salzburg,7192,1,15,6,3,51,18,33,51
Rapid Vienna,7192,2,10,9,5,37,26,11,39
SK Sturm Gra,7192,3,11,5,8,30,32,-2,38
LASK Linz,7192,4,8,8,8,30,29,1,32
Vienna,7192,5,7,5,12,28,40,-12,26
SC Rheindorf,7192,6,5,7,12,21,30,-9,22
Mattersburg,7192,7,5,6,13,30,52,-22,21
FC Salzburg,7193,1,15,7,2,46,19,27,52
SK Sturm Gra,7193,2,12,4,8,34,31,3,40
Rapid Vienna,7193,3,8,10,6,35,28,7,34
LASK Linz,7193,4,9,6,9,31,32,-1,33
Vienna,7193,5,7,6,11,27,40,-13,27
Mattersburg,7193,6,5,7,12,32,44,-12,22
SC Rheindorf,7193,7,4,8,12,16,27,-11,20
FC Salzburg,7194,1,13,7,4,41,19,22,46
SK Sturm Gra,7194,2,12,5,7,31,28,3,41
LASK Linz,7194,3,10,6,8,33,28,5,36
Rapid Vienna,7194,4,8,10,6,35,30,5,34
Vienna,7194,5,8,5,11,27,38,-11,29
SC Rheindorf,7194,6,5,7,12,18,28,-10,22
Mattersburg,7194,7,5,6,13,28,42,-14,21
FC Salzburg,7195,1,14,7,3,43,19,24,49
SK Sturm Gra,7195,2,14,3,7,36,28,8,45
Rapid Vienna,7195,3,9,10,5,37,28,9,37
LASK Linz,7195,4,9,5,10,29,30,-1,32
Mattersburg,7195,5,6,6,12,31,43,-12,24
Vienna,7195,6,6,6,12,24,40,-16,24
SC Rheindorf,7195,7,5,5,14,19,31,-12,20
FC Salzburg,7196,1,15,7,2,45,18,27,52
SK Sturm Gra,7196,2,12,4,8,34,31,3,40
Rapid Vienna,7196,3,9,10,5,37,28,9,37
LASK Linz,7196,4,8,5,11,28,31,-3,29
Vienna,7196,5,7,6,11,26,39,-13,27
Mattersburg,7196,6,6,5,13,31,43,-12,23
SC Rheindorf,7196,7,5,7,12,21,32,-11,22
FC Salzburg,7197,1,14,8,2,43,18,25,50
SK Sturm Gra,7197,2,12,4,8,32,30,2,40
LASK Linz,7197,3,10,5,9,33,29,4,35
Rapid Vienna,7197,4,7,11,6,36,31,5,32
Mattersburg,7197,5,7,5,12,31,43,-12,26
Vienna,7197,6,6,6,12,26,42,-16,24
SC Rheindorf,7197,7,5,7,12,24,32,-8,22
FC Salzburg,7198,1,13,8,3,41,19,22,47
SK Sturm Gra,7198,2,12,5,7,35,30,5,41
Rapid Vienna,7198,3,10,9,5,38,27,11,39
LASK Linz,7198,4,10,5,9,32,30,2,35
Mattersburg,7198,5,7,5,12,31,40,-9,26
Vienna,7198,6,6,6,12,24,40,-16,24
SC Rheindorf,7198,7,4,6,14,19,34,-15,18
FC Salzburg,7199,1,14,7,3,45,18,27,49
Rapid Vienna,7199,2,9,10,5,37,27,10,37
SK Sturm Gra,7199,3,11,3,10,31,36,-5,36
LASK Linz,7199,4,9,5,10,27,29,-2,32
Vienna,7199,5,7,5,12,25,38,-13,26
SC Rheindorf,7199,6,6,7,11,20,27,-7,25
Mattersburg,7199,7,6,7,11,30,40,-10,25
SK Sturm Gra,7200,1,14,4,6,33,25,8,46
FC Salzburg,7200,2,12,8,4,40,20,20,44
Rapid Vienna,7200,3,8,10,6,35,27,8,34
LASK Linz,7200,4,7,6,11,24,31,-7,27
Mattersburg,7200,5,7,6,11,34,42,-8,27
Vienna,7200,6,7,6,11,26,39,-13,27
SC Rheindorf,7200,7,6,6,12,23,31,-8,24
FC Salzburg,7201,1,15,7,2,49,18,31,52
SK Sturm Gra,7201,2,13,4,7,33,28,5,43
LASK Linz,7201,3,9,5,10,28,30,-2,32
Rapid Vienna,7201,4,7,10,7,35,32,3,31
SC Rheindorf,7201,5,6,7,11,22,28,-6,25
Mattersburg,7201,6,6,6,12,29,41,-12,24
Vienna,7201,7,6,5,13,24,43,-19,23
SK Sturm Gra,7202,1,14,3,7,36,30,6,45
FC Salzburg,7202,2,12,6,6,41,25,16,42
Rapid Vienna,7202,3,10,9,5,39,26,13,39
LASK Linz,7202,4,10,5,9,30,30,0,35
Vienna,7202,5,8,5,11,28,39,-11,29
Mattersburg,7202,6,6,6,12,30,41,-11,24
SC Rheindorf,7202,7,4,6,14,16,29,-13,18
FC Salzburg,7203,1,15,6,3,47,18,29,51
SK Sturm Gra,7203,2,12,3,9,31,29,2,39
Rapid Vienna,7203,3,8,10,6,33,28,5,34
LASK Linz,7203,4,8,5,11,24,28,-4,29
Mattersburg,7203,5,8,5,11,31,40,-9,29
Vienna,7203,6,7,5,12,28,42,-14,26
SC Rheindorf,7203,7,6,6,12,17,26,-9,24
FC Salzburg,7204,1,14,8,2,45,19,26,50
SK Sturm Gra,7204,2,13,4,7,31,27,4,43
Rapid Vienna,7204,3,9,10,5,36,25,11,37
LASK Linz,7204,4,7,7,10,25,30,-5,28
Vienna,7204,5,7,5,12,25,39,-14,26
Mattersburg,7204,6,6,7,11,32,40,-8,25
SC Rheindorf,7204,7,4,7,13,17,31,-14,19
FC Salzburg,7205,1,14,8,2,48,19,29,50
SK Sturm Gra,7205,2,13,4,7,33,29,4,43
Rapid Vienna,7205,3,9,10,5,36,26,10,37
LASK Linz,7205,4,8,7,9,28,30,-2,31
Vienna,7205,5,7,6,11,26,39,-13,27
Mattersburg,7205,6,5,6,13,29,45,-16,21
SC Rheindorf,7205,7,5,5,14,18,30,-12,20
FC Salzburg,7206,1,13,7,4,46,21,25,46
SK Sturm Gra,7206,2,14,4,6,36,26,10,46
Rapid Vienna,7206,3,9,11,4,35,24,11,38
LASK Linz,7206,4,9,6,9,28,28,0,33
Mattersburg,7206,5,7,5,12,33,44,-11,26
Vienna,7206,6,6,6,12,27,42,-15,24
SC Rheindorf,7206,7,4,5,15,15,35,-20,17
FC Salzburg,7207,1,15,7,2,50,18,32,52
SK Sturm Gra,7207,2,12,4,8,33,32,1,40
Rapid Vienna,7207,3,9,10,5,36,25,11,37
LASK Linz,7207,4,7,5,12,23,32,-9,26
Mattersburg,7207,5,7,5,12,29,39,-10,26
Vienna,7207,6,7,5,12,25,41,-16,26
SC Rheindorf,7207,7,6,6,12,18,27,-9,24
FC Salzburg,7208,1,13,8,3,44,19,25,47
SK Sturm Gra,7208,2,13,3,8,35,28,7,42
Rapid Vienna,7208,3,8,12,4,34,25,9,36
SC Rheindorf,7208,4,7,6,11,25,27,-2,27
LASK Linz,7208,5,7,6,11,26,39,-13,27
Vienna,7208,5,7,6,11,26,39,-13,27
Mattersburg,7208,7,6,5,13,30,43,-13,23
FC Salzburg,7209,1,15,7,2,49,16,33,52
SK Sturm Gra,7209,2,13,3,8,31,29,2,42
Rapid Vienna,7209,3,8,11,5,34,25,9,35
LASK Linz,7209,4,7,6,11,25,29,-4,27
Mattersburg,7209,5,7,6,11,31,40,-9,27
Vienna,7209,6,6,6,12,24,43,-19,24
SC Rheindorf,7209,7,6,5,13,17,29,-12,23
FC Salzburg,7210,1,14,7,3,47,19,28,49
SK Sturm Gra,7210,2,14,3,7,38,30,8,45
Rapid Vienna,7210,3,9,10,5,36,29,7,37
LASK Linz,7210,4,8,7,9,28,29,-1,31
Vienna,7210,5,7,6,11,28,38,-10,27
Mattersburg,7210,6,6,6,12,30,47,-17,24
SC Rheindorf,7210,7,4,5,15,18,33,-15,17
FC Salzburg,7211,1,14,6,4,45,22,23,48
SK Sturm Gra,7211,2,13,5,6,37,28,9,44
Rapid Vienna,7211,3,9,11,4,35,25,10,38
LASK Linz,7211,4,8,8,8,29,28,1,32
Mattersburg,7211,5,6,6,12,30,42,-12,24
Vienna,7211,6,6,5,13,23,42,-19,23
SC Rheindorf,7211,7,5,5,14,17,29,-12,20
FC Salzburg,7212,1,14,8,2,45,19,26,50
SK Sturm Gra,7212,2,13,3,8,35,29,6,42
Rapid Vienna,7212,3,7,11,6,34,30,4,32
LASK Linz,7212,4,8,6,10,26,30,-4,30
Mattersburg,7212,5,7,6,11,31,38,-7,27
SC Rheindorf,7212,6,6,7,11,22,29,-7,25
Vienna,7212,7,6,5,13,24,42,-18,23
FC Salzburg,7213,1,15,7,2,43,15,28,52
SK Sturm Gra,7213,2,13,4,7,37,28,9,43
Rapid Vienna,7213,3,8,11,5,34,26,8,35
LASK Linz,7213,4,7,7,10,26,32,-6,28
Vienna,7213,5,7,6,11,25,37,-12,27
Mattersburg,7213,6,5,7,12,28,42,-14,22
SC Rheindorf,7213,7,4,8,12,16,29,-13,20
FC Salzburg,7214,1,15,6,3,46,20,26,51
SK Sturm Gra,7214,2,11,6,7,32,29,3,39
Rapid Vienna,7214,3,9,11,4,38,28,10,38
LASK Linz,7214,4,8,7,9,29,30,-1,31
Vienna,7214,5,7,5,12,25,39,-14,26
Mattersburg,7214,6,6,5,13,30,44,-14,23
SC Rheindorf,7214,7,5,6,13,21,31,-10,21
FC Salzburg,7215,1,15,7,2,48,16,32,52
SK Sturm Gra,7215,2,12,3,9,31,32,-1,39
Rapid Vienna,7215,3,8,11,5,36,27,9,35
LASK Linz,7215,4,9,6,9,26,27,-1,33
SC Rheindorf,7215,5,7,5,12,24,29,-5,26
Vienna,7215,6,7,5,12,24,38,-14,26
Mattersburg,7215,7,5,5,14,27,47,-20,20
FC Salzburg,7216,1,15,7,2,44,16,28,52
Rapid Vienna,7216,2,10,10,4,38,26,12,40
SK Sturm Gra,7216,3,12,4,8,32,30,2,40
LASK Linz,7216,4,7,6,11,26,32,-6,27
Vienna,7216,5,7,5,12,25,39,-14,26
Mattersburg,7216,6,6,5,13,29,41,-12,23
SC Rheindorf,7216,7,5,7,12,18,28,-10,22
FC Salzburg,7217,1,15,7,2,49,20,29,52
SK Sturm Gra,7217,2,13,4,7,35,30,5,43
Rapid Vienna,7217,3,9,9,6,39,29,10,36
LASK Linz,7217,4,8,6,10,27,28,-1,30
Vienna,7217,5,7,6,11,28,41,-13,27
Mattersburg,7217,6,6,5,13,32,45,-13,23
SC Rheindorf,7217,7,4,7,13,16,33,-17,19
FC Salzburg,7218,1,15,6,3,47,19,28,51
SK Sturm Gra,7218,2,14,3,7,35,28,7,45
Rapid Vienna,7218,3,9,10,5,39,30,9,37
LASK Linz,7218,4,8,6,10,26,30,-4,30
Mattersburg,7218,5,6,7,11,31,41,-10,25
Vienna,7218,6,6,6,12,27,43,-16,24
SC Rheindorf,7218,7,4,6,14,18,32,-14,18
FC Salzburg,7219,1,14,7,3,44,18,26,49
Rapid Vienna,7219,2,11,9,4,37,24,13,42
SK Sturm Gra,7219,3,11,4,9,30,30,0,37
LASK Linz,7219,4,8,6,10,26,28,-2,30
Mattersburg,7219,5,7,5,12,33,41,-8,26
Vienna,7219,6,7,5,12,24,39,-15,26
SC Rheindorf,7219,7,5,6,13,21,35,-14,21
FC Salzburg,7220,1,15,6,3,44,18,26,51
SK Sturm Gra,7220,2,13,3,8,35,30,5,42
Rapid Vienna,7220,3,9,9,6,34,28,6,36
LASK Linz,7220,4,9,7,8,29,27,2,34
Mattersburg,7220,5,7,6,11,32,41,-9,27
Vienna,7220,6,6,5,13,23,39,-16,23
SC Rheindorf,7220,7,4,6,14,18,32,-14,18
FC Salzburg,7221,1,13,7,4,42,21,21,46
SK Sturm Gra,7221,2,13,5,6,33,25,8,44
Rapid Vienna,7221,3,8,11,5,35,26,9,35
LASK Linz,7221,4,9,6,9,27,27,0,33
Vienna,7221,5,8,5,11,30,39,-9,29
SC Rheindorf,7221,6,6,5,13,17,29,-12,23
Mattersburg,7221,7,5,5,14,27,44,-17,20
FC Salzburg,7222,1,14,6,4,45,20,25,48
SK Sturm Gra,7222,2,13,4,7,34,28,6,43
Rapid Vienna,7222,3,9,9,6,35,28,7,36
SC Rheindorf,7222,4,8,5,11,20,26,-6,29
LASK Linz,7222,5,7,6,11,25,32,-7,27
Vienna,7222,6,7,5,12,25,39,-14,26
Mattersburg,7222,7,6,5,13,33,44,-11,23
FC Salzburg,7223,1,14,8,2,46,18,28,50
SK Sturm Gra,7223,2,12,5,7,32,28,4,41
Rapid Vienna,7223,3,8,10,6,34,27,7,34
LASK Linz,7223,4,9,6,9,26,27,-1,33
Vienna,7223,5,7,6,11,26,38,-12,27
Mattersburg,7223,6,6,5,13,29,46,-17,23
SC Rheindorf,7223,7,5,6,13,19,28,-9,21
FC Salzburg,7224,1,14,6,4,44,21,23,48
SK Sturm Gra,7224,2,13,4,7,37,31,6,43
Rapid Vienna,7224,3,10,10,4,38,26,12,40
LASK Linz,7224,4,9,6,9,32,33,-1,33
Vienna,7224,5,7,5,12,25,39,-14,26
SC Rheindorf,7224,6,5,6,13,20,30,-10,21
Mattersburg,7224,7,5,5,14,29,45,-16,20
FC Salzburg,7225,1,15,7,2,45,17,28,52
SK Sturm Gra,7225,2,13,3,8,34,30,4,42
Rapid Vienna,7225,3,9,11,4,39,26,13,38
LASK Linz,7225,4,7,7,10,27,32,-5,28
Mattersburg,7225,5,6,7,11,31,41,-10,25
Vienna,7225,6,6,6,12,25,40,-15,24
SC Rheindorf,7225,7,4,7,13,18,33,-15,19
FC Salzburg,7226,1,14,7,3,42,16,26,49
SK Sturm Gra,7226,2,13,3,8,37,32,5,42
Rapid Vienna,7226,3,7,12,5,35,29,6,33
LASK Linz,7226,4,8,6,10,26,31,-5,30
Vienna,7226,5,8,5,11,27,39,-12,29
Mattersburg,7226,6,7,5,12,33,44,-11,26
SC Rheindorf,7226,7,5,6,13,24,33,-9,21
FC Salzburg,7227,1,15,6,3,49,21,28,51
Rapid Vienna,7227,2,9,10,5,41,31,10,37
SK Sturm Gra,7227,3,11,4,9,32,33,-1,37
LASK Linz,7227,4,9,5,10,30,31,-1,32
SC Rheindorf,7227,5,7,5,12,26,33,-7,26
Vienna,7227,6,7,5,12,29,42,-13,26
Mattersburg,7227,7,6,5,13,34,50,-16,23
FC Salzburg,7228,1,15,6,3,45,19,26,51
Rapid Vienna,7228,2,10,9,5,38,26,12,39
SK Sturm Gra,7228,3,11,3,10,30,33,-3,36
LASK Linz,7228,4,10,5,9,29,27,2,35
Mattersburg,7228,5,7,5,12,30,43,-13,26
Vienna,7228,6,7,5,12,27,40,-13,26
SC Rheindorf,7228,7,5,5,14,18,29,-11,20
FC Salzburg,7229,1,14,6,4,41,18,23,48
SK Sturm Gra,7229,2,12,4,8,31,29,2,40
Rapid Vienna,7229,3,7,11,6,33,28,5,32
LASK Linz,7229,4,9,5,10,29,32,-3,32
SC Rheindorf,7229,5,7,6,11,23,28,-5,27
Mattersburg,7229,6,7,6,11,33,39,-6,27
Vienna,7229,7,6,6,12,25,41,-16,24
FC Salzburg,7230,1,14,8,2,50,19,31,50
SK Sturm Gra,7230,2,12,4,8,33,31,2,40
Rapid Vienna,7230,3,8,11,5,36,26,10,35
LASK Linz,7230,4,8,7,9,30,31,-1,31
Vienna,7230,5,6,7,11,26,40,-14,25
Mattersburg,7230,6,6,6,12,31,47,-16,24
SC Rheindorf,7230,7,6,5,13,22,34,-12,23
FC Salzburg,7231,1,14,8,2,47,19,28,50
SK Sturm Gra,7231,2,13,3,8,37,30,7,42
Rapid Vienna,7231,3,8,10,6,37,29,8,34
Mattersburg,7231,4,8,6,10,36,39,-3,30
LASK Linz,7231,5,8,6,10,30,36,-6,30
Vienna,7231,6,6,5,13,24,45,-21,23
SC Rheindorf,7231,7,5,6,13,18,31,-13,21
FC Salzburg,7232,1,14,6,4,42,19,23,48
SK Sturm Gra,7232,2,13,4,7,38,30,8,43
LASK Linz,7232,3,9,6,9,31,32,-1,33
Rapid Vienna,7232,4,7,11,6,36,32,4,32
Vienna,7232,5,8,5,11,26,38,-12,29
Mattersburg,7232,6,6,6,12,29,40,-11,24
SC Rheindorf,7232,7,5,6,13,21,32,-11,21
FC Salzburg,7233,1,14,8,2,47,19,28,50
SK Sturm Gra,7233,2,12,4,8,31,31,0,40
Rapid Vienna,7233,3,9,10,5,38,28,10,37
LASK Linz,7233,4,9,5,10,27,29,-2,32
Mattersburg,7233,5,6,8,10,33,41,-8,26
Vienna,7233,6,6,6,12,25,41,-16,24
SC Rheindorf,7233,7,4,7,13,19,31,-12,19
FC Salzburg,7234,1,16,6,2,45,17,28,54
SK Sturm Gra,7234,2,11,5,8,28,28,0,38
Rapid Vienna,7234,3,8,10,6,35,27,8,34
LASK Linz,7234,4,9,6,9,27,27,0,33
Mattersburg,7234,5,6,7,11,33,43,-10,25
Vienna,7234,6,6,6,12,26,41,-15,24
SC Rheindorf,7234,7,5,6,13,22,33,-11,21
FC Salzburg,7235,1,16,6,2,44,16,28,54
SK Sturm Gra,7235,2,12,3,9,31,31,0,39
Rapid Vienna,7235,3,8,10,6,37,29,8,34
LASK Linz,7235,4,9,5,10,27,29,-2,32
Mattersburg,7235,5,8,5,11,33,41,-8,29
Vienna,7235,6,6,5,13,24,40,-16,23
SC Rheindorf,7235,7,5,6,13,21,31,-10,21
FC Salzburg,7236,1,14,7,3,43,19,24,49
SK Sturm Gra,7236,2,12,5,7,32,27,5,41
Rapid Vienna,7236,3,10,10,4,38,26,12,40
LASK Linz,7236,4,8,6,10,29,32,-3,30
Vienna,7236,5,7,5,12,27,40,-13,26
Mattersburg,7236,6,5,7,12,31,45,-14,22
SC Rheindorf,7236,7,5,6,13,19,30,-11,21
FC Salzburg,7237,1,14,6,4,44,21,23,48
SK Sturm Gra,7237,2,12,3,9,34,32,2,39
Rapid Vienna,7237,3,9,9,6,37,28,9,36
LASK Linz,7237,4,9,5,10,31,31,0,32
Mattersburg,7237,5,7,7,10,31,38,-7,28
SC Rheindorf,7237,6,6,6,12,21,32,-11,24
Vienna,7237,7,6,6,12,26,42,-16,24
FC Salzburg,7238,1,14,8,2,42,16,26,50
SK Sturm Gra,7238,2,12,5,7,37,33,4,41
Rapid Vienna,7238,3,8,10,6,36,30,6,34
Mattersburg,7238,4,8,6,10,33,37,-4,30
LASK Linz,7238,5,7,8,9,27,31,-4,29
Vienna,7238,6,6,6,12,24,40,-16,24
SC Rheindorf,7238,7,4,7,13,20,32,-12,19
FC Salzburg,7239,1,14,7,3,48,21,27,49
SK Sturm Gra,7239,2,12,4,8,32,32,0,40
Rapid Vienna,7239,3,9,10,5,36,30,6,37
LASK Linz,7239,4,9,6,9,29,26,3,33
Vienna,7239,5,8,5,11,27,38,-11,29
Mattersburg,7239,6,7,5,12,33,40,-7,26
SC Rheindorf,7239,7,4,5,15,18,36,-18,17
FC Salzburg,7240,1,14,7,3,46,19,27,49
Rapid Vienna,7240,2,10,10,4,39,26,13,40
SK Sturm Gra,7240,3,12,4,8,33,32,1,40
LASK Linz,7240,4,8,6,10,30,31,-1,30
Vienna,7240,5,8,5,11,27,37,-10,29
Mattersburg,7240,6,6,5,13,29,47,-18,23
SC Rheindorf,7240,7,4,7,13,19,31,-12,19
FC Salzburg,7241,1,15,6,3,47,18,29,51
SK Sturm Gra,7241,2,13,3,8,33,29,4,42
Rapid Vienna,7241,3,8,10,6,36,30,6,34
LASK Linz,7241,4,8,7,9,27,28,-1,31
Mattersburg,7241,5,7,5,12,31,41,-10,26
SC Rheindorf,7241,6,6,6,12,18,28,-10,24
Vienna,7241,7,6,5,13,24,42,-18,23
FC Salzburg,7242,1,15,7,2,50,18,32,52
Rapid Vienna,7242,2,10,10,4,43,28,15,40
SK Sturm Gra,7242,3,11,5,8,29,31,-2,38
LASK Linz,7242,4,7,7,10,25,31,-6,28
Vienna,7242,5,6,6,12,24,39,-15,24
Mattersburg,7242,6,5,8,11,31,46,-15,23
SC Rheindorf,7242,7,5,7,12,22,31,-9,22
FC Salzburg,7243,1,14,8,2,43,17,26,50
SK Sturm Gra,7243,2,13,4,7,34,30,4,43
Rapid Vienna,7243,3,9,10,5,38,26,12,37
LASK Linz,7243,4,7,7,10,25,29,-4,28
Vienna,7243,5,7,5,12,27,41,-14,26
SC Rheindorf,7243,6,6,5,13,21,31,-10,23
Mattersburg,7243,7,5,7,12,29,43,-14,22
FC Salzburg,7244,1,16,6,2,48,19,29,54
SK Sturm Gra,7244,2,12,4,8,31,30,1,40
Rapid Vienna,7244,3,8,11,5,35,25,10,35
LASK Linz,7244,4,7,8,9,24,26,-2,29
Vienna,7244,5,7,5,12,27,42,-15,26
Mattersburg,7244,6,6,6,12,31,42,-11,24
SC Rheindorf,7244,7,5,6,13,18,30,-12,21
FC Salzburg,7245,1,14,8,2,43,15,28,50
SK Sturm Gra,7245,2,13,3,8,33,27,6,42
Rapid Vienna,7245,3,9,11,4,36,25,11,38
Mattersburg,7245,4,8,5,11,32,41,-9,29
LASK Linz,7245,5,7,7,10,26,30,-4,28
Vienna,7245,6,6,6,12,23,39,-16,24
SC Rheindorf,7245,7,4,6,14,16,32,-16,18
FC Salzburg,7246,1,14,8,2,51,20,31,50
SK Sturm Gra,7246,2,13,5,6,34,27,7,44
Rapid Vienna,7246,3,8,10,6,35,30,5,34
LASK Linz,7246,4,8,7,9,27,29,-2,31
Vienna,7246,5,7,6,11,28,41,-13,27
SC Rheindorf,7246,6,5,6,13,16,27,-11,21
Mattersburg,7246,7,5,6,13,31,48,-17,21
FC Salzburg,7247,1,16,6,2,46,17,29,54
SK Sturm Gra,7247,2,12,4,8,30,27,3,40
Rapid Vienna,7247,3,7,11,6,34,29,5,32
LASK Linz,7247,4,9,5,10,26,27,-1,32
SC Rheindorf,7247,5,6,7,11,19,27,-8,25
Mattersburg,7247,6,6,6,12,31,42,-11,24
Vienna,7247,7,6,5,13,25,42,-17,23
FC Salzburg,7248,1,14,7,3,45,18,27,49
SK Sturm Gra,7248,2,13,4,7,33,28,5,43
Rapid Vienna,7248,3,7,10,7,35,32,3,31
LASK Linz,7248,4,8,6,10,27,29,-2,30
Mattersburg,7248,5,8,5,11,30,38,-8,29
Vienna,7248,6,7,6,11,25,38,-13,27
SC Rheindorf,7248,7,5,6,13,18,30,-12,21
FC Salzburg,7249,1,15,7,2,46,18,28,52
SK Sturm Gra,7249,2,13,3,8,33,30,3,42
Rapid Vienna,7249,3,8,9,7,34,28,6,33
LASK Linz,7249,4,8,6,10,26,28,-2,30
Vienna,7249,5,7,6,11,27,40,-13,27
Mattersburg,7249,6,6,6,12,32,44,-12,24
SC Rheindorf,7249,7,5,7,12,20,30,-10,22
FC Salzburg,7250,1,14,6,4,43,22,21,48
SK Sturm Gra,7250,2,13,4,7,33,28,5,43
Rapid Vienna,7250,3,9,9,6,37,27,10,36
LASK Linz,7250,4,8,7,9,29,30,-1,31
Vienna,7250,5,8,5,11,29,39,-10,29
Mattersburg,7250,6,6,5,13,31,41,-10,23
SC Rheindorf,7250,7,5,6,13,17,32,-15,21
FC Salzburg,7251,1,13,7,4,47,23,24,46
SK Sturm Gra,7251,2,12,4,8,31,29,2,40
Rapid Vienna,7251,3,8,11,5,36,28,8,35
LASK Linz,7251,4,9,5,10,28,30,-2,32
Mattersburg,7251,5,7,6,11,33,41,-8,27
Vienna,7251,6,7,6,11,27,40,-13,27
SC Rheindorf,7251,7,6,5,13,18,29,-11,23
FC Salzburg,7252,1,15,7,2,46,18,28,52
SK Sturm Gra,7252,2,12,5,7,31,27,4,41
Rapid Vienna,7252,3,8,10,6,35,28,7,34
LASK Linz,7252,4,9,5,10,26,28,-2,32
Vienna,7252,5,7,5,12,25,39,-14,26
SC Rheindorf,7252,6,5,7,12,19,30,-11,22
Mattersburg,7252,7,5,7,12,28,40,-12,22
FC Salzburg,7253,1,13,9,2,44,19,25,48
SK Sturm Gra,7253,2,11,5,8,33,33,0,38
Rapid Vienna,7253,3,8,11,5,37,29,8,35
LASK Linz,7253,4,10,5,9,31,29,2,35
Mattersburg,7253,5,6,7,11,30,40,-10,25
Vienna,7253,6,6,6,12,25,41,-16,24
SC Rheindorf,7253,7,6,5,13,21,30,-9,23
FC Salzburg,7254,1,15,7,2,46,17,29,52
SK Sturm Gra,7254,2,14,3,7,35,29,6,45
Rapid Vienna,7254,3,8,11,5,35,27,8,35
LASK Linz,7254,4,8,6,10,27,28,-1,30
Vienna,7254,5,7,5,12,26,40,-14,26
SC Rheindorf,7254,6,5,6,13,19,32,-13,21
Mattersburg,7254,7,5,6,13,27,42,-15,21
FC Salzburg,7255,1,15,7,2,42,16,26,52
SK Sturm Gra,7255,2,12,3,9,29,28,1,39
Rapid Vienna,7255,3,8,12,4,34,25,9,36
LASK Linz,7255,4,7,7,10,26,29,-3,28
SC Rheindorf,7255,5,6,7,11,21,28,-7,25
Vienna,7255,6,6,6,12,25,40,-15,24
Mattersburg,7255,7,5,8,11,29,40,-11,23
FC Salzburg,7256,1,15,6,3,44,19,25,51
SK Sturm Gra,7256,2,14,4,6,33,25,8,46
Rapid Vienna,7256,3,7,9,8,32,29,3,30
LASK Linz,7256,4,8,6,10,25,27,-2,30
SC Rheindorf,7256,5,7,5,12,20,27,-7,26
Vienna,7256,6,7,5,12,27,41,-14,26
Mattersburg,7256,7,6,5,13,32,45,-13,23
FC Salzburg,7257,1,14,8,2,46,19,27,50
SK Sturm Gra,7257,2,12,3,9,33,32,1,39
Rapid Vienna,7257,3,8,10,6,36,30,6,34
LASK Linz,7257,4,9,5,10,28,31,-3,32
Mattersburg,7257,5,7,6,11,34,43,-9,27
SC Rheindorf,7257,6,6,6,12,21,28,-7,24
Vienna,7257,7,6,6,12,27,42,-15,24
FC Salzburg,7258,1,15,6,3,45,18,27,51
SK Sturm Gra,7258,2,13,3,8,34,31,3,42
Rapid Vienna,7258,3,8,9,7,33,27,6,33
LASK Linz,7258,4,9,6,9,26,28,-2,33
SC Rheindorf,7258,5,6,6,12,23,30,-7,24
Vienna,7258,6,6,6,12,25,41,-16,24
Mattersburg,7258,7,5,8,11,29,40,-11,23
FC Salzburg,7259,1,13,8,3,41,20,21,47
SK Sturm Gra,7259,2,12,5,7,32,28,4,41
LASK Linz,7259,3,9,6,9,27,26,1,33
Rapid Vienna,7259,4,7,10,7,34,30,4,31
Vienna,7259,5,7,6,11,28,39,-11,27
Mattersburg,7259,6,6,7,11,31,42,-11,25
SC Rheindorf,7259,7,6,6,12,19,27,-8,24
FC Salzburg,7260,1,13,8,3,42,19,23,47
SK Sturm Gra,7260,2,13,5,6,33,26,7,44
LASK Linz,7260,3,9,5,10,32,29,3,32
Rapid Vienna,7260,4,7,10,7,32,34,-2,31
Vienna,7260,5,8,5,11,26,38,-12,29
Mattersburg,7260,6,7,5,12,31,40,-9,26
SC Rheindorf,7260,7,5,6,13,19,29,-10,21
FC Salzburg,7261,1,14,6,4,45,23,22,48
SK Sturm Gra,7261,2,13,4,7,37,27,10,43
Rapid Vienna,7261,3,9,10,5,35,25,10,37
LASK Linz,7261,4,7,7,10,25,32,-7,28
Vienna,7261,5,7,6,11,29,39,-10,27
Mattersburg,7261,6,6,6,12,32,46,-14,24
SC Rheindorf,7261,7,5,7,12,19,30,-11,22
FC Salzburg,7262,1,15,7,2,48,16,32,52
SK Sturm Gra,7262,2,13,3,8,34,29,5,42
Rapid Vienna,7262,3,7,11,6,35,31,4,32
LASK Linz,7262,4,7,7,10,29,32,-3,28
Vienna,7262,5,7,6,11,24,37,-13,27
SC Rheindorf,7262,6,6,7,11,21,29,-8,25
Mattersburg,7262,7,6,5,13,29,46,-17,23
FC Salzburg,7263,1,16,6,2,47,18,29,54
SK Sturm Gra,7263,2,12,3,9,30,32,-2,39
LASK Linz,7263,3,8,8,8,31,29,2,32
Rapid Vienna,7263,4,7,10,7,34,29,5,31
SC Rheindorf,7263,5,7,6,11,20,26,-6,27
Mattersburg,7263,6,6,6,12,32,43,-11,24
Vienna,7263,7,6,5,13,26,43,-17,23
FC Salzburg,7264,1,14,7,3,42,18,24,49
SK Sturm Gra,7264,2,13,3,8,32,29,3,42
Rapid Vienna,7264,3,10,9,5,38,27,11,39
LASK Linz,7264,4,8,6,10,26,28,-2,30
Mattersburg,7264,5,8,5,11,34,41,-7,29
Vienna,7264,6,6,6,12,24,39,-15,24
SC Rheindorf,7264,7,4,6,14,17,31,-14,18
FC Salzburg,7265,1,15,7,2,46,18,28,52
SK Sturm Gra,7265,2,12,4,8,33,30,3,40
Rapid Vienna,7265,3,9,10,5,40,31,9,37
LASK Linz,7265,4,9,6,9,29,28,1,33
Vienna,7265,5,7,5,12,27,40,-13,26
Mattersburg,7265,6,5,6,13,27,43,-16,21
SC Rheindorf,7265,7,4,8,12,18,30,-12,20
FC Salzburg,7266,1,15,7,2,44,17,27,52
SK Sturm Gra,7266,2,11,4,9,30,29,1,37
Rapid Vienna,7266,3,8,11,5,36,28,8,35
LASK Linz,7266,4,9,6,9,29,29,0,33
SC Rheindorf,7266,5,6,6,12,21,28,-7,24
Mattersburg,7266,6,6,6,12,29,42,-13,24
Vienna,7266,7,6,6,12,23,39,-16,24
FC Salzburg,7267,1,13,8,3,45,21,24,47
SK Sturm Gra,7267,2,14,3,7,40,30,10,45
Rapid Vienna,7267,3,10,9,5,36,27,9,39
LASK Linz,7267,4,8,5,11,26,34,-8,29
Vienna,7267,5,7,6,11,26,39,-13,27
Mattersburg,7267,6,6,6,12,30,39,-9,24
SC Rheindorf,7267,7,5,5,14,21,34,-13,20
FC Salzburg,7268,1,14,8,2,45,17,28,50
SK Sturm Gra,7268,2,12,4,8,31,32,-1,40
Rapid Vienna,7268,3,8,10,6,35,27,8,34
LASK Linz,7268,4,9,6,9,31,28,3,33
Vienna,7268,5,7,6,11,27,39,-12,27
SC Rheindorf,7268,6,6,6,12,20,28,-8,24
Mattersburg,7268,7,5,6,13,27,45,-18,21
FC Salzburg,7269,1,15,6,3,47,19,28,51
SK Sturm Gra,7269,2,12,3,9,32,34,-2,39
Rapid Vienna,7269,3,8,10,6,33,25,8,34
LASK Linz,7269,4,9,6,9,27,27,0,33
Vienna,7269,5,8,5,11,28,38,-10,29
SC Rheindorf,7269,6,6,5,13,19,29,-10,23
Mattersburg,7269,7,6,5,13,28,42,-14,23
FC Salzburg,7270,1,15,7,2,46,16,30,52
SK Sturm Gra,7270,2,13,4,7,34,28,6,43
Rapid Vienna,7270,3,8,10,6,36,29,7,34
LASK Linz,7270,4,8,6,10,28,33,-5,30
Mattersburg,7270,5,6,6,12,31,43,-12,24
Vienna,7270,6,6,6,12,23,38,-15,24
SC Rheindorf,7270,7,5,7,12,21,32,-11,22
FC Salzburg,7271,1,14,7,3,46,19,27,49
SK Sturm Gra,7271,2,12,3,9,32,35,-3,39
LASK Linz,7271,3,10,5,9,31,28,3,35
Rapid Vienna,7271,4,8,10,6,35,28,7,34
Vienna,7271,5,7,6,11,27,40,-13,27
SC Rheindorf,7271,6,6,7,11,23,30,-7,25
Mattersburg,7271,7,5,6,13,30,44,-14,21
FC Salzburg,7272,1,13,8,3,45,21,24,47
Rapid Vienna,7272,2,9,10,5,36,26,10,37
SK Sturm Gra,7272,3,11,3,10,31,35,-4,36
LASK Linz,7272,4,10,5,9,28,28,0,35
Vienna,7272,5,8,5,11,26,38,-12,29
Mattersburg,7272,6,6,6,12,34,45,-11,24
SC Rheindorf,7272,7,6,5,13,25,32,-7,23
FC Salzburg,7273,1,16,6,2,46,18,28,54
SK Sturm Gra,7273,2,13,4,7,34,27,7,43
Rapid Vienna,7273,3,8,10,6,33,27,6,34
LASK Linz,7273,4,8,7,9,27,27,0,31
Vienna,7273,5,7,5,12,26,38,-12,26
Mattersburg,7273,6,6,5,13,30,45,-15,23
SC Rheindorf,7273,7,4,7,13,18,32,-14,19
FC Salzburg,7274,1,15,7,2,46,16,30,52
SK Sturm Gra,7274,2,13,5,6,34,27,7,44
LASK Linz,7274,3,9,6,9,29,29,0,33
Rapid Vienna,7274,4,7,11,6,33,28,5,32
Vienna,7274,5,7,5,12,26,44,-18,26
Mattersburg,7274,6,6,5,13,31,41,-10,23
SC Rheindorf,7274,7,4,7,13,21,35,-14,19
FC Salzburg,7275,1,14,7,3,48,19,29,49
SK Sturm Gra,7275,2,12,5,7,30,26,4,41
Rapid Vienna,7275,3,8,12,4,37,28,9,36
LASK Linz,7275,4,8,8,8,28,28,0,32
Vienna,7275,5,6,6,12,25,43,-18,24
Mattersburg,7275,6,5,7,12,30,44,-14,22
SC Rheindorf,7275,7,4,9,11,18,28,-10,21
FC Salzburg,7276,1,14,8,2,46,21,25,50
Rapid Vienna,7276,2,9,10,5,33,24,9,37
SK Sturm Gra,7276,3,11,3,10,30,31,-1,36
LASK Linz,7276,4,9,5,10,25,27,-2,32
Vienna,7276,5,7,6,11,29,41,-12,27
SC Rheindorf,7276,6,6,6,12,20,28,-8,24
Mattersburg,7276,7,6,6,12,30,41,-11,24
FC Salzburg,7277,1,16,6,2,50,17,33,54
SK Sturm Gra,7277,2,13,3,8,32,29,3,42
Rapid Vienna,7277,3,8,9,7,35,35,0,33
LASK Linz,7277,4,7,6,11,25,29,-4,27
SC Rheindorf,7277,5,7,6,11,23,27,-4,27
Mattersburg,7277,6,6,7,11,29,41,-12,25
Vienna,7277,7,6,5,13,25,41,-16,23
FC Salzburg,7278,1,14,7,3,44,20,24,49
SK Sturm Gra,7278,2,14,4,6,35,28,7,46
Rapid Vienna,7278,3,9,9,6,36,30,6,36
LASK Linz,7278,4,8,6,10,29,30,-1,30
Mattersburg,7278,5,8,5,11,33,39,-6,29
Vienna,7278,6,6,5,13,25,42,-17,23
SC Rheindorf,7278,7,4,6,14,20,33,-13,18
FC Salzburg,7279,1,15,6,3,50,19,31,51
SK Sturm Gra,7279,2,13,4,7,36,27,9,43
Rapid Vienna,7279,3,8,9,7,34,31,3,33
LASK Linz,7279,4,9,6,9,27,28,-1,33
Vienna,7279,5,7,5,12,25,41,-16,26
Mattersburg,7279,6,6,6,12,31,46,-15,24
SC Rheindorf,7279,7,4,8,12,18,29,-11,20
FC Salzburg,7280,1,15,7,2,46,16,30,52
SK Sturm Gra,7280,2,13,4,7,35,28,7,43
Rapid Vienna,7280,3,9,9,6,37,30,7,36
LASK Linz,7280,4,9,5,10,28,31,-3,32
Mattersburg,7280,5,7,5,12,31,41,-10,26
Vienna,7280,6,6,5,13,25,43,-18,23
SC Rheindorf,7280,7,5,5,14,20,33,-13,20
FC Salzburg,7281,1,14,6,4,45,20,25,48
SK Sturm Gra,7281,2,13,4,7,33,27,6,43
LASK Linz,7281,3,11,5,8,31,26,5,38
Rapid Vienna,7281,4,8,10,6,34,29,5,34
Vienna,7281,5,7,5,12,25,39,-14,26
SC Rheindorf,7281,6,5,7,12,18,27,-9,22
Mattersburg,7281,7,5,5,14,27,45,-18,20
FC Salzburg,7282,1,13,7,4,43,21,22,46
SK Sturm Gra,7282,2,13,4,7,34,27,7,43
Rapid Vienna,7282,3,9,10,5,37,28,9,37
LASK Linz,7282,4,8,5,11,25,30,-5,29
Mattersburg,7282,5,7,6,11,35,42,-7,27
Vienna,7282,6,6,7,11,25,39,-14,25
SC Rheindorf,7282,7,6,5,13,19,31,-12,23
FC Salzburg,7283,1,15,6,3,47,17,30,51
Rapid Vienna,7283,2,10,10,4,36,25,11,40
SK Sturm Gra,7283,3,12,4,8,31,31,0,40
LASK Linz,7283,4,8,6,10,28,31,-3,30
Vienna,7283,5,7,5,12,26,41,-15,26
Mattersburg,7283,6,6,5,13,27,40,-13,23
SC Rheindorf,7283,7,5,6,13,17,27,-10,21
FC Salzburg,7284,1,13,7,4,44,18,26,46
SK Sturm Gra,7284,2,13,4,7,32,29,3,43
Rapid Vienna,7284,3,9,9,6,36,27,9,36
LASK Linz,7284,4,8,5,11,24,29,-5,29
Vienna,7284,5,8,5,11,28,38,-10,29
SC Rheindorf,7284,6,7,5,12,23,28,-5,26
Mattersburg,7284,7,6,5,13,28,46,-18,23
FC Salzburg,7285,1,15,6,3,46,19,27,51
SK Sturm Gra,7285,2,11,5,8,33,31,2,38
Rapid Vienna,7285,3,9,10,5,37,27,10,37
LASK Linz,7285,4,9,7,8,29,28,1,34
Mattersburg,7285,5,7,6,11,33,42,-9,27
Vienna,7285,6,6,5,13,26,42,-16,23
SC Rheindorf,7285,7,4,7,13,18,33,-15,19
FC Salzburg,7286,1,15,7,2,43,16,27,52
SK Sturm Gra,7286,2,13,3,8,32,29,3,42
Rapid Vienna,7286,3,9,10,5,37,27,10,37
LASK Linz,7286,4,10,5,9,30,27,3,35
Vienna,7286,5,7,5,12,24,38,-14,26
Mattersburg,7286,6,6,5,13,28,40,-12,23
SC Rheindorf,7286,7,4,5,15,15,32,-17,17
FC Salzburg,7287,1,14,7,3,46,20,26,49
SK Sturm Gra,7287,2,14,3,7,40,25,15,45
Rapid Vienna,7287,3,7,11,6,34,31,3,32
LASK Linz,7287,4,9,5,10,27,32,-5,32
SC Rheindorf,7287,5,7,6,11,19,26,-7,27
Vienna,7287,6,7,5,12,27,40,-13,26
Mattersburg,7287,7,5,5,14,28,47,-19,20
FC Salzburg,7288,1,16,6,2,53,19,34,54
SK Sturm Gra,7288,2,12,4,8,35,32,3,40
Rapid Vienna,7288,3,9,10,5,41,30,11,37
LASK Linz,7288,4,7,6,11,28,36,-8,27
Vienna,7288,5,7,5,12,28,42,-14,26
Mattersburg,7288,6,6,6,12,33,48,-15,24
SC Rheindorf,7288,7,5,7,12,21,32,-11,22
FC Salzburg,7289,1,15,6,3,49,18,31,51
SK Sturm Gra,7289,2,13,4,7,31,25,6,43
LASK Linz,7289,3,10,5,9,29,27,2,35
Rapid Vienna,7289,4,8,9,7,35,33,2,33
Mattersburg,7289,5,7,5,12,32,40,-8,26
Vienna,7289,6,7,5,12,25,41,-16,26
SC Rheindorf,7289,7,4,6,14,16,33,-17,18
FC Salzburg,7290,1,12,8,4,40,21,19,44
SK Sturm Gra,7290,2,13,4,7,34,29,5,43
Rapid Vienna,7290,3,9,10,5,37,26,11,37
LASK Linz,7290,4,8,6,10,29,32,-3,30
Vienna,7290,5,7,6,11,26,39,-13,27
Mattersburg,7290,6,6,7,11,34,43,-9,25
SC Rheindorf,7290,7,5,7,12,19,29,-10,22
FC Salzburg,7291,1,14,7,3,44,20,24,49
SK Sturm Gra,7291,2,12,5,7,36,32,4,41
LASK Linz,7291,3,9,7,8,30,29,1,34
Rapid Vienna,7291,4,7,12,5,39,32,7,33
Vienna,7291,5,8,5,11,27,39,-12,29
Mattersburg,7291,6,6,5,13,31,43,-12,23
SC Rheindorf,7291,7,5,5,14,18,30,-12,20
FC Salzburg,7292,1,16,6,2,45,15,30,54
SK Sturm Gra,7292,2,14,3,7,36,28,8,45
Rapid Vienna,7292,3,8,9,7,34,30,4,33
LASK Linz,7292,4,8,6,10,30,31,-1,30
Mattersburg,7292,5,7,6,11,33,41,-8,27
Vienna,7292,6,6,5,13,23,40,-17,23
SC Rheindorf,7292,7,5,5,14,18,34,-16,20
FC Salzburg,7293,1,16,6,2,48,16,32,54
SK Sturm Gra,7293,2,13,4,7,33,29,4,43
Rapid Vienna,7293,3,9,9,6,37,26,11,36
LASK Linz,7293,4,8,5,11,25,30,-5,29
Vienna,7293,5,7,5,12,25,41,-16,26
Mattersburg,7293,6,6,5,13,30,42,-12,23
SC Rheindorf,7293,7,5,6,13,18,32,-14,21
FC Salzburg,7294,1,15,6,3,46,20,26,51
SK Sturm Gra,7294,2,12,3,9,31,33,-2,39
Rapid Vienna,7294,3,9,11,4,36,26,10,38
Mattersburg,7294,4,8,5,11,36,40,-4,29
LASK Linz,7294,5,7,6,11,24,28,-4,27
SC Rheindorf,7294,6,6,6,12,21,29,-8,24
Vienna,7294,7,6,5,13,23,41,-18,23
FC Salzburg,7295,1,15,6,3,45,18,27,51
SK Sturm Gra,7295,2,13,4,7,31,26,5,43
Rapid Vienna,7295,3,8,9,7,33,28,5,33
LASK Linz,7295,4,8,5,11,26,31,-5,29
Mattersburg,7295,5,7,6,11,35,44,-9,27
Vienna,7295,6,7,5,12,27,41,-14,26
SC Rheindorf,7295,7,5,7,12,22,31,-9,22
FC Salzburg,7296,1,15,7,2,47,16,31,52
SK Sturm Gra,7296,2,14,3,7,36,26,10,45
Rapid Vienna,7296,3,9,10,5,36,27,9,37
LASK Linz,7296,4,8,5,11,28,35,-7,29
Mattersburg,7296,5,6,6,12,31,45,-14,24
Vienna,7296,6,6,6,12,26,42,-16,24
SC Rheindorf,7296,7,5,5,14,20,33,-13,20
FC Salzburg,7297,1,14,7,3,50,19,31,49
SK Sturm Gra,7297,2,12,3,9,30,33,-3,39
Rapid Vienna,7297,3,8,11,5,35,27,8,35
LASK Linz,7297,4,9,5,10,28,30,-2,32
SC Rheindorf,7297,5,7,6,11,24,29,-5,27
Vienna,7297,6,7,5,12,28,41,-13,26
Mattersburg,7297,7,6,5,13,31,47,-16,23
FC Salzburg,7298,1,13,7,4,44,23,21,46
SK Sturm Gra,7298,2,12,4,8,32,30,2,40
Rapid Vienna,7298,3,10,9,5,37,27,10,39
LASK Linz,7298,4,7,7,10,27,31,-4,28
Mattersburg,7298,5,7,7,10,30,38,-8,28
Vienna,7298,6,7,5,12,28,40,-12,26
SC Rheindorf,7298,7,5,7,12,20,29,-9,22
FC Salzburg,7299,1,15,6,3,43,16,27,51
SK Sturm Gra,7299,2,13,4,7,33,29,4,43
Rapid Vienna,7299,3,9,10,5,39,29,10,37
LASK Linz,7299,4,9,5,10,31,30,1,32
Mattersburg,7299,5,6,5,13,29,42,-13,23
Vienna,7299,6,6,5,13,23,41,-18,23
SC Rheindorf,7299,7,5,7,12,21,32,-11,22
FC Salzburg,7300,1,14,7,3,45,19,26,49
SK Sturm Gra,7300,2,13,5,6,34,27,7,44
Rapid Vienna,7300,3,9,10,5,39,28,11,37
LASK Linz,7300,4,8,5,11,26,29,-3,29
Mattersburg,7300,5,8,5,11,30,40,-10,29
Vienna,7300,6,6,5,13,23,40,-17,23
SC Rheindorf,7300,7,5,5,14,16,30,-14,20
FC Salzburg,7301,1,14,8,2,44,18,26,50
SK Sturm Gra,7301,2,12,4,8,32,29,3,40
Rapid Vienna,7301,3,8,9,7,34,30,4,33
LASK Linz,7301,4,9,6,9,27,27,0,33
Mattersburg,7301,5,7,6,11,32,40,-8,27
Vienna,7301,6,6,6,12,25,41,-16,24
SC Rheindorf,7301,7,6,5,13,18,27,-9,23
FC Salzburg,7302,1,14,7,3,44,18,26,49
SK Sturm Gra,7302,2,11,7,6,32,28,4,40
Rapid Vienna,7302,3,9,11,4,38,26,12,38
LASK Linz,7302,4,8,7,9,27,31,-4,31
Vienna,7302,5,7,5,12,25,40,-15,26
Mattersburg,7302,6,6,5,13,28,42,-14,23
SC Rheindorf,7302,7,5,6,13,20,29,-9,21
FC Salzburg,7303,1,14,6,4,44,20,24,48
SK Sturm Gra,7303,2,13,4,7,35,27,8,43
Rapid Vienna,7303,3,8,10,6,33,28,5,34
LASK Linz,7303,4,8,6,10,25,28,-3,30
Mattersburg,7303,5,8,5,11,32,40,-8,29
Vienna,7303,6,8,5,11,29,39,-10,29
SC Rheindorf,7303,7,4,6,14,16,32,-16,18
FC Salzburg,7304,1,16,6,2,45,15,30,54
SK Sturm Gra,7304,2,12,5,7,32,28,4,41
Rapid Vienna,7304,3,9,10,5,36,26,10,37
LASK Linz,7304,4,8,6,10,29,31,-2,30
Mattersburg,7304,5,7,5,12,30,38,-8,26
Vienna,7304,6,6,5,13,23,43,-20,23
SC Rheindorf,7304,7,5,5,14,17,31,-14,20
FC Salzburg,7305,1,13,6,5,42,21,21,45
SK Sturm Gra,7305,2,13,4,7,35,30,5,43
Rapid Vienna,7305,3,10,9,5,36,26,10,39
LASK Linz,7305,4,8,6,10,29,32,-3,30
Vienna,7305,5,7,6,11,27,39,-12,27
Mattersburg,7305,6,6,7,11,30,41,-11,25
SC Rheindorf,7305,7,5,6,13,22,32,-10,21
FC Salzburg,7306,1,15,7,2,47,17,30,52
Rapid Vienna,7306,2,10,10,4,43,26,17,40
SK Sturm Gra,7306,3,12,3,9,29,30,-1,39
LASK Linz,7306,4,7,6,11,26,30,-4,27
SC Rheindorf,7306,5,6,6,12,20,33,-13,24
Vienna,7306,6,6,6,12,24,41,-17,24
Mattersburg,7306,7,5,8,11,30,42,-12,23
FC Salzburg,7307,1,15,6,3,47,20,27,51
SK Sturm Gra,7307,2,14,3,7,39,27,12,45
Rapid Vienna,7307,3,9,9,6,33,28,5,36
LASK Linz,7307,4,7,6,11,24,31,-7,27
Vienna,7307,5,7,5,12,27,41,-14,26
Mattersburg,7307,6,6,6,12,32,45,-13,24
SC Rheindorf,7307,7,5,7,12,18,28,-10,22
FC Salzburg,7308,1,13,8,3,44,20,24,47
SK Sturm Gra,7308,2,12,5,7,31,27,4,41
Rapid Vienna,7308,3,10,10,4,42,27,15,40
LASK Linz,7308,4,9,6,9,28,28,0,33
Vienna,7308,5,7,6,11,26,39,-13,27
Mattersburg,7308,6,6,5,13,29,43,-14,23
SC Rheindorf,7308,7,4,6,14,17,33,-16,18
FC Salzburg,7309,1,13,7,4,41,20,21,46
Rapid Vienna,7309,2,9,11,4,37,26,11,38
SK Sturm Gra,7309,3,11,5,8,31,29,2,38
LASK Linz,7309,4,9,6,9,27,28,-1,33
Mattersburg,7309,5,8,5,11,31,37,-6,29
Vienna,7309,6,7,5,12,25,39,-14,26
SC Rheindorf,7309,7,5,5,14,17,30,-13,20
FC Salzburg,7310,1,13,8,3,45,21,24,47
SK Sturm Gra,7310,2,12,4,8,30,29,1,40
Rapid Vienna,7310,3,7,11,6,35,29,6,32
LASK Linz,7310,4,9,5,10,27,31,-4,32
Mattersburg,7310,5,7,6,11,32,41,-9,27
SC Rheindorf,7310,6,7,5,12,23,28,-5,26
Vienna,7310,7,7,5,12,27,40,-13,26
FC Salzburg,7311,1,15,7,2,48,17,31,52
SK Sturm Gra,7311,2,11,7,6,31,27,4,40
Rapid Vienna,7311,3,8,10,6,34,29,5,34
LASK Linz,7311,4,9,6,9,28,28,0,33
Mattersburg,7311,5,8,5,11,30,41,-11,29
Vienna,7311,6,6,5,13,24,40,-16,23
SC Rheindorf,7311,7,4,6,14,15,28,-13,18
FC Salzburg,7312,1,16,6,2,45,17,28,54
SK Sturm Gra,7312,2,11,5,8,29,28,1,38
Rapid Vienna,7312,3,8,11,5,33,25,8,35
LASK Linz,7312,4,9,7,8,28,26,2,34
Vienna,7312,5,7,5,12,25,38,-13,26
Mattersburg,7312,6,6,5,13,30,44,-14,23
SC Rheindorf,7312,7,4,7,13,16,28,-12,19
FC Salzburg,7313,1,16,6,2,50,18,32,54
SK Sturm Gra,7313,2,13,4,7,32,30,2,43
Rapid Vienna,7313,3,8,9,7,33,29,4,33
LASK Linz,7313,4,8,5,11,26,28,-2,29
Vienna,7313,5,7,5,12,27,39,-12,26
Mattersburg,7313,6,6,6,12,31,45,-14,24
SC Rheindorf,7313,7,5,7,12,18,28,-10,22
FC Salzburg,7314,1,15,7,2,50,17,33,52
SK Sturm Gra,7314,2,13,4,7,33,27,6,43
Rapid Vienna,7314,3,7,10,7,33,32,1,31
LASK Linz,7314,4,7,7,10,25,29,-4,28
Vienna,7314,5,7,5,12,26,39,-13,26
SC Rheindorf,7314,6,6,7,11,20,27,-7,25
Mattersburg,7314,7,6,6,12,29,45,-16,24
SK Sturm Gra,7315,1,14,4,6,35,25,10,46
FC Salzburg,7315,2,12,9,3,43,22,21,45
Rapid Vienna,7315,3,7,12,5,34,28,6,33
LASK Linz,7315,4,7,8,9,26,28,-2,29
Mattersburg,7315,5,6,8,10,31,39,-8,26
Vienna,7315,6,6,7,11,26,40,-14,25
SC Rheindorf,7315,7,5,6,13,16,29,-13,21
FC Salzburg,7316,1,14,8,2,47,18,29,50
SK Sturm Gra,7316,2,13,4,7,35,28,7,43
Rapid Vienna,7316,3,8,9,7,36,30,6,33
LASK Linz,7316,4,8,5,11,27,32,-5,29
Mattersburg,7316,5,8,5,11,31,43,-12,29
Vienna,7316,6,6,6,12,25,40,-15,24
SC Rheindorf,7316,7,6,5,13,18,28,-10,23
FC Salzburg,7317,1,14,8,2,45,20,25,50
SK Sturm Gra,7317,2,12,5,7,33,30,3,41
Rapid Vienna,7317,3,9,10,5,37,27,10,37
LASK Linz,7317,4,7,8,9,25,30,-5,29
Vienna,7317,5,7,5,12,27,39,-12,26
Mattersburg,7317,6,6,6,12,35,45,-10,24
SC Rheindorf,7317,7,5,6,13,20,31,-11,21
FC Salzburg,7318,1,16,6,2,50,15,35,54
SK Sturm Gra,7318,2,11,5,8,33,34,-1,38
Rapid Vienna,7318,3,8,11,5,37,31,6,35
LASK Linz,7318,4,8,8,8,27,27,0,32
Mattersburg,7318,5,6,7,11,30,40,-10,25
Vienna,7318,6,6,5,13,23,41,-18,23
SC Rheindorf,7318,7,4,8,12,21,33,-12,20
FC Salzburg,7319,1,14,6,4,45,21,24,48
SK Sturm Gra,7319,2,15,3,6,40,27,13,48
Rapid Vienna,7319,3,9,9,6,36,28,8,36
LASK Linz,7319,4,8,5,11,24,30,-6,29
Mattersburg,7319,5,7,5,12,31,42,-11,26
Vienna,7319,6,7,5,12,26,39,-13,26
SC Rheindorf,7319,7,5,5,14,17,32,-15,20
FC Salzburg,7320,1,13,7,4,40,18,22,46
SK Sturm Gra,7320,2,14,3,7,35,29,6,45
Rapid Vienna,7320,3,7,10,7,32,27,5,31
LASK Linz,7320,4,8,7,9,25,26,-1,31
Mattersburg,7320,5,7,7,10,32,38,-6,28
Vienna,7320,6,7,5,12,27,42,-15,26
SC Rheindorf,7320,7,6,5,13,21,32,-11,23
FC Salzburg,7321,1,14,7,3,44,20,24,49
SK Sturm Gra,7321,2,13,4,7,35,28,7,43
Rapid Vienna,7321,3,10,10,4,39,24,15,40
LASK Linz,7321,4,9,5,10,27,30,-3,32
Vienna,7321,5,7,5,12,25,39,-14,26
Mattersburg,7321,6,6,5,13,30,42,-12,23
SC Rheindorf,7321,7,4,6,14,16,33,-17,18
FC Salzburg,7322,1,14,6,4,48,19,29,48
SK Sturm Gra,7322,2,13,4,7,31,28,3,43
Rapid Vienna,7322,3,8,10,6,34,27,7,34
LASK Linz,7322,4,8,7,9,27,28,-1,31
Vienna,7322,5,7,5,12,27,41,-14,26
SC Rheindorf,7322,6,6,6,12,20,28,-8,24
Mattersburg,7322,7,6,6,12,32,48,-16,24
FC Salzburg,7323,1,15,7,2,46,18,28,52
SK Sturm Gra,7323,2,12,4,8,30,29,1,40
Rapid Vienna,7323,3,8,11,5,35,26,9,35
LASK Linz,7323,4,8,8,8,28,27,1,32
Vienna,7323,5,7,5,12,26,40,-14,26
Mattersburg,7323,6,5,7,12,28,41,-13,22
SC Rheindorf,7323,7,5,6,13,17,29,-12,21
FC Salzburg,7324,1,15,6,3,47,22,25,51
SK Sturm Gra,7324,2,13,4,7,31,27,4,43
Rapid Vienna,7324,3,9,10,5,37,26,11,37
LASK Linz,7324,4,8,6,10,25,28,-3,30
SC Rheindorf,7324,5,6,6,12,20,29,-9,24
Mattersburg,7324,6,6,5,13,32,43,-11,23
Vienna,7324,7,6,5,13,25,42,-17,23
FC Salzburg,7325,1,16,6,2,49,17,32,54
SK Sturm Gra,7325,2,13,4,7,33,28,5,43
Rapid Vienna,7325,3,9,9,6,38,26,12,36
LASK Linz,7325,4,8,7,9,29,31,-2,31
Vienna,7325,5,6,6,12,25,42,-17,24
Mattersburg,7325,6,5,8,11,30,44,-14,23
SC Rheindorf,7325,7,4,6,14,16,32,-16,18
FC Salzburg,7326,1,14,6,4,44,19,25,48
SK Sturm Gra,7326,2,14,4,6,35,27,8,46
Rapid Vienna,7326,3,9,10,5,35,26,9,37
LASK Linz,7326,4,8,7,9,28,30,-2,31
Vienna,7326,5,7,5,12,26,40,-14,26
Mattersburg,7326,6,6,5,13,30,43,-13,23
SC Rheindorf,7326,7,5,5,14,18,31,-13,20
FC Salzburg,7327,1,14,7,3,43,18,25,49
SK Sturm Gra,7327,2,13,4,7,34,29,5,43
Rapid Vienna,7327,3,9,9,6,35,27,8,36
LASK Linz,7327,4,8,6,10,25,30,-5,30
Mattersburg,7327,5,8,5,11,33,39,-6,29
Vienna,7327,6,6,5,13,23,40,-17,23
SC Rheindorf,7327,7,5,6,13,18,28,-10,21
FC Salzburg,7328,1,15,6,3,45,18,27,51
SK Sturm Gra,7328,2,11,4,9,30,30,0,37
Rapid Vienna,7328,3,9,9,6,36,28,8,36
LASK Linz,7328,4,10,6,8,28,26,2,36
SC Rheindorf,7328,5,7,5,12,21,29,-8,26
Vienna,7328,6,6,6,12,26,41,-15,24
Mattersburg,7328,7,5,6,13,31,45,-14,21
FC Salzburg,7329,1,13,7,4,42,21,21,46
SK Sturm Gra,7329,2,13,5,6,33,26,7,44
Rapid Vienna,7329,3,8,11,5,36,27,9,35
LASK Linz,7329,4,9,5,10,27,29,-2,32
Mattersburg,7329,5,7,6,11,32,42,-10,27
Vienna,7329,6,7,5,12,26,39,-13,26
SC Rheindorf,7329,7,4,7,13,18,30,-12,19
FC Salzburg,7330,1,15,7,2,45,17,28,52
SK Sturm Gra,7330,2,13,3,8,34,30,4,42
LASK Linz,7330,3,9,6,9,27,28,-1,33
Rapid Vienna,7330,4,7,11,6,32,26,6,32
Vienna,7330,5,7,5,12,26,41,-15,26
SC Rheindorf,7330,6,6,7,11,18,26,-8,25
Mattersburg,7330,7,5,5,14,29,43,-14,20
FC Salzburg,7331,1,14,8,2,48,19,29,50
SK Sturm Gra,7331,2,12,4,8,31,30,1,40
LASK Linz,7331,3,9,7,8,26,24,2,34
Rapid Vienna,7331,4,7,12,5,34,27,7,33
Vienna,7331,5,7,5,12,32,42,-10,26
SC Rheindorf,7331,6,6,5,13,19,30,-11,23
Mattersburg,7331,7,5,7,12,28,46,-18,22
FC Salzburg,7332,1,14,8,2,44,18,26,50
SK Sturm Gra,7332,2,12,3,9,31,31,0,39
Rapid Vienna,7332,3,9,11,4,38,24,14,38
LASK Linz,7332,4,7,7,10,24,31,-7,28
Mattersburg,7332,5,7,6,11,35,42,-7,27
Vienna,7332,6,6,6,12,25,40,-15,24
SC Rheindorf,7332,7,5,7,12,18,29,-11,22
FC Salzburg,7333,1,14,8,2,42,16,26,50
SK Sturm Gra,7333,2,13,4,7,31,27,4,43
Rapid Vienna,7333,3,8,12,4,34,25,9,36
LASK Linz,7333,4,7,6,11,24,29,-5,27
Vienna,7333,5,7,5,12,26,40,-14,26
Mattersburg,7333,6,6,7,11,31,41,-10,25
SC Rheindorf,7333,7,5,6,13,18,28,-10,21
FC Salzburg,7334,1,14,7,3,42,20,22,49
SK Sturm Gra,7334,2,13,4,7,33,29,4,43
Rapid Vienna,7334,3,7,11,6,34,29,5,32
Vienna,7334,4,8,5,11,30,37,-7,29
LASK Linz,7334,5,7,7,10,27,30,-3,28
Mattersburg,7334,6,7,5,12,28,40,-12,26
SC Rheindorf,7334,7,6,5,13,21,30,-9,23
FC Salzburg,7335,1,15,6,3,48,22,26,51
SK Sturm Gra,7335,2,12,5,7,34,31,3,41
Rapid Vienna,7335,3,9,10,5,37,28,9,37
Vienna,7335,4,8,5,11,29,38,-9,29
LASK Linz,7335,5,7,6,11,28,32,-4,27
Mattersburg,7335,6,6,6,12,31,44,-13,24
SC Rheindorf,7335,7,5,6,13,17,29,-12,21
FC Salzburg,7336,1,15,6,3,46,21,25,51
SK Sturm Gra,7336,2,12,5,7,35,31,4,41
Rapid Vienna,7336,3,8,10,6,39,33,6,34
LASK Linz,7336,4,9,5,10,30,30,0,32
Mattersburg,7336,5,8,6,10,35,39,-4,30
Vienna,7336,6,6,6,12,24,40,-16,24
SC Rheindorf,7336,7,4,6,14,18,33,-15,18
FC Salzburg,7337,1,14,6,4,47,23,24,48
SK Sturm Gra,7337,2,13,4,7,35,28,7,43
Rapid Vienna,7337,3,9,10,5,37,28,9,37
Vienna,7337,4,8,5,11,28,40,-12,29
LASK Linz,7337,5,7,7,10,27,30,-3,28
Mattersburg,7337,6,7,5,12,32,43,-11,26
SC Rheindorf,7337,7,4,7,13,17,31,-14,19
FC Salzburg,7338,1,15,6,3,48,20,28,51
SK Sturm Gra,7338,2,13,3,8,32,29,3,42
LASK Linz,7338,3,8,7,9,26,27,-1,31
Rapid Vienna,7338,4,7,9,8,34,31,3,30
Vienna,7338,5,7,6,11,28,41,-13,27
Mattersburg,7338,6,6,7,11,30,41,-11,25
SC Rheindorf,7338,7,6,6,12,19,28,-9,24
FC Salzburg,7339,1,16,6,2,46,18,28,54
Rapid Vienna,7339,2,10,9,5,41,30,11,39
SK Sturm Gra,7339,3,12,3,9,33,33,0,39
LASK Linz,7339,4,8,6,10,28,29,-1,30
Vienna,7339,5,7,5,12,26,40,-14,26
Mattersburg,7339,6,6,6,12,31,42,-11,24
SC Rheindorf,7339,7,5,5,14,19,32,-13,20
FC Salzburg,7340,1,14,8,2,42,16,26,50
SK Sturm Gra,7340,2,12,5,7,35,28,7,41
Rapid Vienna,7340,3,8,10,6,35,29,6,34
LASK Linz,7340,4,9,5,10,28,34,-6,32
Mattersburg,7340,5,7,5,12,35,41,-6,26
Vienna,7340,6,7,5,12,27,42,-15,26
SC Rheindorf,7340,7,5,6,13,18,30,-12,21
FC Salzburg,7341,1,14,7,3,43,18,25,49
SK Sturm Gra,7341,2,13,4,7,32,28,4,43
Rapid Vienna,7341,3,8,9,7,38,34,4,33
Vienna,7341,4,8,5,11,29,39,-10,29
LASK Linz,7341,5,7,7,10,25,29,-4,28
Mattersburg,7341,6,6,7,11,31,40,-9,25
SC Rheindorf,7341,7,5,7,12,21,31,-10,22
FC Salzburg,7342,1,14,8,2,44,18,26,50
Rapid Vienna,7342,2,9,11,4,39,28,11,38
SK Sturm Gra,7342,3,11,5,8,32,30,2,38
LASK Linz,7342,4,8,6,10,26,31,-5,30
Mattersburg,7342,5,7,5,12,32,41,-9,26
Vienna,7342,6,7,5,12,25,38,-13,26
SC Rheindorf,7342,7,5,6,13,19,31,-12,21
FC Salzburg,7343,1,15,6,3,48,21,27,51
SK Sturm Gra,7343,2,12,4,8,33,29,4,40
Rapid Vienna,7343,3,9,9,6,36,29,7,36
LASK Linz,7343,4,9,6,9,29,30,-1,33
SC Rheindorf,7343,5,7,5,12,22,28,-6,26
Mattersburg,7343,6,6,5,13,32,44,-12,23
Vienna,7343,7,6,5,13,25,44,-19,23
FC Salzburg,7344,1,15,7,2,49,16,33,52
SK Sturm Gra,7344,2,12,4,8,33,31,2,40
Rapid Vienna,7344,3,9,10,5,36,26,10,37
LASK Linz,7344,4,8,6,10,27,29,-2,30
Vienna,7344,5,7,5,12,25,44,-19,26
Mattersburg,7344,6,6,5,13,32,43,-11,23
SC Rheindorf,7344,7,6,5,13,21,34,-13,23
FC Salzburg,7345,1,15,7,2,50,19,31,52
SK Sturm Gra,7345,2,14,3,7,37,32,5,45
Rapid Vienna,7345,3,9,10,5,35,27,8,37
LASK Linz,7345,4,8,5,11,25,32,-7,29
Vienna,7345,5,7,5,12,26,38,-12,26
Mattersburg,7345,6,6,5,13,31,46,-15,23
SC Rheindorf,7345,7,5,5,14,20,30,-10,20
FC Salzburg,7346,1,13,9,2,43,19,24,48
SK Sturm Gra,7346,2,11,4,9,29,30,-1,37
Rapid Vienna,7346,3,9,9,6,39,27,12,36
LASK Linz,7346,4,10,6,8,28,26,2,36
Mattersburg,7346,5,7,7,10,36,41,-5,28
Vienna,7346,6,6,6,12,24,39,-15,24
SC Rheindorf,7346,7,5,5,14,19,36,-17,20
FC Salzburg,7347,1,15,7,2,49,16,33,52
SK Sturm Gra,7347,2,12,4,8,34,35,-1,40
Rapid Vienna,7347,3,8,10,6,34,28,6,34
LASK Linz,7347,4,8,6,10,28,30,-2,30
Vienna,7347,5,7,5,12,24,38,-14,26
Mattersburg,7347,6,6,6,12,31,42,-11,24
SC Rheindorf,7347,7,6,6,12,21,32,-11,24
FC Salzburg,7348,1,15,6,3,50,20,30,51
SK Sturm Gra,7348,2,11,5,8,31,31,0,38
Rapid Vienna,7348,3,9,10,5,37,29,8,37
LASK Linz,7348,4,9,5,10,28,27,1,32
Vienna,7348,5,7,5,12,27,42,-15,26
SC Rheindorf,7348,6,6,6,12,19,28,-9,24
Mattersburg,7348,7,6,5,13,30,45,-15,23
FC Salzburg,7349,1,14,7,3,44,18,26,49
SK Sturm Gra,7349,2,11,5,8,29,29,0,38
Rapid Vienna,7349,3,8,12,4,37,27,10,36
LASK Linz,7349,4,7,7,10,26,30,-4,28
Mattersburg,7349,5,7,6,11,32,40,-8,27
Vienna,7349,6,7,6,11,25,38,-13,27
SC Rheindorf,7349,7,5,7,12,19,30,-11,22
FC Salzburg,7350,1,14,8,2,47,17,30,50
SK Sturm Gra,7350,2,13,3,8,33,30,3,42
Rapid Vienna,7350,3,9,10,5,37,28,9,37
Mattersburg,7350,4,8,5,11,34,43,-9,29
LASK Linz,7350,5,7,6,11,26,32,-6,27
Vienna,7350,6,6,6,12,25,40,-15,24
SC Rheindorf,7350,7,5,6,13,18,30,-12,21
FC Salzburg,7351,1,14,6,4,43,18,25,48
SK Sturm Gra,7351,2,14,3,7,33,27,6,45
Rapid Vienna,7351,3,8,9,7,36,31,5,33
LASK Linz,7351,4,8,6,10,27,29,-2,30
Vienna,7351,5,7,6,11,25,37,-12,27
SC Rheindorf,7351,6,6,6,12,21,29,-8,24
Mattersburg,7351,7,5,8,11,27,41,-14,23
FC Salzburg,7352,1,16,6,2,47,15,32,54
SK Sturm Gra,7352,2,11,5,8,30,28,2,38
Rapid Vienna,7352,3,9,10,5,35,26,9,37
LASK Linz,7352,4,9,7,8,29,26,3,34
Vienna,7352,5,7,5,12,26,39,-13,26
Mattersburg,7352,6,6,5,13,27,44,-17,23
SC Rheindorf,7352,7,4,6,14,17,33,-16,18
FC Salzburg,7353,1,16,6,2,48,16,32,54
SK Sturm Gra,7353,2,14,3,7,35,27,8,45
LASK Linz,7353,3,9,5,10,28,28,0,32
Rapid Vienna,7353,4,7,10,7,32,30,2,31
Vienna,7353,5,7,5,12,26,40,-14,26
Mattersburg,7353,6,6,5,13,28,44,-16,23
SC Rheindorf,7353,7,5,6,13,16,28,-12,21
FC Salzburg,7354,1,13,7,4,41,20,21,46
SK Sturm Gra,7354,2,13,4,7,33,28,5,43
Rapid Vienna,7354,3,8,11,5,35,28,7,35
LASK Linz,7354,4,9,6,9,30,28,2,33
Mattersburg,7354,5,7,7,10,35,40,-5,28
Vienna,7354,6,6,6,12,25,40,-15,24
SC Rheindorf,7354,7,5,5,14,16,31,-15,20
FC Salzburg,7355,1,16,6,2,46,15,31,54
SK Sturm Gra,7355,2,13,3,8,34,28,6,42
Rapid Vienna,7355,3,8,9,7,34,32,2,33
LASK Linz,7355,4,9,5,10,31,29,2,32
Vienna,7355,5,7,5,12,26,40,-14,26
Mattersburg,7355,6,6,6,12,30,43,-13,24
SC Rheindorf,7355,7,5,6,13,17,31,-14,21
FC Salzburg,7356,1,14,7,3,42,18,24,49
SK Sturm Gra,7356,2,13,4,7,35,29,6,43
Rapid Vienna,7356,3,9,10,5,35,27,8,37
LASK Linz,7356,4,8,6,10,27,30,-3,30
Mattersburg,7356,5,6,7,11,28,38,-10,25
Vienna,7356,6,6,6,12,24,39,-15,24
SC Rheindorf,7356,7,5,6,13,19,29,-10,21
FC Salzburg,7357,1,15,7,2,53,19,34,52
SK Sturm Gra,7357,2,14,3,7,36,26,10,45
Rapid Vienna,7357,3,8,9,7,35,34,1,33
LASK Linz,7357,4,9,5,10,26,28,-2,32
Mattersburg,7357,5,8,5,11,35,43,-8,29
Vienna,7357,6,6,6,12,25,43,-18,24
SC Rheindorf,7357,7,4,5,15,17,34,-17,17
FC Salzburg,7358,1,14,7,3,44,21,23,49
Rapid Vienna,7358,2,10,9,5,35,25,10,39
SK Sturm Gra,7358,3,11,5,8,34,32,2,38
LASK Linz,7358,4,8,6,10,27,29,-2,30
Mattersburg,7358,5,7,6,11,30,39,-9,27
SC Rheindorf,7358,6,6,6,12,20,28,-8,24
Vienna,7358,7,6,5,13,25,41,-16,23
FC Salzburg,7359,1,15,7,2,45,16,29,52
SK Sturm Gra,7359,2,12,4,8,31,29,2,40
LASK Linz,7359,3,11,5,8,36,29,7,38
Rapid Vienna,7359,4,7,10,7,33,29,4,31
Vienna,7359,5,6,7,11,25,39,-14,25
Mattersburg,7359,6,5,7,12,32,48,-16,22
SC Rheindorf,7359,7,5,6,13,19,31,-12,21
FC Salzburg,7360,1,14,6,4,40,18,22,48
SK Sturm Gra,7360,2,13,3,8,33,29,4,42
Rapid Vienna,7360,3,9,10,5,39,27,12,37
Mattersburg,7360,4,9,5,10,35,39,-4,32
LASK Linz,7360,5,7,5,12,29,37,-8,26
SC Rheindorf,7360,6,6,6,12,21,30,-9,24
Vienna,7360,7,6,5,13,23,40,-17,23
FC Salzburg,7361,1,16,6,2,46,17,29,54
SK Sturm Gra,7361,2,12,4,8,32,30,2,40
Rapid Vienna,7361,3,8,11,5,37,29,8,35
LASK Linz,7361,4,8,7,9,29,30,-1,31
Mattersburg,7361,5,7,5,12,34,43,-9,26
Vienna,7361,6,6,5,13,25,42,-17,23
SC Rheindorf,7361,7,4,8,12,17,29,-12,20
FC Salzburg,7362,1,14,7,3,46,20,26,49
SK Sturm Gra,7362,2,12,4,8,32,29,3,40
Rapid Vienna,7362,3,9,11,4,35,25,10,38
LASK Linz,7362,4,8,6,10,26,28,-2,30
Mattersburg,7362,5,7,5,12,32,42,-10,26
SC Rheindorf,7362,6,6,6,12,19,28,-9,24
Vienna,7362,7,6,5,13,24,42,-18,23
FC Salzburg,7363,1,16,6,2,48,17,31,54
SK Sturm Gra,7363,2,12,3,9,32,30,2,39
Rapid Vienna,7363,3,8,10,6,34,27,7,34
LASK Linz,7363,4,9,5,10,28,31,-3,32
Vienna,7363,5,7,5,12,24,41,-17,26
Mattersburg,7363,6,6,6,12,32,41,-9,24
SC Rheindorf,7363,7,5,7,12,20,31,-11,22
FC Salzburg,7364,1,14,7,3,45,24,21,49
Rapid Vienna,7364,2,10,10,4,41,26,15,40
SK Sturm Gra,7364,3,11,5,8,31,29,2,38
LASK Linz,7364,4,9,5,10,29,30,-1,32
Mattersburg,7364,5,7,5,12,29,42,-13,26
SC Rheindorf,7364,6,6,5,13,22,30,-8,23
Vienna,7364,7,6,5,13,25,41,-16,23
FC Salzburg,7365,1,14,7,3,49,21,28,49
SK Sturm Gra,7365,2,11,5,8,30,32,-2,38
Rapid Vienna,7365,3,8,11,5,36,31,5,35
LASK Linz,7365,4,9,6,9,33,29,4,33
SC Rheindorf,7365,5,7,6,11,23,28,-5,27
Vienna,7365,6,6,7,11,26,40,-14,25
Mattersburg,7365,7,5,6,13,29,45,-16,21
FC Salzburg,7366,1,16,6,2,48,17,31,54
SK Sturm Gra,7366,2,13,3,8,34,32,2,42
LASK Linz,7366,3,11,5,8,31,25,6,38
Rapid Vienna,7366,4,7,9,8,33,32,1,30
Vienna,7366,5,7,5,12,26,40,-14,26
SC Rheindorf,7366,6,6,5,13,19,29,-10,23
Mattersburg,7366,7,5,5,14,30,46,-16,20
FC Salzburg,7367,1,15,7,2,46,16,30,52
SK Sturm Gra,7367,2,13,4,7,34,28,6,43
Rapid Vienna,7367,3,8,11,5,36,28,8,35
Mattersburg,7367,4,7,6,11,31,39,-8,27
LASK Linz,7367,5,7,5,12,26,35,-9,26
SC Rheindorf,7367,6,6,6,12,21,28,-7,24
Vienna,7367,7,6,5,13,23,43,-20,23
FC Salzburg,7368,1,15,7,2,43,15,28,52
SK Sturm Gra,7368,2,13,4,7,36,29,7,43
Rapid Vienna,7368,3,7,10,7,36,34,2,31
LASK Linz,7368,4,8,6,10,30,33,-3,30
Vienna,7368,5,6,7,11,24,38,-14,25
Mattersburg,7368,6,6,6,12,32,42,-10,24
SC Rheindorf,7368,7,6,6,12,20,30,-10,24
FC Salzburg,7369,1,16,6,2,49,16,33,54
SK Sturm Gra,7369,2,12,5,7,31,30,1,41
Rapid Vienna,7369,3,8,10,6,37,29,8,34
LASK Linz,7369,4,8,7,9,26,27,-1,31
SC Rheindorf,7369,5,5,8,11,20,28,-8,23
Mattersburg,7369,6,6,5,13,32,47,-15,23
Vienna,7369,7,6,5,13,25,43,-18,23
FC Salzburg,7370,1,13,9,2,41,16,25,48
SK Sturm Gra,7370,2,13,3,8,33,29,4,42
Rapid Vienna,7370,3,9,11,4,35,24,11,38
LASK Linz,7370,4,7,7,10,26,30,-4,28
Mattersburg,7370,5,7,7,10,34,40,-6,28
Vienna,7370,6,6,7,11,25,39,-14,25
SC Rheindorf,7370,7,4,6,14,17,33,-16,18
FC Salzburg,7371,1,13,8,3,42,20,22,47
SK Sturm Gra,7371,2,12,3,9,31,30,1,39
Rapid Vienna,7371,3,9,10,5,38,29,9,37
LASK Linz,7371,4,10,6,8,31,27,4,36
Vienna,7371,5,7,5,12,27,39,-12,26
Mattersburg,7371,6,6,6,12,30,43,-13,24
SC Rheindorf,7371,7,5,6,13,20,31,-11,21
FC Salzburg,7372,1,15,7,2,49,17,32,52
SK Sturm Gra,7372,2,12,5,7,30,28,2,41
LASK Linz,7372,3,9,7,8,29,25,4,34
Rapid Vienna,7372,4,7,11,6,32,29,3,32
Vienna,7372,5,7,5,12,24,41,-17,26
Mattersburg,7372,6,5,7,12,28,41,-13,22
SC Rheindorf,7372,7,4,8,12,16,27,-11,20
FC Salzburg,7373,1,13,8,3,45,20,25,47
SK Sturm Gra,7373,2,13,4,7,35,29,6,43
Rapid Vienna,7373,3,8,11,5,34,28,6,35
LASK Linz,7373,4,8,6,10,28,28,0,30
Vienna,7373,5,8,5,11,26,38,-12,29
Mattersburg,7373,6,6,6,12,31,43,-12,24
SC Rheindorf,7373,7,5,6,13,16,29,-13,21
FC Salzburg,7374,1,15,7,2,41,15,26,52
SK Sturm Gra,7374,2,12,4,8,35,32,3,40
Rapid Vienna,7374,3,8,11,5,37,28,9,35
LASK Linz,7374,4,8,7,9,28,30,-2,31
Vienna,7374,5,7,5,12,26,40,-14,26
SC Rheindorf,7374,6,5,8,11,23,32,-9,23
Mattersburg,7374,7,5,6,13,32,45,-13,21
FC Salzburg,7375,1,14,7,3,43,17,26,49
SK Sturm Gra,7375,2,12,4,8,33,29,4,40
Rapid Vienna,7375,3,9,11,4,36,26,10,38
LASK Linz,7375,4,8,7,9,30,32,-2,31
SC Rheindorf,7375,5,6,6,12,21,29,-8,24
Vienna,7375,6,6,6,12,24,40,-16,24
Mattersburg,7375,7,5,7,12,29,43,-14,22
FC Salzburg,7376,1,14,7,3,43,18,25,49
SK Sturm Gra,7376,2,12,3,9,30,31,-1,39
Rapid Vienna,7376,3,8,9,7,33,27,6,33
LASK Linz,7376,4,8,7,9,30,31,-1,31
SC Rheindorf,7376,5,7,6,11,24,29,-5,27
Vienna,7376,6,7,5,12,25,39,-14,26
Mattersburg,7376,7,6,7,11,30,40,-10,25
FC Salzburg,7377,1,16,6,2,55,17,38,54
SK Sturm Gra,7377,2,12,5,7,33,31,2,41
Rapid Vienna,7377,3,9,10,5,35,27,8,37
LASK Linz,7377,4,7,8,9,25,27,-2,29
Mattersburg,7377,5,6,7,11,31,45,-14,25
Vienna,7377,6,6,6,12,23,41,-18,24
SC Rheindorf,7377,7,4,6,14,18,32,-14,18
FC Salzburg,7378,1,15,7,2,44,18,26,52
SK Sturm Gra,7378,2,12,4,8,33,30,3,40
Rapid Vienna,7378,3,8,12,4,35,26,9,36
LASK Linz,7378,4,7,7,10,26,31,-5,28
Mattersburg,7378,5,6,6,12,30,39,-9,24
SC Rheindorf,7378,6,6,6,12,18,27,-9,24
Vienna,7378,7,6,6,12,24,39,-15,24
FC Salzburg,7379,1,15,6,3,46,16,30,51
SK Sturm Gra,7379,2,12,3,9,31,31,0,39
Rapid Vienna,7379,3,9,9,6,37,26,11,36
LASK Linz,7379,4,8,5,11,26,31,-5,29
Vienna,7379,5,8,5,11,27,37,-10,29
SC Rheindorf,7379,6,7,5,12,20,29,-9,26
Mattersburg,7379,7,6,5,13,28,45,-17,23
FC Salzburg,7380,1,15,6,3,49,19,30,51
SK Sturm Gra,7380,2,13,3,8,34,30,4,42
Rapid Vienna,7380,3,8,10,6,37,31,6,34
LASK Linz,7380,4,8,6,10,27,30,-3,30
Mattersburg,7380,5,7,6,11,34,42,-8,27
Vienna,7380,6,6,6,12,24,43,-19,24
SC Rheindorf,7380,7,5,7,12,21,31,-10,22
FC Salzburg,7381,1,15,6,3,48,19,29,51
SK Sturm Gra,7381,2,13,3,8,35,31,4,42
Rapid Vienna,7381,3,7,10,7,37,35,2,31
Mattersburg,7381,4,7,7,10,32,39,-7,28
LASK Linz,7381,5,7,6,11,26,32,-6,27
SC Rheindorf,7381,6,7,6,11,22,28,-6,27
Vienna,7381,7,6,6,12,24,40,-16,24
FC Salzburg,7382,1,14,6,4,43,20,23,48
SK Sturm Gra,7382,2,12,5,7,30,26,4,41
Rapid Vienna,7382,3,9,9,6,35,27,8,36
LASK Linz,7382,4,8,8,8,28,28,0,32
Vienna,7382,5,7,5,12,26,41,-15,26
Mattersburg,7382,6,6,7,11,35,44,-9,25
SC Rheindorf,7382,7,4,8,12,18,29,-11,20
FC Salzburg,7383,1,15,7,2,49,15,34,52
SK Sturm Gra,7383,2,14,4,6,35,25,10,46
Rapid Vienna,7383,3,8,10,6,34,30,4,34
LASK Linz,7383,4,7,7,10,26,30,-4,28
Vienna,7383,5,7,5,12,26,40,-14,26
Mattersburg,7383,6,5,7,12,29,47,-18,22
SC Rheindorf,7383,7,5,6,13,19,31,-12,21
FC Salzburg,7384,1,15,6,3,47,20,27,51
Rapid Vienna,7384,2,10,10,4,42,26,16,40
SK Sturm Gra,7384,3,11,5,8,32,32,0,38
LASK Linz,7384,4,7,8,9,27,29,-2,29
Mattersburg,7384,5,7,6,11,35,42,-7,27
Vienna,7384,6,6,5,13,25,44,-19,23
SC Rheindorf,7384,7,5,6,13,20,35,-15,21
FC Salzburg,7385,1,16,6,2,47,16,31,54
SK Sturm Gra,7385,2,13,4,7,34,31,3,43
Rapid Vienna,7385,3,8,10,6,38,30,8,34
LASK Linz,7385,4,7,7,10,26,31,-5,28
Mattersburg,7385,5,6,6,12,32,44,-12,24
Vienna,7385,6,6,6,12,26,41,-15,24
SC Rheindorf,7385,7,5,7,12,20,30,-10,22
FC Salzburg,7386,1,15,6,3,48,17,31,51
SK Sturm Gra,7386,2,13,4,7,34,30,4,43
Rapid Vienna,7386,3,9,11,4,39,27,12,38
LASK Linz,7386,4,8,7,9,29,29,0,31
Mattersburg,7386,5,7,6,11,32,42,-10,27
Vienna,7386,6,6,5,13,25,43,-18,23
SC Rheindorf,7386,7,4,5,15,18,37,-19,17
FC Salzburg,7387,1,15,7,2,47,16,31,52
SK Sturm Gra,7387,2,14,3,7,32,26,6,45
Rapid Vienna,7387,3,7,11,6,32,27,5,32
LASK Linz,7387,4,9,5,10,27,26,1,32
Vienna,7387,5,7,5,12,27,41,-14,26
Mattersburg,7387,6,6,5,13,30,46,-16,23
SC Rheindorf,7387,7,5,6,13,17,30,-13,21
FC Salzburg,7388,1,13,7,4,40,19,21,46
SK Sturm Gra,7388,2,13,3,8,33,32,1,42
Rapid Vienna,7388,3,9,10,5,38,26,12,37
SC Rheindorf,7388,4,8,5,11,26,30,-4,29
LASK Linz,7388,5,7,6,11,25,30,-5,27
Vienna,7388,6,7,5,12,25,39,-14,26
Mattersburg,7388,7,6,6,12,31,42,-11,24
FC Salzburg,7389,1,13,9,2,42,17,25,48
SK Sturm Gra,7389,2,13,4,7,34,28,6,43
LASK Linz,7389,3,9,6,9,31,26,5,33
Rapid Vienna,7389,4,7,10,7,33,30,3,31
Mattersburg,7389,5,6,7,11,29,41,-12,25
Vienna,7389,6,6,7,11,24,38,-14,25
SC Rheindorf,7389,7,6,5,13,18,31,-13,23
FC Salzburg,7390,1,13,7,4,43,21,22,46
SK Sturm Gra,7390,2,13,4,7,34,30,4,43
Rapid Vienna,7390,3,8,11,5,39,30,9,35
LASK Linz,7390,4,8,7,9,29,31,-2,31
Vienna,7390,5,7,6,11,26,38,-12,27
Mattersburg,7390,6,6,8,10,30,39,-9,26
SC Rheindorf,7390,7,4,7,13,19,31,-12,19
FC Salzburg,7391,1,13,7,4,39,17,22,46
SK Sturm Gra,7391,2,14,4,6,34,25,9,46
Rapid Vienna,7391,3,7,10,7,32,29,3,31
LASK Linz,7391,4,8,5,11,27,31,-4,29
Mattersburg,7391,5,7,6,11,31,39,-8,27
SC Rheindorf,7391,6,6,7,11,19,27,-8,25
Vienna,7391,7,6,7,11,24,38,-14,25
FC Salzburg,7392,1,15,6,3,46,20,26,51
SK Sturm Gra,7392,2,12,4,8,32,30,2,40
Rapid Vienna,7392,3,9,10,5,37,28,9,37
LASK Linz,7392,4,10,6,8,28,25,3,36
Mattersburg,7392,5,6,6,12,33,44,-11,24
Vienna,7392,6,6,5,13,24,41,-17,23
SC Rheindorf,7392,7,4,7,13,19,31,-12,19
FC Salzburg,7393,1,15,7,2,48,18,30,52
SK Sturm Gra,7393,2,12,3,9,32,32,0,39
Rapid Vienna,7393,3,9,9,6,34,26,8,36
LASK Linz,7393,4,10,5,9,30,28,2,35
Mattersburg,7393,5,7,5,12,32,44,-12,26
Vienna,7393,6,6,6,12,24,39,-15,24
SC Rheindorf,7393,7,5,5,14,18,31,-13,20
FC Salzburg,7394,1,16,6,2,49,18,31,54
SK Sturm Gra,7394,2,13,4,7,31,27,4,43
Rapid Vienna,7394,3,8,9,7,36,30,6,33
LASK Linz,7394,4,7,6,11,24,28,-4,27
Mattersburg,7394,5,7,6,11,30,41,-11,27
SC Rheindorf,7394,6,6,6,12,19,28,-9,24
Vienna,7394,7,6,5,13,24,41,-17,23
FC Salzburg,7395,1,14,8,2,47,18,29,50
SK Sturm Gra,7395,2,13,4,7,32,28,4,43
Rapid Vienna,7395,3,9,10,5,38,27,11,37
LASK Linz,7395,4,7,7,10,25,29,-4,28
Vienna,7395,5,7,5,12,27,41,-14,26
SC Rheindorf,7395,6,6,6,12,18,27,-9,24
Mattersburg,7395,7,5,6,13,28,45,-17,21
FC Salzburg,7396,1,15,6,3,43,18,25,51
SK Sturm Gra,7396,2,12,5,7,35,32,3,41
Rapid Vienna,7396,3,9,10,5,37,27,10,37
LASK Linz,7396,4,8,8,8,29,28,1,32
Vienna,7396,5,7,5,12,27,39,-12,26
SC Rheindorf,7396,6,5,6,13,21,31,-10,21
Mattersburg,7396,7,5,6,13,29,46,-17,21
FC Salzburg,7397,1,13,9,2,41,16,25,48
Rapid Vienna,7397,2,10,10,4,38,24,14,40
SK Sturm Gra,7397,3,12,4,8,31,30,1,40
LASK Linz,7397,4,8,6,10,27,29,-2,30
Vienna,7397,5,7,5,12,26,41,-15,26
Mattersburg,7397,6,5,8,11,29,40,-11,23
SC Rheindorf,7397,7,5,6,13,18,30,-12,21
FC Salzburg,7398,1,15,7,2,44,17,27,52
SK Sturm Gra,7398,2,13,4,7,34,27,7,43
LASK Linz,7398,3,10,5,9,30,25,5,35
Rapid Vienna,7398,4,7,11,6,33,29,4,32
Vienna,7398,5,7,6,11,26,39,-13,27
Mattersburg,7398,6,6,5,13,29,41,-12,23
SC Rheindorf,7398,7,4,6,14,16,34,-18,18
FC Salzburg,7399,1,14,8,2,42,17,25,50
SK Sturm Gra,7399,2,14,4,6,38,30,8,46
Rapid Vienna,7399,3,8,10,6,36,31,5,34
LASK Linz,7399,4,9,5,10,32,32,0,32
Mattersburg,7399,5,7,5,12,31,39,-8,26
Vienna,7399,6,7,5,12,26,40,-14,26
SC Rheindorf,7399,7,4,5,15,16,32,-16,17
FC Salzburg,7400,1,14,7,3,46,19,27,49
SK Sturm Gra,7400,2,13,3,8,32,31,1,42
Rapid Vienna,7400,3,9,9,6,37,27,10,36
LASK Linz,7400,4,8,7,9,26,27,-1,31
Vienna,7400,5,8,5,11,26,38,-12,29
Mattersburg,7400,6,6,7,11,29,39,-10,25
SC Rheindorf,7400,7,4,6,14,17,32,-15,18
FC Salzburg,7401,1,14,8,2,47,19,28,50
SK Sturm Gra,7401,2,12,4,8,32,29,3,40
Rapid Vienna,7401,3,8,9,7,35,32,3,33
LASK Linz,7401,4,8,5,11,29,34,-5,29
Mattersburg,7401,5,7,6,11,33,42,-9,27
SC Rheindorf,7401,6,7,5,12,21,27,-6,26
Vienna,7401,7,6,7,11,25,39,-14,25
FC Salzburg,7402,1,15,6,3,45,19,26,51
SK Sturm Gra,7402,2,13,3,8,35,30,5,42
Rapid Vienna,7402,3,8,10,6,35,28,7,34
LASK Linz,7402,4,9,7,8,30,27,3,34
SC Rheindorf,7402,5,6,6,12,21,32,-11,24
Mattersburg,7402,6,6,5,13,31,45,-14,23
Vienna,7402,7,6,5,13,23,39,-16,23
FC Salzburg,7403,1,14,6,4,46,18,28,48
SK Sturm Gra,7403,2,13,5,6,35,29,6,44
Rapid Vienna,7403,3,9,10,5,37,28,9,37
LASK Linz,7403,4,8,6,10,27,29,-2,30
SC Rheindorf,7403,5,7,5,12,24,32,-8,26
Vienna,7403,6,6,6,12,25,41,-16,24
Mattersburg,7403,7,5,6,13,29,46,-17,21
FC Salzburg,7404,1,14,6,4,43,21,22,48
SK Sturm Gra,7404,2,13,3,8,34,30,4,42
Rapid Vienna,7404,3,9,9,6,36,28,8,36
LASK Linz,7404,4,8,5,11,26,31,-5,29
Vienna,7404,5,8,5,11,27,37,-10,29
SC Rheindorf,7404,6,6,6,12,19,28,-9,24
Mattersburg,7404,7,6,6,12,31,41,-10,24
FC Salzburg,7405,1,15,6,3,47,17,30,51
SK Sturm Gra,7405,2,11,6,7,32,31,1,39
Rapid Vienna,7405,3,9,10,5,36,27,9,37
LASK Linz,7405,4,8,6,10,28,29,-1,30
Mattersburg,7405,5,7,5,12,33,42,-9,26
SC Rheindorf,7405,6,6,6,12,19,30,-11,24
Vienna,7405,7,6,5,13,24,43,-19,23
FC Salzburg,7406,1,14,6,4,44,22,22,48
Rapid Vienna,7406,2,9,10,5,37,28,9,37
SK Sturm Gra,7406,3,11,4,9,29,29,0,37
LASK Linz,7406,4,8,8,8,25,24,1,32
Vienna,7406,5,7,6,11,28,39,-11,27
SC Rheindorf,7406,6,5,8,11,21,30,-9,23
Mattersburg,7406,7,5,8,11,32,44,-12,23
FC Salzburg,7407,1,15,6,3,47,18,29,51
SK Sturm Gra,7407,2,12,4,8,31,28,3,40
Rapid Vienna,7407,3,9,10,5,36,27,9,37
LASK Linz,7407,4,8,7,9,28,29,-1,31
Vienna,7407,5,7,5,12,24,40,-16,26
Mattersburg,7407,6,6,6,12,30,42,-12,24
SC Rheindorf,7407,7,5,6,13,17,29,-12,21
FC Salzburg,7408,1,13,8,3,44,21,23,47
SK Sturm Gra,7408,2,13,5,6,37,30,7,44
Rapid Vienna,7408,3,8,11,5,36,30,6,35
LASK Linz,7408,4,8,5,11,26,31,-5,29
Vienna,7408,5,7,6,11,26,39,-13,27
Mattersburg,7408,6,7,5,12,33,42,-9,26
SC Rheindorf,7408,7,5,6,13,25,34,-9,21
FC Salzburg,7409,1,13,9,2,43,18,25,48
SK Sturm Gra,7409,2,12,3,9,33,32,1,39
Rapid Vienna,7409,3,9,10,5,37,28,9,37
LASK Linz,7409,4,9,7,8,28,27,1,34
Mattersburg,7409,5,7,7,10,32,39,-7,28
Vienna,7409,6,6,6,12,25,41,-16,24
SC Rheindorf,7409,7,4,6,14,18,31,-13,18
FC Salzburg,7410,1,14,7,3,48,17,31,49
SK Sturm Gra,7410,2,13,3,8,34,35,-1,42
Rapid Vienna,7410,3,8,10,6,33,29,4,34
LASK Linz,7410,4,8,6,10,29,29,0,30
Mattersburg,7410,5,8,5,11,34,40,-6,29
Vienna,7410,6,6,6,12,23,41,-18,24
SC Rheindorf,7410,7,5,7,12,17,27,-10,22
FC Salzburg,7411,1,14,7,3,44,18,26,49
SK Sturm Gra,7411,2,14,3,7,38,27,11,45
Rapid Vienna,7411,3,9,10,5,37,28,9,37
Mattersburg,7411,4,7,6,11,34,44,-10,27
Vienna,7411,5,7,6,11,26,39,-13,27
LASK Linz,7411,6,7,5,12,24,35,-11,26
SC Rheindorf,7411,7,5,5,14,21,33,-12,20
FC Salzburg,7412,1,14,7,3,44,20,24,49
SK Sturm Gra,7412,2,14,3,7,37,30,7,45
Rapid Vienna,7412,3,10,9,5,40,29,11,39
LASK Linz,7412,4,9,5,10,28,29,-1,32
Mattersburg,7412,5,7,5,12,32,42,-10,26
Vienna,7412,6,6,6,12,24,39,-15,24
SC Rheindorf,7412,7,4,5,15,16,32,-16,17
FC Salzburg,7413,1,14,8,2,44,19,25,50
SK Sturm Gra,7413,2,12,5,7,31,29,2,41
Rapid Vienna,7413,3,9,10,5,39,29,10,37
LASK Linz,7413,4,8,6,10,27,30,-3,30
SC Rheindorf,7413,5,6,6,12,24,29,-5,24
Mattersburg,7413,6,6,6,12,28,41,-13,24
Vienna,7413,7,6,5,13,23,39,-16,23
FC Salzburg,7414,1,16,6,2,48,18,30,54
SK Sturm Gra,7414,2,13,3,8,33,32,1,42
Rapid Vienna,7414,3,8,10,6,36,30,6,34
LASK Linz,7414,4,8,6,10,28,29,-1,30
Mattersburg,7414,5,6,6,12,29,41,-12,24
Vienna,7414,6,6,6,12,24,39,-15,24
SC Rheindorf,7414,7,5,7,12,19,28,-9,22
FC Salzburg,7415,1,15,7,2,47,17,30,52
SK Sturm Gra,7415,2,12,4,8,33,32,1,40
LASK Linz,7415,3,10,5,9,32,28,4,35
Rapid Vienna,7415,4,7,9,8,33,32,1,30
SC Rheindorf,7415,5,8,5,11,25,28,-3,29
Vienna,7415,6,6,6,12,23,39,-16,24
Mattersburg,7415,7,5,6,13,26,43,-17,21
FC Salzburg,7416,1,14,8,2,48,19,29,50
SK Sturm Gra,7416,2,12,3,9,30,28,2,39
LASK Linz,7416,3,9,6,9,25,25,0,33
Rapid Vienna,7416,4,7,11,6,32,27,5,32
Mattersburg,7416,5,7,5,12,29,42,-13,26
SC Rheindorf,7416,6,6,7,11,18,26,-8,25
Vienna,7416,7,6,6,12,26,41,-15,24
FC Salzburg,7417,1,15,7,2,47,19,28,52
SK Sturm Gra,7417,2,12,4,8,32,28,4,40
Rapid Vienna,7417,3,8,11,5,39,31,8,35
LASK Linz,7417,4,8,7,9,27,29,-2,31
Mattersburg,7417,5,7,6,11,31,39,-8,27
Vienna,7417,6,6,5,13,23,41,-18,23
SC Rheindorf,7417,7,5,6,13,17,29,-12,21
FC Salzburg,7418,1,14,8,2,46,18,28,50
SK Sturm Gra,7418,2,11,6,7,29,26,3,39
LASK Linz,7418,3,9,7,8,32,27,5,34
Rapid Vienna,7418,4,8,9,7,33,33,0,33
Vienna,7418,5,6,7,11,25,39,-14,25
Mattersburg,7418,6,6,6,12,31,44,-13,24
SC Rheindorf,7418,7,5,7,12,21,30,-9,22
FC Salzburg,7419,1,14,8,2,44,19,25,50
SK Sturm Gra,7419,2,12,4,8,30,28,2,40
LASK Linz,7419,3,10,6,8,32,25,7,36
Rapid Vienna,7419,4,7,9,8,31,31,0,30
Mattersburg,7419,5,6,8,10,32,41,-9,26
Vienna,7419,6,6,6,12,25,40,-15,24
SC Rheindorf,7419,7,5,7,12,20,30,-10,22
FC Salzburg,7420,1,15,6,3,44,19,25,51
SK Sturm Gra,7420,2,14,3,7,34,28,6,45
Rapid Vienna,7420,3,8,10,6,38,30,8,34
LASK Linz,7420,4,8,6,10,28,30,-2,30
Vienna,7420,5,7,5,12,24,38,-14,26
Mattersburg,7420,6,6,6,12,30,41,-11,24
SC Rheindorf,7420,7,5,6,13,18,30,-12,21
FC Salzburg,7421,1,15,7,2,45,19,26,52
SK Sturm Gra,7421,2,11,6,7,33,30,3,39
Rapid Vienna,7421,3,7,12,5,37,30,7,33
LASK Linz,7421,4,8,8,8,28,28,0,32
Vienna,7421,5,7,5,12,27,40,-13,26
Mattersburg,7421,6,5,7,12,28,41,-13,22
SC Rheindorf,7421,7,4,9,11,20,30,-10,21
FC Salzburg,7422,1,14,7,3,44,19,25,49
SK Sturm Gra,7422,2,13,3,8,34,31,3,42
Rapid Vienna,7422,3,8,11,5,34,26,8,35
LASK Linz,7422,4,9,6,9,32,31,1,33
Mattersburg,7422,5,6,7,11,35,45,-10,25
Vienna,7422,6,6,6,12,25,40,-15,24
SC Rheindorf,7422,7,4,8,12,18,30,-12,20
FC Salzburg,7423,1,13,8,3,44,20,24,47
SK Sturm Gra,7423,2,11,4,9,32,33,-1,37
Rapid Vienna,7423,3,9,9,6,36,30,6,36
LASK Linz,7423,4,10,5,9,32,29,3,35
SC Rheindorf,7423,5,7,5,12,23,30,-7,26
Mattersburg,7423,6,7,5,12,33,42,-9,26
Vienna,7423,7,6,6,12,25,41,-16,24
FC Salzburg,7424,1,13,6,5,40,21,19,45
SK Sturm Gra,7424,2,13,3,8,30,27,3,42
Rapid Vienna,7424,3,8,10,6,34,25,9,34
LASK Linz,7424,4,9,5,10,27,31,-4,32
Vienna,7424,5,8,5,11,28,38,-10,29
SC Rheindorf,7424,6,7,6,11,23,27,-4,27
Mattersburg,7424,7,6,5,13,31,44,-13,23
FC Salzburg,7425,1,14,6,4,43,21,22,48
SK Sturm Gra,7425,2,13,3,8,33,29,4,42
Rapid Vienna,7425,3,8,9,7,35,30,5,33
Mattersburg,7425,4,8,6,10,35,40,-5,30
LASK Linz,7425,5,8,5,11,29,33,-4,29
SC Rheindorf,7425,6,7,5,12,21,28,-7,26
Vienna,7425,7,6,6,12,26,41,-15,24
FC Salzburg,7426,1,16,6,2,48,17,31,54
SK Sturm Gra,7426,2,13,3,8,34,30,4,42
Rapid Vienna,7426,3,10,9,5,38,27,11,39
LASK Linz,7426,4,8,6,10,29,31,-2,30
Vienna,7426,5,7,5,12,25,41,-16,26
SC Rheindorf,7426,6,5,6,13,18,31,-13,21
Mattersburg,7426,7,5,5,14,27,42,-15,20
FC Salzburg,7427,1,15,6,3,46,20,26,51
SK Sturm Gra,7427,2,12,5,7,30,27,3,41
Rapid Vienna,7427,3,9,9,6,39,29,10,36
LASK Linz,7427,4,8,6,10,28,33,-5,30
Vienna,7427,5,7,5,12,26,40,-14,26
SC Rheindorf,7427,6,6,6,12,20,30,-10,24
Mattersburg,7427,7,6,5,13,32,42,-10,23
FC Salzburg,7428,1,15,6,3,47,19,28,51
SK Sturm Gra,7428,2,12,5,7,30,26,4,41
Rapid Vienna,7428,3,10,10,4,40,27,13,40
LASK Linz,7428,4,8,7,9,26,28,-2,31
Vienna,7428,5,7,5,12,29,41,-12,26
Mattersburg,7428,6,6,5,13,29,45,-16,23
SC Rheindorf,7428,7,4,6,14,17,32,-15,18
FC Salzburg,7429,1,16,6,2,46,18,28,54
SK Sturm Gra,7429,2,13,3,8,32,27,5,42
Rapid Vienna,7429,3,8,9,7,32,26,6,33
LASK Linz,7429,4,8,5,11,25,30,-5,29
SC Rheindorf,7429,5,7,5,12,21,28,-7,26
Vienna,7429,6,7,5,12,26,39,-13,26
Mattersburg,7429,7,6,5,13,30,44,-14,23
FC Salzburg,7430,1,16,6,2,47,16,31,54
SK Sturm Gra,7430,2,13,3,8,35,29,6,42
Rapid Vienna,7430,3,9,10,5,39,31,8,37
LASK Linz,7430,4,8,6,10,29,34,-5,30
Mattersburg,7430,5,7,6,11,31,41,-10,27
Vienna,7430,6,6,5,13,23,39,-16,23
SC Rheindorf,7430,7,4,6,14,21,35,-14,18
FC Salzburg,7431,1,14,7,3,43,19,24,49
SK Sturm Gra,7431,2,12,4,8,32,28,4,40
LASK Linz,7431,3,10,6,8,26,24,2,36
Rapid Vienna,7431,4,7,11,6,34,28,6,32
Vienna,7431,5,8,5,11,28,39,-11,29
SC Rheindorf,7431,6,5,7,12,16,27,-11,22
Mattersburg,7431,7,5,6,13,28,42,-14,21
FC Salzburg,7432,1,15,7,2,49,21,28,52
SK Sturm Gra,7432,2,12,5,7,34,29,5,41
Rapid Vienna,7432,3,8,10,6,34,29,5,34
LASK Linz,7432,4,9,6,9,31,27,4,33
Vienna,7432,5,7,5,12,30,42,-12,26
Mattersburg,7432,6,6,6,12,29,43,-14,24
SC Rheindorf,7432,7,4,7,13,17,33,-16,19
FC Salzburg,7433,1,15,7,2,48,16,32,52
SK Sturm Gra,7433,2,12,5,7,29,25,4,41
Rapid Vienna,7433,3,8,10,6,33,29,4,34
LASK Linz,7433,4,8,6,10,26,27,-1,30
SC Rheindorf,7433,5,7,6,11,25,25,0,27
Vienna,7433,6,7,5,12,25,43,-18,26
Mattersburg,7433,7,5,5,14,28,49,-21,20
FC Salzburg,7434,1,15,6,3,45,20,25,51
Rapid Vienna,7434,2,10,10,4,40,25,15,40
SK Sturm Gra,7434,3,11,6,7,32,30,2,39
LASK Linz,7434,4,8,7,9,26,27,-1,31
Vienna,7434,5,7,5,12,30,40,-10,26
Mattersburg,7434,6,6,6,12,33,48,-15,24
SC Rheindorf,7434,7,4,6,14,20,36,-16,18
FC Salzburg,7435,1,15,6,3,45,19,26,51
SK Sturm Gra,7435,2,13,3,8,33,29,4,42
Rapid Vienna,7435,3,8,10,6,36,29,7,34
LASK Linz,7435,4,8,5,11,26,29,-3,29
SC Rheindorf,7435,5,7,6,11,22,28,-6,27
Vienna,7435,6,7,5,12,26,40,-14,26
Mattersburg,7435,7,6,5,13,28,42,-14,23
FC Salzburg,7436,1,15,7,2,46,18,28,52
SK Sturm Gra,7436,2,14,3,7,35,27,8,45
LASK Linz,7436,3,10,5,9,33,27,6,35
Rapid Vienna,7436,4,8,9,7,35,33,2,33
Mattersburg,7436,5,6,7,11,32,44,-12,25
Vienna,7436,6,6,6,12,24,40,-16,24
SC Rheindorf,7436,7,4,5,15,16,32,-16,17
FC Salzburg,7437,1,16,6,2,45,17,28,54
SK Sturm Gra,7437,2,11,4,9,29,30,-1,37
Rapid Vienna,7437,3,9,9,6,33,28,5,36
LASK Linz,7437,4,9,6,9,31,28,3,33
Vienna,7437,5,7,5,12,27,40,-13,26
SC Rheindorf,7437,6,6,6,12,18,26,-8,24
Mattersburg,7437,7,5,6,13,31,45,-14,21
FC Salzburg,7438,1,14,8,2,50,18,32,50
SK Sturm Gra,7438,2,12,5,7,31,27,4,41
Rapid Vienna,7438,3,9,11,4,36,25,11,38
LASK Linz,7438,4,7,7,10,25,29,-4,28
Mattersburg,7438,5,7,5,12,31,46,-15,26
SC Rheindorf,7438,6,6,5,13,21,30,-9,23
Vienna,7438,7,6,5,13,25,44,-19,23
FC Salzburg,7439,1,13,9,2,43,16,27,48
SK Sturm Gra,7439,2,11,5,8,31,29,2,38
Rapid Vienna,7439,3,8,10,6,35,30,5,34
LASK Linz,7439,4,9,5,10,29,29,0,32
Mattersburg,7439,5,8,5,11,34,42,-8,29
SC Rheindorf,7439,6,6,6,12,22,30,-8,24
Vienna,7439,7,6,6,12,25,43,-18,24
FC Salzburg,7440,1,15,7,2,45,16,29,52
SK Sturm Gra,7440,2,13,4,7,38,33,5,43
Rapid Vienna,7440,3,8,10,6,38,30,8,34
LASK Linz,7440,4,7,8,9,27,30,-3,29
Vienna,7440,5,7,5,12,24,39,-15,26
Mattersburg,7440,6,6,6,12,28,38,-10,24
SC Rheindorf,7440,7,5,6,13,20,34,-14,21
FC Salzburg,7441,1,15,7,2,47,17,30,52
SK Sturm Gra,7441,2,14,3,7,36,29,7,45
Rapid Vienna,7441,3,9,10,5,38,30,8,37
LASK Linz,7441,4,7,7,10,26,29,-3,28
Mattersburg,7441,5,6,7,11,27,41,-14,25
Vienna,7441,6,6,6,12,24,39,-15,24
SC Rheindorf,7441,7,4,6,14,18,31,-13,18
FC Salzburg,7442,1,15,6,3,46,18,28,51
SK Sturm Gra,7442,2,12,3,9,31,36,-5,39
Rapid Vienna,7442,3,9,10,5,35,26,9,37
LASK Linz,7442,4,9,6,9,30,29,1,33
Vienna,7442,5,7,5,12,28,40,-12,26
SC Rheindorf,7442,6,6,6,12,22,27,-5,24
Mattersburg,7442,7,5,6,13,28,44,-16,21
FC Salzburg,7443,1,15,6,3,47,19,28,51
SK Sturm Gra,7443,2,13,3,8,34,32,2,42
Rapid Vienna,7443,3,9,9,6,37,28,9,36
LASK Linz,7443,4,8,6,10,27,30,-3,30
Mattersburg,7443,5,7,6,11,32,41,-9,27
Vienna,7443,6,7,5,12,28,42,-14,26
SC Rheindorf,7443,7,4,7,13,16,29,-13,19
FC Salzburg,7444,1,14,7,3,42,19,23,49
SK Sturm Gra,7444,2,14,3,7,36,28,8,45
Rapid Vienna,7444,3,8,10,6,37,28,9,34
LASK Linz,7444,4,8,6,10,27,30,-3,30
Vienna,7444,5,7,6,11,27,39,-12,27
Mattersburg,7444,6,7,5,12,32,43,-11,26
SC Rheindorf,7444,7,5,5,14,21,35,-14,20
FC Salzburg,7445,1,15,6,3,46,21,25,51
SK Sturm Gra,7445,2,12,4,8,32,29,3,40
Rapid Vienna,7445,3,9,10,5,35,27,8,37
LASK Linz,7445,4,8,7,9,28,27,1,31
Mattersburg,7445,5,7,5,12,36,48,-12,26
Vienna,7445,6,6,5,13,26,43,-17,23
SC Rheindorf,7445,7,5,7,12,20,28,-8,22
FC Salzburg,7446,1,15,6,3,46,18,28,51
SK Sturm Gra,7446,2,13,3,8,35,32,3,42
Rapid Vienna,7446,3,10,9,5,38,29,9,39
LASK Linz,7446,4,8,6,10,30,32,-2,30
Vienna,7446,5,6,6,12,23,39,-16,24
Mattersburg,7446,6,5,8,11,30,42,-12,23
SC Rheindorf,7446,7,5,6,13,21,31,-10,21
FC Salzburg,7447,1,15,6,3,50,20,30,51
SK Sturm Gra,7447,2,13,3,8,34,30,4,42
Rapid Vienna,7447,3,8,10,6,32,27,5,34
LASK Linz,7447,4,9,6,9,29,29,0,33
Mattersburg,7447,5,8,5,11,36,44,-8,29
Vienna,7447,6,6,5,13,25,44,-19,23
SC Rheindorf,7447,7,4,7,13,18,30,-12,19
FC Salzburg,7448,1,14,6,4,47,23,24,48
Rapid Vienna,7448,2,9,9,6,36,28,8,36
SK Sturm Gra,7448,3,11,3,10,30,30,0,36
LASK Linz,7448,4,10,5,9,27,26,1,35
Vienna,7448,5,8,5,11,29,39,-10,29
SC Rheindorf,7448,6,7,5,12,18,26,-8,26
Mattersburg,7448,7,6,5,13,30,45,-15,23
FC Salzburg,7449,1,15,6,3,45,18,27,51
SK Sturm Gra,7449,2,12,4,8,35,34,1,40
LASK Linz,7449,3,10,6,8,30,27,3,36
Rapid Vienna,7449,4,8,10,6,36,31,5,34
Vienna,7449,5,7,5,12,25,38,-13,26
SC Rheindorf,7449,6,6,6,12,21,29,-8,24
Mattersburg,7449,7,5,5,14,26,41,-15,20
FC Salzburg,7450,1,15,6,3,47,20,27,51
SK Sturm Gra,7450,2,13,3,8,32,30,2,42
Rapid Vienna,7450,3,8,10,6,32,27,5,34
LASK Linz,7450,4,9,5,10,27,28,-1,32
SC Rheindorf,7450,5,6,6,12,20,26,-6,24
Mattersburg,7450,6,6,6,12,32,44,-12,24
Vienna,7450,7,6,6,12,26,41,-15,24
FC Salzburg,7451,1,15,6,3,46,19,27,51
SK Sturm Gra,7451,2,13,4,7,32,29,3,43
Rapid Vienna,7451,3,8,10,6,36,29,7,34
LASK Linz,7451,4,7,8,9,26,29,-3,29
Mattersburg,7451,5,7,5,12,32,40,-8,26
SC Rheindorf,7451,6,6,6,12,20,29,-9,24
Vienna,7451,7,6,5,13,26,43,-17,23
SK Sturm Gra,7452,1,13,5,6,33,25,8,44
FC Salzburg,7452,2,12,7,5,42,26,16,43
Rapid Vienna,7452,3,9,11,4,38,27,11,38
LASK Linz,7452,4,8,7,9,28,28,0,31
Vienna,7452,5,8,5,11,30,39,-9,29
SC Rheindorf,7452,6,6,5,13,19,29,-10,23
Mattersburg,7452,7,5,6,13,28,44,-16,21
FC Salzburg,7453,1,14,7,3,45,18,27,49
SK Sturm Gra,7453,2,14,4,6,33,26,7,46
Rapid Vienna,7453,3,7,11,6,33,27,6,32
LASK Linz,7453,4,7,9,8,26,27,-1,30
Mattersburg,7453,5,7,6,11,31,40,-9,27
Vienna,7453,6,6,5,13,25,44,-19,23
SC Rheindorf,7453,7,5,6,13,18,29,-11,21
FC Salzburg,7454,1,15,6,3,48,18,30,51
SK Sturm Gra,7454,2,13,4,7,34,29,5,43
Rapid Vienna,7454,3,9,9,6,36,27,9,36
LASK Linz,7454,4,8,5,11,28,33,-5,29
SC Rheindorf,7454,5,6,6,12,20,29,-9,24
Mattersburg,7454,6,6,6,12,30,45,-15,24
Vienna,7454,7,6,6,12,26,41,-15,24
FC Salzburg,7455,1,15,7,2,50,20,30,52
SK Sturm Gra,7455,2,11,5,8,30,31,-1,38
Rapid Vienna,7455,3,8,11,5,37,28,9,35
LASK Linz,7455,4,9,6,9,29,29,0,33
SC Rheindorf,7455,5,7,5,12,23,30,-7,26
Mattersburg,7455,6,6,5,13,32,45,-13,23
Vienna,7455,7,6,5,13,25,43,-18,23
FC Salzburg,7456,1,13,8,3,42,19,23,47
SK Sturm Gra,7456,2,14,3,7,35,30,5,45
Rapid Vienna,7456,3,9,10,5,40,30,10,37
LASK Linz,7456,4,8,6,10,33,32,1,30
Mattersburg,7456,5,7,6,11,31,40,-9,27
Vienna,7456,6,7,5,12,26,40,-14,26
SC Rheindorf,7456,7,4,6,14,19,35,-16,18
FC Salzburg,7457,1,13,6,5,40,18,22,45
Rapid Vienna,7457,2,10,10,4,37,24,13,40
SK Sturm Gra,7457,3,12,4,8,31,30,1,40
LASK Linz,7457,4,8,7,9,26,28,-2,31
Vienna,7457,5,8,5,11,27,37,-10,29
Mattersburg,7457,6,6,6,12,27,40,-13,24
SC Rheindorf,7457,7,5,6,13,19,30,-11,21
FC Salzburg,7458,1,14,7,3,47,21,26,49
SK Sturm Gra,7458,2,12,5,7,31,28,3,41
Rapid Vienna,7458,3,9,11,4,41,29,12,38
LASK Linz,7458,4,8,5,11,28,30,-2,29
Vienna,7458,5,7,5,12,26,41,-15,26
SC Rheindorf,7458,6,6,6,12,19,30,-11,24
Mattersburg,7458,7,6,5,13,32,45,-13,23
FC Salzburg,7459,1,16,6,2,49,19,30,54
SK Sturm Gra,7459,2,13,3,8,32,28,4,42
Rapid Vienna,7459,3,9,10,5,36,27,9,37
LASK Linz,7459,4,7,6,11,26,31,-5,27
Vienna,7459,5,7,5,12,26,41,-15,26
Mattersburg,7459,6,6,6,12,30,41,-11,24
SC Rheindorf,7459,7,5,6,13,19,31,-12,21
FC Salzburg,7460,1,14,7,3,44,19,25,49
SK Sturm Gra,7460,2,12,4,8,32,29,3,40
Rapid Vienna,7460,3,9,11,4,37,25,12,38
LASK Linz,7460,4,8,6,10,25,28,-3,30
Vienna,7460,5,7,6,11,26,37,-11,27
Mattersburg,7460,6,7,5,12,34,44,-10,26
SC Rheindorf,7460,7,5,5,14,18,34,-16,20
FC Salzburg,7461,1,14,7,3,44,20,24,49
SK Sturm Gra,7461,2,13,5,6,34,28,6,44
LASK Linz,7461,3,10,6,8,34,26,8,36
Rapid Vienna,7461,4,8,10,6,35,31,4,34
Mattersburg,7461,5,6,5,13,30,44,-14,23
Vienna,7461,6,6,5,13,24,40,-16,23
SC Rheindorf,7461,7,5,6,13,17,29,-12,21
FC Salzburg,7462,1,15,7,2,51,20,31,52
SK Sturm Gra,7462,2,12,4,8,31,28,3,40
Rapid Vienna,7462,3,8,11,5,34,26,8,35
LASK Linz,7462,4,7,7,10,26,30,-4,28
Vienna,7462,5,7,6,11,30,43,-13,27
Mattersburg,7462,6,7,5,12,32,46,-14,26
SC Rheindorf,7462,7,5,6,13,17,28,-11,21
FC Salzburg,7463,1,13,8,3,43,20,23,47
SK Sturm Gra,7463,2,14,4,6,35,27,8,46
Rapid Vienna,7463,3,8,10,6,38,28,10,34
LASK Linz,7463,4,8,7,9,27,30,-3,31
Vienna,7463,5,7,6,11,25,38,-13,27
Mattersburg,7463,6,5,7,12,29,42,-13,22
SC Rheindorf,7463,7,5,6,13,21,33,-12,21
FC Salzburg,7464,1,15,7,2,48,18,30,52
Rapid Vienna,7464,2,10,10,4,37,25,12,40
SK Sturm Gra,7464,3,12,4,8,32,31,1,40
LASK Linz,7464,4,7,5,12,25,33,-8,26
Vienna,7464,5,7,5,12,24,40,-16,26
SC Rheindorf,7464,6,6,6,12,20,27,-7,24
Mattersburg,7464,7,6,5,13,29,41,-12,23
FC Salzburg,7465,1,14,6,4,44,20,24,48
SK Sturm Gra,7465,2,12,5,7,33,29,4,41
Rapid Vienna,7465,3,8,12,4,35,26,9,36
Vienna,7465,4,8,5,11,27,37,-10,29
LASK Linz,7465,5,7,6,11,27,36,-9,27
Mattersburg,7465,6,6,6,12,31,42,-11,24
SC Rheindorf,7465,7,5,8,11,20,27,-7,23
FC Salzburg,7466,1,15,7,2,43,17,26,52
SK Sturm Gra,7466,2,13,3,8,32,28,4,42
Rapid Vienna,7466,3,9,10,5,36,25,11,37
LASK Linz,7466,4,8,5,11,25,31,-6,29
Mattersburg,7466,5,7,6,11,33,42,-9,27
Vienna,7466,6,6,5,13,26,42,-16,23
SC Rheindorf,7466,7,5,6,13,20,30,-10,21
FC Salzburg,7467,1,15,7,2,44,17,27,52
SK Sturm Gra,7467,2,11,4,9,31,31,0,37
LASK Linz,7467,3,10,6,8,28,26,2,36
Rapid Vienna,7467,4,8,10,6,33,26,7,34
Vienna,7467,5,7,6,11,24,37,-13,27
Mattersburg,7467,6,6,5,13,29,41,-12,23
SC Rheindorf,7467,7,4,8,12,19,30,-11,20
FC Salzburg,7468,1,15,7,2,44,16,28,52
SK Sturm Gra,7468,2,11,5,8,31,30,1,38
Rapid Vienna,7468,3,9,9,6,36,30,6,36
LASK Linz,7468,4,8,6,10,31,31,0,30
Mattersburg,7468,5,7,6,11,32,39,-7,27
Vienna,7468,6,6,7,11,25,39,-14,25
SC Rheindorf,7468,7,5,6,13,19,33,-14,21
FC Salzburg,7469,1,14,8,2,42,16,26,50
SK Sturm Gra,7469,2,13,5,6,34,27,7,44
Rapid Vienna,7469,3,8,9,7,38,31,7,33
LASK Linz,7469,4,9,5,10,30,30,0,32
Vienna,7469,5,7,6,11,24,37,-13,27
Mattersburg,7469,6,6,5,13,28,41,-13,23
SC Rheindorf,7469,7,5,6,13,17,31,-14,21
FC Salzburg,7470,1,15,7,2,46,17,29,52
SK Sturm Gra,7470,2,12,5,7,34,29,5,41
Rapid Vienna,7470,3,9,9,6,35,28,7,36
LASK Linz,7470,4,7,7,10,27,32,-5,28
SC Rheindorf,7470,5,7,5,12,21,27,-6,26
Mattersburg,7470,6,6,6,12,32,44,-12,24
Vienna,7470,7,6,5,13,26,44,-18,23
FC Salzburg,7471,1,16,6,2,44,15,29,54
SK Sturm Gra,7471,2,11,4,9,31,32,-1,37
LASK Linz,7471,3,9,6,9,30,29,1,33
Rapid Vienna,7471,4,7,10,7,34,32,2,31
SC Rheindorf,7471,5,7,6,11,25,29,-4,27
Vienna,7471,6,7,5,12,25,39,-14,26
Mattersburg,7471,7,5,7,12,32,45,-13,22
FC Salzburg,7472,1,16,6,2,47,18,29,54
SK Sturm Gra,7472,2,12,3,9,32,29,3,39
Rapid Vienna,7472,3,8,10,6,36,30,6,34
LASK Linz,7472,4,9,5,10,27,28,-1,32
SC Rheindorf,7472,5,7,6,11,22,29,-7,27
Vienna,7472,6,7,5,12,26,40,-14,26
Mattersburg,7472,7,5,5,14,29,45,-16,20
FC Salzburg,7473,1,14,6,4,47,19,28,48
SK Sturm Gra,7473,2,13,5,6,34,27,7,44
LASK Linz,7473,3,8,7,9,29,28,1,31
Rapid Vienna,7473,4,7,10,7,36,37,-1,31
SC Rheindorf,7473,5,7,5,12,22,29,-7,26
Vienna,7473,6,7,5,12,25,40,-15,26
Mattersburg,7473,7,6,6,12,28,41,-13,24
FC Salzburg,7474,1,15,6,3,47,20,27,51
Rapid Vienna,7474,2,10,9,5,38,26,12,39
SK Sturm Gra,7474,3,11,3,10,33,34,-1,36
LASK Linz,7474,4,9,5,10,28,30,-2,32
Mattersburg,7474,5,7,5,12,31,43,-12,26
Vienna,7474,6,7,5,12,28,43,-15,26
SC Rheindorf,7474,7,6,5,13,20,29,-9,23
FC Salzburg,7475,1,15,7,2,46,17,29,52
SK Sturm Gra,7475,2,14,3,7,32,27,5,45
LASK Linz,7475,3,9,6,9,27,26,1,33
Rapid Vienna,7475,4,7,10,7,33,29,4,31
Vienna,7475,5,7,6,11,26,39,-13,27
Mattersburg,7475,6,6,5,13,29,42,-13,23
SC Rheindorf,7475,7,4,7,13,16,29,-13,19
FC Salzburg,7476,1,13,7,4,44,21,23,46
SK Sturm Gra,7476,2,14,4,6,36,26,10,46
Rapid Vienna,7476,3,8,11,5,33,26,7,35
LASK Linz,7476,4,8,6,10,26,28,-2,30
Vienna,7476,5,7,6,11,26,39,-13,27
Mattersburg,7476,6,5,8,11,30,43,-13,23
SC Rheindorf,7476,7,5,6,13,20,32,-12,21
FC Salzburg,7477,1,13,6,5,42,21,21,45
Rapid Vienna,7477,2,10,9,5,37,26,11,39
SK Sturm Gra,7477,3,11,4,9,30,29,1,37
LASK Linz,7477,4,10,5,9,29,27,2,35
Mattersburg,7477,5,7,6,11,34,43,-9,27
Vienna,7477,6,7,6,11,26,39,-13,27
SC Rheindorf,7477,7,5,6,13,19,32,-13,21
FC Salzburg,7478,1,13,8,3,41,18,23,47
SK Sturm Gra,7478,2,12,5,7,33,28,5,41
LASK Linz,7478,3,9,7,8,29,27,2,34
Rapid Vienna,7478,4,7,12,5,36,29,7,33
Mattersburg,7478,5,7,6,11,31,39,-8,27
Vienna,7478,6,6,6,12,24,41,-17,24
SC Rheindorf,7478,7,5,6,13,21,33,-12,21
FC Salzburg,7479,1,14,8,2,45,17,28,50
SK Sturm Gra,7479,2,13,5,6,31,25,6,44
Rapid Vienna,7479,3,8,10,6,34,29,5,34
LASK Linz,7479,4,7,8,9,27,29,-2,29
Mattersburg,7479,5,7,6,11,34,43,-9,27
Vienna,7479,6,6,6,12,25,40,-15,24
SC Rheindorf,7479,7,5,5,14,18,31,-13,20
FC Salzburg,7480,1,13,8,3,44,19,25,47
Rapid Vienna,7480,2,10,10,4,37,26,11,40
SK Sturm Gra,7480,3,11,4,9,28,27,1,37
LASK Linz,7480,4,8,6,10,25,28,-3,30
Vienna,7480,5,7,6,11,26,39,-13,27
SC Rheindorf,7480,6,6,6,12,18,27,-9,24
Mattersburg,7480,7,6,6,12,30,42,-12,24
FC Salzburg,7481,1,16,6,2,51,20,31,54
SK Sturm Gra,7481,2,11,6,7,31,29,2,39
Rapid Vienna,7481,3,7,11,6,35,32,3,32
LASK Linz,7481,4,8,8,8,30,29,1,32
Mattersburg,7481,5,7,6,11,34,42,-8,27
Vienna,7481,6,6,5,13,25,41,-16,23
SC Rheindorf,7481,7,4,8,12,16,29,-13,20
SK Sturm Gra,7482,1,14,4,6,37,26,11,46
FC Salzburg,7482,2,13,6,5,41,23,18,45
Rapid Vienna,7482,3,8,10,6,33,26,7,34
LASK Linz,7482,4,7,8,9,25,27,-2,29
Mattersburg,7482,5,7,6,11,31,40,-9,27
SC Rheindorf,7482,6,6,6,12,18,28,-10,24
Vienna,7482,7,6,6,12,24,39,-15,24
FC Salzburg,7483,1,14,7,3,44,19,25,49
SK Sturm Gra,7483,2,12,3,9,35,32,3,39
LASK Linz,7483,3,10,6,8,28,25,3,36
Rapid Vienna,7483,4,8,9,7,34,29,5,33
SC Rheindorf,7483,5,6,7,11,24,32,-8,25
Vienna,7483,6,6,7,11,25,39,-14,25
Mattersburg,7483,7,5,7,12,31,45,-14,22
FC Salzburg,7484,1,14,8,2,48,17,31,50
SK Sturm Gra,7484,2,13,5,6,36,26,10,44
Rapid Vienna,7484,3,7,10,7,34,36,-2,31
LASK Linz,7484,4,8,6,10,25,29,-4,30
Mattersburg,7484,5,7,6,11,31,40,-9,27
Vienna,7484,6,7,5,12,26,41,-15,26
SC Rheindorf,7484,7,4,8,12,18,29,-11,20
FC Salzburg,7485,1,14,8,2,45,18,27,50
SK Sturm Gra,7485,2,12,5,7,34,30,4,41
Rapid Vienna,7485,3,8,10,6,34,27,7,34
LASK Linz,7485,4,9,6,9,31,29,2,33
Vienna,7485,5,7,6,11,27,39,-12,27
Mattersburg,7485,6,6,5,13,28,45,-17,23
SC Rheindorf,7485,7,5,6,13,20,31,-11,21
FC Salzburg,7486,1,12,8,4,41,20,21,44
SK Sturm Gra,7486,2,12,6,6,32,27,5,42
Rapid Vienna,7486,3,9,9,6,38,28,10,36
LASK Linz,7486,4,9,6,9,27,27,0,33
Mattersburg,7486,5,8,6,10,35,39,-4,30
Vienna,7486,6,7,5,12,26,41,-15,26
SC Rheindorf,7486,7,4,6,14,17,34,-17,18
FC Salzburg,7487,1,13,8,3,44,19,25,47
SK Sturm Gra,7487,2,13,4,7,36,28,8,43
LASK Linz,7487,3,10,5,9,27,25,2,35
Rapid Vienna,7487,4,7,10,7,31,30,1,31
Mattersburg,7487,5,8,5,11,34,43,-9,29
Vienna,7487,6,6,6,12,25,40,-15,24
SC Rheindorf,7487,7,5,6,13,19,31,-12,21
FC Salzburg,7488,1,13,8,3,41,18,23,47
SK Sturm Gra,7488,2,12,4,8,31,28,3,40
Rapid Vienna,7488,3,8,11,5,35,28,7,35
LASK Linz,7488,4,8,7,9,29,30,-1,31
Mattersburg,7488,5,8,5,11,35,44,-9,29
Vienna,7488,6,7,5,12,27,39,-12,26
SC Rheindorf,7488,7,5,6,13,22,33,-11,21
FC Salzburg,7489,1,14,7,3,44,22,22,49
SK Sturm Gra,7489,2,13,5,6,35,25,10,44
Rapid Vienna,7489,3,8,11,5,35,28,7,35
LASK Linz,7489,4,8,7,9,26,32,-6,31
Mattersburg,7489,5,7,7,10,37,40,-3,28
Vienna,7489,6,6,5,13,23,39,-16,23
SC Rheindorf,7489,7,4,6,14,20,34,-14,18
FC Salzburg,7490,1,15,7,2,47,20,27,52
SK Sturm Gra,7490,2,12,4,8,33,30,3,40
Rapid Vienna,7490,3,7,11,6,33,27,6,32
LASK Linz,7490,4,8,7,9,29,30,-1,31
Vienna,7490,5,7,5,12,29,41,-12,26
SC Rheindorf,7490,6,6,6,12,22,32,-10,24
Mattersburg,7490,7,6,6,12,33,46,-13,24
FC Salzburg,7491,1,14,8,2,47,18,29,50
SK Sturm Gra,7491,2,14,3,7,35,29,6,45
Rapid Vienna,7491,3,8,11,5,36,29,7,35
LASK Linz,7491,4,9,6,9,28,26,2,33
Mattersburg,7491,5,7,5,12,31,43,-12,26
Vienna,7491,6,6,6,12,26,41,-15,24
SC Rheindorf,7491,7,4,5,15,19,36,-17,17
FC Salzburg,7492,1,13,6,5,47,24,23,45
SK Sturm Gra,7492,2,13,3,8,34,30,4,42
Rapid Vienna,7492,3,10,9,5,41,26,15,39
LASK Linz,7492,4,9,5,10,28,30,-2,32
Vienna,7492,5,7,5,12,26,40,-14,26
SC Rheindorf,7492,6,6,6,12,21,33,-12,24
Mattersburg,7492,7,6,6,12,31,45,-14,24
FC Salzburg,7493,1,14,8,2,46,19,27,50
SK Sturm Gra,7493,2,12,4,8,31,27,4,40
Rapid Vienna,7493,3,9,10,5,36,27,9,37
LASK Linz,7493,4,8,7,9,25,26,-1,31
Vienna,7493,5,7,6,11,26,39,-13,27
Mattersburg,7493,6,7,5,12,28,40,-12,26
SC Rheindorf,7493,7,4,6,14,16,30,-14,18
FC Salzburg,7494,1,15,7,2,43,16,27,52
SK Sturm Gra,7494,2,13,4,7,31,26,5,43
Rapid Vienna,7494,3,8,10,6,34,27,7,34
LASK Linz,7494,4,7,7,10,27,30,-3,28
Mattersburg,7494,5,6,7,11,28,38,-10,25
SC Rheindorf,7494,6,6,6,12,22,31,-9,24
Vienna,7494,7,6,5,13,23,40,-17,23
FC Salzburg,7495,1,14,7,3,42,22,20,49
SK Sturm Gra,7495,2,12,4,8,31,30,1,40
Rapid Vienna,7495,3,9,10,5,35,24,11,37
LASK Linz,7495,4,8,7,9,27,29,-2,31
Vienna,7495,5,7,5,12,29,40,-11,26
Mattersburg,7495,6,6,7,11,32,40,-8,25
SC Rheindorf,7495,7,4,8,12,19,30,-11,20
FC Salzburg,7496,1,14,7,3,46,19,27,49
SK Sturm Gra,7496,2,12,4,8,36,30,6,40
Rapid Vienna,7496,3,9,9,6,40,28,12,36
LASK Linz,7496,4,9,5,10,28,34,-6,32
Mattersburg,7496,5,7,5,12,30,40,-10,26
Vienna,7496,6,7,5,12,27,41,-14,26
SC Rheindorf,7496,7,6,5,13,18,33,-15,23
FC Salzburg,7497,1,14,7,3,43,18,25,49
SK Sturm Gra,7497,2,13,4,7,32,27,5,43
Rapid Vienna,7497,3,10,9,5,41,28,13,39
LASK Linz,7497,4,7,6,11,25,32,-7,27
Mattersburg,7497,5,7,5,12,32,41,-9,26
Vienna,7497,6,7,5,12,25,40,-15,26
SC Rheindorf,7497,7,5,6,13,18,30,-12,21
FC Salzburg,7498,1,15,7,2,46,16,30,52
SK Sturm Gra,7498,2,11,6,7,31,31,0,39
Rapid Vienna,7498,3,8,10,6,35,28,7,34
LASK Linz,7498,4,9,6,9,30,28,2,33
Vienna,7498,5,7,5,12,27,40,-13,26
SC Rheindorf,7498,6,6,5,13,21,28,-7,23
Mattersburg,7498,7,6,5,13,28,47,-19,23
FC Salzburg,7499,1,14,7,3,44,21,23,49
SK Sturm Gra,7499,2,13,4,7,34,27,7,43
Rapid Vienna,7499,3,8,11,5,39,29,10,35
LASK Linz,7499,4,8,5,11,25,29,-4,29
Mattersburg,7499,5,8,5,11,31,38,-7,29
SC Rheindorf,7499,6,6,5,13,19,30,-11,23
Vienna,7499,7,6,5,13,23,41,-18,23
FC Salzburg,7500,1,15,7,2,44,18,26,52
SK Sturm Gra,7500,2,12,4,8,35,33,2,40
Rapid Vienna,7500,3,8,10,6,36,28,8,34
LASK Linz,7500,4,8,7,9,26,27,-1,31
Vienna,7500,5,7,5,12,27,40,-13,26
Mattersburg,7500,6,6,6,12,30,42,-12,24
SC Rheindorf,7500,7,5,7,12,19,29,-10,22
FC Salzburg,7501,1,15,7,2,47,17,30,52
SK Sturm Gra,7501,2,11,5,8,29,30,-1,38
Rapid Vienna,7501,3,8,10,6,33,26,7,34
LASK Linz,7501,4,7,8,9,25,28,-3,29
SC Rheindorf,7501,5,7,6,11,20,26,-6,27
Vienna,7501,6,6,7,11,25,39,-14,25
Mattersburg,7501,7,5,7,12,30,43,-13,22
FC Salzburg,7502,1,15,7,2,51,18,33,52
Rapid Vienna,7502,2,10,10,4,38,26,12,40
SK Sturm Gra,7502,3,12,4,8,34,30,4,40
LASK Linz,7502,4,8,5,11,27,33,-6,29
Vienna,7502,5,7,5,12,26,41,-15,26
Mattersburg,7502,6,6,6,12,31,46,-15,24
SC Rheindorf,7502,7,4,7,13,19,32,-13,19
FC Salzburg,7503,1,13,8,3,43,19,24,47
SK Sturm Gra,7503,2,14,3,7,34,29,5,45
Rapid Vienna,7503,3,7,10,7,34,30,4,31
LASK Linz,7503,4,8,5,11,27,31,-4,29
Mattersburg,7503,5,7,6,11,32,42,-10,27
SC Rheindorf,7503,6,7,5,12,24,30,-6,26
Vienna,7503,7,7,5,12,26,39,-13,26
FC Salzburg,7504,1,14,7,3,44,19,25,49
Rapid Vienna,7504,2,10,10,4,39,24,15,40
SK Sturm Gra,7504,3,11,4,9,30,29,1,37
LASK Linz,7504,4,8,6,10,24,27,-3,30
Vienna,7504,5,7,5,12,27,41,-14,26
SC Rheindorf,7504,6,6,6,12,18,28,-10,24
Mattersburg,7504,7,6,6,12,28,42,-14,24
FC Salzburg,7505,1,15,7,2,45,17,28,52
SK Sturm Gra,7505,2,11,4,9,31,31,0,37
Rapid Vienna,7505,3,9,9,6,36,29,7,36
LASK Linz,7505,4,9,6,9,26,26,0,33
Vienna,7505,5,7,6,11,25,38,-13,27
SC Rheindorf,7505,6,6,7,11,19,27,-8,25
Mattersburg,7505,7,5,5,14,30,44,-14,20
FC Salzburg,7506,1,14,6,4,45,20,25,48
SK Sturm Gra,7506,2,14,4,6,35,27,8,46
LASK Linz,7506,3,8,7,9,29,29,0,31
Rapid Vienna,7506,4,7,9,8,33,32,1,30
Vienna,7506,5,7,5,12,25,39,-14,26
SC Rheindorf,7506,6,6,7,11,24,28,-4,25
Mattersburg,7506,7,6,6,12,31,47,-16,24
FC Salzburg,7507,1,15,6,3,45,20,25,51
SK Sturm Gra,7507,2,13,4,7,34,28,6,43
LASK Linz,7507,3,10,6,8,31,26,5,36
Rapid Vienna,7507,4,7,9,8,32,31,1,30
Vienna,7507,5,8,5,11,30,40,-10,29
Mattersburg,7507,6,6,5,13,32,45,-13,23
SC Rheindorf,7507,7,5,5,14,18,32,-14,20
SK Sturm Gra,7508,1,15,3,6,37,29,8,48
FC Salzburg,7508,2,13,7,4,41,20,21,46
Rapid Vienna,7508,3,9,9,6,37,30,7,36
LASK Linz,7508,4,9,5,10,34,31,3,32
Vienna,7508,5,7,6,11,26,37,-11,27
SC Rheindorf,7508,6,5,6,13,20,32,-12,21
Mattersburg,7508,7,5,6,13,29,45,-16,21
FC Salzburg,7509,1,16,6,2,45,16,29,54
SK Sturm Gra,7509,2,12,4,8,32,30,2,40
Rapid Vienna,7509,3,7,11,6,33,29,4,32
LASK Linz,7509,4,8,7,9,28,28,0,31
Mattersburg,7509,5,7,5,12,31,42,-11,26
SC Rheindorf,7509,6,6,6,12,24,32,-8,24
Vienna,7509,7,6,5,13,25,41,-16,23
FC Salzburg,7510,1,15,7,2,46,17,29,52
SK Sturm Gra,7510,2,14,3,7,35,27,8,45
Rapid Vienna,7510,3,8,10,6,34,29,5,34
LASK Linz,7510,4,8,6,10,28,32,-4,30
Mattersburg,7510,5,6,7,11,33,44,-11,25
Vienna,7510,6,6,5,13,24,42,-18,23
SC Rheindorf,7510,7,5,6,13,19,28,-9,21
FC Salzburg,7511,1,15,6,3,47,18,29,51
SK Sturm Gra,7511,2,12,4,8,31,32,-1,40
LASK Linz,7511,3,9,6,9,26,26,0,33
Rapid Vienna,7511,4,7,11,6,32,26,6,32
Mattersburg,7511,5,7,6,11,30,40,-10,27
Vienna,7511,6,7,5,12,26,39,-13,26
SC Rheindorf,7511,7,4,8,12,17,28,-11,20
FC Salzburg,7512,1,15,7,2,44,15,29,52
SK Sturm Gra,7512,2,12,3,9,32,32,0,39
Rapid Vienna,7512,3,9,9,6,37,29,8,36
LASK Linz,7512,4,8,6,10,30,32,-2,30
Mattersburg,7512,5,6,7,11,30,41,-11,25
SC Rheindorf,7512,6,6,6,12,20,28,-8,24
Vienna,7512,7,6,6,12,24,40,-16,24
FC Salzburg,7513,1,13,8,3,42,19,23,47
SK Sturm Gra,7513,2,11,5,8,30,30,0,38
Rapid Vienna,7513,3,7,13,4,34,26,8,34
LASK Linz,7513,4,9,6,9,27,29,-2,33
Mattersburg,7513,5,9,5,10,37,39,-2,32
Vienna,7513,6,6,5,13,25,41,-16,23
SC Rheindorf,7513,7,5,6,13,19,30,-11,21
FC Salzburg,7514,1,14,7,3,45,20,25,49
SK Sturm Gra,7514,2,14,3,7,35,28,7,45
LASK Linz,7514,3,9,6,9,29,28,1,33
Rapid Vienna,7514,4,7,11,6,33,28,5,32
Mattersburg,7514,5,6,6,12,31,44,-13,24
Vienna,7514,6,6,6,12,26,41,-15,24
SC Rheindorf,7514,7,5,7,12,18,28,-10,22
FC Salzburg,7515,1,16,6,2,46,18,28,54
SK Sturm Gra,7515,2,11,4,9,29,29,0,37
Rapid Vienna,7515,3,8,10,6,33,28,5,34
LASK Linz,7515,4,9,6,9,29,28,1,33
Mattersburg,7515,5,7,6,11,32,39,-7,27
Vienna,7515,6,6,5,13,27,45,-18,23
SC Rheindorf,7515,7,5,7,12,20,29,-9,22
FC Salzburg,7516,1,14,6,4,43,18,25,48
SK Sturm Gra,7516,2,12,4,8,31,28,3,40
Rapid Vienna,7516,3,9,11,4,35,25,10,38
LASK Linz,7516,4,8,7,9,27,28,-1,31
Vienna,7516,5,7,5,12,28,42,-14,26
Mattersburg,7516,6,6,6,12,30,43,-13,24
SC Rheindorf,7516,7,6,5,13,19,29,-10,23
FC Salzburg,7517,1,14,7,3,42,18,24,49
SK Sturm Gra,7517,2,13,4,7,34,29,5,43
Rapid Vienna,7517,3,9,10,5,37,26,11,37
LASK Linz,7517,4,7,6,11,27,35,-8,27
Vienna,7517,5,7,5,12,26,40,-14,26
SC Rheindorf,7517,6,6,7,11,23,30,-7,25
Mattersburg,7517,7,6,5,13,34,45,-11,23
FC Salzburg,7518,1,15,7,2,45,17,28,52
SK Sturm Gra,7518,2,12,4,8,30,29,1,40
Rapid Vienna,7518,3,8,11,5,34,26,8,35
LASK Linz,7518,4,8,6,10,27,27,0,30
Vienna,7518,5,7,5,12,26,39,-13,26
SC Rheindorf,7518,6,5,8,11,18,27,-9,23
Mattersburg,7518,7,5,7,12,27,42,-15,22
FC Salzburg,7519,1,14,8,2,47,19,28,50
SK Sturm Gra,7519,2,12,3,9,33,32,1,39
LASK Linz,7519,3,10,6,8,27,25,2,36
Rapid Vienna,7519,4,8,10,6,35,28,7,34
Vienna,7519,5,7,6,11,28,41,-13,27
Mattersburg,7519,6,6,6,12,31,43,-12,24
SC Rheindorf,7519,7,5,5,14,17,30,-13,20
FC Salzburg,7520,1,14,7,3,48,20,28,49
SK Sturm Gra,7520,2,11,6,7,30,27,3,39
Rapid Vienna,7520,3,9,11,4,35,25,10,38
LASK Linz,7520,4,9,7,8,29,26,3,34
Vienna,7520,5,7,6,11,28,41,-13,27
Mattersburg,7520,6,6,5,13,29,47,-18,23
SC Rheindorf,7520,7,4,6,14,15,28,-13,18
FC Salzburg,7521,1,15,7,2,44,17,27,52
SK Sturm Gra,7521,2,12,5,7,32,28,4,41
Rapid Vienna,7521,3,7,11,6,33,28,5,32
LASK Linz,7521,4,9,5,10,29,31,-2,32
Mattersburg,7521,5,8,6,10,34,37,-3,30
Vienna,7521,6,6,5,13,23,40,-17,23
SC Rheindorf,7521,7,4,7,13,18,32,-14,19
FC Salzburg,7522,1,15,6,3,46,19,27,51
SK Sturm Gra,7522,2,12,4,8,32,30,2,40
Rapid Vienna,7522,3,7,12,5,34,27,7,33
LASK Linz,7522,4,9,6,9,29,28,1,33
Mattersburg,7522,5,7,5,12,29,41,-12,26
Vienna,7522,6,7,5,12,25,39,-14,26
SC Rheindorf,7522,7,5,6,13,18,29,-11,21
FC Salzburg,7523,1,16,6,2,48,16,32,54
SK Sturm Gra,7523,2,14,3,7,34,28,6,45
LASK Linz,7523,3,9,6,9,31,28,3,33
Rapid Vienna,7523,4,7,9,8,31,33,-2,30
Vienna,7523,5,7,5,12,27,40,-13,26
Mattersburg,7523,6,6,5,13,33,46,-13,23
SC Rheindorf,7523,7,5,6,13,20,33,-13,21
FC Salzburg,7524,1,16,6,2,48,17,31,54
SK Sturm Gra,7524,2,12,4,8,34,31,3,40
LASK Linz,7524,3,8,7,9,29,32,-3,31
Rapid Vienna,7524,4,7,9,8,32,31,1,30
Mattersburg,7524,5,7,6,11,35,44,-9,27
SC Rheindorf,7524,6,6,6,12,23,30,-7,24
Vienna,7524,7,6,6,12,28,44,-16,24
FC Salzburg,7525,1,15,6,3,47,19,28,51
SK Sturm Gra,7525,2,12,4,8,33,33,0,40
LASK Linz,7525,3,9,6,9,26,26,0,33
Rapid Vienna,7525,4,7,11,6,35,31,4,32
SC Rheindorf,7525,5,7,6,11,23,27,-4,27
Vienna,7525,6,7,5,12,25,40,-15,26
Mattersburg,7525,7,5,6,13,29,42,-13,21
FC Salzburg,7526,1,15,6,3,47,18,29,51
SK Sturm Gra,7526,2,13,4,7,33,28,5,43
Rapid Vienna,7526,3,9,9,6,39,29,10,36
LASK Linz,7526,4,8,6,10,27,32,-5,30
Mattersburg,7526,5,7,6,11,31,41,-10,27
Vienna,7526,6,6,5,13,24,41,-17,23
SC Rheindorf,7526,7,5,6,13,19,31,-12,21
FC Salzburg,7527,1,14,7,3,49,22,27,49
SK Sturm Gra,7527,2,12,4,8,32,30,2,40
Rapid Vienna,7527,3,8,10,6,32,29,3,34
LASK Linz,7527,4,9,5,10,28,27,1,32
Vienna,7527,5,8,5,11,27,39,-12,29
SC Rheindorf,7527,6,6,6,12,19,27,-8,24
Mattersburg,7527,7,6,5,13,32,45,-13,23
FC Salzburg,7528,1,13,7,4,43,21,22,46
SK Sturm Gra,7528,2,12,4,8,33,30,3,40
Rapid Vienna,7528,3,9,11,4,37,25,12,38
LASK Linz,7528,4,7,6,11,24,31,-7,27
Mattersburg,7528,5,7,6,11,34,42,-8,27
SC Rheindorf,7528,6,7,5,12,22,30,-8,26
Vienna,7528,7,6,7,11,25,39,-14,25
FC Salzburg,7529,1,15,7,2,44,17,27,52
SK Sturm Gra,7529,2,12,4,8,30,27,3,40
LASK Linz,7529,3,10,6,8,31,26,5,36
Rapid Vienna,7529,4,7,11,6,34,29,5,32
Vienna,7529,5,7,6,11,24,37,-13,27
Mattersburg,7529,6,6,5,13,32,42,-10,23
SC Rheindorf,7529,7,4,7,13,17,34,-17,19
FC Salzburg,7530,1,14,7,3,45,20,25,49
SK Sturm Gra,7530,2,12,4,8,32,30,2,40
LASK Linz,7530,3,10,5,9,33,31,2,35
Rapid Vienna,7530,4,7,12,5,34,28,6,33
SC Rheindorf,7530,5,6,6,12,22,30,-8,24
Mattersburg,7530,6,6,6,12,33,45,-12,24
Vienna,7530,7,6,6,12,24,39,-15,24
FC Salzburg,7531,1,14,7,3,47,18,29,49
SK Sturm Gra,7531,2,14,3,7,36,26,10,45
LASK Linz,7531,3,9,5,10,30,34,-4,32
Rapid Vienna,7531,4,7,9,8,32,32,0,30
Vienna,7531,5,7,6,11,27,39,-12,27
Mattersburg,7531,6,7,5,12,33,46,-13,26
SC Rheindorf,7531,7,6,5,13,18,28,-10,23
FC Salzburg,7532,1,13,7,4,42,22,20,46
SK Sturm Gra,7532,2,12,5,7,35,29,6,41
Rapid Vienna,7532,3,10,9,5,38,25,13,39
LASK Linz,7532,4,9,5,10,27,31,-4,32
Mattersburg,7532,5,8,5,11,33,41,-8,29
Vienna,7532,6,7,5,12,27,40,-13,26
SC Rheindorf,7532,7,4,6,14,17,31,-14,18
FC Salzburg,7533,1,16,6,2,49,16,33,54
Rapid Vienna,7533,2,10,9,5,37,27,10,39
SK Sturm Gra,7533,3,12,3,9,29,30,-1,39
LASK Linz,7533,4,8,6,10,27,27,0,30
Vienna,7533,5,7,5,12,26,39,-13,26
Mattersburg,7533,6,6,6,12,32,46,-14,24
SC Rheindorf,7533,7,5,5,14,20,35,-15,20
FC Salzburg,7534,1,15,7,2,44,16,28,52
SK Sturm Gra,7534,2,11,5,8,30,28,2,38
Rapid Vienna,7534,3,8,11,5,34,27,7,35
LASK Linz,7534,4,8,7,9,26,29,-3,31
Mattersburg,7534,5,7,5,12,31,41,-10,26
Vienna,7534,6,6,6,12,24,39,-15,24
SC Rheindorf,7534,7,5,7,12,22,31,-9,22
FC Salzburg,7535,1,14,6,4,44,19,25,48
SK Sturm Gra,7535,2,12,3,9,29,29,0,39
Rapid Vienna,7535,3,9,10,5,38,26,12,37
LASK Linz,7535,4,9,6,9,29,27,2,33
Vienna,7535,5,8,5,11,26,38,-12,29
SC Rheindorf,7535,6,6,5,13,19,31,-12,23
Mattersburg,7535,7,6,5,13,30,45,-15,23
FC Salzburg,7536,1,14,6,4,44,18,26,48
SK Sturm Gra,7536,2,13,3,8,34,32,2,42
LASK Linz,7536,3,11,5,8,32,27,5,38
Rapid Vienna,7536,4,8,9,7,37,32,5,33
Vienna,7536,5,7,5,12,26,41,-15,26
SC Rheindorf,7536,6,6,5,13,21,31,-10,23
Mattersburg,7536,7,6,5,13,31,44,-13,23
FC Salzburg,7537,1,16,6,2,49,18,31,54
SK Sturm Gra,7537,2,13,4,7,35,27,8,43
Rapid Vienna,7537,3,8,10,6,35,33,2,34
LASK Linz,7537,4,8,6,10,27,29,-2,30
Mattersburg,7537,5,6,6,12,30,41,-11,24
Vienna,7537,6,6,5,13,24,42,-18,23
SC Rheindorf,7537,7,4,9,11,18,28,-10,21
FC Salzburg,7538,1,14,6,4,44,20,24,48
SK Sturm Gra,7538,2,12,5,7,34,31,3,41
LASK Linz,7538,3,9,6,9,28,27,1,33
Rapid Vienna,7538,4,7,10,7,35,30,5,31
Mattersburg,7538,5,7,6,11,29,39,-10,27
Vienna,7538,6,7,6,11,26,39,-13,27
SC Rheindorf,7538,7,6,5,13,18,28,-10,23
FC Salzburg,7539,1,14,7,3,46,21,25,49
SK Sturm Gra,7539,2,14,3,7,34,27,7,45
LASK Linz,7539,3,10,5,9,31,27,4,35
Rapid Vienna,7539,4,7,11,6,33,31,2,32
Vienna,7539,5,7,5,12,28,40,-12,26
Mattersburg,7539,6,6,5,13,30,45,-15,23
SC Rheindorf,7539,7,5,6,13,18,29,-11,21
FC Salzburg,7540,1,14,7,3,43,19,24,49
Rapid Vienna,7540,2,10,9,5,41,32,9,39
SK Sturm Gra,7540,3,11,4,9,34,34,0,37
LASK Linz,7540,4,9,7,8,32,27,5,34
Mattersburg,7540,5,7,5,12,33,42,-9,26
Vienna,7540,6,6,6,12,25,41,-16,24
SC Rheindorf,7540,7,5,6,13,21,34,-13,21
FC Salzburg,7541,1,13,8,3,43,19,24,47
SK Sturm Gra,7541,2,12,3,9,34,32,2,39
Rapid Vienna,7541,3,8,11,5,34,30,4,35
LASK Linz,7541,4,9,6,9,32,28,4,33
Vienna,7541,5,7,6,11,26,39,-13,27
SC Rheindorf,7541,6,6,6,12,20,30,-10,24
Mattersburg,7541,7,5,8,11,30,41,-11,23
FC Salzburg,7542,1,14,6,4,43,19,24,48
SK Sturm Gra,7542,2,14,4,6,33,26,7,46
Rapid Vienna,7542,3,8,9,7,34,29,5,33
LASK Linz,7542,4,9,6,9,28,27,1,33
Vienna,7542,5,7,6,11,24,37,-13,27
SC Rheindorf,7542,6,5,7,12,21,29,-8,22
Mattersburg,7542,7,5,6,13,29,45,-16,21
FC Salzburg,7543,1,16,6,2,48,19,29,54
SK Sturm Gra,7543,2,13,4,7,34,28,6,43
Rapid Vienna,7543,3,8,9,7,32,29,3,33
LASK Linz,7543,4,9,5,10,28,31,-3,32
Mattersburg,7543,5,7,6,11,34,40,-6,27
Vienna,7543,6,6,6,12,25,40,-15,24
SC Rheindorf,7543,7,4,6,14,16,30,-14,18
FC Salzburg,7544,1,14,6,4,43,18,25,48
SK Sturm Gra,7544,2,12,3,9,33,33,0,39
Rapid Vienna,7544,3,9,10,5,37,28,9,37
LASK Linz,7544,4,9,7,8,33,31,2,34
Mattersburg,7544,5,7,6,11,35,44,-9,27
Vienna,7544,6,6,5,13,25,42,-17,23
SC Rheindorf,7544,7,5,7,12,22,32,-10,22
FC Salzburg,7545,1,16,6,2,47,16,31,54
SK Sturm Gra,7545,2,13,4,7,32,27,5,43
Rapid Vienna,7545,3,8,9,7,37,30,7,33
LASK Linz,7545,4,8,5,11,26,29,-3,29
Mattersburg,7545,5,7,6,11,29,40,-11,27
Vienna,7545,6,6,6,12,24,41,-17,24
SC Rheindorf,7545,7,5,6,13,17,29,-12,21
FC Salzburg,7546,1,15,7,2,44,18,26,52
SK Sturm Gra,7546,2,13,4,7,31,26,5,43
LASK Linz,7546,3,9,7,8,31,28,3,34
Rapid Vienna,7546,4,7,9,8,33,30,3,30
Vienna,7546,5,6,6,12,25,40,-15,24
SC Rheindorf,7546,6,6,5,13,20,30,-10,23
Mattersburg,7546,7,5,8,11,32,44,-12,23
FC Salzburg,7547,1,14,7,3,43,19,24,49
SK Sturm Gra,7547,2,13,5,6,33,25,8,44
Rapid Vienna,7547,3,8,9,7,37,30,7,33
LASK Linz,7547,4,9,6,9,28,26,2,33
Mattersburg,7547,5,7,6,11,31,41,-10,27
Vienna,7547,6,6,5,13,24,42,-18,23
SC Rheindorf,7547,7,5,6,13,18,31,-13,21
FC Salzburg,7548,1,13,7,4,40,21,19,46
Rapid Vienna,7548,2,10,10,4,38,24,14,40
SK Sturm Gra,7548,3,11,6,7,30,28,2,39
LASK Linz,7548,4,9,7,8,28,27,1,34
Vienna,7548,5,7,6,11,26,37,-11,27
Mattersburg,7548,6,6,6,12,30,41,-11,24
SC Rheindorf,7548,7,4,6,14,15,29,-14,18
FC Salzburg,7549,1,15,6,3,44,17,27,51
SK Sturm Gra,7549,2,13,3,8,30,28,2,42
Rapid Vienna,7549,3,9,10,5,36,27,9,37
LASK Linz,7549,4,8,7,9,26,27,-1,31
Mattersburg,7549,5,7,5,12,34,43,-9,26
Vienna,7549,6,7,5,12,26,39,-13,26
SC Rheindorf,7549,7,4,6,14,16,31,-15,18
FC Salzburg,7550,1,15,7,2,47,19,28,52
SK Sturm Gra,7550,2,13,3,8,33,31,2,42
Rapid Vienna,7550,3,9,9,6,38,30,8,36
LASK Linz,7550,4,7,6,11,25,29,-4,27
SC Rheindorf,7550,5,7,5,12,20,27,-7,26
Vienna,7550,6,7,5,12,25,38,-13,26
Mattersburg,7550,7,5,7,12,27,41,-14,22
FC Salzburg,7551,1,14,8,2,48,18,30,50
SK Sturm Gra,7551,2,11,6,7,32,29,3,39
Rapid Vienna,7551,3,7,13,4,36,28,8,34
LASK Linz,7551,4,9,7,8,31,29,2,34
SC Rheindorf,7551,5,6,6,12,22,29,-7,24
Vienna,7551,6,6,6,12,25,41,-16,24
Mattersburg,7551,7,5,6,13,29,49,-20,21
FC Salzburg,7552,1,13,8,3,41,18,23,47
SK Sturm Gra,7552,2,12,5,7,31,27,4,41
Rapid Vienna,7552,3,8,10,6,34,28,6,34
SC Rheindorf,7552,4,8,5,11,22,26,-4,29
LASK Linz,7552,5,7,7,10,26,29,-3,28
Vienna,7552,6,7,5,12,25,40,-15,26
Mattersburg,7552,7,6,6,12,32,43,-11,24
FC Salzburg,7553,1,15,6,3,43,17,26,51
SK Sturm Gra,7553,2,12,3,9,32,35,-3,39
LASK Linz,7553,3,8,8,8,28,25,3,32
Rapid Vienna,7553,4,7,10,7,34,30,4,31
SC Rheindorf,7553,5,7,6,11,22,27,-5,27
Vienna,7553,6,7,5,12,25,40,-15,26
Mattersburg,7553,7,6,6,12,29,39,-10,24
FC Salzburg,7554,1,14,6,4,44,19,25,48
SK Sturm Gra,7554,2,14,3,7,34,26,8,45
LASK Linz,7554,3,9,5,10,27,30,-3,32
Rapid Vienna,7554,4,7,10,7,34,29,5,31
SC Rheindorf,7554,5,7,6,11,22,27,-5,27
Vienna,7554,6,7,6,11,27,39,-12,27
Mattersburg,7554,7,5,6,13,31,49,-18,21
FC Salzburg,7555,1,13,6,5,41,20,21,45
Rapid Vienna,7555,2,10,10,4,40,26,14,40
SK Sturm Gra,7555,3,12,4,8,31,29,2,40
LASK Linz,7555,4,9,6,9,34,32,2,33
Vienna,7555,5,8,5,11,29,38,-9,29
Mattersburg,7555,6,6,5,13,30,49,-19,23
SC Rheindorf,7555,7,5,6,13,21,32,-11,21
FC Salzburg,7556,1,14,7,3,50,22,28,49
SK Sturm Gra,7556,2,12,6,6,33,27,6,42
Rapid Vienna,7556,3,8,11,5,37,29,8,35
LASK Linz,7556,4,8,7,9,30,27,3,31
Vienna,7556,5,6,6,12,27,47,-20,24
Mattersburg,7556,6,5,8,11,32,47,-15,23
SC Rheindorf,7556,7,4,9,11,18,28,-10,21
FC Salzburg,7557,1,16,6,2,51,21,30,54
SK Sturm Gra,7557,2,12,3,9,32,30,2,39
Rapid Vienna,7557,3,8,10,6,34,29,5,34
LASK Linz,7557,4,8,6,10,26,31,-5,30
Mattersburg,7557,5,7,5,12,35,42,-7,26
Vienna,7557,6,7,5,12,27,41,-14,26
SC Rheindorf,7557,7,6,5,13,19,30,-11,23
FC Salzburg,7558,1,14,8,2,45,18,27,50
SK Sturm Gra,7558,2,13,4,7,37,30,7,43
Rapid Vienna,7558,3,8,11,5,39,33,6,35
LASK Linz,7558,4,7,7,10,27,34,-7,28
Mattersburg,7558,5,7,6,11,32,39,-7,27
Vienna,7558,6,6,5,13,24,42,-18,23
SC Rheindorf,7558,7,5,7,12,21,29,-8,22
FC Salzburg,7559,1,13,7,4,43,22,21,46
SK Sturm Gra,7559,2,14,3,7,40,29,11,45
Rapid Vienna,7559,3,8,11,5,37,31,6,35
LASK Linz,7559,4,7,8,9,27,31,-4,29
Vienna,7559,5,7,5,12,26,39,-13,26
SC Rheindorf,7559,6,5,8,11,20,29,-9,23
Mattersburg,7559,7,5,8,11,29,41,-12,23
FC Salzburg,7560,1,15,7,2,46,17,29,52
SK Sturm Gra,7560,2,14,4,6,35,26,9,46
LASK Linz,7560,3,10,5,9,34,28,6,35
Rapid Vienna,7560,4,8,9,7,36,32,4,33
Vienna,7560,5,7,5,12,25,40,-15,26
Mattersburg,7560,6,6,5,13,30,44,-14,23
SC Rheindorf,7560,7,4,5,15,15,34,-19,17
FC Salzburg,7561,1,15,7,2,47,16,31,52
SK Sturm Gra,7561,2,13,3,8,35,27,8,42
Rapid Vienna,7561,3,8,10,6,33,28,5,34
LASK Linz,7561,4,8,6,10,25,31,-6,30
SC Rheindorf,7561,5,7,5,12,21,27,-6,26
Vienna,7561,6,7,5,12,25,39,-14,26
Mattersburg,7561,7,5,6,13,28,46,-18,21
FC Salzburg,7562,1,16,6,2,46,16,30,54
SK Sturm Gra,7562,2,12,3,9,33,32,1,39
Rapid Vienna,7562,3,8,9,7,36,31,5,33
LASK Linz,7562,4,8,6,10,28,30,-2,30
Mattersburg,7562,5,8,5,11,34,41,-7,29
SC Rheindorf,7562,6,6,6,12,20,29,-9,24
Vienna,7562,7,6,5,13,26,44,-18,23
FC Salzburg,7563,1,13,7,4,46,23,23,46
SK Sturm Gra,7563,2,12,5,7,31,28,3,41
Rapid Vienna,7563,3,9,10,5,34,26,8,37
Mattersburg,7563,4,8,6,10,35,40,-5,30
LASK Linz,7563,5,8,5,11,27,31,-4,29
SC Rheindorf,7563,6,6,6,12,20,28,-8,24
Vienna,7563,7,6,5,13,26,43,-17,23
FC Salzburg,7564,1,14,6,4,48,23,25,48
SK Sturm Gra,7564,2,14,3,7,39,32,7,45
Rapid Vienna,7564,3,10,9,5,41,27,14,39
LASK Linz,7564,4,7,6,11,25,31,-6,27
Vienna,7564,5,7,6,11,25,38,-13,27
Mattersburg,7564,6,6,7,11,32,41,-9,25
SC Rheindorf,7564,7,5,5,14,19,37,-18,20
FC Salzburg,7565,1,16,6,2,47,18,29,54
SK Sturm Gra,7565,2,13,4,7,34,28,6,43
Rapid Vienna,7565,3,9,10,5,35,26,9,37
LASK Linz,7565,4,8,6,10,27,31,-4,30
Vienna,7565,5,7,5,12,25,39,-14,26
Mattersburg,7565,6,5,6,13,26,40,-14,21
SC Rheindorf,7565,7,4,7,13,18,30,-12,19
FC Salzburg,7566,1,15,6,3,45,20,25,51
Rapid Vienna,7566,2,10,10,4,41,27,14,40
SK Sturm Gra,7566,3,12,3,9,32,29,3,39
LASK Linz,7566,4,7,6,11,24,32,-8,27
Vienna,7566,5,7,5,12,25,39,-14,26
SC Rheindorf,7566,6,6,7,11,22,29,-7,25
Mattersburg,7566,7,6,5,13,29,42,-13,23
FC Salzburg,7567,1,15,6,3,44,17,27,51
SK Sturm Gra,7567,2,13,3,8,32,29,3,42
Rapid Vienna,7567,3,8,11,5,37,29,8,35
Mattersburg,7567,4,9,5,10,36,37,-1,32
LASK Linz,7567,5,8,6,10,29,29,0,30
Vienna,7567,6,6,5,13,24,41,-17,23
SC Rheindorf,7567,7,4,6,14,16,36,-20,18
FC Salzburg,7568,1,13,6,5,42,21,21,45
SK Sturm Gra,7568,2,14,3,7,35,28,7,45
Rapid Vienna,7568,3,9,10,5,36,26,10,37
LASK Linz,7568,4,8,6,10,26,30,-4,30
Vienna,7568,5,7,5,12,26,41,-15,26
SC Rheindorf,7568,6,6,6,12,20,29,-9,24
Mattersburg,7568,7,6,6,12,31,41,-10,24
FC Salzburg,7569,1,13,8,3,47,21,26,47
SK Sturm Gra,7569,2,12,5,7,36,35,1,41
Rapid Vienna,7569,3,8,10,6,37,30,7,34
LASK Linz,7569,4,7,8,9,26,28,-2,29
SC Rheindorf,7569,5,7,6,11,24,27,-3,27
Mattersburg,7569,6,7,5,12,32,45,-13,26
Vienna,7569,7,6,6,12,24,40,-16,24
FC Salzburg,7570,1,15,7,2,51,16,35,52
SK Sturm Gra,7570,2,14,3,7,34,30,4,45
Rapid Vienna,7570,3,7,12,5,35,28,7,33
Mattersburg,7570,4,8,5,11,35,44,-9,29
LASK Linz,7570,5,7,6,11,26,31,-5,27
Vienna,7570,6,6,5,13,25,45,-20,23
SC Rheindorf,7570,7,5,6,13,18,30,-12,21
FC Salzburg,7571,1,15,7,2,51,20,31,52
SK Sturm Gra,7571,2,11,4,9,30,33,-3,37
Rapid Vienna,7571,3,8,11,5,38,30,8,35
LASK Linz,7571,4,9,5,10,28,29,-1,32
Mattersburg,7571,5,7,5,12,31,40,-9,26
Vienna,7571,6,7,5,12,25,40,-15,26
SC Rheindorf,7571,7,5,7,12,17,28,-11,22
FC Salzburg,7572,1,14,8,2,47,19,28,50
SK Sturm Gra,7572,2,13,4,7,32,27,5,43
Rapid Vienna,7572,3,9,9,6,37,30,7,36
LASK Linz,7572,4,9,5,10,29,29,0,32
Vienna,7572,5,7,6,11,28,41,-13,27
Mattersburg,7572,6,6,5,13,32,47,-15,23
SC Rheindorf,7572,7,5,5,14,20,32,-12,20
FC Salzburg,7573,1,14,7,3,45,20,25,49
Rapid Vienna,7573,2,10,10,4,37,24,13,40
SK Sturm Gra,7573,3,12,4,8,30,29,1,40
LASK Linz,7573,4,8,6,10,26,28,-2,30
Vienna,7573,5,7,5,12,28,40,-12,26
Mattersburg,7573,6,6,7,11,31,44,-13,25
SC Rheindorf,7573,7,5,5,14,17,29,-12,20
FC Salzburg,7574,1,15,7,2,44,17,27,52
SK Sturm Gra,7574,2,12,4,8,30,29,1,40
LASK Linz,7574,3,9,5,10,30,32,-2,32
Rapid Vienna,7574,4,7,10,7,37,33,4,31
Vienna,7574,5,7,6,11,25,38,-13,27
SC Rheindorf,7574,6,7,5,12,24,31,-7,26
Mattersburg,7574,7,6,5,13,30,40,-10,23
FC Salzburg,7575,1,14,7,3,43,18,25,49
SK Sturm Gra,7575,2,11,6,7,30,27,3,39
Rapid Vienna,7575,3,9,11,4,36,25,11,38
LASK Linz,7575,4,7,8,9,26,28,-2,29
Vienna,7575,5,7,6,11,26,39,-13,27
Mattersburg,7575,6,7,5,12,31,42,-11,26
SC Rheindorf,7575,7,4,7,13,17,30,-13,19
FC Salzburg,7576,1,15,7,2,49,17,32,52
SK Sturm Gra,7576,2,13,4,7,33,32,1,43
Rapid Vienna,7576,3,8,9,7,35,29,6,33
LASK Linz,7576,4,8,7,9,28,29,-1,31
Vienna,7576,5,7,6,11,28,40,-12,27
SC Rheindorf,7576,6,6,6,12,19,27,-8,24
Mattersburg,7576,7,5,5,14,28,46,-18,20
FC Salzburg,7577,1,15,6,3,46,20,26,51
SK Sturm Gra,7577,2,13,3,8,34,28,6,42
Rapid Vienna,7577,3,10,9,5,37,26,11,39
LASK Linz,7577,4,8,6,10,28,31,-3,30
Mattersburg,7577,5,6,7,11,35,43,-8,25
Vienna,7577,6,6,6,12,26,41,-15,24
SC Rheindorf,7577,7,5,5,14,17,34,-17,20
FC Salzburg,7578,1,16,6,2,49,20,29,54
SK Sturm Gra,7578,2,12,5,7,32,28,4,41
Rapid Vienna,7578,3,8,10,6,39,34,5,34
LASK Linz,7578,4,9,7,8,29,28,1,34
Mattersburg,7578,5,6,6,12,32,43,-11,24
Vienna,7578,6,6,5,13,25,41,-16,23
SC Rheindorf,7578,7,4,7,13,19,31,-12,19
FC Salzburg,7579,1,14,7,3,43,18,25,49
SK Sturm Gra,7579,2,14,4,6,35,28,7,46
Rapid Vienna,7579,3,7,12,5,32,26,6,33
LASK Linz,7579,4,7,7,10,26,31,-5,28
Mattersburg,7579,5,7,6,11,33,40,-7,27
Vienna,7579,6,6,6,12,24,39,-15,24
SC Rheindorf,7579,7,5,6,13,18,29,-11,21
FC Salzburg,7580,1,13,8,3,41,19,22,47
SK Sturm Gra,7580,2,12,4,8,34,30,4,40
Rapid Vienna,7580,3,8,11,5,35,27,8,35
LASK Linz,7580,4,10,5,9,30,32,-2,35
Vienna,7580,5,8,5,11,27,38,-11,29
Mattersburg,7580,6,6,6,12,31,42,-11,24
SC Rheindorf,7580,7,5,5,14,20,30,-10,20
FC Salzburg,7581,1,16,6,2,50,19,31,54
SK Sturm Gra,7581,2,14,3,7,41,32,9,45
Rapid Vienna,7581,3,9,9,6,34,29,5,36
LASK Linz,7581,4,7,6,11,28,32,-4,27
Mattersburg,7581,5,7,6,11,35,46,-11,27
Vienna,7581,6,6,6,12,26,42,-16,24
SC Rheindorf,7581,7,4,6,14,20,34,-14,18
FC Salzburg,7582,1,13,6,5,43,25,18,45
Rapid Vienna,7582,2,10,9,5,39,28,11,39
LASK Linz,7582,3,10,6,8,31,27,4,36
SK Sturm Gra,7582,4,11,3,10,31,35,-4,36
Vienna,7582,5,8,5,11,28,37,-9,29
Mattersburg,7582,6,6,7,11,31,42,-11,25
SC Rheindorf,7582,7,5,6,13,21,30,-9,21
FC Salzburg,7583,1,14,7,3,49,19,30,49
SK Sturm Gra,7583,2,11,6,7,32,29,3,39
Rapid Vienna,7583,3,9,10,5,36,27,9,37
LASK Linz,7583,4,9,5,10,26,29,-3,32
Mattersburg,7583,5,7,6,11,34,43,-9,27
Vienna,7583,6,6,6,12,26,44,-18,24
SC Rheindorf,7583,7,5,6,13,19,31,-12,21
FC Salzburg,7584,1,16,6,2,49,18,31,54
SK Sturm Gra,7584,2,13,3,8,36,30,6,42
Rapid Vienna,7584,3,8,10,6,34,29,5,34
LASK Linz,7584,4,9,6,9,27,27,0,33
Vienna,7584,5,6,6,12,24,40,-16,24
Mattersburg,7584,6,5,7,12,28,42,-14,22
SC Rheindorf,7584,7,5,6,13,17,29,-12,21
FC Salzburg,7585,1,14,6,4,43,21,22,48
SK Sturm Gra,7585,2,15,3,6,38,26,12,48
Rapid Vienna,7585,3,9,9,6,38,29,9,36
Mattersburg,7585,4,7,6,11,33,40,-7,27
LASK Linz,7585,5,7,6,11,27,34,-7,27
Vienna,7585,6,7,6,11,26,38,-12,27
SC Rheindorf,7585,7,4,6,14,19,36,-17,18
FC Salzburg,7586,1,15,6,3,48,21,27,51
Rapid Vienna,7586,2,10,10,4,39,27,12,40
SK Sturm Gra,7586,3,12,3,9,33,31,2,39
LASK Linz,7586,4,8,7,9,27,29,-2,31
Mattersburg,7586,5,7,6,11,31,41,-10,27
Vienna,7586,6,6,5,13,25,42,-17,23
SC Rheindorf,7586,7,5,5,14,17,29,-12,20
FC Salzburg,7587,1,12,9,3,40,19,21,45
SK Sturm Gra,7587,2,12,5,7,31,27,4,41
LASK Linz,7587,3,10,5,9,30,29,1,35
Rapid Vienna,7587,4,7,10,7,33,29,4,31
Vienna,7587,5,8,5,11,27,38,-11,29
Mattersburg,7587,6,6,6,12,35,41,-6,24
SC Rheindorf,7587,7,6,6,12,19,32,-13,24
FC Salzburg,7588,1,14,7,3,43,17,26,49
SK Sturm Gra,7588,2,13,4,7,30,25,5,43
Rapid Vienna,7588,3,9,10,5,35,26,9,37
LASK Linz,7588,4,7,7,10,23,28,-5,28
Mattersburg,7588,5,7,6,11,32,40,-8,27
Vienna,7588,6,6,6,12,24,40,-16,24
SC Rheindorf,7588,7,4,8,12,18,29,-11,20
FC Salzburg,7589,1,14,7,3,43,18,25,49
SK Sturm Gra,7589,2,13,5,6,33,26,7,44
Rapid Vienna,7589,3,7,12,5,35,29,6,33
LASK Linz,7589,4,8,6,10,27,29,-2,30
Vienna,7589,5,7,6,11,25,38,-13,27
SC Rheindorf,7589,6,6,7,11,23,28,-5,25
Mattersburg,7589,7,5,5,14,27,45,-18,20
FC Salzburg,7590,1,15,7,2,45,17,28,52
SK Sturm Gra,7590,2,13,3,8,33,29,4,42
LASK Linz,7590,3,9,7,8,29,26,3,34
Rapid Vienna,7590,4,7,11,6,34,29,5,32
Mattersburg,7590,5,6,6,12,31,44,-13,24
Vienna,7590,6,6,6,12,26,42,-16,24
SC Rheindorf,7590,7,5,6,13,18,29,-11,21
FC Salzburg,7591,1,14,6,4,46,21,25,48
SK Sturm Gra,7591,2,14,3,7,33,29,4,45
Rapid Vienna,7591,3,10,9,5,38,26,12,39
LASK Linz,7591,4,9,5,10,26,26,0,32
Vienna,7591,5,6,6,12,26,44,-18,24
SC Rheindorf,7591,6,6,5,13,20,30,-10,23
Mattersburg,7591,7,5,6,13,32,45,-13,21
FC Salzburg,7592,1,13,7,4,44,21,23,46
SK Sturm Gra,7592,2,14,3,7,35,29,6,45
LASK Linz,7592,3,9,5,10,28,27,1,32
Rapid Vienna,7592,4,7,10,7,34,30,4,31
Mattersburg,7592,5,7,6,11,33,42,-9,27
Vienna,7592,6,7,5,12,25,39,-14,26
SC Rheindorf,7592,7,6,6,12,21,32,-11,24
FC Salzburg,7593,1,14,7,3,42,19,23,49
SK Sturm Gra,7593,2,13,3,8,37,32,5,42
Rapid Vienna,7593,3,10,10,4,39,24,15,40
LASK Linz,7593,4,8,5,11,29,32,-3,29
Mattersburg,7593,5,7,6,11,34,40,-6,27
Vienna,7593,6,6,5,13,23,43,-20,23
SC Rheindorf,7593,7,5,6,13,19,33,-14,21
FC Salzburg,7594,1,15,6,3,42,18,24,51
SK Sturm Gra,7594,2,13,3,8,31,31,0,42
Rapid Vienna,7594,3,9,10,5,38,24,14,37
Mattersburg,7594,4,8,5,11,34,40,-6,29
LASK Linz,7594,5,7,6,11,23,27,-4,27
Vienna,7594,6,7,5,12,27,41,-14,26
SC Rheindorf,7594,7,5,5,14,18,32,-14,20
FC Salzburg,7595,1,15,7,2,45,19,26,52
Rapid Vienna,7595,2,10,9,5,37,26,11,39
SK Sturm Gra,7595,3,11,3,10,31,35,-4,36
LASK Linz,7595,4,10,5,9,31,28,3,35
Vienna,7595,5,7,6,11,25,37,-12,27
SC Rheindorf,7595,6,6,5,13,24,30,-6,23
Mattersburg,7595,7,5,5,14,29,47,-18,20
FC Salzburg,7596,1,15,6,3,45,17,28,51
SK Sturm Gra,7596,2,15,3,6,36,25,11,48
LASK Linz,7596,3,10,5,9,33,28,5,35
Rapid Vienna,7596,4,7,10,7,34,35,-1,31
Vienna,7596,5,6,6,12,24,39,-15,24
SC Rheindorf,7596,6,5,6,13,18,31,-13,21
Mattersburg,7596,7,5,6,13,28,43,-15,21
FC Salzburg,7597,1,14,8,2,43,16,27,50
SK Sturm Gra,7597,2,12,4,8,31,31,0,40
LASK Linz,7597,3,11,5,8,32,25,7,38
Rapid Vienna,7597,4,8,10,6,35,28,7,34
Mattersburg,7597,5,6,6,12,31,44,-13,24
Vienna,7597,6,6,6,12,24,40,-16,24
SC Rheindorf,7597,7,5,5,14,21,33,-12,20
FC Salzburg,7598,1,13,8,3,45,21,24,47
SK Sturm Gra,7598,2,12,4,8,30,28,2,40
LASK Linz,7598,3,9,7,8,29,25,4,34
Rapid Vienna,7598,4,7,10,7,36,33,3,31
Vienna,7598,5,7,6,11,25,38,-13,27
SC Rheindorf,7598,6,6,7,11,20,28,-8,25
Mattersburg,7598,7,6,6,12,30,42,-12,24
FC Salzburg,7599,1,13,8,3,47,23,24,47
SK Sturm Gra,7599,2,12,3,9,33,34,-1,39
Rapid Vienna,7599,3,9,9,6,38,28,10,36
LASK Linz,7599,4,9,6,9,27,27,0,33
Mattersburg,7599,5,6,8,10,30,39,-9,26
Vienna,7599,6,6,7,11,27,41,-14,25
SC Rheindorf,7599,7,6,5,13,20,30,-10,23
FC Salzburg,7600,1,13,8,3,44,20,24,47
SK Sturm Gra,7600,2,13,4,7,35,29,6,43
Rapid Vienna,7600,3,8,10,6,34,29,5,34
LASK Linz,7600,4,9,5,10,29,29,0,32
SC Rheindorf,7600,5,7,5,12,22,29,-7,26
Mattersburg,7600,6,6,6,12,30,43,-13,24
Vienna,7600,7,6,6,12,25,40,-15,24
FC Salzburg,7601,1,13,7,4,42,20,22,46
SK Sturm Gra,7601,2,13,4,7,34,27,7,43
LASK Linz,7601,3,10,6,8,33,30,3,36
Rapid Vienna,7601,4,8,11,5,37,29,8,35
Mattersburg,7601,5,8,5,11,34,41,-7,29
Vienna,7601,6,6,5,13,24,43,-19,23
SC Rheindorf,7601,7,4,6,14,19,33,-14,18
FC Salzburg,7602,1,15,6,3,45,18,27,51
SK Sturm Gra,7602,2,12,4,8,31,33,-2,40
Rapid Vienna,7602,3,9,9,6,41,28,13,36
SC Rheindorf,7602,4,8,5,11,21,26,-5,29
LASK Linz,7602,5,7,6,11,26,31,-5,27
Vienna,7602,6,7,5,12,26,41,-15,26
Mattersburg,7602,7,6,5,13,30,43,-13,23
FC Salzburg,7603,1,13,6,5,42,19,23,45
SK Sturm Gra,7603,2,13,5,6,36,30,6,44
Rapid Vienna,7603,3,9,9,6,37,29,8,36
LASK Linz,7603,4,8,7,9,27,29,-2,31
Vienna,7603,5,7,5,12,24,40,-16,26
Mattersburg,7603,6,6,6,12,29,40,-11,24
SC Rheindorf,7603,7,5,8,11,22,30,-8,23
FC Salzburg,7604,1,15,6,3,48,20,28,51
SK Sturm Gra,7604,2,14,3,7,35,28,7,45
LASK Linz,7604,3,9,6,9,25,26,-1,33
Rapid Vienna,7604,4,7,10,7,35,30,5,31
Vienna,7604,5,7,5,12,27,42,-15,26
SC Rheindorf,7604,6,5,8,11,20,29,-9,23
Mattersburg,7604,7,5,6,13,28,43,-15,21
FC Salzburg,7605,1,15,6,3,47,19,28,51
SK Sturm Gra,7605,2,12,5,7,32,29,3,41
Rapid Vienna,7605,3,10,9,5,38,26,12,39
Mattersburg,7605,4,8,5,11,30,39,-9,29
LASK Linz,7605,5,7,7,10,25,28,-3,28
Vienna,7605,6,6,5,13,24,42,-18,23
SC Rheindorf,7605,7,4,7,13,18,31,-13,19
FC Salzburg,7606,1,14,6,4,43,19,24,48
SK Sturm Gra,7606,2,12,4,8,31,30,1,40
Rapid Vienna,7606,3,9,10,5,37,27,10,37
LASK Linz,7606,4,10,5,9,28,26,2,35
Vienna,7606,5,8,5,11,27,39,-12,29
Mattersburg,7606,6,6,6,12,29,40,-11,24
SC Rheindorf,7606,7,4,6,14,15,29,-14,18
FC Salzburg,7607,1,16,6,2,50,18,32,54
SK Sturm Gra,7607,2,12,5,7,31,27,4,41
Rapid Vienna,7607,3,9,10,5,35,26,9,37
Mattersburg,7607,4,8,5,11,32,41,-9,29
LASK Linz,7607,5,7,7,10,25,29,-4,28
Vienna,7607,6,6,5,13,25,44,-19,23
SC Rheindorf,7607,7,4,6,14,16,29,-13,18
FC Salzburg,7608,1,13,7,4,41,20,21,46
SK Sturm Gra,7608,2,14,4,6,33,26,7,46
Rapid Vienna,7608,3,8,11,5,37,28,9,35
LASK Linz,7608,4,8,7,9,27,28,-1,31
Mattersburg,7608,5,6,7,11,30,40,-10,25
SC Rheindorf,7608,6,6,5,13,18,28,-10,23
Vienna,7608,7,6,5,13,24,40,-16,23
FC Salzburg,7609,1,14,7,3,42,18,24,49
SK Sturm Gra,7609,2,14,3,7,33,27,6,45
Rapid Vienna,7609,3,9,10,5,37,27,10,37
LASK Linz,7609,4,8,6,10,29,30,-1,30
Vienna,7609,5,7,6,11,26,39,-13,27
SC Rheindorf,7609,6,5,6,13,19,31,-12,21
Mattersburg,7609,7,5,6,13,28,42,-14,21
FC Salzburg,7610,1,15,7,2,46,16,30,52
SK Sturm Gra,7610,2,13,4,7,35,28,7,43
Rapid Vienna,7610,3,8,11,5,34,26,8,35
Vienna,7610,4,7,6,11,27,39,-12,27
LASK Linz,7610,5,7,5,12,24,33,-9,26
Mattersburg,7610,6,6,6,12,29,44,-15,24
SC Rheindorf,7610,7,5,7,12,17,26,-9,22
FC Salzburg,7611,1,13,8,3,43,19,24,47
SK Sturm Gra,7611,2,13,3,8,34,29,5,42
Rapid Vienna,7611,3,10,9,5,39,28,11,39
LASK Linz,7611,4,9,5,10,28,29,-1,32
Vienna,7611,5,6,7,11,25,39,-14,25
SC Rheindorf,7611,6,6,5,13,19,31,-12,23
Mattersburg,7611,7,5,7,12,30,43,-13,22
FC Salzburg,7612,1,14,8,2,44,18,26,50
SK Sturm Gra,7612,2,11,6,7,28,26,2,39
Rapid Vienna,7612,3,8,11,5,34,26,8,35
LASK Linz,7612,4,7,8,9,25,27,-2,29
Mattersburg,7612,5,7,7,10,33,41,-8,28
SC Rheindorf,7612,6,6,5,13,19,29,-10,23
Vienna,7612,7,6,5,13,23,39,-16,23
FC Salzburg,7613,1,13,9,2,46,20,26,48
SK Sturm Gra,7613,2,13,4,7,33,28,5,43
Rapid Vienna,7613,3,8,12,4,36,26,10,36
LASK Linz,7613,4,8,7,9,29,31,-2,31
Mattersburg,7613,5,6,7,11,33,44,-11,25
Vienna,7613,6,6,6,12,26,42,-16,24
SC Rheindorf,7613,7,4,7,13,18,30,-12,19
FC Salzburg,7614,1,16,6,2,48,16,32,54
SK Sturm Gra,7614,2,11,3,10,29,34,-5,36
Rapid Vienna,7614,3,8,10,6,35,29,6,34
LASK Linz,7614,4,9,6,9,29,27,2,33
Vienna,7614,5,7,5,12,25,40,-15,26
SC Rheindorf,7614,6,6,6,12,20,28,-8,24
Mattersburg,7614,7,6,6,12,29,41,-12,24
FC Salzburg,7615,1,14,7,3,45,19,26,49
SK Sturm Gra,7615,2,12,4,8,33,28,5,40
Rapid Vienna,7615,3,10,9,5,39,30,9,39
LASK Linz,7615,4,9,5,10,29,31,-2,32
Vienna,7615,5,7,5,12,27,42,-15,26
Mattersburg,7615,6,6,6,12,29,41,-12,24
SC Rheindorf,7615,7,5,6,13,19,30,-11,21
FC Salzburg,7616,1,14,8,2,44,17,27,50
SK Sturm Gra,7616,2,14,4,6,36,24,12,46
Rapid Vienna,7616,3,7,10,7,33,31,2,31
LASK Linz,7616,4,8,5,11,27,30,-3,29
Vienna,7616,5,7,5,12,26,39,-13,26
SC Rheindorf,7616,6,6,6,12,17,29,-12,24
Mattersburg,7616,7,6,6,12,29,42,-13,24
FC Salzburg,7617,1,14,7,3,46,19,27,49
SK Sturm Gra,7617,2,12,4,8,34,31,3,40
Rapid Vienna,7617,3,9,11,4,41,28,13,38
Mattersburg,7617,4,8,5,11,30,39,-9,29
LASK Linz,7617,5,7,6,11,27,36,-9,27
SC Rheindorf,7617,6,6,6,12,23,30,-7,24
Vienna,7617,7,6,5,13,23,41,-18,23
FC Salzburg,7618,1,15,7,2,48,17,31,52
SK Sturm Gra,7618,2,13,4,7,35,29,6,43
Rapid Vienna,7618,3,7,10,7,34,30,4,31
LASK Linz,7618,4,7,6,11,26,32,-6,27
Vienna,7618,5,7,6,11,27,38,-11,27
Mattersburg,7618,6,7,5,12,32,46,-14,26
SC Rheindorf,7618,7,6,6,12,19,29,-10,24
FC Salzburg,7619,1,14,7,3,45,19,26,49
SK Sturm Gra,7619,2,14,3,7,33,28,5,45
Rapid Vienna,7619,3,10,9,5,39,28,11,39
LASK Linz,7619,4,7,6,11,26,32,-6,27
Mattersburg,7619,5,6,7,11,29,39,-10,25
Vienna,7619,6,6,7,11,23,37,-14,25
SC Rheindorf,7619,7,4,7,13,16,28,-12,19
FC Salzburg,7620,1,13,7,4,44,22,22,46
SK Sturm Gra,7620,2,13,4,7,35,29,6,43
Rapid Vienna,7620,3,8,9,7,33,30,3,33
LASK Linz,7620,4,8,5,11,26,28,-2,29
SC Rheindorf,7620,5,8,5,11,22,26,-4,29
Mattersburg,7620,6,7,5,12,29,41,-12,26
Vienna,7620,7,7,5,12,25,38,-13,26
FC Salzburg,7621,1,15,6,3,47,19,28,51
SK Sturm Gra,7621,2,13,4,7,36,32,4,43
Rapid Vienna,7621,3,9,9,6,35,29,6,36
Mattersburg,7621,4,8,6,10,34,39,-5,30
LASK Linz,7621,5,7,6,11,26,31,-5,27
Vienna,7621,6,6,5,13,24,41,-17,23
SC Rheindorf,7621,7,4,8,12,18,29,-11,20
FC Salzburg,7622,1,14,7,3,48,19,29,49
SK Sturm Gra,7622,2,12,4,8,32,29,3,40
Rapid Vienna,7622,3,8,12,4,35,26,9,36
LASK Linz,7622,4,9,6,9,26,25,1,33
Mattersburg,7622,5,6,7,11,31,41,-10,25
Vienna,7622,6,6,6,12,25,43,-18,24
SC Rheindorf,7622,7,5,6,13,21,35,-14,21
FC Salzburg,7623,1,14,7,3,46,22,24,49
SK Sturm Gra,7623,2,12,5,7,31,28,3,41
Rapid Vienna,7623,3,7,12,5,34,31,3,33
LASK Linz,7623,4,8,5,11,29,29,0,29
Mattersburg,7623,5,7,6,11,31,41,-10,27
Vienna,7623,6,7,6,11,27,38,-11,27
SC Rheindorf,7623,7,5,7,12,19,28,-9,22
FC Salzburg,7624,1,14,8,2,47,18,29,50
SK Sturm Gra,7624,2,13,4,7,32,28,4,43
Rapid Vienna,7624,3,9,11,4,42,26,16,38
LASK Linz,7624,4,8,5,11,26,31,-5,29
Vienna,7624,5,6,7,11,24,38,-14,25
Mattersburg,7624,6,6,6,12,32,44,-12,24
SC Rheindorf,7624,7,5,5,14,17,35,-18,20
FC Salzburg,7625,1,14,6,4,45,25,20,48
SK Sturm Gra,7625,2,14,4,6,40,29,11,46
Rapid Vienna,7625,3,7,11,6,36,30,6,32
LASK Linz,7625,4,8,5,11,28,33,-5,29
Mattersburg,7625,5,7,6,11,33,41,-8,27
Vienna,7625,6,7,5,12,26,40,-14,26
SC Rheindorf,7625,7,5,7,12,19,29,-10,22
FC Salzburg,7626,1,15,7,2,46,17,29,52
SK Sturm Gra,7626,2,14,4,6,35,27,8,46
Rapid Vienna,7626,3,9,9,6,34,28,6,36
LASK Linz,7626,4,7,5,12,27,32,-5,26
Mattersburg,7626,5,7,5,12,32,41,-9,26
SC Rheindorf,7626,6,6,5,13,18,29,-11,23
Vienna,7626,7,6,5,13,23,41,-18,23
FC Salzburg,7627,1,14,8,2,48,18,30,50
SK Sturm Gra,7627,2,13,5,6,35,26,9,44
Rapid Vienna,7627,3,7,11,6,34,31,3,32
LASK Linz,7627,4,7,7,10,28,34,-6,28
Mattersburg,7627,5,7,7,10,30,38,-8,28
Vienna,7627,6,6,6,12,24,41,-17,24
SC Rheindorf,7627,7,4,8,12,19,30,-11,20
FC Salzburg,7628,1,15,6,3,46,18,28,51
Rapid Vienna,7628,2,11,9,4,39,26,13,42
SK Sturm Gra,7628,3,12,4,8,34,33,1,40
LASK Linz,7628,4,8,6,10,27,30,-3,30
Mattersburg,7628,5,6,6,12,32,41,-9,24
Vienna,7628,6,6,6,12,24,40,-16,24
SC Rheindorf,7628,7,4,7,13,19,33,-14,19
FC Salzburg,7629,1,14,7,3,47,20,27,49
SK Sturm Gra,7629,2,11,6,7,33,30,3,39
Rapid Vienna,7629,3,7,11,6,33,28,5,32
LASK Linz,7629,4,8,8,8,27,27,0,32
Vienna,7629,5,8,5,11,26,37,-11,29
SC Rheindorf,7629,6,6,7,11,24,31,-7,25
Mattersburg,7629,7,5,6,13,29,46,-17,21
FC Salzburg,7630,1,15,7,2,46,16,30,52
SK Sturm Gra,7630,2,12,4,8,33,32,1,40
Rapid Vienna,7630,3,7,10,7,32,30,2,31
LASK Linz,7630,4,8,6,10,27,30,-3,30
Mattersburg,7630,5,7,6,11,29,39,-10,27
SC Rheindorf,7630,6,7,5,12,21,26,-5,26
Vienna,7630,7,6,6,12,23,38,-15,24
FC Salzburg,7631,1,14,7,3,44,20,24,49
SK Sturm Gra,7631,2,13,4,7,32,27,5,43
Rapid Vienna,7631,3,10,10,4,35,23,12,40
Mattersburg,7631,4,7,6,11,30,38,-8,27
LASK Linz,7631,5,7,5,12,23,30,-7,26
Vienna,7631,6,6,6,12,24,39,-15,24
SC Rheindorf,7631,7,5,6,13,16,27,-11,21
FC Salzburg,7632,1,13,6,5,43,19,24,45
SK Sturm Gra,7632,2,13,3,8,34,31,3,42
Rapid Vienna,7632,3,8,9,7,38,33,5,33
LASK Linz,7632,4,9,5,10,27,29,-2,32
Mattersburg,7632,5,8,5,11,31,40,-9,29
SC Rheindorf,7632,6,7,5,12,24,31,-7,26
Vienna,7632,7,7,5,12,24,38,-14,26
FC Salzburg,7633,1,15,6,3,44,19,25,51
SK Sturm Gra,7633,2,12,4,8,31,28,3,40
Rapid Vienna,7633,3,10,9,5,36,25,11,39
LASK Linz,7633,4,8,6,10,26,28,-2,30
Vienna,7633,5,7,5,12,26,39,-13,26
Mattersburg,7633,6,6,6,12,31,44,-13,24
SC Rheindorf,7633,7,4,8,12,16,27,-11,20
FC Salzburg,7634,1,13,6,5,41,20,21,45
SK Sturm Gra,7634,2,12,4,8,31,28,3,40
Rapid Vienna,7634,3,8,11,5,34,26,8,35
LASK Linz,7634,4,7,8,9,27,29,-2,29
Vienna,7634,5,7,6,11,26,39,-13,27
Mattersburg,7634,6,6,8,10,28,37,-9,26
SC Rheindorf,7634,7,6,7,11,20,28,-8,25
FC Salzburg,7635,1,14,7,3,46,21,25,49
SK Sturm Gra,7635,2,13,3,8,35,31,4,42
Rapid Vienna,7635,3,9,10,5,37,29,8,37
LASK Linz,7635,4,7,7,10,26,30,-4,28
Vienna,7635,5,7,6,11,28,41,-13,27
Mattersburg,7635,6,7,5,12,35,42,-7,26
SC Rheindorf,7635,7,5,6,13,19,32,-13,21
FC Salzburg,7636,1,13,6,5,43,22,21,45
SK Sturm Gra,7636,2,11,5,8,32,30,2,38
Rapid Vienna,7636,3,9,10,5,36,27,9,37
SC Rheindorf,7636,4,8,5,11,25,28,-3,29
Vienna,7636,5,8,5,11,27,38,-11,29
LASK Linz,7636,6,7,6,11,27,33,-6,27
Mattersburg,7636,7,7,5,12,30,42,-12,26
FC Salzburg,7637,1,15,6,3,44,19,25,51
SK Sturm Gra,7637,2,13,3,8,33,29,4,42
Rapid Vienna,7637,3,9,9,6,35,27,8,36
LASK Linz,7637,4,8,6,10,27,30,-3,30
Vienna,7637,5,7,5,12,24,38,-14,26
SC Rheindorf,7637,6,6,6,12,19,27,-8,24
Mattersburg,7637,7,6,5,13,30,42,-12,23
FC Salzburg,7638,1,15,6,3,45,18,27,51
SK Sturm Gra,7638,2,13,4,7,35,27,8,43
Rapid Vienna,7638,3,8,10,6,35,28,7,34
LASK Linz,7638,4,9,5,10,26,31,-5,32
Mattersburg,7638,5,7,5,12,33,44,-11,26
SC Rheindorf,7638,6,6,5,13,20,29,-9,23
Vienna,7638,7,6,5,13,25,42,-17,23
FC Salzburg,7639,1,16,6,2,50,19,31,54
SK Sturm Gra,7639,2,13,4,7,32,28,4,43
Rapid Vienna,7639,3,8,10,6,36,28,8,34
LASK Linz,7639,4,9,6,9,28,28,0,33
Vienna,7639,5,6,6,12,26,41,-15,24
Mattersburg,7639,6,5,8,11,30,43,-13,23
SC Rheindorf,7639,7,4,6,14,17,32,-15,18
FC Salzburg,7640,1,16,6,2,45,16,29,54
SK Sturm Gra,7640,2,11,4,9,30,30,0,37
Rapid Vienna,7640,3,8,11,5,34,26,8,35
LASK Linz,7640,4,8,7,9,27,28,-1,31
Mattersburg,7640,5,7,5,12,35,46,-11,26
SC Rheindorf,7640,6,6,6,12,25,33,-8,24
Vienna,7640,7,6,5,13,24,41,-17,23
FC Salzburg,7641,1,15,6,3,47,18,29,51
SK Sturm Gra,7641,2,13,3,8,33,30,3,42
Rapid Vienna,7641,3,8,10,6,34,28,6,34
LASK Linz,7641,4,9,5,10,27,28,-1,32
SC Rheindorf,7641,5,6,6,12,18,27,-9,24
Mattersburg,7641,6,6,6,12,30,43,-13,24
Vienna,7641,7,6,6,12,25,40,-15,24
FC Salzburg,7642,1,14,7,3,48,22,26,49
SK Sturm Gra,7642,2,11,5,8,33,31,2,38
Rapid Vienna,7642,3,9,10,5,35,26,9,37
LASK Linz,7642,4,9,5,10,29,30,-1,32
Mattersburg,7642,5,7,5,12,33,44,-11,26
SC Rheindorf,7642,6,6,7,11,20,26,-6,25
Vienna,7642,7,6,5,13,24,43,-19,23
FC Salzburg,7643,1,15,7,2,46,18,28,52
SK Sturm Gra,7643,2,12,4,8,30,28,2,40
Rapid Vienna,7643,3,8,10,6,34,27,7,34
LASK Linz,7643,4,8,7,9,26,29,-3,31
Mattersburg,7643,5,7,6,11,31,39,-8,27
Vienna,7643,6,6,6,12,25,40,-15,24
SC Rheindorf,7643,7,5,6,13,17,28,-11,21
FC Salzburg,7644,1,15,7,2,44,17,27,52
SK Sturm Gra,7644,2,12,5,7,37,33,4,41
Rapid Vienna,7644,3,8,10,6,36,30,6,34
LASK Linz,7644,4,9,6,9,29,28,1,33
SC Rheindorf,7644,5,6,6,12,24,33,-9,24
Vienna,7644,6,6,6,12,25,41,-16,24
Mattersburg,7644,7,5,6,13,29,42,-13,21
FC Salzburg,7645,1,15,7,2,47,21,26,52
SK Sturm Gra,7645,2,13,5,6,35,27,8,44
Rapid Vienna,7645,3,9,9,6,36,29,7,36
LASK Linz,7645,4,8,5,11,25,28,-3,29
Mattersburg,7645,5,6,6,12,31,45,-14,24
Vienna,7645,6,6,6,12,25,40,-15,24
SC Rheindorf,7645,7,5,6,13,21,30,-9,21
FC Salzburg,7646,1,15,7,2,49,18,31,52
SK Sturm Gra,7646,2,13,3,8,34,30,4,42
Rapid Vienna,7646,3,9,10,5,36,29,7,37
LASK Linz,7646,4,8,5,11,29,30,-1,29
Mattersburg,7646,5,8,5,11,31,44,-13,29
Vienna,7646,6,6,5,13,24,40,-16,23
SC Rheindorf,7646,7,5,5,14,22,34,-12,20
FC Salzburg,7647,1,16,6,2,51,18,33,54
SK Sturm Gra,7647,2,11,4,9,30,29,1,37
LASK Linz,7647,3,10,5,9,28,29,-1,35
Rapid Vienna,7647,4,8,10,6,33,29,4,34
Vienna,7647,5,7,5,12,26,40,-14,26
SC Rheindorf,7647,6,5,8,11,25,32,-7,23
Mattersburg,7647,7,5,6,13,31,47,-16,21
FC Salzburg,7648,1,16,6,2,48,18,30,54
SK Sturm Gra,7648,2,14,3,7,36,27,9,45
Rapid Vienna,7648,3,8,10,6,36,28,8,34
LASK Linz,7648,4,8,6,10,26,31,-5,30
Vienna,7648,5,7,5,12,28,39,-11,26
Mattersburg,7648,6,7,5,12,30,45,-15,26
SC Rheindorf,7648,7,4,5,15,16,32,-16,17
FC Salzburg,7649,1,15,6,3,46,19,27,51
SK Sturm Gra,7649,2,12,5,7,34,32,2,41
Rapid Vienna,7649,3,10,9,5,35,25,10,39
LASK Linz,7649,4,8,7,9,28,29,-1,31
Mattersburg,7649,5,7,5,12,32,40,-8,26
Vienna,7649,6,6,5,13,23,41,-18,23
SC Rheindorf,7649,7,4,7,13,18,30,-12,19
FC Salzburg,7650,1,16,6,2,48,17,31,54
SK Sturm Gra,7650,2,13,4,7,35,30,5,43
Rapid Vienna,7650,3,9,9,6,36,29,7,36
LASK Linz,7650,4,7,7,10,27,30,-3,28
Vienna,7650,5,7,5,12,25,38,-13,26
Mattersburg,7650,6,6,6,12,32,43,-11,24
SC Rheindorf,7650,7,5,5,14,20,36,-16,20
FC Salzburg,7651,1,14,7,3,45,18,27,49
SK Sturm Gra,7651,2,14,3,7,35,28,7,45
Rapid Vienna,7651,3,9,10,5,36,25,11,37
LASK Linz,7651,4,8,5,11,25,30,-5,29
Vienna,7651,5,7,5,12,25,40,-15,26
Mattersburg,7651,6,6,6,12,27,38,-11,24
SC Rheindorf,7651,7,5,6,13,16,30,-14,21
FC Salzburg,7652,1,14,7,3,48,18,30,49
SK Sturm Gra,7652,2,12,4,8,36,31,5,40
Rapid Vienna,7652,3,7,11,6,33,32,1,32
LASK Linz,7652,4,9,5,10,26,30,-4,32
Vienna,7652,5,8,5,11,28,40,-12,29
SC Rheindorf,7652,6,6,7,11,19,27,-8,25
Mattersburg,7652,7,5,7,12,30,42,-12,22
FC Salzburg,7653,1,13,8,3,44,19,25,47
SK Sturm Gra,7653,2,13,4,7,34,31,3,43
Rapid Vienna,7653,3,8,11,5,38,29,9,35
LASK Linz,7653,4,8,6,10,25,28,-3,30
Vienna,7653,5,8,5,11,28,38,-10,29
Mattersburg,7653,6,6,7,11,31,40,-9,25
SC Rheindorf,7653,7,4,7,13,18,33,-15,19
FC Salzburg,7654,1,15,6,3,45,23,22,51
Rapid Vienna,7654,2,10,9,5,36,27,9,39
SK Sturm Gra,7654,3,11,4,9,33,32,1,37
LASK Linz,7654,4,8,6,10,29,30,-1,30
Vienna,7654,5,8,5,11,31,39,-8,29
SC Rheindorf,7654,6,6,6,12,24,32,-8,24
Mattersburg,7654,7,5,6,13,33,48,-15,21
FC Salzburg,7655,1,14,8,2,44,18,26,50
SK Sturm Gra,7655,2,11,4,9,28,28,0,37
Rapid Vienna,7655,3,8,10,6,37,30,7,34
LASK Linz,7655,4,9,6,9,32,30,2,33
SC Rheindorf,7655,5,7,5,12,22,29,-7,26
Vienna,7655,6,7,5,12,28,42,-14,26
Mattersburg,7655,7,6,6,12,31,45,-14,24
FC Salzburg,7656,1,13,7,4,42,21,21,46
SK Sturm Gra,7656,2,12,5,7,32,27,5,41
Rapid Vienna,7656,3,9,9,6,37,29,8,36
LASK Linz,7656,4,8,7,9,29,30,-1,31
Vienna,7656,5,7,5,12,29,41,-12,26
Mattersburg,7656,6,6,7,11,32,43,-11,25
SC Rheindorf,7656,7,6,6,12,19,29,-10,24
FC Salzburg,7657,1,16,6,2,48,16,32,54
SK Sturm Gra,7657,2,12,4,8,30,29,1,40
LASK Linz,7657,3,9,7,8,31,27,4,34
Rapid Vienna,7657,4,7,12,5,36,29,7,33
Mattersburg,7657,5,6,5,13,28,45,-17,23
Vienna,7657,6,6,5,13,23,41,-18,23
SC Rheindorf,7657,7,5,7,12,18,27,-9,22
FC Salzburg,7658,1,16,6,2,48,15,33,54
SK Sturm Gra,7658,2,12,4,8,31,29,2,40
Rapid Vienna,7658,3,7,11,6,35,30,5,32
LASK Linz,7658,4,8,6,10,28,30,-2,30
SC Rheindorf,7658,5,6,7,11,24,31,-7,25
Mattersburg,7658,6,6,7,11,29,42,-13,25
Vienna,7658,7,6,5,13,23,41,-18,23
FC Salzburg,7659,1,12,9,3,39,18,21,45
SK Sturm Gra,7659,2,13,4,7,33,29,4,43
Rapid Vienna,7659,3,9,10,5,37,27,10,37
LASK Linz,7659,4,8,7,9,28,28,0,31
Mattersburg,7659,5,6,7,11,29,39,-10,25
Vienna,7659,6,6,6,12,24,40,-16,24
SC Rheindorf,7659,7,5,7,12,19,28,-9,22
FC Salzburg,7660,1,14,8,2,49,21,28,50
SK Sturm Gra,7660,2,13,3,8,35,30,5,42
Rapid Vienna,7660,3,8,11,5,37,29,8,35
LASK Linz,7660,4,9,7,8,29,27,2,34
Vienna,7660,5,6,7,11,25,39,-14,25
Mattersburg,7660,6,6,6,12,33,44,-11,24
SC Rheindorf,7660,7,4,6,14,17,35,-18,18
FC Salzburg,7661,1,14,7,3,43,16,27,49
SK Sturm Gra,7661,2,12,6,6,34,27,7,42
Rapid Vienna,7661,3,8,10,6,34,30,4,34
LASK Linz,7661,4,8,7,9,32,30,2,31
Mattersburg,7661,5,7,5,12,30,40,-10,26
Vienna,7661,6,7,5,12,25,41,-16,26
SC Rheindorf,7661,7,5,6,13,19,33,-14,21
FC Salzburg,7662,1,14,7,3,42,22,20,49
SK Sturm Gra,7662,2,12,4,8,32,29,3,40
Rapid Vienna,7662,3,8,11,5,35,26,9,35
LASK Linz,7662,4,8,6,10,26,29,-3,30
Vienna,7662,5,7,6,11,27,39,-12,27
Mattersburg,7662,6,6,7,11,34,41,-7,25
SC Rheindorf,7662,7,5,7,12,22,32,-10,22
FC Salzburg,7663,1,13,8,3,42,19,23,47
SK Sturm Gra,7663,2,12,5,7,31,28,3,41
Rapid Vienna,7663,3,10,9,5,39,28,11,39
LASK Linz,7663,4,8,6,10,25,28,-3,30
Vienna,7663,5,7,5,12,25,40,-15,26
Mattersburg,7663,6,6,7,11,28,38,-10,25
SC Rheindorf,7663,7,5,6,13,19,28,-9,21
FC Salzburg,7664,1,15,7,2,46,18,28,52
SK Sturm Gra,7664,2,12,5,7,32,28,4,41
Rapid Vienna,7664,3,8,11,5,34,24,10,35
LASK Linz,7664,4,8,6,10,25,27,-2,30
Vienna,7664,5,7,5,12,27,41,-14,26
Mattersburg,7664,6,6,6,12,29,41,-12,24
SC Rheindorf,7664,7,5,6,13,16,30,-14,21
FC Salzburg,7665,1,14,7,3,45,22,23,49
Rapid Vienna,7665,2,10,10,4,38,24,14,40
SK Sturm Gra,7665,3,12,4,8,32,30,2,40
LASK Linz,7665,4,8,5,11,26,28,-2,29
Vienna,7665,5,7,5,12,25,39,-14,26
Mattersburg,7665,6,6,6,12,35,44,-9,24
SC Rheindorf,7665,7,6,5,13,18,32,-14,23
FC Salzburg,7666,1,13,8,3,43,20,23,47
SK Sturm Gra,7666,2,14,4,6,39,28,11,46
Rapid Vienna,7666,3,9,9,6,36,30,6,36
LASK Linz,7666,4,8,5,11,25,28,-3,29
Mattersburg,7666,5,8,5,11,31,38,-7,29
Vienna,7666,6,7,6,11,27,39,-12,27
SC Rheindorf,7666,7,4,5,15,15,33,-18,17
FC Salzburg,7667,1,13,7,4,44,22,22,46
Rapid Vienna,7667,2,10,10,4,35,24,11,40
SK Sturm Gra,7667,3,11,7,6,32,28,4,40
LASK Linz,7667,4,7,7,10,26,30,-4,28
Mattersburg,7667,5,7,6,11,35,46,-11,27
Vienna,7667,6,7,5,12,32,43,-11,26
SC Rheindorf,7667,7,4,8,12,19,30,-11,20
FC Salzburg,7668,1,16,6,2,46,17,29,54
SK Sturm Gra,7668,2,12,4,8,33,30,3,40
Rapid Vienna,7668,3,8,10,6,34,27,7,34
LASK Linz,7668,4,9,5,10,28,32,-4,32
SC Rheindorf,7668,5,7,5,12,22,28,-6,26
Vienna,7668,6,7,5,12,26,40,-14,26
Mattersburg,7668,7,5,5,14,31,46,-15,20
FC Salzburg,7669,1,13,8,3,41,16,25,47
SK Sturm Gra,7669,2,13,3,8,33,30,3,42
Rapid Vienna,7669,3,8,11,5,34,27,7,35
LASK Linz,7669,4,9,6,9,26,25,1,33
Vienna,7669,5,7,6,11,24,37,-13,27
Mattersburg,7669,6,6,6,12,28,38,-10,24
SC Rheindorf,7669,7,5,6,13,19,32,-13,21
FC Salzburg,7670,1,16,6,2,48,19,29,54
SK Sturm Gra,7670,2,14,3,7,33,27,6,45
Rapid Vienna,7670,3,8,9,7,34,29,5,33
LASK Linz,7670,4,8,5,11,25,30,-5,29
Mattersburg,7670,5,7,5,12,30,41,-11,26
SC Rheindorf,7670,6,6,5,13,21,28,-7,23
Vienna,7670,7,6,5,13,25,42,-17,23
FC Salzburg,7671,1,13,8,3,40,18,22,47
SK Sturm Gra,7671,2,13,4,7,36,27,9,43
Rapid Vienna,7671,3,8,10,6,32,28,4,34
LASK Linz,7671,4,8,6,10,26,29,-3,30
Vienna,7671,5,8,5,11,27,37,-10,29
SC Rheindorf,7671,6,6,6,12,19,28,-9,24
Mattersburg,7671,7,5,7,12,28,41,-13,22
FC Salzburg,7672,1,16,6,2,45,15,30,54
SK Sturm Gra,7672,2,11,5,8,31,32,-1,38
Rapid Vienna,7672,3,8,11,5,35,27,8,35
LASK Linz,7672,4,7,8,9,31,33,-2,29
Mattersburg,7672,5,6,7,11,32,42,-10,25
SC Rheindorf,7672,6,5,8,11,23,30,-7,23
Vienna,7672,7,6,5,13,24,42,-18,23
FC Salzburg,7673,1,14,8,2,44,17,27,50
SK Sturm Gra,7673,2,13,3,8,33,27,6,42
Rapid Vienna,7673,3,8,10,6,34,27,7,34
LASK Linz,7673,4,9,5,10,28,29,-1,32
Vienna,7673,5,7,5,12,25,39,-14,26
Mattersburg,7673,6,6,6,12,31,43,-12,24
SC Rheindorf,7673,7,6,5,13,17,30,-13,23
FC Salzburg,7674,1,15,6,3,44,17,27,51
SK Sturm Gra,7674,2,14,3,7,38,30,8,45
Rapid Vienna,7674,3,8,9,7,38,32,6,33
LASK Linz,7674,4,8,5,11,28,34,-6,29
Mattersburg,7674,5,8,5,11,29,37,-8,29
Vienna,7674,6,7,5,12,24,38,-14,26
SC Rheindorf,7674,7,5,5,14,19,32,-13,20
FC Salzburg,7675,1,15,7,2,47,19,28,52
SK Sturm Gra,7675,2,12,5,7,32,28,4,41
Rapid Vienna,7675,3,9,10,5,39,30,9,37
LASK Linz,7675,4,9,5,10,25,27,-2,32
Mattersburg,7675,5,7,5,12,29,38,-9,26
Vienna,7675,6,6,5,13,24,41,-17,23
SC Rheindorf,7675,7,5,5,14,19,32,-13,20
FC Salzburg,7676,1,13,7,4,43,22,21,46
Rapid Vienna,7676,2,11,9,4,37,24,13,42
SK Sturm Gra,7676,3,12,5,7,32,28,4,41
LASK Linz,7676,4,8,7,9,29,29,0,31
Vienna,7676,5,8,5,11,31,40,-9,29
Mattersburg,7676,6,6,5,13,31,46,-15,23
SC Rheindorf,7676,7,4,6,14,18,32,-14,18
FC Salzburg,7677,1,15,6,3,47,19,28,51
SK Sturm Gra,7677,2,12,4,8,34,31,3,40
Rapid Vienna,7677,3,9,10,5,38,28,10,37
LASK Linz,7677,4,7,8,9,24,26,-2,29
Mattersburg,7677,5,7,7,10,32,40,-8,28
Vienna,7677,6,6,6,12,26,43,-17,24
SC Rheindorf,7677,7,4,7,13,18,32,-14,19
FC Salzburg,7678,1,15,7,2,47,19,28,52
Rapid Vienna,7678,2,10,9,5,43,30,13,39
SK Sturm Gra,7678,3,11,6,7,32,30,2,39
LASK Linz,7678,4,8,6,10,27,30,-3,30
Mattersburg,7678,5,6,6,12,34,44,-10,24
Vienna,7678,6,6,5,13,25,43,-18,23
SC Rheindorf,7678,7,5,7,12,21,33,-12,22
FC Salzburg,7679,1,13,8,3,43,21,22,47
SK Sturm Gra,7679,2,13,5,6,38,30,8,44
Rapid Vienna,7679,3,9,9,6,39,30,9,36
LASK Linz,7679,4,8,7,9,27,28,-1,31
Mattersburg,7679,5,6,8,10,28,37,-9,26
Vienna,7679,6,6,5,13,24,40,-16,23
SC Rheindorf,7679,7,5,6,13,19,32,-13,21
FC Salzburg,7680,1,15,6,3,46,18,28,51
Rapid Vienna,7680,2,10,9,5,37,25,12,39
SK Sturm Gra,7680,3,12,3,9,30,30,0,39
LASK Linz,7680,4,9,5,10,27,27,0,32
Mattersburg,7680,5,7,5,12,29,42,-13,26
Vienna,7680,6,7,5,12,25,39,-14,26
SC Rheindorf,7680,7,5,5,14,18,31,-13,20
FC Salzburg,7681,1,16,6,2,50,17,33,54
SK Sturm Gra,7681,2,14,3,7,36,31,5,45
LASK Linz,7681,3,8,6,10,30,30,0,30
Rapid Vienna,7681,4,7,9,8,34,37,-3,30
Mattersburg,7681,5,7,6,11,32,39,-7,27
SC Rheindorf,7681,6,6,5,13,19,30,-11,23
Vienna,7681,7,6,5,13,24,41,-17,23
FC Salzburg,7682,1,14,8,2,45,18,27,50
SK Sturm Gra,7682,2,12,5,7,29,25,4,41
Rapid Vienna,7682,3,8,10,6,35,27,8,34
LASK Linz,7682,4,7,8,9,26,29,-3,29
Vienna,7682,5,7,5,12,27,42,-15,26
SC Rheindorf,7682,6,6,7,11,21,29,-8,25
Mattersburg,7682,7,5,7,12,30,43,-13,22
FC Salzburg,7683,1,13,7,4,42,20,22,46
Rapid Vienna,7683,2,10,10,4,39,27,12,40
SK Sturm Gra,7683,3,11,4,9,29,29,0,37
LASK Linz,7683,4,8,7,9,27,26,1,31
Mattersburg,7683,5,8,5,11,35,40,-5,29
Vienna,7683,6,7,5,12,24,42,-18,26
SC Rheindorf,7683,7,5,6,13,17,29,-12,21
FC Salzburg,7684,1,16,6,2,46,17,29,54
Rapid Vienna,7684,2,9,9,6,35,28,7,36
SK Sturm Gra,7684,3,11,3,10,28,28,0,36
LASK Linz,7684,4,10,5,9,29,27,2,35
Mattersburg,7684,5,6,6,12,30,43,-13,24
Vienna,7684,6,6,6,12,27,42,-15,24
SC Rheindorf,7684,7,6,5,13,18,28,-10,23
FC Salzburg,7685,1,16,6,2,48,17,31,54
SK Sturm Gra,7685,2,12,3,9,32,29,3,39
Rapid Vienna,7685,3,8,9,7,34,30,4,33
LASK Linz,7685,4,8,6,10,27,30,-3,30
Mattersburg,7685,5,7,6,11,31,40,-9,27
SC Rheindorf,7685,6,6,7,11,21,28,-7,25
Vienna,7685,7,6,5,13,24,43,-19,23
FC Salzburg,7686,1,14,7,3,47,18,29,49
SK Sturm Gra,7686,2,13,4,7,36,31,5,43
Rapid Vienna,7686,3,9,11,4,40,27,13,38
LASK Linz,7686,4,8,5,11,29,33,-4,29
Vienna,7686,5,8,5,11,26,38,-12,29
Mattersburg,7686,6,6,5,13,29,46,-17,23
SC Rheindorf,7686,7,5,5,14,21,35,-14,20
FC Salzburg,7687,1,15,6,3,44,18,26,51
SK Sturm Gra,7687,2,12,4,8,33,32,1,40
Rapid Vienna,7687,3,9,10,5,38,29,9,37
LASK Linz,7687,4,7,9,8,29,30,-1,30
Vienna,7687,5,7,5,12,25,39,-14,26
Mattersburg,7687,6,6,6,12,32,43,-11,24
SC Rheindorf,7687,7,5,6,13,20,30,-10,21
FC Salzburg,7688,1,16,6,2,46,16,30,54
SK Sturm Gra,7688,2,13,3,8,32,28,4,42
LASK Linz,7688,3,10,6,8,30,26,4,36
Rapid Vienna,7688,4,7,9,8,34,32,2,30
Vienna,7688,5,6,6,12,24,41,-17,24
SC Rheindorf,7688,6,5,7,12,21,31,-10,22
Mattersburg,7688,7,5,7,12,28,41,-13,22
FC Salzburg,7689,1,14,7,3,44,18,26,49
SK Sturm Gra,7689,2,13,4,7,32,26,6,43
Rapid Vienna,7689,3,10,9,5,37,27,10,39
LASK Linz,7689,4,7,7,10,24,28,-4,28
Vienna,7689,5,6,6,12,24,40,-16,24
Mattersburg,7689,6,5,8,11,30,42,-12,23
SC Rheindorf,7689,7,5,7,12,20,30,-10,22
FC Salzburg,7690,1,15,6,3,45,19,26,51
SK Sturm Gra,7690,2,12,3,9,31,30,1,39
Rapid Vienna,7690,3,8,9,7,36,30,6,33
LASK Linz,7690,4,8,5,11,27,33,-6,29
SC Rheindorf,7690,5,7,6,11,23,29,-6,27
Vienna,7690,6,7,6,11,26,38,-12,27
Mattersburg,7690,7,6,7,11,30,39,-9,25
FC Salzburg,7691,1,15,6,3,45,17,28,51
SK Sturm Gra,7691,2,13,4,7,32,27,5,43
Rapid Vienna,7691,3,8,10,6,35,28,7,34
LASK Linz,7691,4,8,8,8,27,27,0,32
Vienna,7691,5,7,5,12,26,41,-15,26
Mattersburg,7691,6,6,5,13,30,41,-11,23
SC Rheindorf,7691,7,5,6,13,17,31,-14,21
FC Salzburg,7692,1,15,7,2,49,20,29,52
SK Sturm Gra,7692,2,12,5,7,31,29,2,41
Rapid Vienna,7692,3,9,10,5,38,28,10,37
LASK Linz,7692,4,9,5,10,25,28,-3,32
Mattersburg,7692,5,6,6,12,31,42,-11,24
Vienna,7692,6,6,6,12,25,40,-15,24
SC Rheindorf,7692,7,4,7,13,19,31,-12,19
FC Salzburg,7693,1,14,7,3,43,18,25,49
SK Sturm Gra,7693,2,12,4,8,32,32,0,40
Rapid Vienna,7693,3,10,9,5,40,28,12,39
LASK Linz,7693,4,8,6,10,28,31,-3,30
Vienna,7693,5,7,5,12,26,41,-15,26
SC Rheindorf,7693,6,6,6,12,22,28,-6,24
Mattersburg,7693,7,6,5,13,29,42,-13,23
FC Salzburg,7694,1,14,7,3,43,18,25,49
SK Sturm Gra,7694,2,13,3,8,31,28,3,42
Rapid Vienna,7694,3,7,10,7,31,27,4,31
LASK Linz,7694,4,8,6,10,28,30,-2,30
Mattersburg,7694,5,7,7,10,33,40,-7,28
SC Rheindorf,7694,6,6,7,11,23,30,-7,25
Vienna,7694,7,6,6,12,26,42,-16,24
FC Salzburg,7695,1,14,7,3,43,17,26,49
Rapid Vienna,7695,2,9,10,5,37,26,11,37
SK Sturm Gra,7695,3,11,4,9,28,30,-2,37
LASK Linz,7695,4,9,6,9,29,29,0,33
Vienna,7695,5,7,6,11,26,39,-13,27
Mattersburg,7695,6,6,6,12,32,45,-13,24
SC Rheindorf,7695,7,6,5,13,22,31,-9,23
FC Salzburg,7696,1,15,6,3,51,23,28,51
SK Sturm Gra,7696,2,11,4,9,31,30,1,37
LASK Linz,7696,3,10,5,9,28,27,1,35
Rapid Vienna,7696,4,8,10,6,34,28,6,34
Mattersburg,7696,5,7,5,12,35,43,-8,26
Vienna,7696,6,7,5,12,28,45,-17,26
SC Rheindorf,7696,7,6,5,13,17,28,-11,23
FC Salzburg,7697,1,14,7,3,42,19,23,49
SK Sturm Gra,7697,2,12,3,9,30,30,0,39
Rapid Vienna,7697,3,9,10,5,37,28,9,37
LASK Linz,7697,4,8,5,11,25,28,-3,29
Vienna,7697,5,8,5,11,28,38,-10,29
SC Rheindorf,7697,6,6,6,12,23,29,-6,24
Mattersburg,7697,7,6,6,12,28,41,-13,24
FC Salzburg,7698,1,15,7,2,49,19,30,52
SK Sturm Gra,7698,2,12,4,8,37,36,1,40
Rapid Vienna,7698,3,8,10,6,36,30,6,34
LASK Linz,7698,4,8,6,10,27,30,-3,30
SC Rheindorf,7698,5,7,6,11,24,29,-5,27
Vienna,7698,6,7,6,11,29,39,-10,27
Mattersburg,7698,7,5,5,14,28,47,-19,20
FC Salzburg,7699,1,15,6,3,47,20,27,51
SK Sturm Gra,7699,2,13,4,7,36,28,8,43
Rapid Vienna,7699,3,8,10,6,36,30,6,34
LASK Linz,7699,4,8,8,8,26,26,0,32
Vienna,7699,5,7,5,12,24,38,-14,26
Mattersburg,7699,6,6,5,13,29,42,-13,23
SC Rheindorf,7699,7,5,6,13,18,32,-14,21
FC Salzburg,7700,1,16,6,2,47,18,29,54
SK Sturm Gra,7700,2,11,4,9,29,29,0,37
Rapid Vienna,7700,3,7,11,6,34,30,4,32
LASK Linz,7700,4,8,7,9,27,29,-2,31
SC Rheindorf,7700,5,7,6,11,25,27,-2,27
Vienna,7700,6,7,5,12,25,39,-14,26
Mattersburg,7700,7,6,5,13,31,46,-15,23
FC Salzburg,7701,1,15,6,3,48,20,28,51
SK Sturm Gra,7701,2,13,3,8,34,31,3,42
Rapid Vienna,7701,3,8,9,7,37,32,5,33
LASK Linz,7701,4,8,6,10,27,30,-3,30
Mattersburg,7701,5,7,5,12,30,41,-11,26
Vienna,7701,6,7,5,12,27,41,-14,26
SC Rheindorf,7701,7,6,6,12,19,27,-8,24
FC Salzburg,7702,1,14,8,2,44,15,29,50
SK Sturm Gra,7702,2,12,4,8,33,29,4,40
Rapid Vienna,7702,3,8,11,5,33,25,8,35
LASK Linz,7702,4,8,6,10,27,31,-4,30
Vienna,7702,5,7,6,11,25,38,-13,27
Mattersburg,7702,6,7,5,12,30,43,-13,26
SC Rheindorf,7702,7,5,6,13,19,30,-11,21
FC Salzburg,7703,1,13,8,3,45,23,22,47
SK Sturm Gra,7703,2,13,4,7,34,27,7,43
Rapid Vienna,7703,3,8,10,6,34,29,5,34
LASK Linz,7703,4,9,6,9,28,27,1,33
Mattersburg,7703,5,6,8,10,33,42,-9,26
Vienna,7703,6,6,7,11,26,40,-14,25
SC Rheindorf,7703,7,5,5,14,20,32,-12,20
FC Salzburg,7704,1,15,7,2,46,15,31,52
SK Sturm Gra,7704,2,13,4,7,31,26,5,43
Rapid Vienna,7704,3,8,10,6,35,30,5,34
LASK Linz,7704,4,8,5,11,27,33,-6,29
Vienna,7704,5,7,5,12,26,38,-12,26
Mattersburg,7704,6,7,5,12,33,46,-13,26
SC Rheindorf,7704,7,5,6,13,24,34,-10,21
FC Salzburg,7705,1,14,7,3,46,19,27,49
SK Sturm Gra,7705,2,13,3,8,34,29,5,42
LASK Linz,7705,3,10,6,8,28,26,2,36
Rapid Vienna,7705,4,7,9,8,33,30,3,30
Mattersburg,7705,5,7,5,12,29,42,-13,26
SC Rheindorf,7705,6,6,6,12,18,27,-9,24
Vienna,7705,7,6,6,12,24,39,-15,24
SK Sturm Gra,7706,1,14,3,7,36,26,10,45
FC Salzburg,7706,2,12,7,5,40,21,19,43
Rapid Vienna,7706,3,9,10,5,34,27,7,37
Vienna,7706,4,8,5,11,29,37,-8,29
LASK Linz,7706,5,7,6,11,27,34,-7,27
SC Rheindorf,7706,6,7,5,12,19,27,-8,26
Mattersburg,7706,7,6,6,12,34,47,-13,24
FC Salzburg,7707,1,13,7,4,42,20,22,46
SK Sturm Gra,7707,2,12,4,8,32,30,2,40
Rapid Vienna,7707,3,9,9,6,36,29,7,36
LASK Linz,7707,4,8,7,9,28,29,-1,31
Mattersburg,7707,5,6,8,10,31,38,-7,26
SC Rheindorf,7707,6,7,5,12,21,29,-8,26
Vienna,7707,7,6,6,12,25,40,-15,24
FC Salzburg,7708,1,14,7,3,44,17,27,49
SK Sturm Gra,7708,2,13,4,7,35,30,5,43
Rapid Vienna,7708,3,9,10,5,37,28,9,37
LASK Linz,7708,4,8,7,9,31,32,-1,31
Mattersburg,7708,5,6,6,12,32,44,-12,24
Vienna,7708,6,6,5,13,24,42,-18,23
SC Rheindorf,7708,7,5,7,12,21,31,-10,22
FC Salzburg,7709,1,14,7,3,44,19,25,49
Rapid Vienna,7709,2,10,10,4,38,25,13,40
SK Sturm Gra,7709,3,12,4,8,31,28,3,40
SC Rheindorf,7709,4,7,6,11,22,28,-6,27
LASK Linz,7709,5,7,6,11,26,33,-7,27
Vienna,7709,6,6,6,12,27,43,-16,24
Mattersburg,7709,7,5,7,12,31,43,-12,22
FC Salzburg,7710,1,15,6,3,49,20,29,51
Rapid Vienna,7710,2,10,9,5,41,27,14,39
SK Sturm Gra,7710,3,11,5,8,33,32,1,38
LASK Linz,7710,4,8,6,10,28,30,-2,30
SC Rheindorf,7710,5,6,6,12,24,35,-11,24
Mattersburg,7710,6,6,6,12,33,47,-14,24
Vienna,7710,7,6,6,12,24,41,-17,24
FC Salzburg,7711,1,16,6,2,51,18,33,54
SK Sturm Gra,7711,2,13,4,7,32,27,5,43
LASK Linz,7711,3,9,6,9,27,27,0,33
Rapid Vienna,7711,4,7,10,7,33,30,3,31
Mattersburg,7711,5,6,6,12,30,43,-13,24
Vienna,7711,6,6,6,12,23,40,-17,24
SC Rheindorf,7711,7,5,6,13,19,30,-11,21
FC Salzburg,7712,1,15,7,2,47,18,29,52
Rapid Vienna,7712,2,9,10,5,39,30,9,37
SK Sturm Gra,7712,3,11,4,9,29,30,-1,37
LASK Linz,7712,4,8,6,10,28,29,-1,30
Vienna,7712,5,7,6,11,27,40,-13,27
Mattersburg,7712,6,7,5,12,32,42,-10,26
SC Rheindorf,7712,7,5,6,13,20,33,-13,21
FC Salzburg,7713,1,16,6,2,52,20,32,54
SK Sturm Gra,7713,2,12,3,9,33,33,0,39
Rapid Vienna,7713,3,9,10,5,37,25,12,37
SC Rheindorf,7713,4,7,6,11,18,25,-7,27
LASK Linz,7713,5,7,5,12,24,32,-8,26
Vienna,7713,6,7,5,12,31,44,-13,26
Mattersburg,7713,7,6,5,13,30,46,-16,23
FC Salzburg,7714,1,16,6,2,45,16,29,54
SK Sturm Gra,7714,2,12,3,9,30,27,3,39
LASK Linz,7714,3,9,6,9,26,28,-2,33
Rapid Vienna,7714,4,7,10,7,33,29,4,31
SC Rheindorf,7714,5,7,5,12,22,28,-6,26
Mattersburg,7714,6,7,5,12,32,41,-9,26
Vienna,7714,7,6,5,13,24,43,-19,23
FC Salzburg,7715,1,14,7,3,46,20,26,49
SK Sturm Gra,7715,2,13,5,6,36,28,8,44
Rapid Vienna,7715,3,8,9,7,37,31,6,33
LASK Linz,7715,4,8,6,10,27,31,-4,30
Vienna,7715,5,7,6,11,30,40,-10,27
SC Rheindorf,7715,6,6,6,12,17,28,-11,24
Mattersburg,7715,7,6,5,13,30,45,-15,23
FC Salzburg,7716,1,16,6,2,51,17,34,54
SK Sturm Gra,7716,2,11,5,8,31,34,-3,38
Rapid Vienna,7716,3,9,9,6,37,27,10,36
LASK Linz,7716,4,8,6,10,25,27,-2,30
Mattersburg,7716,5,6,7,11,30,43,-13,25
Vienna,7716,6,6,6,12,26,43,-17,24
SC Rheindorf,7716,7,5,7,12,19,28,-9,22
FC Salzburg,7717,1,14,7,3,41,16,25,49
SK Sturm Gra,7717,2,12,3,9,31,29,2,39
Rapid Vienna,7717,3,8,9,7,39,33,6,33
LASK Linz,7717,4,9,6,9,29,30,-1,33
SC Rheindorf,7717,5,7,6,11,22,29,-7,27
Vienna,7717,6,7,5,12,25,40,-15,26
Mattersburg,7717,7,6,6,12,30,40,-10,24
FC Salzburg,7718,1,15,7,2,45,19,26,52
SK Sturm Gra,7718,2,11,5,8,34,32,2,38
Rapid Vienna,7718,3,9,9,6,34,25,9,36
LASK Linz,7718,4,8,7,9,26,27,-1,31
Vienna,7718,5,7,6,11,26,39,-13,27
Mattersburg,7718,6,6,6,12,31,39,-8,24
SC Rheindorf,7718,7,5,6,13,17,32,-15,21
FC Salzburg,7719,1,14,8,2,46,18,28,50
Rapid Vienna,7719,2,9,11,4,36,26,10,38
SK Sturm Gra,7719,3,11,5,8,30,31,-1,38
LASK Linz,7719,4,9,6,9,29,29,0,33
Vienna,7719,5,6,7,11,25,39,-14,25
Mattersburg,7719,6,5,7,12,28,41,-13,22
SC Rheindorf,7719,7,5,6,13,19,29,-10,21
FC Salzburg,7720,1,14,8,2,50,18,32,50
SK Sturm Gra,7720,2,14,4,6,34,24,10,46
Rapid Vienna,7720,3,8,10,6,36,29,7,34
LASK Linz,7720,4,8,6,10,26,29,-3,30
Mattersburg,7720,5,6,6,12,29,44,-15,24
Vienna,7720,6,6,6,12,26,45,-19,24
SC Rheindorf,7720,7,5,6,13,18,30,-12,21
FC Salzburg,7721,1,15,7,2,46,19,27,52
SK Sturm Gra,7721,2,12,4,8,33,27,6,40
LASK Linz,7721,3,9,6,9,28,28,0,33
Rapid Vienna,7721,4,7,10,7,34,32,2,31
Mattersburg,7721,5,7,5,12,34,41,-7,26
Vienna,7721,6,7,5,12,25,40,-15,26
SC Rheindorf,7721,7,5,7,12,17,30,-13,22
FC Salzburg,7722,1,14,8,2,44,17,27,50
SK Sturm Gra,7722,2,12,5,7,31,27,4,41
Rapid Vienna,7722,3,7,12,5,36,29,7,33
LASK Linz,7722,4,8,8,8,26,26,0,32
Mattersburg,7722,5,6,6,12,34,44,-10,24
Vienna,7722,6,6,6,12,23,41,-18,24
SC Rheindorf,7722,7,5,7,12,21,31,-10,22
SK Sturm Gra,7723,1,14,3,7,36,29,7,45
FC Salzburg,7723,2,12,8,4,41,22,19,44
Rapid Vienna,7723,3,10,10,4,42,27,15,40
LASK Linz,7723,4,8,5,11,26,33,-7,29
SC Rheindorf,7723,5,6,6,12,23,28,-5,24
Mattersburg,7723,6,6,6,12,29,43,-14,24
Vienna,7723,7,6,6,12,24,39,-15,24
FC Salzburg,7724,1,15,7,2,51,17,34,52
SK Sturm Gra,7724,2,11,4,9,30,34,-4,37
LASK Linz,7724,3,10,6,8,32,27,5,36
Rapid Vienna,7724,4,8,11,5,36,29,7,35
Vienna,7724,5,7,5,12,25,39,-14,26
Mattersburg,7724,6,6,5,13,30,45,-15,23
SC Rheindorf,7724,7,5,6,13,19,32,-13,21
FC Salzburg,7725,1,14,8,2,47,21,26,50
SK Sturm Gra,7725,2,11,4,9,30,30,0,37
Rapid Vienna,7725,3,7,11,6,34,28,6,32
LASK Linz,7725,4,8,8,8,26,26,0,32
Vienna,7725,5,7,6,11,30,41,-11,27
SC Rheindorf,7725,6,6,7,11,21,29,-8,25
Mattersburg,7725,7,5,8,11,31,44,-13,23
FC Salzburg,7726,1,15,7,2,46,17,29,52
SK Sturm Gra,7726,2,11,5,8,32,30,2,38
Rapid Vienna,7726,3,8,9,7,36,33,3,33
LASK Linz,7726,4,8,7,9,26,26,0,31
SC Rheindorf,7726,5,7,6,11,22,29,-7,27
Mattersburg,7726,6,6,7,11,32,41,-9,25
Vienna,7726,7,6,5,13,23,41,-18,23
FC Salzburg,7727,1,15,7,2,47,17,30,52
SK Sturm Gra,7727,2,13,3,8,33,30,3,42
Rapid Vienna,7727,3,8,9,7,33,26,7,33
LASK Linz,7727,4,8,5,11,26,31,-5,29
Mattersburg,7727,5,8,5,11,32,42,-10,29
Vienna,7727,6,6,6,12,27,42,-15,24
SC Rheindorf,7727,7,6,5,13,20,30,-10,23
FC Salzburg,7728,1,14,8,2,47,18,29,50
SK Sturm Gra,7728,2,12,5,7,32,28,4,41
LASK Linz,7728,3,9,6,9,28,29,-1,33
Rapid Vienna,7728,4,7,11,6,32,27,5,32
Vienna,7728,5,7,5,12,27,43,-16,26
SC Rheindorf,7728,6,6,6,12,21,31,-10,24
Mattersburg,7728,7,6,5,13,32,43,-11,23
FC Salzburg,7729,1,14,6,4,43,19,24,48
SK Sturm Gra,7729,2,14,4,6,36,29,7,46
LASK Linz,7729,3,9,6,9,30,28,2,33
Rapid Vienna,7729,4,7,9,8,33,31,2,30
Mattersburg,7729,5,6,7,11,31,41,-10,25
Vienna,7729,6,6,6,12,24,40,-16,24
SC Rheindorf,7729,7,5,8,11,21,30,-9,23
FC Salzburg,7730,1,14,8,2,45,18,27,50
SK Sturm Gra,7730,2,12,4,8,32,29,3,40
Rapid Vienna,7730,3,9,11,4,37,27,10,38
LASK Linz,7730,4,8,6,10,25,27,-2,30
Mattersburg,7730,5,6,7,11,29,40,-11,25
Vienna,7730,6,6,6,12,25,41,-16,24
SC Rheindorf,7730,7,5,6,13,19,30,-11,21
FC Salzburg,7731,1,14,7,3,43,17,26,49
SK Sturm Gra,7731,2,14,4,6,33,25,8,46
Rapid Vienna,7731,3,7,9,8,32,29,3,30
Mattersburg,7731,4,8,6,10,32,39,-7,30
LASK Linz,7731,5,8,5,11,26,29,-3,29
SC Rheindorf,7731,6,6,6,12,19,29,-10,24
Vienna,7731,7,6,5,13,23,40,-17,23
FC Salzburg,7732,1,15,6,3,44,18,26,51
SK Sturm Gra,7732,2,13,3,8,33,30,3,42
Rapid Vienna,7732,3,10,9,5,37,26,11,39
LASK Linz,7732,4,9,5,10,28,32,-4,32
Mattersburg,7732,5,6,6,12,29,39,-10,24
Vienna,7732,6,6,6,12,24,39,-15,24
SC Rheindorf,7732,7,5,5,14,22,33,-11,20
FC Salzburg,7733,1,15,6,3,45,19,26,51
SK Sturm Gra,7733,2,12,4,8,31,29,2,40
Rapid Vienna,7733,3,8,10,6,32,27,5,34
LASK Linz,7733,4,8,7,9,29,32,-3,31
Mattersburg,7733,5,7,5,12,34,43,-9,26
Vienna,7733,6,7,5,12,28,39,-11,26
SC Rheindorf,7733,7,5,7,12,19,29,-10,22
FC Salzburg,7734,1,14,8,2,45,17,28,50
SK Sturm Gra,7734,2,12,3,9,33,34,-1,39
LASK Linz,7734,3,10,5,9,32,27,5,35
Rapid Vienna,7734,4,8,10,6,34,29,5,34
Mattersburg,7734,5,7,5,12,29,40,-11,26
Vienna,7734,6,6,6,12,24,40,-16,24
SC Rheindorf,7734,7,6,5,13,20,30,-10,23
FC Salzburg,7735,1,15,7,2,45,16,29,52
SK Sturm Gra,7735,2,12,4,8,34,30,4,40
Rapid Vienna,7735,3,9,9,6,34,30,4,36
LASK Linz,7735,4,10,5,9,26,25,1,35
Vienna,7735,5,7,6,11,24,37,-13,27
Mattersburg,7735,6,6,5,13,27,39,-12,23
SC Rheindorf,7735,7,4,6,14,17,30,-13,18
FC Salzburg,7736,1,15,6,3,47,21,26,51
SK Sturm Gra,7736,2,14,3,7,34,28,6,45
Rapid Vienna,7736,3,8,9,7,33,28,5,33
LASK Linz,7736,4,9,6,9,30,27,3,33
Vienna,7736,5,7,5,12,26,40,-14,26
Mattersburg,7736,6,6,6,12,30,41,-11,24
SC Rheindorf,7736,7,5,5,14,17,32,-15,20
FC Salzburg,7737,1,15,7,2,46,17,29,52
SK Sturm Gra,7737,2,12,5,7,32,29,3,41
Rapid Vienna,7737,3,9,10,5,36,28,8,37
LASK Linz,7737,4,7,7,10,27,30,-3,28
Mattersburg,7737,5,6,8,10,30,39,-9,26
Vienna,7737,6,6,5,13,23,39,-16,23
SC Rheindorf,7737,7,5,6,13,18,30,-12,21
FC Salzburg,7738,1,15,7,2,45,16,29,52
SK Sturm Gra,7738,2,13,4,7,34,29,5,43
Rapid Vienna,7738,3,8,10,6,34,29,5,34
LASK Linz,7738,4,8,7,9,28,28,0,31
Mattersburg,7738,5,8,5,11,32,41,-9,29
Vienna,7738,6,6,5,13,23,40,-17,23
SC Rheindorf,7738,7,4,6,14,16,29,-13,18
FC Salzburg,7739,1,15,7,2,43,17,26,52
SK Sturm Gra,7739,2,12,5,7,31,28,3,41
Rapid Vienna,7739,3,9,10,5,37,27,10,37
LASK Linz,7739,4,8,6,10,27,29,-2,30
Mattersburg,7739,5,6,6,12,31,41,-10,24
Vienna,7739,6,6,6,12,25,40,-15,24
SC Rheindorf,7739,7,4,8,12,18,30,-12,20
FC Salzburg,7740,1,15,7,2,45,16,29,52
SK Sturm Gra,7740,2,12,4,8,35,30,5,40
Rapid Vienna,7740,3,9,9,6,35,29,6,36
LASK Linz,7740,4,9,5,10,27,29,-2,32
Vienna,7740,5,7,6,11,27,37,-10,27
Mattersburg,7740,6,6,5,13,30,45,-15,23
SC Rheindorf,7740,7,5,6,13,19,32,-13,21
FC Salzburg,7741,1,14,8,2,45,17,28,50
SK Sturm Gra,7741,2,13,4,7,35,29,6,43
Rapid Vienna,7741,3,9,11,4,40,28,12,38
LASK Linz,7741,4,8,7,9,28,29,-1,31
Vienna,7741,5,7,5,12,25,41,-16,26
Mattersburg,7741,6,6,5,13,29,41,-12,23
SC Rheindorf,7741,7,4,6,14,17,34,-17,18
FC Salzburg,7742,1,16,6,2,44,16,28,54
SK Sturm Gra,7742,2,12,4,8,34,31,3,40
Rapid Vienna,7742,3,7,11,6,33,27,6,32
LASK Linz,7742,4,7,6,11,26,32,-6,27
SC Rheindorf,7742,5,7,6,11,23,29,-6,27
Mattersburg,7742,6,6,7,11,32,41,-9,25
Vienna,7742,7,6,6,12,24,40,-16,24
FC Salzburg,7743,1,15,6,3,50,20,30,51
SK Sturm Gra,7743,2,13,4,7,36,32,4,43
Rapid Vienna,7743,3,8,11,5,35,27,8,35
LASK Linz,7743,4,7,6,11,27,33,-6,27
Vienna,7743,5,7,5,12,27,43,-16,26
SC Rheindorf,7743,6,6,7,11,21,28,-7,25
Mattersburg,7743,7,6,5,13,32,45,-13,23
FC Salzburg,7744,1,15,7,2,51,18,33,52
SK Sturm Gra,7744,2,11,5,8,30,28,2,38
Rapid Vienna,7744,3,8,11,5,36,29,7,35
LASK Linz,7744,4,8,6,10,26,29,-3,30
Mattersburg,7744,5,7,5,12,31,44,-13,26
Vienna,7744,6,7,5,12,27,43,-16,26
SC Rheindorf,7744,7,6,5,13,19,29,-10,23
FC Salzburg,7745,1,14,7,3,44,19,25,49
SK Sturm Gra,7745,2,13,4,7,33,27,6,43
Rapid Vienna,7745,3,9,9,6,36,28,8,36
LASK Linz,7745,4,8,7,9,26,28,-2,31
Vienna,7745,5,7,6,11,26,39,-13,27
Mattersburg,7745,6,6,6,12,32,43,-11,24
SC Rheindorf,7745,7,4,7,13,18,31,-13,19
FC Salzburg,7746,1,15,6,3,45,20,25,51
SK Sturm Gra,7746,2,12,4,8,32,28,4,40
Rapid Vienna,7746,3,9,10,5,38,28,10,37
LASK Linz,7746,4,7,8,9,25,28,-3,29
Vienna,7746,5,8,5,11,27,38,-11,29
SC Rheindorf,7746,6,6,5,13,19,31,-12,23
Mattersburg,7746,7,5,6,13,30,43,-13,21
FC Salzburg,7747,1,14,8,2,45,17,28,50
SK Sturm Gra,7747,2,12,3,9,32,33,-1,39
Rapid Vienna,7747,3,9,10,5,35,26,9,37
LASK Linz,7747,4,10,6,8,30,28,2,36
Vienna,7747,5,7,6,11,26,38,-12,27
Mattersburg,7747,6,5,7,12,29,42,-13,22
SC Rheindorf,7747,7,4,6,14,18,31,-13,18
FC Salzburg,7748,1,15,6,3,46,20,26,51
SK Sturm Gra,7748,2,12,4,8,33,28,5,40
Rapid Vienna,7748,3,10,9,5,36,26,10,39
LASK Linz,7748,4,9,6,9,28,29,-1,33
Vienna,7748,5,7,5,12,27,40,-13,26
Mattersburg,7748,6,6,5,13,30,44,-14,23
SC Rheindorf,7748,7,5,5,14,17,30,-13,20
FC Salzburg,7749,1,15,6,3,44,17,27,51
SK Sturm Gra,7749,2,12,5,7,32,27,5,41
Rapid Vienna,7749,3,9,11,4,35,24,11,38
LASK Linz,7749,4,8,7,9,27,28,-1,31
Mattersburg,7749,5,7,5,12,32,42,-10,26
Vienna,7749,6,6,5,13,25,44,-19,23
SC Rheindorf,7749,7,4,7,13,16,29,-13,19
FC Salzburg,7750,1,15,7,2,45,18,27,52
SK Sturm Gra,7750,2,14,3,7,36,27,9,45
Rapid Vienna,7750,3,7,11,6,33,30,3,32
LASK Linz,7750,4,8,6,10,26,27,-1,30
Mattersburg,7750,5,7,5,12,28,39,-11,26
Vienna,7750,6,6,6,12,24,39,-15,24
SC Rheindorf,7750,7,5,6,13,17,29,-12,21
FC Salzburg,7751,1,14,7,3,45,19,26,49
SK Sturm Gra,7751,2,11,5,8,30,31,-1,38
LASK Linz,7751,3,10,5,9,29,27,2,35
Rapid Vienna,7751,4,8,10,6,37,29,8,34
SC Rheindorf,7751,5,7,5,12,24,30,-6,26
Vienna,7751,6,7,5,12,25,40,-15,26
Mattersburg,7751,7,6,5,13,30,44,-14,23
FC Salzburg,7752,1,16,6,2,50,16,34,54
SK Sturm Gra,7752,2,12,3,9,34,32,2,39
Rapid Vienna,7752,3,9,10,5,37,27,10,37
SC Rheindorf,7752,4,7,6,11,22,27,-5,27
LASK Linz,7752,5,7,5,12,27,36,-9,26
Mattersburg,7752,6,6,6,12,30,43,-13,24
Vienna,7752,7,6,6,12,23,42,-19,24
FC Salzburg,7753,1,15,7,2,50,17,33,52
SK Sturm Gra,7753,2,13,5,6,34,26,8,44
LASK Linz,7753,3,9,7,8,29,28,1,34
Rapid Vienna,7753,4,8,9,7,37,34,3,33
Mattersburg,7753,5,6,6,12,31,44,-13,24
Vienna,7753,6,6,5,13,25,44,-19,23
SC Rheindorf,7753,7,4,7,13,18,31,-13,19
FC Salzburg,7754,1,16,6,2,47,15,32,54
SK Sturm Gra,7754,2,13,4,7,31,27,4,43
LASK Linz,7754,3,9,5,10,26,27,-1,32
Rapid Vienna,7754,4,7,10,7,32,31,1,31
Mattersburg,7754,5,7,5,12,31,40,-9,26
SC Rheindorf,7754,6,6,5,13,18,29,-11,23
Vienna,7754,7,6,5,13,23,39,-16,23
FC Salzburg,7755,1,13,8,3,42,20,22,47
SK Sturm Gra,7755,2,12,5,7,31,27,4,41
Rapid Vienna,7755,3,8,10,6,36,28,8,34
LASK Linz,7755,4,9,6,9,28,29,-1,33
Mattersburg,7755,5,7,6,11,33,41,-8,27
Vienna,7755,6,6,6,12,25,41,-16,24
SC Rheindorf,7755,7,5,7,12,18,27,-9,22
FC Salzburg,7756,1,16,6,2,45,16,29,54
SK Sturm Gra,7756,2,12,4,8,31,29,2,40
Rapid Vienna,7756,3,8,10,6,33,30,3,34
LASK Linz,7756,4,9,6,9,29,25,4,33
Vienna,7756,5,7,5,12,26,39,-13,26
Mattersburg,7756,6,6,5,13,30,42,-12,23
SC Rheindorf,7756,7,5,6,13,24,37,-13,21
FC Salzburg,7757,1,14,7,3,46,20,26,49
SK Sturm Gra,7757,2,13,4,7,34,29,5,43
Rapid Vienna,7757,3,10,9,5,39,27,12,39
LASK Linz,7757,4,7,7,10,25,29,-4,28
Mattersburg,7757,5,7,6,11,32,43,-11,27
Vienna,7757,6,6,6,12,26,41,-15,24
SC Rheindorf,7757,7,4,7,13,17,30,-13,19
FC Salzburg,7758,1,14,6,4,44,19,25,48
Rapid Vienna,7758,2,9,10,5,39,25,14,37
SK Sturm Gra,7758,3,11,4,9,29,35,-6,37
Mattersburg,7758,4,8,6,10,32,37,-5,30
LASK Linz,7758,5,7,6,11,25,31,-6,27
Vienna,7758,6,7,6,11,25,38,-13,27
SC Rheindorf,7758,7,6,6,12,19,28,-9,24
FC Salzburg,7759,1,16,6,2,47,17,30,54
SK Sturm Gra,7759,2,12,4,8,31,29,2,40
Rapid Vienna,7759,3,8,10,6,35,27,8,34
LASK Linz,7759,4,8,7,9,29,30,-1,31
Vienna,7759,5,7,5,12,25,39,-14,26
SC Rheindorf,7759,6,5,8,11,19,28,-9,23
Mattersburg,7759,7,5,6,13,29,45,-16,21
SK Sturm Gra,7760,1,14,3,7,36,30,6,45
FC Salzburg,7760,2,12,8,4,41,21,20,44
Rapid Vienna,7760,3,9,9,6,38,29,9,36
LASK Linz,7760,4,7,6,11,27,31,-4,27
Mattersburg,7760,5,7,6,11,34,43,-9,27
Vienna,7760,6,7,6,11,26,38,-12,27
SC Rheindorf,7760,7,6,6,12,19,29,-10,24
FC Salzburg,7761,1,15,6,3,47,20,27,51
SK Sturm Gra,7761,2,12,5,7,33,30,3,41
Rapid Vienna,7761,3,8,11,5,35,27,8,35
LASK Linz,7761,4,7,6,11,27,34,-7,27
Mattersburg,7761,5,7,6,11,32,40,-8,27
Vienna,7761,6,7,5,12,26,39,-13,26
SC Rheindorf,7761,7,5,7,12,20,30,-10,22
FC Salzburg,7762,1,13,7,4,43,20,23,46
SK Sturm Gra,7762,2,13,5,6,36,25,11,44
Rapid Vienna,7762,3,8,11,5,34,26,8,35
LASK Linz,7762,4,8,6,10,26,29,-3,30
Vienna,7762,5,8,5,11,26,38,-12,29
Mattersburg,7762,6,7,5,12,31,42,-11,26
SC Rheindorf,7762,7,4,7,13,15,31,-16,19
FC Salzburg,7763,1,16,6,2,45,16,29,54
SK Sturm Gra,7763,2,13,4,7,35,29,6,43
Rapid Vienna,7763,3,8,10,6,33,28,5,34
LASK Linz,7763,4,8,7,9,28,29,-1,31
Vienna,7763,5,7,5,12,26,41,-15,26
SC Rheindorf,7763,6,5,7,12,16,26,-10,22
Mattersburg,7763,7,5,5,14,31,45,-14,20
FC Salzburg,7764,1,14,7,3,44,21,23,49
SK Sturm Gra,7764,2,12,4,8,33,30,3,40
Rapid Vienna,7764,3,9,10,5,35,25,10,37
LASK Linz,7764,4,10,5,9,32,29,3,35
Vienna,7764,5,6,7,11,26,40,-14,25
Mattersburg,7764,6,5,7,12,32,46,-14,22
SC Rheindorf,7764,7,4,8,12,17,28,-11,20
FC Salzburg,7765,1,13,8,3,42,20,22,47
SK Sturm Gra,7765,2,13,4,7,33,26,7,43
Rapid Vienna,7765,3,8,9,7,37,30,7,33
LASK Linz,7765,4,9,5,10,28,32,-4,32
Vienna,7765,5,7,6,11,27,39,-12,27
Mattersburg,7765,6,7,5,12,33,43,-10,26
SC Rheindorf,7765,7,6,5,13,21,31,-10,23
FC Salzburg,7766,1,14,7,3,47,22,25,49
SK Sturm Gra,7766,2,13,4,7,33,28,5,43
Rapid Vienna,7766,3,8,11,5,36,29,7,35
LASK Linz,7766,4,7,8,9,28,30,-2,29
Vienna,7766,5,8,5,11,29,38,-9,29
Mattersburg,7766,6,5,7,12,30,45,-15,22
SC Rheindorf,7766,7,4,8,12,18,29,-11,20
FC Salzburg,7767,1,15,6,3,47,18,29,51
SK Sturm Gra,7767,2,12,4,8,30,27,3,40
LASK Linz,7767,3,11,5,8,29,24,5,38
Rapid Vienna,7767,4,9,9,6,36,28,8,36
Mattersburg,7767,5,7,5,12,29,41,-12,26
Vienna,7767,6,6,5,13,23,41,-18,23
SC Rheindorf,7767,7,4,6,14,16,31,-15,18
FC Salzburg,7768,1,14,7,3,43,16,27,49
SK Sturm Gra,7768,2,12,3,9,30,28,2,39
Rapid Vienna,7768,3,9,10,5,35,25,10,37
LASK Linz,7768,4,10,6,8,30,28,2,36
Vienna,7768,5,7,5,12,27,40,-13,26
SC Rheindorf,7768,6,6,5,13,21,32,-11,23
Mattersburg,7768,7,5,6,13,30,47,-17,21
FC Salzburg,7769,1,15,7,2,47,16,31,52
Rapid Vienna,7769,2,10,10,4,36,23,13,40
SK Sturm Gra,7769,3,11,4,9,30,30,0,37
LASK Linz,7769,4,7,8,9,26,29,-3,29
Mattersburg,7769,5,6,7,11,32,45,-13,25
Vienna,7769,6,6,6,12,25,41,-16,24
SC Rheindorf,7769,7,5,6,13,18,30,-12,21
FC Salzburg,7770,1,14,8,2,43,17,26,50
SK Sturm Gra,7770,2,13,4,7,33,28,5,43
Rapid Vienna,7770,3,8,11,5,35,27,8,35
Mattersburg,7770,4,7,7,10,36,40,-4,28
LASK Linz,7770,5,7,6,11,25,30,-5,27
Vienna,7770,6,6,6,12,25,40,-15,24
SC Rheindorf,7770,7,5,6,13,18,33,-15,21
FC Salzburg,7771,1,15,6,3,46,21,25,51
SK Sturm Gra,7771,2,12,3,9,31,30,1,39
Rapid Vienna,7771,3,9,9,6,36,27,9,36
LASK Linz,7771,4,9,6,9,27,28,-1,33
Mattersburg,7771,5,7,6,11,33,41,-8,27
Vienna,7771,6,6,5,13,24,41,-17,23
SC Rheindorf,7771,7,5,7,12,19,28,-9,22
FC Salzburg,7772,1,15,7,2,46,16,30,52
SK Sturm Gra,7772,2,12,5,7,33,30,3,41
Rapid Vienna,7772,3,8,11,5,35,27,8,35
LASK Linz,7772,4,9,6,9,28,28,0,33
Mattersburg,7772,5,7,5,12,33,43,-10,26
Vienna,7772,6,7,5,12,27,43,-16,26
SC Rheindorf,7772,7,4,5,15,19,34,-15,17
FC Salzburg,7773,1,15,6,3,45,16,29,51
Rapid Vienna,7773,2,9,11,4,38,25,13,38
SK Sturm Gra,7773,3,11,5,8,31,30,1,38
LASK Linz,7773,4,9,7,8,33,27,6,34
Vienna,7773,5,6,6,12,24,39,-15,24
Mattersburg,7773,6,6,6,12,29,48,-19,24
SC Rheindorf,7773,7,4,7,13,20,35,-15,19
SK Sturm Gra,7774,1,14,4,6,34,27,7,46
FC Salzburg,7774,2,12,8,4,39,18,21,44
LASK Linz,7774,3,10,5,9,32,29,3,35
Rapid Vienna,7774,4,8,10,6,35,28,7,34
Vienna,7774,5,7,6,11,27,37,-10,27
Mattersburg,7774,6,7,5,12,31,44,-13,26
SC Rheindorf,7774,7,4,6,14,17,32,-15,18
FC Salzburg,7775,1,15,6,3,44,20,24,51
Rapid Vienna,7775,2,10,10,4,39,25,14,40
SK Sturm Gra,7775,3,11,4,9,33,35,-2,37
LASK Linz,7775,4,8,8,8,28,27,1,32
Mattersburg,7775,5,7,6,11,31,38,-7,27
Vienna,7775,6,6,5,13,24,41,-17,23
SC Rheindorf,7775,7,4,7,13,17,30,-13,19
FC Salzburg,7776,1,15,7,2,44,16,28,52
SK Sturm Gra,7776,2,13,3,8,36,30,6,42
Rapid Vienna,7776,3,8,10,6,35,27,8,34
LASK Linz,7776,4,8,5,11,27,32,-5,29
Vienna,7776,5,7,6,11,27,39,-12,27
Mattersburg,7776,6,6,6,12,33,44,-11,24
SC Rheindorf,7776,7,5,7,12,20,34,-14,22
FC Salzburg,7777,1,15,6,3,48,17,31,51
Rapid Vienna,7777,2,10,9,5,40,27,13,39
SK Sturm Gra,7777,3,11,5,8,29,32,-3,38
LASK Linz,7777,4,8,7,9,27,29,-2,31
Mattersburg,7777,5,6,7,11,33,45,-12,25
Vienna,7777,6,6,5,13,24,42,-18,23
SC Rheindorf,7777,7,5,7,12,21,30,-9,22
FC Salzburg,7778,1,15,6,3,46,19,27,51
SK Sturm Gra,7778,2,11,5,8,31,30,1,38
LASK Linz,7778,3,10,5,9,26,27,-1,35
Rapid Vienna,7778,4,8,10,6,36,27,9,34
SC Rheindorf,7778,5,7,6,11,20,25,-5,27
Mattersburg,7778,6,6,5,13,28,41,-13,23
Vienna,7778,7,6,5,13,24,42,-18,23
FC Salzburg,7779,1,15,7,2,50,18,32,52
SK Sturm Gra,7779,2,13,3,8,32,28,4,42
Rapid Vienna,7779,3,9,9,6,38,29,9,36
LASK Linz,7779,4,8,6,10,28,30,-2,30
Mattersburg,7779,5,7,6,11,33,45,-12,27
Vienna,7779,6,6,7,11,27,41,-14,25
SC Rheindorf,7779,7,4,6,14,18,35,-17,18
FC Salzburg,7780,1,14,7,3,42,17,25,49
SK Sturm Gra,7780,2,13,5,6,32,26,6,44
Rapid Vienna,7780,3,8,11,5,34,27,7,35
LASK Linz,7780,4,8,7,9,29,30,-1,31
Vienna,7780,5,7,6,11,25,38,-13,27
Mattersburg,7780,6,6,6,12,28,38,-10,24
SC Rheindorf,7780,7,4,6,14,18,32,-14,18
FC Salzburg,7781,1,14,7,3,44,20,24,49
SK Sturm Gra,7781,2,13,4,7,37,28,9,43
Rapid Vienna,7781,3,9,11,4,38,25,13,38
LASK Linz,7781,4,7,7,10,24,31,-7,28
Mattersburg,7781,5,7,6,11,33,40,-7,27
Vienna,7781,6,6,7,11,26,40,-14,25
SC Rheindorf,7781,7,4,6,14,17,35,-18,18
FC Salzburg,7782,1,16,6,2,48,19,29,54
SK Sturm Gra,7782,2,12,4,8,31,29,2,40
Rapid Vienna,7782,3,9,9,6,42,32,10,36
LASK Linz,7782,4,8,7,9,29,31,-2,31
Mattersburg,7782,5,6,6,12,29,41,-12,24
SC Rheindorf,7782,6,6,5,13,20,31,-11,23
Vienna,7782,7,6,5,13,24,40,-16,23
FC Salzburg,7783,1,14,6,4,43,19,24,48
SK Sturm Gra,7783,2,12,4,8,33,30,3,40
Rapid Vienna,7783,3,9,10,5,37,26,11,37
LASK Linz,7783,4,8,6,10,28,29,-1,30
Mattersburg,7783,5,7,6,11,31,39,-8,27
Vienna,7783,6,7,5,12,25,41,-16,26
SC Rheindorf,7783,7,5,7,12,17,30,-13,22
FC Salzburg,7784,1,14,7,3,50,18,32,49
SK Sturm Gra,7784,2,11,5,8,31,34,-3,38
Rapid Vienna,7784,3,8,12,4,38,29,9,36
LASK Linz,7784,4,8,6,10,28,31,-3,30
Vienna,7784,5,8,5,11,27,39,-12,29
SC Rheindorf,7784,6,5,8,11,19,27,-8,23
Mattersburg,7784,7,5,7,12,29,44,-15,22
FC Salzburg,7785,1,14,6,4,43,19,24,48
Rapid Vienna,7785,2,9,10,5,37,28,9,37
SK Sturm Gra,7785,3,11,4,9,31,31,0,37
LASK Linz,7785,4,9,6,9,27,27,0,33
Vienna,7785,5,7,6,11,26,39,-13,27
SC Rheindorf,7785,6,6,6,12,20,29,-9,24
Mattersburg,7785,7,6,6,12,30,41,-11,24
FC Salzburg,7786,1,13,8,3,44,19,25,47
Rapid Vienna,7786,2,10,10,4,36,24,12,40
SK Sturm Gra,7786,3,11,3,10,29,33,-4,36
LASK Linz,7786,4,8,6,10,26,28,-2,30
Mattersburg,7786,5,6,8,10,32,41,-9,26
Vienna,7786,6,6,7,11,24,38,-14,25
SC Rheindorf,7786,7,6,6,12,20,28,-8,24
FC Salzburg,7787,1,15,7,2,49,17,32,52
SK Sturm Gra,7787,2,13,4,7,32,27,5,43
Rapid Vienna,7787,3,7,12,5,34,27,7,33
LASK Linz,7787,4,8,6,10,29,32,-3,30
Mattersburg,7787,5,7,5,12,32,44,-12,26
Vienna,7787,6,7,5,12,25,41,-16,26
SC Rheindorf,7787,7,4,7,13,18,31,-13,19
FC Salzburg,7788,1,12,8,4,41,20,21,44
SK Sturm Gra,7788,2,13,4,7,35,25,10,43
Rapid Vienna,7788,3,8,9,7,36,34,2,33
LASK Linz,7788,4,8,6,10,26,30,-4,30
Mattersburg,7788,5,7,7,10,34,41,-7,28
Vienna,7788,6,7,6,11,27,40,-13,27
SC Rheindorf,7788,7,6,6,12,18,27,-9,24
FC Salzburg,7789,1,15,7,2,46,17,29,52
SK Sturm Gra,7789,2,13,3,8,33,30,3,42
LASK Linz,7789,3,9,6,9,30,27,3,33
Rapid Vienna,7789,4,8,9,7,35,35,0,33
Vienna,7789,5,6,7,11,27,41,-14,25
Mattersburg,7789,6,6,6,12,32,43,-11,24
SC Rheindorf,7789,7,5,6,13,20,30,-10,21
FC Salzburg,7790,1,14,7,3,48,22,26,49
SK Sturm Gra,7790,2,12,4,8,40,32,8,40
Rapid Vienna,7790,3,9,10,5,36,27,9,37
LASK Linz,7790,4,8,7,9,26,32,-6,31
Mattersburg,7790,5,6,7,11,33,45,-12,25
Vienna,7790,6,6,6,12,26,41,-15,24
SC Rheindorf,7790,7,5,7,12,18,28,-10,22
FC Salzburg,7791,1,15,6,3,43,18,25,51
SK Sturm Gra,7791,2,11,4,9,31,32,-1,37
Rapid Vienna,7791,3,9,9,6,37,28,9,36
LASK Linz,7791,4,10,6,8,30,26,4,36
Mattersburg,7791,5,8,6,10,33,38,-5,30
Vienna,7791,6,6,5,13,23,40,-17,23
SC Rheindorf,7791,7,4,6,14,18,33,-15,18
FC Salzburg,7792,1,15,6,3,48,18,30,51
Rapid Vienna,7792,2,10,9,5,41,28,13,39
SK Sturm Gra,7792,3,11,4,9,30,32,-2,37
LASK Linz,7792,4,9,5,10,29,31,-2,32
Mattersburg,7792,5,7,5,12,32,40,-8,26
SC Rheindorf,7792,6,6,6,12,19,32,-13,24
Vienna,7792,7,6,5,13,24,42,-18,23
FC Salzburg,7793,1,13,7,4,44,20,24,46
Rapid Vienna,7793,2,10,10,4,38,27,11,40
SK Sturm Gra,7793,3,12,4,8,30,29,1,40
LASK Linz,7793,4,8,6,10,25,27,-2,30
Mattersburg,7793,5,7,6,11,32,41,-9,27
Vienna,7793,6,7,6,11,26,39,-13,27
SC Rheindorf,7793,7,5,5,14,19,31,-12,20
FC Salzburg,7794,1,13,7,4,42,19,23,46
SK Sturm Gra,7794,2,14,3,7,38,27,11,45
Rapid Vienna,7794,3,9,9,6,34,28,6,36
SC Rheindorf,7794,4,7,6,11,20,25,-5,27
LASK Linz,7794,5,7,6,11,25,33,-8,27
Vienna,7794,6,7,6,11,25,38,-13,27
Mattersburg,7794,7,5,7,12,28,42,-14,22
FC Salzburg,7795,1,15,6,3,45,17,28,51
SK Sturm Gra,7795,2,14,3,7,33,26,7,45
Rapid Vienna,7795,3,9,9,6,36,30,6,36
LASK Linz,7795,4,7,6,11,27,32,-5,27
SC Rheindorf,7795,5,6,6,12,21,28,-7,24
Mattersburg,7795,6,6,6,12,30,44,-14,24
Vienna,7795,7,6,6,12,25,40,-15,24
FC Salzburg,7796,1,16,6,2,53,18,35,54
SK Sturm Gra,7796,2,11,5,8,34,33,1,38
Rapid Vienna,7796,3,8,10,6,35,32,3,34
LASK Linz,7796,4,9,6,9,31,29,2,33
Mattersburg,7796,5,7,5,12,30,43,-13,26
Vienna,7796,6,7,5,12,25,41,-16,26
SC Rheindorf,7796,7,4,7,13,18,30,-12,19
FC Salzburg,7797,1,14,7,3,46,19,27,49
SK Sturm Gra,7797,2,12,5,7,31,30,1,41
Rapid Vienna,7797,3,8,11,5,34,26,8,35
LASK Linz,7797,4,9,6,9,28,28,0,33
Mattersburg,7797,5,6,7,11,32,42,-10,25
Vienna,7797,6,6,6,12,25,40,-15,24
SC Rheindorf,7797,7,4,8,12,18,29,-11,20
FC Salzburg,7798,1,14,6,4,44,20,24,48
SK Sturm Gra,7798,2,13,4,7,36,30,6,43
Rapid Vienna,7798,3,9,11,4,38,28,10,38
LASK Linz,7798,4,9,6,9,29,27,2,33
Mattersburg,7798,5,6,6,12,29,43,-14,24
Vienna,7798,6,6,6,12,26,41,-15,24
SC Rheindorf,7798,7,5,5,14,19,32,-13,20
FC Salzburg,7799,1,14,7,3,40,17,23,49
SK Sturm Gra,7799,2,13,4,7,32,26,6,43
Rapid Vienna,7799,3,8,11,5,35,26,9,35
LASK Linz,7799,4,8,8,8,28,25,3,32
Mattersburg,7799,5,7,5,12,32,41,-9,26
Vienna,7799,6,6,6,12,23,38,-15,24
SC Rheindorf,7799,7,4,7,13,17,34,-17,19
FC Salzburg,7800,1,14,7,3,46,17,29,49
SK Sturm Gra,7800,2,14,3,7,34,26,8,45
Rapid Vienna,7800,3,8,10,6,36,30,6,34
LASK Linz,7800,4,8,5,11,28,32,-4,29
Mattersburg,7800,5,7,5,12,29,42,-13,26
Vienna,7800,6,7,5,12,24,40,-16,26
SC Rheindorf,7800,7,6,5,13,18,28,-10,23
FC Salzburg,7801,1,15,6,3,45,18,27,51
SK Sturm Gra,7801,2,13,3,8,32,28,4,42
Rapid Vienna,7801,3,8,9,7,33,27,6,33
LASK Linz,7801,4,8,6,10,26,28,-2,30
SC Rheindorf,7801,5,7,5,12,18,26,-8,26
Mattersburg,7801,6,6,7,11,30,40,-10,25
Vienna,7801,7,6,6,12,25,42,-17,24
FC Salzburg,7802,1,16,6,2,44,17,27,54
SK Sturm Gra,7802,2,11,4,9,31,31,0,37
Rapid Vienna,7802,3,8,11,5,38,28,10,35
LASK Linz,7802,4,8,6,10,28,30,-2,30
Mattersburg,7802,5,6,7,11,30,40,-10,25
SC Rheindorf,7802,6,6,6,12,20,30,-10,24
Vienna,7802,7,6,6,12,24,39,-15,24
FC Salzburg,7803,1,15,6,3,49,17,32,51
SK Sturm Gra,7803,2,12,5,7,32,28,4,41
Rapid Vienna,7803,3,8,11,5,37,28,9,35
LASK Linz,7803,4,8,7,9,27,29,-2,31
Vienna,7803,5,7,5,12,26,40,-14,26
Mattersburg,7803,6,6,5,13,29,46,-17,23
SC Rheindorf,7803,7,5,7,12,17,29,-12,22
FC Salzburg,7804,1,15,6,3,50,19,31,51
SK Sturm Gra,7804,2,13,3,8,37,36,1,42
Rapid Vienna,7804,3,9,10,5,40,31,9,37
LASK Linz,7804,4,9,6,9,28,30,-2,33
Vienna,7804,5,7,5,12,27,41,-14,26
SC Rheindorf,7804,6,5,6,13,20,30,-10,21
Mattersburg,7804,7,5,6,13,28,43,-15,21
FC Salzburg,7805,1,13,8,3,43,20,23,47
SK Sturm Gra,7805,2,12,5,7,32,27,5,41
Rapid Vienna,7805,3,9,10,5,37,27,10,37
LASK Linz,7805,4,9,6,9,29,28,1,33
Vienna,7805,5,7,6,11,26,39,-13,27
Mattersburg,7805,6,6,6,12,31,43,-12,24
SC Rheindorf,7805,7,4,7,13,17,31,-14,19
FC Salzburg,7806,1,16,6,2,45,17,28,54
SK Sturm Gra,7806,2,13,4,7,32,25,7,43
Rapid Vienna,7806,3,9,10,5,37,26,11,37
LASK Linz,7806,4,8,5,11,26,32,-6,29
Mattersburg,7806,5,7,5,12,31,44,-13,26
Vienna,7806,6,6,5,13,25,41,-16,23
SC Rheindorf,7806,7,5,5,14,20,31,-11,20
FC Salzburg,7807,1,15,7,2,48,18,30,52
SK Sturm Gra,7807,2,13,3,8,34,28,6,42
Rapid Vienna,7807,3,8,10,6,33,28,5,34
LASK Linz,7807,4,7,6,11,26,32,-6,27
Vienna,7807,5,7,6,11,29,41,-12,27
SC Rheindorf,7807,6,6,6,12,21,30,-9,24
Mattersburg,7807,7,6,6,12,31,45,-14,24
FC Salzburg,7808,1,14,6,4,47,19,28,48
SK Sturm Gra,7808,2,12,4,8,32,30,2,40
Rapid Vienna,7808,3,9,10,5,39,28,11,37
LASK Linz,7808,4,8,7,9,27,28,-1,31
Vienna,7808,5,8,5,11,29,39,-10,29
Mattersburg,7808,6,7,5,12,33,48,-15,26
SC Rheindorf,7808,7,4,7,13,17,32,-15,19
FC Salzburg,7809,1,14,7,3,46,20,26,49
SK Sturm Gra,7809,2,12,5,7,32,26,6,41
Rapid Vienna,7809,3,9,11,4,36,25,11,38
LASK Linz,7809,4,9,6,9,28,29,-1,33
Vienna,7809,5,7,5,12,26,43,-17,26
Mattersburg,7809,6,5,7,12,29,41,-12,22
SC Rheindorf,7809,7,4,7,13,16,29,-13,19
FC Salzburg,7810,1,15,7,2,47,18,29,52
SK Sturm Gra,7810,2,12,4,8,31,28,3,40
Rapid Vienna,7810,3,8,11,5,34,27,7,35
LASK Linz,7810,4,8,7,9,25,26,-1,31
Vienna,7810,5,7,5,12,27,40,-13,26
Mattersburg,7810,6,6,5,13,28,44,-16,23
SC Rheindorf,7810,7,5,7,12,17,26,-9,22
FC Salzburg,7811,1,14,8,2,45,20,25,50
SK Sturm Gra,7811,2,13,4,7,36,29,7,43
Rapid Vienna,7811,3,9,9,6,37,30,7,36
LASK Linz,7811,4,7,7,10,25,30,-5,28
Vienna,7811,5,7,6,11,26,39,-13,27
Mattersburg,7811,6,6,6,12,29,40,-11,24
SC Rheindorf,7811,7,5,6,13,19,29,-10,21
FC Salzburg,7812,1,13,8,3,44,21,23,47
SK Sturm Gra,7812,2,13,5,6,36,29,7,44
Rapid Vienna,7812,3,9,9,6,40,29,11,36
Mattersburg,7812,4,7,6,11,32,41,-9,27
LASK Linz,7812,5,7,5,12,25,31,-6,26
Vienna,7812,6,7,5,12,27,41,-14,26
SC Rheindorf,7812,7,6,6,12,21,33,-12,24
FC Salzburg,7813,1,14,7,3,43,18,25,49
SK Sturm Gra,7813,2,13,4,7,32,28,4,43
LASK Linz,7813,3,11,5,8,29,25,4,38
Rapid Vienna,7813,4,8,10,6,38,28,10,34
Vienna,7813,5,6,6,12,24,39,-15,24
SC Rheindorf,7813,6,5,6,13,20,32,-12,21
Mattersburg,7813,7,5,6,13,27,43,-16,21
FC Salzburg,7814,1,14,7,3,45,22,23,49
SK Sturm Gra,7814,2,13,4,7,39,30,9,43
Rapid Vienna,7814,3,10,10,4,40,26,14,40
LASK Linz,7814,4,9,5,10,27,30,-3,32
Mattersburg,7814,5,7,5,12,31,41,-10,26
Vienna,7814,6,6,6,12,26,41,-15,24
SC Rheindorf,7814,7,4,5,15,15,33,-18,17
FC Salzburg,7815,1,15,7,2,45,17,28,52
SK Sturm Gra,7815,2,13,4,7,33,28,5,43
Rapid Vienna,7815,3,7,12,5,33,27,6,33
Mattersburg,7815,4,8,5,11,38,39,-1,29
LASK Linz,7815,5,7,6,11,23,29,-6,27
Vienna,7815,6,6,6,12,24,44,-20,24
SC Rheindorf,7815,7,5,6,13,21,33,-12,21
FC Salzburg,7816,1,14,8,2,43,17,26,50
SK Sturm Gra,7816,2,13,4,7,32,27,5,43
Rapid Vienna,7816,3,8,11,5,34,26,8,35
LASK Linz,7816,4,9,5,10,30,30,0,32
Vienna,7816,5,7,6,11,25,38,-13,27
SC Rheindorf,7816,6,5,6,13,21,32,-11,21
Mattersburg,7816,7,5,6,13,28,43,-15,21
FC Salzburg,7817,1,15,7,2,44,18,26,52
Rapid Vienna,7817,2,9,10,5,37,29,8,37
SK Sturm Gra,7817,3,11,3,10,28,29,-1,36
LASK Linz,7817,4,9,6,9,30,28,2,33
SC Rheindorf,7817,5,7,5,12,18,26,-8,26
Vienna,7817,6,7,5,12,26,39,-13,26
Mattersburg,7817,7,5,6,13,27,41,-14,21
FC Salzburg,7818,1,13,8,3,43,20,23,47
SK Sturm Gra,7818,2,12,4,8,31,29,2,40
Rapid Vienna,7818,3,8,10,6,36,29,7,34
LASK Linz,7818,4,8,6,10,25,30,-5,30
Mattersburg,7818,5,8,5,11,32,40,-8,29
Vienna,7818,6,7,6,11,26,39,-13,27
SC Rheindorf,7818,7,6,5,13,24,30,-6,23
FC Salzburg,7819,1,14,7,3,44,19,25,49
Rapid Vienna,7819,2,10,10,4,38,27,11,40
SK Sturm Gra,7819,3,12,4,8,32,28,4,40
Mattersburg,7819,4,7,6,11,33,42,-9,27
Vienna,7819,5,7,6,11,27,40,-13,27
LASK Linz,7819,6,7,5,12,25,33,-8,26
SC Rheindorf,7819,7,5,6,13,19,29,-10,21
FC Salzburg,7820,1,13,8,3,45,20,25,47
SK Sturm Gra,7820,2,12,4,8,32,30,2,40
Rapid Vienna,7820,3,10,9,5,40,29,11,39
LASK Linz,7820,4,9,5,10,28,27,1,32
Vienna,7820,5,8,5,11,28,38,-10,29
Mattersburg,7820,6,6,6,12,29,42,-13,24
SC Rheindorf,7820,7,5,5,14,18,34,-16,20
FC Salzburg,7821,1,15,6,3,44,16,28,51
SK Sturm Gra,7821,2,14,3,7,33,27,6,45
Rapid Vienna,7821,3,8,9,7,36,34,2,33
LASK Linz,7821,4,8,5,11,31,30,1,29
Vienna,7821,5,7,5,12,24,38,-14,26
SC Rheindorf,7821,6,6,6,12,22,32,-10,24
Mattersburg,7821,7,6,6,12,29,42,-13,24
FC Salzburg,7822,1,16,6,2,45,17,28,54
Rapid Vienna,7822,2,10,9,5,38,28,10,39
SK Sturm Gra,7822,3,11,4,9,31,30,1,37
LASK Linz,7822,4,8,6,10,26,30,-4,30
Vienna,7822,5,7,5,12,25,39,-14,26
SC Rheindorf,7822,6,6,6,12,23,30,-7,24
Mattersburg,7822,7,5,6,13,29,43,-14,21
FC Salzburg,7823,1,13,7,4,42,21,21,46
SK Sturm Gra,7823,2,12,5,7,34,30,4,41
Rapid Vienna,7823,3,8,12,4,37,27,10,36
LASK Linz,7823,4,8,6,10,27,29,-2,30
Vienna,7823,5,7,5,12,25,39,-14,26
SC Rheindorf,7823,6,6,7,11,19,27,-8,25
Mattersburg,7823,7,6,6,12,28,39,-11,24
FC Salzburg,7824,1,15,6,3,44,18,26,51
SK Sturm Gra,7824,2,13,4,7,34,29,5,43
Rapid Vienna,7824,3,7,10,7,33,30,3,31
LASK Linz,7824,4,8,7,9,26,29,-3,31
Mattersburg,7824,5,7,5,12,33,41,-8,26
Vienna,7824,6,7,5,12,26,40,-14,26
SC Rheindorf,7824,7,5,7,12,23,32,-9,22
FC Salzburg,7825,1,16,6,2,54,22,32,54
SK Sturm Gra,7825,2,14,3,7,38,32,6,45
LASK Linz,7825,3,9,6,9,28,29,-1,33
Rapid Vienna,7825,4,7,11,6,35,30,5,32
Vienna,7825,5,7,5,12,28,41,-13,26
Mattersburg,7825,6,6,5,13,31,47,-16,23
SC Rheindorf,7825,7,4,6,14,18,31,-13,18
FC Salzburg,7826,1,14,8,2,46,16,30,50
SK Sturm Gra,7826,2,13,3,8,32,28,4,42
LASK Linz,7826,3,10,6,8,28,26,2,36
Rapid Vienna,7826,4,8,10,6,36,31,5,34
Vienna,7826,5,6,6,12,25,43,-18,24
Mattersburg,7826,6,5,8,11,29,40,-11,23
SC Rheindorf,7826,7,5,5,14,18,30,-12,20
FC Salzburg,7827,1,16,6,2,47,16,31,54
SK Sturm Gra,7827,2,13,3,8,34,31,3,42
Rapid Vienna,7827,3,8,9,7,36,33,3,33
LASK Linz,7827,4,9,6,9,29,29,0,33
Vienna,7827,5,7,5,12,25,39,-14,26
Mattersburg,7827,6,6,6,12,30,42,-12,24
SC Rheindorf,7827,7,5,5,14,18,29,-11,20
FC Salzburg,7828,1,14,7,3,41,18,23,49
SK Sturm Gra,7828,2,13,4,7,32,26,6,43
LASK Linz,7828,3,9,6,9,27,27,0,33
Rapid Vienna,7828,4,7,11,6,32,26,6,32
Mattersburg,7828,5,6,6,12,33,42,-9,24
SC Rheindorf,7828,6,6,6,12,20,31,-11,24
Vienna,7828,7,6,6,12,24,39,-15,24
FC Salzburg,7829,1,16,6,2,51,17,34,54
SK Sturm Gra,7829,2,13,3,8,30,27,3,42
Rapid Vienna,7829,3,7,10,7,34,33,1,31
LASK Linz,7829,4,8,6,10,27,27,0,30
Mattersburg,7829,5,7,5,12,30,42,-12,26
SC Rheindorf,7829,6,6,7,11,20,27,-7,25
Vienna,7829,7,6,5,13,23,42,-19,23
FC Salzburg,7830,1,16,6,2,50,21,29,54
SK Sturm Gra,7830,2,13,4,7,33,28,5,43
Rapid Vienna,7830,3,8,10,6,38,31,7,34
LASK Linz,7830,4,8,6,10,27,30,-3,30
Vienna,7830,5,7,5,12,28,41,-13,26
SC Rheindorf,7830,6,6,6,12,22,31,-9,24
Mattersburg,7830,7,5,5,14,27,43,-16,20
FC Salzburg,7831,1,14,7,3,43,19,24,49
SK Sturm Gra,7831,2,11,5,8,29,29,0,38
Rapid Vienna,7831,3,9,9,6,36,26,10,36
LASK Linz,7831,4,9,7,8,28,25,3,34
SC Rheindorf,7831,5,6,6,12,19,29,-10,24
Mattersburg,7831,6,6,6,12,30,42,-12,24
Vienna,7831,7,6,6,12,25,40,-15,24
FC Salzburg,7832,1,15,7,2,45,15,30,52
SK Sturm Gra,7832,2,13,4,7,34,28,6,43
LASK Linz,7832,3,9,7,8,32,29,3,34
Rapid Vienna,7832,4,8,9,7,34,31,3,33
Vienna,7832,5,7,5,12,25,41,-16,26
Mattersburg,7832,6,6,6,12,32,43,-11,24
SC Rheindorf,7832,7,4,6,14,18,33,-15,18
FC Salzburg,7833,1,14,7,3,43,18,25,49
SK Sturm Gra,7833,2,12,4,8,33,29,4,40
Rapid Vienna,7833,3,8,12,4,34,25,9,36
Mattersburg,7833,4,9,5,10,33,38,-5,32
LASK Linz,7833,5,7,7,10,24,29,-5,28
Vienna,7833,6,6,5,13,23,40,-17,23
SC Rheindorf,7833,7,5,6,13,20,31,-11,21
FC Salzburg,7834,1,13,9,2,48,20,28,48
SK Sturm Gra,7834,2,12,6,6,31,26,5,42
Rapid Vienna,7834,3,7,13,4,35,27,8,34
LASK Linz,7834,4,9,6,9,28,27,1,33
Vienna,7834,5,7,6,11,27,39,-12,27
Mattersburg,7834,6,5,6,13,28,47,-19,21
SC Rheindorf,7834,7,4,8,12,18,29,-11,20
FC Salzburg,7835,1,15,7,2,46,16,30,52
SK Sturm Gra,7835,2,13,3,8,35,30,5,42
LASK Linz,7835,3,9,5,10,28,27,1,32
Rapid Vienna,7835,4,7,9,8,33,35,-2,30
SC Rheindorf,7835,5,7,6,11,23,30,-7,27
Mattersburg,7835,6,6,6,12,30,41,-11,24
Vienna,7835,7,6,6,12,23,39,-16,24
FC Salzburg,7836,1,15,6,3,47,20,27,51
Rapid Vienna,7836,2,10,10,4,40,25,15,40
SK Sturm Gra,7836,3,11,3,10,29,33,-4,36
LASK Linz,7836,4,9,7,8,27,24,3,34
Mattersburg,7836,5,6,6,12,29,42,-13,24
Vienna,7836,6,6,6,12,25,42,-17,24
SC Rheindorf,7836,7,5,6,13,16,27,-11,21
FC Salzburg,7837,1,15,6,3,47,21,26,51
SK Sturm Gra,7837,2,12,4,8,32,29,3,40
LASK Linz,7837,3,9,5,10,26,29,-3,32
Rapid Vienna,7837,4,7,10,7,33,31,2,31
Vienna,7837,5,7,6,11,26,39,-13,27
SC Rheindorf,7837,6,7,5,12,23,27,-4,26
Mattersburg,7837,7,6,6,12,29,40,-11,24
FC Salzburg,7838,1,14,7,3,49,20,29,49
Rapid Vienna,7838,2,10,9,5,40,30,10,39
SK Sturm Gra,7838,3,11,4,9,35,38,-3,37
LASK Linz,7838,4,8,7,9,29,32,-3,31
Vienna,7838,5,8,5,11,27,39,-12,29
Mattersburg,7838,6,6,7,11,30,40,-10,25
SC Rheindorf,7838,7,5,5,14,20,31,-11,20
FC Salzburg,7839,1,14,6,4,45,18,27,48
SK Sturm Gra,7839,2,14,3,7,33,28,5,45
Rapid Vienna,7839,3,9,10,5,35,27,8,37
LASK Linz,7839,4,7,6,11,26,31,-5,27
SC Rheindorf,7839,5,7,5,12,23,29,-6,26
Vienna,7839,6,7,5,12,27,40,-13,26
Mattersburg,7839,7,6,5,13,31,47,-16,23
FC Salzburg,7840,1,15,7,2,46,18,28,52
SK Sturm Gra,7840,2,12,5,7,32,28,4,41
Rapid Vienna,7840,3,8,9,7,35,28,7,33
LASK Linz,7840,4,8,7,9,29,31,-2,31
Mattersburg,7840,5,7,6,11,32,42,-10,27
Vienna,7840,6,6,7,11,25,39,-14,25
SC Rheindorf,7840,7,4,7,13,19,32,-13,19
FC Salzburg,7841,1,13,7,4,45,21,24,46
SK Sturm Gra,7841,2,13,3,8,34,31,3,42
Rapid Vienna,7841,3,9,11,4,38,26,12,38
LASK Linz,7841,4,9,7,8,27,26,1,34
Vienna,7841,5,8,5,11,26,37,-11,29
Mattersburg,7841,6,5,6,13,27,43,-16,21
SC Rheindorf,7841,7,4,7,13,17,30,-13,19
FC Salzburg,7842,1,13,9,2,46,21,25,48
SK Sturm Gra,7842,2,12,5,7,32,28,4,41
Rapid Vienna,7842,3,10,10,4,36,24,12,40
LASK Linz,7842,4,7,7,10,28,33,-5,28
Vienna,7842,5,7,5,12,27,42,-15,26
Mattersburg,7842,6,5,8,11,33,44,-11,23
SC Rheindorf,7842,7,5,6,13,19,29,-10,21
SK Sturm Gra,7843,1,15,3,6,37,28,9,48
FC Salzburg,7843,2,13,7,4,42,20,22,46
Rapid Vienna,7843,3,8,9,7,37,32,5,33
LASK Linz,7843,4,8,6,10,29,31,-2,30
Mattersburg,7843,5,7,7,10,33,38,-5,28
Vienna,7843,6,7,5,12,25,41,-16,26
SC Rheindorf,7843,7,5,5,14,19,32,-13,20
FC Salzburg,7844,1,14,6,4,44,23,21,48
SK Sturm Gra,7844,2,12,4,8,30,27,3,40
Rapid Vienna,7844,3,9,11,4,37,24,13,38
LASK Linz,7844,4,9,5,10,28,28,0,32
Mattersburg,7844,5,8,5,11,37,42,-5,29
Vienna,7844,6,6,5,13,24,42,-18,23
SC Rheindorf,7844,7,5,6,13,18,32,-14,21
FC Salzburg,7845,1,12,10,2,46,23,23,46
SK Sturm Gra,7845,2,13,5,6,34,28,6,44
Rapid Vienna,7845,3,8,10,6,35,28,7,34
LASK Linz,7845,4,8,6,10,29,31,-2,30
Vienna,7845,5,7,6,11,30,41,-11,27
Mattersburg,7845,6,6,6,12,34,47,-13,24
SC Rheindorf,7845,7,5,7,12,21,31,-10,22
FC Salzburg,7846,1,14,7,3,46,21,25,49
SK Sturm Gra,7846,2,13,3,8,35,30,5,42
Rapid Vienna,7846,3,10,9,5,38,30,8,39
Mattersburg,7846,4,7,7,10,34,39,-5,28
LASK Linz,7846,5,7,5,12,25,35,-10,26
Vienna,7846,6,6,6,12,24,39,-15,24
SC Rheindorf,7846,7,6,5,13,22,30,-8,23
FC Salzburg,7847,1,14,7,3,43,18,25,49
SK Sturm Gra,7847,2,13,5,6,36,28,8,44
Rapid Vienna,7847,3,8,10,6,35,29,6,34
LASK Linz,7847,4,8,6,10,28,30,-2,30
Vienna,7847,5,7,6,11,27,39,-12,27
SC Rheindorf,7847,6,6,6,12,21,31,-10,24
Mattersburg,7847,7,5,6,13,28,43,-15,21
FC Salzburg,7848,1,16,6,2,45,15,30,54
SK Sturm Gra,7848,2,13,3,8,34,32,2,42
Rapid Vienna,7848,3,10,9,5,38,26,12,39
LASK Linz,7848,4,7,6,11,25,30,-5,27
Mattersburg,7848,5,7,6,11,31,38,-7,27
Vienna,7848,6,6,5,13,23,40,-17,23
SC Rheindorf,7848,7,5,5,14,19,34,-15,20
FC Salzburg,7849,1,15,7,2,44,16,28,52
SK Sturm Gra,7849,2,12,5,7,34,29,5,41
Rapid Vienna,7849,3,8,11,5,36,28,8,35
LASK Linz,7849,4,9,5,10,29,31,-2,32
Vienna,7849,5,7,5,12,25,40,-15,26
Mattersburg,7849,6,6,5,13,29,41,-12,23
SC Rheindorf,7849,7,5,6,13,19,31,-12,21
FC Salzburg,7850,1,13,8,3,44,21,23,47
SK Sturm Gra,7850,2,13,5,6,34,27,7,44
Rapid Vienna,7850,3,8,11,5,34,26,8,35
LASK Linz,7850,4,8,7,9,28,28,0,31
Vienna,7850,5,7,6,11,28,41,-13,27
Mattersburg,7850,6,5,8,11,30,41,-11,23
SC Rheindorf,7850,7,4,7,13,17,31,-14,19
FC Salzburg,7851,1,14,8,2,43,17,26,50
SK Sturm Gra,7851,2,12,4,8,33,30,3,40
Rapid Vienna,7851,3,8,10,6,33,26,7,34
LASK Linz,7851,4,9,6,9,29,30,-1,33
Vienna,7851,5,7,5,12,27,41,-14,26
Mattersburg,7851,6,6,7,11,32,42,-10,25
SC Rheindorf,7851,7,4,8,12,18,29,-11,20
FC Salzburg,7852,1,16,6,2,48,18,30,54
SK Sturm Gra,7852,2,12,4,8,34,33,1,40
Rapid Vienna,7852,3,7,12,5,40,34,6,33
LASK Linz,7852,4,8,6,10,30,30,0,30
Mattersburg,7852,5,7,5,12,30,40,-10,26
Vienna,7852,6,7,5,12,25,40,-15,26
SC Rheindorf,7852,7,5,6,13,21,33,-12,21
FC Salzburg,7853,1,14,6,4,44,22,22,48
Rapid Vienna,7853,2,10,10,4,43,25,18,40
SK Sturm Gra,7853,3,11,6,7,31,28,3,39
LASK Linz,7853,4,7,8,9,25,28,-3,29
Vienna,7853,5,8,5,11,26,38,-12,29
Mattersburg,7853,6,6,6,12,30,42,-12,24
SC Rheindorf,7853,7,4,7,13,17,33,-16,19
SK Sturm Gra,7854,1,14,4,6,36,27,9,46
FC Salzburg,7854,2,12,7,5,39,21,18,43
Rapid Vienna,7854,3,9,10,5,36,27,9,37
LASK Linz,7854,4,10,5,9,29,26,3,35
Vienna,7854,5,7,6,11,26,38,-12,27
Mattersburg,7854,6,5,7,12,29,43,-14,22
SC Rheindorf,7854,7,5,5,14,20,33,-13,20
FC Salzburg,7855,1,16,6,2,49,17,32,54
SK Sturm Gra,7855,2,12,4,8,32,31,1,40
Rapid Vienna,7855,3,8,10,6,34,29,5,34
LASK Linz,7855,4,8,6,10,28,30,-2,30
Vienna,7855,5,7,5,12,27,41,-14,26
Mattersburg,7855,6,6,6,12,33,42,-9,24
SC Rheindorf,7855,7,5,7,12,18,31,-13,22
FC Salzburg,7856,1,14,7,3,41,16,25,49
SK Sturm Gra,7856,2,12,4,8,33,30,3,40
Rapid Vienna,7856,3,9,11,4,37,25,12,38
LASK Linz,7856,4,9,6,9,30,28,2,33
Mattersburg,7856,5,6,7,11,32,44,-12,25
Vienna,7856,6,6,6,12,26,42,-16,24
SC Rheindorf,7856,7,4,7,13,20,34,-14,19
FC Salzburg,7857,1,14,7,3,44,18,26,49
SK Sturm Gra,7857,2,12,6,6,35,30,5,42
Rapid Vienna,7857,3,9,11,4,38,27,11,38
LASK Linz,7857,4,9,6,9,30,29,1,33
Vienna,7857,5,7,5,12,25,40,-15,26
SC Rheindorf,7857,6,5,6,13,21,31,-10,21
Mattersburg,7857,7,5,5,14,29,47,-18,20
FC Salzburg,7858,1,14,6,4,44,18,26,48
SK Sturm Gra,7858,2,12,4,8,30,28,2,40
Rapid Vienna,7858,3,8,11,5,34,28,6,35
LASK Linz,7858,4,9,5,10,29,28,1,32
SC Rheindorf,7858,5,7,6,11,21,27,-6,27
Vienna,7858,6,7,5,12,24,38,-14,26
Mattersburg,7858,7,6,5,13,30,45,-15,23
FC Salzburg,7859,1,14,7,3,42,17,25,49
Rapid Vienna,7859,2,9,11,4,38,28,10,38
SK Sturm Gra,7859,3,11,5,8,32,31,1,38
LASK Linz,7859,4,7,7,10,25,30,-5,28
Mattersburg,7859,5,7,6,11,30,40,-10,27
SC Rheindorf,7859,6,6,7,11,22,27,-5,25
Vienna,7859,7,6,5,13,23,39,-16,23
FC Salzburg,7860,1,14,8,2,49,17,32,50
SK Sturm Gra,7860,2,12,5,7,32,28,4,41
Rapid Vienna,7860,3,8,11,5,32,26,6,35
LASK Linz,7860,4,9,6,9,27,25,2,33
Vienna,7860,5,7,6,11,25,38,-13,27
Mattersburg,7860,6,5,6,13,29,48,-19,21
SC Rheindorf,7860,7,4,8,12,18,30,-12,20
FC Salzburg,7861,1,15,6,3,47,21,26,51
SK Sturm Gra,7861,2,13,3,8,34,29,5,42
Rapid Vienna,7861,3,8,10,6,36,28,8,34
LASK Linz,7861,4,9,7,8,27,25,2,34
Vienna,7861,5,7,5,12,27,42,-15,26
Mattersburg,7861,6,6,6,12,29,42,-13,24
SC Rheindorf,7861,7,5,5,14,20,33,-13,20
FC Salzburg,7862,1,15,7,2,51,19,32,52
SK Sturm Gra,7862,2,12,5,7,32,29,3,41
Rapid Vienna,7862,3,8,10,6,39,35,4,34
LASK Linz,7862,4,9,7,8,32,30,2,34
Vienna,7862,5,7,5,12,26,41,-15,26
SC Rheindorf,7862,6,5,6,13,21,32,-11,21
Mattersburg,7862,7,5,6,13,29,44,-15,21
FC Salzburg,7863,1,14,8,2,46,20,26,50
SK Sturm Gra,7863,2,14,4,6,35,28,7,46
Rapid Vienna,7863,3,9,10,5,38,28,10,37
LASK Linz,7863,4,7,5,12,25,30,-5,26
Vienna,7863,5,7,5,12,28,41,-13,26
SC Rheindorf,7863,6,6,5,13,18,29,-11,23
Mattersburg,7863,7,6,5,13,30,44,-14,23
FC Salzburg,7864,1,15,7,2,43,17,26,52
SK Sturm Gra,7864,2,11,5,8,31,29,2,38
Rapid Vienna,7864,3,8,11,5,34,26,8,35
LASK Linz,7864,4,9,7,8,30,29,1,34
SC Rheindorf,7864,5,6,6,12,22,29,-7,24
Mattersburg,7864,6,6,5,13,32,46,-14,23
Vienna,7864,7,6,5,13,25,41,-16,23
FC Salzburg,7865,1,13,6,5,42,22,20,45
SK Sturm Gra,7865,2,14,3,7,34,25,9,45
Rapid Vienna,7865,3,10,9,5,39,27,12,39
LASK Linz,7865,4,8,6,10,24,30,-6,30
Vienna,7865,5,7,6,11,26,38,-12,27
Mattersburg,7865,6,6,7,11,31,40,-9,25
SC Rheindorf,7865,7,5,5,14,17,31,-14,20
FC Salzburg,7866,1,13,6,5,48,25,23,45
SK Sturm Gra,7866,2,12,4,8,33,33,0,40
Rapid Vienna,7866,3,9,10,5,36,28,8,37
LASK Linz,7866,4,8,8,8,28,27,1,32
Vienna,7866,5,8,5,11,27,39,-12,29
SC Rheindorf,7866,6,6,6,12,24,28,-4,24
Mattersburg,7866,7,6,5,13,28,44,-16,23
FC Salzburg,7867,1,15,7,2,47,16,31,52
SK Sturm Gra,7867,2,13,3,8,34,29,5,42
Rapid Vienna,7867,3,9,9,6,34,27,7,36
LASK Linz,7867,4,8,6,10,25,30,-5,30
Mattersburg,7867,5,7,6,11,34,41,-7,27
Vienna,7867,6,6,6,12,24,43,-19,24
SC Rheindorf,7867,7,5,5,14,18,30,-12,20
SK Sturm Gra,7868,1,14,4,6,35,24,11,46
FC Salzburg,7868,2,13,6,5,44,25,19,45
Rapid Vienna,7868,3,9,9,6,39,31,8,36
LASK Linz,7868,4,8,6,10,29,30,-1,30
Mattersburg,7868,5,8,5,11,32,41,-9,29
Vienna,7868,6,7,5,12,25,39,-14,26
SC Rheindorf,7868,7,5,5,14,16,30,-14,20
SK Sturm Gra,7869,1,14,4,6,37,27,10,46
FC Salzburg,7869,2,12,7,5,40,22,18,43
Rapid Vienna,7869,3,9,10,5,38,28,10,37
LASK Linz,7869,4,9,5,10,29,31,-2,32
Vienna,7869,5,8,5,11,26,37,-11,29
SC Rheindorf,7869,6,6,5,13,20,31,-11,23
Mattersburg,7869,7,5,6,13,30,44,-14,21
FC Salzburg,7870,1,15,6,3,48,20,28,51
SK Sturm Gra,7870,2,14,3,7,33,27,6,45
Rapid Vienna,7870,3,10,9,5,39,25,14,39
LASK Linz,7870,4,7,5,12,25,33,-8,26
Mattersburg,7870,5,7,5,12,30,42,-12,26
Vienna,7870,6,7,5,12,24,41,-17,26
SC Rheindorf,7870,7,5,5,14,19,30,-11,20
FC Salzburg,7871,1,15,6,3,47,20,27,51
SK Sturm Gra,7871,2,12,4,8,32,31,1,40
Rapid Vienna,7871,3,8,10,6,34,28,6,34
SC Rheindorf,7871,4,8,5,11,21,25,-4,29
LASK Linz,7871,5,7,5,12,26,33,-7,26
Mattersburg,7871,6,7,5,12,31,41,-10,26
Vienna,7871,7,7,5,12,27,40,-13,26
FC Salzburg,7872,1,14,7,3,46,19,27,49
Rapid Vienna,7872,2,10,10,4,40,27,13,40
SK Sturm Gra,7872,3,11,6,7,30,27,3,39
LASK Linz,7872,4,9,6,9,28,28,0,33
Mattersburg,7872,5,7,6,11,31,41,-10,27
Vienna,7872,6,6,5,13,25,43,-18,23
SC Rheindorf,7872,7,4,6,14,16,31,-15,18
FC Salzburg,7873,1,15,6,3,43,16,27,51
SK Sturm Gra,7873,2,12,3,9,30,30,0,39
Rapid Vienna,7873,3,9,9,6,34,29,5,36
LASK Linz,7873,4,10,6,8,32,27,5,36
Vienna,7873,5,8,5,11,27,37,-10,29
SC Rheindorf,7873,6,5,6,13,21,30,-9,21
Mattersburg,7873,7,5,5,14,28,46,-18,20
FC Salzburg,7874,1,14,8,2,45,15,30,50
SK Sturm Gra,7874,2,11,4,9,31,32,-1,37
LASK Linz,7874,3,10,6,8,31,27,4,36
Rapid Vienna,7874,4,7,11,6,35,34,1,32
Vienna,7874,5,6,7,11,23,37,-14,25
SC Rheindorf,7874,6,6,6,12,20,27,-7,24
Mattersburg,7874,7,5,8,11,27,40,-13,23
FC Salzburg,7875,1,15,7,2,46,18,28,52
SK Sturm Gra,7875,2,12,5,7,32,29,3,41
Rapid Vienna,7875,3,7,12,5,32,26,6,33
LASK Linz,7875,4,8,6,10,25,29,-4,30
Vienna,7875,5,7,5,12,26,40,-14,26
SC Rheindorf,7875,6,5,8,11,20,26,-6,23
Mattersburg,7875,7,5,7,12,27,40,-13,22
FC Salzburg,7876,1,14,7,3,42,18,24,49
SK Sturm Gra,7876,2,14,4,6,36,26,10,46
Rapid Vienna,7876,3,8,11,5,35,27,8,35
LASK Linz,7876,4,7,7,10,25,29,-4,28
Mattersburg,7876,5,7,6,11,34,41,-7,27
Vienna,7876,6,6,5,13,24,42,-18,23
SC Rheindorf,7876,7,5,6,13,18,31,-13,21
FC Salzburg,7877,1,14,7,3,44,19,25,49
SK Sturm Gra,7877,2,13,4,7,32,27,5,43
Rapid Vienna,7877,3,10,9,5,36,25,11,39
LASK Linz,7877,4,8,6,10,26,27,-1,30
Vienna,7877,5,7,5,12,25,38,-13,26
SC Rheindorf,7877,6,6,5,13,19,29,-10,23
Mattersburg,7877,7,5,6,13,28,45,-17,21
FC Salzburg,7878,1,13,9,2,41,17,24,48
SK Sturm Gra,7878,2,12,5,7,30,26,4,41
Rapid Vienna,7878,3,8,12,4,39,29,10,36
Mattersburg,7878,4,8,6,10,32,39,-7,30
LASK Linz,7878,5,7,6,11,25,30,-5,27
Vienna,7878,6,6,5,13,24,40,-16,23
SC Rheindorf,7878,7,5,7,12,19,29,-10,22
FC Salzburg,7879,1,14,8,2,51,19,32,50
SK Sturm Gra,7879,2,11,5,8,31,29,2,38
Rapid Vienna,7879,3,9,10,5,40,27,13,37
LASK Linz,7879,4,10,5,9,30,29,1,35
Mattersburg,7879,5,7,6,11,33,44,-11,27
Vienna,7879,6,6,5,13,25,46,-21,23
SC Rheindorf,7879,7,4,7,13,16,32,-16,19
FC Salzburg,7880,1,15,7,2,47,20,27,52
SK Sturm Gra,7880,2,13,5,6,32,26,6,44
Rapid Vienna,7880,3,8,11,5,32,25,7,35
LASK Linz,7880,4,8,6,10,26,27,-1,30
Vienna,7880,5,6,6,12,26,41,-15,24
Mattersburg,7880,6,5,7,12,29,42,-13,22
SC Rheindorf,7880,7,5,6,13,18,29,-11,21
FC Salzburg,7881,1,14,6,4,45,20,25,48
SK Sturm Gra,7881,2,13,3,8,38,33,5,42
LASK Linz,7881,3,10,5,9,29,25,4,35
Rapid Vienna,7881,4,8,10,6,35,32,3,34
Mattersburg,7881,5,7,5,12,33,41,-8,26
Vienna,7881,6,7,5,12,26,41,-15,26
SC Rheindorf,7881,7,5,6,13,23,37,-14,21
FC Salzburg,7882,1,15,7,2,46,18,28,52
SK Sturm Gra,7882,2,12,5,7,32,30,2,41
LASK Linz,7882,3,9,6,9,26,26,0,33
Rapid Vienna,7882,4,7,9,8,31,28,3,30
SC Rheindorf,7882,5,7,6,11,23,27,-4,27
Vienna,7882,6,6,6,12,24,39,-15,24
Mattersburg,7882,7,5,7,12,30,44,-14,22
FC Salzburg,7883,1,15,6,3,48,17,31,51
SK Sturm Gra,7883,2,13,3,8,33,29,4,42
Rapid Vienna,7883,3,8,10,6,34,27,7,34
Vienna,7883,4,8,5,11,26,38,-12,29
LASK Linz,7883,5,7,5,12,24,32,-8,26
SC Rheindorf,7883,6,6,7,11,20,28,-8,25
Mattersburg,7883,7,6,6,12,31,45,-14,24
FC Salzburg,7884,1,15,7,2,51,20,31,52
SK Sturm Gra,7884,2,13,3,8,35,29,6,42
Rapid Vienna,7884,3,7,11,6,34,29,5,32
LASK Linz,7884,4,8,6,10,27,30,-3,30
Mattersburg,7884,5,6,7,11,32,46,-14,25
Vienna,7884,6,6,7,11,27,41,-14,25
SC Rheindorf,7884,7,5,7,12,18,29,-11,22
FC Salzburg,7885,1,16,6,2,46,17,29,54
SK Sturm Gra,7885,2,13,3,8,33,31,2,42
Rapid Vienna,7885,3,8,10,6,36,27,9,34
LASK Linz,7885,4,8,7,9,27,27,0,31
Vienna,7885,5,7,5,12,27,39,-12,26
Mattersburg,7885,6,6,5,13,28,43,-15,23
SC Rheindorf,7885,7,5,6,13,20,33,-13,21
FC Salzburg,7886,1,15,7,2,47,18,29,52
SK Sturm Gra,7886,2,12,4,8,36,32,4,40
Rapid Vienna,7886,3,10,9,5,40,26,14,39
Mattersburg,7886,4,8,5,11,34,43,-9,29
LASK Linz,7886,5,7,7,10,28,33,-5,28
Vienna,7886,6,6,6,12,26,41,-15,24
SC Rheindorf,7886,7,4,6,14,17,35,-18,18
FC Salzburg,7887,1,14,7,3,45,18,27,49
SK Sturm Gra,7887,2,12,5,7,34,30,4,41
Rapid Vienna,7887,3,10,9,5,40,29,11,39
LASK Linz,7887,4,8,6,10,28,32,-4,30
Mattersburg,7887,5,7,5,12,32,43,-11,26
Vienna,7887,6,6,6,12,25,40,-15,24
SC Rheindorf,7887,7,5,6,13,19,31,-12,21
FC Salzburg,7888,1,15,7,2,47,18,29,52
SK Sturm Gra,7888,2,12,4,8,33,32,1,40
Rapid Vienna,7888,3,9,9,6,35,27,8,36
LASK Linz,7888,4,9,6,9,28,28,0,33
Vienna,7888,5,7,6,11,30,39,-9,27
Mattersburg,7888,6,6,5,13,30,48,-18,23
SC Rheindorf,7888,7,5,5,14,20,31,-11,20
FC Salzburg,7889,1,15,6,3,51,23,28,51
SK Sturm Gra,7889,2,12,3,9,30,30,0,39
Rapid Vienna,7889,3,8,9,7,33,28,5,33
LASK Linz,7889,4,9,5,10,25,29,-4,32
Vienna,7889,5,8,5,11,28,38,-10,29
SC Rheindorf,7889,6,6,6,12,19,28,-9,24
Mattersburg,7889,7,6,6,12,35,45,-10,24
FC Salzburg,7890,1,16,6,2,46,17,29,54
SK Sturm Gra,7890,2,12,4,8,31,29,2,40
LASK Linz,7890,3,9,7,8,30,26,4,34
Rapid Vienna,7890,4,7,10,7,33,29,4,31
Vienna,7890,5,7,5,12,28,39,-11,26
Mattersburg,7890,6,6,5,13,31,45,-14,23
SC Rheindorf,7890,7,6,5,13,19,33,-14,23
FC Salzburg,7891,1,15,6,3,44,16,28,51
SK Sturm Gra,7891,2,14,3,7,35,27,8,45
Rapid Vienna,7891,3,7,11,6,32,28,4,32
LASK Linz,7891,4,8,7,9,27,28,-1,31
Vienna,7891,5,8,5,11,27,39,-12,29
Mattersburg,7891,6,5,7,12,29,42,-13,22
SC Rheindorf,7891,7,4,7,13,15,29,-14,19
FC Salzburg,7892,1,16,6,2,52,19,33,54
SK Sturm Gra,7892,2,13,4,7,37,30,7,43
Rapid Vienna,7892,3,8,11,5,35,29,6,35
LASK Linz,7892,4,8,7,9,26,27,-1,31
Vienna,7892,5,7,5,12,26,41,-15,26
SC Rheindorf,7892,6,5,6,13,21,31,-10,21
Mattersburg,7892,7,5,5,14,29,49,-20,20
FC Salzburg,7893,1,16,6,2,47,18,29,54
SK Sturm Gra,7893,2,12,4,8,30,27,3,40
Rapid Vienna,7893,3,8,11,5,35,27,8,35
LASK Linz,7893,4,7,5,12,27,33,-6,26
Mattersburg,7893,5,7,5,12,32,43,-11,26
Vienna,7893,6,7,5,12,26,39,-13,26
SC Rheindorf,7893,7,6,6,12,19,29,-10,24
FC Salzburg,7894,1,14,7,3,43,19,24,49
SK Sturm Gra,7894,2,12,4,8,30,28,2,40
LASK Linz,7894,3,10,5,9,27,26,1,35
Rapid Vienna,7894,4,7,10,7,33,28,5,31
SC Rheindorf,7894,5,7,5,12,19,26,-7,26
Mattersburg,7894,6,6,7,11,27,37,-10,25
Vienna,7894,7,6,6,12,24,39,-15,24
FC Salzburg,7895,1,16,6,2,47,18,29,54
SK Sturm Gra,7895,2,12,4,8,31,29,2,40
LASK Linz,7895,3,10,5,9,32,31,1,35
Rapid Vienna,7895,4,8,10,6,35,27,8,34
Mattersburg,7895,5,6,6,12,32,42,-10,24
Vienna,7895,6,6,5,13,23,42,-19,23
SC Rheindorf,7895,7,4,8,12,16,27,-11,20
FC Salzburg,7896,1,13,8,3,43,19,24,47
SK Sturm Gra,7896,2,12,5,7,31,27,4,41
Rapid Vienna,7896,3,8,10,6,35,28,7,34
LASK Linz,7896,4,8,6,10,25,29,-4,30
Vienna,7896,5,7,6,11,25,38,-13,27
SC Rheindorf,7896,6,7,5,12,22,30,-8,26
Mattersburg,7896,7,6,6,12,32,42,-10,24
FC Salzburg,7897,1,14,8,2,41,16,25,50
SK Sturm Gra,7897,2,13,4,7,33,28,5,43
Rapid Vienna,7897,3,8,12,4,35,25,10,36
LASK Linz,7897,4,7,7,10,24,28,-4,28
Vienna,7897,5,7,5,12,26,38,-12,26
Mattersburg,7897,6,6,6,12,28,41,-13,24
SC Rheindorf,7897,7,5,6,13,19,30,-11,21
FC Salzburg,7898,1,14,7,3,49,19,30,49
SK Sturm Gra,7898,2,12,5,7,31,27,4,41
LASK Linz,7898,3,11,5,8,29,26,3,38
Rapid Vienna,7898,4,8,10,6,33,25,8,34
Vienna,7898,5,7,5,12,28,43,-15,26
SC Rheindorf,7898,6,5,6,13,20,31,-11,21
Mattersburg,7898,7,5,6,13,30,49,-19,21
FC Salzburg,7899,1,16,6,2,49,17,32,54
SK Sturm Gra,7899,2,12,3,9,30,30,0,39
Rapid Vienna,7899,3,8,10,6,36,29,7,34
LASK Linz,7899,4,8,6,10,25,28,-3,30
Mattersburg,7899,5,8,5,11,30,40,-10,29
Vienna,7899,6,6,5,13,24,40,-16,23
SC Rheindorf,7899,7,5,7,12,19,29,-10,22
FC Salzburg,7900,1,14,6,4,43,20,23,48
SK Sturm Gra,7900,2,14,3,7,35,28,7,45
Rapid Vienna,7900,3,10,10,4,37,24,13,40
LASK Linz,7900,4,8,6,10,27,30,-3,30
Mattersburg,7900,5,7,6,11,30,39,-9,27
Vienna,7900,6,6,5,13,24,41,-17,23
SC Rheindorf,7900,7,4,6,14,16,30,-14,18
FC Salzburg,7901,1,14,8,2,47,19,28,50
SK Sturm Gra,7901,2,13,3,8,31,28,3,42
Rapid Vienna,7901,3,9,10,5,38,30,8,37
LASK Linz,7901,4,8,5,11,27,34,-7,29
Mattersburg,7901,5,6,7,11,34,40,-6,25
Vienna,7901,6,6,7,11,25,39,-14,25
SC Rheindorf,7901,7,5,6,13,17,29,-12,21
FC Salzburg,7902,1,15,6,3,52,20,32,51
SK Sturm Gra,7902,2,13,3,8,36,32,4,42
Rapid Vienna,7902,3,8,10,6,36,32,4,34
LASK Linz,7902,4,9,5,10,29,28,1,32
Mattersburg,7902,5,7,6,11,30,42,-12,27
Vienna,7902,6,7,5,12,25,39,-14,26
SC Rheindorf,7902,7,4,7,13,19,34,-15,19
FC Salzburg,7903,1,15,6,3,46,19,27,51
SK Sturm Gra,7903,2,12,4,8,31,28,3,40
Rapid Vienna,7903,3,9,10,5,34,25,9,37
LASK Linz,7903,4,9,6,9,29,27,2,33
Vienna,7903,5,7,5,12,27,39,-12,26
SC Rheindorf,7903,6,4,9,11,16,26,-10,21
Mattersburg,7903,7,5,6,13,30,49,-19,21
FC Salzburg,7904,1,15,6,3,43,17,26,51
SK Sturm Gra,7904,2,14,3,7,34,26,8,45
Rapid Vienna,7904,3,8,9,7,34,29,5,33
SC Rheindorf,7904,4,8,5,11,24,27,-3,29
Mattersburg,7904,5,7,5,12,32,41,-9,26
LASK Linz,7904,6,7,5,12,23,32,-9,26
Vienna,7904,7,6,5,13,24,42,-18,23
FC Salzburg,7905,1,14,8,2,44,16,28,50
SK Sturm Gra,7905,2,13,4,7,35,30,5,43
Rapid Vienna,7905,3,9,9,6,39,29,10,36
LASK Linz,7905,4,9,6,9,31,28,3,33
Mattersburg,7905,5,6,8,10,30,39,-9,26
Vienna,7905,6,6,5,13,24,43,-19,23
SC Rheindorf,7905,7,4,6,14,17,35,-18,18
FC Salzburg,7906,1,16,6,2,48,17,31,54
SK Sturm Gra,7906,2,11,3,10,31,34,-3,36
Rapid Vienna,7906,3,8,10,6,34,27,7,34
LASK Linz,7906,4,9,6,9,26,27,-1,33
SC Rheindorf,7906,5,7,5,12,21,30,-9,26
Vienna,7906,6,7,5,12,24,39,-15,26
Mattersburg,7906,7,6,5,13,29,39,-10,23
FC Salzburg,7907,1,14,7,3,44,20,24,49
SK Sturm Gra,7907,2,13,4,7,36,29,7,43
Rapid Vienna,7907,3,8,10,6,37,29,8,34
LASK Linz,7907,4,7,7,10,26,30,-4,28
Mattersburg,7907,5,7,7,10,30,38,-8,28
Vienna,7907,6,7,6,11,24,37,-13,27
SC Rheindorf,7907,7,4,7,13,18,32,-14,19
FC Salzburg,7908,1,15,6,3,49,19,30,51
Rapid Vienna,7908,2,10,10,4,40,26,14,40
SK Sturm Gra,7908,3,12,4,8,30,31,-1,40
LASK Linz,7908,4,8,8,8,29,28,1,32
Mattersburg,7908,5,6,6,12,31,44,-13,24
Vienna,7908,6,6,5,13,23,41,-18,23
SC Rheindorf,7908,7,4,7,13,16,29,-13,19
FC Salzburg,7909,1,14,6,4,43,20,23,48
SK Sturm Gra,7909,2,13,4,7,35,28,7,43
Rapid Vienna,7909,3,9,10,5,36,29,7,37
LASK Linz,7909,4,8,6,10,25,29,-4,30
SC Rheindorf,7909,5,6,6,12,23,28,-5,24
Mattersburg,7909,6,6,6,12,30,42,-12,24
Vienna,7909,7,6,6,12,26,42,-16,24
FC Salzburg,7910,1,16,6,2,47,17,30,54
SK Sturm Gra,7910,2,12,4,8,30,27,3,40
Rapid Vienna,7910,3,8,11,5,38,31,7,35
LASK Linz,7910,4,8,6,10,27,29,-2,30
Mattersburg,7910,5,6,6,12,30,43,-13,24
SC Rheindorf,7910,6,5,8,11,17,26,-9,23
Vienna,7910,7,6,5,13,25,41,-16,23
FC Salzburg,7911,1,15,6,3,48,19,29,51
SK Sturm Gra,7911,2,12,3,9,32,31,1,39
Rapid Vienna,7911,3,9,10,5,38,30,8,37
LASK Linz,7911,4,9,6,9,27,27,0,33
Mattersburg,7911,5,7,6,11,33,44,-11,27
Vienna,7911,6,6,5,13,24,41,-17,23
SC Rheindorf,7911,7,5,6,13,22,32,-10,21
FC Salzburg,7912,1,14,7,3,47,19,28,49
Rapid Vienna,7912,2,9,10,5,37,29,8,37
SK Sturm Gra,7912,3,11,3,10,31,32,-1,36
LASK Linz,7912,4,10,5,9,32,28,4,35
Vienna,7912,5,8,5,11,32,39,-7,29
SC Rheindorf,7912,6,6,5,13,20,30,-10,23
Mattersburg,7912,7,6,5,13,29,51,-22,23
FC Salzburg,7913,1,15,6,3,48,17,31,51
SK Sturm Gra,7913,2,12,4,8,30,30,0,40
Rapid Vienna,7913,3,9,11,4,36,26,10,38
LASK Linz,7913,4,8,7,9,28,29,-1,31
Mattersburg,7913,5,6,6,12,30,40,-10,24
Vienna,7913,6,6,6,12,24,42,-18,24
SC Rheindorf,7913,7,5,6,13,17,29,-12,21
FC Salzburg,7914,1,15,7,2,45,18,27,52
SK Sturm Gra,7914,2,13,4,7,36,28,8,43
LASK Linz,7914,3,9,6,9,29,26,3,33
Rapid Vienna,7914,4,7,11,6,35,30,5,32
Vienna,7914,5,7,6,11,27,38,-11,27
Mattersburg,7914,6,6,5,13,28,43,-15,23
SC Rheindorf,7914,7,5,5,14,17,34,-17,20
FC Salzburg,7915,1,15,6,3,47,18,29,51
SK Sturm Gra,7915,2,13,4,7,32,30,2,43
Rapid Vienna,7915,3,9,10,5,37,25,12,37
LASK Linz,7915,4,7,6,11,24,30,-6,27
SC Rheindorf,7915,5,6,6,12,22,30,-8,24
Mattersburg,7915,6,6,6,12,34,47,-13,24
Vienna,7915,7,6,6,12,25,41,-16,24
FC Salzburg,7916,1,13,9,2,43,16,27,48
SK Sturm Gra,7916,2,11,5,8,31,29,2,38
Rapid Vienna,7916,3,9,10,5,35,26,9,37
LASK Linz,7916,4,9,6,9,28,28,0,33
Vienna,7916,5,7,6,11,25,37,-12,27
Mattersburg,7916,6,7,5,12,29,43,-14,26
SC Rheindorf,7916,7,4,7,13,15,27,-12,19
FC Salzburg,7917,1,14,6,4,44,19,25,48
SK Sturm Gra,7917,2,14,3,7,34,29,5,45
Rapid Vienna,7917,3,9,10,5,35,24,11,37
Vienna,7917,4,8,5,11,26,37,-11,29
LASK Linz,7917,5,7,7,10,24,29,-5,28
Mattersburg,7917,6,6,6,12,30,41,-11,24
SC Rheindorf,7917,7,4,7,13,17,31,-14,19
FC Salzburg,7918,1,16,6,2,47,18,29,54
Rapid Vienna,7918,2,9,10,5,39,28,11,37
SK Sturm Gra,7918,3,11,4,9,32,32,0,37
LASK Linz,7918,4,7,7,10,25,32,-7,28
SC Rheindorf,7918,5,7,5,12,22,28,-6,26
Mattersburg,7918,6,7,5,12,30,41,-11,26
Vienna,7918,7,6,5,13,24,40,-16,23
FC Salzburg,7919,1,16,6,2,48,16,32,54
SK Sturm Gra,7919,2,11,4,9,32,32,0,37
LASK Linz,7919,3,9,5,10,29,32,-3,32
Rapid Vienna,7919,4,7,10,7,36,35,1,31
SC Rheindorf,7919,5,8,5,11,23,26,-3,29
Mattersburg,7919,6,6,6,12,27,39,-12,24
Vienna,7919,7,6,6,12,23,38,-15,24
FC Salzburg,7920,1,13,8,3,44,21,23,47
SK Sturm Gra,7920,2,13,3,8,34,29,5,42
Rapid Vienna,7920,3,10,10,4,38,25,13,40
LASK Linz,7920,4,8,6,10,29,32,-3,30
Vienna,7920,5,7,6,11,31,41,-10,27
Mattersburg,7920,6,6,5,13,33,49,-16,23
SC Rheindorf,7920,7,5,6,13,18,30,-12,21
FC Salzburg,7921,1,15,6,3,45,19,26,51
SK Sturm Gra,7921,2,12,3,9,34,32,2,39
Rapid Vienna,7921,3,9,10,5,37,27,10,37
LASK Linz,7921,4,9,6,9,28,29,-1,33
Vienna,7921,5,7,5,12,25,40,-15,26
SC Rheindorf,7921,6,6,7,11,19,26,-7,25
Mattersburg,7921,7,5,5,14,29,44,-15,20
FC Salzburg,7922,1,15,6,3,48,19,29,51
SK Sturm Gra,7922,2,12,4,8,34,33,1,40
Rapid Vienna,7922,3,8,10,6,37,30,7,34
LASK Linz,7922,4,8,8,8,32,32,0,32
Vienna,7922,5,7,6,11,27,39,-12,27
SC Rheindorf,7922,6,5,7,12,20,30,-10,22
Mattersburg,7922,7,5,7,12,28,43,-15,22
FC Salzburg,7923,1,15,7,2,49,20,29,52
SK Sturm Gra,7923,2,11,5,8,28,29,-1,38
Rapid Vienna,7923,3,7,12,5,33,26,7,33
LASK Linz,7923,4,8,6,10,26,28,-2,30
Mattersburg,7923,5,7,6,11,34,45,-11,27
SC Rheindorf,7923,6,6,7,11,20,26,-6,25
Vienna,7923,7,6,5,13,27,43,-16,23
FC Salzburg,7924,1,15,6,3,43,18,25,51
SK Sturm Gra,7924,2,12,3,9,30,29,1,39
Rapid Vienna,7924,3,9,10,5,34,26,8,37
LASK Linz,7924,4,7,7,10,24,27,-3,28
SC Rheindorf,7924,5,7,5,12,21,28,-7,26
Mattersburg,7924,6,6,7,11,29,38,-9,25
Vienna,7924,7,6,6,12,24,39,-15,24
FC Salzburg,7925,1,15,6,3,43,16,27,51
SK Sturm Gra,7925,2,12,3,9,29,27,2,39
Rapid Vienna,7925,3,8,10,6,34,27,7,34
LASK Linz,7925,4,9,7,8,29,27,2,34
Vienna,7925,5,7,5,12,26,39,-13,26
SC Rheindorf,7925,6,6,6,12,20,29,-9,24
Mattersburg,7925,7,6,5,13,28,44,-16,23
FC Salzburg,7926,1,14,8,2,46,21,25,50
SK Sturm Gra,7926,2,11,6,7,29,27,2,39
Rapid Vienna,7926,3,9,10,5,39,30,9,37
LASK Linz,7926,4,8,8,8,29,28,1,32
Vienna,7926,5,6,6,12,27,42,-15,24
Mattersburg,7926,6,5,8,11,32,43,-11,23
SC Rheindorf,7926,7,4,8,12,19,30,-11,20
FC Salzburg,7927,1,15,7,2,44,16,28,52
SK Sturm Gra,7927,2,12,3,9,30,29,1,39
Rapid Vienna,7927,3,9,9,6,37,27,10,36
LASK Linz,7927,4,9,6,9,33,32,1,33
Mattersburg,7927,5,6,6,12,32,43,-11,24
SC Rheindorf,7927,6,6,6,12,18,30,-12,24
Vienna,7927,7,6,5,13,23,40,-17,23
FC Salzburg,7928,1,16,6,2,47,18,29,54
SK Sturm Gra,7928,2,12,3,9,34,35,-1,39
Rapid Vienna,7928,3,8,9,7,36,30,6,33
LASK Linz,7928,4,9,6,9,26,26,0,33
Vienna,7928,5,7,5,12,27,40,-13,26
SC Rheindorf,7928,6,6,6,12,20,28,-8,24
Mattersburg,7928,7,5,7,12,29,42,-13,22
FC Salzburg,7929,1,15,6,3,44,18,26,51
SK Sturm Gra,7929,2,11,4,9,29,29,0,37
Rapid Vienna,7929,3,8,10,6,34,30,4,34
LASK Linz,7929,4,8,7,9,28,27,1,31
Mattersburg,7929,5,8,5,11,32,39,-7,29
Vienna,7929,6,7,5,12,25,40,-15,26
SC Rheindorf,7929,7,5,7,12,19,28,-9,22
FC Salzburg,7930,1,15,7,2,48,17,31,52
SK Sturm Gra,7930,2,13,3,8,32,30,2,42
LASK Linz,7930,3,10,5,9,29,25,4,35
Rapid Vienna,7930,4,8,10,6,35,30,5,34
Vienna,7930,5,6,6,12,24,40,-16,24
Mattersburg,7930,6,5,7,12,28,42,-14,22
SC Rheindorf,7930,7,5,6,13,18,30,-12,21
FC Salzburg,7931,1,14,7,3,43,18,25,49
SK Sturm Gra,7931,2,12,4,8,30,29,1,40
Rapid Vienna,7931,3,8,10,6,34,28,6,34
LASK Linz,7931,4,8,5,11,25,29,-4,29
Vienna,7931,5,7,6,11,25,38,-13,27
SC Rheindorf,7931,6,7,5,12,22,27,-5,26
Mattersburg,7931,7,7,5,12,32,42,-10,26
FC Salzburg,7932,1,14,6,4,47,20,27,48
Rapid Vienna,7932,2,10,9,5,36,26,10,39
SK Sturm Gra,7932,3,12,3,9,30,32,-2,39
LASK Linz,7932,4,10,5,9,27,25,2,35
Vienna,7932,5,8,5,11,28,39,-11,29
Mattersburg,7932,6,6,5,13,29,42,-13,23
SC Rheindorf,7932,7,5,5,14,19,32,-13,20
FC Salzburg,7933,1,15,7,2,45,18,27,52
SK Sturm Gra,7933,2,13,3,8,33,28,5,42
LASK Linz,7933,3,10,6,8,30,26,4,36
Rapid Vienna,7933,4,7,11,6,33,29,4,32
Mattersburg,7933,5,6,7,11,30,41,-11,25
Vienna,7933,6,6,5,13,25,41,-16,23
SC Rheindorf,7933,7,4,7,13,17,30,-13,19
FC Salzburg,7934,1,15,6,3,44,16,28,51
SK Sturm Gra,7934,2,12,4,8,30,27,3,40
Rapid Vienna,7934,3,9,9,6,35,27,8,36
LASK Linz,7934,4,10,5,9,30,29,1,35
Mattersburg,7934,5,6,6,12,28,42,-14,24
Vienna,7934,6,6,6,12,23,38,-15,24
SC Rheindorf,7934,7,5,6,13,18,29,-11,21
FC Salzburg,7935,1,14,7,3,45,20,25,49
SK Sturm Gra,7935,2,12,3,9,33,34,-1,39
Rapid Vienna,7935,3,8,11,5,35,27,8,35
LASK Linz,7935,4,8,7,9,27,27,0,31
Vienna,7935,5,8,5,11,28,39,-11,29
Mattersburg,7935,6,7,5,12,33,40,-7,26
SC Rheindorf,7935,7,5,6,13,18,32,-14,21
FC Salzburg,7936,1,15,6,3,46,18,28,51
SK Sturm Gra,7936,2,13,4,7,35,28,7,43
Rapid Vienna,7936,3,9,11,4,36,24,12,38
LASK Linz,7936,4,8,5,11,24,29,-5,29
Mattersburg,7936,5,7,6,11,29,41,-12,27
Vienna,7936,6,6,5,13,23,40,-17,23
SC Rheindorf,7936,7,4,7,13,17,30,-13,19
FC Salzburg,7937,1,14,7,3,46,20,26,49
SK Sturm Gra,7937,2,13,4,7,32,28,4,43
Rapid Vienna,7937,3,8,11,5,35,27,8,35
LASK Linz,7937,4,9,5,10,30,30,0,32
Vienna,7937,5,7,5,12,26,41,-15,26
Mattersburg,7937,6,6,6,12,34,45,-11,24
SC Rheindorf,7937,7,4,8,12,17,29,-12,20
FC Salzburg,7938,1,15,7,2,47,18,29,52
SK Sturm Gra,7938,2,12,4,8,32,30,2,40
Rapid Vienna,7938,3,9,11,4,38,26,12,38
LASK Linz,7938,4,7,8,9,26,28,-2,29
Mattersburg,7938,5,7,6,11,31,41,-10,27
Vienna,7938,6,6,5,13,24,41,-17,23
SC Rheindorf,7938,7,4,7,13,15,29,-14,19
FC Salzburg,7939,1,13,8,3,41,18,23,47
SK Sturm Gra,7939,2,12,5,7,33,30,3,41
Rapid Vienna,7939,3,9,9,6,36,30,6,36
LASK Linz,7939,4,8,6,10,30,31,-1,30
Vienna,7939,5,7,6,11,24,37,-13,27
Mattersburg,7939,6,7,5,12,32,42,-10,26
SC Rheindorf,7939,7,6,5,13,20,28,-8,23
SK Sturm Gra,7940,1,14,3,7,36,29,7,45
FC Salzburg,7940,2,12,7,5,40,20,20,43
LASK Linz,7940,3,10,6,8,30,28,2,36
Rapid Vienna,7940,4,8,10,6,34,27,7,34
Vienna,7940,5,7,5,12,24,40,-16,26
Mattersburg,7940,6,6,6,12,31,40,-9,24
SC Rheindorf,7940,7,5,7,12,20,31,-11,22
FC Salzburg,7941,1,14,7,3,45,21,24,49
SK Sturm Gra,7941,2,13,3,8,33,28,5,42
Rapid Vienna,7941,3,8,10,6,37,29,8,34
LASK Linz,7941,4,9,6,9,30,29,1,33
Vienna,7941,5,7,5,12,28,41,-13,26
Mattersburg,7941,6,6,7,11,31,42,-11,25
SC Rheindorf,7941,7,5,6,13,19,33,-14,21
FC Salzburg,7942,1,14,8,2,42,15,27,50
SK Sturm Gra,7942,2,12,5,7,31,29,2,41
Rapid Vienna,7942,3,9,10,5,38,28,10,37
LASK Linz,7942,4,8,6,10,27,29,-2,30
SC Rheindorf,7942,5,6,6,12,22,31,-9,24
Vienna,7942,6,6,6,12,24,39,-15,24
Mattersburg,7942,7,6,5,13,31,44,-13,23
FC Salzburg,7943,1,16,6,2,47,18,29,54
Rapid Vienna,7943,2,9,9,6,36,28,8,36
SK Sturm Gra,7943,3,11,3,10,29,30,-1,36
LASK Linz,7943,4,10,5,9,31,28,3,35
Mattersburg,7943,5,7,6,11,31,41,-10,27
Vienna,7943,6,6,6,12,24,40,-16,24
SC Rheindorf,7943,7,5,5,14,18,31,-13,20
FC Salzburg,7944,1,13,7,4,43,23,20,46
SK Sturm Gra,7944,2,12,5,7,34,28,6,41
Rapid Vienna,7944,3,10,9,5,38,28,10,39
LASK Linz,7944,4,8,6,10,25,30,-5,30
Mattersburg,7944,5,7,7,10,32,37,-5,28
Vienna,7944,6,7,5,12,25,39,-14,26
SC Rheindorf,7944,7,4,7,13,17,29,-12,19
FC Salzburg,7945,1,14,6,4,41,19,22,48
SK Sturm Gra,7945,2,13,3,8,33,29,4,42
Rapid Vienna,7945,3,8,9,7,35,30,5,33
LASK Linz,7945,4,9,5,10,30,32,-2,32
Vienna,7945,5,8,5,11,25,37,-12,29
Mattersburg,7945,6,7,5,12,33,41,-8,26
SC Rheindorf,7945,7,6,5,13,19,28,-9,23
FC Salzburg,7946,1,14,7,3,44,18,26,49
SK Sturm Gra,7946,2,13,4,7,33,27,6,43
Rapid Vienna,7946,3,8,10,6,35,29,6,34
LASK Linz,7946,4,8,6,10,28,30,-2,30
Vienna,7946,5,7,6,11,26,39,-13,27
Mattersburg,7946,6,5,8,11,29,42,-13,23
SC Rheindorf,7946,7,5,7,12,19,29,-10,22
FC Salzburg,7947,1,14,6,4,49,21,28,48
Rapid Vienna,7947,2,10,10,4,41,29,12,40
SK Sturm Gra,7947,3,11,5,8,30,34,-4,38
Vienna,7947,4,8,5,11,25,37,-12,29
LASK Linz,7947,5,7,6,11,26,34,-8,27
Mattersburg,7947,6,7,5,12,31,41,-10,26
SC Rheindorf,7947,7,6,5,13,23,29,-6,23
FC Salzburg,7948,1,14,7,3,47,22,25,49
SK Sturm Gra,7948,2,12,6,6,38,33,5,42
Rapid Vienna,7948,3,9,10,5,42,31,11,37
LASK Linz,7948,4,10,5,9,31,28,3,35
Mattersburg,7948,5,6,6,12,32,43,-11,24
Vienna,7948,6,6,6,12,24,41,-17,24
SC Rheindorf,7948,7,4,6,14,18,34,-16,18
FC Salzburg,7949,1,14,7,3,45,20,25,49
SK Sturm Gra,7949,2,12,5,7,32,27,5,41
Rapid Vienna,7949,3,8,11,5,32,24,8,35
LASK Linz,7949,4,10,5,9,28,26,2,35
SC Rheindorf,7949,5,6,6,12,17,26,-9,24
Mattersburg,7949,6,6,5,13,27,42,-15,23
Vienna,7949,7,6,5,13,25,41,-16,23
FC Salzburg,7950,1,15,6,3,47,17,30,51
SK Sturm Gra,7950,2,12,4,8,31,30,1,40
Rapid Vienna,7950,3,10,9,5,37,25,12,39
LASK Linz,7950,4,7,8,9,27,29,-2,29
Vienna,7950,5,7,5,12,26,42,-16,26
Mattersburg,7950,6,6,7,11,34,45,-11,25
SC Rheindorf,7950,7,4,7,13,17,31,-14,19
FC Salzburg,7951,1,15,7,2,44,16,28,52
SK Sturm Gra,7951,2,13,3,8,35,28,7,42
Rapid Vienna,7951,3,9,9,6,37,30,7,36
LASK Linz,7951,4,7,6,11,27,33,-6,27
Vienna,7951,5,7,6,11,28,38,-10,27
SC Rheindorf,7951,6,6,6,12,21,31,-10,24
Mattersburg,7951,7,6,5,13,30,46,-16,23
FC Salzburg,7952,1,15,7,2,47,18,29,52
SK Sturm Gra,7952,2,11,5,8,34,35,-1,38
Rapid Vienna,7952,3,8,10,6,35,28,7,34
LASK Linz,7952,4,9,5,10,27,32,-5,32
Mattersburg,7952,5,8,5,11,37,38,-1,29
SC Rheindorf,7952,6,6,5,13,23,34,-11,23
Vienna,7952,7,6,5,13,24,42,-18,23
FC Salzburg,7953,1,12,9,3,41,19,22,45
SK Sturm Gra,7953,2,11,7,6,31,27,4,40
Rapid Vienna,7953,3,9,10,5,37,28,9,37
LASK Linz,7953,4,9,6,9,31,30,1,33
Vienna,7953,5,7,6,11,27,39,-12,27
Mattersburg,7953,6,6,7,11,33,44,-11,25
SC Rheindorf,7953,7,4,7,13,19,32,-13,19
FC Salzburg,7954,1,15,6,3,45,19,26,51
SK Sturm Gra,7954,2,12,4,8,33,29,4,40
Rapid Vienna,7954,3,9,9,6,36,29,7,36
LASK Linz,7954,4,8,7,9,29,29,0,31
Vienna,7954,5,7,5,12,25,41,-16,26
Mattersburg,7954,6,6,7,11,32,40,-8,25
SC Rheindorf,7954,7,5,6,13,18,31,-13,21
FC Salzburg,7955,1,15,6,3,51,22,29,51
SK Sturm Gra,7955,2,13,4,7,34,26,8,43
LASK Linz,7955,3,9,7,8,27,26,1,34
Rapid Vienna,7955,4,8,9,7,34,30,4,33
Vienna,7955,5,7,5,12,27,41,-14,26
Mattersburg,7955,6,5,7,12,29,46,-17,22
SC Rheindorf,7955,7,5,6,13,18,29,-11,21
FC Salzburg,7956,1,14,7,3,46,20,26,49
SK Sturm Gra,7956,2,12,5,7,34,29,5,41
Rapid Vienna,7956,3,9,10,5,37,27,10,37
LASK Linz,7956,4,9,5,10,27,30,-3,32
Vienna,7956,5,7,5,12,28,40,-12,26
SC Rheindorf,7956,6,6,6,12,20,29,-9,24
Mattersburg,7956,7,5,6,13,30,47,-17,21
FC Salzburg,7957,1,15,7,2,50,18,32,52
SK Sturm Gra,7957,2,13,4,7,35,29,6,43
Rapid Vienna,7957,3,8,11,5,37,27,10,35
LASK Linz,7957,4,10,5,9,33,28,5,35
Vienna,7957,5,7,5,12,27,40,-13,26
SC Rheindorf,7957,6,5,5,14,21,37,-16,20
Mattersburg,7957,7,5,5,14,31,55,-24,20
FC Salzburg,7958,1,14,8,2,48,17,31,50
SK Sturm Gra,7958,2,12,5,7,34,31,3,41
Rapid Vienna,7958,3,7,9,8,34,34,0,30
LASK Linz,7958,4,8,6,10,29,29,0,30
SC Rheindorf,7958,5,7,6,11,22,28,-6,27
Vienna,7958,6,7,6,11,26,38,-12,27
Mattersburg,7958,7,6,6,12,28,44,-16,24
FC Salzburg,7959,1,14,7,3,43,19,24,49
SK Sturm Gra,7959,2,12,4,8,31,28,3,40
Rapid Vienna,7959,3,9,11,4,36,25,11,38
LASK Linz,7959,4,8,6,10,24,30,-6,30
Vienna,7959,5,7,6,11,26,39,-13,27
Mattersburg,7959,6,6,7,11,32,39,-7,25
SC Rheindorf,7959,7,4,7,13,15,27,-12,19
FC Salzburg,7960,1,16,6,2,49,17,32,54
SK Sturm Gra,7960,2,11,5,8,31,34,-3,38
Rapid Vienna,7960,3,8,10,6,39,32,7,34
LASK Linz,7960,4,9,6,9,31,27,4,33
Vienna,7960,5,7,5,12,25,41,-16,26
Mattersburg,7960,6,6,5,13,28,40,-12,23
SC Rheindorf,7960,7,5,7,12,20,32,-12,22
FC Salzburg,7961,1,15,7,2,47,17,30,52
SK Sturm Gra,7961,2,12,4,8,34,32,2,40
Rapid Vienna,7961,3,9,10,5,39,28,11,37
Mattersburg,7961,4,7,7,10,37,40,-3,28
LASK Linz,7961,5,7,7,10,27,34,-7,28
Vienna,7961,6,6,6,12,25,43,-18,24
SC Rheindorf,7961,7,4,7,13,19,34,-15,19
FC Salzburg,7962,1,16,6,2,47,17,30,54
SK Sturm Gra,7962,2,12,3,9,30,32,-2,39
Rapid Vienna,7962,3,8,10,6,36,30,6,34
LASK Linz,7962,4,8,5,11,28,33,-5,29
SC Rheindorf,7962,5,7,6,11,24,26,-2,27
Vienna,7962,6,7,5,12,26,41,-15,26
Mattersburg,7962,7,6,5,13,30,42,-12,23
FC Salzburg,7963,1,15,7,2,46,16,30,52
SK Sturm Gra,7963,2,13,4,7,33,29,4,43
Rapid Vienna,7963,3,9,10,5,38,27,11,37
Mattersburg,7963,4,8,5,11,33,40,-7,29
LASK Linz,7963,5,7,6,11,26,31,-5,27
Vienna,7963,6,6,5,13,24,41,-17,23
SC Rheindorf,7963,7,4,7,13,17,33,-16,19
FC Salzburg,7964,1,14,7,3,43,19,24,49
SK Sturm Gra,7964,2,12,5,7,34,26,8,41
Rapid Vienna,7964,3,10,9,5,36,26,10,39
LASK Linz,7964,4,8,5,11,26,33,-7,29
SC Rheindorf,7964,5,7,6,11,22,27,-5,27
Vienna,7964,6,7,5,12,27,41,-14,26
Mattersburg,7964,7,5,5,14,29,45,-16,20
FC Salzburg,7965,1,15,6,3,44,18,26,51
SK Sturm Gra,7965,2,12,3,9,35,29,6,39
Rapid Vienna,7965,3,9,9,6,35,32,3,36
LASK Linz,7965,4,8,5,11,27,31,-4,29
Mattersburg,7965,5,8,5,11,30,40,-10,29
SC Rheindorf,7965,6,7,5,12,25,30,-5,26
Vienna,7965,7,6,5,13,24,40,-16,23
FC Salzburg,7966,1,13,7,4,44,22,22,46
SK Sturm Gra,7966,2,12,5,7,32,28,4,41
Rapid Vienna,7966,3,8,11,5,35,26,9,35
LASK Linz,7966,4,9,6,9,28,28,0,33
Vienna,7966,5,6,7,11,25,39,-14,25
SC Rheindorf,7966,6,6,6,12,18,28,-10,24
Mattersburg,7966,7,6,6,12,31,42,-11,24
FC Salzburg,7967,1,14,7,3,42,18,24,49
Rapid Vienna,7967,2,10,10,4,36,25,11,40
SK Sturm Gra,7967,3,12,3,9,31,28,3,39
LASK Linz,7967,4,8,7,9,24,25,-1,31
Mattersburg,7967,5,6,7,11,32,41,-9,25
Vienna,7967,6,6,7,11,26,40,-14,25
SC Rheindorf,7967,7,5,5,14,18,32,-14,20
FC Salzburg,7968,1,16,6,2,48,17,31,54
SK Sturm Gra,7968,2,13,3,8,33,29,4,42
LASK Linz,7968,3,10,5,9,32,28,4,35
Rapid Vienna,7968,4,7,9,8,32,30,2,30
SC Rheindorf,7968,5,7,5,12,23,31,-8,26
Vienna,7968,6,6,6,12,24,40,-16,24
Mattersburg,7968,7,5,6,13,30,47,-17,21
FC Salzburg,7969,1,15,7,2,50,19,31,52
SK Sturm Gra,7969,2,13,4,7,34,29,5,43
Rapid Vienna,7969,3,8,12,4,38,29,9,36
LASK Linz,7969,4,8,7,9,28,28,0,31
Vienna,7969,5,7,5,12,28,40,-12,26
Mattersburg,7969,6,6,6,12,29,45,-16,24
SC Rheindorf,7969,7,4,5,15,16,33,-17,17
FC Salzburg,7970,1,16,6,2,49,16,33,54
SK Sturm Gra,7970,2,12,3,9,32,31,1,39
Rapid Vienna,7970,3,8,10,6,33,28,5,34
LASK Linz,7970,4,8,6,10,27,31,-4,30
Mattersburg,7970,5,7,6,11,34,45,-11,27
SC Rheindorf,7970,6,5,8,11,22,29,-7,23
Vienna,7970,7,6,5,13,23,40,-17,23
FC Salzburg,7971,1,14,7,3,46,20,26,49
SK Sturm Gra,7971,2,11,5,8,31,32,-1,38
Rapid Vienna,7971,3,8,11,5,36,27,9,35
LASK Linz,7971,4,9,7,8,28,27,1,34
SC Rheindorf,7971,5,6,7,11,19,26,-7,25
Vienna,7971,6,6,6,12,25,41,-16,24
Mattersburg,7971,7,5,7,12,31,43,-12,22
FC Salzburg,7972,1,13,8,3,43,20,23,47
SK Sturm Gra,7972,2,11,3,10,30,31,-1,36
Rapid Vienna,7972,3,8,11,5,33,27,6,35
LASK Linz,7972,4,10,5,9,29,26,3,35
Mattersburg,7972,5,8,6,10,34,39,-5,30
Vienna,7972,6,7,5,12,25,39,-14,26
SC Rheindorf,7972,7,5,6,13,21,33,-12,21
FC Salzburg,7973,1,13,8,3,41,18,23,47
SK Sturm Gra,7973,2,12,5,7,30,27,3,41
Rapid Vienna,7973,3,8,10,6,33,26,7,34
LASK Linz,7973,4,8,7,9,26,26,0,31
SC Rheindorf,7973,5,7,6,11,20,25,-5,27
Vienna,7973,6,7,6,11,24,37,-13,27
Mattersburg,7973,7,5,6,13,27,42,-15,21
FC Salzburg,7974,1,15,7,2,45,17,28,52
Rapid Vienna,7974,2,10,9,5,35,25,10,39
SK Sturm Gra,7974,3,11,4,9,28,28,0,37
LASK Linz,7974,4,9,6,9,27,26,1,33
Vienna,7974,5,6,6,12,26,41,-15,24
SC Rheindorf,7974,6,6,5,13,21,29,-8,23
Mattersburg,7974,7,6,5,13,30,46,-16,23
FC Salzburg,7975,1,15,7,2,50,18,32,52
SK Sturm Gra,7975,2,14,3,7,35,27,8,45
Rapid Vienna,7975,3,7,12,5,31,25,6,33
LASK Linz,7975,4,8,6,10,24,30,-6,30
Mattersburg,7975,5,7,5,12,35,46,-11,26
Vienna,7975,6,7,5,12,29,41,-12,26
SC Rheindorf,7975,7,4,6,14,15,32,-17,18
FC Salzburg,7976,1,14,7,3,51,21,30,49
SK Sturm Gra,7976,2,12,3,9,30,32,-2,39
Rapid Vienna,7976,3,9,10,5,37,29,8,37
LASK Linz,7976,4,9,7,8,27,26,1,34
Mattersburg,7976,5,6,8,10,30,39,-9,26
Vienna,7976,6,6,5,13,26,44,-18,23
SC Rheindorf,7976,7,5,6,13,17,27,-10,21
FC Salzburg,7977,1,13,9,2,40,16,24,48
SK Sturm Gra,7977,2,11,5,8,30,32,-2,38
LASK Linz,7977,3,9,6,9,28,28,0,33
Rapid Vienna,7977,4,7,11,6,35,29,6,32
Mattersburg,7977,5,7,7,10,33,39,-6,28
Vienna,7977,6,6,7,11,23,37,-14,25
SC Rheindorf,7977,7,5,7,12,21,29,-8,22
FC Salzburg,7978,1,16,6,2,47,18,29,54
SK Sturm Gra,7978,2,12,5,7,31,27,4,41
Rapid Vienna,7978,3,9,9,6,37,28,9,36
LASK Linz,7978,4,7,7,10,26,33,-7,28
Mattersburg,7978,5,7,6,11,32,42,-10,27
Vienna,7978,6,6,5,13,25,41,-16,23
SC Rheindorf,7978,7,5,6,13,20,29,-9,21
FC Salzburg,7979,1,16,6,2,47,16,31,54
SK Sturm Gra,7979,2,12,4,8,31,27,4,40
Rapid Vienna,7979,3,9,9,6,33,27,6,36
LASK Linz,7979,4,8,7,9,26,26,0,31
Vienna,7979,5,7,5,12,26,42,-16,26
Mattersburg,7979,6,5,7,12,31,45,-14,22
SC Rheindorf,7979,7,5,6,13,18,29,-11,21
FC Salzburg,7980,1,13,7,4,39,19,20,46
SK Sturm Gra,7980,2,13,4,7,33,28,5,43
Rapid Vienna,7980,3,8,11,5,37,28,9,35
LASK Linz,7980,4,8,6,10,26,28,-2,30
Vienna,7980,5,8,5,11,26,37,-11,29
SC Rheindorf,7980,6,6,6,12,18,27,-9,24
Mattersburg,7980,7,6,5,13,27,39,-12,23
FC Salzburg,7981,1,15,7,2,48,18,30,52
SK Sturm Gra,7981,2,11,4,9,29,31,-2,37
LASK Linz,7981,3,9,7,8,30,25,5,34
Rapid Vienna,7981,4,7,11,6,31,30,1,32
Mattersburg,7981,5,6,7,11,29,40,-11,25
Vienna,7981,6,6,7,11,26,40,-14,25
SC Rheindorf,7981,7,5,7,12,19,28,-9,22
FC Salzburg,7982,1,15,7,2,47,15,32,52
SK Sturm Gra,7982,2,12,5,7,30,26,4,41
Rapid Vienna,7982,3,8,12,4,34,25,9,36
LASK Linz,7982,4,7,7,10,24,27,-3,28
Mattersburg,7982,5,7,5,12,29,43,-14,26
Vienna,7982,6,7,5,12,25,40,-15,26
SC Rheindorf,7982,7,5,5,14,18,31,-13,20
FC Salzburg,7983,1,13,6,5,44,21,23,45
SK Sturm Gra,7983,2,13,3,8,33,33,0,42
Rapid Vienna,7983,3,9,10,5,36,27,9,37
LASK Linz,7983,4,8,5,11,26,30,-4,29
Vienna,7983,5,8,5,11,26,38,-12,29
SC Rheindorf,7983,6,6,7,11,25,28,-3,25
Mattersburg,7983,7,6,6,12,28,41,-13,24
FC Salzburg,7984,1,15,7,2,51,19,32,52
SK Sturm Gra,7984,2,13,5,6,33,27,6,44
Rapid Vienna,7984,3,8,10,6,36,33,3,34
LASK Linz,7984,4,9,6,9,29,26,3,33
Mattersburg,7984,5,6,6,12,30,43,-13,24
Vienna,7984,6,6,5,13,27,43,-16,23
SC Rheindorf,7984,7,4,7,13,18,33,-15,19
FC Salzburg,7985,1,14,7,3,46,22,24,49
Rapid Vienna,7985,2,9,11,4,37,26,11,38
SK Sturm Gra,7985,3,11,3,10,28,31,-3,36
LASK Linz,7985,4,9,6,9,29,28,1,33
Mattersburg,7985,5,7,5,12,34,41,-7,26
Vienna,7985,6,7,5,12,27,41,-14,26
SC Rheindorf,7985,7,6,5,13,18,30,-12,23
FC Salzburg,7986,1,13,9,2,45,21,24,48
SK Sturm Gra,7986,2,13,3,8,33,28,5,42
Rapid Vienna,7986,3,9,10,5,39,28,11,37
LASK Linz,7986,4,9,5,10,30,32,-2,32
Mattersburg,7986,5,7,7,10,35,41,-6,28
Vienna,7986,6,6,6,12,28,44,-16,24
SC Rheindorf,7986,7,4,6,14,18,34,-16,18
FC Salzburg,7987,1,15,7,2,47,17,30,52
SK Sturm Gra,7987,2,13,3,8,34,28,6,42
Rapid Vienna,7987,3,8,10,6,33,30,3,34
LASK Linz,7987,4,7,7,10,25,28,-3,28
Vienna,7987,5,7,6,11,28,40,-12,27
Mattersburg,7987,6,6,6,12,33,46,-13,24
SC Rheindorf,7987,7,5,7,12,20,31,-11,22
FC Salzburg,7988,1,16,6,2,48,18,30,54
SK Sturm Gra,7988,2,12,4,8,35,30,5,40
Rapid Vienna,7988,3,8,11,5,37,29,8,35
Mattersburg,7988,4,7,6,11,29,38,-9,27
LASK Linz,7988,5,7,6,11,25,35,-10,27
SC Rheindorf,7988,6,6,6,12,20,27,-7,24
Vienna,7988,7,6,5,13,24,41,-17,23
FC Salzburg,7989,1,14,7,3,44,18,26,49
SK Sturm Gra,7989,2,12,5,7,36,32,4,41
Rapid Vienna,7989,3,9,11,4,41,30,11,38
LASK Linz,7989,4,7,7,10,26,31,-5,28
SC Rheindorf,7989,5,6,7,11,21,28,-7,25
Vienna,7989,6,6,6,12,23,39,-16,24
Mattersburg,7989,7,5,7,12,27,40,-13,22
FC Salzburg,7990,1,16,6,2,47,15,32,54
SK Sturm Gra,7990,2,12,4,8,31,28,3,40
LASK Linz,7990,3,11,5,8,29,24,5,38
Rapid Vienna,7990,4,7,10,7,33,30,3,31
Vienna,7990,5,7,5,12,24,38,-14,26
Mattersburg,7990,6,6,5,13,28,44,-16,23
SC Rheindorf,7990,7,4,7,13,16,29,-13,19
FC Salzburg,7991,1,14,6,4,47,21,26,48
Rapid Vienna,7991,2,10,10,4,41,26,15,40
SK Sturm Gra,7991,3,12,3,9,31,33,-2,39
LASK Linz,7991,4,7,7,10,25,30,-5,28
Vienna,7991,5,7,5,12,27,42,-15,26
Mattersburg,7991,6,6,7,11,32,43,-11,25
SC Rheindorf,7991,7,6,6,12,24,32,-8,24
FC Salzburg,7992,1,15,7,2,44,16,28,52
SK Sturm Gra,7992,2,14,3,7,34,27,7,45
Rapid Vienna,7992,3,7,11,6,35,32,3,32
LASK Linz,7992,4,8,7,9,26,27,-1,31
Vienna,7992,5,7,5,12,25,39,-14,26
SC Rheindorf,7992,6,5,7,12,21,30,-9,22
Mattersburg,7992,7,5,6,13,30,44,-14,21
FC Salzburg,7993,1,16,6,2,46,16,30,54
SK Sturm Gra,7993,2,11,5,8,30,29,1,38
Rapid Vienna,7993,3,9,10,5,37,26,11,37
LASK Linz,7993,4,9,6,9,30,30,0,33
Vienna,7993,5,7,5,12,24,39,-15,26
Mattersburg,7993,6,6,6,12,27,39,-12,24
SC Rheindorf,7993,7,4,6,14,17,32,-15,18
FC Salzburg,7994,1,14,7,3,44,18,26,49
Rapid Vienna,7994,2,10,10,4,41,28,13,40
SK Sturm Gra,7994,3,12,3,9,32,30,2,39
LASK Linz,7994,4,7,7,10,26,31,-5,28
Mattersburg,7994,5,7,7,10,30,38,-8,28
Vienna,7994,6,6,6,12,23,40,-17,24
SC Rheindorf,7994,7,5,6,13,17,28,-11,21
FC Salzburg,7995,1,14,8,2,48,18,30,50
SK Sturm Gra,7995,2,14,4,6,36,25,11,46
LASK Linz,7995,3,9,6,9,29,29,0,33
Rapid Vienna,7995,4,7,11,6,34,30,4,32
Vienna,7995,5,6,7,11,24,38,-14,25
SC Rheindorf,7995,6,5,6,13,18,31,-13,21
Mattersburg,7995,7,5,6,13,26,44,-18,21
FC Salzburg,7996,1,16,6,2,48,15,33,54
SK Sturm Gra,7996,2,11,6,7,28,26,2,39
Rapid Vienna,7996,3,8,11,5,36,28,8,35
LASK Linz,7996,4,8,7,9,28,29,-1,31
Mattersburg,7996,5,7,5,12,31,44,-13,26
Vienna,7996,6,6,5,13,25,45,-20,23
SC Rheindorf,7996,7,5,6,13,20,29,-9,21
FC Salzburg,7997,1,14,8,2,44,16,28,50
SK Sturm Gra,7997,2,13,4,7,34,27,7,43
Rapid Vienna,7997,3,9,11,4,38,26,12,38
Mattersburg,7997,4,8,5,11,34,43,-9,29
LASK Linz,7997,5,7,6,11,29,36,-7,27
Vienna,7997,6,6,5,13,25,43,-18,23
SC Rheindorf,7997,7,5,5,14,18,31,-13,20
FC Salzburg,7998,1,15,6,3,47,17,30,51
SK Sturm Gra,7998,2,14,4,6,38,30,8,46
Rapid Vienna,7998,3,8,9,7,32,28,4,33
LASK Linz,7998,4,8,6,10,28,30,-2,30
Vienna,7998,5,7,5,12,27,42,-15,26
Mattersburg,7998,6,6,6,12,30,42,-12,24
SC Rheindorf,7998,7,5,6,13,20,33,-13,21
FC Salzburg,7999,1,14,8,2,44,18,26,50
SK Sturm Gra,7999,2,12,5,7,32,28,4,41
Rapid Vienna,7999,3,8,10,6,37,32,5,34
LASK Linz,7999,4,8,7,9,30,28,2,31
Vienna,7999,5,7,6,11,25,38,-13,27
Mattersburg,7999,6,6,6,12,28,39,-11,24
SC Rheindorf,7999,7,5,6,13,18,31,-13,21
FC Salzburg,8000,1,15,6,3,50,19,31,51
SK Sturm Gra,8000,2,12,4,8,31,32,-1,40
Rapid Vienna,8000,3,9,10,5,38,27,11,37
LASK Linz,8000,4,9,6,9,28,28,0,33
Vienna,8000,5,6,6,12,23,40,-17,24
SC Rheindorf,8000,6,6,5,13,20,28,-8,23
Mattersburg,8000,7,5,7,12,28,44,-16,22
FC Salzburg,8001,1,14,7,3,46,20,26,49
SK Sturm Gra,8001,2,14,3,7,34,27,7,45
Rapid Vienna,8001,3,9,9,6,36,28,8,36
LASK Linz,8001,4,8,5,11,30,33,-3,29
SC Rheindorf,8001,5,7,5,12,21,29,-8,26
Vienna,8001,6,6,6,12,24,41,-17,24
Mattersburg,8001,7,5,7,12,28,41,-13,22
FC Salzburg,8002,1,14,7,3,48,19,29,49
SK Sturm Gra,8002,2,11,5,8,31,33,-2,38
Rapid Vienna,8002,3,9,10,5,40,29,11,37
LASK Linz,8002,4,8,6,10,28,31,-3,30
SC Rheindorf,8002,5,7,5,12,20,28,-8,26
Vienna,8002,6,6,7,11,25,39,-14,25
Mattersburg,8002,7,6,6,12,28,41,-13,24
FC Salzburg,8003,1,14,6,4,42,21,21,48
SK Sturm Gra,8003,2,12,5,7,38,34,4,41
Rapid Vienna,8003,3,8,11,5,38,29,9,35
LASK Linz,8003,4,8,8,8,34,34,0,32
Mattersburg,8003,5,7,6,11,36,43,-7,27
Vienna,8003,6,7,5,12,26,41,-15,26
SC Rheindorf,8003,7,5,5,14,23,35,-12,20
FC Salzburg,8004,1,12,9,3,40,18,22,45
SK Sturm Gra,8004,2,12,5,7,32,29,3,41
Rapid Vienna,8004,3,9,9,6,38,31,7,36
LASK Linz,8004,4,9,5,10,30,29,1,32
Mattersburg,8004,5,7,7,10,33,39,-6,28
Vienna,8004,6,6,6,12,23,40,-17,24
SC Rheindorf,8004,7,5,7,12,19,29,-10,22
FC Salzburg,8005,1,14,6,4,44,20,24,48
SK Sturm Gra,8005,2,12,4,8,34,32,2,40
Rapid Vienna,8005,3,9,11,4,36,26,10,38
LASK Linz,8005,4,8,6,10,30,31,-1,30
Vienna,8005,5,8,5,11,26,38,-12,29
SC Rheindorf,8005,6,6,7,11,22,30,-8,25
Mattersburg,8005,7,5,5,14,28,43,-15,20
FC Salzburg,8006,1,14,6,4,43,19,24,48
Rapid Vienna,8006,2,11,9,4,38,25,13,42
SK Sturm Gra,8006,3,12,3,9,33,33,0,39
LASK Linz,8006,4,8,6,10,29,33,-4,30
Mattersburg,8006,5,6,7,11,30,41,-11,25
Vienna,8006,6,6,6,12,25,40,-15,24
SC Rheindorf,8006,7,6,5,13,21,28,-7,23
FC Salzburg,8007,1,13,9,2,46,20,26,48
SK Sturm Gra,8007,2,12,6,6,33,28,5,42
Rapid Vienna,8007,3,7,10,7,35,31,4,31
LASK Linz,8007,4,8,6,10,26,29,-3,30
Mattersburg,8007,5,8,6,10,31,38,-7,30
SC Rheindorf,8007,6,6,6,12,22,29,-7,24
Vienna,8007,7,6,5,13,23,41,-18,23
FC Salzburg,8008,1,13,8,3,43,19,24,47
SK Sturm Gra,8008,2,11,4,9,31,31,0,37
Rapid Vienna,8008,3,8,12,4,34,25,9,36
Mattersburg,8008,4,8,5,11,36,40,-4,29
LASK Linz,8008,5,7,7,10,25,31,-6,28
SC Rheindorf,8008,6,7,6,11,20,27,-7,27
Vienna,8008,7,6,6,12,28,44,-16,24
FC Salzburg,8009,1,15,6,3,48,17,31,51
SK Sturm Gra,8009,2,12,4,8,32,31,1,40
Rapid Vienna,8009,3,9,11,4,35,25,10,38
LASK Linz,8009,4,7,6,11,25,31,-6,27
Mattersburg,8009,5,7,5,12,31,43,-12,26
Vienna,8009,6,7,5,12,27,40,-13,26
SC Rheindorf,8009,7,5,7,12,19,30,-11,22
FC Salzburg,8010,1,15,6,3,49,21,28,51
SK Sturm Gra,8010,2,12,4,8,32,28,4,40
Rapid Vienna,8010,3,10,9,5,36,26,10,39
LASK Linz,8010,4,8,5,11,26,29,-3,29
Vienna,8010,5,7,5,12,31,45,-14,26
SC Rheindorf,8010,6,6,6,12,20,28,-8,24
Mattersburg,8010,7,6,5,13,32,49,-17,23
FC Salzburg,8011,1,15,6,3,43,16,27,51
SK Sturm Gra,8011,2,13,4,7,32,26,6,43
Rapid Vienna,8011,3,8,10,6,34,30,4,34
LASK Linz,8011,4,8,6,10,29,30,-1,30
Vienna,8011,5,8,5,11,27,38,-11,29
Mattersburg,8011,6,6,5,13,32,45,-13,23
SC Rheindorf,8011,7,4,8,12,21,33,-12,20
FC Salzburg,8012,1,14,6,4,44,18,26,48
SK Sturm Gra,8012,2,11,5,8,31,31,0,38
LASK Linz,8012,3,10,5,9,30,27,3,35
Rapid Vienna,8012,4,7,10,7,35,33,2,31
Mattersburg,8012,5,8,5,11,36,41,-5,29
Vienna,8012,6,7,5,12,25,41,-16,26
SC Rheindorf,8012,7,6,6,12,20,30,-10,24
FC Salzburg,8013,1,15,7,2,49,20,29,52
SK Sturm Gra,8013,2,11,6,7,30,28,2,39
Rapid Vienna,8013,3,8,11,5,36,29,7,35
LASK Linz,8013,4,8,6,10,29,30,-1,30
Vienna,8013,5,7,5,12,27,41,-14,26
Mattersburg,8013,6,6,6,12,31,44,-13,24
SC Rheindorf,8013,7,5,7,12,17,27,-10,22
FC Salzburg,8014,1,15,6,3,46,16,30,51
SK Sturm Gra,8014,2,13,4,7,34,30,4,43
Rapid Vienna,8014,3,8,11,5,34,27,7,35
LASK Linz,8014,4,9,5,10,28,29,-1,32
Vienna,8014,5,8,5,11,25,37,-12,29
Mattersburg,8014,6,5,6,13,26,42,-16,21
SC Rheindorf,8014,7,4,7,13,18,30,-12,19
FC Salzburg,8015,1,15,6,3,48,19,29,51
SK Sturm Gra,8015,2,12,5,7,35,32,3,41
LASK Linz,8015,3,9,6,9,29,28,1,33
Rapid Vienna,8015,4,7,10,7,33,33,0,31
Mattersburg,8015,5,7,5,12,33,44,-11,26
Vienna,8015,6,7,5,12,26,40,-14,26
SC Rheindorf,8015,7,5,7,12,22,30,-8,22
FC Salzburg,8016,1,15,7,2,46,20,26,52
Rapid Vienna,8016,2,9,10,5,38,29,9,37
SK Sturm Gra,8016,3,11,4,9,31,32,-1,37
LASK Linz,8016,4,8,6,10,28,29,-1,30
Vienna,8016,5,7,5,12,24,38,-14,26
SC Rheindorf,8016,6,6,6,12,22,30,-8,24
Mattersburg,8016,7,6,6,12,31,42,-11,24
FC Salzburg,8017,1,15,7,2,44,17,27,52
SK Sturm Gra,8017,2,14,3,7,36,26,10,45
Rapid Vienna,8017,3,8,10,6,34,27,7,34
LASK Linz,8017,4,9,6,9,26,28,-2,33
Mattersburg,8017,5,6,7,11,28,38,-10,25
Vienna,8017,6,6,5,13,23,40,-17,23
SC Rheindorf,8017,7,4,6,14,15,30,-15,18
FC Salzburg,8018,1,14,8,2,47,18,29,50
SK Sturm Gra,8018,2,12,4,8,34,31,3,40
Rapid Vienna,8018,3,8,12,4,35,26,9,36
LASK Linz,8018,4,8,7,9,29,31,-2,31
Mattersburg,8018,5,6,7,11,33,45,-12,25
Vienna,8018,6,6,7,11,26,40,-14,25
SC Rheindorf,8018,7,5,5,14,20,33,-13,20
FC Salzburg,8019,1,14,7,3,46,20,26,49
SK Sturm Gra,8019,2,12,4,8,31,32,-1,40
Rapid Vienna,8019,3,9,9,6,37,28,9,36
LASK Linz,8019,4,8,6,10,27,30,-3,30
Vienna,8019,5,7,5,12,25,40,-15,26
SC Rheindorf,8019,6,6,7,11,23,27,-4,25
Mattersburg,8019,7,6,6,12,27,39,-12,24
FC Salzburg,8020,1,15,6,3,42,18,24,51
SK Sturm Gra,8020,2,12,5,7,31,27,4,41
Rapid Vienna,8020,3,7,10,7,32,28,4,31
LASK Linz,8020,4,8,5,11,28,33,-5,29
Vienna,8020,5,8,5,11,26,37,-11,29
SC Rheindorf,8020,6,6,7,11,22,28,-6,25
Mattersburg,8020,7,6,6,12,30,40,-10,24
FC Salzburg,8021,1,16,6,2,53,21,32,54
SK Sturm Gra,8021,2,12,4,8,34,31,3,40
Rapid Vienna,8021,3,8,10,6,36,32,4,34
LASK Linz,8021,4,9,5,10,29,31,-2,32
Mattersburg,8021,5,7,5,12,33,44,-11,26
Vienna,8021,6,6,5,13,27,44,-17,23
SC Rheindorf,8021,7,5,7,12,22,31,-9,22
FC Salzburg,8022,1,14,6,4,45,21,24,48
SK Sturm Gra,8022,2,13,3,8,34,32,2,42
Rapid Vienna,8022,3,10,9,5,37,26,11,39
LASK Linz,8022,4,8,6,10,29,31,-2,30
Mattersburg,8022,5,8,5,11,35,43,-8,29
Vienna,8022,6,7,5,12,26,39,-13,26
SC Rheindorf,8022,7,4,6,14,19,33,-14,18
FC Salzburg,8023,1,14,7,3,45,19,26,49
SK Sturm Gra,8023,2,13,4,7,31,26,5,43
Rapid Vienna,8023,3,10,10,4,35,24,11,40
LASK Linz,8023,4,8,6,10,29,30,-1,30
Vienna,8023,5,7,5,12,29,41,-12,26
SC Rheindorf,8023,6,5,6,13,19,29,-10,21
Mattersburg,8023,7,5,6,13,31,50,-19,21
FC Salzburg,8024,1,13,8,3,44,21,23,47
SK Sturm Gra,8024,2,13,4,7,33,26,7,43
Rapid Vienna,8024,3,9,10,5,37,26,11,37
LASK Linz,8024,4,10,5,9,30,29,1,35
Vienna,8024,5,7,6,11,28,40,-12,27
Mattersburg,8024,6,5,6,13,29,44,-15,21
SC Rheindorf,8024,7,4,7,13,17,32,-15,19
FC Salzburg,8025,1,14,6,4,45,19,26,48
SK Sturm Gra,8025,2,13,4,7,33,29,4,43
Rapid Vienna,8025,3,9,10,5,39,29,10,37
LASK Linz,8025,4,9,5,10,30,30,0,32
Mattersburg,8025,5,7,6,11,32,43,-11,27
Vienna,8025,6,6,5,13,23,40,-17,23
SC Rheindorf,8025,7,5,6,13,22,34,-12,21
FC Salzburg,8026,1,15,7,2,51,23,28,52
SK Sturm Gra,8026,2,12,5,7,35,33,2,41
Rapid Vienna,8026,3,7,10,7,32,28,4,31
LASK Linz,8026,4,8,7,9,29,30,-1,31
Vienna,8026,5,7,5,12,27,40,-13,26
SC Rheindorf,8026,6,6,6,12,20,29,-9,24
Mattersburg,8026,7,6,6,12,33,44,-11,24
FC Salzburg,8027,1,15,6,3,50,19,31,51
SK Sturm Gra,8027,2,13,3,8,35,27,8,42
Rapid Vienna,8027,3,8,9,7,34,33,1,33
LASK Linz,8027,4,9,6,9,28,29,-1,33
Vienna,8027,5,7,5,12,27,40,-13,26
Mattersburg,8027,6,6,6,12,30,45,-15,24
SC Rheindorf,8027,7,6,5,13,19,30,-11,23
FC Salzburg,8028,1,13,7,4,47,22,25,46
SK Sturm Gra,8028,2,12,5,7,34,30,4,41
Rapid Vienna,8028,3,9,10,5,37,27,10,37
LASK Linz,8028,4,10,5,9,27,26,1,35
Vienna,8028,5,8,5,11,27,39,-12,29
Mattersburg,8028,6,7,5,12,30,43,-13,26
SC Rheindorf,8028,7,4,5,15,17,32,-15,17
FC Salzburg,8029,1,14,6,4,46,21,25,48
SK Sturm Gra,8029,2,12,3,9,31,34,-3,39
Rapid Vienna,8029,3,8,9,7,34,29,5,33
LASK Linz,8029,4,9,5,10,26,28,-2,32
Vienna,8029,5,8,5,11,29,38,-9,29
SC Rheindorf,8029,6,7,5,12,22,28,-6,26
Mattersburg,8029,7,7,5,12,31,41,-10,26
FC Salzburg,8030,1,14,7,3,42,17,25,49
SK Sturm Gra,8030,2,13,3,8,33,30,3,42
Rapid Vienna,8030,3,9,10,5,39,26,13,37
LASK Linz,8030,4,9,5,10,26,29,-3,32
Vienna,8030,5,8,5,11,26,37,-11,29
Mattersburg,8030,6,6,5,13,31,42,-11,23
SC Rheindorf,8030,7,5,5,14,17,33,-16,20
FC Salzburg,8031,1,14,7,3,44,18,26,49
SK Sturm Gra,8031,2,13,4,7,32,26,6,43
Rapid Vienna,8031,3,8,11,5,34,26,8,35
Mattersburg,8031,4,8,5,11,34,42,-8,29
LASK Linz,8031,5,7,5,12,24,33,-9,26
Vienna,8031,6,7,5,12,28,42,-14,26
SC Rheindorf,8031,7,5,7,12,19,28,-9,22
FC Salzburg,8032,1,15,6,3,45,18,27,51
SK Sturm Gra,8032,2,13,5,6,35,27,8,44
Rapid Vienna,8032,3,8,11,5,33,26,7,35
Mattersburg,8032,4,7,6,11,33,40,-7,27
LASK Linz,8032,5,7,6,11,27,36,-9,27
Vienna,8032,6,6,5,13,24,40,-16,23
SC Rheindorf,8032,7,5,7,12,19,29,-10,22
FC Salzburg,8033,1,15,6,3,46,18,28,51
SK Sturm Gra,8033,2,13,3,8,36,28,8,42
LASK Linz,8033,3,10,5,9,28,26,2,35
Rapid Vienna,8033,4,8,10,6,34,30,4,34
Vienna,8033,5,7,5,12,25,41,-16,26
Mattersburg,8033,6,6,6,12,29,41,-12,24
SC Rheindorf,8033,7,4,7,13,16,30,-14,19
FC Salzburg,8034,1,15,7,2,46,20,26,52
SK Sturm Gra,8034,2,12,5,7,34,30,4,41
Rapid Vienna,8034,3,8,11,5,35,27,8,35
LASK Linz,8034,4,7,7,10,29,36,-7,28
Mattersburg,8034,5,7,5,12,33,39,-6,26
SC Rheindorf,8034,6,6,6,12,17,26,-9,24
Vienna,8034,7,6,5,13,25,41,-16,23
FC Salzburg,8035,1,14,6,4,45,21,24,48
SK Sturm Gra,8035,2,13,4,7,33,28,5,43
Rapid Vienna,8035,3,9,10,5,35,26,9,37
LASK Linz,8035,4,8,7,9,26,27,-1,31
Vienna,8035,5,7,5,12,27,40,-13,26
Mattersburg,8035,6,6,6,12,29,43,-14,24
SC Rheindorf,8035,7,5,6,13,19,29,-10,21
FC Salzburg,8036,1,14,7,3,43,20,23,49
SK Sturm Gra,8036,2,13,4,7,35,27,8,43
Rapid Vienna,8036,3,10,10,4,43,29,14,40
LASK Linz,8036,4,9,5,10,28,33,-5,32
Vienna,8036,5,6,6,12,23,38,-15,24
SC Rheindorf,8036,6,5,6,13,19,30,-11,21
Mattersburg,8036,7,5,6,13,28,42,-14,21
FC Salzburg,8037,1,13,6,5,43,21,22,45
SK Sturm Gra,8037,2,13,3,8,30,28,2,42
Rapid Vienna,8037,3,8,11,5,36,27,9,35
LASK Linz,8037,4,8,6,10,27,29,-2,30
Mattersburg,8037,5,8,5,11,34,42,-8,29
Vienna,8037,6,8,5,11,28,40,-12,29
SC Rheindorf,8037,7,5,6,13,18,29,-11,21
FC Salzburg,8038,1,14,7,3,46,20,26,49
SK Sturm Gra,8038,2,13,3,8,34,30,4,42
Rapid Vienna,8038,3,8,10,6,36,30,6,34
LASK Linz,8038,4,7,8,9,26,29,-3,29
Mattersburg,8038,5,7,6,11,32,41,-9,27
Vienna,8038,6,7,6,11,25,38,-13,27
SC Rheindorf,8038,7,5,6,13,21,32,-11,21
FC Salzburg,8039,1,15,7,2,49,19,30,52
SK Sturm Gra,8039,2,12,4,8,31,30,1,40
Rapid Vienna,8039,3,9,10,5,37,28,9,37
LASK Linz,8039,4,9,5,10,28,28,0,32
Vienna,8039,5,6,7,11,25,39,-14,25
Mattersburg,8039,6,6,6,12,29,41,-12,24
SC Rheindorf,8039,7,5,5,14,19,33,-14,20
FC Salzburg,8040,1,14,7,3,46,21,25,49
SK Sturm Gra,8040,2,12,3,9,33,33,0,39
Rapid Vienna,8040,3,9,10,5,39,28,11,37
LASK Linz,8040,4,8,5,11,28,33,-5,29
Mattersburg,8040,5,7,5,12,35,40,-5,26
SC Rheindorf,8040,6,7,5,12,21,31,-10,26
Vienna,8040,7,7,5,12,26,42,-16,26
FC Salzburg,8041,1,16,6,2,48,17,31,54
SK Sturm Gra,8041,2,12,3,9,31,30,1,39
Rapid Vienna,8041,3,9,9,6,36,30,6,36
LASK Linz,8041,4,9,5,10,29,29,0,32
Mattersburg,8041,5,7,5,12,35,44,-9,26
SC Rheindorf,8041,6,6,5,13,21,30,-9,23
Vienna,8041,7,6,5,13,24,44,-20,23
FC Salzburg,8042,1,14,7,3,43,19,24,49
SK Sturm Gra,8042,2,11,4,9,29,31,-2,37
Rapid Vienna,8042,3,9,9,6,37,27,10,36
LASK Linz,8042,4,8,6,10,25,27,-2,30
SC Rheindorf,8042,5,7,6,11,20,27,-7,27
Mattersburg,8042,6,7,6,11,33,41,-8,27
Vienna,8042,7,6,6,12,27,42,-15,24
FC Salzburg,8043,1,14,7,3,42,18,24,49
SK Sturm Gra,8043,2,12,4,8,34,31,3,40
Rapid Vienna,8043,3,9,10,5,36,26,10,37
LASK Linz,8043,4,10,6,8,32,29,3,36
Mattersburg,8043,5,6,6,12,31,42,-11,24
Vienna,8043,6,6,5,13,24,41,-17,23
SC Rheindorf,8043,7,4,8,12,21,33,-12,20
FC Salzburg,8044,1,14,7,3,42,16,26,49
Rapid Vienna,8044,2,10,9,5,38,27,11,39
SK Sturm Gra,8044,3,11,4,9,29,29,0,37
LASK Linz,8044,4,8,6,10,28,32,-4,30
Mattersburg,8044,5,7,6,11,34,42,-8,27
Vienna,8044,6,7,6,11,25,38,-13,27
SC Rheindorf,8044,7,5,6,13,21,33,-12,21
FC Salzburg,8045,1,13,8,3,43,20,23,47
SK Sturm Gra,8045,2,13,5,6,36,30,6,44
Rapid Vienna,8045,3,7,11,6,35,29,6,32
LASK Linz,8045,4,8,6,10,27,30,-3,30
Mattersburg,8045,5,7,6,11,33,41,-8,27
Vienna,8045,6,7,6,11,26,38,-12,27
SC Rheindorf,8045,7,4,8,12,18,30,-12,20
FC Salzburg,8046,1,15,6,3,49,16,33,51
Rapid Vienna,8046,2,9,10,5,37,26,11,37
SK Sturm Gra,8046,3,11,3,10,29,35,-6,36
LASK Linz,8046,4,9,5,10,30,32,-2,32
Mattersburg,8046,5,7,5,12,32,45,-13,26
Vienna,8046,6,7,5,12,24,41,-17,26
SC Rheindorf,8046,7,6,6,12,22,28,-6,24
FC Salzburg,8047,1,13,8,3,44,20,24,47
SK Sturm Gra,8047,2,12,5,7,34,32,2,41
Rapid Vienna,8047,3,8,11,5,38,29,9,35
LASK Linz,8047,4,8,8,8,29,29,0,32
Mattersburg,8047,5,7,6,11,31,40,-9,27
Vienna,8047,6,6,6,12,24,39,-15,24
SC Rheindorf,8047,7,4,8,12,19,30,-11,20
FC Salzburg,8048,1,13,7,4,42,21,21,46
Rapid Vienna,8048,2,10,9,5,36,25,11,39
SK Sturm Gra,8048,3,12,3,9,30,30,0,39
LASK Linz,8048,4,8,5,11,27,31,-4,29
Vienna,8048,5,8,5,11,28,38,-10,29
Mattersburg,8048,6,7,6,11,32,41,-9,27
SC Rheindorf,8048,7,6,5,13,19,28,-9,23
FC Salzburg,8049,1,14,7,3,45,18,27,49
Rapid Vienna,8049,2,9,10,5,34,27,7,37
SK Sturm Gra,8049,3,11,4,9,28,31,-3,37
LASK Linz,8049,4,8,6,10,28,28,0,30
Vienna,8049,5,7,6,11,27,40,-13,27
SC Rheindorf,8049,6,7,5,12,21,27,-6,26
Mattersburg,8049,7,6,6,12,30,42,-12,24
FC Salzburg,8050,1,15,6,3,50,18,32,51
SK Sturm Gra,8050,2,14,4,6,36,27,9,46
LASK Linz,8050,3,9,5,10,29,33,-4,32
Rapid Vienna,8050,4,7,9,8,36,35,1,30
Mattersburg,8050,5,7,6,11,33,43,-10,27
Vienna,8050,6,6,6,12,25,41,-16,24
SC Rheindorf,8050,7,5,6,13,19,31,-12,21
FC Salzburg,8051,1,14,8,2,42,16,26,50
Rapid Vienna,8051,2,9,11,4,37,26,11,38
SK Sturm Gra,8051,3,11,4,9,29,31,-2,37
LASK Linz,8051,4,8,7,9,27,28,-1,31
Mattersburg,8051,5,7,6,11,31,40,-9,27
SC Rheindorf,8051,6,6,5,13,20,29,-9,23
Vienna,8051,7,6,5,13,24,40,-16,23
FC Salzburg,8052,1,14,7,3,43,17,26,49
SK Sturm Gra,8052,2,12,5,7,33,30,3,41
Rapid Vienna,8052,3,10,9,5,36,24,12,39
LASK Linz,8052,4,8,7,9,28,30,-2,31
Mattersburg,8052,5,6,7,11,30,42,-12,25
Vienna,8052,6,6,5,13,24,40,-16,23
SC Rheindorf,8052,7,5,6,13,17,28,-11,21
FC Salzburg,8053,1,15,7,2,49,20,29,52
SK Sturm Gra,8053,2,13,3,8,32,31,1,42
Rapid Vienna,8053,3,9,10,5,43,29,14,37
LASK Linz,8053,4,8,6,10,27,29,-2,30
Vienna,8053,5,7,5,12,26,41,-15,26
Mattersburg,8053,6,6,6,12,35,46,-11,24
SC Rheindorf,8053,7,5,5,14,20,36,-16,20
FC Salzburg,8054,1,15,6,3,48,18,30,51
SK Sturm Gra,8054,2,14,3,7,32,27,5,45
Rapid Vienna,8054,3,9,10,5,34,24,10,37
LASK Linz,8054,4,8,7,9,26,26,0,31
Vienna,8054,5,7,5,12,25,43,-18,26
Mattersburg,8054,6,6,5,13,29,42,-13,23
SC Rheindorf,8054,7,4,6,14,16,30,-14,18
FC Salzburg,8055,1,14,7,3,47,21,26,49
Rapid Vienna,8055,2,9,10,5,38,31,7,37
SK Sturm Gra,8055,3,11,4,9,32,32,0,37
LASK Linz,8055,4,7,9,8,28,29,-1,30
Mattersburg,8055,5,6,7,11,33,42,-9,25
Vienna,8055,6,6,7,11,27,41,-14,25
SC Rheindorf,8055,7,6,6,12,20,29,-9,24
FC Salzburg,8056,1,13,8,3,46,21,25,47
Rapid Vienna,8056,2,10,10,4,39,25,14,40
SK Sturm Gra,8056,3,11,4,9,31,32,-1,37
LASK Linz,8056,4,9,6,9,29,30,-1,33
Vienna,8056,5,8,5,11,26,37,-11,29
Mattersburg,8056,6,6,5,13,31,47,-16,23
SC Rheindorf,8056,7,5,6,13,21,31,-10,21
FC Salzburg,8057,1,13,6,5,41,21,20,45
SK Sturm Gra,8057,2,13,3,8,34,28,6,42
Rapid Vienna,8057,3,10,9,5,36,27,9,39
LASK Linz,8057,4,8,7,9,27,27,0,31
Vienna,8057,5,8,5,11,27,38,-11,29
SC Rheindorf,8057,6,6,6,12,18,28,-10,24
Mattersburg,8057,7,5,6,13,28,42,-14,21
FC Salzburg,8058,1,14,7,3,41,17,24,49
SK Sturm Gra,8058,2,13,4,7,32,27,5,43
Rapid Vienna,8058,3,9,11,4,36,26,10,38
LASK Linz,8058,4,7,6,11,27,31,-4,27
Vienna,8058,5,7,6,11,25,38,-13,27
Mattersburg,8058,6,6,6,12,31,42,-11,24
SC Rheindorf,8058,7,5,6,13,19,30,-11,21
FC Salzburg,8059,1,14,8,2,47,20,27,50
SK Sturm Gra,8059,2,13,4,7,35,30,5,43
Rapid Vienna,8059,3,7,11,6,36,30,6,32
LASK Linz,8059,4,9,5,10,29,32,-3,32
Vienna,8059,5,7,6,11,32,44,-12,27
Mattersburg,8059,6,6,6,12,35,46,-11,24
SC Rheindorf,8059,7,4,8,12,19,31,-12,20
FC Salzburg,8060,1,13,7,4,46,22,24,46
SK Sturm Gra,8060,2,13,4,7,32,27,5,43
Rapid Vienna,8060,3,10,9,5,40,28,12,39
LASK Linz,8060,4,9,5,10,28,30,-2,32
Vienna,8060,5,7,6,11,26,39,-13,27
Mattersburg,8060,6,7,5,12,31,41,-10,26
SC Rheindorf,8060,7,4,6,14,17,33,-16,18
FC Salzburg,8061,1,14,8,2,45,19,26,50
SK Sturm Gra,8061,2,13,4,7,37,30,7,43
Rapid Vienna,8061,3,8,10,6,41,33,8,34
LASK Linz,8061,4,7,6,11,26,34,-8,27
Mattersburg,8061,5,6,7,11,31,42,-11,25
Vienna,8061,6,6,7,11,25,39,-14,25
SC Rheindorf,8061,7,6,6,12,24,32,-8,24
FC Salzburg,8062,1,14,7,3,45,19,26,49
SK Sturm Gra,8062,2,11,4,9,31,31,0,37
Rapid Vienna,8062,3,9,9,6,36,30,6,36
LASK Linz,8062,4,10,6,8,33,29,4,36
Mattersburg,8062,5,7,6,11,34,42,-8,27
Vienna,8062,6,6,6,12,24,40,-16,24
SC Rheindorf,8062,7,5,6,13,22,34,-12,21
FC Salzburg,8063,1,15,6,3,48,19,29,51
SK Sturm Gra,8063,2,12,5,7,29,25,4,41
Rapid Vienna,8063,3,8,11,5,35,25,10,35
LASK Linz,8063,4,7,8,9,23,26,-3,29
Vienna,8063,5,8,5,11,29,39,-10,29
Mattersburg,8063,6,7,5,12,31,45,-14,26
SC Rheindorf,8063,7,4,6,14,15,31,-16,18
FC Salzburg,8064,1,13,7,4,40,18,22,46
SK Sturm Gra,8064,2,12,6,6,31,26,5,42
Rapid Vienna,8064,3,9,11,4,39,26,13,38
LASK Linz,8064,4,9,6,9,27,29,-2,33
Vienna,8064,5,8,5,11,27,38,-11,29
Mattersburg,8064,6,6,5,13,31,43,-12,23
SC Rheindorf,8064,7,4,6,14,17,32,-15,18
FC Salzburg,8065,1,13,9,2,41,17,24,48
Rapid Vienna,8065,2,9,10,5,33,24,9,37
SK Sturm Gra,8065,3,11,4,9,29,30,-1,37
LASK Linz,8065,4,10,5,9,31,27,4,35
Mattersburg,8065,5,7,6,11,34,44,-10,27
SC Rheindorf,8065,6,6,5,13,19,29,-10,23
Vienna,8065,7,6,5,13,25,41,-16,23
FC Salzburg,8066,1,15,7,2,46,19,27,52
SK Sturm Gra,8066,2,12,5,7,30,26,4,41
Rapid Vienna,8066,3,10,9,5,35,25,10,39
LASK Linz,8066,4,8,7,9,25,25,0,31
Vienna,8066,5,7,5,12,27,39,-12,26
SC Rheindorf,8066,6,5,6,13,19,29,-10,21
Mattersburg,8066,7,5,5,14,29,48,-19,20
FC Salzburg,8067,1,16,6,2,48,17,31,54
SK Sturm Gra,8067,2,13,4,7,36,31,5,43
LASK Linz,8067,3,10,6,8,33,26,7,36
Rapid Vienna,8067,4,8,9,7,34,28,6,33
Vienna,8067,5,7,5,12,25,41,-16,26
Mattersburg,8067,6,5,6,13,29,45,-16,21
SC Rheindorf,8067,7,4,6,14,19,36,-17,18
FC Salzburg,8068,1,14,6,4,47,23,24,48
SK Sturm Gra,8068,2,13,4,7,32,27,5,43
Rapid Vienna,8068,3,11,9,4,38,25,13,42
LASK Linz,8068,4,8,6,10,26,29,-3,30
Mattersburg,8068,5,7,6,11,30,39,-9,27
Vienna,8068,6,6,6,12,26,42,-16,24
SC Rheindorf,8068,7,4,5,15,17,31,-14,17
FC Salzburg,8069,1,16,6,2,48,16,32,54
SK Sturm Gra,8069,2,13,3,8,32,29,3,42
Rapid Vienna,8069,3,8,10,6,35,29,6,34
LASK Linz,8069,4,7,7,10,26,31,-5,28
Mattersburg,8069,5,7,5,12,32,40,-8,26
Vienna,8069,6,7,5,12,25,40,-15,26
SC Rheindorf,8069,7,5,6,13,18,31,-13,21
FC Salzburg,8070,1,15,7,2,49,18,31,52
SK Sturm Gra,8070,2,13,3,8,34,34,0,42
Rapid Vienna,8070,3,8,11,5,36,29,7,35
LASK Linz,8070,4,9,5,10,26,27,-1,32
Vienna,8070,5,7,5,12,27,41,-14,26
SC Rheindorf,8070,6,6,6,12,19,27,-8,24
Mattersburg,8070,7,5,5,14,29,44,-15,20
FC Salzburg,8071,1,14,7,3,44,18,26,49
SK Sturm Gra,8071,2,12,5,7,33,28,5,41
Rapid Vienna,8071,3,9,10,5,36,27,9,37
LASK Linz,8071,4,8,8,8,30,28,2,32
SC Rheindorf,8071,5,6,6,12,18,27,-9,24
Vienna,8071,6,6,5,13,24,40,-16,23
Mattersburg,8071,7,6,5,13,29,46,-17,23
FC Salzburg,8072,1,15,6,3,48,19,29,51
Rapid Vienna,8072,2,9,10,5,38,27,11,37
SK Sturm Gra,8072,3,11,4,9,29,33,-4,37
LASK Linz,8072,4,10,5,9,29,28,1,35
Mattersburg,8072,5,7,6,11,30,40,-10,27
Vienna,8072,6,6,6,12,23,42,-19,24
SC Rheindorf,8072,7,5,5,14,22,30,-8,20
FC Salzburg,8073,1,15,6,3,45,17,28,51
SK Sturm Gra,8073,2,15,3,6,34,25,9,48
Rapid Vienna,8073,3,8,9,7,33,28,5,33
LASK Linz,8073,4,9,5,10,27,28,-1,32
Vienna,8073,5,6,6,12,25,42,-17,24
Mattersburg,8073,6,5,7,12,30,44,-14,22
SC Rheindorf,8073,7,5,6,13,18,28,-10,21
FC Salzburg,8074,1,15,7,2,45,17,28,52
SK Sturm Gra,8074,2,11,5,8,29,28,1,38
Rapid Vienna,8074,3,8,11,5,34,26,8,35
LASK Linz,8074,4,8,6,10,25,27,-2,30
Vienna,8074,5,7,6,11,27,39,-12,27
SC Rheindorf,8074,6,5,8,11,20,29,-9,23
Mattersburg,8074,7,5,7,12,26,40,-14,22
FC Salzburg,8075,1,15,7,2,47,16,31,52
SK Sturm Gra,8075,2,13,3,8,38,31,7,42
Rapid Vienna,8075,3,8,9,7,39,32,7,33
SC Rheindorf,8075,4,8,5,11,23,29,-6,29
LASK Linz,8075,5,7,6,11,24,35,-11,27
Mattersburg,8075,6,6,6,12,31,43,-12,24
Vienna,8075,7,6,6,12,23,39,-16,24
FC Salzburg,8076,1,14,6,4,45,23,22,48
SK Sturm Gra,8076,2,13,4,7,36,30,6,43
Rapid Vienna,8076,3,8,11,5,37,29,8,35
Mattersburg,8076,4,8,6,10,36,41,-5,30
LASK Linz,8076,5,7,7,10,28,33,-5,28
SC Rheindorf,8076,6,6,5,13,20,29,-9,23
Vienna,8076,7,6,5,13,24,41,-17,23
FC Salzburg,8077,1,15,6,3,45,18,27,51
SK Sturm Gra,8077,2,14,3,7,33,27,6,45
Rapid Vienna,8077,3,10,9,5,38,28,10,39
LASK Linz,8077,4,7,6,11,27,31,-4,27
Vienna,8077,5,7,5,12,24,40,-16,26
Mattersburg,8077,6,5,7,12,28,40,-12,22
SC Rheindorf,8077,7,5,6,13,20,31,-11,21
FC Salzburg,8078,1,16,6,2,48,16,32,54
SK Sturm Gra,8078,2,12,5,7,31,27,4,41
Rapid Vienna,8078,3,8,9,7,35,27,8,33
LASK Linz,8078,4,8,7,9,25,26,-1,31
Mattersburg,8078,5,6,7,11,31,44,-13,25
Vienna,8078,6,6,6,12,24,40,-16,24
SC Rheindorf,8078,7,4,8,12,17,31,-14,20
FC Salzburg,8079,1,16,6,2,50,20,30,54
SK Sturm Gra,8079,2,11,5,8,31,30,1,38
Rapid Vienna,8079,3,9,10,5,38,30,8,37
LASK Linz,8079,4,7,8,9,28,30,-2,29
Mattersburg,8079,5,6,7,11,32,41,-9,25
Vienna,8079,6,6,6,12,25,41,-16,24
SC Rheindorf,8079,7,5,6,13,20,32,-12,21
FC Salzburg,8080,1,13,9,2,44,20,24,48
SK Sturm Gra,8080,2,13,5,6,33,26,7,44
Rapid Vienna,8080,3,8,10,6,37,31,6,34
LASK Linz,8080,4,8,8,8,29,29,0,32
Mattersburg,8080,5,6,8,10,33,41,-8,26
Vienna,8080,6,6,6,12,24,39,-15,24
SC Rheindorf,8080,7,4,6,14,18,32,-14,18
FC Salzburg,8081,1,15,7,2,48,15,33,52
SK Sturm Gra,8081,2,12,3,9,31,30,1,39
Rapid Vienna,8081,3,9,9,6,34,29,5,36
LASK Linz,8081,4,8,5,11,26,30,-4,29
Vienna,8081,5,7,6,11,25,38,-13,27
SC Rheindorf,8081,6,7,5,12,22,30,-8,26
Mattersburg,8081,7,6,5,13,29,43,-14,23
FC Salzburg,8082,1,15,6,3,52,23,29,51
SK Sturm Gra,8082,2,12,3,9,31,31,0,39
Rapid Vienna,8082,3,9,9,6,35,26,9,36
LASK Linz,8082,4,9,7,8,28,27,1,34
Mattersburg,8082,5,6,7,11,32,41,-9,25
Vienna,8082,6,6,5,13,27,47,-20,23
SC Rheindorf,8082,7,5,7,12,20,30,-10,22
FC Salzburg,8083,1,15,6,3,45,19,26,51
SK Sturm Gra,8083,2,14,4,6,35,27,8,46
Rapid Vienna,8083,3,8,10,6,35,27,8,34
LASK Linz,8083,4,7,7,10,27,31,-4,28
Mattersburg,8083,5,6,6,12,32,43,-11,24
Vienna,8083,6,6,6,12,25,41,-16,24
SC Rheindorf,8083,7,5,7,12,20,31,-11,22
FC Salzburg,8084,1,14,7,3,44,20,24,49
SK Sturm Gra,8084,2,13,3,8,34,30,4,42
Rapid Vienna,8084,3,9,9,6,35,27,8,36
LASK Linz,8084,4,8,6,10,25,27,-2,30
Mattersburg,8084,5,6,8,10,34,40,-6,26
SC Rheindorf,8084,6,6,6,12,20,29,-9,24
Vienna,8084,7,6,5,13,25,44,-19,23
FC Salzburg,8085,1,13,8,3,44,20,24,47
SK Sturm Gra,8085,2,13,4,7,33,26,7,43
Rapid Vienna,8085,3,10,10,4,37,26,11,40
LASK Linz,8085,4,7,6,11,26,32,-6,27
Vienna,8085,5,7,6,11,28,40,-12,27
Mattersburg,8085,6,6,5,13,32,48,-16,23
SC Rheindorf,8085,7,5,7,12,21,29,-8,22
FC Salzburg,8086,1,13,9,2,41,17,24,48
SK Sturm Gra,8086,2,14,4,6,33,25,8,46
Rapid Vienna,8086,3,7,11,6,34,30,4,32
LASK Linz,8086,4,8,6,10,28,29,-1,30
Mattersburg,8086,5,6,8,10,29,38,-9,26
Vienna,8086,6,6,5,13,25,41,-16,23
SC Rheindorf,8086,7,5,7,12,18,28,-10,22
FC Salzburg,8087,1,15,7,2,46,17,29,52
SK Sturm Gra,8087,2,11,5,8,31,31,0,38
LASK Linz,8087,3,9,7,8,30,28,2,34
Rapid Vienna,8087,4,8,9,7,35,29,6,33
Vienna,8087,5,7,5,12,25,39,-14,26
SC Rheindorf,8087,6,6,6,12,22,30,-8,24
Mattersburg,8087,7,5,7,12,30,45,-15,22
FC Salzburg,8088,1,16,6,2,49,15,34,54
SK Sturm Gra,8088,2,13,3,8,32,29,3,42
Rapid Vienna,8088,3,9,9,6,33,26,7,36
LASK Linz,8088,4,8,5,11,26,29,-3,29
Vienna,8088,5,7,5,12,26,42,-16,26
SC Rheindorf,8088,6,6,5,13,20,31,-11,23
Mattersburg,8088,7,6,5,13,32,46,-14,23
FC Salzburg,8089,1,15,6,3,44,17,27,51
SK Sturm Gra,8089,2,12,4,8,32,31,1,40
Rapid Vienna,8089,3,9,9,6,36,28,8,36
LASK Linz,8089,4,10,6,8,31,28,3,36
Mattersburg,8089,5,7,5,12,30,41,-11,26
Vienna,8089,6,7,5,12,25,39,-14,26
SC Rheindorf,8089,7,4,5,15,15,29,-14,17
FC Salzburg,8090,1,14,7,3,46,23,23,49
Rapid Vienna,8090,2,10,10,4,38,25,13,40
SK Sturm Gra,8090,3,12,3,9,34,31,3,39
LASK Linz,8090,4,7,7,10,28,32,-4,28
SC Rheindorf,8090,5,6,7,11,22,30,-8,25
Vienna,8090,6,6,7,11,26,40,-14,25
Mattersburg,8090,7,5,7,12,30,43,-13,22
FC Salzburg,8091,1,14,8,2,46,19,27,50
SK Sturm Gra,8091,2,12,5,7,31,27,4,41
Rapid Vienna,8091,3,8,10,6,34,28,6,34
Mattersburg,8091,4,8,5,11,33,42,-9,29
LASK Linz,8091,5,7,7,10,27,31,-4,28
Vienna,8091,6,6,6,12,25,40,-15,24
SC Rheindorf,8091,7,6,5,13,18,27,-9,23
FC Salzburg,8092,1,14,6,4,42,19,23,48
SK Sturm Gra,8092,2,11,5,8,32,31,1,38
Rapid Vienna,8092,3,9,10,5,37,27,10,37
LASK Linz,8092,4,9,7,8,30,27,3,34
Mattersburg,8092,5,8,5,11,35,40,-5,29
Vienna,8092,6,6,5,13,25,43,-18,23
SC Rheindorf,8092,7,5,6,13,20,34,-14,21
FC Salzburg,8093,1,14,6,4,45,17,28,48
SK Sturm Gra,8093,2,15,3,6,34,25,9,48
Rapid Vienna,8093,3,9,10,5,37,28,9,37
LASK Linz,8093,4,8,7,9,30,29,1,31
Vienna,8093,5,6,6,12,24,42,-18,24
SC Rheindorf,8093,6,5,6,13,19,31,-12,21
Mattersburg,8093,7,5,6,13,29,46,-17,21
FC Salzburg,8094,1,14,7,3,47,21,26,49
SK Sturm Gra,8094,2,13,5,6,36,29,7,44
Rapid Vienna,8094,3,8,10,6,36,30,6,34
LASK Linz,8094,4,8,7,9,31,31,0,31
Mattersburg,8094,5,6,7,11,31,42,-11,25
Vienna,8094,6,6,6,12,25,41,-16,24
SC Rheindorf,8094,7,5,6,13,20,32,-12,21
FC Salzburg,8095,1,13,8,3,42,19,23,47
SK Sturm Gra,8095,2,14,3,7,34,29,5,45
Rapid Vienna,8095,3,8,10,6,35,29,6,34
LASK Linz,8095,4,8,5,11,27,29,-2,29
Mattersburg,8095,5,7,6,11,33,40,-7,27
Vienna,8095,6,6,7,11,25,39,-14,25
SC Rheindorf,8095,7,6,5,13,21,32,-11,23
FC Salzburg,8096,1,14,7,3,46,21,25,49
SK Sturm Gra,8096,2,13,5,6,35,27,8,44
Rapid Vienna,8096,3,9,10,5,36,28,8,37
LASK Linz,8096,4,8,7,9,28,31,-3,31
Mattersburg,8096,5,7,5,12,33,41,-8,26
Vienna,8096,6,7,5,12,28,40,-12,26
SC Rheindorf,8096,7,4,5,15,15,33,-18,17
FC Salzburg,8097,1,15,6,3,44,19,25,51
SK Sturm Gra,8097,2,12,4,8,33,30,3,40
Rapid Vienna,8097,3,9,9,6,38,28,10,36
LASK Linz,8097,4,9,5,10,29,30,-1,32
Vienna,8097,5,7,5,12,29,42,-13,26
SC Rheindorf,8097,6,6,6,12,23,33,-10,24
Mattersburg,8097,7,6,5,13,30,44,-14,23
FC Salzburg,8098,1,14,6,4,44,20,24,48
SK Sturm Gra,8098,2,12,4,8,34,29,5,40
Rapid Vienna,8098,3,8,9,7,34,32,2,33
LASK Linz,8098,4,9,6,9,27,28,-1,33
Mattersburg,8098,5,9,5,10,34,39,-5,32
SC Rheindorf,8098,6,6,5,13,18,27,-9,23
Vienna,8098,7,6,5,13,25,41,-16,23
FC Salzburg,8099,1,14,6,4,43,20,23,48
SK Sturm Gra,8099,2,12,4,8,32,30,2,40
LASK Linz,8099,3,9,6,9,32,31,1,33
Rapid Vienna,8099,4,7,11,6,33,27,6,32
Vienna,8099,5,8,5,11,27,38,-11,29
Mattersburg,8099,6,7,6,11,35,42,-7,27
SC Rheindorf,8099,7,5,6,13,19,33,-14,21
FC Salzburg,8100,1,14,7,3,47,21,26,49
SK Sturm Gra,8100,2,12,4,8,34,31,3,40
Rapid Vienna,8100,3,8,12,4,37,27,10,36
LASK Linz,8100,4,7,7,10,28,33,-5,28
Vienna,8100,5,7,6,11,29,41,-12,27
SC Rheindorf,8100,6,6,7,11,21,29,-8,25
Mattersburg,8100,7,5,7,12,32,46,-14,22
FC Salzburg,8101,1,15,7,2,47,20,27,52
SK Sturm Gra,8101,2,13,3,8,34,31,3,42
Rapid Vienna,8101,3,9,10,5,39,28,11,37
LASK Linz,8101,4,7,7,10,27,30,-3,28
Vienna,8101,5,6,6,12,26,41,-15,24
Mattersburg,8101,6,5,8,11,33,44,-11,23
SC Rheindorf,8101,7,5,7,12,21,33,-12,22
FC Salzburg,8102,1,15,7,2,48,15,33,52
SK Sturm Gra,8102,2,12,5,7,32,30,2,41
LASK Linz,8102,3,9,7,8,31,30,1,34
Rapid Vienna,8102,4,7,10,7,32,29,3,31
Vienna,8102,5,7,6,11,24,37,-13,27
Mattersburg,8102,6,6,5,13,30,45,-15,23
SC Rheindorf,8102,7,4,8,12,17,28,-11,20
FC Salzburg,8103,1,13,6,5,44,23,21,45
SK Sturm Gra,8103,2,12,6,6,31,26,5,42
Rapid Vienna,8103,3,8,10,6,33,26,7,34
LASK Linz,8103,4,9,6,9,27,27,0,33
SC Rheindorf,8103,5,7,6,11,23,28,-5,27
Mattersburg,8103,6,7,5,12,33,44,-11,26
Vienna,8103,7,6,5,13,25,42,-17,23
FC Salzburg,8104,1,14,8,2,44,18,26,50
SK Sturm Gra,8104,2,12,4,8,32,31,1,40
LASK Linz,8104,3,10,6,8,29,26,3,36
Rapid Vienna,8104,4,7,11,6,34,29,5,32
SC Rheindorf,8104,5,6,6,12,23,29,-6,24
Mattersburg,8104,6,6,6,12,30,43,-13,24
Vienna,8104,7,6,5,13,23,39,-16,23
FC Salzburg,8105,1,14,8,2,45,20,25,50
SK Sturm Gra,8105,2,12,5,7,35,31,4,41
Rapid Vienna,8105,3,9,10,5,36,26,10,37
LASK Linz,8105,4,7,7,10,26,30,-4,28
Mattersburg,8105,5,7,6,11,36,41,-5,27
Vienna,8105,6,6,6,12,24,41,-17,24
SC Rheindorf,8105,7,5,6,13,18,31,-13,21
FC Salzburg,8106,1,13,8,3,43,20,23,47
SK Sturm Gra,8106,2,13,3,8,33,30,3,42
Rapid Vienna,8106,3,9,11,4,36,24,12,38
LASK Linz,8106,4,7,6,11,23,31,-8,27
SC Rheindorf,8106,5,7,5,12,25,32,-7,26
Mattersburg,8106,6,7,5,12,35,43,-8,26
Vienna,8106,7,6,6,12,24,39,-15,24
FC Salzburg,8107,1,15,6,3,44,17,27,51
Rapid Vienna,8107,2,10,10,4,37,26,11,40
SK Sturm Gra,8107,3,12,3,9,32,30,2,39
LASK Linz,8107,4,7,6,11,23,29,-6,27
SC Rheindorf,8107,5,6,7,11,21,27,-6,25
Mattersburg,8107,6,6,7,11,28,38,-10,25
Vienna,8107,7,6,5,13,23,41,-18,23
FC Salzburg,8108,1,12,8,4,41,20,21,44
SK Sturm Gra,8108,2,12,6,6,31,26,5,42
Rapid Vienna,8108,3,9,11,4,36,24,12,38
LASK Linz,8108,4,7,8,9,27,30,-3,29
Mattersburg,8108,5,7,7,10,34,40,-6,28
Vienna,8108,6,6,7,11,24,38,-14,25
SC Rheindorf,8108,7,4,7,13,16,31,-15,19
FC Salzburg,8109,1,15,6,3,44,17,27,51
SK Sturm Gra,8109,2,12,5,7,32,30,2,41
Rapid Vienna,8109,3,9,11,4,34,24,10,38
LASK Linz,8109,4,9,6,9,28,28,0,33
Vienna,8109,5,7,5,12,25,38,-13,26
Mattersburg,8109,6,6,5,13,27,40,-13,23
SC Rheindorf,8109,7,4,6,14,17,30,-13,18
FC Salzburg,8110,1,15,7,2,49,18,31,52
SK Sturm Gra,8110,2,12,4,8,32,29,3,40
Rapid Vienna,8110,3,9,11,4,38,26,12,38
LASK Linz,8110,4,9,6,9,26,26,0,33
Mattersburg,8110,5,6,6,12,31,43,-12,24
Vienna,8110,6,6,5,13,23,43,-20,23
SC Rheindorf,8110,7,4,7,13,19,33,-14,19
FC Salzburg,8111,1,14,6,4,43,19,24,48
Rapid Vienna,8111,2,9,10,5,36,27,9,37
SK Sturm Gra,8111,3,11,4,9,30,32,-2,37
LASK Linz,8111,4,9,7,8,30,28,2,34
SC Rheindorf,8111,5,7,5,12,22,26,-4,26
Mattersburg,8111,6,7,5,12,30,41,-11,26
Vienna,8111,7,6,5,13,24,42,-18,23
FC Salzburg,8112,1,14,6,4,41,19,22,48
SK Sturm Gra,8112,2,13,3,8,33,27,6,42
Rapid Vienna,8112,3,9,9,6,34,26,8,36
LASK Linz,8112,4,9,5,10,26,29,-3,32
Vienna,8112,5,8,5,11,28,38,-10,29
Mattersburg,8112,6,7,5,12,30,40,-10,26
SC Rheindorf,8112,7,5,5,14,17,30,-13,20
FC Salzburg,8113,1,14,8,2,44,17,27,50
SK Sturm Gra,8113,2,12,5,7,33,28,5,41
Rapid Vienna,8113,3,8,11,5,34,26,8,35
LASK Linz,8113,4,7,7,10,25,30,-5,28
Mattersburg,8113,5,7,5,12,30,40,-10,26
Vienna,8113,6,7,5,12,27,42,-15,26
SC Rheindorf,8113,7,5,7,12,18,28,-10,22
FC Salzburg,8114,1,13,7,4,43,20,23,46
SK Sturm Gra,8114,2,14,4,6,34,27,7,46
Rapid Vienna,8114,3,9,11,4,38,27,11,38
LASK Linz,8114,4,7,7,10,28,32,-4,28
Mattersburg,8114,5,7,6,11,33,44,-11,27
Vienna,8114,6,7,5,12,28,41,-13,26
SC Rheindorf,8114,7,4,6,14,19,32,-13,18
SK Sturm Gra,8115,1,14,4,6,34,26,8,46
FC Salzburg,8115,2,13,6,5,43,20,23,45
Rapid Vienna,8115,3,9,10,5,36,28,8,37
LASK Linz,8115,4,8,6,10,29,31,-2,30
Vienna,8115,5,7,6,11,26,39,-13,27
Mattersburg,8115,6,6,6,12,31,44,-13,24
SC Rheindorf,8115,7,4,8,12,17,28,-11,20
FC Salzburg,8116,1,15,7,2,47,18,29,52
SK Sturm Gra,8116,2,12,5,7,31,27,4,41
Rapid Vienna,8116,3,7,11,6,35,29,6,32
LASK Linz,8116,4,9,5,10,27,30,-3,32
Mattersburg,8116,5,8,5,11,31,40,-9,29
Vienna,8116,6,6,5,13,24,41,-17,23
SC Rheindorf,8116,7,5,6,13,20,30,-10,21
FC Salzburg,8117,1,14,7,3,44,19,25,49
SK Sturm Gra,8117,2,12,5,7,30,26,4,41
Rapid Vienna,8117,3,9,10,5,35,27,8,37
LASK Linz,8117,4,8,7,9,25,26,-1,31
Mattersburg,8117,5,7,5,12,32,41,-9,26
Vienna,8117,6,7,5,12,26,41,-15,26
SC Rheindorf,8117,7,4,7,13,20,32,-12,19
FC Salzburg,8118,1,13,9,2,44,18,26,48
SK Sturm Gra,8118,2,13,4,7,34,30,4,43
Rapid Vienna,8118,3,8,11,5,33,25,8,35
LASK Linz,8118,4,9,5,10,28,29,-1,32
Vienna,8118,5,7,6,11,29,39,-10,27
Mattersburg,8118,6,5,7,12,30,46,-16,22
SC Rheindorf,8118,7,5,6,13,17,28,-11,21
FC Salzburg,8119,1,16,6,2,53,20,33,54
SK Sturm Gra,8119,2,12,4,8,35,34,1,40
Rapid Vienna,8119,3,9,9,6,34,28,6,36
LASK Linz,8119,4,7,8,9,28,30,-2,29
Vienna,8119,5,7,5,12,27,40,-13,26
SC Rheindorf,8119,6,5,7,12,20,28,-8,22
Mattersburg,8119,7,5,7,12,29,46,-17,22
FC Salzburg,8120,1,13,7,4,42,21,21,46
Rapid Vienna,8120,2,9,10,5,38,27,11,37
SK Sturm Gra,8120,3,11,4,9,32,36,-4,37
LASK Linz,8120,4,8,6,10,31,30,1,30
Vienna,8120,5,8,5,11,28,37,-9,29
SC Rheindorf,8120,6,6,7,11,23,31,-8,25
Mattersburg,8120,7,6,7,11,29,41,-12,25
FC Salzburg,8121,1,14,8,2,44,16,28,50
SK Sturm Gra,8121,2,12,5,7,31,28,3,41
Rapid Vienna,8121,3,7,12,5,34,28,6,33
LASK Linz,8121,4,9,6,9,27,26,1,33
Mattersburg,8121,5,8,6,10,33,40,-7,30
Vienna,8121,6,6,5,13,25,43,-18,23
SC Rheindorf,8121,7,4,6,14,18,31,-13,18
FC Salzburg,8122,1,13,9,2,46,20,26,48
SK Sturm Gra,8122,2,12,6,6,32,27,5,42
Rapid Vienna,8122,3,8,11,5,39,30,9,35
LASK Linz,8122,4,8,5,11,29,33,-4,29
Vienna,8122,5,7,6,11,26,39,-13,27
SC Rheindorf,8122,6,6,7,11,21,29,-8,25
Mattersburg,8122,7,5,6,13,29,44,-15,21
FC Salzburg,8123,1,14,7,3,44,20,24,49
SK Sturm Gra,8123,2,12,6,6,33,28,5,42
Rapid Vienna,8123,3,8,11,5,36,26,10,35
LASK Linz,8123,4,8,8,8,27,27,0,32
Mattersburg,8123,5,6,6,12,31,41,-10,24
Vienna,8123,6,6,5,13,25,44,-19,23
SC Rheindorf,8123,7,5,7,12,19,29,-10,22
FC Salzburg,8124,1,14,8,2,43,17,26,50
Rapid Vienna,8124,2,9,11,4,34,24,10,38
SK Sturm Gra,8124,3,11,4,9,30,30,0,37
LASK Linz,8124,4,8,7,9,26,28,-2,31
Vienna,8124,5,7,6,11,25,37,-12,27
SC Rheindorf,8124,6,6,6,12,19,27,-8,24
Mattersburg,8124,7,5,6,13,28,42,-14,21
FC Salzburg,8125,1,15,6,3,45,18,27,51
SK Sturm Gra,8125,2,13,3,8,33,29,4,42
Rapid Vienna,8125,3,9,9,6,36,29,7,36
Mattersburg,8125,4,8,5,11,32,39,-7,29
LASK Linz,8125,5,7,6,11,24,32,-8,27
SC Rheindorf,8125,6,6,6,12,21,27,-6,24
Vienna,8125,7,6,5,13,24,41,-17,23
FC Salzburg,8126,1,15,7,2,45,19,26,52
Rapid Vienna,8126,2,9,11,4,38,26,12,38
SK Sturm Gra,8126,3,11,4,9,28,28,0,37
LASK Linz,8126,4,8,6,10,26,30,-4,30
Mattersburg,8126,5,6,6,12,31,39,-8,24
SC Rheindorf,8126,6,6,6,12,19,30,-11,24
Vienna,8126,7,6,6,12,26,41,-15,24
FC Salzburg,8127,1,15,7,2,47,19,28,52
SK Sturm Gra,8127,2,12,4,8,31,31,0,40
Rapid Vienna,8127,3,9,9,6,39,28,11,36
LASK Linz,8127,4,7,7,10,27,33,-6,28
Vienna,8127,5,7,5,12,25,39,-14,26
Mattersburg,8127,6,6,7,11,33,43,-10,25
SC Rheindorf,8127,7,6,5,13,21,30,-9,23
FC Salzburg,8128,1,14,6,4,43,21,22,48
SK Sturm Gra,8128,2,13,3,8,34,31,3,42
Rapid Vienna,8128,3,8,9,7,35,31,4,33
LASK Linz,8128,4,9,6,9,30,28,2,33
Mattersburg,8128,5,7,6,11,32,40,-8,27
Vienna,8128,6,7,5,12,24,38,-14,26
SC Rheindorf,8128,7,6,5,13,21,30,-9,23
FC Salzburg,8129,1,15,7,2,44,16,28,52
SK Sturm Gra,8129,2,13,3,8,35,27,8,42
Rapid Vienna,8129,3,8,10,6,34,30,4,34
LASK Linz,8129,4,7,8,9,27,31,-4,29
Vienna,8129,5,7,5,12,25,40,-15,26
Mattersburg,8129,6,6,7,11,30,40,-10,25
SC Rheindorf,8129,7,5,6,13,20,31,-11,21
FC Salzburg,8130,1,14,7,3,44,18,26,49
SK Sturm Gra,8130,2,11,5,8,29,28,1,38
Rapid Vienna,8130,3,9,9,6,39,27,12,36
Mattersburg,8130,4,9,5,10,36,37,-1,32
LASK Linz,8130,5,8,6,10,26,28,-2,30
SC Rheindorf,8130,6,6,5,13,17,31,-14,23
Vienna,8130,7,6,5,13,23,45,-22,23
FC Salzburg,8131,1,14,7,3,46,20,26,49
SK Sturm Gra,8131,2,11,6,7,32,31,1,39
Rapid Vienna,8131,3,9,10,5,37,28,9,37
LASK Linz,8131,4,8,7,9,31,31,0,31
Mattersburg,8131,5,5,9,10,34,44,-10,24
Vienna,8131,6,6,6,12,26,42,-16,24
SC Rheindorf,8131,7,5,7,12,18,28,-10,22
FC Salzburg,8132,1,15,6,3,45,20,25,51
SK Sturm Gra,8132,2,14,4,6,33,26,7,46
LASK Linz,8132,3,9,7,8,29,26,3,34
Rapid Vienna,8132,4,7,9,8,33,29,4,30
Vienna,8132,5,6,6,12,26,41,-15,24
SC Rheindorf,8132,6,5,7,12,19,29,-10,22
Mattersburg,8132,7,5,7,12,28,42,-14,22
FC Salzburg,8133,1,15,7,2,45,17,28,52
SK Sturm Gra,8133,2,11,6,7,30,27,3,39
Rapid Vienna,8133,3,8,9,7,32,29,3,33
LASK Linz,8133,4,8,6,10,26,28,-2,30
Mattersburg,8133,5,8,5,11,33,38,-5,29
SC Rheindorf,8133,6,6,6,12,19,29,-10,24
Vienna,8133,7,6,5,13,24,41,-17,23
FC Salzburg,8134,1,12,8,4,40,20,20,44
SK Sturm Gra,8134,2,13,4,7,33,26,7,43
Rapid Vienna,8134,3,9,9,6,33,28,5,36
LASK Linz,8134,4,8,5,11,27,30,-3,29
Vienna,8134,5,8,5,11,27,37,-10,29
Mattersburg,8134,6,7,6,11,33,41,-8,27
SC Rheindorf,8134,7,6,5,13,19,30,-11,23
SK Sturm Gra,8135,1,14,4,6,36,26,10,46
FC Salzburg,8135,2,12,7,5,43,24,19,43
LASK Linz,8135,3,8,8,8,30,27,3,32
Rapid Vienna,8135,4,7,11,6,33,32,1,32
Vienna,8135,5,8,5,11,29,39,-10,29
Mattersburg,8135,6,7,6,11,34,44,-10,27
SC Rheindorf,8135,7,4,7,13,19,32,-13,19
FC Salzburg,8136,1,13,7,4,41,20,21,46
SK Sturm Gra,8136,2,14,4,6,36,24,12,46
Rapid Vienna,8136,3,9,9,6,37,30,7,36
Mattersburg,8136,4,8,6,10,34,37,-3,30
LASK Linz,8136,5,8,5,11,27,34,-7,29
Vienna,8136,6,6,5,13,24,41,-17,23
SC Rheindorf,8136,7,5,6,13,20,33,-13,21
FC Salzburg,8137,1,15,6,3,44,18,26,51
SK Sturm Gra,8137,2,13,3,8,33,31,2,42
Rapid Vienna,8137,3,8,10,6,40,29,11,34
Mattersburg,8137,4,7,6,11,31,39,-8,27
LASK Linz,8137,5,7,6,11,26,34,-8,27
Vienna,8137,6,7,6,11,26,38,-12,27
SC Rheindorf,8137,7,6,5,13,17,28,-11,23
FC Salzburg,8138,1,15,6,3,46,18,28,51
SK Sturm Gra,8138,2,13,3,8,32,29,3,42
Rapid Vienna,8138,3,8,10,6,37,31,6,34
LASK Linz,8138,4,9,7,8,33,32,1,34
Vienna,8138,5,7,5,12,27,41,-14,26
SC Rheindorf,8138,6,6,5,13,21,29,-8,23
Mattersburg,8138,7,5,6,13,31,47,-16,21
FC Salzburg,8139,1,14,8,2,48,19,29,50
SK Sturm Gra,8139,2,11,6,7,34,32,2,39
Rapid Vienna,8139,3,9,11,4,37,26,11,38
LASK Linz,8139,4,8,7,9,28,29,-1,31
Vienna,8139,5,6,6,12,25,43,-18,24
SC Rheindorf,8139,6,5,7,12,20,29,-9,22
Mattersburg,8139,7,5,7,12,27,41,-14,22
FC Salzburg,8140,1,13,9,2,40,16,24,48
SK Sturm Gra,8140,2,12,4,8,31,27,4,40
Rapid Vienna,8140,3,7,11,6,32,27,5,32
LASK Linz,8140,4,8,7,9,25,28,-3,31
Mattersburg,8140,5,7,7,10,33,39,-6,28
SC Rheindorf,8140,6,6,6,12,22,30,-8,24
Vienna,8140,7,6,6,12,25,41,-16,24
FC Salzburg,8141,1,13,8,3,47,21,26,47
SK Sturm Gra,8141,2,13,3,8,35,35,0,42
Rapid Vienna,8141,3,8,10,6,36,28,8,34
LASK Linz,8141,4,9,5,10,29,31,-2,32
Mattersburg,8141,5,8,5,11,34,41,-7,29
Vienna,8141,6,6,6,12,24,40,-16,24
SC Rheindorf,8141,7,6,5,13,22,31,-9,23
FC Salzburg,8142,1,16,6,2,48,17,31,54
SK Sturm Gra,8142,2,12,4,8,31,32,-1,40
Rapid Vienna,8142,3,8,9,7,36,28,8,33
LASK Linz,8142,4,8,8,8,26,26,0,32
Mattersburg,8142,5,6,7,11,31,40,-9,25
Vienna,8142,6,6,5,13,24,42,-18,23
SC Rheindorf,8142,7,5,7,12,21,32,-11,22
FC Salzburg,8143,1,14,7,3,44,17,27,49
SK Sturm Gra,8143,2,14,4,6,32,25,7,46
Rapid Vienna,8143,3,9,9,6,37,26,11,36
LASK Linz,8143,4,8,7,9,25,26,-1,31
Mattersburg,8143,5,6,7,11,29,40,-11,25
Vienna,8143,6,6,5,13,25,44,-19,23
SC Rheindorf,8143,7,4,7,13,16,30,-14,19
FC Salzburg,8144,1,15,7,2,47,18,29,52
SK Sturm Gra,8144,2,13,4,7,36,27,9,43
Rapid Vienna,8144,3,8,9,7,33,29,4,33
LASK Linz,8144,4,9,6,9,29,32,-3,33
Vienna,8144,5,6,7,11,26,40,-14,25
Mattersburg,8144,6,5,7,12,29,43,-14,22
SC Rheindorf,8144,7,4,8,12,18,29,-11,20
FC Salzburg,8145,1,13,7,4,43,23,20,46
SK Sturm Gra,8145,2,13,5,6,31,24,7,44
Rapid Vienna,8145,3,9,10,5,38,28,10,37
LASK Linz,8145,4,8,7,9,30,31,-1,31
Vienna,8145,5,8,5,11,29,39,-10,29
Mattersburg,8145,6,6,5,13,31,45,-14,23
SC Rheindorf,8145,7,5,5,14,21,33,-12,20
FC Salzburg,8146,1,15,6,3,44,16,28,51
Rapid Vienna,8146,2,10,9,5,37,24,13,39
SK Sturm Gra,8146,3,11,4,9,30,30,0,37
LASK Linz,8146,4,7,7,10,26,31,-5,28
SC Rheindorf,8146,5,7,6,11,22,29,-7,27
Vienna,8146,6,7,5,12,25,38,-13,26
Mattersburg,8146,7,5,7,12,29,45,-16,22
FC Salzburg,8147,1,15,6,3,47,19,28,51
SK Sturm Gra,8147,2,11,5,8,30,29,1,38
Rapid Vienna,8147,3,8,10,6,35,28,7,34
LASK Linz,8147,4,8,6,10,27,30,-3,30
Mattersburg,8147,5,8,5,11,35,43,-8,29
Vienna,8147,6,7,5,12,25,40,-15,26
SC Rheindorf,8147,7,5,7,12,18,28,-10,22
FC Salzburg,8148,1,16,6,2,44,15,29,54
SK Sturm Gra,8148,2,13,4,7,34,28,6,43
Rapid Vienna,8148,3,8,11,5,35,27,8,35
LASK Linz,8148,4,7,7,10,25,31,-6,28
Mattersburg,8148,5,7,5,12,32,39,-7,26
Vienna,8148,6,6,5,13,23,40,-17,23
SC Rheindorf,8148,7,5,6,13,17,30,-13,21
FC Salzburg,8149,1,16,6,2,45,17,28,54
Rapid Vienna,8149,2,10,9,5,40,28,12,39
SK Sturm Gra,8149,3,11,4,9,29,29,0,37
LASK Linz,8149,4,7,7,10,25,30,-5,28
SC Rheindorf,8149,5,7,5,12,22,30,-8,26
Vienna,8149,6,7,5,12,26,38,-12,26
Mattersburg,8149,7,5,6,13,29,44,-15,21
FC Salzburg,8150,1,15,6,3,46,21,25,51
SK Sturm Gra,8150,2,14,3,7,35,29,6,45
Rapid Vienna,8150,3,7,11,6,36,30,6,32
Vienna,8150,4,8,5,11,28,38,-10,29
LASK Linz,8150,5,7,6,11,24,29,-5,27
Mattersburg,8150,6,6,6,12,32,44,-12,24
SC Rheindorf,8150,7,5,7,12,19,29,-10,22
FC Salzburg,8151,1,14,6,4,45,18,27,48
SK Sturm Gra,8151,2,13,3,8,32,29,3,42
Rapid Vienna,8151,3,10,9,5,38,28,10,39
LASK Linz,8151,4,9,5,10,29,29,0,32
Vienna,8151,5,7,6,11,26,38,-12,27
SC Rheindorf,8151,6,6,5,13,21,30,-9,23
Mattersburg,8151,7,5,6,13,27,46,-19,21
FC Salzburg,8152,1,14,8,2,45,19,26,50
SK Sturm Gra,8152,2,12,6,6,32,27,5,42
Rapid Vienna,8152,3,8,12,4,35,26,9,36
LASK Linz,8152,4,7,6,11,28,34,-6,27
Vienna,8152,5,7,5,12,26,40,-14,26
SC Rheindorf,8152,6,6,7,11,20,26,-6,25
Mattersburg,8152,7,5,6,13,29,43,-14,21
FC Salzburg,8153,1,15,7,2,46,16,30,52
SK Sturm Gra,8153,2,14,3,7,33,26,7,45
Rapid Vienna,8153,3,8,9,7,33,31,2,33
LASK Linz,8153,4,8,5,11,27,29,-2,29
Vienna,8153,5,7,6,11,25,38,-13,27
Mattersburg,8153,6,6,6,12,30,43,-13,24
SC Rheindorf,8153,7,5,6,13,18,29,-11,21
FC Salzburg,8154,1,15,6,3,45,17,28,51
SK Sturm Gra,8154,2,12,3,9,32,30,2,39
Rapid Vienna,8154,3,9,10,5,38,27,11,37
LASK Linz,8154,4,8,6,10,29,34,-5,30
SC Rheindorf,8154,5,7,6,11,22,29,-7,27
Vienna,8154,6,7,5,12,27,42,-15,26
Mattersburg,8154,7,5,6,13,33,47,-14,21
FC Salzburg,8155,1,13,7,4,46,23,23,46
SK Sturm Gra,8155,2,13,5,6,34,25,9,44
Rapid Vienna,8155,3,9,10,5,42,33,9,37
LASK Linz,8155,4,8,6,10,26,29,-3,30
Mattersburg,8155,5,7,5,12,30,43,-13,26
Vienna,8155,6,6,6,12,25,40,-15,24
SC Rheindorf,8155,7,5,7,12,18,28,-10,22
FC Salzburg,8156,1,16,6,2,51,15,36,54
SK Sturm Gra,8156,2,13,3,8,32,29,3,42
LASK Linz,8156,3,9,5,10,28,32,-4,32
Rapid Vienna,8156,4,7,10,7,32,30,2,31
Vienna,8156,5,7,5,12,26,39,-13,26
Mattersburg,8156,6,6,6,12,31,45,-14,24
SC Rheindorf,8156,7,5,7,12,17,27,-10,22
FC Salzburg,8157,1,13,7,4,44,23,21,46
SK Sturm Gra,8157,2,12,4,8,32,30,2,40
Rapid Vienna,8157,3,10,9,5,39,25,14,39
LASK Linz,8157,4,8,6,10,28,29,-1,30
Vienna,8157,5,8,5,11,30,39,-9,29
Mattersburg,8157,6,6,6,12,32,46,-14,24
SC Rheindorf,8157,7,6,5,13,19,32,-13,23
FC Salzburg,8158,1,13,7,4,44,19,25,46
SK Sturm Gra,8158,2,13,3,8,33,32,1,42
Rapid Vienna,8158,3,9,9,6,36,28,8,36
LASK Linz,8158,4,10,6,8,31,28,3,36
Mattersburg,8158,5,7,6,11,29,39,-10,27
Vienna,8158,6,7,6,11,25,37,-12,27
SC Rheindorf,8158,7,4,5,15,20,35,-15,17
FC Salzburg,8159,1,14,6,4,46,19,27,48
SK Sturm Gra,8159,2,13,4,7,35,29,6,43
Rapid Vienna,8159,3,9,10,5,37,28,9,37
LASK Linz,8159,4,8,5,11,27,32,-5,29
Mattersburg,8159,5,8,5,11,34,41,-7,29
SC Rheindorf,8159,6,6,5,13,19,28,-9,23
Vienna,8159,7,6,5,13,24,45,-21,23
FC Salzburg,8160,1,14,8,2,45,18,27,50
SK Sturm Gra,8160,2,12,3,9,34,34,0,39
LASK Linz,8160,3,10,5,9,28,28,0,35
Rapid Vienna,8160,4,7,10,7,33,29,4,31
Vienna,8160,5,7,6,11,27,40,-13,27
Mattersburg,8160,6,6,7,11,31,40,-9,25
SC Rheindorf,8160,7,5,7,12,19,28,-9,22
FC Salzburg,8161,1,14,8,2,48,19,29,50
SK Sturm Gra,8161,2,13,5,6,33,26,7,44
Rapid Vienna,8161,3,8,10,6,33,28,5,34
LASK Linz,8161,4,9,6,9,29,29,0,33
Vienna,8161,5,7,5,12,27,41,-14,26
Mattersburg,8161,6,5,7,12,30,45,-15,22
SC Rheindorf,8161,7,5,5,14,17,29,-12,20
FC Salzburg,8162,1,15,7,2,44,18,26,52
SK Sturm Gra,8162,2,14,3,7,37,27,10,45
LASK Linz,8162,3,10,5,9,27,27,0,35
Rapid Vienna,8162,4,7,11,6,34,29,5,32
Vienna,8162,5,6,6,12,24,39,-15,24
SC Rheindorf,8162,6,5,6,13,17,28,-11,21
Mattersburg,8162,7,5,6,13,27,42,-15,21
FC Salzburg,8163,1,15,7,2,44,17,27,52
SK Sturm Gra,8163,2,13,3,8,37,32,5,42
Rapid Vienna,8163,3,7,12,5,34,29,5,33
LASK Linz,8163,4,8,7,9,30,30,0,31
Vienna,8163,5,7,5,12,26,40,-14,26
Mattersburg,8163,6,6,6,12,31,42,-11,24
SC Rheindorf,8163,7,5,6,13,18,30,-12,21
FC Salzburg,8164,1,15,6,3,47,19,28,51
SK Sturm Gra,8164,2,13,3,8,37,26,11,42
Rapid Vienna,8164,3,8,10,6,34,31,3,34
Mattersburg,8164,4,8,6,10,33,40,-7,30
LASK Linz,8164,5,7,6,11,24,31,-7,27
Vienna,8164,6,6,6,12,24,41,-17,24
SC Rheindorf,8164,7,6,5,13,19,30,-11,23
FC Salzburg,8165,1,15,6,3,45,20,25,51
SK Sturm Gra,8165,2,11,6,7,32,29,3,39
Rapid Vienna,8165,3,9,11,4,37,25,12,38
LASK Linz,8165,4,8,8,8,29,27,2,32
Mattersburg,8165,5,6,5,13,28,43,-15,23
Vienna,8165,6,6,5,13,24,41,-17,23
SC Rheindorf,8165,7,5,7,12,19,29,-10,22
FC Salzburg,8166,1,14,7,3,43,18,25,49
SK Sturm Gra,8166,2,12,6,6,34,28,6,42
LASK Linz,8166,3,9,6,9,28,28,0,33
Rapid Vienna,8166,4,7,10,7,34,30,4,31
Mattersburg,8166,5,7,6,11,30,39,-9,27
Vienna,8166,6,7,5,12,25,40,-15,26
SC Rheindorf,8166,7,4,8,12,18,29,-11,20
SK Sturm Gra,8167,1,15,3,6,34,26,8,48
FC Salzburg,8167,2,13,6,5,43,23,20,45
Rapid Vienna,8167,3,8,10,6,37,28,9,34
Mattersburg,8167,4,8,5,11,32,39,-7,29
LASK Linz,8167,5,7,7,10,27,32,-5,28
Vienna,8167,6,7,5,12,26,40,-14,26
SC Rheindorf,8167,7,5,6,13,19,30,-11,21
FC Salzburg,8168,1,14,7,3,45,19,26,49
SK Sturm Gra,8168,2,13,3,8,33,31,2,42
Rapid Vienna,8168,3,9,10,5,36,25,11,37
LASK Linz,8168,4,9,5,10,29,29,0,32
Vienna,8168,5,7,6,11,26,38,-12,27
Mattersburg,8168,6,6,5,13,31,47,-16,23
SC Rheindorf,8168,7,5,6,13,21,32,-11,21
FC Salzburg,8169,1,15,7,2,45,17,28,52
SK Sturm Gra,8169,2,13,4,7,35,28,7,43
Rapid Vienna,8169,3,8,10,6,37,28,9,34
SC Rheindorf,8169,4,7,6,11,23,30,-7,27
LASK Linz,8169,5,7,6,11,26,34,-8,27
Vienna,8169,6,6,6,12,25,41,-16,24
Mattersburg,8169,7,5,7,12,29,42,-13,22
FC Salzburg,8170,1,14,7,3,46,21,25,49
SK Sturm Gra,8170,2,12,6,6,37,31,6,42
Rapid Vienna,8170,3,9,11,4,40,29,11,38
LASK Linz,8170,4,8,7,9,28,30,-2,31
Mattersburg,8170,5,7,6,11,34,43,-9,27
Vienna,8170,6,6,5,13,26,43,-17,23
SC Rheindorf,8170,7,4,6,14,18,32,-14,18
FC Salzburg,8171,1,15,7,2,50,18,32,52
SK Sturm Gra,8171,2,12,4,8,31,31,0,40
LASK Linz,8171,3,9,6,9,29,29,0,33
Rapid Vienna,8171,4,7,10,7,33,29,4,31
Vienna,8171,5,7,5,12,27,44,-17,26
SC Rheindorf,8171,6,6,7,11,19,26,-7,25
Mattersburg,8171,7,5,7,12,32,44,-12,22
FC Salzburg,8172,1,15,7,2,50,20,30,52
SK Sturm Gra,8172,2,14,3,7,37,28,9,45
Rapid Vienna,8172,3,8,10,6,35,27,8,34
LASK Linz,8172,4,9,5,10,28,31,-3,32
Mattersburg,8172,5,6,6,12,29,42,-13,24
Vienna,8172,6,6,5,13,23,42,-19,23
SC Rheindorf,8172,7,5,6,13,22,34,-12,21
FC Salzburg,8173,1,15,7,2,46,19,27,52
SK Sturm Gra,8173,2,13,3,8,34,30,4,42
Rapid Vienna,8173,3,9,10,5,39,29,10,37
Mattersburg,8173,4,7,6,11,34,43,-9,27
LASK Linz,8173,5,7,5,12,25,33,-8,26
Vienna,8173,6,7,5,12,27,39,-12,26
SC Rheindorf,8173,7,5,6,13,20,32,-12,21
FC Salzburg,8174,1,14,6,4,45,20,25,48
SK Sturm Gra,8174,2,12,4,8,32,30,2,40
Rapid Vienna,8174,3,9,9,6,39,31,8,36
LASK Linz,8174,4,9,6,9,33,32,1,33
Vienna,8174,5,7,6,11,29,42,-13,27
SC Rheindorf,8174,6,6,6,12,21,28,-7,24
Mattersburg,8174,7,5,7,12,32,48,-16,22
FC Salzburg,8175,1,14,8,2,50,21,29,50
SK Sturm Gra,8175,2,13,3,8,35,29,6,42
Rapid Vienna,8175,3,8,11,5,34,27,7,35
LASK Linz,8175,4,8,6,10,28,32,-4,30
Mattersburg,8175,5,7,6,11,35,45,-10,27
Vienna,8175,6,6,6,12,26,42,-16,24
SC Rheindorf,8175,7,5,6,13,17,29,-12,21
FC Salzburg,8176,1,15,6,3,50,20,30,51
Rapid Vienna,8176,2,11,9,4,41,27,14,42
SK Sturm Gra,8176,3,12,3,9,34,31,3,39
LASK Linz,8176,4,8,6,10,27,29,-2,30
Vienna,8176,5,7,5,12,25,42,-17,26
Mattersburg,8176,6,6,6,12,29,43,-14,24
SC Rheindorf,8176,7,4,7,13,20,34,-14,19
FC Salzburg,8177,1,15,7,2,50,20,30,52
SK Sturm Gra,8177,2,13,3,8,40,31,9,42
Rapid Vienna,8177,3,8,9,7,36,36,0,33
LASK Linz,8177,4,9,5,10,27,35,-8,32
Mattersburg,8177,5,6,7,11,33,42,-9,25
Vienna,8177,6,6,7,11,24,38,-14,25
SC Rheindorf,8177,7,5,6,13,21,29,-8,21
FC Salzburg,8178,1,14,7,3,44,21,23,49
SK Sturm Gra,8178,2,12,6,6,33,27,6,42
Rapid Vienna,8178,3,9,11,4,38,25,13,38
Mattersburg,8178,4,8,5,11,36,41,-5,29
LASK Linz,8178,5,7,6,11,25,33,-8,27
Vienna,8178,6,6,5,13,26,44,-18,23
SC Rheindorf,8178,7,4,8,12,19,30,-11,20
FC Salzburg,8179,1,13,8,3,43,20,23,47
SK Sturm Gra,8179,2,13,5,6,35,26,9,44
Rapid Vienna,8179,3,7,11,6,36,34,2,32
LASK Linz,8179,4,8,5,11,26,31,-5,29
Mattersburg,8179,5,8,5,11,33,39,-6,29
SC Rheindorf,8179,6,6,6,12,25,31,-6,24
Vienna,8179,7,6,6,12,24,41,-17,24
FC Salzburg,8180,1,15,6,3,42,20,22,51
SK Sturm Gra,8180,2,13,4,7,30,25,5,43
Rapid Vienna,8180,3,10,9,5,37,24,13,39
LASK Linz,8180,4,7,7,10,25,28,-3,28
Mattersburg,8180,5,6,7,11,32,41,-9,25
Vienna,8180,6,6,6,12,25,40,-15,24
SC Rheindorf,8180,7,4,7,13,16,29,-13,19
FC Salzburg,8181,1,13,9,2,44,18,26,48
SK Sturm Gra,8181,2,13,4,7,30,25,5,43
Rapid Vienna,8181,3,9,9,6,38,29,9,36
LASK Linz,8181,4,10,5,9,29,27,2,35
Vienna,8181,5,7,6,11,25,37,-12,27
Mattersburg,8181,6,5,7,12,31,45,-14,22
SC Rheindorf,8181,7,4,6,14,17,33,-16,18
FC Salzburg,8182,1,15,7,2,51,17,34,52
SK Sturm Gra,8182,2,13,3,8,34,28,6,42
Rapid Vienna,8182,3,9,9,6,36,34,2,36
LASK Linz,8182,4,8,6,10,30,32,-2,30
Mattersburg,8182,5,6,6,12,31,45,-14,24
Vienna,8182,6,6,6,12,24,39,-15,24
SC Rheindorf,8182,7,6,5,13,21,32,-11,23
FC Salzburg,8183,1,15,6,3,46,17,29,51
SK Sturm Gra,8183,2,13,5,6,36,29,7,44
Rapid Vienna,8183,3,7,9,8,33,33,0,30
LASK Linz,8183,4,8,6,10,28,31,-3,30
Mattersburg,8183,5,7,6,11,31,37,-6,27
SC Rheindorf,8183,6,6,6,12,22,32,-10,24
Vienna,8183,7,6,6,12,23,40,-17,24
FC Salzburg,8184,1,15,7,2,45,16,29,52
SK Sturm Gra,8184,2,14,3,7,34,26,8,45
LASK Linz,8184,3,9,5,10,28,28,0,32
Rapid Vienna,8184,4,7,10,7,33,30,3,31
SC Rheindorf,8184,5,7,5,12,19,27,-8,26
Vienna,8184,6,7,5,12,27,42,-15,26
Mattersburg,8184,7,5,5,14,27,44,-17,20
FC Salzburg,8185,1,13,8,3,43,19,24,47
SK Sturm Gra,8185,2,12,5,7,31,27,4,41
Rapid Vienna,8185,3,8,11,5,34,26,8,35
LASK Linz,8185,4,8,7,9,26,28,-2,31
Vienna,8185,5,7,5,12,24,39,-15,26
Mattersburg,8185,6,6,7,11,31,40,-9,25
SC Rheindorf,8185,7,6,5,13,20,30,-10,23
FC Salzburg,8186,1,15,7,2,48,20,28,52
Rapid Vienna,8186,2,9,11,4,43,31,12,38
SK Sturm Gra,8186,3,11,4,9,32,34,-2,37
LASK Linz,8186,4,8,6,10,27,29,-2,30
Vienna,8186,5,7,5,12,25,38,-13,26
SC Rheindorf,8186,6,5,8,11,22,31,-9,23
Mattersburg,8186,7,5,7,12,29,43,-14,22
FC Salzburg,8187,1,15,7,2,50,17,33,52
SK Sturm Gra,8187,2,12,5,7,31,27,4,41
LASK Linz,8187,3,9,7,8,29,28,1,34
Rapid Vienna,8187,4,7,11,6,36,30,6,32
Vienna,8187,5,7,5,12,26,40,-14,26
Mattersburg,8187,6,6,5,13,29,48,-19,23
SC Rheindorf,8187,7,5,6,13,18,29,-11,21
FC Salzburg,8188,1,14,6,4,42,20,22,48
SK Sturm Gra,8188,2,12,4,8,35,29,6,40
Rapid Vienna,8188,3,8,12,4,40,30,10,36
LASK Linz,8188,4,10,6,8,33,31,2,36
Vienna,8188,5,7,5,12,26,41,-15,26
Mattersburg,8188,6,6,6,12,34,44,-10,24
SC Rheindorf,8188,7,4,7,13,22,37,-15,19
FC Salzburg,8189,1,16,6,2,49,18,31,54
SK Sturm Gra,8189,2,12,3,9,29,29,0,39
Rapid Vienna,8189,3,8,10,6,36,30,6,34
LASK Linz,8189,4,8,5,11,24,29,-5,29
Mattersburg,8189,5,7,6,11,32,39,-7,27
SC Rheindorf,8189,6,6,6,12,21,29,-8,24
Vienna,8189,7,6,6,12,25,42,-17,24
FC Salzburg,8190,1,13,8,3,42,18,24,47
Rapid Vienna,8190,2,11,9,4,40,25,15,42
SK Sturm Gra,8190,3,12,3,9,30,29,1,39
LASK Linz,8190,4,7,6,11,25,31,-6,27
Vienna,8190,5,7,6,11,26,38,-12,27
Mattersburg,8190,6,6,6,12,32,43,-11,24
SC Rheindorf,8190,7,6,6,12,21,32,-11,24
FC Salzburg,8191,1,14,7,3,42,17,25,49
SK Sturm Gra,8191,2,13,4,7,37,31,6,43
LASK Linz,8191,3,9,7,8,34,29,5,34
Rapid Vienna,8191,4,7,11,6,35,31,4,32
Vienna,8191,5,8,5,11,26,38,-12,29
Mattersburg,8191,6,5,7,12,28,41,-13,22
SC Rheindorf,8191,7,4,7,13,18,33,-15,19
FC Salzburg,8192,1,13,7,4,47,22,25,46
SK Sturm Gra,8192,2,14,3,7,34,27,7,45
LASK Linz,8192,3,9,6,9,28,27,1,33
Rapid Vienna,8192,4,7,11,6,34,30,4,32
Vienna,8192,5,8,5,11,27,37,-10,29
SC Rheindorf,8192,6,5,7,12,18,28,-10,22
Mattersburg,8192,7,5,7,12,27,44,-17,22
FC Salzburg,8193,1,16,6,2,49,18,31,54
SK Sturm Gra,8193,2,13,3,8,34,28,6,42
Rapid Vienna,8193,3,8,9,7,34,30,4,33
LASK Linz,8193,4,8,6,10,25,29,-4,30
Mattersburg,8193,5,6,7,11,30,41,-11,25
SC Rheindorf,8193,6,6,6,12,19,28,-9,24
Vienna,8193,7,6,5,13,23,40,-17,23
FC Salzburg,8194,1,15,7,2,47,20,27,52
SK Sturm Gra,8194,2,13,4,7,33,26,7,43
Rapid Vienna,8194,3,8,11,5,36,27,9,35
LASK Linz,8194,4,8,6,10,28,32,-4,30
Mattersburg,8194,5,7,5,12,36,44,-8,26
Vienna,8194,6,6,5,13,24,44,-20,23
SC Rheindorf,8194,7,4,8,12,17,28,-11,20
FC Salzburg,8195,1,14,8,2,46,18,28,50
SK Sturm Gra,8195,2,12,3,9,31,30,1,39
LASK Linz,8195,3,11,5,8,28,24,4,38
Rapid Vienna,8195,4,8,10,6,34,27,7,34
Vienna,8195,5,6,6,12,27,43,-16,24
Mattersburg,8195,6,5,8,11,33,44,-11,23
SC Rheindorf,8195,7,5,6,13,21,34,-13,21
FC Salzburg,8196,1,13,7,4,44,22,22,46
SK Sturm Gra,8196,2,13,4,7,33,31,2,43
Rapid Vienna,8196,3,9,10,5,41,28,13,37
LASK Linz,8196,4,7,8,9,27,30,-3,29
Vienna,8196,5,7,6,11,28,41,-13,27
Mattersburg,8196,6,6,8,10,36,44,-8,26
SC Rheindorf,8196,7,4,7,13,19,32,-13,19
FC Salzburg,8197,1,14,7,3,46,19,27,49
SK Sturm Gra,8197,2,13,4,7,35,31,4,43
Rapid Vienna,8197,3,9,9,6,38,31,7,36
LASK Linz,8197,4,8,6,10,27,29,-2,30
Mattersburg,8197,5,7,5,12,30,41,-11,26
Vienna,8197,6,6,6,12,23,39,-16,24
SC Rheindorf,8197,7,6,5,13,22,31,-9,23
FC Salzburg,8198,1,14,8,2,44,17,27,50
SK Sturm Gra,8198,2,12,4,8,32,30,2,40
Rapid Vienna,8198,3,10,9,5,42,29,13,39
Mattersburg,8198,4,7,6,11,33,44,-11,27
LASK Linz,8198,5,7,5,12,28,33,-5,26
SC Rheindorf,8198,6,6,6,12,22,33,-11,24
Vienna,8198,7,6,6,12,26,41,-15,24
FC Salzburg,8199,1,15,7,2,45,18,27,52
SK Sturm Gra,8199,2,11,5,8,31,30,1,38
Rapid Vienna,8199,3,9,9,6,36,28,8,36
LASK Linz,8199,4,9,6,9,28,28,0,33
Vienna,8199,5,7,6,11,25,38,-13,27
Mattersburg,8199,6,7,5,12,29,39,-10,26
SC Rheindorf,8199,7,4,6,14,18,31,-13,18
FC Salzburg,8200,1,14,8,2,42,17,25,50
SK Sturm Gra,8200,2,12,4,8,33,30,3,40
Rapid Vienna,8200,3,8,9,7,35,31,4,33
LASK Linz,8200,4,8,6,10,31,31,0,30
Mattersburg,8200,5,6,8,10,30,38,-8,26
Vienna,8200,6,6,7,11,27,41,-14,25
SC Rheindorf,8200,7,6,6,12,21,31,-10,24
FC Salzburg,8201,1,15,7,2,45,17,28,52
SK Sturm Gra,8201,2,11,4,9,28,28,0,37
LASK Linz,8201,3,10,6,8,29,26,3,36
Rapid Vienna,8201,4,8,11,5,33,26,7,35
Vienna,8201,5,7,5,12,26,40,-14,26
Mattersburg,8201,6,6,5,13,31,43,-12,23
SC Rheindorf,8201,7,5,6,13,17,29,-12,21
FC Salzburg,8202,1,14,7,3,43,20,23,49
SK Sturm Gra,8202,2,11,5,8,33,31,2,38
LASK Linz,8202,3,9,6,9,29,30,-1,33
Rapid Vienna,8202,4,7,11,6,34,28,6,32
Vienna,8202,5,8,5,11,28,38,-10,29
SC Rheindorf,8202,6,7,5,12,21,28,-7,26
Mattersburg,8202,7,6,5,13,30,43,-13,23
FC Salzburg,8203,1,12,6,6,40,23,17,42
SK Sturm Gra,8203,2,13,3,8,32,30,2,42
Rapid Vienna,8203,3,10,10,4,42,27,15,40
LASK Linz,8203,4,7,7,10,25,30,-5,28
Mattersburg,8203,5,7,7,10,31,37,-6,28
Vienna,8203,6,7,5,12,25,39,-14,26
SC Rheindorf,8203,7,5,8,11,17,26,-9,23
FC Salzburg,8204,1,14,6,4,45,20,25,48
SK Sturm Gra,8204,2,13,3,8,33,31,2,42
Rapid Vienna,8204,3,10,9,5,36,25,11,39
Mattersburg,8204,4,8,6,10,35,39,-4,30
LASK Linz,8204,5,8,5,11,25,31,-6,29
Vienna,8204,6,6,6,12,24,39,-15,24
SC Rheindorf,8204,7,5,5,14,18,31,-13,20
FC Salzburg,8205,1,14,8,2,45,18,27,50
SK Sturm Gra,8205,2,13,4,7,33,26,7,43
Rapid Vienna,8205,3,9,11,4,35,25,10,38
LASK Linz,8205,4,8,6,10,26,28,-2,30
Vienna,8205,5,7,5,12,26,39,-13,26
Mattersburg,8205,6,6,5,13,29,44,-15,23
SC Rheindorf,8205,7,5,5,14,20,34,-14,20
FC Salzburg,8206,1,14,7,3,43,19,24,49
LASK Linz,8206,2,11,5,8,34,27,7,38
SK Sturm Gra,8206,3,11,4,9,32,34,-2,37
Rapid Vienna,8206,4,8,10,6,35,29,6,34
Vienna,8206,5,7,6,11,25,37,-12,27
Mattersburg,8206,6,6,6,12,29,40,-11,24
SC Rheindorf,8206,7,4,8,12,18,30,-12,20
FC Salzburg,8207,1,14,7,3,44,19,25,49
SK Sturm Gra,8207,2,13,3,8,32,29,3,42
Rapid Vienna,8207,3,8,9,7,36,29,7,33
LASK Linz,8207,4,8,5,11,27,29,-2,29
Vienna,8207,5,7,6,11,25,38,-13,27
SC Rheindorf,8207,6,7,5,12,21,30,-9,26
Mattersburg,8207,7,6,7,11,31,42,-11,25
FC Salzburg,8208,1,14,7,3,45,21,24,49
SK Sturm Gra,8208,2,11,7,6,35,31,4,40
Rapid Vienna,8208,3,8,10,6,35,29,6,34
LASK Linz,8208,4,8,7,9,29,30,-1,31
Vienna,8208,5,7,6,11,27,40,-13,27
Mattersburg,8208,6,5,8,11,32,43,-11,23
SC Rheindorf,8208,7,5,7,12,21,30,-9,22
FC Salzburg,8209,1,14,8,2,45,18,27,50
SK Sturm Gra,8209,2,12,4,8,32,30,2,40
Rapid Vienna,8209,3,9,9,6,34,27,7,36
LASK Linz,8209,4,9,5,10,26,26,0,32
Mattersburg,8209,5,7,7,10,30,38,-8,28
Vienna,8209,6,6,6,12,23,39,-16,24
SC Rheindorf,8209,7,5,5,14,20,32,-12,20
FC Salzburg,8210,1,16,6,2,48,17,31,54
SK Sturm Gra,8210,2,12,5,7,29,26,3,41
Rapid Vienna,8210,3,9,10,5,34,27,7,37
LASK Linz,8210,4,8,7,9,25,26,-1,31
Vienna,8210,5,7,5,12,28,39,-11,26
SC Rheindorf,8210,6,5,6,13,19,29,-10,21
Mattersburg,8210,7,5,5,14,27,46,-19,20
FC Salzburg,8211,1,15,6,3,44,20,24,51
SK Sturm Gra,8211,2,14,3,7,34,25,9,45
Rapid Vienna,8211,3,9,10,5,38,28,10,37
LASK Linz,8211,4,7,8,9,26,29,-3,29
Mattersburg,8211,5,7,6,11,33,42,-9,27
Vienna,8211,6,6,5,13,26,42,-16,23
SC Rheindorf,8211,7,4,6,14,16,31,-15,18
FC Salzburg,8212,1,14,6,4,43,20,23,48
SK Sturm Gra,8212,2,13,3,8,32,27,5,42
Rapid Vienna,8212,3,10,9,5,40,25,15,39
LASK Linz,8212,4,9,5,10,27,31,-4,32
Mattersburg,8212,5,6,7,11,32,42,-10,25
Vienna,8212,6,6,6,12,25,40,-15,24
SC Rheindorf,8212,7,5,6,13,18,32,-14,21
FC Salzburg,8213,1,13,7,4,46,25,21,46
SK Sturm Gra,8213,2,13,4,7,35,30,5,43
Rapid Vienna,8213,3,9,10,5,37,27,10,37
LASK Linz,8213,4,8,5,11,26,31,-5,29
Mattersburg,8213,5,7,6,11,36,44,-8,27
Vienna,8213,6,7,6,11,29,41,-12,27
SC Rheindorf,8213,7,5,6,13,22,33,-11,21
FC Salzburg,8214,1,13,7,4,43,25,18,46
Rapid Vienna,8214,2,10,10,4,43,28,15,40
SK Sturm Gra,8214,3,11,4,9,30,29,1,37
LASK Linz,8214,4,10,5,9,31,30,1,35
Vienna,8214,5,8,5,11,27,38,-11,29
Mattersburg,8214,6,6,5,13,30,43,-13,23
SC Rheindorf,8214,7,5,6,13,19,30,-11,21
FC Salzburg,8215,1,15,6,3,47,20,27,51
SK Sturm Gra,8215,2,14,3,7,36,29,7,45
Rapid Vienna,8215,3,9,9,6,35,28,7,36
LASK Linz,8215,4,8,7,9,31,31,0,31
Vienna,8215,5,7,5,12,29,41,-12,26
SC Rheindorf,8215,6,5,6,13,19,31,-12,21
Mattersburg,8215,7,5,6,13,31,48,-17,21
FC Salzburg,8216,1,14,7,3,46,18,28,49
SK Sturm Gra,8216,2,13,4,7,33,28,5,43
Rapid Vienna,8216,3,10,9,5,39,28,11,39
LASK Linz,8216,4,8,6,10,29,31,-2,30
Mattersburg,8216,5,6,7,11,31,44,-13,25
Vienna,8216,6,6,6,12,24,40,-16,24
SC Rheindorf,8216,7,5,5,14,18,31,-13,20
FC Salzburg,8217,1,15,6,3,42,16,26,51
SK Sturm Gra,8217,2,13,3,8,32,28,4,42
Rapid Vienna,8217,3,8,10,6,33,26,7,34
LASK Linz,8217,4,9,7,8,30,29,1,34
Vienna,8217,5,7,5,12,26,41,-15,26
Mattersburg,8217,6,6,5,13,33,44,-11,23
SC Rheindorf,8217,7,5,6,13,17,29,-12,21
FC Salzburg,8218,1,14,8,2,45,17,28,50
SK Sturm Gra,8218,2,13,4,7,32,29,3,43
Rapid Vienna,8218,3,8,9,7,35,30,5,33
LASK Linz,8218,4,7,6,11,24,30,-6,27
Vienna,8218,5,7,6,11,25,37,-12,27
SC Rheindorf,8218,6,7,5,12,22,28,-6,26
Mattersburg,8218,7,6,6,12,29,41,-12,24
FC Salzburg,8219,1,13,7,4,42,20,22,46
SK Sturm Gra,8219,2,12,3,9,32,30,2,39
Rapid Vienna,8219,3,9,10,5,35,26,9,37
LASK Linz,8219,4,9,5,10,29,30,-1,32
Vienna,8219,5,7,6,11,27,40,-13,27
Mattersburg,8219,6,7,5,12,33,43,-10,26
SC Rheindorf,8219,7,6,6,12,18,27,-9,24
FC Salzburg,8220,1,14,7,3,46,22,24,49
SK Sturm Gra,8220,2,11,6,7,30,29,1,39
Rapid Vienna,8220,3,9,10,5,39,28,11,37
LASK Linz,8220,4,9,6,9,27,27,0,33
Mattersburg,8220,5,7,6,11,33,40,-7,27
Vienna,8220,6,6,6,12,24,40,-16,24
SC Rheindorf,8220,7,4,7,13,17,30,-13,19
FC Salzburg,8221,1,15,6,3,49,20,29,51
SK Sturm Gra,8221,2,12,3,9,32,30,2,39
LASK Linz,8221,3,11,5,8,31,25,6,38
Rapid Vienna,8221,4,8,9,7,33,32,1,33
Mattersburg,8221,5,7,5,12,32,43,-11,26
Vienna,8221,6,7,5,12,25,40,-15,26
SC Rheindorf,8221,7,5,5,14,19,31,-12,20
FC Salzburg,8222,1,14,7,3,45,20,25,49
SK Sturm Gra,8222,2,12,4,8,32,30,2,40
LASK Linz,8222,3,10,5,9,28,26,2,35
Rapid Vienna,8222,4,7,11,6,35,30,5,32
SC Rheindorf,8222,5,7,5,12,21,28,-7,26
Vienna,8222,6,7,5,12,26,40,-14,26
Mattersburg,8222,7,6,5,13,29,42,-13,23
FC Salzburg,8223,1,14,6,4,44,18,26,48
SK Sturm Gra,8223,2,12,4,8,31,28,3,40
Rapid Vienna,8223,3,8,10,6,36,30,6,34
LASK Linz,8223,4,9,7,8,31,29,2,34
Mattersburg,8223,5,7,6,11,31,40,-9,27
Vienna,8223,6,7,5,12,25,42,-17,26
SC Rheindorf,8223,7,4,8,12,16,27,-11,20
FC Salzburg,8224,1,14,6,4,41,19,22,48
SK Sturm Gra,8224,2,11,6,7,33,31,2,39
Rapid Vienna,8224,3,9,11,4,36,26,10,38
LASK Linz,8224,4,8,8,8,32,28,4,32
Vienna,8224,5,7,5,12,25,39,-14,26
Mattersburg,8224,6,6,6,12,32,45,-13,24
SC Rheindorf,8224,7,4,8,12,19,30,-11,20
FC Salzburg,8225,1,15,6,3,43,17,26,51
SK Sturm Gra,8225,2,12,4,8,29,26,3,40
Rapid Vienna,8225,3,9,9,6,34,26,8,36
LASK Linz,8225,4,8,6,10,26,29,-3,30
Vienna,8225,5,7,6,11,26,39,-13,27
Mattersburg,8225,6,6,6,12,30,42,-12,24
SC Rheindorf,8225,7,6,5,13,18,27,-9,23
FC Salzburg,8226,1,14,7,3,46,17,29,49
SK Sturm Gra,8226,2,12,4,8,30,30,0,40
Rapid Vienna,8226,3,8,10,6,34,27,7,34
LASK Linz,8226,4,9,5,10,31,30,1,32
Mattersburg,8226,5,7,6,11,35,46,-11,27
Vienna,8226,6,7,6,11,28,41,-13,27
SC Rheindorf,8226,7,5,6,13,20,33,-13,21
FC Salzburg,8227,1,15,7,2,43,17,26,52
SK Sturm Gra,8227,2,12,5,7,33,29,4,41
Rapid Vienna,8227,3,7,12,5,31,24,7,33
LASK Linz,8227,4,7,8,9,25,29,-4,29
Mattersburg,8227,5,7,5,12,34,45,-11,26
Vienna,8227,6,6,6,12,24,40,-16,24
SC Rheindorf,8227,7,5,7,12,22,28,-6,22
FC Salzburg,8228,1,14,7,3,45,19,26,49
SK Sturm Gra,8228,2,13,3,8,33,27,6,42
Rapid Vienna,8228,3,8,10,6,34,28,6,34
LASK Linz,8228,4,8,6,10,28,29,-1,30
Mattersburg,8228,5,6,8,10,30,39,-9,26
SC Rheindorf,8228,6,6,6,12,18,30,-12,24
Vienna,8228,7,6,6,12,26,42,-16,24
FC Salzburg,8229,1,13,7,4,44,22,22,46
SK Sturm Gra,8229,2,13,4,7,35,27,8,43
Rapid Vienna,8229,3,10,10,4,38,26,12,40
LASK Linz,8229,4,8,6,10,29,31,-2,30
Vienna,8229,5,7,5,12,27,41,-14,26
Mattersburg,8229,6,6,6,12,31,46,-15,24
SC Rheindorf,8229,7,5,6,13,17,28,-11,21
FC Salzburg,8230,1,13,8,3,43,21,22,47
SK Sturm Gra,8230,2,14,4,6,35,27,8,46
LASK Linz,8230,3,9,5,10,25,26,-1,32
Rapid Vienna,8230,4,7,10,7,34,29,5,31
Mattersburg,8230,5,7,6,11,33,41,-8,27
Vienna,8230,6,6,6,12,26,42,-16,24
SC Rheindorf,8230,7,6,5,13,18,28,-10,23
FC Salzburg,8231,1,14,6,4,41,19,22,48
SK Sturm Gra,8231,2,13,3,8,32,28,4,42
Rapid Vienna,8231,3,8,10,6,37,28,9,34
LASK Linz,8231,4,8,6,10,28,31,-3,30
Vienna,8231,5,7,6,11,25,38,-13,27
SC Rheindorf,8231,6,7,5,12,19,27,-8,26
Mattersburg,8231,7,6,6,12,29,40,-11,24
FC Salzburg,8232,1,15,7,2,44,17,27,52
SK Sturm Gra,8232,2,13,4,7,33,28,5,43
Rapid Vienna,8232,3,9,9,6,36,28,8,36
LASK Linz,8232,4,8,6,10,31,33,-2,30
SC Rheindorf,8232,5,6,6,12,20,28,-8,24
Mattersburg,8232,6,6,5,13,31,44,-13,23
Vienna,8232,7,6,5,13,26,43,-17,23
FC Salzburg,8233,1,12,9,3,45,23,22,45
SK Sturm Gra,8233,2,12,5,7,31,28,3,41
Rapid Vienna,8233,3,8,11,5,37,28,9,35
LASK Linz,8233,4,8,6,10,25,26,-1,30
Vienna,8233,5,8,5,11,30,41,-11,29
SC Rheindorf,8233,6,6,7,11,21,29,-8,25
Mattersburg,8233,7,5,7,12,29,43,-14,22
FC Salzburg,8234,1,14,6,4,43,21,22,48
SK Sturm Gra,8234,2,13,3,8,31,27,4,42
Rapid Vienna,8234,3,9,9,6,37,26,11,36
LASK Linz,8234,4,9,6,9,27,27,0,33
SC Rheindorf,8234,5,6,6,12,18,28,-10,24
Vienna,8234,6,6,6,12,25,40,-15,24
Mattersburg,8234,7,5,8,11,29,41,-12,23
FC Salzburg,8235,1,14,7,3,45,20,25,49
SK Sturm Gra,8235,2,12,6,6,32,27,5,42
Rapid Vienna,8235,3,8,11,5,36,26,10,35
LASK Linz,8235,4,10,5,9,28,27,1,35
Vienna,8235,5,7,5,12,27,39,-12,26
Mattersburg,8235,6,6,5,13,29,46,-17,23
SC Rheindorf,8235,7,4,7,13,15,27,-12,19
FC Salzburg,8236,1,14,8,2,47,17,30,50
SK Sturm Gra,8236,2,13,5,6,35,27,8,44
Rapid Vienna,8236,3,8,11,5,36,29,7,35
LASK Linz,8236,4,7,7,10,26,30,-4,28
Mattersburg,8236,5,7,5,12,32,42,-10,26
Vienna,8236,6,6,5,13,24,45,-21,23
SC Rheindorf,8236,7,5,7,12,18,28,-10,22
FC Salzburg,8237,1,13,8,3,43,18,25,47
SK Sturm Gra,8237,2,12,4,8,31,32,-1,40
Rapid Vienna,8237,3,9,11,4,40,28,12,38
LASK Linz,8237,4,7,8,9,29,31,-2,29
Mattersburg,8237,5,7,6,11,34,44,-10,27
Vienna,8237,6,6,6,12,26,41,-15,24
SC Rheindorf,8237,7,5,7,12,23,32,-9,22
FC Salzburg,8238,1,14,6,4,43,21,22,48
SK Sturm Gra,8238,2,14,4,6,36,28,8,46
Rapid Vienna,8238,3,9,9,6,35,27,8,36
LASK Linz,8238,4,8,5,11,28,32,-4,29
Mattersburg,8238,5,7,5,12,32,42,-10,26
Vienna,8238,6,7,5,12,26,40,-14,26
SC Rheindorf,8238,7,5,6,13,20,30,-10,21
FC Salzburg,8239,1,13,7,4,46,22,24,46
SK Sturm Gra,8239,2,14,3,7,33,27,6,45
Rapid Vienna,8239,3,8,11,5,36,28,8,35
LASK Linz,8239,4,7,8,9,27,29,-2,29
Vienna,8239,5,7,5,12,27,40,-13,26
SC Rheindorf,8239,6,6,6,12,21,30,-9,24
Mattersburg,8239,7,6,6,12,32,46,-14,24
FC Salzburg,8240,1,16,6,2,49,16,33,54
SK Sturm Gra,8240,2,12,4,8,31,31,0,40
LASK Linz,8240,3,9,7,8,32,27,5,34
Rapid Vienna,8240,4,8,10,6,37,33,4,34
Vienna,8240,5,7,5,12,27,38,-11,26
SC Rheindorf,8240,6,5,6,13,18,30,-12,21
Mattersburg,8240,7,5,6,13,30,49,-19,21
FC Salzburg,8241,1,15,6,3,46,20,26,51
SK Sturm Gra,8241,2,11,3,10,30,35,-5,36
Rapid Vienna,8241,3,8,11,5,38,29,9,35
LASK Linz,8241,4,9,7,8,34,29,5,34
Vienna,8241,5,7,6,11,25,37,-12,27
SC Rheindorf,8241,6,5,8,11,17,26,-9,23
Mattersburg,8241,7,5,7,12,28,42,-14,22
FC Salzburg,8242,1,15,7,2,46,19,27,52
SK Sturm Gra,8242,2,12,4,8,33,30,3,40
Rapid Vienna,8242,3,9,10,5,38,29,9,37
LASK Linz,8242,4,7,6,11,25,29,-4,27
SC Rheindorf,8242,5,7,6,11,22,28,-6,27
Vienna,8242,6,6,6,12,25,40,-15,24
Mattersburg,8242,7,5,7,12,28,42,-14,22
FC Salzburg,8243,1,13,7,4,41,21,20,46
SK Sturm Gra,8243,2,14,4,6,36,26,10,46
Rapid Vienna,8243,3,10,9,5,37,28,9,39
LASK Linz,8243,4,7,7,10,26,29,-3,28
Mattersburg,8243,5,6,8,10,33,42,-9,26
Vienna,8243,6,6,6,12,26,41,-15,24
SC Rheindorf,8243,7,4,7,13,18,30,-12,19
FC Salzburg,8244,1,16,6,2,43,15,28,54
SK Sturm Gra,8244,2,12,3,9,29,30,-1,39
Rapid Vienna,8244,3,8,10,6,37,27,10,34
LASK Linz,8244,4,8,7,9,30,30,0,31
SC Rheindorf,8244,5,7,5,12,20,29,-9,26
Vienna,8244,6,6,6,12,24,40,-16,24
Mattersburg,8244,7,5,7,12,32,44,-12,22
FC Salzburg,8245,1,15,7,2,45,19,26,52
SK Sturm Gra,8245,2,12,4,8,32,32,0,40
Rapid Vienna,8245,3,9,10,5,34,25,9,37
LASK Linz,8245,4,7,6,11,26,30,-4,27
SC Rheindorf,8245,5,7,5,12,24,28,-4,26
Mattersburg,8245,6,7,5,12,33,43,-10,26
Vienna,8245,7,6,5,13,24,41,-17,23
FC Salzburg,8246,1,15,6,3,44,17,27,51
SK Sturm Gra,8246,2,12,3,9,32,32,0,39
Rapid Vienna,8246,3,8,10,6,35,29,6,34
LASK Linz,8246,4,8,6,10,30,31,-1,30
Mattersburg,8246,5,7,5,12,32,42,-10,26
Vienna,8246,6,7,5,12,26,41,-15,26
SC Rheindorf,8246,7,6,7,11,19,26,-7,25
FC Salzburg,8247,1,14,6,4,43,21,22,48
SK Sturm Gra,8247,2,12,4,8,31,31,0,40
Rapid Vienna,8247,3,9,11,4,42,30,12,38
LASK Linz,8247,4,7,8,9,26,28,-2,29
Vienna,8247,5,8,5,11,27,37,-10,29
SC Rheindorf,8247,6,5,8,11,24,31,-7,23
Mattersburg,8247,7,5,6,13,28,43,-15,21
FC Salzburg,8248,1,15,7,2,47,19,28,52
SK Sturm Gra,8248,2,13,4,7,37,28,9,43
LASK Linz,8248,3,9,6,9,31,30,1,33
Rapid Vienna,8248,4,7,10,7,38,34,4,31
Mattersburg,8248,5,6,8,10,33,42,-9,26
Vienna,8248,6,6,6,12,24,41,-17,24
SC Rheindorf,8248,7,4,7,13,21,37,-16,19
FC Salzburg,8249,1,13,8,3,42,21,21,47
SK Sturm Gra,8249,2,13,4,7,32,27,5,43
LASK Linz,8249,3,10,6,8,32,28,4,36
Rapid Vienna,8249,4,8,10,6,38,33,5,34
Vienna,8249,5,7,6,11,28,39,-11,27
Mattersburg,8249,6,5,7,12,30,42,-12,22
SC Rheindorf,8249,7,4,7,13,18,30,-12,19
FC Salzburg,8250,1,16,6,2,49,17,32,54
SK Sturm Gra,8250,2,12,4,8,32,29,3,40
Rapid Vienna,8250,3,7,11,6,34,28,6,32
LASK Linz,8250,4,8,7,9,26,27,-1,31
Vienna,8250,5,7,5,12,26,45,-19,26
SC Rheindorf,8250,6,5,8,11,22,29,-7,23
Mattersburg,8250,7,6,5,13,31,45,-14,23
FC Salzburg,8251,1,15,6,3,45,19,26,51
SK Sturm Gra,8251,2,12,4,8,35,32,3,40
LASK Linz,8251,3,10,6,8,32,29,3,36
Rapid Vienna,8251,4,7,11,6,35,31,4,32
Mattersburg,8251,5,7,6,11,33,40,-7,27
Vienna,8251,6,6,6,12,25,42,-17,24
SC Rheindorf,8251,7,4,7,13,21,33,-12,19
FC Salzburg,8252,1,15,6,3,49,19,30,51
SK Sturm Gra,8252,2,12,5,7,30,30,0,41
Rapid Vienna,8252,3,8,10,6,35,28,7,34
LASK Linz,8252,4,8,7,9,26,27,-1,31
Mattersburg,8252,5,7,6,11,34,40,-6,27
Vienna,8252,6,7,6,11,27,40,-13,27
SC Rheindorf,8252,7,4,6,14,17,34,-17,18
FC Salzburg,8253,1,14,7,3,44,19,25,49
SK Sturm Gra,8253,2,14,3,7,34,25,9,45
Rapid Vienna,8253,3,8,11,5,34,28,6,35
LASK Linz,8253,4,7,7,10,24,28,-4,28
SC Rheindorf,8253,5,6,6,12,18,27,-9,24
Vienna,8253,6,6,6,12,25,41,-16,24
Mattersburg,8253,7,5,8,11,29,40,-11,23
FC Salzburg,8254,1,14,6,4,43,21,22,48
SK Sturm Gra,8254,2,14,3,7,33,27,6,45
Rapid Vienna,8254,3,7,10,7,34,29,5,31
LASK Linz,8254,4,8,6,10,28,30,-2,30
Vienna,8254,5,7,5,12,24,38,-14,26
SC Rheindorf,8254,6,6,7,11,21,28,-7,25
Mattersburg,8254,7,6,7,11,29,39,-10,25
FC Salzburg,8255,1,15,7,2,50,16,34,52
SK Sturm Gra,8255,2,13,3,8,33,30,3,42
Rapid Vienna,8255,3,7,10,7,31,28,3,31
LASK Linz,8255,4,7,7,10,24,27,-3,28
SC Rheindorf,8255,5,7,5,12,21,29,-8,26
Vienna,8255,6,6,7,11,24,38,-14,25
Mattersburg,8255,7,6,7,11,31,46,-15,25
FC Salzburg,8256,1,14,8,2,49,18,31,50
SK Sturm Gra,8256,2,12,6,6,33,26,7,42
LASK Linz,8256,3,10,6,8,31,29,2,36
Rapid Vienna,8256,4,7,10,7,32,30,2,31
Vienna,8256,5,7,6,11,25,37,-12,27
SC Rheindorf,8256,6,5,7,12,18,28,-10,22
Mattersburg,8256,7,5,5,14,29,49,-20,20
FC Salzburg,8257,1,15,6,3,45,17,28,51
SK Sturm Gra,8257,2,13,3,8,33,30,3,42
Rapid Vienna,8257,3,8,9,7,34,29,5,33
LASK Linz,8257,4,8,5,11,26,30,-4,29
Mattersburg,8257,5,7,6,11,30,38,-8,27
Vienna,8257,6,7,5,12,25,39,-14,26
SC Rheindorf,8257,7,6,6,12,18,28,-10,24
FC Salzburg,8258,1,14,7,3,46,19,27,49
SK Sturm Gra,8258,2,13,3,8,36,35,1,42
Rapid Vienna,8258,3,9,9,6,39,31,8,36
LASK Linz,8258,4,9,7,8,31,30,1,34
Mattersburg,8258,5,6,7,11,30,40,-10,25
Vienna,8258,6,6,7,11,25,39,-14,25
SC Rheindorf,8258,7,4,6,14,18,31,-13,18
FC Salzburg,8259,1,15,7,2,46,16,30,52
SK Sturm Gra,8259,2,12,4,8,32,29,3,40
Rapid Vienna,8259,3,8,10,6,35,33,2,34
LASK Linz,8259,4,9,6,9,28,26,2,33
Mattersburg,8259,5,7,6,11,31,39,-8,27
Vienna,8259,6,6,5,13,24,42,-18,23
SC Rheindorf,8259,7,5,6,13,19,30,-11,21
FC Salzburg,8260,1,14,7,3,44,19,25,49
SK Sturm Gra,8260,2,13,3,8,35,31,4,42
Rapid Vienna,8260,3,8,10,6,33,27,6,34
LASK Linz,8260,4,8,5,11,25,31,-6,29
SC Rheindorf,8260,5,7,6,11,24,27,-3,27
Vienna,8260,6,7,5,12,26,40,-14,26
Mattersburg,8260,7,6,6,12,27,39,-12,24
FC Salzburg,8261,1,15,7,2,46,19,27,52
SK Sturm Gra,8261,2,13,4,7,36,30,6,43
Rapid Vienna,8261,3,8,10,6,35,30,5,34
LASK Linz,8261,4,8,7,9,26,27,-1,31
Vienna,8261,5,6,7,11,27,41,-14,25
Mattersburg,8261,6,5,7,12,31,43,-12,22
SC Rheindorf,8261,7,5,6,13,19,30,-11,21
FC Salzburg,8262,1,16,6,2,46,16,30,54
SK Sturm Gra,8262,2,12,4,8,31,31,0,40
Rapid Vienna,8262,3,8,10,6,35,27,8,34
LASK Linz,8262,4,7,6,11,27,32,-5,27
SC Rheindorf,8262,5,7,6,11,20,27,-7,27
Vienna,8262,6,7,5,12,24,39,-15,26
Mattersburg,8262,7,6,5,13,31,42,-11,23
FC Salzburg,8263,1,15,6,3,48,21,27,51
SK Sturm Gra,8263,2,12,5,7,33,31,2,41
Rapid Vienna,8263,3,9,10,5,38,27,11,37
LASK Linz,8263,4,7,9,8,30,31,-1,30
Mattersburg,8263,5,6,6,12,31,43,-12,24
Vienna,8263,6,6,5,13,25,41,-16,23
SC Rheindorf,8263,7,5,7,12,18,29,-11,22
FC Salzburg,8264,1,16,6,2,47,18,29,54
SK Sturm Gra,8264,2,14,3,7,35,29,6,45
LASK Linz,8264,3,10,5,9,27,26,1,35
Rapid Vienna,8264,4,8,9,7,35,27,8,33
Vienna,8264,5,6,6,12,25,41,-16,24
Mattersburg,8264,6,5,6,13,30,44,-14,21
SC Rheindorf,8264,7,5,5,14,19,33,-14,20
FC Salzburg,8265,1,16,6,2,44,16,28,54
SK Sturm Gra,8265,2,11,6,7,30,27,3,39
Rapid Vienna,8265,3,8,11,5,38,29,9,35
LASK Linz,8265,4,8,7,9,30,30,0,31
Vienna,8265,5,7,5,12,25,39,-14,26
SC Rheindorf,8265,6,6,6,12,20,31,-11,24
Mattersburg,8265,7,5,5,14,32,47,-15,20
FC Salzburg,8266,1,16,6,2,45,17,28,54
SK Sturm Gra,8266,2,13,3,8,35,28,7,42
LASK Linz,8266,3,9,6,9,25,26,-1,33
Rapid Vienna,8266,4,7,10,7,33,29,4,31
Vienna,8266,5,7,5,12,29,40,-11,26
Mattersburg,8266,6,6,6,12,32,46,-14,24
SC Rheindorf,8266,7,4,8,12,19,32,-13,20
FC Salzburg,8267,1,13,8,3,41,18,23,47
Rapid Vienna,8267,2,10,10,4,39,24,15,40
SK Sturm Gra,8267,3,12,4,8,32,28,4,40
LASK Linz,8267,4,8,6,10,25,30,-5,30
Mattersburg,8267,5,6,7,11,29,39,-10,25
Vienna,8267,6,6,6,12,24,39,-15,24
SC Rheindorf,8267,7,5,7,12,19,31,-12,22
FC Salzburg,8268,1,14,7,3,47,21,26,49
SK Sturm Gra,8268,2,11,5,8,33,34,-1,38
Rapid Vienna,8268,3,8,10,6,35,27,8,34
LASK Linz,8268,4,9,5,10,27,30,-3,32
Mattersburg,8268,5,7,7,10,32,39,-7,28
Vienna,8268,6,7,5,12,26,40,-14,26
SC Rheindorf,8268,7,5,7,12,21,30,-9,22
FC Salzburg,8269,1,13,6,5,43,23,20,45
SK Sturm Gra,8269,2,13,5,6,35,28,7,44
Rapid Vienna,8269,3,9,10,5,39,30,9,37
Mattersburg,8269,4,8,5,11,33,38,-5,29
LASK Linz,8269,5,7,5,12,27,33,-6,26
Vienna,8269,6,7,5,12,26,41,-15,26
SC Rheindorf,8269,7,6,6,12,21,31,-10,24
FC Salzburg,8270,1,15,7,2,50,18,32,52
SK Sturm Gra,8270,2,14,3,7,32,28,4,45
Rapid Vienna,8270,3,8,9,7,36,28,8,33
LASK Linz,8270,4,9,5,10,27,28,-1,32
Vienna,8270,5,6,7,11,26,40,-14,25
SC Rheindorf,8270,6,6,5,13,18,30,-12,23
Mattersburg,8270,7,5,6,13,30,47,-17,21
FC Salzburg,8271,1,15,7,2,46,20,26,52
SK Sturm Gra,8271,2,13,4,7,31,26,5,43
Rapid Vienna,8271,3,9,9,6,37,28,9,36
LASK Linz,8271,4,8,6,10,27,30,-3,30
Vienna,8271,5,6,7,11,25,39,-14,25
Mattersburg,8271,6,5,7,12,32,44,-12,22
SC Rheindorf,8271,7,4,8,12,19,30,-11,20
FC Salzburg,8272,1,15,6,3,48,17,31,51
Rapid Vienna,8272,2,9,11,4,37,26,11,38
SK Sturm Gra,8272,3,11,5,8,29,28,1,38
LASK Linz,8272,4,9,6,9,32,29,3,33
Mattersburg,8272,5,6,6,12,31,45,-14,24
Vienna,8272,6,6,6,12,24,41,-17,24
SC Rheindorf,8272,7,5,6,13,18,33,-15,21
FC Salzburg,8273,1,13,8,3,43,18,25,47
SK Sturm Gra,8273,2,13,4,7,39,28,11,43
Rapid Vienna,8273,3,10,10,4,38,27,11,40
LASK Linz,8273,4,8,5,11,28,33,-5,29
Vienna,8273,5,7,5,12,26,40,-14,26
SC Rheindorf,8273,6,6,6,12,19,29,-10,24
Mattersburg,8273,7,5,6,13,28,46,-18,21
FC Salzburg,8274,1,14,7,3,43,19,24,49
Rapid Vienna,8274,2,10,10,4,38,24,14,40
SK Sturm Gra,8274,3,11,6,7,31,29,2,39
Mattersburg,8274,4,8,6,10,35,39,-4,30
LASK Linz,8274,5,7,6,11,25,30,-5,27
Vienna,8274,6,6,5,13,24,42,-18,23
SC Rheindorf,8274,7,5,6,13,18,31,-13,21
SK Sturm Gra,8275,1,14,3,7,35,30,5,45
FC Salzburg,8275,2,12,8,4,41,21,20,44
Rapid Vienna,8275,3,10,9,5,38,28,10,39
LASK Linz,8275,4,8,5,11,28,32,-4,29
Mattersburg,8275,5,6,7,11,33,41,-8,25
Vienna,8275,6,6,7,11,26,40,-14,25
SC Rheindorf,8275,7,6,5,13,22,31,-9,23
FC Salzburg,8276,1,13,8,3,40,16,24,47
SK Sturm Gra,8276,2,12,6,6,30,25,5,42
Rapid Vienna,8276,3,10,10,4,35,23,12,40
LASK Linz,8276,4,8,5,11,27,29,-2,29
Vienna,8276,5,6,6,12,24,40,-16,24
Mattersburg,8276,6,5,8,11,28,40,-12,23
SC Rheindorf,8276,7,5,7,12,18,29,-11,22
FC Salzburg,8277,1,15,7,2,47,17,30,52
SK Sturm Gra,8277,2,11,5,8,31,30,1,38
LASK Linz,8277,3,9,7,8,33,29,4,34
Rapid Vienna,8277,4,7,12,5,33,28,5,33
SC Rheindorf,8277,5,7,5,12,21,29,-8,26
Vienna,8277,6,7,5,12,27,44,-17,26
Mattersburg,8277,7,5,5,14,30,45,-15,20
FC Salzburg,8278,1,14,7,3,43,19,24,49
SK Sturm Gra,8278,2,12,4,8,30,27,3,40
Rapid Vienna,8278,3,7,12,5,32,25,7,33
LASK Linz,8278,4,8,8,8,30,30,0,32
Vienna,8278,5,8,5,11,27,39,-12,29
Mattersburg,8278,6,6,6,12,31,42,-11,24
SC Rheindorf,8278,7,5,6,13,17,28,-11,21
FC Salzburg,8279,1,15,7,2,51,16,35,52
SK Sturm Gra,8279,2,13,3,8,35,32,3,42
Rapid Vienna,8279,3,9,9,6,36,28,8,36
LASK Linz,8279,4,8,5,11,25,31,-6,29
Mattersburg,8279,5,8,5,11,33,45,-12,29
Vienna,8279,6,6,6,12,27,42,-15,24
SC Rheindorf,8279,7,5,5,14,21,34,-13,20
FC Salzburg,8280,1,14,8,2,44,18,26,50
Rapid Vienna,8280,2,9,10,5,34,26,8,37
SK Sturm Gra,8280,3,11,3,10,30,31,-1,36
LASK Linz,8280,4,9,5,10,27,27,0,32
SC Rheindorf,8280,5,7,5,12,21,28,-7,26
Vienna,8280,6,6,7,11,25,39,-14,25
Mattersburg,8280,7,6,6,12,28,40,-12,24
FC Salzburg,8281,1,15,7,2,46,16,30,52
SK Sturm Gra,8281,2,12,4,8,33,33,0,40
Rapid Vienna,8281,3,8,10,6,36,29,7,34
LASK Linz,8281,4,8,5,11,28,30,-2,29
SC Rheindorf,8281,5,7,5,12,22,30,-8,26
Mattersburg,8281,6,7,5,12,36,46,-10,26
Vienna,8281,7,6,6,12,25,42,-17,24
FC Salzburg,8282,1,14,8,2,47,21,26,50
SK Sturm Gra,8282,2,12,3,9,32,31,1,39
Rapid Vienna,8282,3,9,10,5,39,29,10,37
SC Rheindorf,8282,4,7,6,11,20,27,-7,27
Mattersburg,8282,5,7,6,11,33,42,-9,27
LASK Linz,8282,6,7,5,12,25,31,-6,26
Vienna,8282,7,6,6,12,26,41,-15,24
FC Salzburg,8283,1,14,7,3,51,20,31,49
SK Sturm Gra,8283,2,13,5,6,35,28,7,44
Rapid Vienna,8283,3,8,10,6,37,30,7,34
LASK Linz,8283,4,8,6,10,26,31,-5,30
Vienna,8283,5,7,6,11,28,40,-12,27
Mattersburg,8283,6,6,6,12,29,48,-19,24
SC Rheindorf,8283,7,5,6,13,22,31,-9,21
FC Salzburg,8284,1,14,6,4,43,17,26,48
SK Sturm Gra,8284,2,14,4,6,36,28,8,46
Rapid Vienna,8284,3,9,9,6,39,31,8,36
LASK Linz,8284,4,9,5,10,28,30,-2,32
SC Rheindorf,8284,5,6,6,12,22,29,-7,24
Vienna,8284,6,6,6,12,26,41,-15,24
Mattersburg,8284,7,5,6,13,31,49,-18,21
FC Salzburg,8285,1,14,7,3,45,18,27,49
Rapid Vienna,8285,2,10,10,4,37,23,14,40
SK Sturm Gra,8285,3,11,6,7,30,27,3,39
LASK Linz,8285,4,8,5,11,27,31,-4,29
Vienna,8285,5,7,5,12,25,40,-15,26
SC Rheindorf,8285,6,6,6,12,20,31,-11,24
Mattersburg,8285,7,6,5,13,31,45,-14,23
FC Salzburg,8286,1,15,7,2,47,17,30,52
SK Sturm Gra,8286,2,11,5,8,32,31,1,38
Rapid Vienna,8286,3,8,11,5,35,26,9,35
LASK Linz,8286,4,9,6,9,33,31,2,33
Mattersburg,8286,5,8,5,11,33,43,-10,29
Vienna,8286,6,6,6,12,23,38,-15,24
SC Rheindorf,8286,7,4,6,14,18,35,-17,18
FC Salzburg,8287,1,14,7,3,44,18,26,49
SK Sturm Gra,8287,2,13,3,8,33,29,4,42
Rapid Vienna,8287,3,8,11,5,34,27,7,35
LASK Linz,8287,4,9,5,10,28,29,-1,32
Mattersburg,8287,5,6,7,11,32,42,-10,25
Vienna,8287,6,6,6,12,27,43,-16,24
SC Rheindorf,8287,7,5,7,12,20,30,-10,22
FC Salzburg,8288,1,15,6,3,49,18,31,51
SK Sturm Gra,8288,2,12,3,9,31,32,-1,39
Rapid Vienna,8288,3,9,10,5,40,28,12,37
LASK Linz,8288,4,8,6,10,28,30,-2,30
Vienna,8288,5,8,5,11,26,38,-12,29
Mattersburg,8288,6,7,5,12,32,46,-14,26
SC Rheindorf,8288,7,5,5,14,19,33,-14,20
FC Salzburg,8289,1,14,8,2,46,20,26,50
SK Sturm Gra,8289,2,12,4,8,31,28,3,40
Rapid Vienna,8289,3,8,9,7,33,31,2,33
LASK Linz,8289,4,9,6,9,29,28,1,33
SC Rheindorf,8289,5,7,6,11,22,26,-4,27
Vienna,8289,6,6,6,12,27,44,-17,24
Mattersburg,8289,7,6,5,13,32,43,-11,23
FC Salzburg,8290,1,14,8,2,45,19,26,50
SK Sturm Gra,8290,2,14,4,6,36,26,10,46
Rapid Vienna,8290,3,8,10,6,34,27,7,34
LASK Linz,8290,4,9,6,9,27,27,0,33
Mattersburg,8290,5,7,5,12,33,42,-9,26
Vienna,8290,6,6,6,12,26,42,-16,24
SC Rheindorf,8290,7,4,5,15,15,33,-18,17
FC Salzburg,8291,1,15,6,3,46,19,27,51
SK Sturm Gra,8291,2,14,4,6,36,28,8,46
Rapid Vienna,8291,3,8,10,6,35,29,6,34
LASK Linz,8291,4,8,6,10,27,30,-3,30
Vienna,8291,5,7,5,12,30,41,-11,26
Mattersburg,8291,6,7,5,12,32,44,-12,26
SC Rheindorf,8291,7,4,6,14,17,32,-15,18
FC Salzburg,8292,1,15,7,2,47,20,27,52
SK Sturm Gra,8292,2,11,4,9,32,32,0,37
LASK Linz,8292,3,10,5,9,34,28,6,35
Rapid Vienna,8292,4,8,10,6,35,31,4,34
Mattersburg,8292,5,7,5,12,33,44,-11,26
Vienna,8292,6,6,6,12,26,41,-15,24
SC Rheindorf,8292,7,5,7,12,22,33,-11,22
FC Salzburg,8293,1,14,8,2,45,17,28,50
SK Sturm Gra,8293,2,12,4,8,34,31,3,40
Rapid Vienna,8293,3,9,11,4,39,29,10,38
LASK Linz,8293,4,7,8,9,25,30,-5,29
Vienna,8293,5,7,5,12,25,39,-14,26
SC Rheindorf,8293,6,5,7,12,21,30,-9,22
Mattersburg,8293,7,5,7,12,27,40,-13,22
FC Salzburg,8294,1,13,8,3,43,20,23,47
SK Sturm Gra,8294,2,11,5,8,31,31,0,38
Rapid Vienna,8294,3,9,10,5,37,28,9,37
LASK Linz,8294,4,8,8,8,27,27,0,32
Vienna,8294,5,7,5,12,27,40,-13,26
Mattersburg,8294,6,6,7,11,31,41,-10,25
SC Rheindorf,8294,7,5,7,12,21,30,-9,22
FC Salzburg,8295,1,16,6,2,45,16,29,54
SK Sturm Gra,8295,2,13,3,8,33,28,5,42
Rapid Vienna,8295,3,8,9,7,35,30,5,33
LASK Linz,8295,4,9,5,10,30,28,2,32
Mattersburg,8295,5,6,6,12,28,39,-11,24
Vienna,8295,6,6,6,12,24,40,-16,24
SC Rheindorf,8295,7,6,5,13,17,31,-14,23
FC Salzburg,8296,1,15,6,3,42,17,25,51
SK Sturm Gra,8296,2,12,3,9,34,33,1,39
Rapid Vienna,8296,3,9,9,6,38,30,8,36
LASK Linz,8296,4,9,5,10,28,28,0,32
Mattersburg,8296,5,8,5,11,33,39,-6,29
SC Rheindorf,8296,6,6,5,13,20,32,-12,23
Vienna,8296,7,6,5,13,24,40,-16,23
FC Salzburg,8297,1,14,7,3,46,22,24,49
Rapid Vienna,8297,2,11,9,4,42,26,16,42
SK Sturm Gra,8297,3,12,4,8,34,31,3,40
LASK Linz,8297,4,7,6,11,25,36,-11,27
Vienna,8297,5,7,5,12,28,39,-11,26
Mattersburg,8297,6,6,7,11,33,43,-10,25
SC Rheindorf,8297,7,5,6,13,22,33,-11,21
FC Salzburg,8298,1,14,8,2,44,19,25,50
SK Sturm Gra,8298,2,13,3,8,33,27,6,42
Rapid Vienna,8298,3,9,10,5,35,25,10,37
LASK Linz,8298,4,8,6,10,26,29,-3,30
Vienna,8298,5,7,6,11,28,39,-11,27
Mattersburg,8298,6,6,6,12,28,41,-13,24
SC Rheindorf,8298,7,5,5,14,20,34,-14,20
FC Salzburg,8299,1,14,6,4,46,19,27,48
SK Sturm Gra,8299,2,14,3,7,36,29,7,45
Rapid Vienna,8299,3,10,9,5,38,28,10,39
LASK Linz,8299,4,7,6,11,25,29,-4,27
Vienna,8299,5,7,6,11,27,40,-13,27
Mattersburg,8299,6,5,8,11,29,44,-15,23
SC Rheindorf,8299,7,5,6,13,19,31,-12,21
FC Salzburg,8300,1,14,8,2,41,16,25,50
SK Sturm Gra,8300,2,12,5,7,33,29,4,41
Rapid Vienna,8300,3,8,10,6,35,28,7,34
LASK Linz,8300,4,7,7,10,24,28,-4,28
SC Rheindorf,8300,5,7,6,11,20,26,-6,27
Mattersburg,8300,6,6,7,11,29,39,-10,25
Vienna,8300,7,6,5,13,24,40,-16,23
FC Salzburg,8301,1,14,8,2,44,19,25,50
SK Sturm Gra,8301,2,13,4,7,34,27,7,43
Rapid Vienna,8301,3,8,10,6,34,32,2,34
LASK Linz,8301,4,8,5,11,30,30,0,29
Mattersburg,8301,5,7,5,12,34,42,-8,26
SC Rheindorf,8301,6,6,6,12,18,28,-10,24
Vienna,8301,7,6,6,12,23,39,-16,24
FC Salzburg,8302,1,14,7,3,43,18,25,49
SK Sturm Gra,8302,2,13,5,6,35,28,7,44
Rapid Vienna,8302,3,8,10,6,37,30,7,34
LASK Linz,8302,4,8,6,10,29,32,-3,30
Vienna,8302,5,7,5,12,26,40,-14,26
Mattersburg,8302,6,6,7,11,31,40,-9,25
SC Rheindorf,8302,7,5,6,13,21,34,-13,21
FC Salzburg,8303,1,14,7,3,44,21,23,49
SK Sturm Gra,8303,2,13,4,7,35,26,9,43
Rapid Vienna,8303,3,9,10,5,38,27,11,37
LASK Linz,8303,4,8,5,11,27,33,-6,29
SC Rheindorf,8303,5,7,5,12,22,31,-9,26
Mattersburg,8303,6,6,6,12,31,42,-11,24
Vienna,8303,7,6,5,13,24,41,-17,23
FC Salzburg,8304,1,15,6,3,50,20,30,51
SK Sturm Gra,8304,2,13,4,7,34,32,2,43
Rapid Vienna,8304,3,8,11,5,37,29,8,35
LASK Linz,8304,4,7,6,11,25,32,-7,27
SC Rheindorf,8304,5,7,5,12,23,27,-4,26
Vienna,8304,6,7,5,12,25,41,-16,26
Mattersburg,8304,7,6,5,13,30,43,-13,23
FC Salzburg,8305,1,15,7,2,45,16,29,52
SK Sturm Gra,8305,2,13,5,6,31,25,6,44
Rapid Vienna,8305,3,8,10,6,37,31,6,34
LASK Linz,8305,4,9,6,9,31,30,1,33
Mattersburg,8305,5,6,6,12,30,43,-13,24
Vienna,8305,6,6,5,13,23,40,-17,23
SC Rheindorf,8305,7,4,7,13,17,29,-12,19
FC Salzburg,8306,1,14,6,4,44,17,27,48
SK Sturm Gra,8306,2,13,5,6,32,25,7,44
Rapid Vienna,8306,3,9,11,4,38,27,11,38
LASK Linz,8306,4,7,6,11,26,33,-7,27
Mattersburg,8306,5,7,6,11,33,41,-8,27
Vienna,8306,6,6,6,12,23,40,-17,24
SC Rheindorf,8306,7,5,6,13,18,31,-13,21
FC Salzburg,8307,1,15,6,3,49,19,30,51
SK Sturm Gra,8307,2,12,4,8,30,29,1,40
Rapid Vienna,8307,3,9,9,6,36,28,8,36
LASK Linz,8307,4,9,5,10,28,31,-3,32
SC Rheindorf,8307,5,7,6,11,26,29,-3,27
Vienna,8307,6,6,6,12,25,40,-15,24
Mattersburg,8307,7,5,6,13,32,50,-18,21
FC Salzburg,8308,1,13,7,4,42,21,21,46
Rapid Vienna,8308,2,11,9,4,38,24,14,42
SK Sturm Gra,8308,3,12,4,8,31,27,4,40
LASK Linz,8308,4,7,6,11,25,30,-5,27
Vienna,8308,5,7,6,11,25,38,-13,27
Mattersburg,8308,6,7,5,12,34,44,-10,26
SC Rheindorf,8308,7,5,7,12,20,31,-11,22
FC Salzburg,8309,1,13,9,2,46,22,24,48
SK Sturm Gra,8309,2,13,5,6,36,30,6,44
Rapid Vienna,8309,3,9,10,5,35,26,9,37
LASK Linz,8309,4,7,6,11,27,32,-5,27
Vienna,8309,5,7,6,11,26,39,-13,27
SC Rheindorf,8309,6,5,7,12,21,30,-9,22
Mattersburg,8309,7,5,7,12,29,41,-12,22
FC Salzburg,8310,1,14,8,2,45,19,26,50
Rapid Vienna,8310,2,10,9,5,38,25,13,39
SK Sturm Gra,8310,3,11,4,9,30,31,-1,37
LASK Linz,8310,4,8,7,9,25,27,-2,31
Vienna,8310,5,6,7,11,27,41,-14,25
SC Rheindorf,8310,6,6,6,12,22,30,-8,24
Mattersburg,8310,7,5,7,12,31,45,-14,22
FC Salzburg,8311,1,14,6,4,42,18,24,48
SK Sturm Gra,8311,2,12,5,7,31,27,4,41
Rapid Vienna,8311,3,9,9,6,35,28,7,36
LASK Linz,8311,4,8,7,9,29,33,-4,31
Vienna,8311,5,7,5,12,25,40,-15,26
SC Rheindorf,8311,6,6,6,12,26,31,-5,24
Mattersburg,8311,7,6,6,12,30,41,-11,24
FC Salzburg,8312,1,15,6,3,45,17,28,51
SK Sturm Gra,8312,2,11,4,9,32,31,1,37
LASK Linz,8312,3,9,6,9,27,27,0,33
Rapid Vienna,8312,4,7,11,6,35,31,4,32
SC Rheindorf,8312,5,7,6,11,20,26,-6,27
Mattersburg,8312,6,6,7,11,32,43,-11,25
Vienna,8312,7,6,6,12,26,42,-16,24
FC Salzburg,8313,1,13,7,4,46,24,22,46
Rapid Vienna,8313,2,11,9,4,39,24,15,42
SK Sturm Gra,8313,3,12,4,8,33,30,3,40
LASK Linz,8313,4,7,6,11,24,30,-6,27
Mattersburg,8313,5,6,7,11,33,43,-10,25
Vienna,8313,6,6,7,11,25,39,-14,25
SC Rheindorf,8313,7,6,6,12,21,31,-10,24
FC Salzburg,8314,1,15,6,3,50,17,33,51
SK Sturm Gra,8314,2,13,4,7,33,27,6,43
Rapid Vienna,8314,3,8,9,7,35,32,3,33
LASK Linz,8314,4,9,6,9,28,27,1,33
SC Rheindorf,8314,5,6,7,11,22,27,-5,25
Vienna,8314,6,6,6,12,24,41,-17,24
Mattersburg,8314,7,5,6,13,28,49,-21,21
FC Salzburg,8315,1,15,7,2,43,16,27,52
SK Sturm Gra,8315,2,12,4,8,33,31,2,40
Rapid Vienna,8315,3,10,9,5,36,25,11,39
LASK Linz,8315,4,8,5,11,25,28,-3,29
Mattersburg,8315,5,7,6,11,29,38,-9,27
Vienna,8315,6,6,5,13,25,41,-16,23
SC Rheindorf,8315,7,5,6,13,18,30,-12,21
FC Salzburg,8316,1,14,7,3,43,18,25,49
Rapid Vienna,8316,2,10,10,4,36,25,11,40
SK Sturm Gra,8316,3,12,4,8,33,30,3,40
LASK Linz,8316,4,8,7,9,29,31,-2,31
Mattersburg,8316,5,6,6,12,32,44,-12,24
SC Rheindorf,8316,6,6,5,13,21,27,-6,23
Vienna,8316,7,6,5,13,24,43,-19,23
FC Salzburg,8317,1,14,7,3,44,19,25,49
SK Sturm Gra,8317,2,12,5,7,31,28,3,41
Rapid Vienna,8317,3,9,10,5,36,26,10,37
LASK Linz,8317,4,8,6,10,26,27,-1,30
SC Rheindorf,8317,5,6,6,12,20,28,-8,24
Mattersburg,8317,6,6,6,12,30,43,-13,24
Vienna,8317,7,6,6,12,25,41,-16,24
FC Salzburg,8318,1,16,6,2,46,16,30,54
SK Sturm Gra,8318,2,12,4,8,33,33,0,40
LASK Linz,8318,3,9,6,9,31,30,1,33
Rapid Vienna,8318,4,7,9,8,34,33,1,30
Vienna,8318,5,7,5,12,25,39,-14,26
Mattersburg,8318,6,6,6,12,29,38,-9,24
SC Rheindorf,8318,7,5,8,11,20,29,-9,23
FC Salzburg,8319,1,14,7,3,41,16,25,49
SK Sturm Gra,8319,2,13,4,7,32,27,5,43
Rapid Vienna,8319,3,8,10,6,39,29,10,34
LASK Linz,8319,4,8,6,10,28,29,-1,30
Vienna,8319,5,8,5,11,27,38,-11,29
Mattersburg,8319,6,7,6,11,31,40,-9,27
SC Rheindorf,8319,7,4,6,14,19,38,-19,18
FC Salzburg,8320,1,14,6,4,43,23,20,48
SK Sturm Gra,8320,2,13,4,7,34,29,5,43
Rapid Vienna,8320,3,10,9,5,39,24,15,39
Mattersburg,8320,4,8,5,11,33,41,-8,29
LASK Linz,8320,5,7,6,11,23,30,-7,27
Vienna,8320,6,6,5,13,24,40,-16,23
SC Rheindorf,8320,7,5,7,12,20,29,-9,22
FC Salzburg,8321,1,14,7,3,44,20,24,49
SK Sturm Gra,8321,2,12,5,7,32,27,5,41
Rapid Vienna,8321,3,9,10,5,37,29,8,37
LASK Linz,8321,4,9,5,10,30,29,1,32
Mattersburg,8321,5,7,6,11,29,39,-10,27
Vienna,8321,6,7,5,12,25,38,-13,26
SC Rheindorf,8321,7,4,6,14,17,32,-15,18
FC Salzburg,8322,1,14,6,4,43,20,23,48
SK Sturm Gra,8322,2,14,3,7,35,27,8,45
Rapid Vienna,8322,3,9,9,6,35,29,6,36
LASK Linz,8322,4,7,6,11,24,30,-6,27
Vienna,8322,5,7,5,12,24,38,-14,26
Mattersburg,8322,6,6,7,11,28,38,-10,25
SC Rheindorf,8322,7,6,6,12,21,28,-7,24
FC Salzburg,8323,1,15,7,2,45,17,28,52
SK Sturm Gra,8323,2,12,4,8,31,28,3,40
Rapid Vienna,8323,3,8,12,4,36,27,9,36
LASK Linz,8323,4,8,7,9,26,27,-1,31
Mattersburg,8323,5,7,5,12,29,43,-14,26
Vienna,8323,6,6,5,13,25,43,-18,23
SC Rheindorf,8323,7,5,6,13,22,29,-7,21
FC Salzburg,8324,1,15,7,2,46,18,28,52
Rapid Vienna,8324,2,10,9,5,38,26,12,39
SK Sturm Gra,8324,3,11,5,8,30,30,0,38
LASK Linz,8324,4,7,7,10,24,28,-4,28
SC Rheindorf,8324,5,6,6,12,19,27,-8,24
Vienna,8324,6,6,6,12,25,40,-15,24
Mattersburg,8324,7,5,8,11,30,43,-13,23
FC Salzburg,8325,1,14,7,3,45,19,26,49
SK Sturm Gra,8325,2,15,3,6,35,26,9,48
Rapid Vienna,8325,3,8,10,6,36,29,7,34
LASK Linz,8325,4,7,5,12,24,29,-5,26
Vienna,8325,5,6,7,11,26,40,-14,25
SC Rheindorf,8325,6,6,6,12,19,29,-10,24
Mattersburg,8325,7,6,6,12,28,41,-13,24
FC Salzburg,8326,1,13,7,4,44,23,21,46
SK Sturm Gra,8326,2,14,4,6,35,26,9,46
LASK Linz,8326,3,9,7,8,32,29,3,34
Rapid Vienna,8326,4,7,10,7,33,31,2,31
Vienna,8326,5,8,5,11,27,39,-12,29
Mattersburg,8326,6,6,6,12,32,43,-11,24
SC Rheindorf,8326,7,5,5,14,18,30,-12,20
FC Salzburg,8327,1,16,6,2,53,20,33,54
SK Sturm Gra,8327,2,11,4,9,30,37,-7,37
Rapid Vienna,8327,3,9,9,6,40,29,11,36
LASK Linz,8327,4,9,6,9,27,27,0,33
Mattersburg,8327,5,8,5,11,35,41,-6,29
Vienna,8327,6,6,5,13,24,41,-17,23
SC Rheindorf,8327,7,4,7,13,16,30,-14,19
FC Salzburg,8328,1,15,6,3,46,17,29,51
SK Sturm Gra,8328,2,14,3,7,31,25,6,45
Rapid Vienna,8328,3,9,10,5,35,26,9,37
LASK Linz,8328,4,7,6,11,25,31,-6,27
Vienna,8328,5,7,5,12,25,39,-14,26
Mattersburg,8328,6,6,6,12,31,44,-13,24
SC Rheindorf,8328,7,4,8,12,17,28,-11,20
FC Salzburg,8329,1,15,6,3,47,20,27,51
SK Sturm Gra,8329,2,13,4,7,32,28,4,43
Rapid Vienna,8329,3,8,10,6,34,25,9,34
Mattersburg,8329,4,8,5,11,35,41,-6,29
LASK Linz,8329,5,8,5,11,25,31,-6,29
SC Rheindorf,8329,6,6,5,13,18,29,-11,23
Vienna,8329,7,6,5,13,27,44,-17,23
FC Salzburg,8330,1,14,7,3,44,18,26,49
SK Sturm Gra,8330,2,13,3,8,34,31,3,42
Rapid Vienna,8330,3,10,9,5,38,27,11,39
Mattersburg,8330,4,8,5,11,32,40,-8,29
LASK Linz,8330,5,7,5,12,25,34,-9,26
Vienna,8330,6,6,6,12,24,39,-15,24
SC Rheindorf,8330,7,6,5,13,22,30,-8,23
FC Salzburg,8331,1,14,8,2,43,16,27,50
SK Sturm Gra,8331,2,14,4,6,32,25,7,46
Rapid Vienna,8331,3,7,11,6,34,29,5,32
LASK Linz,8331,4,8,7,9,26,26,0,31
Vienna,8331,5,6,6,12,25,40,-15,24
SC Rheindorf,8331,6,5,7,12,18,28,-10,22
Mattersburg,8331,7,5,7,12,28,42,-14,22
FC Salzburg,8332,1,14,8,2,48,23,25,50
SK Sturm Gra,8332,2,12,5,7,32,29,3,41
Rapid Vienna,8332,3,8,12,4,38,29,9,36
LASK Linz,8332,4,7,6,11,26,31,-5,27
Mattersburg,8332,5,7,6,11,32,40,-8,27
SC Rheindorf,8332,6,6,6,12,19,26,-7,24
Vienna,8332,7,6,5,13,27,44,-17,23
FC Salzburg,8333,1,13,7,4,44,21,23,46
SK Sturm Gra,8333,2,11,5,8,33,32,1,38
Rapid Vienna,8333,3,9,10,5,38,29,9,37
LASK Linz,8333,4,8,5,11,27,31,-4,29
Vienna,8333,5,8,5,11,25,37,-12,29
Mattersburg,8333,6,7,6,11,32,41,-9,27
SC Rheindorf,8333,7,6,6,12,22,30,-8,24
FC Salzburg,8334,1,14,8,2,46,16,30,50
SK Sturm Gra,8334,2,13,4,7,33,27,6,43
Rapid Vienna,8334,3,8,10,6,33,29,4,34
LASK Linz,8334,4,8,6,10,26,29,-3,30
Vienna,8334,5,7,6,11,29,38,-9,27
Mattersburg,8334,6,6,5,13,29,47,-18,23
SC Rheindorf,8334,7,5,7,12,19,29,-10,22
FC Salzburg,8335,1,14,7,3,46,21,25,49
SK Sturm Gra,8335,2,13,3,8,33,29,4,42
Rapid Vienna,8335,3,8,10,6,34,28,6,34
LASK Linz,8335,4,9,6,9,27,25,2,33
Mattersburg,8335,5,7,6,11,35,39,-4,27
Vienna,8335,6,7,5,12,27,41,-14,26
SC Rheindorf,8335,7,5,5,14,17,36,-19,20
FC Salzburg,8336,1,13,8,3,44,20,24,47
SK Sturm Gra,8336,2,12,6,6,32,27,5,42
Rapid Vienna,8336,3,8,11,5,35,26,9,35
LASK Linz,8336,4,9,5,10,27,28,-1,32
Vienna,8336,5,7,6,11,25,38,-13,27
Mattersburg,8336,6,6,5,13,30,43,-13,23
SC Rheindorf,8336,7,5,7,12,19,30,-11,22
FC Salzburg,8337,1,13,7,4,45,22,23,46
SK Sturm Gra,8337,2,14,4,6,38,25,13,46
Rapid Vienna,8337,3,9,10,5,38,28,10,37
LASK Linz,8337,4,8,7,9,27,32,-5,31
Vienna,8337,5,7,5,12,27,42,-15,26
Mattersburg,8337,6,6,5,13,29,42,-13,23
SC Rheindorf,8337,7,5,6,13,19,32,-13,21
FC Salzburg,8338,1,14,6,4,44,21,23,48
SK Sturm Gra,8338,2,14,3,7,38,30,8,45
Rapid Vienna,8338,3,9,10,5,40,29,11,37
LASK Linz,8338,4,8,6,10,27,31,-4,30
Mattersburg,8338,5,7,6,11,33,39,-6,27
Vienna,8338,6,7,5,12,25,41,-16,26
SC Rheindorf,8338,7,4,6,14,17,33,-16,18
FC Salzburg,8339,1,14,7,3,41,17,24,49
SK Sturm Gra,8339,2,13,5,6,31,25,6,44
Rapid Vienna,8339,3,10,9,5,36,25,11,39
Mattersburg,8339,4,8,5,11,35,39,-4,29
LASK Linz,8339,5,7,7,10,24,29,-5,28
Vienna,8339,6,6,5,13,23,41,-18,23
SC Rheindorf,8339,7,4,6,14,17,31,-14,18
FC Salzburg,8340,1,13,7,4,41,22,19,46
SK Sturm Gra,8340,2,14,4,6,37,27,10,46
Rapid Vienna,8340,3,8,9,7,32,30,2,33
LASK Linz,8340,4,9,6,9,27,26,1,33
Vienna,8340,5,8,5,11,30,38,-8,29
Mattersburg,8340,6,5,7,12,29,42,-13,22
SC Rheindorf,8340,7,5,6,13,19,30,-11,21
FC Salzburg,8341,1,15,7,2,44,17,27,52
SK Sturm Gra,8341,2,12,3,9,30,28,2,39
Rapid Vienna,8341,3,9,11,4,36,26,10,38
LASK Linz,8341,4,8,7,9,27,28,-1,31
Mattersburg,8341,5,7,5,12,29,40,-11,26
Vienna,8341,6,6,5,13,23,40,-17,23
SC Rheindorf,8341,7,5,6,13,19,29,-10,21
FC Salzburg,8342,1,15,7,2,45,17,28,52
SK Sturm Gra,8342,2,13,3,8,35,30,5,42
Rapid Vienna,8342,3,8,10,6,35,29,6,34
LASK Linz,8342,4,8,7,9,31,31,0,31
Vienna,8342,5,7,5,12,27,39,-12,26
SC Rheindorf,8342,6,5,7,12,21,32,-11,22
Mattersburg,8342,7,5,7,12,29,45,-16,22
FC Salzburg,8343,1,14,8,2,45,19,26,50
SK Sturm Gra,8343,2,13,4,7,34,29,5,43
Rapid Vienna,8343,3,9,9,6,35,30,5,36
LASK Linz,8343,4,8,6,10,32,31,1,30
Mattersburg,8343,5,8,6,10,33,39,-6,30
Vienna,8343,6,6,5,13,25,42,-17,23
SC Rheindorf,8343,7,4,6,14,16,30,-14,18
FC Salzburg,8344,1,14,8,2,46,20,26,50
SK Sturm Gra,8344,2,11,5,8,34,33,1,38
Rapid Vienna,8344,3,9,10,5,39,28,11,37
LASK Linz,8344,4,7,7,10,26,33,-7,28
Vienna,8344,5,7,6,11,28,41,-13,27
Mattersburg,8344,6,6,7,11,34,42,-8,25
SC Rheindorf,8344,7,5,7,12,20,30,-10,22
FC Salzburg,8345,1,14,6,4,42,21,21,48
SK Sturm Gra,8345,2,14,3,7,38,27,11,45
LASK Linz,8345,3,10,5,9,29,27,2,35
Rapid Vienna,8345,4,8,9,7,35,32,3,33
Mattersburg,8345,5,7,6,11,32,41,-9,27
Vienna,8345,6,7,6,11,28,40,-12,27
SC Rheindorf,8345,7,4,5,15,16,32,-16,17
FC Salzburg,8346,1,15,6,3,48,20,28,51
SK Sturm Gra,8346,2,12,4,8,32,31,1,40
Rapid Vienna,8346,3,8,9,7,35,31,4,33
Mattersburg,8346,4,8,5,11,30,37,-7,29
LASK Linz,8346,5,7,6,11,25,29,-4,27
SC Rheindorf,8346,6,7,5,12,22,27,-5,26
Vienna,8346,7,7,5,12,24,41,-17,26
FC Salzburg,8347,1,13,7,4,46,25,21,46
SK Sturm Gra,8347,2,14,3,7,34,26,8,45
Rapid Vienna,8347,3,10,9,5,38,25,13,39
LASK Linz,8347,4,7,7,10,25,29,-4,28
Mattersburg,8347,5,6,7,11,31,43,-12,25
Vienna,8347,6,6,7,11,27,41,-14,25
SC Rheindorf,8347,7,5,6,13,21,33,-12,21
FC Salzburg,8348,1,15,7,2,45,17,28,52
SK Sturm Gra,8348,2,11,6,7,32,31,1,39
Rapid Vienna,8348,3,8,12,4,38,29,9,36
LASK Linz,8348,4,7,6,11,25,31,-6,27
Mattersburg,8348,5,7,5,12,31,40,-9,26
Vienna,8348,6,7,5,12,27,39,-12,26
SC Rheindorf,8348,7,5,7,12,19,30,-11,22
FC Salzburg,8349,1,16,6,2,49,18,31,54
SK Sturm Gra,8349,2,12,5,7,35,30,5,41
Rapid Vienna,8349,3,9,9,6,37,29,8,36
LASK Linz,8349,4,7,8,9,28,30,-2,29
Mattersburg,8349,5,6,7,11,32,43,-11,25
Vienna,8349,6,6,5,13,25,43,-18,23
SC Rheindorf,8349,7,4,8,12,20,33,-13,20
FC Salzburg,8350,1,16,6,2,48,18,30,54
Rapid Vienna,8350,2,9,9,6,40,30,10,36
SK Sturm Gra,8350,3,11,3,10,30,33,-3,36
LASK Linz,8350,4,9,5,10,27,32,-5,32
Mattersburg,8350,5,7,6,11,31,41,-10,27
SC Rheindorf,8350,6,6,6,12,24,30,-6,24
Vienna,8350,7,6,5,13,24,40,-16,23
FC Salzburg,8351,1,14,8,2,44,18,26,50
SK Sturm Gra,8351,2,14,4,6,35,26,9,46
Rapid Vienna,8351,3,9,10,5,34,25,9,37
LASK Linz,8351,4,7,7,10,27,31,-4,28
Mattersburg,8351,5,6,6,12,30,41,-11,24
Vienna,8351,6,6,5,13,27,44,-17,23
SC Rheindorf,8351,7,5,6,13,19,31,-12,21
FC Salzburg,8352,1,13,6,5,42,19,23,45
SK Sturm Gra,8352,2,12,5,7,32,28,4,41
Rapid Vienna,8352,3,9,10,5,36,27,9,37
Mattersburg,8352,4,9,5,10,34,38,-4,32
LASK Linz,8352,5,8,5,11,25,29,-4,29
SC Rheindorf,8352,6,6,6,12,20,29,-9,24
Vienna,8352,7,6,5,13,25,44,-19,23
FC Salzburg,8353,1,14,7,3,44,18,26,49
SK Sturm Gra,8353,2,13,3,8,35,31,4,42
Rapid Vienna,8353,3,9,10,5,35,27,8,37
Mattersburg,8353,4,8,6,10,36,41,-5,30
LASK Linz,8353,5,7,5,12,25,31,-6,26
SC Rheindorf,8353,6,6,6,12,22,31,-9,24
Vienna,8353,7,6,5,13,24,42,-18,23
FC Salzburg,8354,1,16,6,2,47,16,31,54
Rapid Vienna,8354,2,10,9,5,42,28,14,39
SK Sturm Gra,8354,3,11,3,10,30,34,-4,36
LASK Linz,8354,4,8,6,10,27,31,-4,30
Mattersburg,8354,5,7,6,11,30,38,-8,27
Vienna,8354,6,6,5,13,23,41,-18,23
SC Rheindorf,8354,7,5,7,12,19,30,-11,22
FC Salzburg,8355,1,15,6,3,47,22,25,51
SK Sturm Gra,8355,2,12,3,9,30,31,-1,39
Rapid Vienna,8355,3,9,9,6,40,28,12,36
LASK Linz,8355,4,10,6,8,29,26,3,36
Mattersburg,8355,5,6,7,11,34,44,-10,25
Vienna,8355,6,6,5,13,26,45,-19,23
SC Rheindorf,8355,7,5,6,13,23,33,-10,21
FC Salzburg,8356,1,15,6,3,48,17,31,51
SK Sturm Gra,8356,2,12,4,8,36,32,4,40
Rapid Vienna,8356,3,10,9,5,38,27,11,39
LASK Linz,8356,4,9,6,9,27,29,-2,33
Vienna,8356,5,7,5,12,26,43,-17,26
SC Rheindorf,8356,6,5,7,12,21,32,-11,22
Mattersburg,8356,7,5,5,14,29,45,-16,20
FC Salzburg,8357,1,14,7,3,43,18,25,49
SK Sturm Gra,8357,2,13,4,7,31,30,1,43
Rapid Vienna,8357,3,8,9,7,34,29,5,33
LASK Linz,8357,4,9,6,9,28,27,1,33
Vienna,8357,5,8,5,11,29,41,-12,29
SC Rheindorf,8357,6,6,5,13,24,30,-6,23
Mattersburg,8357,7,5,6,13,34,48,-14,21
FC Salzburg,8358,1,16,6,2,46,18,28,54
SK Sturm Gra,8358,2,12,3,9,33,33,0,39
Rapid Vienna,8358,3,8,11,5,35,26,9,35
LASK Linz,8358,4,8,6,10,27,29,-2,30
Mattersburg,8358,5,7,6,11,31,41,-10,27
Vienna,8358,6,6,5,13,24,40,-16,23
SC Rheindorf,8358,7,5,7,12,19,28,-9,22
FC Salzburg,8359,1,14,8,2,45,18,27,50
SK Sturm Gra,8359,2,11,5,8,34,33,1,38
Rapid Vienna,8359,3,8,11,5,36,27,9,35
LASK Linz,8359,4,9,6,9,29,28,1,33
Mattersburg,8359,5,8,5,11,35,44,-9,29
Vienna,8359,6,6,5,13,27,44,-17,23
SC Rheindorf,8359,7,5,6,13,18,30,-12,21
FC Salzburg,8360,1,15,7,2,44,17,27,52
SK Sturm Gra,8360,2,12,3,9,31,32,-1,39
LASK Linz,8360,3,11,5,8,33,29,4,38
Rapid Vienna,8360,4,7,10,7,32,27,5,31
Vienna,8360,5,7,5,12,25,39,-14,26
Mattersburg,8360,6,6,6,12,32,41,-9,24
SC Rheindorf,8360,7,5,6,13,20,32,-12,21
FC Salzburg,8361,1,15,6,3,47,20,27,51
SK Sturm Gra,8361,2,12,5,7,33,29,4,41
Rapid Vienna,8361,3,8,12,4,36,27,9,36
LASK Linz,8361,4,8,7,9,28,30,-2,31
Vienna,8361,5,7,5,12,27,41,-14,26
Mattersburg,8361,6,6,6,12,32,44,-12,24
SC Rheindorf,8361,7,4,7,13,20,32,-12,19
FC Salzburg,8362,1,15,7,2,44,17,27,52
SK Sturm Gra,8362,2,12,6,6,33,27,6,42
Rapid Vienna,8362,3,8,10,6,38,29,9,34
Mattersburg,8362,4,7,6,11,33,42,-9,27
LASK Linz,8362,5,7,6,11,26,39,-13,27
SC Rheindorf,8362,6,5,8,11,26,29,-3,23
Vienna,8362,7,6,5,13,24,41,-17,23
FC Salzburg,8363,1,13,9,2,47,23,24,48
SK Sturm Gra,8363,2,13,4,7,36,28,8,43
LASK Linz,8363,3,9,6,9,29,29,0,33
Rapid Vienna,8363,4,7,9,8,34,34,0,30
Vienna,8363,5,7,6,11,31,42,-11,27
SC Rheindorf,8363,6,6,6,12,20,28,-8,24
Mattersburg,8363,7,5,8,11,31,44,-13,23
FC Salzburg,8364,1,14,7,3,49,18,31,49
SK Sturm Gra,8364,2,14,3,7,36,33,3,45
Rapid Vienna,8364,3,9,10,5,35,27,8,37
LASK Linz,8364,4,7,6,11,26,33,-7,27
Vienna,8364,5,7,6,11,27,38,-11,27
SC Rheindorf,8364,6,6,5,13,19,28,-9,23
Mattersburg,8364,7,6,5,13,28,43,-15,23
FC Salzburg,8365,1,16,6,2,50,22,28,54
SK Sturm Gra,8365,2,13,3,8,35,31,4,42
LASK Linz,8365,3,10,6,8,32,27,5,36
Rapid Vienna,8365,4,8,10,6,36,29,7,34
Mattersburg,8365,5,7,5,12,32,45,-13,26
Vienna,8365,6,6,5,13,24,40,-16,23
SC Rheindorf,8365,7,4,5,15,19,34,-15,17
FC Salzburg,8366,1,15,7,2,47,16,31,52
SK Sturm Gra,8366,2,13,3,8,35,29,6,42
Rapid Vienna,8366,3,10,10,4,37,24,13,40
LASK Linz,8366,4,8,5,11,25,32,-7,29
SC Rheindorf,8366,5,6,5,13,21,31,-10,23
Mattersburg,8366,6,6,5,13,28,44,-16,23
Vienna,8366,7,6,5,13,24,41,-17,23
FC Salzburg,8367,1,13,8,3,45,21,24,47
SK Sturm Gra,8367,2,12,4,8,33,33,0,40
Rapid Vienna,8367,3,9,10,5,35,24,11,37
LASK Linz,8367,4,8,6,10,28,29,-1,30
Mattersburg,8367,5,6,7,11,32,43,-11,25
Vienna,8367,6,6,7,11,25,39,-14,25
SC Rheindorf,8367,7,6,6,12,20,29,-9,24
FC Salzburg,8368,1,16,6,2,51,19,32,54
SK Sturm Gra,8368,2,12,4,8,30,30,0,40
LASK Linz,8368,3,9,7,8,28,26,2,34
Rapid Vienna,8368,4,8,9,7,33,27,6,33
SC Rheindorf,8368,5,6,6,12,21,27,-6,24
Mattersburg,8368,6,6,5,13,32,46,-14,23
Vienna,8368,7,6,5,13,26,46,-20,23
FC Salzburg,8369,1,14,7,3,45,19,26,49
SK Sturm Gra,8369,2,14,3,7,37,28,9,45
Rapid Vienna,8369,3,8,10,6,35,28,7,34
SC Rheindorf,8369,4,7,6,11,20,27,-7,27
LASK Linz,8369,5,7,5,12,23,31,-8,26
Vienna,8369,6,7,5,12,29,43,-14,26
Mattersburg,8369,7,6,6,12,30,43,-13,24
FC Salzburg,8370,1,13,8,3,42,19,23,47
SK Sturm Gra,8370,2,12,4,8,32,28,4,40
Rapid Vienna,8370,3,9,10,5,35,25,10,37
Mattersburg,8370,4,9,5,10,32,38,-6,32
LASK Linz,8370,5,8,5,11,25,30,-5,29
Vienna,8370,6,6,6,12,24,39,-15,24
SC Rheindorf,8370,7,5,6,13,19,30,-11,21
FC Salzburg,8371,1,15,6,3,47,18,29,51
SK Sturm Gra,8371,2,11,6,7,32,31,1,39
Rapid Vienna,8371,3,9,10,5,35,26,9,37
LASK Linz,8371,4,7,8,9,24,26,-2,29
Vienna,8371,5,7,6,11,26,39,-13,27
Mattersburg,8371,6,6,7,11,31,43,-12,25
SC Rheindorf,8371,7,4,7,13,18,30,-12,19
FC Salzburg,8372,1,15,7,2,50,18,32,52
SK Sturm Gra,8372,2,13,4,7,32,27,5,43
Rapid Vienna,8372,3,8,11,5,35,26,9,35
LASK Linz,8372,4,8,6,10,25,27,-2,30
Mattersburg,8372,5,7,6,11,31,44,-13,27
Vienna,8372,6,6,6,12,25,40,-15,24
SC Rheindorf,8372,7,4,6,14,16,32,-16,18
FC Salzburg,8373,1,14,8,2,44,17,27,50
SK Sturm Gra,8373,2,13,4,7,34,27,7,43
Rapid Vienna,8373,3,8,11,5,32,26,6,35
LASK Linz,8373,4,8,7,9,27,27,0,31
Mattersburg,8373,5,5,9,10,30,40,-10,24
Vienna,8373,6,6,6,12,25,42,-17,24
SC Rheindorf,8373,7,4,7,13,17,30,-13,19
FC Salzburg,8374,1,13,8,3,40,17,23,47
SK Sturm Gra,8374,2,14,4,6,33,26,7,46
Rapid Vienna,8374,3,7,12,5,34,27,7,33
LASK Linz,8374,4,7,7,10,26,30,-4,28
Vienna,8374,5,6,7,11,24,38,-14,25
SC Rheindorf,8374,6,5,8,11,21,29,-8,23
Mattersburg,8374,7,5,8,11,30,41,-11,23
FC Salzburg,8375,1,16,6,2,46,17,29,54
SK Sturm Gra,8375,2,12,4,8,32,28,4,40
Rapid Vienna,8375,3,9,9,6,36,28,8,36
LASK Linz,8375,4,9,6,9,27,27,0,33
Mattersburg,8375,5,7,6,11,31,40,-9,27
Vienna,8375,6,6,5,13,24,40,-16,23
SC Rheindorf,8375,7,4,6,14,17,33,-16,18
FC Salzburg,8376,1,13,8,3,41,18,23,47
SK Sturm Gra,8376,2,12,4,8,31,31,0,40
Rapid Vienna,8376,3,9,10,5,37,28,9,37
LASK Linz,8376,4,8,6,10,33,34,-1,30
Vienna,8376,5,7,6,11,25,38,-13,27
Mattersburg,8376,6,6,7,11,32,42,-10,25
SC Rheindorf,8376,7,6,5,13,24,32,-8,23
FC Salzburg,8377,1,14,8,2,43,17,26,50
SK Sturm Gra,8377,2,12,3,9,33,28,5,39
Rapid Vienna,8377,3,9,10,5,35,27,8,37
LASK Linz,8377,4,8,7,9,27,30,-3,31
Vienna,8377,5,7,5,12,27,40,-13,26
Mattersburg,8377,6,6,7,11,34,44,-10,25
SC Rheindorf,8377,7,5,6,13,18,31,-13,21
FC Salzburg,8378,1,14,7,3,43,16,27,49
SK Sturm Gra,8378,2,14,4,6,35,28,7,46
Rapid Vienna,8378,3,8,11,5,37,29,8,35
LASK Linz,8378,4,9,5,10,31,32,-1,32
Vienna,8378,5,7,6,11,26,38,-12,27
Mattersburg,8378,6,6,5,13,30,45,-15,23
SC Rheindorf,8378,7,4,6,14,17,31,-14,18
FC Salzburg,8379,1,15,7,2,46,19,27,52
SK Sturm Gra,8379,2,12,3,9,32,29,3,39
LASK Linz,8379,3,9,6,9,30,30,0,33
Rapid Vienna,8379,4,7,10,7,33,30,3,31
SC Rheindorf,8379,5,7,6,11,25,31,-6,27
Vienna,8379,6,6,6,12,23,38,-15,24
Mattersburg,8379,7,5,8,11,33,45,-12,23
FC Salzburg,8380,1,15,6,3,46,19,27,51
SK Sturm Gra,8380,2,12,4,8,33,31,2,40
Rapid Vienna,8380,3,7,11,6,34,31,3,32
LASK Linz,8380,4,8,6,10,29,31,-2,30
Vienna,8380,5,8,5,11,29,40,-11,29
Mattersburg,8380,6,7,5,12,35,44,-9,26
SC Rheindorf,8380,7,5,7,12,21,31,-10,22
FC Salzburg,8381,1,14,8,2,41,16,25,50
SK Sturm Gra,8381,2,11,7,6,32,28,4,40
LASK Linz,8381,3,10,6,8,30,27,3,36
Rapid Vienna,8381,4,8,11,5,35,28,7,35
Mattersburg,8381,5,6,6,12,30,39,-9,24
Vienna,8381,6,6,6,12,24,39,-15,24
SC Rheindorf,8381,7,4,6,14,16,31,-15,18
FC Salzburg,8382,1,13,8,3,45,21,24,47
SK Sturm Gra,8382,2,11,7,6,31,27,4,40
Rapid Vienna,8382,3,8,11,5,40,32,8,35
LASK Linz,8382,4,8,7,9,32,32,0,31
Mattersburg,8382,5,6,7,11,33,44,-11,25
Vienna,8382,6,6,7,11,26,40,-14,25
SC Rheindorf,8382,7,5,7,12,23,34,-11,22
FC Salzburg,8383,1,15,7,2,46,18,28,52
SK Sturm Gra,8383,2,14,3,7,36,27,9,45
Rapid Vienna,8383,3,7,10,7,34,29,5,31
LASK Linz,8383,4,8,5,11,26,32,-6,29
Mattersburg,8383,5,7,5,12,29,40,-11,26
Vienna,8383,6,7,5,12,24,39,-15,26
SC Rheindorf,8383,7,6,5,13,19,29,-10,23
FC Salzburg,8384,1,14,8,2,46,16,30,50
SK Sturm Gra,8384,2,12,4,8,31,28,3,40
Rapid Vienna,8384,3,7,11,6,33,29,4,32
LASK Linz,8384,4,9,5,10,29,30,-1,32
SC Rheindorf,8384,5,8,5,11,24,28,-4,29
Vienna,8384,6,7,5,12,26,43,-17,26
Mattersburg,8384,7,5,6,13,29,44,-15,21
FC Salzburg,8385,1,14,6,4,48,23,25,48
Rapid Vienna,8385,2,10,9,5,38,26,12,39
SK Sturm Gra,8385,3,11,3,10,30,35,-5,36
LASK Linz,8385,4,9,5,10,26,29,-3,32
SC Rheindorf,8385,5,7,5,12,20,27,-7,26
Mattersburg,8385,6,7,5,12,35,43,-8,26
Vienna,8385,7,7,5,12,27,41,-14,26
FC Salzburg,8386,1,16,6,2,50,17,33,54
SK Sturm Gra,8386,2,12,5,7,36,32,4,41
Rapid Vienna,8386,3,7,11,6,33,27,6,32
LASK Linz,8386,4,7,8,9,24,28,-4,29
Mattersburg,8386,5,6,7,11,29,40,-11,25
SC Rheindorf,8386,6,5,8,11,20,29,-9,23
Vienna,8386,7,6,5,13,23,42,-19,23
FC Salzburg,8387,1,15,6,3,45,17,28,51
SK Sturm Gra,8387,2,11,4,9,31,32,-1,37
Rapid Vienna,8387,3,8,11,5,36,27,9,35
LASK Linz,8387,4,9,6,9,28,28,0,33
Mattersburg,8387,5,8,5,11,31,41,-10,29
Vienna,8387,6,6,5,13,24,41,-17,23
SC Rheindorf,8387,7,5,7,12,21,30,-9,22
FC Salzburg,8388,1,15,6,3,45,19,26,51
SK Sturm Gra,8388,2,14,3,7,33,25,8,45
Rapid Vienna,8388,3,9,10,5,36,27,9,37
LASK Linz,8388,4,8,5,11,26,30,-4,29
Vienna,8388,5,6,6,12,25,41,-16,24
SC Rheindorf,8388,6,5,7,12,19,29,-10,22
Mattersburg,8388,7,5,7,12,29,42,-13,22
FC Salzburg,8389,1,15,7,2,44,16,28,52
SK Sturm Gra,8389,2,11,5,8,31,31,0,38
Rapid Vienna,8389,3,9,10,5,35,28,7,37
LASK Linz,8389,4,9,7,8,33,29,4,34
Mattersburg,8389,5,6,6,12,31,42,-11,24
Vienna,8389,6,6,5,13,25,41,-16,23
SC Rheindorf,8389,7,5,6,13,17,29,-12,21
FC Salzburg,8390,1,13,8,3,44,21,23,47
Rapid Vienna,8390,2,9,11,4,38,27,11,38
SK Sturm Gra,8390,3,11,4,9,31,30,1,37
LASK Linz,8390,4,9,6,9,30,31,-1,33
Mattersburg,8390,5,8,5,11,33,40,-7,29
Vienna,8390,6,6,6,12,25,40,-15,24
SC Rheindorf,8390,7,5,6,13,17,29,-12,21
FC Salzburg,8391,1,14,6,4,46,22,24,48
Rapid Vienna,8391,2,10,10,4,38,25,13,40
SK Sturm Gra,8391,3,11,5,8,32,31,1,38
LASK Linz,8391,4,9,5,10,29,29,0,32
Mattersburg,8391,5,8,5,11,36,43,-7,29
Vienna,8391,6,6,5,13,24,41,-17,23
SC Rheindorf,8391,7,5,6,13,19,33,-14,21
FC Salzburg,8392,1,15,6,3,46,19,27,51
SK Sturm Gra,8392,2,12,4,8,29,26,3,40
Rapid Vienna,8392,3,9,10,5,37,28,9,37
LASK Linz,8392,4,8,7,9,27,28,-1,31
Mattersburg,8392,5,8,5,11,33,41,-8,29
Vienna,8392,6,6,5,13,26,43,-17,23
SC Rheindorf,8392,7,5,5,14,19,32,-13,20
FC Salzburg,8393,1,12,7,5,39,19,20,43
SK Sturm Gra,8393,2,12,4,8,30,28,2,40
Rapid Vienna,8393,3,9,10,5,36,27,9,37
LASK Linz,8393,4,10,5,9,30,30,0,35
Mattersburg,8393,5,7,5,12,32,41,-9,26
SC Rheindorf,8393,6,6,7,11,24,29,-5,25
Vienna,8393,7,6,6,12,23,40,-17,24
FC Salzburg,8394,1,14,7,3,45,21,24,49
SK Sturm Gra,8394,2,14,3,7,35,29,6,45
LASK Linz,8394,3,8,7,9,29,28,1,31
Rapid Vienna,8394,4,7,9,8,33,34,-1,30
Vienna,8394,5,7,6,11,26,39,-13,27
SC Rheindorf,8394,6,6,6,12,23,29,-6,24
Mattersburg,8394,7,6,6,12,31,42,-11,24
FC Salzburg,8395,1,14,7,3,44,21,23,49
SK Sturm Gra,8395,2,12,5,7,32,27,5,41
Rapid Vienna,8395,3,9,10,5,36,26,10,37
LASK Linz,8395,4,8,7,9,25,26,-1,31
Mattersburg,8395,5,7,5,12,32,41,-9,26
Vienna,8395,6,6,6,12,26,42,-16,24
SC Rheindorf,8395,7,5,6,13,19,31,-12,21
FC Salzburg,8396,1,15,6,3,46,19,27,51
SK Sturm Gra,8396,2,13,4,7,32,27,5,43
Rapid Vienna,8396,3,9,10,5,39,29,10,37
LASK Linz,8396,4,8,7,9,30,31,-1,31
Mattersburg,8396,5,8,5,11,34,43,-9,29
Vienna,8396,6,6,5,13,27,43,-16,23
SC Rheindorf,8396,7,4,5,15,18,34,-16,17
FC Salzburg,8397,1,16,6,2,46,17,29,54
SK Sturm Gra,8397,2,11,5,8,33,31,2,38
Rapid Vienna,8397,3,9,10,5,35,26,9,37
LASK Linz,8397,4,7,7,10,28,32,-4,28
Mattersburg,8397,5,6,7,11,33,42,-9,25
Vienna,8397,6,6,6,12,24,41,-17,24
SC Rheindorf,8397,7,5,7,12,20,30,-10,22
FC Salzburg,8398,1,13,9,2,41,17,24,48
SK Sturm Gra,8398,2,13,5,6,31,25,6,44
Rapid Vienna,8398,3,8,10,6,35,28,7,34
LASK Linz,8398,4,9,6,9,30,27,3,33
Mattersburg,8398,5,6,7,11,29,39,-10,25
Vienna,8398,6,6,7,11,26,40,-14,25
SC Rheindorf,8398,7,4,6,14,16,32,-16,18
FC Salzburg,8399,1,15,6,3,47,20,27,51
SK Sturm Gra,8399,2,14,3,7,35,27,8,45
Rapid Vienna,8399,3,9,9,6,37,27,10,36
LASK Linz,8399,4,8,6,10,28,31,-3,30
Vienna,8399,5,7,6,11,24,37,-13,27
Mattersburg,8399,6,5,7,12,30,44,-14,22
SC Rheindorf,8399,7,4,7,13,17,32,-15,19
FC Salzburg,8400,1,14,8,2,41,16,25,50
SK Sturm Gra,8400,2,12,3,9,31,30,1,39
Rapid Vienna,8400,3,9,10,5,35,24,11,37
LASK Linz,8400,4,9,5,10,28,31,-3,32
Vienna,8400,5,6,7,11,24,38,-14,25
SC Rheindorf,8400,6,6,6,12,20,28,-8,24
Mattersburg,8400,7,5,7,12,28,40,-12,22
FC Salzburg,8401,1,14,6,4,43,21,22,48
SK Sturm Gra,8401,2,13,4,7,32,26,6,43
Rapid Vienna,8401,3,9,10,5,36,26,10,37
LASK Linz,8401,4,7,6,11,26,32,-6,27
SC Rheindorf,8401,5,7,6,11,23,29,-6,27
Mattersburg,8401,6,7,5,12,35,43,-8,26
Vienna,8401,7,6,5,13,26,44,-18,23
FC Salzburg,8402,1,13,8,3,46,22,24,47
SK Sturm Gra,8402,2,12,4,8,32,31,1,40
Rapid Vienna,8402,3,8,10,6,35,29,6,34
LASK Linz,8402,4,9,6,9,29,29,0,33
Mattersburg,8402,5,6,8,10,29,37,-8,26
SC Rheindorf,8402,6,6,6,12,21,27,-6,24
Vienna,8402,7,6,6,12,24,41,-17,24
FC Salzburg,8403,1,14,8,2,46,19,27,50
SK Sturm Gra,8403,2,12,5,7,30,28,2,41
Rapid Vienna,8403,3,8,12,4,37,28,9,36
LASK Linz,8403,4,7,6,11,24,28,-4,27
Mattersburg,8403,5,7,6,11,33,43,-10,27
SC Rheindorf,8403,6,6,6,12,23,31,-8,24
Vienna,8403,7,6,5,13,24,40,-16,23
FC Salzburg,8404,1,13,6,5,42,21,21,45
SK Sturm Gra,8404,2,13,4,7,33,26,7,43
Rapid Vienna,8404,3,9,9,6,35,29,6,36
LASK Linz,8404,4,10,6,8,27,24,3,36
Vienna,8404,5,8,5,11,27,38,-11,29
Mattersburg,8404,6,6,6,12,30,41,-11,24
SC Rheindorf,8404,7,4,6,14,17,32,-15,18
FC Salzburg,8405,1,15,6,3,47,17,30,51
SK Sturm Gra,8405,2,12,4,8,32,30,2,40
LASK Linz,8405,3,10,5,9,32,28,4,35
Rapid Vienna,8405,4,8,10,6,34,27,7,34
Vienna,8405,5,7,6,11,26,39,-13,27
Mattersburg,8405,6,6,6,12,29,46,-17,24
SC Rheindorf,8405,7,5,5,14,18,31,-13,20
FC Salzburg,8406,1,13,7,4,42,19,23,46
SK Sturm Gra,8406,2,13,3,8,31,27,4,42
Rapid Vienna,8406,3,8,10,6,34,29,5,34
LASK Linz,8406,4,9,5,10,29,29,0,32
Vienna,8406,5,8,5,11,26,37,-11,29
Mattersburg,8406,6,6,7,11,29,40,-11,25
SC Rheindorf,8406,7,5,7,12,17,27,-10,22
FC Salzburg,8407,1,16,6,2,51,19,32,54
SK Sturm Gra,8407,2,12,3,9,30,30,0,39
Rapid Vienna,8407,3,9,10,5,35,27,8,37
Mattersburg,8407,4,7,6,11,33,43,-10,27
LASK Linz,8407,5,7,5,12,25,30,-5,26
SC Rheindorf,8407,6,6,6,12,18,28,-10,24
Vienna,8407,7,6,6,12,27,42,-15,24
FC Salzburg,8408,1,15,6,3,43,18,25,51
SK Sturm Gra,8408,2,11,5,8,30,31,-1,38
Rapid Vienna,8408,3,8,11,5,35,27,8,35
LASK Linz,8408,4,9,7,8,33,28,5,34
Mattersburg,8408,5,6,6,12,31,42,-11,24
Vienna,8408,6,6,6,12,25,40,-15,24
SC Rheindorf,8408,7,5,7,12,18,29,-11,22
FC Salzburg,8409,1,15,7,2,47,17,30,52
SK Sturm Gra,8409,2,12,4,8,31,32,-1,40
Rapid Vienna,8409,3,7,11,6,37,31,6,32
LASK Linz,8409,4,8,7,9,26,27,-1,31
SC Rheindorf,8409,5,7,6,11,21,27,-6,27
Mattersburg,8409,6,6,6,12,31,41,-10,24
Vienna,8409,7,6,5,13,24,42,-18,23
FC Salzburg,8410,1,14,8,2,42,15,27,50
SK Sturm Gra,8410,2,11,5,8,30,28,2,38
Rapid Vienna,8410,3,9,10,5,36,26,10,37
LASK Linz,8410,4,8,6,10,27,30,-3,30
Vienna,8410,5,7,6,11,25,37,-12,27
SC Rheindorf,8410,6,6,6,12,22,31,-9,24
Mattersburg,8410,7,6,5,13,31,46,-15,23
FC Salzburg,8411,1,15,6,3,46,19,27,51
SK Sturm Gra,8411,2,12,5,7,33,29,4,41
Rapid Vienna,8411,3,10,10,4,35,24,11,40
LASK Linz,8411,4,7,6,11,25,31,-6,27
Mattersburg,8411,5,6,7,11,31,41,-10,25
Vienna,8411,6,6,6,12,25,41,-16,24
SC Rheindorf,8411,7,5,6,13,20,30,-10,21
FC Salzburg,8412,1,16,6,2,46,16,30,54
SK Sturm Gra,8412,2,12,5,7,33,30,3,41
Rapid Vienna,8412,3,9,10,5,34,25,9,37
LASK Linz,8412,4,8,6,10,27,30,-3,30
Vienna,8412,5,7,5,12,26,39,-13,26
Mattersburg,8412,6,6,6,12,31,44,-13,24
SC Rheindorf,8412,7,4,6,14,16,29,-13,18
FC Salzburg,8413,1,13,8,3,44,21,23,47
SK Sturm Gra,8413,2,13,5,6,38,29,9,44
Rapid Vienna,8413,3,9,9,6,41,32,9,36
LASK Linz,8413,4,9,5,10,33,35,-2,32
Vienna,8413,5,7,5,12,25,42,-17,26
SC Rheindorf,8413,6,5,7,12,22,31,-9,22
Mattersburg,8413,7,5,7,12,31,44,-13,22
FC Salzburg,8414,1,13,7,4,42,21,21,46
Rapid Vienna,8414,2,9,10,5,36,26,10,37
SK Sturm Gra,8414,3,11,4,9,31,33,-2,37
LASK Linz,8414,4,10,5,9,30,29,1,35
Vienna,8414,5,8,5,11,30,38,-8,29
Mattersburg,8414,6,7,6,11,33,42,-9,27
SC Rheindorf,8414,7,5,5,14,19,32,-13,20
FC Salzburg,8415,1,16,6,2,53,20,33,54
SK Sturm Gra,8415,2,14,3,7,35,29,6,45
Rapid Vienna,8415,3,8,9,7,39,33,6,33
LASK Linz,8415,4,8,5,11,27,30,-3,29
Mattersburg,8415,5,7,5,12,30,41,-11,26
Vienna,8415,6,7,5,12,26,42,-16,26
SC Rheindorf,8415,7,5,5,14,18,33,-15,20
FC Salzburg,8416,1,13,7,4,41,21,20,46
SK Sturm Gra,8416,2,14,3,7,38,28,10,45
Rapid Vienna,8416,3,10,9,5,37,26,11,39
LASK Linz,8416,4,8,6,10,26,29,-3,30
Mattersburg,8416,5,7,6,11,30,39,-9,27
Vienna,8416,6,6,6,12,25,40,-15,24
SC Rheindorf,8416,7,5,5,14,17,31,-14,20
FC Salzburg,8417,1,14,8,2,48,20,28,50
SK Sturm Gra,8417,2,12,4,8,31,28,3,40
Rapid Vienna,8417,3,9,9,6,36,26,10,36
LASK Linz,8417,4,9,6,9,27,28,-1,33
Vienna,8417,5,7,5,12,30,43,-13,26
Mattersburg,8417,6,6,7,11,33,47,-14,25
SC Rheindorf,8417,7,5,5,14,18,31,-13,20
FC Salzburg,8418,1,14,8,2,46,18,28,50
SK Sturm Gra,8418,2,11,5,8,32,30,2,38
Rapid Vienna,8418,3,8,10,6,35,31,4,34
LASK Linz,8418,4,9,6,9,29,30,-1,33
Vienna,8418,5,6,7,11,25,39,-14,25
SC Rheindorf,8418,6,5,8,11,21,27,-6,23
Mattersburg,8418,7,5,8,11,28,41,-13,23
FC Salzburg,8419,1,15,7,2,45,19,26,52
SK Sturm Gra,8419,2,12,5,7,32,27,5,41
Rapid Vienna,8419,3,7,13,4,34,26,8,34
Mattersburg,8419,4,8,5,11,35,43,-8,29
LASK Linz,8419,5,7,7,10,25,29,-4,28
Vienna,8419,6,6,5,13,25,41,-16,23
SC Rheindorf,8419,7,4,8,12,18,29,-11,20
FC Salzburg,8420,1,15,6,3,47,19,28,51
SK Sturm Gra,8420,2,12,5,7,34,30,4,41
Rapid Vienna,8420,3,8,10,6,35,32,3,34
LASK Linz,8420,4,8,7,9,30,33,-3,31
Mattersburg,8420,5,8,5,11,37,41,-4,29
Vienna,8420,6,7,5,12,27,39,-12,26
SC Rheindorf,8420,7,4,6,14,20,36,-16,18
FC Salzburg,8421,1,15,7,2,48,19,29,52
SK Sturm Gra,8421,2,12,5,7,34,30,4,41
Rapid Vienna,8421,3,8,10,6,38,28,10,34
LASK Linz,8421,4,7,7,10,28,33,-5,28
Vienna,8421,5,7,6,11,27,39,-12,27
Mattersburg,8421,6,7,5,12,30,42,-12,26
SC Rheindorf,8421,7,5,6,13,19,33,-14,21
FC Salzburg,8422,1,13,7,4,42,19,23,46
SK Sturm Gra,8422,2,13,4,7,32,28,4,43
Rapid Vienna,8422,3,8,9,7,32,28,4,33
LASK Linz,8422,4,8,6,10,31,32,-1,30
SC Rheindorf,8422,5,8,5,11,23,27,-4,29
Vienna,8422,6,7,5,12,26,40,-14,26
Mattersburg,8422,7,6,6,12,32,44,-12,24
FC Salzburg,8423,1,14,7,3,42,18,24,49
Rapid Vienna,8423,2,10,10,4,39,24,15,40
SK Sturm Gra,8423,3,11,3,10,31,33,-2,36
LASK Linz,8423,4,8,5,11,27,30,-3,29
Vienna,8423,5,8,5,11,26,37,-11,29
SC Rheindorf,8423,6,6,6,12,19,30,-11,24
Mattersburg,8423,7,6,6,12,28,40,-12,24
FC Salzburg,8424,1,14,6,4,47,20,27,48
SK Sturm Gra,8424,2,15,3,6,35,25,10,48
Rapid Vienna,8424,3,10,9,5,37,26,11,39
LASK Linz,8424,4,8,6,10,27,29,-2,30
Mattersburg,8424,5,6,6,12,29,45,-16,24
Vienna,8424,6,6,6,12,25,42,-17,24
SC Rheindorf,8424,7,4,6,14,15,28,-13,18
FC Salzburg,8425,1,13,7,4,42,19,23,46
SK Sturm Gra,8425,2,13,4,7,35,28,7,43
Rapid Vienna,8425,3,8,11,5,33,25,8,35
LASK Linz,8425,4,9,5,10,27,31,-4,32
Vienna,8425,5,8,5,11,27,37,-10,29
SC Rheindorf,8425,6,6,5,13,22,32,-10,23
Mattersburg,8425,7,6,5,13,31,45,-14,23
FC Salzburg,8426,1,14,7,3,44,19,25,49
SK Sturm Gra,8426,2,12,6,6,35,27,8,42
Rapid Vienna,8426,3,8,11,5,39,30,9,35
LASK Linz,8426,4,8,6,10,27,32,-5,30
Vienna,8426,5,7,5,12,26,41,-15,26
SC Rheindorf,8426,6,6,6,12,20,30,-10,24
Mattersburg,8426,7,6,5,13,31,43,-12,23
FC Salzburg,8427,1,16,6,2,49,17,32,54
SK Sturm Gra,8427,2,12,4,8,29,28,1,40
Rapid Vienna,8427,3,8,10,6,36,28,8,34
LASK Linz,8427,4,8,6,10,26,31,-5,30
Mattersburg,8427,5,7,5,12,30,42,-12,26
SC Rheindorf,8427,6,6,6,12,21,28,-7,24
Vienna,8427,7,6,5,13,25,42,-17,23
FC Salzburg,8428,1,13,9,2,47,22,25,48
SK Sturm Gra,8428,2,12,4,8,36,33,3,40
Rapid Vienna,8428,3,9,11,4,38,26,12,38
Vienna,8428,4,7,6,11,26,39,-13,27
LASK Linz,8428,5,7,5,12,24,33,-9,26
Mattersburg,8428,6,6,7,11,33,42,-9,25
SC Rheindorf,8428,7,6,6,12,20,29,-9,24
FC Salzburg,8429,1,14,8,2,44,19,25,50
SK Sturm Gra,8429,2,12,6,6,33,28,5,42
Rapid Vienna,8429,3,9,10,5,37,27,10,37
LASK Linz,8429,4,8,5,11,29,35,-6,29
Mattersburg,8429,5,7,6,11,34,40,-6,27
Vienna,8429,6,6,7,11,24,38,-14,25
SC Rheindorf,8429,7,4,6,14,17,31,-14,18
FC Salzburg,8430,1,14,7,3,45,19,26,49
SK Sturm Gra,8430,2,13,4,7,32,28,4,43
Rapid Vienna,8430,3,10,10,4,37,25,12,40
LASK Linz,8430,4,8,6,10,28,30,-2,30
Vienna,8430,5,7,6,11,25,38,-13,27
SC Rheindorf,8430,6,5,6,13,18,30,-12,21
Mattersburg,8430,7,5,5,14,30,45,-15,20
FC Salzburg,8431,1,15,7,2,46,20,26,52
SK Sturm Gra,8431,2,11,3,10,29,31,-2,36
LASK Linz,8431,3,10,5,9,29,27,2,35
Rapid Vienna,8431,4,8,10,6,34,27,7,34
Vienna,8431,5,7,6,11,26,39,-13,27
SC Rheindorf,8431,6,6,7,11,21,28,-7,25
Mattersburg,8431,7,5,6,13,30,43,-13,21
FC Salzburg,8432,1,14,7,3,43,19,24,49
SK Sturm Gra,8432,2,13,3,8,37,33,4,42
Rapid Vienna,8432,3,8,11,5,36,30,6,35
LASK Linz,8432,4,7,7,10,26,32,-6,28
Mattersburg,8432,5,6,8,10,32,38,-6,26
SC Rheindorf,8432,6,6,7,11,25,28,-3,25
Vienna,8432,7,6,5,13,23,42,-19,23
FC Salzburg,8433,1,15,6,3,50,20,30,51
SK Sturm Gra,8433,2,13,3,8,32,27,5,42
Rapid Vienna,8433,3,9,10,5,35,26,9,37
LASK Linz,8433,4,7,6,11,25,31,-6,27
Mattersburg,8433,5,7,5,12,34,45,-11,26
SC Rheindorf,8433,6,6,7,11,20,28,-8,25
Vienna,8433,7,6,5,13,24,43,-19,23
FC Salzburg,8434,1,13,8,3,42,20,22,47
SK Sturm Gra,8434,2,12,4,8,36,32,4,40
Rapid Vienna,8434,3,10,9,5,42,29,13,39
LASK Linz,8434,4,10,5,9,31,26,5,35
Vienna,8434,5,7,6,11,24,37,-13,27
SC Rheindorf,8434,6,6,5,13,20,35,-15,23
Mattersburg,8434,7,5,5,14,27,43,-16,20
FC Salzburg,8435,1,15,7,2,47,18,29,52
SK Sturm Gra,8435,2,12,3,9,32,32,0,39
Rapid Vienna,8435,3,9,10,5,36,27,9,37
LASK Linz,8435,4,8,6,10,29,31,-2,30
Mattersburg,8435,5,8,5,11,34,40,-6,29
Vienna,8435,6,6,5,13,24,43,-19,23
SC Rheindorf,8435,7,5,6,13,21,32,-11,21
FC Salzburg,8436,1,15,7,2,45,16,29,52
SK Sturm Gra,8436,2,12,4,8,32,31,1,40
Rapid Vienna,8436,3,9,9,6,34,27,7,36
LASK Linz,8436,4,9,6,9,26,25,1,33
Mattersburg,8436,5,6,7,11,31,40,-9,25
Vienna,8436,6,6,5,13,25,43,-18,23
SC Rheindorf,8436,7,4,8,12,17,28,-11,20
FC Salzburg,8437,1,15,6,3,43,18,25,51
SK Sturm Gra,8437,2,11,5,8,33,31,2,38
Rapid Vienna,8437,3,8,11,5,37,26,11,35
LASK Linz,8437,4,9,5,10,27,31,-4,32
Mattersburg,8437,5,7,5,12,30,40,-10,26
SC Rheindorf,8437,6,6,7,11,21,28,-7,25
Vienna,8437,7,6,5,13,24,41,-17,23
FC Salzburg,8438,1,14,7,3,47,23,24,49
SK Sturm Gra,8438,2,13,3,8,36,32,4,42
Rapid Vienna,8438,3,8,11,5,36,32,4,35
LASK Linz,8438,4,7,8,9,25,27,-2,29
Vienna,8438,5,7,5,12,29,41,-12,26
SC Rheindorf,8438,6,6,6,12,22,28,-6,24
Mattersburg,8438,7,6,6,12,29,41,-12,24
FC Salzburg,8439,1,16,6,2,48,18,30,54
SK Sturm Gra,8439,2,11,6,7,29,28,1,39
Rapid Vienna,8439,3,8,10,6,37,29,8,34
LASK Linz,8439,4,8,6,10,25,28,-3,30
Vienna,8439,5,7,5,12,25,38,-13,26
SC Rheindorf,8439,6,6,6,12,18,28,-10,24
Mattersburg,8439,7,6,5,13,30,43,-13,23
FC Salzburg,8440,1,15,6,3,47,18,29,51
SK Sturm Gra,8440,2,12,4,8,32,30,2,40
Rapid Vienna,8440,3,8,10,6,36,29,7,34
LASK Linz,8440,4,8,8,8,29,29,0,32
SC Rheindorf,8440,5,7,6,11,22,28,-6,27
Vienna,8440,6,7,5,12,26,40,-14,26
Mattersburg,8440,7,5,5,14,31,49,-18,20
FC Salzburg,8441,1,13,8,3,42,19,23,47
SK Sturm Gra,8441,2,12,3,9,34,33,1,39
Rapid Vienna,8441,3,9,10,5,35,25,10,37
LASK Linz,8441,4,10,5,9,30,27,3,35
Vienna,8441,5,7,6,11,27,39,-12,27
SC Rheindorf,8441,6,6,5,13,18,27,-9,23
Mattersburg,8441,7,6,5,13,28,44,-16,23
FC Salzburg,8442,1,15,7,2,48,19,29,52
SK Sturm Gra,8442,2,12,5,7,33,28,5,41
Rapid Vienna,8442,3,9,10,5,36,28,8,37
LASK Linz,8442,4,8,5,11,27,31,-4,29
Vienna,8442,5,7,6,11,27,39,-12,27
Mattersburg,8442,6,6,5,13,32,47,-15,23
SC Rheindorf,8442,7,5,6,13,20,31,-11,21
FC Salzburg,8443,1,16,6,2,46,16,30,54
SK Sturm Gra,8443,2,11,5,8,31,31,0,38
Rapid Vienna,8443,3,8,11,5,34,26,8,35
LASK Linz,8443,4,8,7,9,28,30,-2,31
Mattersburg,8443,5,6,6,12,32,41,-9,24
Vienna,8443,6,6,6,12,24,40,-16,24
SC Rheindorf,8443,7,6,5,13,18,29,-11,23
FC Salzburg,8444,1,15,6,3,44,16,28,51
SK Sturm Gra,8444,2,12,4,8,31,31,0,40
Rapid Vienna,8444,3,9,10,5,35,26,9,37
LASK Linz,8444,4,9,6,9,29,28,1,33
Vienna,8444,5,7,5,12,25,38,-13,26
Mattersburg,8444,6,6,5,13,29,43,-14,23
SC Rheindorf,8444,7,5,6,13,21,32,-11,21
FC Salzburg,8445,1,13,8,3,43,18,25,47
SK Sturm Gra,8445,2,13,4,7,35,26,9,43
Rapid Vienna,8445,3,10,9,5,35,27,8,39
Vienna,8445,4,7,6,11,25,38,-13,27
LASK Linz,8445,5,7,5,12,23,32,-9,26
SC Rheindorf,8445,6,6,6,12,22,30,-8,24
Mattersburg,8445,7,6,6,12,31,43,-12,24
FC Salzburg,8446,1,15,6,3,43,17,26,51
SK Sturm Gra,8446,2,13,4,7,32,26,6,43
Rapid Vienna,8446,3,9,9,6,34,30,4,36
LASK Linz,8446,4,8,6,10,28,27,1,30
Mattersburg,8446,5,7,5,12,31,41,-10,26
Vienna,8446,6,7,5,12,24,39,-15,26
SC Rheindorf,8446,7,5,5,14,19,31,-12,20
FC Salzburg,8447,1,13,8,3,43,19,24,47
SK Sturm Gra,8447,2,13,4,7,34,27,7,43
Rapid Vienna,8447,3,8,9,7,34,28,6,33
LASK Linz,8447,4,8,5,11,26,32,-6,29
Mattersburg,8447,5,8,5,11,32,40,-8,29
SC Rheindorf,8447,6,7,5,12,19,27,-8,26
Vienna,8447,7,6,6,12,24,39,-15,24
FC Salzburg,8448,1,14,6,4,45,20,25,48
Rapid Vienna,8448,2,11,9,4,41,25,16,42
SK Sturm Gra,8448,3,12,4,8,31,31,0,40
LASK Linz,8448,4,8,7,9,30,30,0,31
Vienna,8448,5,8,5,11,25,37,-12,29
Mattersburg,8448,6,6,6,12,32,43,-11,24
SC Rheindorf,8448,7,4,5,15,15,33,-18,17
FC Salzburg,8449,1,13,7,4,42,19,23,46
SK Sturm Gra,8449,2,13,3,8,32,30,2,42
Rapid Vienna,8449,3,9,9,6,35,26,9,36
LASK Linz,8449,4,8,5,11,25,29,-4,29
Mattersburg,8449,5,8,5,11,34,41,-7,29
Vienna,8449,6,7,6,11,27,40,-13,27
SC Rheindorf,8449,7,6,5,13,19,29,-10,23
FC Salzburg,8450,1,15,6,3,46,18,28,51
Rapid Vienna,8450,2,10,10,4,38,24,14,40
SK Sturm Gra,8450,3,11,6,7,31,28,3,39
LASK Linz,8450,4,9,6,9,30,29,1,33
Mattersburg,8450,5,6,6,12,33,45,-12,24
Vienna,8450,6,6,6,12,25,41,-16,24
SC Rheindorf,8450,7,4,6,14,17,35,-18,18
FC Salzburg,8451,1,14,7,3,43,18,25,49
SK Sturm Gra,8451,2,13,3,8,30,27,3,42
Rapid Vienna,8451,3,7,11,6,33,28,5,32
LASK Linz,8451,4,9,5,10,27,27,0,32
Mattersburg,8451,5,9,5,10,33,38,-5,32
Vienna,8451,6,6,5,13,23,40,-17,23
SC Rheindorf,8451,7,5,6,13,19,30,-11,21
FC Salzburg,8452,1,16,6,2,50,20,30,54
SK Sturm Gra,8452,2,12,4,8,30,28,2,40
Rapid Vienna,8452,3,10,9,5,39,27,12,39
LASK Linz,8452,4,7,5,12,25,32,-7,26
Vienna,8452,5,7,5,12,28,42,-14,26
SC Rheindorf,8452,6,6,6,12,22,31,-9,24
Mattersburg,8452,7,6,5,13,32,46,-14,23
FC Salzburg,8453,1,15,7,2,44,17,27,52
SK Sturm Gra,8453,2,12,4,8,33,30,3,40
Rapid Vienna,8453,3,8,10,6,38,30,8,34
LASK Linz,8453,4,8,5,11,27,30,-3,29
Mattersburg,8453,5,7,7,10,30,38,-8,28
SC Rheindorf,8453,6,6,6,12,18,28,-10,24
Vienna,8453,7,6,5,13,26,43,-17,23
FC Salzburg,8454,1,14,8,2,43,18,25,50
SK Sturm Gra,8454,2,14,4,6,37,26,11,46
Rapid Vienna,8454,3,9,9,6,35,27,8,36
LASK Linz,8454,4,8,5,11,24,30,-6,29
Vienna,8454,5,7,5,12,28,40,-12,26
Mattersburg,8454,6,6,6,12,29,45,-16,24
SC Rheindorf,8454,7,5,5,14,19,29,-10,20
FC Salzburg,8455,1,13,8,3,43,20,23,47
Rapid Vienna,8455,2,11,9,4,42,27,15,42
SK Sturm Gra,8455,3,12,3,9,33,31,2,39
LASK Linz,8455,4,7,6,11,25,31,-6,27
Vienna,8455,5,7,6,11,30,39,-9,27
Mattersburg,8455,6,6,7,11,31,45,-14,25
SC Rheindorf,8455,7,5,7,12,18,29,-11,22
FC Salzburg,8456,1,14,7,3,51,25,26,49
SK Sturm Gra,8456,2,13,3,8,35,34,1,42
Rapid Vienna,8456,3,8,10,6,37,30,7,34
LASK Linz,8456,4,9,6,9,28,27,1,33
Mattersburg,8456,5,7,6,11,30,41,-11,27
SC Rheindorf,8456,6,6,5,13,21,28,-7,23
Vienna,8456,7,6,5,13,26,43,-17,23
FC Salzburg,8457,1,16,6,2,46,18,28,54
SK Sturm Gra,8457,2,14,3,7,37,27,10,45
Rapid Vienna,8457,3,8,9,7,35,32,3,33
LASK Linz,8457,4,8,5,11,27,33,-6,29
Vienna,8457,5,7,5,12,28,42,-14,26
SC Rheindorf,8457,6,6,6,12,21,29,-8,24
Mattersburg,8457,7,5,6,13,33,46,-13,21
FC Salzburg,8458,1,15,7,2,45,18,27,52
SK Sturm Gra,8458,2,12,4,8,31,28,3,40
Rapid Vienna,8458,3,8,10,6,35,28,7,34
Mattersburg,8458,4,7,6,11,29,38,-9,27
LASK Linz,8458,5,7,5,12,25,31,-6,26
SC Rheindorf,8458,6,7,5,12,20,28,-8,26
Vienna,8458,7,6,7,11,23,37,-14,25
FC Salzburg,8459,1,15,7,2,46,17,29,52
SK Sturm Gra,8459,2,13,4,7,31,29,2,43
Rapid Vienna,8459,3,8,11,5,34,25,9,35
LASK Linz,8459,4,7,6,11,24,32,-8,27
Mattersburg,8459,5,6,7,11,34,41,-7,25
Vienna,8459,6,6,6,12,26,41,-15,24
SC Rheindorf,8459,7,4,9,11,19,29,-10,21
FC Salzburg,8460,1,13,8,3,43,18,25,47
SK Sturm Gra,8460,2,13,5,6,34,27,7,44
Rapid Vienna,8460,3,7,12,5,35,28,7,33
LASK Linz,8460,4,8,7,9,26,27,-1,31
SC Rheindorf,8460,5,7,5,12,19,28,-9,26
Vienna,8460,6,6,6,12,26,43,-17,24
Mattersburg,8460,7,5,7,12,29,41,-12,22
FC Salzburg,8461,1,15,7,2,46,16,30,52
SK Sturm Gra,8461,2,13,3,8,36,30,6,42
Rapid Vienna,8461,3,8,9,7,33,27,6,33
LASK Linz,8461,4,9,5,10,27,31,-4,32
SC Rheindorf,8461,5,6,6,12,22,30,-8,24
Mattersburg,8461,6,6,6,12,32,46,-14,24
Vienna,8461,7,6,6,12,27,43,-16,24
FC Salzburg,8462,1,15,6,3,42,19,23,51
SK Sturm Gra,8462,2,13,4,7,34,28,6,43
Rapid Vienna,8462,3,7,11,6,34,29,5,32
LASK Linz,8462,4,8,6,10,27,29,-2,30
Vienna,8462,5,7,5,12,26,39,-13,26
Mattersburg,8462,6,6,6,12,29,39,-10,24
SC Rheindorf,8462,7,5,8,11,21,30,-9,23
FC Salzburg,8463,1,16,6,2,47,16,31,54
SK Sturm Gra,8463,2,14,3,7,33,26,7,45
Rapid Vienna,8463,3,8,10,6,33,28,5,34
LASK Linz,8463,4,9,5,10,30,30,0,32
Mattersburg,8463,5,6,5,13,31,46,-15,23
Vienna,8463,6,6,5,13,24,40,-16,23
SC Rheindorf,8463,7,5,6,13,18,30,-12,21
FC Salzburg,8464,1,15,7,2,45,15,30,52
SK Sturm Gra,8464,2,12,4,8,30,28,2,40
Rapid Vienna,8464,3,8,11,5,33,25,8,35
LASK Linz,8464,4,8,7,9,26,27,-1,31
Vienna,8464,5,7,5,12,24,40,-16,26
SC Rheindorf,8464,6,5,8,11,20,28,-8,23
Mattersburg,8464,7,5,6,13,29,44,-15,21
FC Salzburg,8465,1,14,7,3,46,20,26,49
SK Sturm Gra,8465,2,14,3,7,35,28,7,45
Rapid Vienna,8465,3,9,9,6,38,27,11,36
LASK Linz,8465,4,9,5,10,29,33,-4,32
Mattersburg,8465,5,7,5,12,29,41,-12,26
Vienna,8465,6,6,6,12,24,39,-15,24
SC Rheindorf,8465,7,5,5,14,18,31,-13,20
FC Salzburg,8466,1,14,8,2,47,19,28,50
SK Sturm Gra,8466,2,13,4,7,33,28,5,43
Rapid Vienna,8466,3,9,9,6,38,28,10,36
LASK Linz,8466,4,8,5,11,27,31,-4,29
Mattersburg,8466,5,7,6,11,30,41,-11,27
Vienna,8466,6,7,5,12,26,41,-15,26
SC Rheindorf,8466,7,5,5,14,20,33,-13,20
FC Salzburg,8467,1,14,7,3,47,19,28,49
SK Sturm Gra,8467,2,12,4,8,33,33,0,40
Rapid Vienna,8467,3,9,11,4,36,26,10,38
LASK Linz,8467,4,9,5,10,29,29,0,32
Vienna,8467,5,7,6,11,26,39,-13,27
SC Rheindorf,8467,6,6,6,12,21,30,-9,24
Mattersburg,8467,7,5,5,14,31,47,-16,20
FC Salzburg,8468,1,14,8,2,46,18,28,50
SK Sturm Gra,8468,2,13,5,6,35,26,9,44
Rapid Vienna,8468,3,8,11,5,37,29,8,35
LASK Linz,8468,4,9,6,9,29,30,-1,33
Vienna,8468,5,6,6,12,25,41,-16,24
SC Rheindorf,8468,6,5,6,13,19,30,-11,21
Mattersburg,8468,7,5,6,13,28,45,-17,21
FC Salzburg,8469,1,16,6,2,49,19,30,54
SK Sturm Gra,8469,2,12,3,9,32,30,2,39
LASK Linz,8469,3,8,8,8,28,28,0,32
Rapid Vienna,8469,4,7,10,7,34,29,5,31
SC Rheindorf,8469,5,7,6,11,22,29,-7,27
Vienna,8469,6,6,6,12,26,43,-17,24
Mattersburg,8469,7,5,7,12,31,44,-13,22
FC Salzburg,8470,1,15,7,2,49,16,33,52
SK Sturm Gra,8470,2,12,4,8,32,28,4,40
LASK Linz,8470,3,10,5,9,29,29,0,35
Rapid Vienna,8470,4,8,9,7,34,30,4,33
Mattersburg,8470,5,7,5,12,30,44,-14,26
SC Rheindorf,8470,6,6,5,13,21,30,-9,23
Vienna,8470,7,6,5,13,23,41,-18,23
FC Salzburg,8471,1,13,7,4,45,22,23,46
SK Sturm Gra,8471,2,13,4,7,37,29,8,43
Rapid Vienna,8471,3,8,11,5,38,33,5,35
LASK Linz,8471,4,9,6,9,31,30,1,33
Mattersburg,8471,5,6,7,11,30,41,-11,25
Vienna,8471,6,6,7,11,25,39,-14,25
SC Rheindorf,8471,7,4,8,12,18,30,-12,20
FC Salzburg,8472,1,14,8,2,47,19,28,50
SK Sturm Gra,8472,2,13,4,7,34,30,4,43
Rapid Vienna,8472,3,8,10,6,34,28,6,34
LASK Linz,8472,4,9,7,8,29,26,3,34
Mattersburg,8472,5,6,6,12,30,41,-11,24
Vienna,8472,6,6,6,12,25,41,-16,24
SC Rheindorf,8472,7,4,7,13,15,29,-14,19
FC Salzburg,8473,1,14,8,2,44,19,25,50
SK Sturm Gra,8473,2,12,4,8,31,28,3,40
Rapid Vienna,8473,3,8,11,5,33,27,6,35
LASK Linz,8473,4,8,8,8,28,26,2,32
Vienna,8473,5,7,6,11,28,41,-13,27
SC Rheindorf,8473,6,6,5,13,24,32,-8,23
Mattersburg,8473,7,5,6,13,30,45,-15,21
FC Salzburg,8474,1,14,6,4,40,18,22,48
SK Sturm Gra,8474,2,13,3,8,32,27,5,42
Rapid Vienna,8474,3,9,9,6,36,27,9,36
LASK Linz,8474,4,9,5,10,29,29,0,32
Mattersburg,8474,5,7,5,12,32,42,-10,26
Vienna,8474,6,7,5,12,25,39,-14,26
SC Rheindorf,8474,7,6,5,13,19,31,-12,23
FC Salzburg,8475,1,15,6,3,48,20,28,51
Rapid Vienna,8475,2,10,9,5,36,26,10,39
SK Sturm Gra,8475,3,11,3,10,30,32,-2,36
LASK Linz,8475,4,9,6,9,27,26,1,33
Mattersburg,8475,5,7,6,11,33,40,-7,27
SC Rheindorf,8475,6,6,5,13,18,29,-11,23
Vienna,8475,7,6,5,13,24,43,-19,23
FC Salzburg,8476,1,16,6,2,48,18,30,54
SK Sturm Gra,8476,2,13,3,8,33,28,5,42
Rapid Vienna,8476,3,8,10,6,37,29,8,34
LASK Linz,8476,4,8,5,11,24,30,-6,29
Mattersburg,8476,5,7,6,11,31,40,-9,27
Vienna,8476,6,6,6,12,25,42,-17,24
SC Rheindorf,8476,7,5,6,13,18,29,-11,21
FC Salzburg,8477,1,15,6,3,47,17,30,51
SK Sturm Gra,8477,2,13,3,8,31,31,0,42
Rapid Vienna,8477,3,10,9,5,39,27,12,39
LASK Linz,8477,4,8,7,9,28,27,1,31
Vienna,8477,5,7,5,12,27,39,-12,26
Mattersburg,8477,6,6,6,12,29,47,-18,24
SC Rheindorf,8477,7,4,6,14,17,30,-13,18
FC Salzburg,8478,1,15,6,3,52,20,32,51
SK Sturm Gra,8478,2,13,3,8,35,28,7,42
Rapid Vienna,8478,3,9,9,6,38,30,8,36
LASK Linz,8478,4,8,6,10,27,34,-7,30
Mattersburg,8478,5,6,7,11,32,46,-14,25
SC Rheindorf,8478,6,6,6,12,21,29,-8,24
Vienna,8478,7,6,5,13,24,42,-18,23
FC Salzburg,8479,1,14,7,3,46,20,26,49
SK Sturm Gra,8479,2,12,3,9,30,30,0,39
Rapid Vienna,8479,3,9,10,5,34,26,8,37
LASK Linz,8479,4,7,8,9,27,29,-2,29
Mattersburg,8479,5,6,8,10,34,43,-9,26
SC Rheindorf,8479,6,6,7,11,23,28,-5,25
Vienna,8479,7,6,5,13,23,41,-18,23
FC Salzburg,8480,1,16,6,2,47,17,30,54
SK Sturm Gra,8480,2,11,5,8,33,31,2,38
Rapid Vienna,8480,3,9,10,5,37,27,10,37
Mattersburg,8480,4,8,5,11,31,41,-10,29
LASK Linz,8480,5,7,6,11,28,34,-6,27
SC Rheindorf,8480,6,6,5,13,19,29,-10,23
Vienna,8480,7,6,5,13,25,41,-16,23
FC Salzburg,8481,1,14,6,4,44,20,24,48
SK Sturm Gra,8481,2,14,3,7,35,27,8,45
Rapid Vienna,8481,3,9,9,6,39,28,11,36
LASK Linz,8481,4,8,5,11,26,31,-5,29
Vienna,8481,5,7,6,11,27,39,-12,27
Mattersburg,8481,6,6,7,11,32,42,-10,25
SC Rheindorf,8481,7,5,6,13,18,34,-16,21
FC Salzburg,8482,1,14,6,4,43,18,25,48
SK Sturm Gra,8482,2,13,3,8,34,29,5,42
LASK Linz,8482,3,10,5,9,31,28,3,35
Rapid Vienna,8482,4,8,10,6,33,29,4,34
Vienna,8482,5,8,5,11,26,38,-12,29
Mattersburg,8482,6,7,5,12,32,41,-9,26
SC Rheindorf,8482,7,4,6,14,17,33,-16,18
FC Salzburg,8483,1,13,8,3,44,19,25,47
SK Sturm Gra,8483,2,11,5,8,31,29,2,38
Rapid Vienna,8483,3,8,9,7,35,32,3,33
LASK Linz,8483,4,9,6,9,25,26,-1,33
Vienna,8483,5,7,6,11,28,40,-12,27
SC Rheindorf,8483,6,6,7,11,20,27,-7,25
Mattersburg,8483,7,5,9,10,29,39,-10,24
FC Salzburg,8484,1,15,7,2,49,20,29,52
SK Sturm Gra,8484,2,12,5,7,34,30,4,41
Rapid Vienna,8484,3,9,10,5,38,29,9,37
LASK Linz,8484,4,8,6,10,26,29,-3,30
Mattersburg,8484,5,6,7,11,31,40,-9,25
Vienna,8484,6,6,6,12,25,42,-17,24
SC Rheindorf,8484,7,4,7,13,18,31,-13,19
FC Salzburg,8485,1,15,6,3,48,18,30,51
Rapid Vienna,8485,2,10,10,4,41,27,14,40
SK Sturm Gra,8485,3,12,3,9,32,33,-1,39
LASK Linz,8485,4,7,7,10,27,31,-4,28
Vienna,8485,5,7,5,12,25,39,-14,26
SC Rheindorf,8485,6,6,6,12,20,30,-10,24
Mattersburg,8485,7,6,5,13,29,44,-15,23
FC Salzburg,8486,1,13,8,3,41,18,23,47
SK Sturm Gra,8486,2,12,6,6,33,26,7,42
Rapid Vienna,8486,3,7,12,5,35,30,5,33
LASK Linz,8486,4,7,8,9,27,29,-2,29
Mattersburg,8486,5,7,6,11,34,41,-7,27
Vienna,8486,6,7,5,12,26,39,-13,26
SC Rheindorf,8486,7,5,7,12,18,31,-13,22
FC Salzburg,8487,1,15,7,2,46,19,27,52
SK Sturm Gra,8487,2,13,4,7,36,28,8,43
Rapid Vienna,8487,3,9,10,5,41,29,12,37
LASK Linz,8487,4,7,7,10,26,34,-8,28
Mattersburg,8487,5,7,5,12,36,44,-8,26
Vienna,8487,6,7,5,12,27,41,-14,26
SC Rheindorf,8487,7,4,6,14,17,34,-17,18
FC Salzburg,8488,1,15,7,2,47,18,29,52
SK Sturm Gra,8488,2,12,4,8,31,30,1,40
Rapid Vienna,8488,3,8,11,5,36,28,8,35
LASK Linz,8488,4,9,5,10,30,31,-1,32
Mattersburg,8488,5,6,6,12,28,40,-12,24
Vienna,8488,6,6,6,12,25,41,-16,24
SC Rheindorf,8488,7,6,5,13,23,32,-9,23
FC Salzburg,8489,1,15,7,2,44,17,27,52
SK Sturm Gra,8489,2,12,5,7,34,29,5,41
Rapid Vienna,8489,3,7,11,6,34,29,5,32
LASK Linz,8489,4,7,7,10,30,33,-3,28
Mattersburg,8489,5,7,7,10,33,40,-7,28
Vienna,8489,6,6,6,12,26,42,-16,24
SC Rheindorf,8489,7,5,7,12,21,32,-11,22
FC Salzburg,8490,1,14,8,2,46,18,28,50
SK Sturm Gra,8490,2,12,3,9,32,33,-1,39
Rapid Vienna,8490,3,8,11,5,36,26,10,35
LASK Linz,8490,4,9,6,9,26,26,0,33
Mattersburg,8490,5,8,6,10,32,37,-5,30
Vienna,8490,6,6,5,13,24,41,-17,23
SC Rheindorf,8490,7,5,5,14,18,33,-15,20
FC Salzburg,8491,1,12,9,3,41,20,21,45
SK Sturm Gra,8491,2,12,6,6,34,28,6,42
Rapid Vienna,8491,3,10,10,4,36,24,12,40
LASK Linz,8491,4,8,7,9,26,26,0,31
Mattersburg,8491,5,6,8,10,30,39,-9,26
Vienna,8491,6,6,7,11,26,40,-14,25
SC Rheindorf,8491,7,4,5,15,16,32,-16,17
FC Salzburg,8492,1,15,7,2,44,18,26,52
SK Sturm Gra,8492,2,13,4,7,34,27,7,43
LASK Linz,8492,3,9,6,9,31,29,2,33
Rapid Vienna,8492,4,7,10,7,33,30,3,31
Vienna,8492,5,6,6,12,24,39,-15,24
SC Rheindorf,8492,6,5,8,11,21,30,-9,23
Mattersburg,8492,7,5,7,12,28,42,-14,22
FC Salzburg,8493,1,13,8,3,41,20,21,47
SK Sturm Gra,8493,2,12,4,8,32,28,4,40
Rapid Vienna,8493,3,10,9,5,40,27,13,39
LASK Linz,8493,4,9,6,9,26,26,0,33
Vienna,8493,5,7,6,11,24,37,-13,27
SC Rheindorf,8493,6,5,7,12,17,29,-12,22
Mattersburg,8493,7,5,6,13,27,40,-13,21
FC Salzburg,8494,1,14,8,2,42,16,26,50
SK Sturm Gra,8494,2,12,4,8,31,30,1,40
LASK Linz,8494,3,10,6,8,28,26,2,36
Rapid Vienna,8494,4,8,9,7,34,26,8,33
Mattersburg,8494,5,7,6,11,30,39,-9,27
Vienna,8494,6,6,6,12,25,40,-15,24
SC Rheindorf,8494,7,5,5,14,18,31,-13,20
FC Salzburg,8495,1,14,8,2,48,18,30,50
SK Sturm Gra,8495,2,12,4,8,38,32,6,40
LASK Linz,8495,3,9,6,9,33,30,3,33
Rapid Vienna,8495,4,8,9,7,33,36,-3,33
Vienna,8495,5,7,6,11,25,38,-13,27
Mattersburg,8495,6,7,5,12,30,42,-12,26
SC Rheindorf,8495,7,5,6,13,18,29,-11,21
FC Salzburg,8496,1,14,8,2,50,17,33,50
SK Sturm Gra,8496,2,12,5,7,32,28,4,41
Rapid Vienna,8496,3,8,11,5,35,27,8,35
LASK Linz,8496,4,8,7,9,29,30,-1,31
Vienna,8496,5,7,5,12,25,39,-14,26
SC Rheindorf,8496,6,6,5,13,20,33,-13,23
Mattersburg,8496,7,6,5,13,31,48,-17,23
FC Salzburg,8497,1,14,7,3,45,20,25,49
SK Sturm Gra,8497,2,13,4,7,35,28,7,43
Rapid Vienna,8497,3,8,12,4,37,26,11,36
LASK Linz,8497,4,9,6,9,26,29,-3,33
Vienna,8497,5,7,6,11,27,38,-11,27
Mattersburg,8497,6,5,6,13,27,44,-17,21
SC Rheindorf,8497,7,4,7,13,19,31,-12,19
FC Salzburg,8498,1,16,6,2,49,16,33,54
Rapid Vienna,8498,2,9,10,5,37,27,10,37
SK Sturm Gra,8498,3,11,3,10,32,35,-3,36
LASK Linz,8498,4,8,6,10,27,32,-5,30
Mattersburg,8498,5,7,5,12,35,41,-6,26
SC Rheindorf,8498,6,6,7,11,21,29,-8,25
Vienna,8498,7,6,5,13,23,44,-21,23
FC Salzburg,8499,1,14,8,2,44,16,28,50
SK Sturm Gra,8499,2,13,3,8,35,30,5,42
LASK Linz,8499,3,10,5,9,27,27,0,35
Rapid Vienna,8499,4,8,9,7,35,33,2,33
Vienna,8499,5,7,6,11,27,40,-13,27
Mattersburg,8499,6,6,6,12,31,42,-11,24
SC Rheindorf,8499,7,5,5,14,22,33,-11,20
FC Salzburg,8500,1,13,8,3,43,20,23,47
SK Sturm Gra,8500,2,11,5,8,31,34,-3,38
Rapid Vienna,8500,3,8,12,4,39,29,10,36
LASK Linz,8500,4,8,8,8,31,27,4,32
Mattersburg,8500,5,7,6,11,32,41,-9,27
Vienna,8500,6,7,6,11,27,38,-11,27
SC Rheindorf,8500,7,4,7,13,21,35,-14,19
FC Salzburg,8501,1,15,6,3,46,17,29,51
SK Sturm Gra,8501,2,14,3,7,31,28,3,45
Rapid Vienna,8501,3,8,9,7,32,27,5,33
LASK Linz,8501,4,9,6,9,26,26,0,33
Vienna,8501,5,7,5,12,27,41,-14,26
Mattersburg,8501,6,6,5,13,32,44,-12,23
SC Rheindorf,8501,7,5,6,13,18,29,-11,21
FC Salzburg,8502,1,15,6,3,48,17,31,51
SK Sturm Gra,8502,2,12,5,7,32,30,2,41
Rapid Vienna,8502,3,9,10,5,34,26,8,37
LASK Linz,8502,4,8,5,11,28,30,-2,29
Vienna,8502,5,7,5,12,26,39,-13,26
SC Rheindorf,8502,6,6,6,12,24,32,-8,24
Mattersburg,8502,7,6,5,13,31,49,-18,23
FC Salzburg,8503,1,13,7,4,44,22,22,46
SK Sturm Gra,8503,2,13,4,7,35,29,6,43
Rapid Vienna,8503,3,9,10,5,37,28,9,37
LASK Linz,8503,4,8,7,9,29,30,-1,31
Mattersburg,8503,5,7,6,11,30,38,-8,27
Vienna,8503,6,7,5,12,24,38,-14,26
SC Rheindorf,8503,7,4,7,13,17,31,-14,19
FC Salzburg,8504,1,14,8,2,46,20,26,50
SK Sturm Gra,8504,2,12,5,7,32,28,4,41
Rapid Vienna,8504,3,8,11,5,37,29,8,35
LASK Linz,8504,4,8,6,10,27,30,-3,30
Mattersburg,8504,5,6,7,11,30,40,-10,25
Vienna,8504,6,6,7,11,26,40,-14,25
SC Rheindorf,8504,7,5,6,13,20,31,-11,21
FC Salzburg,8505,1,13,7,4,42,19,23,46
SK Sturm Gra,8505,2,13,4,7,35,30,5,43
Rapid Vienna,8505,3,9,9,6,34,28,6,36
Mattersburg,8505,4,8,6,10,33,36,-3,30
LASK Linz,8505,5,8,6,10,28,31,-3,30
Vienna,8505,6,7,5,12,24,38,-14,26
SC Rheindorf,8505,7,5,5,14,16,30,-14,20
FC Salzburg,8506,1,13,6,5,42,24,18,45
SK Sturm Gra,8506,2,11,4,9,29,30,-1,37
Rapid Vienna,8506,3,9,9,6,38,27,11,36
LASK Linz,8506,4,9,5,10,25,26,-1,32
Vienna,8506,5,8,5,11,28,40,-12,29
SC Rheindorf,8506,6,7,6,11,22,27,-5,27
Mattersburg,8506,7,7,5,12,33,43,-10,26
FC Salzburg,8507,1,14,7,3,46,17,29,49
SK Sturm Gra,8507,2,12,4,8,35,34,1,40
Rapid Vienna,8507,3,9,10,5,38,28,10,37
LASK Linz,8507,4,9,5,10,27,30,-3,32
Mattersburg,8507,5,7,5,12,30,43,-13,26
SC Rheindorf,8507,6,6,6,12,21,28,-7,24
Vienna,8507,7,6,5,13,24,41,-17,23
FC Salzburg,8508,1,15,7,2,45,17,28,52
SK Sturm Gra,8508,2,13,4,7,39,30,9,43
Rapid Vienna,8508,3,8,11,5,37,33,4,35
LASK Linz,8508,4,8,6,10,27,32,-5,30
Mattersburg,8508,5,7,5,12,35,44,-9,26
Vienna,8508,6,7,5,12,27,40,-13,26
SC Rheindorf,8508,7,4,6,14,20,34,-14,18
FC Salzburg,8509,1,14,6,4,42,19,23,48
SK Sturm Gra,8509,2,12,5,7,32,30,2,41
Rapid Vienna,8509,3,8,11,5,34,26,8,35
LASK Linz,8509,4,8,8,8,27,26,1,32
Vienna,8509,5,7,5,12,26,38,-12,26
SC Rheindorf,8509,6,5,8,11,19,26,-7,23
Mattersburg,8509,7,5,7,12,28,43,-15,22
FC Salzburg,8510,1,16,6,2,48,17,31,54
SK Sturm Gra,8510,2,12,4,8,34,33,1,40
Rapid Vienna,8510,3,7,10,7,33,30,3,31
LASK Linz,8510,4,8,7,9,27,29,-2,31
SC Rheindorf,8510,5,7,6,11,21,26,-5,27
Vienna,8510,6,7,5,12,24,38,-14,26
Mattersburg,8510,7,5,6,13,27,41,-14,21
FC Salzburg,8511,1,15,7,2,43,17,26,52
Rapid Vienna,8511,2,9,10,5,35,26,9,37
SK Sturm Gra,8511,3,11,4,9,30,29,1,37
LASK Linz,8511,4,7,7,10,28,31,-3,28
Vienna,8511,5,7,5,12,26,39,-13,26
SC Rheindorf,8511,6,6,7,11,19,27,-8,25
Mattersburg,8511,7,6,6,12,27,39,-12,24
FC Salzburg,8512,1,15,6,3,44,17,27,51
SK Sturm Gra,8512,2,13,3,8,36,28,8,42
Rapid Vienna,8512,3,10,9,5,35,29,6,39
LASK Linz,8512,4,8,5,11,27,32,-5,29
Mattersburg,8512,5,7,5,12,33,44,-11,26
SC Rheindorf,8512,6,6,5,13,21,30,-9,23
Vienna,8512,7,6,5,13,26,42,-16,23
FC Salzburg,8513,1,13,8,3,42,19,23,47
SK Sturm Gra,8513,2,13,4,7,33,26,7,43
Rapid Vienna,8513,3,8,10,6,34,29,5,34
Mattersburg,8513,4,8,5,11,32,40,-8,29
LASK Linz,8513,5,7,6,11,25,29,-4,27
SC Rheindorf,8513,6,7,6,11,21,28,-7,27
Vienna,8513,7,6,5,13,27,43,-16,23
FC Salzburg,8514,1,16,6,2,50,17,33,54
SK Sturm Gra,8514,2,12,3,9,31,31,0,39
Rapid Vienna,8514,3,9,10,5,38,30,8,37
LASK Linz,8514,4,8,7,9,29,30,-1,31
Mattersburg,8514,5,6,6,12,32,43,-11,24
SC Rheindorf,8514,6,6,5,13,19,30,-11,23
Vienna,8514,7,6,5,13,25,43,-18,23
FC Salzburg,8515,1,14,8,2,45,18,27,50
SK Sturm Gra,8515,2,13,5,6,37,30,7,44
Rapid Vienna,8515,3,9,10,5,38,28,10,37
LASK Linz,8515,4,8,5,11,25,30,-5,29
Vienna,8515,5,7,5,12,29,38,-9,26
Mattersburg,8515,6,6,6,12,30,46,-16,24
SC Rheindorf,8515,7,5,5,14,21,35,-14,20
FC Salzburg,8516,1,15,7,2,44,17,27,52
SK Sturm Gra,8516,2,13,3,8,35,31,4,42
Rapid Vienna,8516,3,9,10,5,39,29,10,37
LASK Linz,8516,4,8,6,10,27,31,-4,30
Mattersburg,8516,5,6,6,12,31,42,-11,24
Vienna,8516,6,6,6,12,24,39,-15,24
SC Rheindorf,8516,7,5,6,13,22,33,-11,21
FC Salzburg,8517,1,13,9,2,42,18,24,48
SK Sturm Gra,8517,2,13,4,7,31,26,5,43
Rapid Vienna,8517,3,7,12,5,33,26,7,33
LASK Linz,8517,4,9,6,9,27,26,1,33
Mattersburg,8517,5,7,6,11,30,38,-8,27
Vienna,8517,6,6,5,13,24,40,-16,23
SC Rheindorf,8517,7,5,6,13,16,29,-13,21
FC Salzburg,8518,1,15,6,3,48,21,27,51
SK Sturm Gra,8518,2,12,5,7,33,31,2,41
Rapid Vienna,8518,3,8,11,5,37,29,8,35
Vienna,8518,4,8,5,11,29,39,-10,29
LASK Linz,8518,5,7,6,11,27,33,-6,27
SC Rheindorf,8518,6,6,6,12,21,30,-9,24
Mattersburg,8518,7,6,5,13,31,43,-12,23
FC Salzburg,8519,1,14,7,3,46,22,24,49
SK Sturm Gra,8519,2,12,3,9,33,33,0,39
Rapid Vienna,8519,3,8,10,6,34,29,5,34
LASK Linz,8519,4,9,6,9,31,29,2,33
Mattersburg,8519,5,6,7,11,36,45,-9,25
Vienna,8519,6,6,7,11,29,43,-14,25
SC Rheindorf,8519,7,5,8,11,22,30,-8,23
FC Salzburg,8520,1,14,6,4,43,17,26,48
SK Sturm Gra,8520,2,12,4,8,30,29,1,40
LASK Linz,8520,3,9,7,8,29,25,4,34
Rapid Vienna,8520,4,8,9,7,34,31,3,33
Mattersburg,8520,5,7,7,10,31,37,-6,28
Vienna,8520,6,7,6,11,25,38,-13,27
SC Rheindorf,8520,7,4,7,13,18,33,-15,19
FC Salzburg,8521,1,16,6,2,46,17,29,54
Rapid Vienna,8521,2,9,9,6,38,29,9,36
SK Sturm Gra,8521,3,11,3,10,31,32,-1,36
LASK Linz,8521,4,9,6,9,29,29,0,33
Vienna,8521,5,7,5,12,25,38,-13,26
Mattersburg,8521,6,6,6,12,30,43,-13,24
SC Rheindorf,8521,7,6,5,13,20,31,-11,23
FC Salzburg,8522,1,15,7,2,43,16,27,52
SK Sturm Gra,8522,2,12,4,8,32,29,3,40
Rapid Vienna,8522,3,9,10,5,35,26,9,37
LASK Linz,8522,4,7,6,11,25,30,-5,27
Vienna,8522,5,7,6,11,25,37,-12,27
SC Rheindorf,8522,6,6,6,12,19,27,-8,24
Mattersburg,8522,7,6,5,13,28,42,-14,23
FC Salzburg,8523,1,13,8,3,44,21,23,47
SK Sturm Gra,8523,2,12,4,8,32,28,4,40
Rapid Vienna,8523,3,8,12,4,36,27,9,36
LASK Linz,8523,4,9,7,8,29,28,1,34
Mattersburg,8523,5,6,7,11,33,43,-10,25
Vienna,8523,6,6,6,12,26,42,-16,24
SC Rheindorf,8523,7,4,8,12,18,29,-11,20
FC Salzburg,8524,1,13,7,4,45,21,24,46
SK Sturm Gra,8524,2,13,4,7,33,29,4,43
LASK Linz,8524,3,9,7,8,30,25,5,34
Rapid Vienna,8524,4,7,12,5,35,28,7,33
Vienna,8524,5,8,5,11,28,39,-11,29
Mattersburg,8524,6,5,7,12,29,44,-15,22
SC Rheindorf,8524,7,5,6,13,17,31,-14,21
FC Salzburg,8525,1,14,8,2,44,18,26,50
SK Sturm Gra,8525,2,12,5,7,31,28,3,41
Rapid Vienna,8525,3,7,11,6,32,27,5,32
LASK Linz,8525,4,8,7,9,29,29,0,31
Vienna,8525,5,7,6,11,24,37,-13,27
Mattersburg,8525,6,6,6,12,32,43,-11,24
SC Rheindorf,8525,7,4,9,11,18,28,-10,21
FC Salzburg,8526,1,14,7,3,44,18,26,49
SK Sturm Gra,8526,2,13,3,8,33,29,4,42
Rapid Vienna,8526,3,10,9,5,40,28,12,39
LASK Linz,8526,4,9,5,10,26,28,-2,32
Mattersburg,8526,5,6,7,11,31,41,-10,25
Vienna,8526,6,6,6,12,25,40,-15,24
SC Rheindorf,8526,7,5,5,14,18,33,-15,20
FC Salzburg,8527,1,15,7,2,47,17,30,52
SK Sturm Gra,8527,2,12,4,8,31,33,-2,40
Rapid Vienna,8527,3,7,10,7,33,30,3,31
LASK Linz,8527,4,8,5,11,27,31,-4,29
Mattersburg,8527,5,7,6,11,33,41,-8,27
SC Rheindorf,8527,6,7,5,12,25,27,-2,26
Vienna,8527,7,7,5,12,25,42,-17,26
FC Salzburg,8528,1,15,7,2,50,20,30,52
SK Sturm Gra,8528,2,14,3,7,33,29,4,45
Rapid Vienna,8528,3,7,10,7,33,29,4,31
LASK Linz,8528,4,8,7,9,26,26,0,31
Mattersburg,8528,5,7,5,12,35,44,-9,26
Vienna,8528,6,6,6,12,26,43,-17,24
SC Rheindorf,8528,7,5,6,13,17,29,-12,21
FC Salzburg,8529,1,16,6,2,49,16,33,54
SK Sturm Gra,8529,2,12,3,9,32,32,0,39
Rapid Vienna,8529,3,9,10,5,36,26,10,37
LASK Linz,8529,4,8,6,10,24,27,-3,30
Mattersburg,8529,5,7,5,12,28,39,-11,26
SC Rheindorf,8529,6,6,5,13,18,31,-13,23
Vienna,8529,7,6,5,13,23,39,-16,23
FC Salzburg,8530,1,15,6,3,49,19,30,51
SK Sturm Gra,8530,2,13,3,8,38,33,5,42
Rapid Vienna,8530,3,9,9,6,36,29,7,36
LASK Linz,8530,4,10,5,9,31,28,3,35
Vienna,8530,5,7,5,12,25,39,-14,26
Mattersburg,8530,6,6,6,12,29,44,-15,24
SC Rheindorf,8530,7,4,6,14,16,32,-16,18
FC Salzburg,8531,1,14,7,3,43,18,25,49
SK Sturm Gra,8531,2,14,4,6,35,26,9,46
Rapid Vienna,8531,3,9,10,5,37,27,10,37
LASK Linz,8531,4,8,5,11,24,35,-11,29
Mattersburg,8531,5,6,6,12,34,41,-7,24
Vienna,8531,6,6,6,12,24,39,-15,24
SC Rheindorf,8531,7,5,6,13,18,29,-11,21
FC Salzburg,8532,1,15,7,2,49,20,29,52
SK Sturm Gra,8532,2,12,5,7,31,29,2,41
Rapid Vienna,8532,3,8,12,4,35,24,11,36
LASK Linz,8532,4,8,7,9,27,27,0,31
Vienna,8532,5,7,5,12,27,41,-14,26
Mattersburg,8532,6,5,7,12,28,41,-13,22
SC Rheindorf,8532,7,4,7,13,16,31,-15,19
FC Salzburg,8533,1,12,8,4,43,22,21,44
SK Sturm Gra,8533,2,12,5,7,32,27,5,41
Rapid Vienna,8533,3,8,11,5,34,26,8,35
LASK Linz,8533,4,9,5,10,27,30,-3,32
SC Rheindorf,8533,5,7,6,11,21,27,-6,27
Vienna,8533,6,7,6,11,25,38,-13,27
Mattersburg,8533,7,5,7,12,28,40,-12,22
FC Salzburg,8534,1,14,6,4,47,22,25,48
SK Sturm Gra,8534,2,14,3,7,34,30,4,45
Rapid Vienna,8534,3,8,10,6,34,27,7,34
Vienna,8534,4,8,5,11,27,39,-12,29
LASK Linz,8534,5,7,6,11,26,33,-7,27
SC Rheindorf,8534,6,6,6,12,19,27,-8,24
Mattersburg,8534,7,6,6,12,33,42,-9,24
FC Salzburg,8535,1,14,6,4,45,23,22,48
SK Sturm Gra,8535,2,12,6,6,34,29,5,42
Rapid Vienna,8535,3,8,11,5,39,32,7,35
LASK Linz,8535,4,7,9,8,28,29,-1,30
Mattersburg,8535,5,6,7,11,32,41,-9,25
Vienna,8535,6,6,6,12,26,41,-15,24
SC Rheindorf,8535,7,5,7,12,22,31,-9,22
FC Salzburg,8536,1,14,7,3,47,19,28,49
SK Sturm Gra,8536,2,12,5,7,33,28,5,41
Rapid Vienna,8536,3,9,11,4,38,25,13,38
LASK Linz,8536,4,8,6,10,24,27,-3,30
Mattersburg,8536,5,8,5,11,34,42,-8,29
Vienna,8536,6,6,5,13,23,43,-20,23
SC Rheindorf,8536,7,5,5,14,20,35,-15,20
FC Salzburg,8537,1,15,6,3,46,19,27,51
SK Sturm Gra,8537,2,14,3,7,35,28,7,45
Rapid Vienna,8537,3,8,10,6,37,30,7,34
LASK Linz,8537,4,8,5,11,25,32,-7,29
Mattersburg,8537,5,6,7,11,30,38,-8,25
Vienna,8537,6,6,6,12,24,40,-16,24
SC Rheindorf,8537,7,5,7,12,19,29,-10,22
FC Salzburg,8538,1,14,6,4,44,21,23,48
SK Sturm Gra,8538,2,12,3,9,30,28,2,39
Rapid Vienna,8538,3,9,9,6,38,29,9,36
LASK Linz,8538,4,10,5,9,33,31,2,35
Vienna,8538,5,8,5,11,29,40,-11,29
Mattersburg,8538,6,7,5,12,33,43,-10,26
SC Rheindorf,8538,7,5,5,14,20,35,-15,20
FC Salzburg,8539,1,15,7,2,48,18,30,52
SK Sturm Gra,8539,2,12,4,8,31,31,0,40
Rapid Vienna,8539,3,9,10,5,38,28,10,37
LASK Linz,8539,4,7,6,11,25,29,-4,27
Vienna,8539,5,7,5,12,25,41,-16,26
SC Rheindorf,8539,6,6,6,12,22,30,-8,24
Mattersburg,8539,7,6,6,12,31,43,-12,24
FC Salzburg,8540,1,13,7,4,42,22,20,46
SK Sturm Gra,8540,2,14,4,6,38,30,8,46
Rapid Vienna,8540,3,8,10,6,36,29,7,34
LASK Linz,8540,4,8,6,10,29,30,-1,30
Mattersburg,8540,5,7,6,11,30,39,-9,27
Vienna,8540,6,6,7,11,25,39,-14,25
SC Rheindorf,8540,7,5,6,13,18,29,-11,21
FC Salzburg,8541,1,15,6,3,45,17,28,51
SK Sturm Gra,8541,2,14,3,7,33,26,7,45
LASK Linz,8541,3,11,5,8,30,26,4,38
Rapid Vienna,8541,4,8,9,7,33,28,5,33
Mattersburg,8541,5,7,5,12,33,43,-10,26
Vienna,8541,6,6,5,13,24,42,-18,23
SC Rheindorf,8541,7,4,5,15,17,33,-16,17
FC Salzburg,8542,1,15,7,2,46,19,27,52
SK Sturm Gra,8542,2,13,5,6,38,29,9,44
LASK Linz,8542,3,9,6,9,28,31,-3,33
Rapid Vienna,8542,4,7,10,7,37,32,5,31
Mattersburg,8542,5,6,6,12,34,43,-9,24
Vienna,8542,6,6,6,12,25,41,-16,24
SC Rheindorf,8542,7,5,6,13,19,32,-13,21
FC Salzburg,8543,1,14,8,2,47,18,29,50
SK Sturm Gra,8543,2,12,4,8,33,31,2,40
LASK Linz,8543,3,10,6,8,32,29,3,36
Rapid Vienna,8543,4,8,10,6,39,31,8,34
Vienna,8543,5,7,6,11,27,40,-13,27
Mattersburg,8543,6,6,6,12,32,45,-13,24
SC Rheindorf,8543,7,4,6,14,17,33,-16,18
FC Salzburg,8544,1,15,6,3,45,19,26,51
SK Sturm Gra,8544,2,13,4,7,33,27,6,43
Rapid Vienna,8544,3,9,10,5,37,27,10,37
Mattersburg,8544,4,8,5,11,33,41,-8,29
LASK Linz,8544,5,7,5,12,25,31,-6,26
Vienna,8544,6,7,5,12,26,40,-14,26
SC Rheindorf,8544,7,5,5,14,20,34,-14,20
FC Salzburg,8545,1,15,7,2,50,21,29,52
SK Sturm Gra,8545,2,12,5,7,34,29,5,41
Rapid Vienna,8545,3,7,11,6,33,30,3,32
SC Rheindorf,8545,4,7,6,11,22,27,-5,27
LASK Linz,8545,5,7,6,11,25,34,-9,27
Mattersburg,8545,6,6,7,11,34,41,-7,25
Vienna,8545,7,6,6,12,26,42,-16,24
FC Salzburg,8546,1,15,6,3,47,20,27,51
SK Sturm Gra,8546,2,13,3,8,34,30,4,42
LASK Linz,8546,3,10,6,8,30,27,3,36
Rapid Vienna,8546,4,8,9,7,34,30,4,33
Mattersburg,8546,5,6,8,10,31,40,-9,26
Vienna,8546,6,6,6,12,24,40,-16,24
SC Rheindorf,8546,7,4,6,14,16,29,-13,18
FC Salzburg,8547,1,13,7,4,46,22,24,46
SK Sturm Gra,8547,2,13,3,8,34,32,2,42
Rapid Vienna,8547,3,10,9,5,39,26,13,39
Mattersburg,8547,4,8,6,10,40,40,0,30
LASK Linz,8547,5,8,5,11,25,33,-8,29
Vienna,8547,6,6,7,11,26,40,-14,25
SC Rheindorf,8547,7,5,5,14,19,36,-17,20
FC Salzburg,8548,1,14,7,3,44,17,27,49
SK Sturm Gra,8548,2,12,6,6,32,27,5,42
Rapid Vienna,8548,3,8,11,5,33,25,8,35
LASK Linz,8548,4,9,5,10,26,27,-1,32
Mattersburg,8548,5,6,6,12,31,44,-13,24
SC Rheindorf,8548,6,5,8,11,20,29,-9,23
Vienna,8548,7,6,5,13,24,41,-17,23
FC Salzburg,8549,1,13,8,3,44,19,25,47
SK Sturm Gra,8549,2,12,4,8,34,33,1,40
Rapid Vienna,8549,3,9,10,5,39,30,9,37
LASK Linz,8549,4,10,5,9,31,28,3,35
Vienna,8549,5,6,6,12,24,41,-17,24
Mattersburg,8549,6,5,8,11,29,40,-11,23
SC Rheindorf,8549,7,5,7,12,19,29,-10,22
FC Salzburg,8550,1,15,6,3,43,17,26,51
SK Sturm Gra,8550,2,12,4,8,31,28,3,40
Rapid Vienna,8550,3,9,10,5,35,26,9,37
LASK Linz,8550,4,8,6,10,26,29,-3,30
Vienna,8550,5,8,5,11,26,37,-11,29
Mattersburg,8550,6,6,5,13,31,44,-13,23
SC Rheindorf,8550,7,5,6,13,19,30,-11,21
FC Salzburg,8551,1,15,6,3,47,21,26,51
SK Sturm Gra,8551,2,12,3,9,32,30,2,39
Rapid Vienna,8551,3,9,10,5,35,28,7,37
LASK Linz,8551,4,8,7,9,28,27,1,31
Vienna,8551,5,7,5,12,28,40,-12,26
Mattersburg,8551,6,6,6,12,29,43,-14,24
SC Rheindorf,8551,7,5,7,12,18,28,-10,22
FC Salzburg,8552,1,13,8,3,41,18,23,47
SK Sturm Gra,8552,2,13,4,7,33,26,7,43
Rapid Vienna,8552,3,9,10,5,37,27,10,37
LASK Linz,8552,4,9,6,9,27,30,-3,33
Mattersburg,8552,5,6,7,11,34,42,-8,25
Vienna,8552,6,6,7,11,25,39,-14,25
SC Rheindorf,8552,7,4,6,14,19,34,-15,18
FC Salzburg,8553,1,14,7,3,45,19,26,49
SK Sturm Gra,8553,2,11,5,8,30,31,-1,38
Rapid Vienna,8553,3,8,11,5,37,27,10,35
Vienna,8553,4,8,5,11,28,38,-10,29
LASK Linz,8553,5,7,7,10,24,30,-6,28
SC Rheindorf,8553,6,7,6,11,22,27,-5,27
Mattersburg,8553,7,6,5,13,30,44,-14,23
FC Salzburg,8554,1,14,7,3,45,19,26,49
SK Sturm Gra,8554,2,14,4,6,35,27,8,46
Rapid Vienna,8554,3,10,9,5,36,26,10,39
LASK Linz,8554,4,9,5,10,28,28,0,32
Vienna,8554,5,7,5,12,25,39,-14,26
Mattersburg,8554,6,6,5,13,28,42,-14,23
SC Rheindorf,8554,7,4,5,15,15,31,-16,17
FC Salzburg,8555,1,13,7,4,43,25,18,46
Rapid Vienna,8555,2,10,9,5,40,26,14,39
SK Sturm Gra,8555,3,11,4,9,29,29,0,37
LASK Linz,8555,4,9,5,10,26,27,-1,32
Vienna,8555,5,7,6,11,26,37,-11,27
Mattersburg,8555,6,7,5,12,34,44,-10,26
SC Rheindorf,8555,7,6,6,12,19,29,-10,24
FC Salzburg,8556,1,16,6,2,49,17,32,54
SK Sturm Gra,8556,2,12,4,8,33,32,1,40
Rapid Vienna,8556,3,9,10,5,38,28,10,37
LASK Linz,8556,4,8,6,10,28,28,0,30
Vienna,8556,5,7,5,12,27,39,-12,26
Mattersburg,8556,6,6,5,13,29,49,-20,23
SC Rheindorf,8556,7,5,6,13,18,29,-11,21
FC Salzburg,8557,1,15,7,2,46,18,28,52
SK Sturm Gra,8557,2,12,4,8,33,30,3,40
Rapid Vienna,8557,3,8,10,6,34,28,6,34
LASK Linz,8557,4,9,6,9,30,29,1,33
SC Rheindorf,8557,5,7,5,12,21,27,-6,26
Vienna,8557,6,6,6,12,25,42,-17,24
Mattersburg,8557,7,5,6,13,30,45,-15,21
FC Salzburg,8558,1,15,7,2,49,16,33,52
LASK Linz,8558,2,11,5,8,31,27,4,38
Rapid Vienna,8558,3,9,9,6,37,31,6,36
SK Sturm Gra,8558,4,11,3,10,30,37,-7,36
Mattersburg,8558,5,6,7,11,32,42,-10,25
Vienna,8558,6,6,5,13,25,41,-16,23
SC Rheindorf,8558,7,5,6,13,20,30,-10,21
FC Salzburg,8559,1,13,8,3,43,18,25,47
SK Sturm Gra,8559,2,11,5,8,30,30,0,38
Rapid Vienna,8559,3,9,10,5,38,26,12,37
LASK Linz,8559,4,8,7,9,26,26,0,31
Mattersburg,8559,5,7,6,11,33,40,-7,27
Vienna,8559,6,7,5,12,25,42,-17,26
SC Rheindorf,8559,7,6,5,13,17,30,-13,23
FC Salzburg,8560,1,15,7,2,43,16,27,52
SK Sturm Gra,8560,2,12,5,7,35,32,3,41
Rapid Vienna,8560,3,8,9,7,35,29,6,33
LASK Linz,8560,4,9,6,9,27,27,0,33
Mattersburg,8560,5,6,7,11,29,40,-11,25
Vienna,8560,6,6,6,12,24,39,-15,24
SC Rheindorf,8560,7,5,6,13,19,29,-10,21
FC Salzburg,8561,1,14,8,2,44,18,26,50
SK Sturm Gra,8561,2,12,4,8,31,27,4,40
Rapid Vienna,8561,3,8,10,6,35,28,7,34
LASK Linz,8561,4,9,6,9,28,28,0,33
Vienna,8561,5,7,5,12,27,40,-13,26
Mattersburg,8561,6,6,6,12,31,44,-13,24
SC Rheindorf,8561,7,5,7,12,20,31,-11,22
FC Salzburg,8562,1,15,7,2,47,19,28,52
SK Sturm Gra,8562,2,13,4,7,31,26,5,43
Rapid Vienna,8562,3,9,10,5,37,29,8,37
LASK Linz,8562,4,7,6,11,25,30,-5,27
Vienna,8562,5,7,5,12,28,40,-12,26
Mattersburg,8562,6,5,8,11,28,42,-14,23
SC Rheindorf,8562,7,5,6,13,21,31,-10,21
FC Salzburg,8563,1,13,7,4,44,23,21,46
SK Sturm Gra,8563,2,13,4,7,35,28,7,43
Rapid Vienna,8563,3,9,9,6,37,30,7,36
LASK Linz,8563,4,9,6,9,31,30,1,33
Mattersburg,8563,5,6,7,11,33,44,-11,25
SC Rheindorf,8563,6,6,6,12,21,29,-8,24
Vienna,8563,7,6,5,13,25,42,-17,23
FC Salzburg,8564,1,13,9,2,47,22,25,48
SK Sturm Gra,8564,2,12,5,7,33,30,3,41
LASK Linz,8564,3,10,6,8,34,28,6,36
Rapid Vienna,8564,4,8,10,6,35,28,7,34
Vienna,8564,5,6,6,12,30,46,-16,24
SC Rheindorf,8564,6,6,5,13,19,30,-11,23
Mattersburg,8564,7,5,7,12,30,44,-14,22
FC Salzburg,8565,1,16,6,2,51,17,34,54
Rapid Vienna,8565,2,10,9,5,36,25,11,39
SK Sturm Gra,8565,3,11,4,9,31,31,0,37
LASK Linz,8565,4,8,6,10,29,34,-5,30
Vienna,8565,5,7,5,12,26,40,-14,26
SC Rheindorf,8565,6,6,5,13,20,31,-11,23
Mattersburg,8565,7,6,5,13,34,49,-15,23
FC Salzburg,8566,1,14,8,2,46,18,28,50
SK Sturm Gra,8566,2,11,4,9,29,28,1,37
Rapid Vienna,8566,3,8,12,4,35,26,9,36
LASK Linz,8566,4,9,7,8,29,26,3,34
Vienna,8566,5,7,6,11,26,39,-13,27
Mattersburg,8566,6,6,5,13,31,47,-16,23
SC Rheindorf,8566,7,4,8,12,15,27,-12,20
FC Salzburg,8567,1,15,6,3,48,16,32,51
SK Sturm Gra,8567,2,12,3,9,31,31,0,39
Rapid Vienna,8567,3,9,9,6,38,30,8,36
LASK Linz,8567,4,9,5,10,29,28,1,32
Vienna,8567,5,8,5,11,29,37,-8,29
Mattersburg,8567,6,6,6,12,31,50,-19,24
SC Rheindorf,8567,7,5,6,13,20,34,-14,21
FC Salzburg,8568,1,13,7,4,45,24,21,46
SK Sturm Gra,8568,2,13,3,8,34,28,6,42
Rapid Vienna,8568,3,10,9,5,38,27,11,39
LASK Linz,8568,4,9,5,10,26,28,-2,32
SC Rheindorf,8568,5,7,5,12,19,27,-8,26
Vienna,8568,6,6,7,11,25,39,-14,25
Mattersburg,8568,7,5,6,13,30,44,-14,21
FC Salzburg,8569,1,15,7,2,46,18,28,52
SK Sturm Gra,8569,2,13,4,7,34,26,8,43
Rapid Vienna,8569,3,8,10,6,35,29,6,34
LASK Linz,8569,4,8,6,10,25,29,-4,30
SC Rheindorf,8569,5,6,6,12,19,27,-8,24
Vienna,8569,6,6,6,12,26,41,-15,24
Mattersburg,8569,7,6,5,13,30,45,-15,23
FC Salzburg,8570,1,15,7,2,47,17,30,52
SK Sturm Gra,8570,2,13,3,8,35,30,5,42
LASK Linz,8570,3,10,6,8,31,29,2,36
Rapid Vienna,8570,4,7,10,7,34,30,4,31
Vienna,8570,5,7,5,12,27,40,-13,26
SC Rheindorf,8570,6,5,7,12,18,29,-11,22
Mattersburg,8570,7,5,6,13,29,46,-17,21
FC Salzburg,8571,1,12,10,2,42,19,23,46
SK Sturm Gra,8571,2,11,5,8,32,32,0,38
Rapid Vienna,8571,3,7,12,5,34,27,7,33
LASK Linz,8571,4,9,6,9,31,30,1,33
SC Rheindorf,8571,5,6,7,11,20,27,-7,25
Vienna,8571,6,6,7,11,27,41,-14,25
Mattersburg,8571,7,5,9,10,31,41,-10,24
FC Salzburg,8572,1,15,7,2,45,18,27,52
SK Sturm Gra,8572,2,12,6,6,31,26,5,42
Rapid Vienna,8572,3,8,10,6,35,29,6,34
LASK Linz,8572,4,8,6,10,26,27,-1,30
Mattersburg,8572,5,7,5,12,32,41,-9,26
Vienna,8572,6,6,5,13,24,41,-17,23
SC Rheindorf,8572,7,5,7,12,16,27,-11,22
FC Salzburg,8573,1,16,6,2,47,16,31,54
SK Sturm Gra,8573,2,12,4,8,32,30,2,40
Rapid Vienna,8573,3,8,10,6,38,31,7,34
LASK Linz,8573,4,8,7,9,27,27,0,31
SC Rheindorf,8573,5,7,5,12,23,31,-8,26
Mattersburg,8573,6,6,5,13,31,46,-15,23
Vienna,8573,7,6,5,13,24,41,-17,23
FC Salzburg,8574,1,15,6,3,50,18,32,51
SK Sturm Gra,8574,2,12,4,8,34,33,1,40
Rapid Vienna,8574,3,8,10,6,37,30,7,34
LASK Linz,8574,4,9,5,10,27,28,-1,32
Vienna,8574,5,7,5,12,25,39,-14,26
Mattersburg,8574,6,6,6,12,27,44,-17,24
SC Rheindorf,8574,7,5,8,11,19,27,-8,23
FC Salzburg,8575,1,14,7,3,45,20,25,49
SK Sturm Gra,8575,2,11,5,8,30,28,2,38
Rapid Vienna,8575,3,9,10,5,37,28,9,37
LASK Linz,8575,4,9,6,9,31,30,1,33
Mattersburg,8575,5,7,6,11,34,42,-8,27
Vienna,8575,6,6,6,12,24,40,-16,24
SC Rheindorf,8575,7,5,6,13,19,32,-13,21
FC Salzburg,8576,1,13,7,4,41,19,22,46
SK Sturm Gra,8576,2,14,3,7,32,29,3,45
Rapid Vienna,8576,3,8,10,6,32,25,7,34
LASK Linz,8576,4,8,5,11,25,27,-2,29
Mattersburg,8576,5,8,5,11,31,39,-8,29
Vienna,8576,6,7,6,11,27,40,-13,27
SC Rheindorf,8576,7,5,6,13,19,28,-9,21
FC Salzburg,8577,1,14,6,4,47,22,25,48
SK Sturm Gra,8577,2,13,3,8,36,29,7,42
Rapid Vienna,8577,3,9,9,6,35,29,6,36
LASK Linz,8577,4,9,5,10,27,31,-4,32
Mattersburg,8577,5,8,5,11,36,40,-4,29
Vienna,8577,6,7,5,12,25,40,-15,26
SC Rheindorf,8577,7,5,5,14,16,31,-15,20
FC Salzburg,8578,1,15,7,2,46,19,27,52
SK Sturm Gra,8578,2,11,7,6,31,27,4,40
Rapid Vienna,8578,3,9,10,5,37,27,10,37
LASK Linz,8578,4,7,6,11,25,31,-6,27
Mattersburg,8578,5,7,5,12,30,41,-11,26
Vienna,8578,6,7,5,12,26,39,-13,26
SC Rheindorf,8578,7,5,6,13,18,29,-11,21
FC Salzburg,8579,1,15,7,2,45,17,28,52
SK Sturm Gra,8579,2,11,5,8,30,29,1,38
Rapid Vienna,8579,3,7,13,4,36,28,8,34
LASK Linz,8579,4,8,8,8,27,27,0,32
Vienna,8579,5,7,5,12,26,38,-12,26
Mattersburg,8579,6,6,6,12,27,41,-14,24
SC Rheindorf,8579,7,5,6,13,18,29,-11,21
FC Salzburg,8580,1,14,7,3,45,21,24,49
SK Sturm Gra,8580,2,12,5,7,32,29,3,41
Rapid Vienna,8580,3,9,10,5,35,24,11,37
LASK Linz,8580,4,8,5,11,26,30,-4,29
Mattersburg,8580,5,8,5,11,34,40,-6,29
Vienna,8580,6,6,6,12,27,43,-16,24
SC Rheindorf,8580,7,5,6,13,18,30,-12,21
FC Salzburg,8581,1,14,8,2,47,20,27,50
SK Sturm Gra,8581,2,11,5,8,30,28,2,38
Rapid Vienna,8581,3,8,11,5,35,27,8,35
LASK Linz,8581,4,8,6,10,26,29,-3,30
Vienna,8581,5,7,6,11,27,39,-12,27
SC Rheindorf,8581,6,6,7,11,20,27,-7,25
Mattersburg,8581,7,6,5,13,29,44,-15,23
FC Salzburg,8582,1,15,6,3,45,18,27,51
SK Sturm Gra,8582,2,12,4,8,32,30,2,40
Rapid Vienna,8582,3,8,10,6,34,28,6,34
LASK Linz,8582,4,7,7,10,26,29,-3,28
Mattersburg,8582,5,7,6,11,30,40,-10,27
Vienna,8582,6,7,5,12,25,40,-15,26
SC Rheindorf,8582,7,6,6,12,20,27,-7,24
SK Sturm Gra,8583,1,15,3,6,36,26,10,48
FC Salzburg,8583,2,13,6,5,41,21,20,45
LASK Linz,8583,3,9,6,9,33,28,5,33
Rapid Vienna,8583,4,8,9,7,33,29,4,33
Mattersburg,8583,5,7,6,11,29,42,-13,27
Vienna,8583,6,7,5,12,26,40,-14,26
SC Rheindorf,8583,7,4,7,13,16,28,-12,19
FC Salzburg,8584,1,13,7,4,41,21,20,46
SK Sturm Gra,8584,2,12,5,7,30,27,3,41
Rapid Vienna,8584,3,9,9,6,37,26,11,36
LASK Linz,8584,4,8,5,11,28,31,-3,29
Vienna,8584,5,8,5,11,32,41,-9,29
SC Rheindorf,8584,6,7,6,11,20,26,-6,27
Mattersburg,8584,7,6,5,13,31,47,-16,23
FC Salzburg,8585,1,14,6,4,44,21,23,48
SK Sturm Gra,8585,2,12,5,7,33,29,4,41
Rapid Vienna,8585,3,7,11,6,34,29,5,32
LASK Linz,8585,4,8,6,10,26,28,-2,30
Vienna,8585,5,8,5,11,26,38,-12,29
Mattersburg,8585,6,7,6,11,32,40,-8,27
SC Rheindorf,8585,7,5,7,12,20,30,-10,22
FC Salzburg,8586,1,13,7,4,48,26,22,46
SK Sturm Gra,8586,2,12,5,7,34,30,4,41
Rapid Vienna,8586,3,9,10,5,37,26,11,37
SC Rheindorf,8586,4,8,5,11,20,25,-5,29
LASK Linz,8586,5,7,6,11,25,30,-5,27
Mattersburg,8586,6,6,7,11,30,40,-10,25
Vienna,8586,7,6,6,12,24,41,-17,24
FC Salzburg,8587,1,14,7,3,44,19,25,49
SK Sturm Gra,8587,2,12,6,6,34,29,5,42
Rapid Vienna,8587,3,7,11,6,36,31,5,32
LASK Linz,8587,4,8,6,10,28,29,-1,30
Mattersburg,8587,5,7,6,11,34,41,-7,27
Vienna,8587,6,7,5,12,25,42,-17,26
SC Rheindorf,8587,7,5,7,12,20,30,-10,22
FC Salzburg,8588,1,16,6,2,50,16,34,54
SK Sturm Gra,8588,2,13,3,8,33,32,1,42
Rapid Vienna,8588,3,10,9,5,37,27,10,39
LASK Linz,8588,4,9,5,10,28,31,-3,32
Mattersburg,8588,5,6,6,12,34,43,-9,24
Vienna,8588,6,6,6,12,24,41,-17,24
SC Rheindorf,8588,7,4,5,15,17,33,-16,17
FC Salzburg,8589,1,14,7,3,46,19,27,49
SK Sturm Gra,8589,2,13,4,7,37,27,10,43
LASK Linz,8589,3,10,5,9,27,26,1,35
Rapid Vienna,8589,4,8,9,7,38,33,5,33
Vienna,8589,5,7,6,11,27,40,-13,27
SC Rheindorf,8589,6,6,6,12,20,33,-13,24
Mattersburg,8589,7,5,5,14,30,47,-17,20
FC Salzburg,8590,1,14,7,3,47,18,29,49
SK Sturm Gra,8590,2,13,3,8,30,29,1,42
Rapid Vienna,8590,3,9,10,5,36,28,8,37
LASK Linz,8590,4,8,7,9,27,28,-1,31
Mattersburg,8590,5,6,7,11,29,39,-10,25
Vienna,8590,6,6,6,12,25,42,-17,24
SC Rheindorf,8590,7,5,6,13,19,29,-10,21
FC Salzburg,8591,1,14,7,3,47,20,27,49
SK Sturm Gra,8591,2,12,6,6,33,28,5,42
Rapid Vienna,8591,3,10,10,4,36,25,11,40
LASK Linz,8591,4,8,6,10,25,27,-2,30
Mattersburg,8591,5,7,6,11,31,43,-12,27
Vienna,8591,6,6,5,13,27,43,-16,23
SC Rheindorf,8591,7,4,6,14,17,30,-13,18
FC Salzburg,8592,1,13,7,4,41,21,20,46
SK Sturm Gra,8592,2,13,4,7,37,30,7,43
Rapid Vienna,8592,3,9,11,4,34,24,10,38
LASK Linz,8592,4,9,5,10,35,31,4,32
Vienna,8592,5,7,5,12,26,41,-15,26
SC Rheindorf,8592,6,6,5,13,21,33,-12,23
Mattersburg,8592,7,6,5,13,32,46,-14,23
FC Salzburg,8593,1,13,7,4,42,21,21,46
Rapid Vienna,8593,2,10,10,4,41,28,13,40
SK Sturm Gra,8593,3,11,5,8,31,32,-1,38
LASK Linz,8593,4,9,6,9,29,28,1,33
Mattersburg,8593,5,7,5,12,31,39,-8,26
Vienna,8593,6,7,5,12,25,39,-14,26
SC Rheindorf,8593,7,5,6,13,20,32,-12,21
FC Salzburg,8594,1,12,9,3,44,23,21,45
SK Sturm Gra,8594,2,13,5,6,40,33,7,44
LASK Linz,8594,3,10,6,8,33,28,5,36
Rapid Vienna,8594,4,7,11,6,37,33,4,32
Vienna,8594,5,7,6,11,25,37,-12,27
Mattersburg,8594,6,6,5,13,29,42,-13,23
SC Rheindorf,8594,7,5,6,13,20,32,-12,21
FC Salzburg,8595,1,14,6,4,44,19,25,48
SK Sturm Gra,8595,2,14,3,7,37,30,7,45
Rapid Vienna,8595,3,9,9,6,37,30,7,36
LASK Linz,8595,4,9,6,9,30,29,1,33
Vienna,8595,5,7,6,11,25,38,-13,27
Mattersburg,8595,6,6,7,11,29,40,-11,25
SC Rheindorf,8595,7,4,5,15,19,35,-16,17
FC Salzburg,8596,1,14,8,2,43,17,26,50
SK Sturm Gra,8596,2,13,5,6,35,26,9,44
Rapid Vienna,8596,3,8,9,7,33,29,4,33
LASK Linz,8596,4,8,6,10,25,28,-3,30
Mattersburg,8596,5,7,6,11,31,39,-8,27
Vienna,8596,6,6,6,12,23,39,-16,24
SC Rheindorf,8596,7,5,6,13,17,29,-12,21
FC Salzburg,8597,1,15,6,3,43,18,25,51
SK Sturm Gra,8597,2,13,4,7,35,28,7,43
Rapid Vienna,8597,3,9,9,6,38,29,9,36
Mattersburg,8597,4,8,6,10,34,38,-4,30
LASK Linz,8597,5,7,7,10,29,36,-7,28
Vienna,8597,6,6,6,12,25,40,-15,24
SC Rheindorf,8597,7,4,6,14,16,31,-15,18
FC Salzburg,8598,1,14,7,3,45,19,26,49
SK Sturm Gra,8598,2,13,4,7,34,27,7,43
Rapid Vienna,8598,3,8,10,6,35,29,6,34
LASK Linz,8598,4,8,7,9,26,27,-1,31
Vienna,8598,5,7,6,11,26,39,-13,27
SC Rheindorf,8598,6,5,7,12,20,30,-10,22
Mattersburg,8598,7,5,7,12,30,45,-15,22
FC Salzburg,8599,1,14,8,2,44,18,26,50
SK Sturm Gra,8599,2,12,4,8,32,30,2,40
Rapid Vienna,8599,3,9,10,5,37,26,11,37
LASK Linz,8599,4,8,5,11,27,30,-3,29
Mattersburg,8599,5,8,5,11,34,41,-7,29
SC Rheindorf,8599,6,6,5,13,18,30,-12,23
Vienna,8599,7,6,5,13,24,41,-17,23
FC Salzburg,8600,1,16,6,2,46,17,29,54
SK Sturm Gra,8600,2,13,3,8,32,29,3,42
Rapid Vienna,8600,3,10,9,5,36,26,10,39
LASK Linz,8600,4,7,6,11,24,28,-4,27
Vienna,8600,5,7,5,12,25,39,-14,26
Mattersburg,8600,6,6,6,12,30,41,-11,24
SC Rheindorf,8600,7,5,5,14,19,32,-13,20
FC Salzburg,8601,1,14,7,3,47,17,30,49
SK Sturm Gra,8601,2,14,4,6,37,26,11,46
Rapid Vienna,8601,3,9,10,5,35,28,7,37
LASK Linz,8601,4,7,6,11,24,30,-6,27
Mattersburg,8601,5,7,5,12,28,42,-14,26
Vienna,8601,6,7,5,12,24,40,-16,26
SC Rheindorf,8601,7,5,5,14,17,29,-12,20
FC Salzburg,8602,1,15,6,3,46,20,26,51
SK Sturm Gra,8602,2,13,3,8,32,30,2,42
Rapid Vienna,8602,3,9,10,5,37,27,10,37
LASK Linz,8602,4,9,6,9,31,31,0,33
Mattersburg,8602,5,7,5,12,34,44,-10,26
Vienna,8602,6,6,5,13,25,41,-16,23
SC Rheindorf,8602,7,5,5,14,20,32,-12,20
FC Salzburg,8603,1,15,6,3,43,18,25,51
SK Sturm Gra,8603,2,12,4,8,30,28,2,40
Rapid Vienna,8603,3,9,10,5,36,24,12,37
LASK Linz,8603,4,8,6,10,25,28,-3,30
Vienna,8603,5,8,5,11,26,38,-12,29
Mattersburg,8603,6,6,5,13,30,41,-11,23
SC Rheindorf,8603,7,5,6,13,19,32,-13,21
FC Salzburg,8604,1,15,6,3,49,20,29,51
Rapid Vienna,8604,2,10,9,5,37,27,10,39
SK Sturm Gra,8604,3,11,3,10,31,33,-2,36
LASK Linz,8604,4,8,5,11,27,35,-8,29
SC Rheindorf,8604,5,7,5,12,24,29,-5,26
Mattersburg,8604,6,7,5,12,34,46,-12,26
Vienna,8604,7,7,5,12,28,40,-12,26
FC Salzburg,8605,1,14,7,3,44,17,27,49
SK Sturm Gra,8605,2,12,3,9,30,31,-1,39
Rapid Vienna,8605,3,9,11,4,34,24,10,38
LASK Linz,8605,4,10,6,8,29,25,4,36
Vienna,8605,5,7,5,12,26,40,-14,26
Mattersburg,8605,6,6,5,13,28,43,-15,23
SC Rheindorf,8605,7,5,5,14,18,29,-11,20
FC Salzburg,8606,1,15,6,3,44,16,28,51
SK Sturm Gra,8606,2,12,4,8,32,29,3,40
Rapid Vienna,8606,3,9,10,5,34,27,7,37
LASK Linz,8606,4,8,8,8,26,26,0,32
Vienna,8606,5,7,5,12,26,40,-14,26
SC Rheindorf,8606,6,5,7,12,20,29,-9,22
Mattersburg,8606,7,5,6,13,29,44,-15,21
FC Salzburg,8607,1,16,6,2,48,18,30,54
SK Sturm Gra,8607,2,13,4,7,34,29,5,43
LASK Linz,8607,3,9,5,10,28,28,0,32
Rapid Vienna,8607,4,7,9,8,35,34,1,30
SC Rheindorf,8607,5,6,6,12,21,30,-9,24
Mattersburg,8607,6,6,6,12,35,47,-12,24
Vienna,8607,7,6,6,12,28,43,-15,24
FC Salzburg,8608,1,15,7,2,45,18,27,52
SK Sturm Gra,8608,2,13,4,7,34,28,6,43
Rapid Vienna,8608,3,7,11,6,35,29,6,32
LASK Linz,8608,4,8,6,10,29,31,-2,30
Mattersburg,8608,5,7,6,11,34,41,-7,27
Vienna,8608,6,6,5,13,26,43,-17,23
SC Rheindorf,8608,7,5,7,12,17,30,-13,22
FC Salzburg,8609,1,15,6,3,44,19,25,51
Rapid Vienna,8609,2,9,11,4,40,28,12,38
SK Sturm Gra,8609,3,11,5,8,29,28,1,38
LASK Linz,8609,4,9,6,9,28,29,-1,33
Mattersburg,8609,5,6,6,12,30,41,-11,24
Vienna,8609,6,6,5,13,23,39,-16,23
SC Rheindorf,8609,7,5,7,12,18,28,-10,22
FC Salzburg,8610,1,13,8,3,43,19,24,47
SK Sturm Gra,8610,2,11,6,7,30,27,3,39
Rapid Vienna,8610,3,9,9,6,37,30,7,36
LASK Linz,8610,4,8,6,10,29,31,-2,30
Mattersburg,8610,5,7,7,10,35,43,-8,28
Vienna,8610,6,7,5,12,26,39,-13,26
SC Rheindorf,8610,7,5,7,12,21,32,-11,22
FC Salzburg,8611,1,16,6,2,51,18,33,54
SK Sturm Gra,8611,2,13,3,8,34,31,3,42
Rapid Vienna,8611,3,9,9,6,36,29,7,36
LASK Linz,8611,4,10,5,9,32,29,3,35
Mattersburg,8611,5,7,5,12,35,45,-10,26
Vienna,8611,6,6,5,13,26,43,-17,23
SC Rheindorf,8611,7,4,5,15,17,36,-19,17
FC Salzburg,8612,1,15,6,3,48,18,30,51
SK Sturm Gra,8612,2,11,5,8,31,32,-1,38
Rapid Vienna,8612,3,8,12,4,35,26,9,36
LASK Linz,8612,4,9,6,9,26,31,-5,33
Mattersburg,8612,5,7,6,11,38,42,-4,27
Vienna,8612,6,6,6,12,25,40,-15,24
SC Rheindorf,8612,7,4,7,13,17,31,-14,19
FC Salzburg,8613,1,15,7,2,47,18,29,52
SK Sturm Gra,8613,2,12,3,9,30,30,0,39
LASK Linz,8613,3,9,5,10,27,29,-2,32
Rapid Vienna,8613,4,7,10,7,32,28,4,31
SC Rheindorf,8613,5,7,6,11,24,28,-4,27
Mattersburg,8613,6,6,7,11,34,44,-10,25
Vienna,8613,7,6,6,12,27,44,-17,24
FC Salzburg,8614,1,16,6,2,46,17,29,54
Rapid Vienna,8614,2,9,10,5,39,31,8,37
LASK Linz,8614,3,10,6,8,36,29,7,36
SK Sturm Gra,8614,4,11,3,10,31,36,-5,36
Mattersburg,8614,5,7,5,12,34,43,-9,26
Vienna,8614,6,6,5,13,25,43,-18,23
SC Rheindorf,8614,7,5,5,14,24,36,-12,20
FC Salzburg,8615,1,14,8,2,50,20,30,50
SK Sturm Gra,8615,2,12,3,9,31,30,1,39
Rapid Vienna,8615,3,9,11,4,36,25,11,38
LASK Linz,8615,4,9,7,8,28,24,4,34
Mattersburg,8615,5,7,6,11,30,44,-14,27
Vienna,8615,6,6,6,12,26,41,-15,24
SC Rheindorf,8615,7,4,5,15,16,33,-17,17
FC Salzburg,8616,1,15,7,2,50,17,33,52
SK Sturm Gra,8616,2,11,5,8,33,34,-1,38
Rapid Vienna,8616,3,7,11,6,33,29,4,32
LASK Linz,8616,4,8,6,10,28,30,-2,30
SC Rheindorf,8616,5,8,5,11,24,28,-4,29
Mattersburg,8616,6,6,6,12,31,45,-14,24
Vienna,8616,7,6,6,12,26,42,-16,24
FC Salzburg,8617,1,14,7,3,47,20,27,49
SK Sturm Gra,8617,2,11,5,8,31,31,0,38
Rapid Vienna,8617,3,8,12,4,32,23,9,36
LASK Linz,8617,4,8,7,9,26,28,-2,31
Vienna,8617,5,8,5,11,26,37,-11,29
Mattersburg,8617,6,6,6,12,32,45,-13,24
SC Rheindorf,8617,7,5,6,13,20,30,-10,21
FC Salzburg,8618,1,16,6,2,48,19,29,54
SK Sturm Gra,8618,2,11,5,8,30,28,2,38
Rapid Vienna,8618,3,9,10,5,35,28,7,37
LASK Linz,8618,4,7,7,10,28,33,-5,28
Mattersburg,8618,5,6,7,11,32,40,-8,25
Vienna,8618,6,6,6,12,27,42,-15,24
SC Rheindorf,8618,7,4,9,11,17,27,-10,21
FC Salzburg,8619,1,14,8,2,46,18,28,50
Rapid Vienna,8619,2,9,11,4,41,26,15,38
SK Sturm Gra,8619,3,11,4,9,32,31,1,37
LASK Linz,8619,4,8,5,11,25,32,-7,29
Mattersburg,8619,5,8,5,11,33,41,-8,29
Vienna,8619,6,6,6,12,24,39,-15,24
SC Rheindorf,8619,7,6,5,13,19,33,-14,23
FC Salzburg,8620,1,15,6,3,44,19,25,51
SK Sturm Gra,8620,2,12,4,8,35,32,3,40
Rapid Vienna,8620,3,8,11,5,35,27,8,35
LASK Linz,8620,4,9,5,10,29,31,-2,32
Mattersburg,8620,5,6,7,11,30,38,-8,25
Vienna,8620,6,6,6,12,24,39,-15,24
SC Rheindorf,8620,7,5,7,12,20,31,-11,22
FC Salzburg,8621,1,15,6,3,46,17,29,51
Rapid Vienna,8621,2,10,10,4,35,24,11,40
SK Sturm Gra,8621,3,12,4,8,30,30,0,40
LASK Linz,8621,4,8,5,11,25,31,-6,29
Vienna,8621,5,7,5,12,26,40,-14,26
SC Rheindorf,8621,6,6,5,13,23,29,-6,23
Mattersburg,8621,7,6,5,13,32,46,-14,23
FC Salzburg,8622,1,16,6,2,48,16,32,54
SK Sturm Gra,8622,2,12,4,8,32,30,2,40
Rapid Vienna,8622,3,9,9,6,33,26,7,36
LASK Linz,8622,4,8,7,9,25,26,-1,31
Mattersburg,8622,5,6,6,12,28,42,-14,24
SC Rheindorf,8622,6,6,5,13,21,28,-7,23
Vienna,8622,7,6,5,13,24,43,-19,23
FC Salzburg,8623,1,15,6,3,43,17,26,51
SK Sturm Gra,8623,2,14,4,6,34,26,8,46
Rapid Vienna,8623,3,8,9,7,35,30,5,33
LASK Linz,8623,4,7,7,10,27,31,-4,28
Vienna,8623,5,7,5,12,27,40,-13,26
SC Rheindorf,8623,6,6,7,11,22,29,-7,25
Mattersburg,8623,7,5,6,13,29,44,-15,21
FC Salzburg,8624,1,13,7,4,40,19,21,46
SK Sturm Gra,8624,2,12,5,7,33,29,4,41
Rapid Vienna,8624,3,10,10,4,38,26,12,40
LASK Linz,8624,4,8,5,11,27,31,-4,29
Mattersburg,8624,5,8,5,11,33,41,-8,29
Vienna,8624,6,7,5,12,26,39,-13,26
SC Rheindorf,8624,7,5,5,14,21,33,-12,20
FC Salzburg,8625,1,14,8,2,42,17,25,50
SK Sturm Gra,8625,2,12,5,7,30,26,4,41
Rapid Vienna,8625,3,9,10,5,35,25,10,37
LASK Linz,8625,4,7,6,11,24,28,-4,27
Vienna,8625,5,7,5,12,25,39,-14,26
Mattersburg,8625,6,6,7,11,30,40,-10,25
SC Rheindorf,8625,7,6,5,13,18,29,-11,23
FC Salzburg,8626,1,14,8,2,45,17,28,50
SK Sturm Gra,8626,2,12,4,8,32,28,4,40
Rapid Vienna,8626,3,9,10,5,34,25,9,37
LASK Linz,8626,4,8,6,10,25,27,-2,30
Mattersburg,8626,5,6,7,11,30,40,-10,25
SC Rheindorf,8626,6,6,6,12,19,29,-10,24
Vienna,8626,7,6,5,13,23,42,-19,23
FC Salzburg,8627,1,13,9,2,46,20,26,48
SK Sturm Gra,8627,2,13,4,7,33,26,7,43
Rapid Vienna,8627,3,8,11,5,35,27,8,35
LASK Linz,8627,4,8,7,9,26,27,-1,31
Mattersburg,8627,5,6,7,11,32,41,-9,25
Vienna,8627,6,6,5,13,26,45,-19,23
SC Rheindorf,8627,7,5,7,12,20,32,-12,22
FC Salzburg,8628,1,14,7,3,49,22,27,49
SK Sturm Gra,8628,2,12,5,7,34,30,4,41
Rapid Vienna,8628,3,9,9,6,40,30,10,36
LASK Linz,8628,4,10,5,9,28,26,2,35
Vienna,8628,5,8,5,11,29,40,-11,29
Mattersburg,8628,6,6,5,13,32,45,-13,23
SC Rheindorf,8628,7,4,6,14,16,35,-19,18
FC Salzburg,8629,1,14,7,3,42,20,22,49
SK Sturm Gra,8629,2,11,5,8,31,29,2,38
Rapid Vienna,8629,3,8,10,6,37,28,9,34
LASK Linz,8629,4,8,7,9,26,27,-1,31
Mattersburg,8629,5,7,7,10,30,38,-8,28
SC Rheindorf,8629,6,6,6,12,20,29,-9,24
Vienna,8629,7,6,6,12,24,39,-15,24
FC Salzburg,8630,1,15,7,2,49,17,32,52
SK Sturm Gra,8630,2,12,4,8,34,33,1,40
Rapid Vienna,8630,3,7,11,6,35,29,6,32
LASK Linz,8630,4,8,5,11,26,33,-7,29
Mattersburg,8630,5,8,5,11,33,41,-8,29
SC Rheindorf,8630,6,7,5,12,23,31,-8,26
Vienna,8630,7,6,5,13,25,41,-16,23
FC Salzburg,8631,1,14,7,3,45,20,25,49
SK Sturm Gra,8631,2,11,4,9,32,32,0,37
LASK Linz,8631,3,9,7,8,32,29,3,34
Rapid Vienna,8631,4,7,12,5,35,30,5,33
Vienna,8631,5,7,5,12,28,43,-15,26
Mattersburg,8631,6,6,7,11,33,42,-9,25
SC Rheindorf,8631,7,5,8,11,23,32,-9,23
SK Sturm Gra,8632,1,14,4,6,36,27,9,46
FC Salzburg,8632,2,12,8,4,41,20,21,44
Rapid Vienna,8632,3,7,11,6,33,27,6,32
LASK Linz,8632,4,9,5,10,26,32,-6,32
Mattersburg,8632,5,8,6,10,38,41,-3,30
Vienna,8632,6,7,5,12,25,40,-15,26
SC Rheindorf,8632,7,4,7,13,18,30,-12,19
FC Salzburg,8633,1,16,6,2,47,17,30,54
SK Sturm Gra,8633,2,12,4,8,33,29,4,40
Rapid Vienna,8633,3,9,9,6,34,27,7,36
LASK Linz,8633,4,10,5,9,28,27,1,35
Mattersburg,8633,5,7,5,12,35,42,-7,26
Vienna,8633,6,6,5,13,25,44,-19,23
SC Rheindorf,8633,7,4,6,14,18,34,-16,18
FC Salzburg,8634,1,14,6,4,42,20,22,48
SK Sturm Gra,8634,2,12,5,7,37,30,7,41
Rapid Vienna,8634,3,10,10,4,41,27,14,40
Vienna,8634,4,8,5,11,29,39,-10,29
LASK Linz,8634,5,7,7,10,24,31,-7,28
SC Rheindorf,8634,6,5,7,12,20,30,-10,22
Mattersburg,8634,7,5,6,13,28,44,-16,21
FC Salzburg,8635,1,13,9,2,40,16,24,48
SK Sturm Gra,8635,2,12,4,8,35,31,4,40
Rapid Vienna,8635,3,9,9,6,39,31,8,36
LASK Linz,8635,4,9,5,10,29,31,-2,32
Mattersburg,8635,5,6,7,11,31,40,-9,25
Vienna,8635,6,6,7,11,25,39,-14,25
SC Rheindorf,8635,7,6,5,13,20,31,-11,23
FC Salzburg,8636,1,14,8,2,44,18,26,50
SK Sturm Gra,8636,2,13,3,8,34,31,3,42
Rapid Vienna,8636,3,8,11,5,37,26,11,35
LASK Linz,8636,4,8,6,10,25,30,-5,30
Vienna,8636,5,7,5,12,25,39,-14,26
Mattersburg,8636,6,6,6,12,32,43,-11,24
SC Rheindorf,8636,7,6,5,13,22,32,-10,23
FC Salzburg,8637,1,15,7,2,50,22,28,52
SK Sturm Gra,8637,2,13,4,7,34,29,5,43
Rapid Vienna,8637,3,8,11,5,37,26,11,35
LASK Linz,8637,4,8,7,9,27,27,0,31
Vienna,8637,5,7,5,12,28,44,-16,26
Mattersburg,8637,6,5,6,13,29,43,-14,21
SC Rheindorf,8637,7,4,8,12,19,33,-14,20
FC Salzburg,8638,1,14,8,2,45,19,26,50
Rapid Vienna,8638,2,10,10,4,39,25,14,40
SK Sturm Gra,8638,3,11,4,9,31,30,1,37
LASK Linz,8638,4,9,5,10,29,34,-5,32
Vienna,8638,5,6,7,11,25,39,-14,25
Mattersburg,8638,6,6,6,12,29,41,-12,24
SC Rheindorf,8638,7,5,6,13,21,31,-10,21
FC Salzburg,8639,1,14,7,3,50,20,30,49
SK Sturm Gra,8639,2,11,5,8,32,34,-2,38
Rapid Vienna,8639,3,8,11,5,37,28,9,35
LASK Linz,8639,4,9,6,9,31,32,-1,33
Vienna,8639,5,7,6,11,27,38,-11,27
Mattersburg,8639,6,6,6,12,32,46,-14,24
SC Rheindorf,8639,7,6,5,13,20,31,-11,23
FC Salzburg,8640,1,14,6,4,43,20,23,48
SK Sturm Gra,8640,2,12,4,8,32,31,1,40
Rapid Vienna,8640,3,8,11,5,34,27,7,35
LASK Linz,8640,4,8,7,9,26,27,-1,31
SC Rheindorf,8640,5,7,6,11,22,26,-4,27
Mattersburg,8640,6,7,5,12,32,41,-9,26
Vienna,8640,7,6,5,13,25,42,-17,23
FC Salzburg,8641,1,14,7,3,45,22,23,49
SK Sturm Gra,8641,2,13,4,7,33,27,6,43
Rapid Vienna,8641,3,8,11,5,39,28,11,35
LASK Linz,8641,4,8,6,10,27,34,-7,30
Vienna,8641,5,7,5,12,28,41,-13,26
Mattersburg,8641,6,6,6,12,28,38,-10,24
SC Rheindorf,8641,7,4,9,11,18,28,-10,21
FC Salzburg,8642,1,15,7,2,46,18,28,52
SK Sturm Gra,8642,2,13,4,7,33,27,6,43
Rapid Vienna,8642,3,8,10,6,33,26,7,34
LASK Linz,8642,4,8,6,10,25,30,-5,30
Vienna,8642,5,7,5,12,28,41,-13,26
Mattersburg,8642,6,6,6,12,34,46,-12,24
SC Rheindorf,8642,7,4,8,12,18,29,-11,20
SK Sturm Gra,8643,1,14,4,6,32,25,7,46
FC Salzburg,8643,2,12,8,4,39,18,21,44
Rapid Vienna,8643,3,8,10,6,33,25,8,34
Mattersburg,8643,4,8,6,10,32,39,-7,30
LASK Linz,8643,5,8,5,11,27,30,-3,29
Vienna,8643,6,6,6,12,25,40,-15,24
SC Rheindorf,8643,7,5,7,12,19,30,-11,22
FC Salzburg,8644,1,13,9,2,47,22,25,48
SK Sturm Gra,8644,2,12,6,6,37,32,5,42
Rapid Vienna,8644,3,8,12,4,41,30,11,36
Mattersburg,8644,4,8,5,11,37,43,-6,29
LASK Linz,8644,5,7,6,11,27,34,-7,27
Vienna,8644,6,6,6,12,26,42,-16,24
SC Rheindorf,8644,7,5,6,13,20,32,-12,21
FC Salzburg,8645,1,15,6,3,47,19,28,51
SK Sturm Gra,8645,2,14,3,7,38,31,7,45
Rapid Vienna,8645,3,8,10,6,35,30,5,34
LASK Linz,8645,4,7,6,11,26,32,-6,27
Mattersburg,8645,5,7,6,11,32,40,-8,27
Vienna,8645,6,7,6,11,26,39,-13,27
SC Rheindorf,8645,7,4,7,13,17,30,-13,19
FC Salzburg,8646,1,15,7,2,45,16,29,52
SK Sturm Gra,8646,2,11,6,7,32,29,3,39
Rapid Vienna,8646,3,8,11,5,35,28,7,35
LASK Linz,8646,4,8,6,10,25,26,-1,30
Vienna,8646,5,7,5,12,26,39,-13,26
Mattersburg,8646,6,6,6,12,29,44,-15,24
SC Rheindorf,8646,7,5,7,12,19,29,-10,22
FC Salzburg,8647,1,12,7,5,41,22,19,43
SK Sturm Gra,8647,2,11,6,7,33,31,2,39
LASK Linz,8647,3,10,6,8,30,27,3,36
Rapid Vienna,8647,4,8,11,5,36,28,8,35
Vienna,8647,5,7,6,11,25,38,-13,27
Mattersburg,8647,6,6,7,11,31,41,-10,25
SC Rheindorf,8647,7,5,7,12,20,29,-9,22
FC Salzburg,8648,1,14,8,2,46,18,28,50
SK Sturm Gra,8648,2,13,4,7,34,29,5,43
LASK Linz,8648,3,9,6,9,28,27,1,33
Rapid Vienna,8648,4,7,11,6,34,30,4,32
Mattersburg,8648,5,7,5,12,29,41,-12,26
Vienna,8648,6,7,5,12,25,39,-14,26
SC Rheindorf,8648,7,5,5,14,19,31,-12,20
SK Sturm Gra,8649,1,13,5,6,33,25,8,44
FC Salzburg,8649,2,12,7,5,39,24,15,43
Rapid Vienna,8649,3,8,10,6,38,29,9,34
LASK Linz,8649,4,7,8,9,28,32,-4,29
Vienna,8649,5,7,6,11,26,38,-12,27
Mattersburg,8649,6,6,7,11,31,39,-8,25
SC Rheindorf,8649,7,6,7,11,19,27,-8,25
FC Salzburg,8650,1,15,6,3,48,19,29,51
SK Sturm Gra,8650,2,13,3,8,32,30,2,42
Rapid Vienna,8650,3,9,9,6,35,26,9,36
LASK Linz,8650,4,10,5,9,26,25,1,35
Mattersburg,8650,5,7,6,11,32,44,-12,27
Vienna,8650,6,6,6,12,26,41,-15,24
SC Rheindorf,8650,7,4,5,15,17,31,-14,17
FC Salzburg,8651,1,15,7,2,44,17,27,52
SK Sturm Gra,8651,2,12,4,8,33,31,2,40
Rapid Vienna,8651,3,8,12,4,38,27,11,36
LASK Linz,8651,4,7,7,10,29,32,-3,28
Mattersburg,8651,5,6,7,11,28,39,-11,25
SC Rheindorf,8651,6,6,6,12,21,31,-10,24
Vienna,8651,7,6,5,13,23,39,-16,23
FC Salzburg,8652,1,15,7,2,47,19,28,52
SK Sturm Gra,8652,2,13,3,8,34,28,6,42
Rapid Vienna,8652,3,8,11,5,35,28,7,35
LASK Linz,8652,4,7,7,10,26,33,-7,28
SC Rheindorf,8652,5,6,6,12,23,29,-6,24
Vienna,8652,6,6,6,12,27,43,-16,24
Mattersburg,8652,7,5,8,11,31,43,-12,23
FC Salzburg,8653,1,14,7,3,46,22,24,49
SK Sturm Gra,8653,2,12,3,9,30,33,-3,39
Rapid Vienna,8653,3,9,10,5,36,25,11,37
Vienna,8653,4,8,5,11,30,41,-11,29
LASK Linz,8653,5,7,7,10,25,31,-6,28
Mattersburg,8653,6,6,7,11,33,43,-10,25
SC Rheindorf,8653,7,5,7,12,21,26,-5,22
FC Salzburg,8654,1,15,6,3,48,20,28,51
SK Sturm Gra,8654,2,11,6,7,32,32,0,39
Rapid Vienna,8654,3,7,11,6,33,27,6,32
LASK Linz,8654,4,8,6,10,24,26,-2,30
Mattersburg,8654,5,7,6,11,29,38,-9,27
SC Rheindorf,8654,6,6,7,11,20,28,-8,25
Vienna,8654,7,6,6,12,23,38,-15,24
FC Salzburg,8655,1,14,7,3,46,18,28,49
Rapid Vienna,8655,2,10,10,4,36,25,11,40
SK Sturm Gra,8655,3,11,5,8,30,28,2,38
LASK Linz,8655,4,8,6,10,28,29,-1,30
Mattersburg,8655,5,8,5,11,31,43,-12,29
Vienna,8655,6,6,6,12,25,40,-15,24
SC Rheindorf,8655,7,5,5,14,17,30,-13,20
FC Salzburg,8656,1,15,6,3,47,20,27,51
SK Sturm Gra,8656,2,13,3,8,32,27,5,42
Rapid Vienna,8656,3,9,10,5,35,26,9,37
LASK Linz,8656,4,8,6,10,26,29,-3,30
Vienna,8656,5,8,5,11,27,38,-11,29
SC Rheindorf,8656,6,5,6,13,19,30,-11,21
Mattersburg,8656,7,5,6,13,30,46,-16,21
FC Salzburg,8657,1,15,7,2,48,20,28,52
SK Sturm Gra,8657,2,11,6,7,33,30,3,39
Rapid Vienna,8657,3,8,10,6,39,32,7,34
LASK Linz,8657,4,8,6,10,27,32,-5,30
SC Rheindorf,8657,5,6,7,11,21,27,-6,25
Mattersburg,8657,6,6,6,12,32,43,-11,24
Vienna,8657,7,6,6,12,26,42,-16,24
FC Salzburg,8658,1,14,6,4,44,19,25,48
SK Sturm Gra,8658,2,13,4,7,30,26,4,43
Rapid Vienna,8658,3,9,10,5,37,28,9,37
LASK Linz,8658,4,8,6,10,29,29,0,30
Mattersburg,8658,5,7,6,11,34,44,-10,27
Vienna,8658,6,6,6,12,25,41,-16,24
SC Rheindorf,8658,7,5,6,13,20,32,-12,21
FC Salzburg,8659,1,15,7,2,54,20,34,52
Rapid Vienna,8659,2,9,10,5,37,28,9,37
SK Sturm Gra,8659,3,11,4,9,28,34,-6,37
LASK Linz,8659,4,8,7,9,27,29,-2,31
SC Rheindorf,8659,5,7,5,12,23,28,-5,26
Vienna,8659,6,6,6,12,28,43,-15,24
Mattersburg,8659,7,6,5,13,30,45,-15,23
FC Salzburg,8660,1,15,6,3,45,16,29,51
SK Sturm Gra,8660,2,13,4,7,34,28,6,43
Rapid Vienna,8660,3,8,10,6,36,31,5,34
LASK Linz,8660,4,8,6,10,27,30,-3,30
Mattersburg,8660,5,7,6,11,33,43,-10,27
Vienna,8660,6,6,5,13,23,40,-17,23
SC Rheindorf,8660,7,4,9,11,23,33,-10,21
FC Salzburg,8661,1,15,6,3,45,17,28,51
SK Sturm Gra,8661,2,12,4,8,30,26,4,40
Rapid Vienna,8661,3,8,11,5,35,29,6,35
LASK Linz,8661,4,9,5,10,29,33,-4,32
Vienna,8661,5,8,5,11,27,38,-11,29
Mattersburg,8661,6,6,5,13,32,46,-14,23
SC Rheindorf,8661,7,5,6,13,25,34,-9,21
FC Salzburg,8662,1,13,7,4,43,21,22,46
Rapid Vienna,8662,2,10,10,4,37,24,13,40
SK Sturm Gra,8662,3,12,4,8,33,33,0,40
LASK Linz,8662,4,8,7,9,29,27,2,31
Mattersburg,8662,5,6,6,12,34,45,-11,24
SC Rheindorf,8662,6,6,6,12,20,31,-11,24
Vienna,8662,7,6,6,12,24,39,-15,24
FC Salzburg,8663,1,15,6,3,47,20,27,51
SK Sturm Gra,8663,2,12,4,8,34,29,5,40
Rapid Vienna,8663,3,8,10,6,35,31,4,34
LASK Linz,8663,4,9,5,10,31,34,-3,32
Vienna,8663,5,8,5,11,30,38,-8,29
SC Rheindorf,8663,6,7,5,12,24,31,-7,26
Mattersburg,8663,7,5,5,14,28,46,-18,20
FC Salzburg,8664,1,15,6,3,47,16,31,51
SK Sturm Gra,8664,2,14,3,7,34,29,5,45
Rapid Vienna,8664,3,9,9,6,37,28,9,36
LASK Linz,8664,4,9,6,9,26,26,0,33
Vienna,8664,5,7,5,12,24,42,-18,26
SC Rheindorf,8664,6,5,6,13,19,31,-12,21
Mattersburg,8664,7,5,5,14,26,41,-15,20
FC Salzburg,8665,1,14,6,4,42,22,20,48
SK Sturm Gra,8665,2,13,4,7,34,27,7,43
Rapid Vienna,8665,3,8,11,5,37,27,10,35
LASK Linz,8665,4,9,5,10,29,31,-2,32
Vienna,8665,5,8,5,11,27,38,-11,29
Mattersburg,8665,6,6,5,13,30,42,-12,23
SC Rheindorf,8665,7,5,6,13,20,32,-12,21
FC Salzburg,8666,1,15,7,2,48,20,28,52
SK Sturm Gra,8666,2,12,4,8,32,28,4,40
Rapid Vienna,8666,3,9,10,5,36,29,7,37
Vienna,8666,4,7,6,11,29,42,-13,27
LASK Linz,8666,5,7,5,12,27,35,-8,26
SC Rheindorf,8666,6,6,6,12,20,27,-7,24
Mattersburg,8666,7,6,6,12,31,42,-11,24
FC Salzburg,8667,1,13,8,3,45,20,25,47
SK Sturm Gra,8667,2,12,5,7,30,26,4,41
Rapid Vienna,8667,3,9,10,5,41,28,13,37
LASK Linz,8667,4,9,6,9,29,29,0,33
Mattersburg,8667,5,7,6,11,31,39,-8,27
Vienna,8667,6,7,5,12,25,41,-16,26
SC Rheindorf,8667,7,4,6,14,17,35,-18,18
FC Salzburg,8668,1,13,7,4,41,21,20,46
SK Sturm Gra,8668,2,12,5,7,33,27,6,41
Rapid Vienna,8668,3,8,11,5,36,27,9,35
LASK Linz,8668,4,7,7,10,24,29,-5,28
Mattersburg,8668,5,7,6,11,32,40,-8,27
Vienna,8668,6,7,5,12,25,39,-14,26
SC Rheindorf,8668,7,6,7,11,19,27,-8,25
FC Salzburg,8669,1,15,6,3,44,18,26,51
SK Sturm Gra,8669,2,13,3,8,33,32,1,42
LASK Linz,8669,3,10,6,8,30,27,3,36
Rapid Vienna,8669,4,8,10,6,36,28,8,34
SC Rheindorf,8669,5,6,5,13,23,30,-7,23
Mattersburg,8669,6,6,5,13,34,48,-14,23
Vienna,8669,7,6,5,13,25,42,-17,23
FC Salzburg,8670,1,15,6,3,48,21,27,51
Rapid Vienna,8670,2,10,9,5,37,30,7,39
SK Sturm Gra,8670,3,12,3,9,35,31,4,39
LASK Linz,8670,4,9,5,10,28,30,-2,32
Vienna,8670,5,7,5,12,26,40,-14,26
SC Rheindorf,8670,6,6,5,13,19,29,-10,23
Mattersburg,8670,7,6,5,13,31,43,-12,23
FC Salzburg,8671,1,13,8,3,41,20,21,47
SK Sturm Gra,8671,2,14,4,6,37,28,9,46
Rapid Vienna,8671,3,8,11,5,34,26,8,35
LASK Linz,8671,4,7,6,11,25,31,-6,27
Mattersburg,8671,5,7,6,11,31,40,-9,27
Vienna,8671,6,7,6,11,28,39,-11,27
SC Rheindorf,8671,7,4,7,13,18,30,-12,19
FC Salzburg,8672,1,16,6,2,49,15,34,54
SK Sturm Gra,8672,2,13,3,8,33,29,4,42
Rapid Vienna,8672,3,7,10,7,31,30,1,31
LASK Linz,8672,4,8,7,9,26,26,0,31
Vienna,8672,5,7,5,12,26,41,-15,26
Mattersburg,8672,6,6,6,12,29,43,-14,24
SC Rheindorf,8672,7,6,5,13,21,31,-10,23
FC Salzburg,8673,1,16,6,2,50,18,32,54
SK Sturm Gra,8673,2,13,3,8,35,31,4,42
Rapid Vienna,8673,3,8,9,7,35,36,-1,33
LASK Linz,8673,4,8,6,10,31,29,2,30
Mattersburg,8673,5,7,6,11,33,40,-7,27
SC Rheindorf,8673,6,6,5,13,18,29,-11,23
Vienna,8673,7,6,5,13,25,44,-19,23
FC Salzburg,8674,1,15,6,3,49,21,28,51
SK Sturm Gra,8674,2,13,4,7,37,28,9,43
LASK Linz,8674,3,9,6,9,29,28,1,33
Rapid Vienna,8674,4,7,9,8,33,37,-4,30
Mattersburg,8674,5,7,6,11,33,41,-8,27
SC Rheindorf,8674,6,6,6,12,19,28,-9,24
Vienna,8674,7,6,5,13,24,41,-17,23
FC Salzburg,8675,1,13,9,2,44,20,24,48
SK Sturm Gra,8675,2,12,4,8,32,30,2,40
Rapid Vienna,8675,3,7,11,6,32,28,4,32
LASK Linz,8675,4,8,6,10,26,28,-2,30
Mattersburg,8675,5,7,6,11,33,41,-8,27
Vienna,8675,6,7,6,11,28,41,-13,27
SC Rheindorf,8675,7,6,6,12,20,27,-7,24
FC Salzburg,8676,1,16,6,2,49,16,33,54
SK Sturm Gra,8676,2,13,3,8,37,30,7,42
Rapid Vienna,8676,3,10,9,5,39,27,12,39
LASK Linz,8676,4,9,5,10,28,32,-4,32
Mattersburg,8676,5,6,6,12,29,43,-14,24
Vienna,8676,6,6,6,12,24,42,-18,24
SC Rheindorf,8676,7,4,5,15,17,33,-16,17
FC Salzburg,8677,1,16,6,2,52,17,35,54
SK Sturm Gra,8677,2,12,4,8,30,28,2,40
Rapid Vienna,8677,3,9,9,6,36,30,6,36
LASK Linz,8677,4,9,6,9,29,27,2,33
Mattersburg,8677,5,7,6,11,32,40,-8,27
Vienna,8677,6,6,5,13,23,44,-21,23
SC Rheindorf,8677,7,4,6,14,18,34,-16,18
FC Salzburg,8678,1,15,7,2,50,19,31,52
SK Sturm Gra,8678,2,12,4,8,33,29,4,40
Rapid Vienna,8678,3,8,11,5,33,27,6,35
LASK Linz,8678,4,9,6,9,29,29,0,33
Mattersburg,8678,5,6,6,12,32,47,-15,24
Vienna,8678,6,6,6,12,25,41,-16,24
SC Rheindorf,8678,7,5,6,13,20,30,-10,21
FC Salzburg,8679,1,15,7,2,46,17,29,52
SK Sturm Gra,8679,2,11,5,8,30,29,1,38
Rapid Vienna,8679,3,9,10,5,33,25,8,37
LASK Linz,8679,4,9,7,8,29,26,3,34
Vienna,8679,5,7,5,12,26,40,-14,26
Mattersburg,8679,6,6,5,13,31,45,-14,23
SC Rheindorf,8679,7,4,7,13,19,32,-13,19
FC Salzburg,8680,1,13,6,5,41,21,20,45
SK Sturm Gra,8680,2,14,3,7,32,25,7,45
Rapid Vienna,8680,3,8,9,7,34,28,6,33
LASK Linz,8680,4,8,6,10,27,29,-2,30
SC Rheindorf,8680,5,8,5,11,21,27,-6,29
Vienna,8680,6,8,5,11,28,37,-9,29
Mattersburg,8680,7,5,6,13,29,45,-16,21
FC Salzburg,8681,1,13,7,4,44,22,22,46
SK Sturm Gra,8681,2,11,5,8,32,30,2,38
Rapid Vienna,8681,3,9,10,5,36,26,10,37
LASK Linz,8681,4,9,6,9,29,30,-1,33
Vienna,8681,5,8,5,11,26,38,-12,29
Mattersburg,8681,6,7,5,12,30,40,-10,26
SC Rheindorf,8681,7,5,6,13,20,31,-11,21
FC Salzburg,8682,1,14,6,4,43,17,26,48
Rapid Vienna,8682,2,11,9,4,38,23,15,42
SK Sturm Gra,8682,3,11,5,8,30,29,1,38
LASK Linz,8682,4,9,6,9,29,28,1,33
Vienna,8682,5,8,5,11,27,37,-10,29
Mattersburg,8682,6,6,5,13,29,45,-16,23
SC Rheindorf,8682,7,4,6,14,16,33,-17,18
FC Salzburg,8683,1,14,7,3,47,20,27,49
SK Sturm Gra,8683,2,12,4,8,32,31,1,40
Rapid Vienna,8683,3,8,10,6,36,29,7,34
LASK Linz,8683,4,8,6,10,28,30,-2,30
SC Rheindorf,8683,5,7,5,12,22,28,-6,26
Mattersburg,8683,6,6,7,11,31,44,-13,25
Vienna,8683,7,6,7,11,26,40,-14,25
FC Salzburg,8684,1,13,8,3,44,20,24,47
SK Sturm Gra,8684,2,14,4,6,37,29,8,46
Rapid Vienna,8684,3,7,12,5,36,30,6,33
LASK Linz,8684,4,8,7,9,25,25,0,31
Vienna,8684,5,7,6,11,27,40,-13,27
Mattersburg,8684,6,5,8,11,29,41,-12,23
SC Rheindorf,8684,7,4,7,13,17,30,-13,19
FC Salzburg,8685,1,14,8,2,46,19,27,50
SK Sturm Gra,8685,2,11,5,8,32,30,2,38
Rapid Vienna,8685,3,8,12,4,36,26,10,36
LASK Linz,8685,4,8,7,9,28,30,-2,31
Mattersburg,8685,5,6,7,11,33,44,-11,25
SC Rheindorf,8685,6,6,6,12,22,30,-8,24
Vienna,8685,7,6,5,13,26,44,-18,23
FC Salzburg,8686,1,13,7,4,41,20,21,46
SK Sturm Gra,8686,2,13,4,7,35,29,6,43
Rapid Vienna,8686,3,9,10,5,37,27,10,37
Mattersburg,8686,4,8,6,10,35,41,-6,30
LASK Linz,8686,5,7,7,10,27,32,-5,28
Vienna,8686,6,6,6,12,26,41,-15,24
SC Rheindorf,8686,7,4,8,12,21,32,-11,20
FC Salzburg,8687,1,15,7,2,47,18,29,52
SK Sturm Gra,8687,2,14,3,7,36,27,9,45
Rapid Vienna,8687,3,7,11,6,35,30,5,32
LASK Linz,8687,4,9,5,10,27,30,-3,32
Vienna,8687,5,7,5,12,26,40,-14,26
Mattersburg,8687,6,6,5,13,33,46,-13,23
SC Rheindorf,8687,7,5,6,13,19,32,-13,21
FC Salzburg,8688,1,14,8,2,42,17,25,50
SK Sturm Gra,8688,2,12,3,9,34,32,2,39
LASK Linz,8688,3,9,5,10,27,29,-2,32
Rapid Vienna,8688,4,7,9,8,34,31,3,30
Vienna,8688,5,7,6,11,28,38,-10,27
Mattersburg,8688,6,7,6,11,31,42,-11,27
SC Rheindorf,8688,7,7,5,12,22,29,-7,26
FC Salzburg,8689,1,13,7,4,41,20,21,46
SK Sturm Gra,8689,2,11,5,8,33,31,2,38
Rapid Vienna,8689,3,8,12,4,37,28,9,36
LASK Linz,8689,4,9,6,9,30,29,1,33
Mattersburg,8689,5,8,6,10,35,40,-5,30
Vienna,8689,6,7,5,12,25,40,-15,26
SC Rheindorf,8689,7,4,7,13,21,34,-13,19
FC Salzburg,8690,1,14,7,3,44,20,24,49
SK Sturm Gra,8690,2,12,4,8,30,27,3,40
Rapid Vienna,8690,3,9,11,4,38,26,12,38
LASK Linz,8690,4,8,6,10,26,27,-1,30
Vienna,8690,5,7,6,11,25,38,-13,27
SC Rheindorf,8690,6,6,6,12,19,28,-9,24
Mattersburg,8690,7,5,6,13,29,45,-16,21
FC Salzburg,8691,1,15,7,2,44,16,28,52
SK Sturm Gra,8691,2,14,4,6,34,26,8,46
Rapid Vienna,8691,3,8,9,7,35,29,6,33
LASK Linz,8691,4,8,5,11,25,30,-5,29
Vienna,8691,5,7,5,12,26,41,-15,26
SC Rheindorf,8691,6,6,5,13,22,31,-9,23
Mattersburg,8691,7,6,5,13,30,43,-13,23
FC Salzburg,8692,1,16,6,2,46,17,29,54
Rapid Vienna,8692,2,10,9,5,36,27,9,39
SK Sturm Gra,8692,3,11,3,10,31,33,-2,36
LASK Linz,8692,4,8,6,10,25,28,-3,30
Mattersburg,8692,5,7,5,12,33,41,-8,26
SC Rheindorf,8692,6,6,6,12,20,29,-9,24
Vienna,8692,7,6,5,13,26,42,-16,23
FC Salzburg,8693,1,15,7,2,46,17,29,52
SK Sturm Gra,8693,2,13,4,7,34,27,7,43
Rapid Vienna,8693,3,8,10,6,35,28,7,34
LASK Linz,8693,4,8,5,11,28,34,-6,29
Mattersburg,8693,5,7,5,12,32,44,-12,26
Vienna,8693,6,7,5,12,26,40,-14,26
SC Rheindorf,8693,7,5,6,13,19,30,-11,21
FC Salzburg,8694,1,15,7,2,45,16,29,52
SK Sturm Gra,8694,2,11,6,7,33,31,2,39
Rapid Vienna,8694,3,9,10,5,37,30,7,37
LASK Linz,8694,4,7,8,9,25,27,-2,29
Vienna,8694,5,7,5,12,26,39,-13,26
SC Rheindorf,8694,6,5,7,12,19,29,-10,22
Mattersburg,8694,7,5,7,12,29,42,-13,22
SK Sturm Gra,8695,1,14,4,6,36,28,8,46
FC Salzburg,8695,2,13,6,5,40,20,20,45
Rapid Vienna,8695,3,8,12,4,37,27,10,36
LASK Linz,8695,4,8,6,10,29,31,-2,30
Mattersburg,8695,5,8,5,11,35,43,-8,29
Vienna,8695,6,7,5,12,26,39,-13,26
SC Rheindorf,8695,7,4,6,14,19,34,-15,18
FC Salzburg,8696,1,14,8,2,44,17,27,50
SK Sturm Gra,8696,2,13,4,7,32,27,5,43
Rapid Vienna,8696,3,8,9,7,34,30,4,33
LASK Linz,8696,4,8,6,10,27,30,-3,30
Vienna,8696,5,7,6,11,26,37,-11,27
Mattersburg,8696,6,6,7,11,30,41,-11,25
SC Rheindorf,8696,7,5,6,13,20,31,-11,21
FC Salzburg,8697,1,13,8,3,42,19,23,47
SK Sturm Gra,8697,2,14,4,6,35,28,7,46
Rapid Vienna,8697,3,9,9,6,38,29,9,36
LASK Linz,8697,4,9,6,9,31,29,2,33
Vienna,8697,5,7,6,11,26,38,-12,27
Mattersburg,8697,6,5,6,13,28,44,-16,21
SC Rheindorf,8697,7,5,5,14,19,32,-13,20
FC Salzburg,8698,1,15,6,3,47,20,27,51
SK Sturm Gra,8698,2,12,5,7,30,26,4,41
Rapid Vienna,8698,3,9,10,5,33,24,9,37
Mattersburg,8698,4,7,6,11,32,41,-9,27
LASK Linz,8698,5,7,5,12,23,30,-7,26
SC Rheindorf,8698,6,6,6,12,18,26,-8,24
Vienna,8698,7,6,6,12,27,43,-16,24
FC Salzburg,8699,1,13,9,2,44,20,24,48
SK Sturm Gra,8699,2,11,5,8,33,33,0,38
Rapid Vienna,8699,3,8,11,5,34,26,8,35
LASK Linz,8699,4,7,8,9,26,30,-4,29
Mattersburg,8699,5,6,8,10,30,39,-9,26
Vienna,8699,6,6,7,11,25,39,-14,25
SC Rheindorf,8699,7,6,6,12,23,28,-5,24
FC Salzburg,8700,1,14,6,4,47,22,25,48
SK Sturm Gra,8700,2,14,3,7,32,28,4,45
Mattersburg,8700,3,9,5,10,40,41,-1,32
Rapid Vienna,8700,4,7,10,7,31,29,2,31
LASK Linz,8700,5,8,6,10,25,28,-3,30
Vienna,8700,6,7,5,12,28,40,-12,26
SC Rheindorf,8700,7,4,7,13,17,32,-15,19
FC Salzburg,8701,1,16,6,2,48,17,31,54
SK Sturm Gra,8701,2,12,4,8,30,26,4,40
Rapid Vienna,8701,3,8,10,6,32,25,7,34
LASK Linz,8701,4,7,6,11,23,31,-8,27
Mattersburg,8701,5,7,6,11,31,42,-11,27
SC Rheindorf,8701,6,6,6,12,18,26,-8,24
Vienna,8701,7,6,6,12,26,41,-15,24
FC Salzburg,8702,1,14,8,2,49,19,30,50
SK Sturm Gra,8702,2,13,3,8,36,31,5,42
Rapid Vienna,8702,3,8,11,5,37,28,9,35
LASK Linz,8702,4,7,6,11,23,34,-11,27
Vienna,8702,5,7,6,11,28,41,-13,27
Mattersburg,8702,6,7,5,12,34,45,-11,26
SC Rheindorf,8702,7,6,5,13,21,30,-9,23
FC Salzburg,8703,1,14,6,4,41,21,20,48
SK Sturm Gra,8703,2,13,3,8,33,29,4,42
Rapid Vienna,8703,3,9,10,5,35,25,10,37
LASK Linz,8703,4,9,6,9,28,29,-1,33
Vienna,8703,5,7,5,12,28,38,-10,26
Mattersburg,8703,6,6,7,11,29,40,-11,25
SC Rheindorf,8703,7,4,7,13,18,30,-12,19
FC Salzburg,8704,1,14,7,3,46,20,26,49
SK Sturm Gra,8704,2,14,4,6,33,25,8,46
Rapid Vienna,8704,3,7,11,6,35,30,5,32
LASK Linz,8704,4,9,5,10,28,29,-1,32
Vienna,8704,5,6,7,11,24,38,-14,25
Mattersburg,8704,6,6,6,12,29,42,-13,24
SC Rheindorf,8704,7,5,6,13,18,29,-11,21
FC Salzburg,8705,1,14,7,3,44,20,24,49
Rapid Vienna,8705,2,10,10,4,37,25,12,40
SK Sturm Gra,8705,3,12,4,8,32,29,3,40
LASK Linz,8705,4,9,7,8,27,26,1,34
Vienna,8705,5,7,5,12,26,40,-14,26
Mattersburg,8705,6,5,6,13,31,44,-13,21
SC Rheindorf,8705,7,4,7,13,18,31,-13,19
FC Salzburg,8706,1,14,8,2,43,16,27,50
SK Sturm Gra,8706,2,11,5,8,29,30,-1,38
Rapid Vienna,8706,3,8,10,6,37,29,8,34
LASK Linz,8706,4,8,7,9,29,29,0,31
SC Rheindorf,8706,5,7,6,11,25,28,-3,27
Mattersburg,8706,6,7,5,12,32,46,-14,26
Vienna,8706,7,6,5,13,24,41,-17,23
FC Salzburg,8707,1,13,7,4,43,21,22,46
Rapid Vienna,8707,2,11,9,4,41,26,15,42
SK Sturm Gra,8707,3,12,4,8,32,30,2,40
LASK Linz,8707,4,8,5,11,28,31,-3,29
Vienna,8707,5,7,5,12,26,42,-16,26
SC Rheindorf,8707,6,6,6,12,20,29,-9,24
Mattersburg,8707,7,6,6,12,30,41,-11,24
FC Salzburg,8708,1,16,6,2,43,16,27,54
SK Sturm Gra,8708,2,11,4,9,28,31,-3,37
LASK Linz,8708,3,9,7,8,29,27,2,34
Rapid Vienna,8708,4,8,9,7,34,28,6,33
SC Rheindorf,8708,5,7,6,11,26,27,-1,27
Mattersburg,8708,6,6,5,13,30,44,-14,23
Vienna,8708,7,6,5,13,24,41,-17,23
FC Salzburg,8709,1,14,7,3,47,20,27,49
SK Sturm Gra,8709,2,12,5,7,31,31,0,41
Rapid Vienna,8709,3,10,9,5,36,25,11,39
LASK Linz,8709,4,8,6,10,26,28,-2,30
Mattersburg,8709,5,7,6,11,32,41,-9,27
Vienna,8709,6,7,5,12,26,40,-14,26
SC Rheindorf,8709,7,4,6,14,15,28,-13,18
FC Salzburg,8710,1,14,8,2,47,18,29,50
SK Sturm Gra,8710,2,13,4,7,35,28,7,43
Rapid Vienna,8710,3,8,11,5,36,26,10,35
LASK Linz,8710,4,10,5,9,32,31,1,35
Mattersburg,8710,5,7,5,12,34,48,-14,26
Vienna,8710,6,6,5,13,23,42,-19,23
SC Rheindorf,8710,7,4,6,14,21,35,-14,18
FC Salzburg,8711,1,14,8,2,46,19,27,50
SK Sturm Gra,8711,2,11,4,9,33,32,1,37
Rapid Vienna,8711,3,9,9,6,37,31,6,36
LASK Linz,8711,4,9,5,10,28,32,-4,32
Mattersburg,8711,5,8,5,11,32,39,-7,29
Vienna,8711,6,6,6,12,26,41,-15,24
SC Rheindorf,8711,7,6,5,13,22,30,-8,23
FC Salzburg,8712,1,13,8,3,43,20,23,47
SK Sturm Gra,8712,2,12,4,8,33,31,2,40
Rapid Vienna,8712,3,8,12,4,35,26,9,36
LASK Linz,8712,4,8,7,9,25,27,-2,31
Mattersburg,8712,5,6,7,11,31,41,-10,25
Vienna,8712,6,6,6,12,23,38,-15,24
SC Rheindorf,8712,7,5,8,11,23,30,-7,23
FC Salzburg,8713,1,14,7,3,46,22,24,49
SK Sturm Gra,8713,2,12,4,8,33,31,2,40
Rapid Vienna,8713,3,8,10,6,39,32,7,34
LASK Linz,8713,4,8,6,10,29,30,-1,30
Vienna,8713,5,7,6,11,30,43,-13,27
Mattersburg,8713,6,6,7,11,32,42,-10,25
SC Rheindorf,8713,7,6,6,12,21,30,-9,24
FC Salzburg,8714,1,16,6,2,48,19,29,54
SK Sturm Gra,8714,2,12,3,9,32,31,1,39
Rapid Vienna,8714,3,7,11,6,35,32,3,32
LASK Linz,8714,4,8,6,10,28,29,-1,30
Mattersburg,8714,5,7,5,12,32,40,-8,26
Vienna,8714,6,7,5,12,26,41,-15,26
SC Rheindorf,8714,7,6,6,12,23,32,-9,24
FC Salzburg,8715,1,14,7,3,46,21,25,49
SK Sturm Gra,8715,2,12,6,6,33,28,5,42
Rapid Vienna,8715,3,9,11,4,39,27,12,38
LASK Linz,8715,4,8,7,9,26,28,-2,31
Mattersburg,8715,5,8,5,11,36,41,-5,29
Vienna,8715,6,6,5,13,23,40,-17,23
SC Rheindorf,8715,7,4,5,15,17,35,-18,17
FC Salzburg,8716,1,14,7,3,47,22,25,49
SK Sturm Gra,8716,2,12,3,9,30,28,2,39
Rapid Vienna,8716,3,8,11,5,35,27,8,35
LASK Linz,8716,4,10,5,9,27,26,1,35
Vienna,8716,5,7,6,11,28,39,-11,27
Mattersburg,8716,6,6,6,12,33,47,-14,24
SC Rheindorf,8716,7,5,6,13,19,30,-11,21
FC Salzburg,8717,1,14,7,3,43,17,26,49
SK Sturm Gra,8717,2,14,3,7,33,26,7,45
Rapid Vienna,8717,3,8,10,6,35,28,7,34
LASK Linz,8717,4,8,6,10,26,31,-5,30
Mattersburg,8717,5,7,7,10,33,39,-6,28
Vienna,8717,6,6,6,12,24,41,-17,24
SC Rheindorf,8717,7,4,7,13,18,30,-12,19
FC Salzburg,8718,1,13,7,4,41,19,22,46
SK Sturm Gra,8718,2,14,3,7,34,27,7,45
Rapid Vienna,8718,3,9,10,5,36,27,9,37
LASK Linz,8718,4,8,5,11,26,31,-5,29
Vienna,8718,5,7,6,11,27,38,-11,27
Mattersburg,8718,6,7,5,12,34,43,-9,26
SC Rheindorf,8718,7,5,6,13,17,30,-13,21
FC Salzburg,8719,1,13,8,3,43,20,23,47
SK Sturm Gra,8719,2,12,4,8,33,29,4,40
Rapid Vienna,8719,3,8,10,6,38,33,5,34
Mattersburg,8719,4,8,5,11,33,38,-5,29
LASK Linz,8719,5,8,5,11,26,31,-5,29
Vienna,8719,6,7,6,11,26,38,-12,27
SC Rheindorf,8719,7,6,6,12,20,30,-10,24
FC Salzburg,8720,1,14,7,3,46,18,28,49
SK Sturm Gra,8720,2,11,5,8,32,35,-3,38
Rapid Vienna,8720,3,8,11,5,37,30,7,35
LASK Linz,8720,4,8,7,9,27,27,0,31
Mattersburg,8720,5,8,5,11,31,39,-8,29
Vienna,8720,6,7,5,12,25,40,-15,26
SC Rheindorf,8720,7,5,6,13,22,31,-9,21
FC Salzburg,8721,1,15,7,2,48,19,29,52
SK Sturm Gra,8721,2,13,4,7,31,28,3,43
LASK Linz,8721,3,9,6,9,30,27,3,33
Rapid Vienna,8721,4,7,11,6,34,29,5,32
Vienna,8721,5,7,5,12,27,40,-13,26
SC Rheindorf,8721,6,5,7,12,18,28,-10,22
Mattersburg,8721,7,5,6,13,31,48,-17,21
FC Salzburg,8722,1,13,8,3,45,19,26,47
SK Sturm Gra,8722,2,14,4,6,35,26,9,46
Rapid Vienna,8722,3,7,11,6,35,29,6,32
LASK Linz,8722,4,8,7,9,27,28,-1,31
Mattersburg,8722,5,8,5,11,34,41,-7,29
Vienna,8722,6,6,6,12,26,41,-15,24
SC Rheindorf,8722,7,4,7,13,17,35,-18,19
FC Salzburg,8723,1,15,7,2,50,16,34,52
SK Sturm Gra,8723,2,11,6,7,30,31,-1,39
Rapid Vienna,8723,3,7,11,6,35,31,4,32
LASK Linz,8723,4,8,7,9,28,29,-1,31
Mattersburg,8723,5,7,6,11,32,39,-7,27
Vienna,8723,6,7,5,12,25,42,-17,26
SC Rheindorf,8723,7,4,8,12,18,30,-12,20
FC Salzburg,8724,1,13,9,2,43,19,24,48
SK Sturm Gra,8724,2,13,4,7,32,26,6,43
LASK Linz,8724,3,9,6,9,26,25,1,33
Rapid Vienna,8724,4,7,9,8,34,31,3,30
SC Rheindorf,8724,5,7,6,11,20,27,-7,27
Vienna,8724,6,6,7,11,27,41,-14,25
Mattersburg,8724,7,5,7,12,30,43,-13,22
FC Salzburg,8725,1,12,9,3,39,18,21,45
SK Sturm Gra,8725,2,11,6,7,29,26,3,39
Rapid Vienna,8725,3,9,11,4,36,25,11,38
LASK Linz,8725,4,8,7,9,26,27,-1,31
Vienna,8725,5,8,5,11,28,37,-9,29
SC Rheindorf,8725,6,6,6,12,19,29,-10,24
Mattersburg,8725,7,5,6,13,26,41,-15,21
FC Salzburg,8726,1,14,7,3,43,19,24,49
SK Sturm Gra,8726,2,13,4,7,34,29,5,43
Rapid Vienna,8726,3,7,12,5,33,26,7,33
LASK Linz,8726,4,8,6,10,27,29,-2,30
Vienna,8726,5,7,5,12,27,38,-11,26
Mattersburg,8726,6,6,7,11,30,43,-13,25
SC Rheindorf,8726,7,5,7,12,21,31,-10,22
FC Salzburg,8727,1,13,7,4,41,21,20,46
SK Sturm Gra,8727,2,12,3,9,32,31,1,39
Rapid Vienna,8727,3,9,10,5,35,27,8,37
LASK Linz,8727,4,8,6,10,27,29,-2,30
Mattersburg,8727,5,7,6,11,34,41,-7,27
SC Rheindorf,8727,6,7,5,12,20,26,-6,26
Vienna,8727,7,7,5,12,27,41,-14,26
FC Salzburg,8728,1,14,7,3,51,20,31,49
SK Sturm Gra,8728,2,12,5,7,33,34,-1,41
Rapid Vienna,8728,3,8,12,4,40,27,13,36
LASK Linz,8728,4,7,7,10,26,33,-7,28
Mattersburg,8728,5,6,7,11,32,46,-14,25
Vienna,8728,6,6,6,12,27,45,-18,24
SC Rheindorf,8728,7,5,8,11,25,29,-4,23
FC Salzburg,8729,1,15,6,3,43,16,27,51
SK Sturm Gra,8729,2,15,3,6,34,25,9,48
Rapid Vienna,8729,3,8,10,6,33,27,6,34
LASK Linz,8729,4,8,7,9,28,29,-1,31
Mattersburg,8729,5,6,5,13,31,44,-13,23
Vienna,8729,6,6,5,13,23,41,-18,23
SC Rheindorf,8729,7,5,6,13,22,32,-10,21
FC Salzburg,8730,1,16,6,2,49,16,33,54
SK Sturm Gra,8730,2,13,4,7,30,29,1,43
Rapid Vienna,8730,3,8,9,7,32,28,4,33
LASK Linz,8730,4,9,5,10,27,29,-2,32
Vienna,8730,5,7,5,12,25,40,-15,26
Mattersburg,8730,6,6,5,13,31,43,-12,23
SC Rheindorf,8730,7,5,6,13,19,28,-9,21
FC Salzburg,8731,1,14,7,3,44,17,27,49
SK Sturm Gra,8731,2,12,5,7,33,28,5,41
Rapid Vienna,8731,3,8,12,4,35,26,9,36
LASK Linz,8731,4,8,6,10,30,33,-3,30
Mattersburg,8731,5,8,5,11,33,42,-9,29
Vienna,8731,6,7,5,12,25,39,-14,26
SC Rheindorf,8731,7,4,6,14,18,33,-15,18
FC Salzburg,8732,1,14,7,3,46,20,26,49
SK Sturm Gra,8732,2,13,5,6,36,28,8,44
Rapid Vienna,8732,3,8,9,7,34,29,5,33
LASK Linz,8732,4,9,6,9,29,30,-1,33
Vienna,8732,5,7,6,11,26,38,-12,27
Mattersburg,8732,6,6,7,11,28,40,-12,25
SC Rheindorf,8732,7,4,6,14,19,33,-14,18
FC Salzburg,8733,1,13,7,4,41,18,23,46
SK Sturm Gra,8733,2,13,4,7,36,27,9,43
Rapid Vienna,8733,3,10,10,4,38,26,12,40
LASK Linz,8733,4,8,6,10,26,33,-7,30
Mattersburg,8733,5,7,5,12,31,43,-12,26
Vienna,8733,6,7,5,12,26,39,-13,26
SC Rheindorf,8733,7,5,5,14,21,33,-12,20
FC Salzburg,8734,1,14,6,4,45,21,24,48
SK Sturm Gra,8734,2,13,3,8,33,29,4,42
Rapid Vienna,8734,3,9,10,5,38,27,11,37
LASK Linz,8734,4,9,6,9,30,30,0,33
Mattersburg,8734,5,6,6,12,31,46,-15,24
Vienna,8734,6,6,6,12,24,40,-16,24
SC Rheindorf,8734,7,6,5,13,22,30,-8,23
FC Salzburg,8735,1,15,6,3,46,17,29,51
Rapid Vienna,8735,2,10,9,5,34,24,10,39
SK Sturm Gra,8735,3,11,4,9,30,30,0,37
LASK Linz,8735,4,9,6,9,27,27,0,33
Mattersburg,8735,5,7,6,11,30,41,-11,27
Vienna,8735,6,6,5,13,24,41,-17,23
SC Rheindorf,8735,7,4,8,12,17,28,-11,20
FC Salzburg,8736,1,14,6,4,42,19,23,48
SK Sturm Gra,8736,2,12,4,8,32,31,1,40
Rapid Vienna,8736,3,10,9,5,39,27,12,39
LASK Linz,8736,4,7,8,9,25,28,-3,29
Vienna,8736,5,7,5,12,25,39,-14,26
SC Rheindorf,8736,6,6,6,12,24,29,-5,24
Mattersburg,8736,7,6,6,12,30,44,-14,24
FC Salzburg,8737,1,15,7,2,48,21,27,52
SK Sturm Gra,8737,2,12,4,8,31,29,2,40
LASK Linz,8737,3,9,5,10,28,29,-1,32
Rapid Vienna,8737,4,7,10,7,34,31,3,31
Mattersburg,8737,5,8,6,10,34,41,-7,30
SC Rheindorf,8737,6,6,5,13,23,31,-8,23
Vienna,8737,7,6,5,13,25,41,-16,23
FC Salzburg,8738,1,13,8,3,45,21,24,47
SK Sturm Gra,8738,2,14,3,7,35,31,4,45
Rapid Vienna,8738,3,9,11,4,39,26,13,38
LASK Linz,8738,4,7,8,9,23,25,-2,29
Vienna,8738,5,7,5,12,25,40,-15,26
Mattersburg,8738,6,6,7,11,32,41,-9,25
SC Rheindorf,8738,7,4,6,14,18,33,-15,18
FC Salzburg,8739,1,14,6,4,45,22,23,48
SK Sturm Gra,8739,2,13,3,8,35,32,3,42
Rapid Vienna,8739,3,10,9,5,36,26,10,39
LASK Linz,8739,4,8,5,11,28,30,-2,29
Mattersburg,8739,5,7,5,12,31,42,-11,26
Vienna,8739,6,7,5,12,26,40,-14,26
SC Rheindorf,8739,7,6,5,13,21,30,-9,23
FC Salzburg,8740,1,15,6,3,43,18,25,51
SK Sturm Gra,8740,2,12,3,9,33,31,2,39
Rapid Vienna,8740,3,8,10,6,34,28,6,34
LASK Linz,8740,4,9,7,8,29,27,2,34
SC Rheindorf,8740,5,6,6,12,22,30,-8,24
Mattersburg,8740,6,6,6,12,31,43,-12,24
Vienna,8740,7,6,6,12,25,40,-15,24
FC Salzburg,8741,1,15,7,2,48,17,31,52
SK Sturm Gra,8741,2,12,4,8,36,35,1,40
LASK Linz,8741,3,9,6,9,32,30,2,33
Rapid Vienna,8741,4,7,9,8,35,37,-2,30
Vienna,8741,5,7,6,11,25,38,-13,27
SC Rheindorf,8741,6,7,5,12,25,29,-4,26
Mattersburg,8741,7,6,5,13,30,45,-15,23
FC Salzburg,8742,1,15,6,3,46,18,28,51
Rapid Vienna,8742,2,11,9,4,39,26,13,42
SK Sturm Gra,8742,3,13,3,8,34,30,4,42
LASK Linz,8742,4,8,6,10,28,29,-1,30
Vienna,8742,5,6,6,12,25,40,-15,24
Mattersburg,8742,6,5,7,12,29,45,-16,22
SC Rheindorf,8742,7,4,7,13,17,30,-13,19
FC Salzburg,8743,1,13,6,5,43,22,21,45
Rapid Vienna,8743,2,10,10,4,38,25,13,40
SK Sturm Gra,8743,3,12,3,9,32,31,1,39
LASK Linz,8743,4,10,5,9,31,30,1,35
Vienna,8743,5,7,6,11,26,39,-13,27
SC Rheindorf,8743,6,6,6,12,21,29,-8,24
Mattersburg,8743,7,5,6,13,31,46,-15,21
FC Salzburg,8744,1,12,9,3,44,22,22,45
SK Sturm Gra,8744,2,13,5,6,37,29,8,44
Rapid Vienna,8744,3,7,12,5,35,29,6,33
LASK Linz,8744,4,9,5,10,29,27,2,32
Mattersburg,8744,5,8,6,10,32,39,-7,30
Vienna,8744,6,6,7,11,27,41,-14,25
SC Rheindorf,8744,7,4,6,14,18,35,-17,18
FC Salzburg,8745,1,15,7,2,46,16,30,52
SK Sturm Gra,8745,2,13,4,7,32,27,5,43
Rapid Vienna,8745,3,8,9,7,34,33,1,33
LASK Linz,8745,4,8,5,11,28,29,-1,29
Mattersburg,8745,5,8,5,11,30,38,-8,29
SC Rheindorf,8745,6,6,5,13,18,28,-10,23
Vienna,8745,7,6,5,13,23,40,-17,23
FC Salzburg,8746,1,14,7,3,47,21,26,49
SK Sturm Gra,8746,2,14,4,6,34,27,7,46
Rapid Vienna,8746,3,8,9,7,37,29,8,33
LASK Linz,8746,4,8,5,11,24,27,-3,29
Mattersburg,8746,5,7,5,12,32,45,-13,26
Vienna,8746,6,7,5,12,26,41,-15,26
SC Rheindorf,8746,7,6,5,13,23,33,-10,23
FC Salzburg,8747,1,14,7,3,46,18,28,49
SK Sturm Gra,8747,2,12,4,8,31,29,2,40
Rapid Vienna,8747,3,8,11,5,35,27,8,35
LASK Linz,8747,4,9,6,9,27,27,0,33
SC Rheindorf,8747,5,7,5,12,19,27,-8,26
Vienna,8747,6,6,7,11,25,39,-14,25
Mattersburg,8747,7,5,6,13,28,44,-16,21
FC Salzburg,8748,1,15,7,2,46,17,29,52
SK Sturm Gra,8748,2,13,3,8,35,29,6,42
Rapid Vienna,8748,3,9,10,5,37,28,9,37
LASK Linz,8748,4,7,6,11,25,32,-7,27
Mattersburg,8748,5,6,7,11,34,43,-9,25
Vienna,8748,6,6,7,11,26,40,-14,25
SC Rheindorf,8748,7,5,6,13,18,32,-14,21
FC Salzburg,8749,1,14,7,3,44,22,22,49
Rapid Vienna,8749,2,11,9,4,41,24,17,42
SK Sturm Gra,8749,3,12,4,8,30,30,0,40
LASK Linz,8749,4,8,5,11,25,31,-6,29
Vienna,8749,5,7,5,12,27,39,-12,26
SC Rheindorf,8749,6,6,5,13,19,28,-9,23
Mattersburg,8749,7,6,5,13,33,45,-12,23
FC Salzburg,8750,1,14,8,2,44,16,28,50
SK Sturm Gra,8750,2,12,4,8,30,28,2,40
Rapid Vienna,8750,3,8,10,6,33,28,5,34
LASK Linz,8750,4,8,6,10,27,29,-2,30
SC Rheindorf,8750,5,7,5,12,20,26,-6,26
Mattersburg,8750,6,7,5,12,34,44,-10,26
Vienna,8750,7,6,6,12,25,42,-17,24
FC Salzburg,8751,1,15,6,3,46,20,26,51
SK Sturm Gra,8751,2,12,5,7,32,28,4,41
Rapid Vienna,8751,3,8,10,6,38,31,7,34
LASK Linz,8751,4,8,6,10,27,30,-3,30
Mattersburg,8751,5,7,5,12,31,41,-10,26
Vienna,8751,6,7,5,12,24,39,-15,26
SC Rheindorf,8751,7,5,7,12,18,27,-9,22
FC Salzburg,8752,1,14,6,4,41,22,19,48
SK Sturm Gra,8752,2,12,3,9,30,29,1,39
Rapid Vienna,8752,3,9,10,5,35,25,10,37
LASK Linz,8752,4,8,6,10,26,29,-3,30
Vienna,8752,5,8,5,11,32,38,-6,29
SC Rheindorf,8752,6,6,6,12,20,29,-9,24
Mattersburg,8752,7,6,6,12,31,43,-12,24
FC Salzburg,8753,1,14,7,3,45,20,25,49
SK Sturm Gra,8753,2,12,4,8,33,30,3,40
Rapid Vienna,8753,3,9,9,6,36,28,8,36
LASK Linz,8753,4,9,7,8,27,25,2,34
Vienna,8753,5,7,6,11,26,39,-13,27
Mattersburg,8753,6,6,6,12,33,44,-11,24
SC Rheindorf,8753,7,5,5,14,18,32,-14,20
FC Salzburg,8754,1,14,7,3,44,19,25,49
SK Sturm Gra,8754,2,12,6,6,35,29,6,42
Rapid Vienna,8754,3,8,11,5,40,30,10,35
LASK Linz,8754,4,7,7,10,27,32,-5,28
Vienna,8754,5,6,7,11,24,38,-14,25
SC Rheindorf,8754,6,6,6,12,22,29,-7,24
Mattersburg,8754,7,6,6,12,28,43,-15,24
FC Salzburg,8755,1,15,6,3,47,18,29,51
SK Sturm Gra,8755,2,13,5,6,34,27,7,44
Rapid Vienna,8755,3,8,9,7,35,32,3,33
LASK Linz,8755,4,8,7,9,27,28,-1,31
SC Rheindorf,8755,5,6,6,12,19,28,-9,24
Mattersburg,8755,6,6,6,12,29,41,-12,24
Vienna,8755,7,6,5,13,24,41,-17,23
FC Salzburg,8756,1,14,8,2,47,18,29,50
SK Sturm Gra,8756,2,12,5,7,33,32,1,41
Rapid Vienna,8756,3,8,11,5,34,29,5,35
LASK Linz,8756,4,9,6,9,30,26,4,33
Vienna,8756,5,6,7,11,24,38,-14,25
SC Rheindorf,8756,6,6,5,13,19,29,-10,23
Mattersburg,8756,7,5,6,13,27,42,-15,21
FC Salzburg,8757,1,16,6,2,48,17,31,54
SK Sturm Gra,8757,2,13,4,7,37,33,4,43
LASK Linz,8757,3,9,7,8,33,29,4,34
Rapid Vienna,8757,4,7,9,8,32,30,2,30
Mattersburg,8757,5,6,6,12,33,45,-12,24
Vienna,8757,6,6,5,13,24,42,-18,23
SC Rheindorf,8757,7,5,7,12,20,31,-11,22
FC Salzburg,8758,1,13,6,5,44,23,21,45
SK Sturm Gra,8758,2,14,3,7,31,26,5,45
Rapid Vienna,8758,3,10,9,5,38,26,12,39
LASK Linz,8758,4,8,6,10,25,27,-2,30
Vienna,8758,5,8,5,11,28,39,-11,29
Mattersburg,8758,6,6,5,13,30,43,-13,23
SC Rheindorf,8758,7,5,6,13,18,30,-12,21
FC Salzburg,8759,1,15,6,3,46,20,26,51
SK Sturm Gra,8759,2,14,4,6,36,26,10,46
Rapid Vienna,8759,3,8,10,6,36,32,4,34
LASK Linz,8759,4,8,7,9,26,27,-1,31
Vienna,8759,5,7,5,12,24,39,-15,26
SC Rheindorf,8759,6,6,5,13,23,32,-9,23
Mattersburg,8759,7,5,5,14,29,44,-15,20
FC Salzburg,8760,1,14,8,2,44,17,27,50
SK Sturm Gra,8760,2,14,3,7,39,29,10,45
Rapid Vienna,8760,3,8,10,6,37,29,8,34
LASK Linz,8760,4,8,5,11,27,31,-4,29
Vienna,8760,5,6,7,11,25,39,-14,25
Mattersburg,8760,6,6,6,12,28,42,-14,24
SC Rheindorf,8760,7,6,5,13,21,34,-13,23
FC Salzburg,8761,1,15,7,2,45,16,29,52
SK Sturm Gra,8761,2,11,5,8,31,30,1,38
LASK Linz,8761,3,10,6,8,32,28,4,36
Rapid Vienna,8761,4,8,11,5,37,29,8,35
Mattersburg,8761,5,6,7,11,32,44,-12,25
Vienna,8761,6,6,6,12,25,41,-16,24
SC Rheindorf,8761,7,4,6,14,19,33,-14,18
FC Salzburg,8762,1,15,6,3,44,20,24,51
SK Sturm Gra,8762,2,12,4,8,36,31,5,40
Rapid Vienna,8762,3,9,10,5,37,26,11,37
LASK Linz,8762,4,9,6,9,27,27,0,33
Vienna,8762,5,7,6,11,27,39,-12,27
Mattersburg,8762,6,5,6,13,29,42,-13,21
SC Rheindorf,8762,7,5,6,13,19,34,-15,21
FC Salzburg,8763,1,15,6,3,48,21,27,51
SK Sturm Gra,8763,2,12,5,7,33,28,5,41
Rapid Vienna,8763,3,10,10,4,41,26,15,40
LASK Linz,8763,4,7,6,11,27,32,-5,27
Mattersburg,8763,5,7,5,12,32,46,-14,26
SC Rheindorf,8763,6,6,5,13,18,30,-12,23
Vienna,8763,7,6,5,13,27,43,-16,23
FC Salzburg,8764,1,15,7,2,43,16,27,52
SK Sturm Gra,8764,2,13,3,8,33,32,1,42
LASK Linz,8764,3,9,6,9,34,29,5,33
Rapid Vienna,8764,4,7,11,6,33,29,4,32
Mattersburg,8764,5,6,7,11,31,40,-9,25
Vienna,8764,6,6,5,13,24,41,-17,23
SC Rheindorf,8764,7,5,7,12,19,30,-11,22
FC Salzburg,8765,1,14,7,3,43,19,24,49
SK Sturm Gra,8765,2,13,4,7,32,27,5,43
Rapid Vienna,8765,3,9,9,6,36,27,9,36
LASK Linz,8765,4,8,6,10,25,28,-3,30
Mattersburg,8765,5,7,5,12,33,43,-10,26
Vienna,8765,6,6,6,12,26,41,-15,24
SC Rheindorf,8765,7,6,5,13,19,29,-10,23
FC Salzburg,8766,1,12,7,5,41,25,16,43
SK Sturm Gra,8766,2,12,4,8,34,31,3,40
Rapid Vienna,8766,3,9,10,5,35,26,9,37
Mattersburg,8766,4,9,5,10,37,37,0,32
LASK Linz,8766,5,8,7,9,26,29,-3,31
Vienna,8766,6,6,6,12,24,41,-17,24
SC Rheindorf,8766,7,5,7,12,20,28,-8,22
FC Salzburg,8767,1,16,6,2,47,17,30,54
SK Sturm Gra,8767,2,13,4,7,34,30,4,43
Rapid Vienna,8767,3,7,10,7,35,32,3,31
LASK Linz,8767,4,8,7,9,30,32,-2,31
Mattersburg,8767,5,7,5,12,31,40,-9,26
Vienna,8767,6,7,5,12,25,39,-14,26
SC Rheindorf,8767,7,4,7,13,18,30,-12,19
FC Salzburg,8768,1,13,7,4,44,24,20,46
SK Sturm Gra,8768,2,13,5,6,35,27,8,44
Rapid Vienna,8768,3,9,9,6,36,27,9,36
LASK Linz,8768,4,9,5,10,27,31,-4,32
Mattersburg,8768,5,7,6,11,35,41,-6,27
Vienna,8768,6,6,5,13,24,43,-19,23
SC Rheindorf,8768,7,5,7,12,21,29,-8,22
FC Salzburg,8769,1,14,7,3,46,22,24,49
Rapid Vienna,8769,2,10,9,5,36,28,8,39
SK Sturm Gra,8769,3,12,3,9,33,29,4,39
Mattersburg,8769,4,8,6,10,40,42,-2,30
LASK Linz,8769,5,8,6,10,30,35,-5,30
Vienna,8769,6,6,5,13,27,44,-17,23
SC Rheindorf,8769,7,5,6,13,20,32,-12,21
FC Salzburg,8770,1,16,6,2,46,18,28,54
SK Sturm Gra,8770,2,13,3,8,34,29,5,42
LASK Linz,8770,3,10,6,8,30,27,3,36
Rapid Vienna,8770,4,8,9,7,33,29,4,33
Mattersburg,8770,5,7,5,12,32,41,-9,26
Vienna,8770,6,6,5,13,25,43,-18,23
SC Rheindorf,8770,7,4,6,14,16,29,-13,18
FC Salzburg,8771,1,13,7,4,43,20,23,46
SK Sturm Gra,8771,2,13,4,7,36,27,9,43
LASK Linz,8771,3,10,5,9,29,28,1,35
Rapid Vienna,8771,4,8,10,6,35,31,4,34
Mattersburg,8771,5,7,5,12,31,42,-11,26
Vienna,8771,6,7,5,12,24,38,-14,26
SC Rheindorf,8771,7,5,6,13,19,31,-12,21
FC Salzburg,8772,1,16,6,2,49,18,31,54
SK Sturm Gra,8772,2,12,4,8,30,26,4,40
LASK Linz,8772,3,10,6,8,28,25,3,36
Rapid Vienna,8772,4,7,11,6,33,28,5,32
Vienna,8772,5,6,6,12,25,41,-16,24
Mattersburg,8772,6,5,7,12,32,46,-14,22
SC Rheindorf,8772,7,5,6,13,20,33,-13,21
FC Salzburg,8773,1,14,8,2,46,20,26,50
SK Sturm Gra,8773,2,12,6,6,33,27,6,42
Rapid Vienna,8773,3,7,11,6,34,30,4,32
LASK Linz,8773,4,8,7,9,29,30,-1,31
Vienna,8773,5,7,6,11,28,39,-11,27
SC Rheindorf,8773,6,6,7,11,19,27,-8,25
Mattersburg,8773,7,5,5,14,30,46,-16,20
FC Salzburg,8774,1,14,7,3,45,20,25,49
SK Sturm Gra,8774,2,12,5,7,29,25,4,41
Rapid Vienna,8774,3,10,10,4,37,25,12,40
LASK Linz,8774,4,8,6,10,27,29,-2,30
Mattersburg,8774,5,7,5,12,33,43,-10,26
Vienna,8774,6,6,5,13,26,44,-18,23
SC Rheindorf,8774,7,5,6,13,17,28,-11,21
FC Salzburg,8775,1,15,7,2,46,19,27,52
SK Sturm Gra,8775,2,11,4,9,30,30,0,37
Rapid Vienna,8775,3,9,9,6,38,31,7,36
LASK Linz,8775,4,8,5,11,27,29,-2,29
SC Rheindorf,8775,5,7,6,11,21,27,-6,27
Mattersburg,8775,6,6,7,11,32,42,-10,25
Vienna,8775,7,6,6,12,25,41,-16,24
FC Salzburg,8776,1,15,7,2,43,17,26,52
Rapid Vienna,8776,2,9,11,4,38,28,10,38
SK Sturm Gra,8776,3,11,5,8,29,27,2,38
LASK Linz,8776,4,7,7,10,28,33,-5,28
Vienna,8776,5,7,5,12,24,38,-14,26
Mattersburg,8776,6,6,6,12,31,40,-9,24
SC Rheindorf,8776,7,5,7,12,19,29,-10,22
FC Salzburg,8777,1,14,7,3,44,18,26,49
SK Sturm Gra,8777,2,12,4,8,32,28,4,40
Rapid Vienna,8777,3,9,10,5,37,29,8,37
LASK Linz,8777,4,7,9,8,27,28,-1,30
Mattersburg,8777,5,7,7,10,35,40,-5,28
Vienna,8777,6,6,5,13,24,44,-20,23
SC Rheindorf,8777,7,5,6,13,19,31,-12,21
FC Salzburg,8778,1,16,6,2,51,17,34,54
SK Sturm Gra,8778,2,14,3,7,35,26,9,45
Rapid Vienna,8778,3,8,10,6,35,30,5,34
LASK Linz,8778,4,7,7,10,28,34,-6,28
Mattersburg,8778,5,7,6,11,37,46,-9,27
Vienna,8778,6,6,5,13,25,45,-20,23
SC Rheindorf,8778,7,4,7,13,18,31,-13,19
FC Salzburg,8779,1,14,7,3,45,18,27,49
SK Sturm Gra,8779,2,13,3,8,34,31,3,42
Rapid Vienna,8779,3,10,9,5,37,26,11,39
LASK Linz,8779,4,9,5,10,28,30,-2,32
Vienna,8779,5,7,6,11,25,38,-13,27
SC Rheindorf,8779,6,5,6,13,20,31,-11,21
Mattersburg,8779,7,5,6,13,28,43,-15,21
FC Salzburg,8780,1,15,7,2,51,18,33,52
SK Sturm Gra,8780,2,13,4,7,34,27,7,43
LASK Linz,8780,3,9,5,10,27,30,-3,32
Rapid Vienna,8780,4,7,9,8,32,33,-1,30
Mattersburg,8780,5,6,7,11,32,42,-10,25
SC Rheindorf,8780,6,6,6,12,20,29,-9,24
Vienna,8780,7,6,6,12,26,43,-17,24
FC Salzburg,8781,1,14,7,3,46,20,26,49
SK Sturm Gra,8781,2,13,4,7,35,31,4,43
Rapid Vienna,8781,3,9,9,6,40,28,12,36
LASK Linz,8781,4,9,5,10,28,34,-6,32
Mattersburg,8781,5,7,5,12,32,41,-9,26
Vienna,8781,6,6,6,12,23,39,-16,24
SC Rheindorf,8781,7,5,6,13,21,32,-11,21
FC Salzburg,8782,1,13,8,3,44,22,22,47
SK Sturm Gra,8782,2,14,4,6,34,25,9,46
Rapid Vienna,8782,3,8,10,6,35,28,7,34
LASK Linz,8782,4,7,7,10,26,29,-3,28
Mattersburg,8782,5,7,6,11,36,45,-9,27
Vienna,8782,6,6,6,12,26,41,-15,24
SC Rheindorf,8782,7,6,5,13,18,29,-11,23
FC Salzburg,8783,1,13,7,4,41,19,22,46
SK Sturm Gra,8783,2,13,4,7,32,27,5,43
LASK Linz,8783,3,8,7,9,26,27,-1,31
Rapid Vienna,8783,4,7,9,8,34,31,3,30
Mattersburg,8783,5,8,5,11,32,38,-6,29
Vienna,8783,6,7,6,11,26,39,-13,27
SC Rheindorf,8783,7,6,6,12,18,28,-10,24
FC Salzburg,8784,1,13,8,3,41,18,23,47
SK Sturm Gra,8784,2,12,6,6,31,26,5,42
Rapid Vienna,8784,3,9,9,6,40,27,13,36
Mattersburg,8784,4,8,6,10,34,38,-4,30
LASK Linz,8784,5,8,6,10,24,28,-4,30
Vienna,8784,6,6,5,13,24,40,-16,23
SC Rheindorf,8784,7,5,6,13,19,36,-17,21
FC Salzburg,8785,1,14,8,2,42,17,25,50
Rapid Vienna,8785,2,9,10,5,36,27,9,37
SK Sturm Gra,8785,3,11,4,9,32,31,1,37
LASK Linz,8785,4,9,6,9,31,29,2,33
Vienna,8785,5,7,6,11,25,38,-13,27
SC Rheindorf,8785,6,6,5,13,19,29,-10,23
Mattersburg,8785,7,6,5,13,27,41,-14,23
FC Salzburg,8786,1,14,6,4,43,21,22,48
Rapid Vienna,8786,2,10,10,4,37,23,14,40
SK Sturm Gra,8786,3,12,3,9,31,30,1,39
Mattersburg,8786,4,8,5,11,34,42,-8,29
LASK Linz,8786,5,7,7,10,24,27,-3,28
Vienna,8786,6,7,5,12,25,40,-15,26
SC Rheindorf,8786,7,5,6,13,18,29,-11,21
FC Salzburg,8787,1,13,8,3,44,22,22,47
SK Sturm Gra,8787,2,12,5,7,33,29,4,41
Rapid Vienna,8787,3,9,9,6,35,28,7,36
LASK Linz,8787,4,9,6,9,31,30,1,33
Vienna,8787,5,8,5,11,28,38,-10,29
Mattersburg,8787,6,6,7,11,32,42,-10,25
SC Rheindorf,8787,7,4,6,14,16,30,-14,18
FC Salzburg,8788,1,14,7,3,41,17,24,49
SK Sturm Gra,8788,2,14,3,7,35,28,7,45
Rapid Vienna,8788,3,10,9,5,38,25,13,39
LASK Linz,8788,4,7,6,11,25,32,-7,27
Mattersburg,8788,5,6,8,10,30,38,-8,26
Vienna,8788,6,6,5,13,24,42,-18,23
SC Rheindorf,8788,7,5,6,13,20,31,-11,21
FC Salzburg,8789,1,14,8,2,45,19,26,50
SK Sturm Gra,8789,2,13,5,6,32,26,6,44
Rapid Vienna,8789,3,7,10,7,32,28,4,31
LASK Linz,8789,4,8,7,9,26,26,0,31
Mattersburg,8789,5,6,8,10,32,40,-8,26
Vienna,8789,6,6,6,12,24,40,-16,24
SC Rheindorf,8789,7,5,6,13,17,29,-12,21
FC Salzburg,8790,1,14,6,4,44,20,24,48
SK Sturm Gra,8790,2,12,6,6,33,28,5,42
Rapid Vienna,8790,3,8,10,6,39,31,8,34
LASK Linz,8790,4,9,7,8,35,32,3,34
Vienna,8790,5,7,5,12,26,39,-13,26
Mattersburg,8790,6,6,6,12,30,42,-12,24
SC Rheindorf,8790,7,4,8,12,19,34,-15,20
FC Salzburg,8791,1,15,6,3,43,18,25,51
SK Sturm Gra,8791,2,12,4,8,30,27,3,40
Rapid Vienna,8791,3,8,10,6,36,29,7,34
LASK Linz,8791,4,8,6,10,26,29,-3,30
Mattersburg,8791,5,7,5,12,30,40,-10,26
Vienna,8791,6,7,5,12,25,39,-14,26
SC Rheindorf,8791,7,5,8,11,22,30,-8,23
FC Salzburg,8792,1,15,7,2,50,20,30,52
SK Sturm Gra,8792,2,13,3,8,35,34,1,42
Rapid Vienna,8792,3,8,10,6,35,31,4,34
LASK Linz,8792,4,8,5,11,26,30,-4,29
SC Rheindorf,8792,5,7,5,12,26,28,-2,26
Mattersburg,8792,6,7,5,12,32,42,-10,26
Vienna,8792,7,6,5,13,24,43,-19,23
FC Salzburg,8793,1,14,7,3,45,22,23,49
SK Sturm Gra,8793,2,12,5,7,31,27,4,41
Rapid Vienna,8793,3,9,10,5,39,29,10,37
Vienna,8793,4,8,5,11,29,37,-8,29
LASK Linz,8793,5,7,6,11,25,32,-7,27
Mattersburg,8793,6,6,7,11,31,42,-11,25
SC Rheindorf,8793,7,5,6,13,18,29,-11,21
FC Salzburg,8794,1,15,6,3,45,20,25,51
Rapid Vienna,8794,2,11,9,4,39,25,14,42
SK Sturm Gra,8794,3,12,4,8,33,31,2,40
LASK Linz,8794,4,9,6,9,27,26,1,33
Mattersburg,8794,5,6,5,13,29,41,-12,23
Vienna,8794,6,6,5,13,24,41,-17,23
SC Rheindorf,8794,7,5,5,14,19,32,-13,20
FC Salzburg,8795,1,13,7,4,43,21,22,46
SK Sturm Gra,8795,2,14,4,6,35,26,9,46
Rapid Vienna,8795,3,8,11,5,38,29,9,35
LASK Linz,8795,4,8,6,10,29,33,-4,30
Vienna,8795,5,7,6,11,27,40,-13,27
SC Rheindorf,8795,6,5,7,12,21,30,-9,22
Mattersburg,8795,7,5,7,12,31,45,-14,22
FC Salzburg,8796,1,16,6,2,52,19,33,54
SK Sturm Gra,8796,2,13,4,7,34,30,4,43
Rapid Vienna,8796,3,8,10,6,35,30,5,34
LASK Linz,8796,4,8,6,10,28,30,-2,30
Mattersburg,8796,5,7,5,12,32,41,-9,26
Vienna,8796,6,7,5,12,25,42,-17,26
SC Rheindorf,8796,7,4,6,14,17,31,-14,18
FC Salzburg,8797,1,14,8,2,43,16,27,50
Rapid Vienna,8797,2,10,10,4,38,27,11,40
SK Sturm Gra,8797,3,11,4,9,32,32,0,37
LASK Linz,8797,4,8,5,11,27,30,-3,29
Mattersburg,8797,5,8,5,11,33,42,-9,29
Vienna,8797,6,6,6,12,25,40,-15,24
SC Rheindorf,8797,7,5,6,13,20,31,-11,21
FC Salzburg,8798,1,15,7,2,45,17,28,52
SK Sturm Gra,8798,2,13,4,7,34,27,7,43
Rapid Vienna,8798,3,9,9,6,34,29,5,36
LASK Linz,8798,4,9,5,10,27,28,-1,32
Mattersburg,8798,5,6,6,12,29,42,-13,24
Vienna,8798,6,6,5,13,23,40,-17,23
SC Rheindorf,8798,7,5,6,13,19,28,-9,21
FC Salzburg,8799,1,13,9,2,42,18,24,48
SK Sturm Gra,8799,2,13,4,7,30,26,4,43
Rapid Vienna,8799,3,7,11,6,33,27,6,32
LASK Linz,8799,4,7,8,9,27,29,-2,29
Vienna,8799,5,7,6,11,27,40,-13,27
SC Rheindorf,8799,6,6,7,11,21,28,-7,25
Mattersburg,8799,7,5,7,12,33,45,-12,22
FC Salzburg,8800,1,14,7,3,47,18,29,49
SK Sturm Gra,8800,2,13,3,8,31,31,0,42
Rapid Vienna,8800,3,7,12,5,33,26,7,33
LASK Linz,8800,4,8,7,9,27,27,0,31
Vienna,8800,5,8,5,11,26,38,-12,29
SC Rheindorf,8800,6,5,7,12,20,30,-10,22
Mattersburg,8800,7,5,7,12,31,45,-14,22
FC Salzburg,8801,1,15,6,3,42,16,26,51
SK Sturm Gra,8801,2,13,3,8,33,28,5,42
Rapid Vienna,8801,3,9,10,5,35,26,9,37
LASK Linz,8801,4,8,6,10,27,30,-3,30
Vienna,8801,5,7,5,12,24,39,-15,26
Mattersburg,8801,6,6,6,12,28,39,-11,24
SC Rheindorf,8801,7,5,6,13,16,27,-11,21
FC Salzburg,8802,1,14,6,4,49,21,28,48
SK Sturm Gra,8802,2,12,4,8,35,32,3,40
Rapid Vienna,8802,3,8,11,5,35,29,6,35
LASK Linz,8802,4,8,7,9,30,31,-1,31
SC Rheindorf,8802,5,7,6,11,22,27,-5,27
Vienna,8802,6,7,5,12,26,40,-14,26
Mattersburg,8802,7,5,7,12,28,45,-17,22
FC Salzburg,8803,1,16,6,2,48,16,32,54
SK Sturm Gra,8803,2,12,5,7,33,28,5,41
Rapid Vienna,8803,3,8,10,6,36,30,6,34
LASK Linz,8803,4,8,6,10,28,31,-3,30
Vienna,8803,5,7,5,12,26,40,-14,26
SC Rheindorf,8803,6,6,5,13,21,30,-9,23
Mattersburg,8803,7,6,5,13,29,46,-17,23
FC Salzburg,8804,1,14,8,2,43,16,27,50
SK Sturm Gra,8804,2,12,3,9,31,30,1,39
Rapid Vienna,8804,3,9,9,6,35,27,8,36
LASK Linz,8804,4,9,5,10,28,30,-2,32
Vienna,8804,5,7,6,11,26,39,-13,27
Mattersburg,8804,6,6,6,12,29,41,-12,24
SC Rheindorf,8804,7,6,5,13,21,30,-9,23
FC Salzburg,8805,1,14,6,4,44,20,24,48
Rapid Vienna,8805,2,10,10,4,40,26,14,40
SK Sturm Gra,8805,3,12,3,9,33,32,1,39
LASK Linz,8805,4,8,6,10,25,28,-3,30
Vienna,8805,5,8,5,11,28,39,-11,29
Mattersburg,8805,6,7,5,12,30,43,-13,26
SC Rheindorf,8805,7,4,7,13,17,29,-12,19
FC Salzburg,8806,1,14,8,2,43,17,26,50
SK Sturm Gra,8806,2,14,4,6,36,27,9,46
Rapid Vienna,8806,3,7,9,8,34,31,3,30
LASK Linz,8806,4,8,6,10,26,29,-3,30
Mattersburg,8806,5,7,6,11,32,42,-10,27
Vienna,8806,6,7,5,12,25,39,-14,26
SC Rheindorf,8806,7,5,6,13,22,33,-11,21
FC Salzburg,8807,1,14,7,3,45,19,26,49
Rapid Vienna,8807,2,9,10,5,38,28,10,37
SK Sturm Gra,8807,3,11,3,10,32,34,-2,36
LASK Linz,8807,4,9,7,8,27,26,1,34
Mattersburg,8807,5,6,8,10,29,38,-9,26
Vienna,8807,6,6,6,12,25,41,-16,24
SC Rheindorf,8807,7,5,7,12,21,31,-10,22
FC Salzburg,8808,1,14,7,3,43,18,25,49
SK Sturm Gra,8808,2,14,4,6,40,29,11,46
Rapid Vienna,8808,3,8,11,5,34,27,7,35
LASK Linz,8808,4,7,7,10,26,30,-4,28
Vienna,8808,5,6,6,12,24,39,-15,24
Mattersburg,8808,6,5,8,11,30,42,-12,23
SC Rheindorf,8808,7,5,7,12,22,34,-12,22
FC Salzburg,8809,1,12,9,3,43,21,22,45
SK Sturm Gra,8809,2,12,4,8,32,29,3,40
Rapid Vienna,8809,3,8,11,5,37,31,6,35
LASK Linz,8809,4,8,5,11,31,35,-4,29
Mattersburg,8809,5,8,5,11,32,39,-7,29
Vienna,8809,6,7,6,11,26,39,-13,27
SC Rheindorf,8809,7,6,6,12,20,27,-7,24
FC Salzburg,8810,1,14,7,3,44,19,25,49
SK Sturm Gra,8810,2,11,5,8,30,30,0,38
Rapid Vienna,8810,3,8,10,6,37,32,5,34
LASK Linz,8810,4,8,8,8,27,27,0,32
Vienna,8810,5,7,6,11,28,39,-11,27
Mattersburg,8810,6,5,9,10,28,38,-10,24
SC Rheindorf,8810,7,5,7,12,19,28,-9,22
FC Salzburg,8811,1,13,6,5,41,20,21,45
SK Sturm Gra,8811,2,12,5,7,35,31,4,41
Rapid Vienna,8811,3,10,9,5,37,25,12,39
LASK Linz,8811,4,8,7,9,28,30,-2,31
Vienna,8811,5,8,5,11,26,38,-12,29
SC Rheindorf,8811,6,6,6,12,23,30,-7,24
Mattersburg,8811,7,5,6,13,27,43,-16,21
FC Salzburg,8812,1,15,7,2,49,17,32,52
SK Sturm Gra,8812,2,12,5,7,33,30,3,41
LASK Linz,8812,3,9,6,9,30,31,-1,33
Rapid Vienna,8812,4,7,11,6,36,30,6,32
Vienna,8812,5,7,5,12,26,41,-15,26
Mattersburg,8812,6,6,5,13,32,46,-14,23
SC Rheindorf,8812,7,5,7,12,19,30,-11,22
FC Salzburg,8813,1,15,7,2,47,18,29,52
SK Sturm Gra,8813,2,12,3,9,32,31,1,39
Rapid Vienna,8813,3,9,10,5,38,28,10,37
LASK Linz,8813,4,9,5,10,31,32,-1,32
Vienna,8813,5,7,6,11,26,38,-12,27
SC Rheindorf,8813,6,5,7,12,21,31,-10,22
Mattersburg,8813,7,5,6,13,30,47,-17,21
FC Salzburg,8814,1,14,8,2,42,16,26,50
Rapid Vienna,8814,2,10,9,5,42,27,15,39
SK Sturm Gra,8814,3,12,3,9,33,31,2,39
LASK Linz,8814,4,8,5,11,28,32,-4,29
Vienna,8814,5,7,6,11,25,38,-13,27
Mattersburg,8814,6,6,6,12,32,42,-10,24
SC Rheindorf,8814,7,6,5,13,20,36,-16,23
FC Salzburg,8815,1,15,7,2,46,17,29,52
SK Sturm Gra,8815,2,12,6,6,31,25,6,42
LASK Linz,8815,3,9,7,8,27,26,1,34
Rapid Vienna,8815,4,7,9,8,31,29,2,30
Vienna,8815,5,7,5,12,28,41,-13,26
Mattersburg,8815,6,6,5,13,32,47,-15,23
SC Rheindorf,8815,7,5,7,12,17,27,-10,22
FC Salzburg,8816,1,12,6,6,39,22,17,42
SK Sturm Gra,8816,2,13,3,8,36,29,7,42
Rapid Vienna,8816,3,9,10,5,35,26,9,37
LASK Linz,8816,4,10,6,8,28,26,2,36
Vienna,8816,5,8,5,11,27,38,-11,29
Mattersburg,8816,6,7,5,12,31,40,-9,26
SC Rheindorf,8816,7,5,5,14,18,33,-15,20
FC Salzburg,8817,1,14,6,4,49,22,27,48
Rapid Vienna,8817,2,10,9,5,37,28,9,39
SK Sturm Gra,8817,3,11,4,9,29,30,-1,37
LASK Linz,8817,4,9,6,9,26,27,-1,33
Vienna,8817,5,8,5,11,28,39,-11,29
SC Rheindorf,8817,6,6,5,13,23,32,-9,23
Mattersburg,8817,7,6,5,13,31,45,-14,23
SK Sturm Gra,8818,1,14,4,6,34,26,8,46
FC Salzburg,8818,2,12,8,4,39,18,21,44
Rapid Vienna,8818,3,8,10,6,32,26,6,34
LASK Linz,8818,4,8,6,10,25,29,-4,30
Mattersburg,8818,5,8,6,10,35,40,-5,30
Vienna,8818,6,6,6,12,24,39,-15,24
SC Rheindorf,8818,7,5,6,13,21,32,-11,21
FC Salzburg,8819,1,15,6,3,48,18,30,51
SK Sturm Gra,8819,2,12,5,7,30,25,5,41
Rapid Vienna,8819,3,8,9,7,35,32,3,33
LASK Linz,8819,4,7,7,10,26,31,-5,28
Vienna,8819,5,7,6,11,28,41,-13,27
SC Rheindorf,8819,6,6,7,11,19,27,-8,25
Mattersburg,8819,7,6,6,12,31,43,-12,24
FC Salzburg,8820,1,14,7,3,47,21,26,49
SK Sturm Gra,8820,2,12,4,8,32,29,3,40
Rapid Vienna,8820,3,9,10,5,39,29,10,37
LASK Linz,8820,4,8,7,9,29,30,-1,31
SC Rheindorf,8820,5,7,5,12,24,33,-9,26
Vienna,8820,6,6,6,12,26,42,-16,24
Mattersburg,8820,7,5,7,12,31,44,-13,22
FC Salzburg,8821,1,15,6,3,44,17,27,51
SK Sturm Gra,8821,2,14,3,7,35,27,8,45
Rapid Vienna,8821,3,8,9,7,34,31,3,33
LASK Linz,8821,4,8,7,9,28,28,0,31
Mattersburg,8821,5,7,6,11,30,39,-9,27
Vienna,8821,6,6,5,13,23,40,-17,23
SC Rheindorf,8821,7,5,6,13,21,33,-12,21
FC Salzburg,8822,1,13,6,5,44,24,20,45
SK Sturm Gra,8822,2,12,4,8,35,32,3,40
Rapid Vienna,8822,3,9,11,4,35,25,10,38
LASK Linz,8822,4,9,7,8,32,31,1,34
Vienna,8822,5,8,5,11,30,38,-8,29
Mattersburg,8822,6,6,6,12,33,46,-13,24
SC Rheindorf,8822,7,4,7,13,17,30,-13,19
FC Salzburg,8823,1,15,7,2,47,18,29,52
Rapid Vienna,8823,2,10,10,4,39,26,13,40
SK Sturm Gra,8823,3,11,5,8,33,33,0,38
Mattersburg,8823,4,8,5,11,36,43,-7,29
LASK Linz,8823,5,7,7,10,25,30,-5,28
Vienna,8823,6,6,5,13,26,43,-17,23
SC Rheindorf,8823,7,4,7,13,18,31,-13,19
FC Salzburg,8824,1,13,8,3,45,21,24,47
SK Sturm Gra,8824,2,12,4,8,33,30,3,40
Rapid Vienna,8824,3,8,12,4,39,30,9,36
LASK Linz,8824,4,9,6,9,30,30,0,33
Vienna,8824,5,7,6,11,29,41,-12,27
SC Rheindorf,8824,6,5,8,11,19,27,-8,23
Mattersburg,8824,7,5,6,13,28,44,-16,21
FC Salzburg,8825,1,13,8,3,45,22,23,47
SK Sturm Gra,8825,2,12,4,8,32,31,1,40
Rapid Vienna,8825,3,9,10,5,38,26,12,37
LASK Linz,8825,4,8,6,10,27,29,-2,30
Mattersburg,8825,5,6,8,10,33,42,-9,26
Vienna,8825,6,6,7,11,30,44,-14,25
SC Rheindorf,8825,7,5,7,12,17,28,-11,22
FC Salzburg,8826,1,14,8,2,45,19,26,50
SK Sturm Gra,8826,2,13,4,7,33,27,6,43
Rapid Vienna,8826,3,9,9,6,36,26,10,36
LASK Linz,8826,4,8,5,11,27,29,-2,29
Vienna,8826,5,7,6,11,29,38,-9,27
SC Rheindorf,8826,6,6,5,13,18,31,-13,23
Mattersburg,8826,7,6,5,13,30,48,-18,23
FC Salzburg,8827,1,14,8,2,44,18,26,50
SK Sturm Gra,8827,2,13,4,7,33,28,5,43
LASK Linz,8827,3,10,6,8,29,26,3,36
Rapid Vienna,8827,4,8,9,7,34,29,5,33
Vienna,8827,5,7,5,12,25,38,-13,26
Mattersburg,8827,6,5,7,12,28,42,-14,22
SC Rheindorf,8827,7,5,5,14,19,31,-12,20
FC Salzburg,8828,1,16,6,2,49,18,31,54
Rapid Vienna,8828,2,10,9,5,37,27,10,39
SK Sturm Gra,8828,3,11,5,8,32,31,1,38
LASK Linz,8828,4,8,7,9,30,31,-1,31
Vienna,8828,5,7,5,12,27,41,-14,26
Mattersburg,8828,6,6,6,12,32,46,-14,24
SC Rheindorf,8828,7,4,6,14,19,32,-13,18
FC Salzburg,8829,1,15,6,3,45,18,27,51
Rapid Vienna,8829,2,10,9,5,36,28,8,39
SK Sturm Gra,8829,3,12,3,9,31,29,2,39
LASK Linz,8829,4,8,6,10,27,27,0,30
Mattersburg,8829,5,7,6,11,29,40,-11,27
Vienna,8829,6,6,5,13,23,39,-16,23
SC Rheindorf,8829,7,5,7,12,16,26,-10,22
FC Salzburg,8830,1,14,7,3,47,18,29,49
SK Sturm Gra,8830,2,14,3,7,33,30,3,45
Rapid Vienna,8830,3,9,9,6,36,29,7,36
LASK Linz,8830,4,9,5,10,29,31,-2,32
Vienna,8830,5,8,5,11,28,38,-10,29
Mattersburg,8830,6,5,6,13,31,46,-15,21
SC Rheindorf,8830,7,5,5,14,22,34,-12,20
FC Salzburg,8831,1,16,6,2,49,16,33,54
SK Sturm Gra,8831,2,12,5,7,30,27,3,41
Rapid Vienna,8831,3,9,9,6,38,30,8,36
LASK Linz,8831,4,7,8,9,24,28,-4,29
Mattersburg,8831,5,6,7,11,31,42,-11,25
Vienna,8831,6,6,5,13,24,42,-18,23
SC Rheindorf,8831,7,4,8,12,19,30,-11,20
FC Salzburg,8832,1,14,6,4,45,20,25,48
SK Sturm Gra,8832,2,13,4,7,33,29,4,43
Rapid Vienna,8832,3,9,10,5,40,29,11,37
LASK Linz,8832,4,8,8,8,28,27,1,32
Mattersburg,8832,5,7,5,12,30,41,-11,26
Vienna,8832,6,7,5,12,25,39,-14,26
SC Rheindorf,8832,7,4,6,14,18,34,-16,18
FC Salzburg,8833,1,14,6,4,42,19,23,48
SK Sturm Gra,8833,2,13,3,8,33,27,6,42
Rapid Vienna,8833,3,10,9,5,39,28,11,39
LASK Linz,8833,4,9,5,10,28,32,-4,32
Mattersburg,8833,5,7,5,12,30,41,-11,26
Vienna,8833,6,7,5,12,26,40,-14,26
SC Rheindorf,8833,7,5,5,14,19,30,-11,20
FC Salzburg,8834,1,15,6,3,46,18,28,51
SK Sturm Gra,8834,2,12,5,7,33,29,4,41
Rapid Vienna,8834,3,10,10,4,37,25,12,40
LASK Linz,8834,4,8,7,9,26,27,-1,31
Mattersburg,8834,5,6,6,12,30,42,-12,24
Vienna,8834,6,6,5,13,24,42,-18,23
SC Rheindorf,8834,7,4,7,13,18,31,-13,19
FC Salzburg,8835,1,14,7,3,44,17,27,49
SK Sturm Gra,8835,2,13,3,8,35,29,6,42
LASK Linz,8835,3,10,6,8,32,28,4,36
Rapid Vienna,8835,4,7,10,7,34,29,5,31
Vienna,8835,5,7,5,12,24,42,-18,26
SC Rheindorf,8835,6,6,6,12,19,30,-11,24
Mattersburg,8835,7,6,5,13,32,45,-13,23
FC Salzburg,8836,1,16,6,2,44,16,28,54
SK Sturm Gra,8836,2,11,5,8,30,28,2,38
LASK Linz,8836,3,9,6,9,28,28,0,33
Rapid Vienna,8836,4,7,11,6,35,30,5,32
Vienna,8836,5,7,5,12,29,39,-10,26
Mattersburg,8836,6,6,6,12,28,44,-16,24
SC Rheindorf,8836,7,5,7,12,19,28,-9,22
FC Salzburg,8837,1,15,7,2,51,20,31,52
SK Sturm Gra,8837,2,11,5,8,32,32,0,38
Rapid Vienna,8837,3,9,10,5,37,31,6,37
LASK Linz,8837,4,8,5,11,27,30,-3,29
Mattersburg,8837,5,7,6,11,31,40,-9,27
SC Rheindorf,8837,6,6,6,12,21,28,-7,24
Vienna,8837,7,6,5,13,24,42,-18,23
FC Salzburg,8838,1,15,6,3,45,19,26,51
SK Sturm Gra,8838,2,13,3,8,30,30,0,42
Rapid Vienna,8838,3,7,9,8,33,30,3,30
LASK Linz,8838,4,8,6,10,27,29,-2,30
Mattersburg,8838,5,7,6,11,33,42,-9,27
Vienna,8838,6,7,5,12,26,39,-13,26
SC Rheindorf,8838,7,6,7,11,23,28,-5,25
FC Salzburg,8839,1,16,6,2,48,19,29,54
SK Sturm Gra,8839,2,14,3,7,35,28,7,45
Rapid Vienna,8839,3,7,11,6,33,27,6,32
LASK Linz,8839,4,8,6,10,25,28,-3,30
Vienna,8839,5,7,5,12,26,40,-14,26
Mattersburg,8839,6,6,5,13,29,41,-12,23
SC Rheindorf,8839,7,5,6,13,16,29,-13,21
FC Salzburg,8840,1,15,7,2,45,18,27,52
SK Sturm Gra,8840,2,13,3,8,33,29,4,42
LASK Linz,8840,3,9,6,9,28,29,-1,33
Rapid Vienna,8840,4,7,11,6,35,29,6,32
Vienna,8840,5,7,5,12,25,38,-13,26
Mattersburg,8840,6,6,6,12,30,41,-11,24
SC Rheindorf,8840,7,4,8,12,17,29,-12,20
FC Salzburg,8841,1,15,6,3,50,22,28,51
SK Sturm Gra,8841,2,11,6,7,34,34,0,39
Rapid Vienna,8841,3,9,10,5,39,27,12,37
LASK Linz,8841,4,7,7,10,26,31,-5,28
Mattersburg,8841,5,7,6,11,31,39,-8,27
Vienna,8841,6,6,6,12,24,40,-16,24
SC Rheindorf,8841,7,5,7,12,20,31,-11,22
FC Salzburg,8842,1,14,7,3,47,21,26,49
SK Sturm Gra,8842,2,11,4,9,30,31,-1,37
Rapid Vienna,8842,3,7,12,5,36,29,7,33
LASK Linz,8842,4,8,7,9,30,31,-1,31
Vienna,8842,5,7,6,11,26,39,-13,27
SC Rheindorf,8842,6,6,7,11,23,31,-8,25
Mattersburg,8842,7,5,9,10,36,46,-10,24
FC Salzburg,8843,1,15,6,3,46,21,25,51
SK Sturm Gra,8843,2,15,3,6,38,25,13,48
Rapid Vienna,8843,3,7,11,6,33,29,4,32
LASK Linz,8843,4,7,8,9,24,27,-3,29
Vienna,8843,5,7,5,12,27,39,-12,26
Mattersburg,8843,6,5,7,12,29,43,-14,22
SC Rheindorf,8843,7,4,8,12,19,32,-13,20
FC Salzburg,8844,1,14,7,3,46,18,28,49
SK Sturm Gra,8844,2,14,4,6,35,27,8,46
Rapid Vienna,8844,3,9,9,6,36,26,10,36
LASK Linz,8844,4,9,5,10,27,28,-1,32
Mattersburg,8844,5,6,7,11,30,42,-12,25
Vienna,8844,6,6,6,12,25,43,-18,24
SC Rheindorf,8844,7,4,6,14,18,33,-15,18
FC Salzburg,8845,1,14,6,4,49,20,29,48
SK Sturm Gra,8845,2,13,3,8,32,30,2,42
Rapid Vienna,8845,3,8,10,6,34,27,7,34
LASK Linz,8845,4,8,5,11,28,31,-3,29
Vienna,8845,5,8,5,11,27,37,-10,29
SC Rheindorf,8845,6,6,7,11,20,26,-6,25
Mattersburg,8845,7,6,6,12,29,48,-19,24
FC Salzburg,8846,1,14,7,3,44,18,26,49
SK Sturm Gra,8846,2,13,4,7,34,28,6,43
LASK Linz,8846,3,9,6,9,28,27,1,33
Rapid Vienna,8846,4,7,9,8,32,31,1,30
Vienna,8846,5,8,5,11,27,38,-11,29
SC Rheindorf,8846,6,7,5,12,20,28,-8,26
Mattersburg,8846,7,5,6,13,27,42,-15,21
FC Salzburg,8847,1,14,7,3,43,18,25,49
SK Sturm Gra,8847,2,13,3,8,31,29,2,42
Rapid Vienna,8847,3,9,9,6,38,27,11,36
LASK Linz,8847,4,9,5,10,28,30,-2,32
Vienna,8847,5,7,6,11,25,37,-12,27
SC Rheindorf,8847,6,7,5,12,23,30,-7,26
Mattersburg,8847,7,5,5,14,28,45,-17,20
FC Salzburg,8848,1,14,6,4,47,24,23,48
SK Sturm Gra,8848,2,12,5,7,31,28,3,41
Rapid Vienna,8848,3,10,9,5,40,28,12,39
LASK Linz,8848,4,8,7,9,27,28,-1,31
Mattersburg,8848,5,8,5,11,37,41,-4,29
Vienna,8848,6,6,5,13,25,46,-21,23
SC Rheindorf,8848,7,4,7,13,17,29,-12,19
FC Salzburg,8849,1,16,6,2,45,17,28,54
SK Sturm Gra,8849,2,11,5,8,32,30,2,38
Rapid Vienna,8849,3,8,10,6,34,27,7,34
LASK Linz,8849,4,7,7,10,26,29,-3,28
SC Rheindorf,8849,5,7,6,11,24,29,-5,27
Mattersburg,8849,6,7,5,12,29,42,-13,26
Vienna,8849,7,6,5,13,25,41,-16,23
FC Salzburg,8850,1,16,6,2,48,17,31,54
SK Sturm Gra,8850,2,12,3,9,37,36,1,39
Rapid Vienna,8850,3,9,10,5,36,27,9,37
LASK Linz,8850,4,9,5,10,34,34,0,32
Mattersburg,8850,5,7,5,12,34,43,-9,26
Vienna,8850,6,6,5,13,25,42,-17,23
SC Rheindorf,8850,7,5,6,13,17,32,-15,21
FC Salzburg,8851,1,13,9,2,43,19,24,48
SK Sturm Gra,8851,2,14,4,6,35,27,8,46
Rapid Vienna,8851,3,7,12,5,33,27,6,33
LASK Linz,8851,4,7,6,11,26,31,-5,27
Vienna,8851,5,7,5,12,26,39,-13,26
Mattersburg,8851,6,6,7,11,33,43,-10,25
SC Rheindorf,8851,7,5,7,12,22,32,-10,22
FC Salzburg,8852,1,16,6,2,49,16,33,54
SK Sturm Gra,8852,2,12,4,8,31,28,3,40
Rapid Vienna,8852,3,8,11,5,34,25,9,35
LASK Linz,8852,4,8,6,10,27,30,-3,30
Vienna,8852,5,7,5,12,25,39,-14,26
SC Rheindorf,8852,6,6,5,13,20,32,-12,23
Mattersburg,8852,7,6,5,13,30,46,-16,23
FC Salzburg,8853,1,14,6,4,42,17,25,48
SK Sturm Gra,8853,2,14,3,7,35,27,8,45
Rapid Vienna,8853,3,8,11,5,34,27,7,35
LASK Linz,8853,4,7,6,11,25,30,-5,27
Mattersburg,8853,5,7,6,11,32,41,-9,27
Vienna,8853,6,7,5,12,26,40,-14,26
SC Rheindorf,8853,7,5,7,12,18,30,-12,22
FC Salzburg,8854,1,14,6,4,47,22,25,48
SK Sturm Gra,8854,2,14,3,7,38,33,5,45
Rapid Vienna,8854,3,8,10,6,38,30,8,34
LASK Linz,8854,4,8,6,10,31,37,-6,30
Vienna,8854,5,8,5,11,28,38,-10,29
Mattersburg,8854,6,6,5,13,33,45,-12,23
SC Rheindorf,8854,7,5,7,12,21,31,-10,22
FC Salzburg,8855,1,15,7,2,44,17,27,52
SK Sturm Gra,8855,2,11,4,9,29,31,-2,37
LASK Linz,8855,3,10,6,8,30,26,4,36
Rapid Vienna,8855,4,8,9,7,34,28,6,33
Vienna,8855,5,7,6,11,26,39,-13,27
SC Rheindorf,8855,6,5,7,12,20,29,-9,22
Mattersburg,8855,7,5,7,12,31,44,-13,22
FC Salzburg,8856,1,16,6,2,50,18,32,54
SK Sturm Gra,8856,2,12,5,7,32,30,2,41
Rapid Vienna,8856,3,8,10,6,37,29,8,34
LASK Linz,8856,4,9,5,10,27,28,-1,32
Mattersburg,8856,5,6,6,12,30,42,-12,24
Vienna,8856,6,6,5,13,24,42,-18,23
SC Rheindorf,8856,7,5,7,12,19,30,-11,22
FC Salzburg,8857,1,14,6,4,42,18,24,48
SK Sturm Gra,8857,2,13,3,8,32,27,5,42
Rapid Vienna,8857,3,8,9,7,33,28,5,33
LASK Linz,8857,4,8,5,11,26,30,-4,29
Mattersburg,8857,5,8,5,11,31,39,-8,29
SC Rheindorf,8857,6,7,5,12,21,29,-8,26
Vienna,8857,7,7,5,12,25,39,-14,26
FC Salzburg,8858,1,14,6,4,44,20,24,48
Rapid Vienna,8858,2,10,9,5,36,26,10,39
SK Sturm Gra,8858,3,11,4,9,31,30,1,37
LASK Linz,8858,4,9,6,9,27,27,0,33
Mattersburg,8858,5,8,5,11,33,39,-6,29
Vienna,8858,6,7,5,12,25,42,-17,26
SC Rheindorf,8858,7,4,7,13,19,31,-12,19
FC Salzburg,8859,1,14,7,3,43,19,24,49
SK Sturm Gra,8859,2,13,4,7,34,28,6,43
Rapid Vienna,8859,3,9,9,6,35,26,9,36
LASK Linz,8859,4,8,7,9,28,30,-2,31
Vienna,8859,5,8,5,11,26,38,-12,29
Mattersburg,8859,6,6,7,11,30,40,-10,25
SC Rheindorf,8859,7,4,5,15,18,33,-15,17
FC Salzburg,8860,1,13,7,4,41,19,22,46
SK Sturm Gra,8860,2,13,4,7,35,30,5,43
Rapid Vienna,8860,3,9,10,5,37,27,10,37
LASK Linz,8860,4,9,5,10,28,29,-1,32
Vienna,8860,5,7,6,11,25,38,-13,27
SC Rheindorf,8860,6,5,7,12,21,30,-9,22
Mattersburg,8860,7,5,7,12,28,42,-14,22
FC Salzburg,8861,1,14,7,3,46,18,28,49
Rapid Vienna,8861,2,11,9,4,36,24,12,42
SK Sturm Gra,8861,3,11,6,7,30,27,3,39
LASK Linz,8861,4,9,6,9,30,30,0,33
Mattersburg,8861,5,7,5,12,35,46,-11,26
Vienna,8861,6,6,5,13,26,44,-18,23
SC Rheindorf,8861,7,4,6,14,17,31,-14,18
FC Salzburg,8862,1,14,7,3,43,20,23,49
SK Sturm Gra,8862,2,14,3,7,33,27,6,45
Rapid Vienna,8862,3,9,11,4,37,26,11,38
LASK Linz,8862,4,8,6,10,27,28,-1,30
Vienna,8862,5,7,5,12,25,39,-14,26
Mattersburg,8862,6,5,6,13,27,41,-14,21
SC Rheindorf,8862,7,4,8,12,16,27,-11,20
FC Salzburg,8863,1,15,6,3,44,17,27,51
Rapid Vienna,8863,2,10,9,5,39,26,13,39
SK Sturm Gra,8863,3,11,4,9,32,36,-4,37
LASK Linz,8863,4,9,6,9,28,28,0,33
SC Rheindorf,8863,5,6,6,12,22,30,-8,24
Vienna,8863,6,6,6,12,23,38,-15,24
Mattersburg,8863,7,5,7,12,26,39,-13,22
FC Salzburg,8864,1,16,6,2,46,16,30,54
SK Sturm Gra,8864,2,12,4,8,31,28,3,40
LASK Linz,8864,3,10,5,9,29,27,2,35
Rapid Vienna,8864,4,8,9,7,33,30,3,33
Vienna,8864,5,7,5,12,25,39,-14,26
Mattersburg,8864,6,6,6,12,30,42,-12,24
SC Rheindorf,8864,7,4,7,13,19,31,-12,19
FC Salzburg,8865,1,13,8,3,41,20,21,47
SK Sturm Gra,8865,2,12,5,7,30,28,2,41
Rapid Vienna,8865,3,9,10,5,37,25,12,37
Mattersburg,8865,4,7,7,10,34,40,-6,28
SC Rheindorf,8865,5,7,6,11,22,26,-4,27
LASK Linz,8865,6,7,5,12,24,32,-8,26
Vienna,8865,7,6,5,13,25,42,-17,23
FC Salzburg,8866,1,14,8,2,45,17,28,50
SK Sturm Gra,8866,2,12,5,7,33,28,5,41
Rapid Vienna,8866,3,7,12,5,34,27,7,33
LASK Linz,8866,4,7,8,9,27,29,-2,29
Mattersburg,8866,5,8,5,11,31,42,-11,29
Vienna,8866,6,6,6,12,24,39,-15,24
SC Rheindorf,8866,7,5,6,13,19,31,-12,21
FC Salzburg,8867,1,14,7,3,44,18,26,49
SK Sturm Gra,8867,2,12,4,8,32,32,0,40
Rapid Vienna,8867,3,9,10,5,36,26,10,37
LASK Linz,8867,4,8,7,9,31,31,0,31
Mattersburg,8867,5,6,7,11,34,42,-8,25
Vienna,8867,6,6,7,11,26,40,-14,25
SC Rheindorf,8867,7,5,6,13,17,31,-14,21
FC Salzburg,8868,1,13,8,3,44,22,22,47
SK Sturm Gra,8868,2,12,4,8,32,29,3,40
LASK Linz,8868,3,10,6,8,29,26,3,36
Rapid Vienna,8868,4,8,11,5,36,27,9,35
Vienna,8868,5,7,6,11,29,40,-11,27
Mattersburg,8868,6,5,8,11,30,42,-12,23
SC Rheindorf,8868,7,5,5,14,20,34,-14,20
FC Salzburg,8869,1,15,7,2,44,17,27,52
SK Sturm Gra,8869,2,12,5,7,35,31,4,41
LASK Linz,8869,3,9,5,10,27,29,-2,32
Rapid Vienna,8869,4,7,10,7,33,28,5,31
SC Rheindorf,8869,5,7,6,11,22,27,-5,27
Mattersburg,8869,6,6,6,12,31,44,-13,24
Vienna,8869,7,6,5,13,26,42,-16,23
FC Salzburg,8870,1,14,7,3,44,20,24,49
SK Sturm Gra,8870,2,12,4,8,30,28,2,40
Rapid Vienna,8870,3,9,10,5,37,28,9,37
LASK Linz,8870,4,9,5,10,28,29,-1,32
Mattersburg,8870,5,7,5,12,35,44,-9,26
Vienna,8870,6,6,6,12,27,42,-15,24
SC Rheindorf,8870,7,5,7,12,18,28,-10,22
FC Salzburg,8871,1,13,8,3,43,21,22,47
SK Sturm Gra,8871,2,12,4,8,33,30,3,40
Rapid Vienna,8871,3,8,11,5,36,27,9,35
LASK Linz,8871,4,7,7,10,26,29,-3,28
Mattersburg,8871,5,6,8,10,32,41,-9,26
SC Rheindorf,8871,6,6,7,11,19,27,-8,25
Vienna,8871,7,6,7,11,27,41,-14,25
FC Salzburg,8872,1,15,6,3,44,19,25,51
Rapid Vienna,8872,2,9,10,5,36,25,11,37
SK Sturm Gra,8872,3,11,4,9,32,32,0,37
LASK Linz,8872,4,9,5,10,25,29,-4,32
Vienna,8872,5,7,6,11,27,39,-12,27
SC Rheindorf,8872,6,6,7,11,20,27,-7,25
Mattersburg,8872,7,5,6,13,29,42,-13,21
FC Salzburg,8873,1,13,8,3,43,20,23,47
SK Sturm Gra,8873,2,11,6,7,33,31,2,39
LASK Linz,8873,3,11,5,8,31,27,4,38
Rapid Vienna,8873,4,8,10,6,35,27,8,34
Mattersburg,8873,5,7,6,11,28,37,-9,27
Vienna,8873,6,6,5,13,23,40,-17,23
SC Rheindorf,8873,7,5,6,13,19,30,-11,21
FC Salzburg,8874,1,13,7,4,43,21,22,46
SK Sturm Gra,8874,2,13,4,7,34,27,7,43
Rapid Vienna,8874,3,9,9,6,36,27,9,36
LASK Linz,8874,4,10,5,9,29,28,1,35
Vienna,8874,5,7,6,11,26,39,-13,27
Mattersburg,8874,6,6,6,12,31,43,-12,24
SC Rheindorf,8874,7,4,7,13,17,31,-14,19
FC Salzburg,8875,1,15,6,3,45,17,28,51
SK Sturm Gra,8875,2,11,4,9,29,29,0,37
Rapid Vienna,8875,3,8,11,5,34,27,7,35
LASK Linz,8875,4,8,8,8,31,31,0,32
Vienna,8875,5,7,6,11,24,37,-13,27
SC Rheindorf,8875,6,6,6,12,19,27,-8,24
Mattersburg,8875,7,5,7,12,30,44,-14,22
FC Salzburg,8876,1,16,6,2,49,18,31,54
SK Sturm Gra,8876,2,13,4,7,33,27,6,43
Rapid Vienna,8876,3,9,9,6,39,30,9,36
Mattersburg,8876,4,7,6,11,28,38,-10,27
LASK Linz,8876,5,7,5,12,25,31,-6,26
Vienna,8876,6,6,5,13,24,42,-18,23
SC Rheindorf,8876,7,5,7,12,17,29,-12,22
FC Salzburg,8877,1,16,6,2,50,17,33,54
SK Sturm Gra,8877,2,13,4,7,32,27,5,43
Rapid Vienna,8877,3,7,11,6,36,33,3,32
LASK Linz,8877,4,8,6,10,29,27,2,30
Vienna,8877,5,7,5,12,26,41,-15,26
Mattersburg,8877,6,6,5,13,31,48,-17,23
SC Rheindorf,8877,7,5,7,12,20,31,-11,22
FC Salzburg,8878,1,15,6,3,46,16,30,51
SK Sturm Gra,8878,2,12,4,8,31,32,-1,40
Rapid Vienna,8878,3,9,9,6,35,26,9,36
LASK Linz,8878,4,8,7,9,27,29,-2,31
Mattersburg,8878,5,7,5,12,33,41,-8,26
SC Rheindorf,8878,6,6,6,12,19,30,-11,24
Vienna,8878,7,6,5,13,24,41,-17,23
FC Salzburg,8879,1,14,8,2,40,15,25,50
SK Sturm Gra,8879,2,11,6,7,33,33,0,39
LASK Linz,8879,3,9,6,9,28,27,1,33
Rapid Vienna,8879,4,7,11,6,35,29,6,32
Vienna,8879,5,7,5,12,25,39,-14,26
Mattersburg,8879,6,6,7,11,31,41,-10,25
SC Rheindorf,8879,7,5,7,12,25,33,-8,22
FC Salzburg,8880,1,14,6,4,50,18,32,48
Rapid Vienna,8880,2,9,11,4,35,23,12,38
SK Sturm Gra,8880,3,11,5,8,30,33,-3,38
LASK Linz,8880,4,9,7,8,28,26,2,34
Vienna,8880,5,7,5,12,24,40,-16,26
Mattersburg,8880,6,6,5,13,30,47,-17,23
SC Rheindorf,8880,7,5,7,12,20,30,-10,22
FC Salzburg,8881,1,14,7,3,44,20,24,49
SK Sturm Gra,8881,2,12,3,9,29,28,1,39
Rapid Vienna,8881,3,9,9,6,35,27,8,36
LASK Linz,8881,4,8,5,11,26,29,-3,29
Vienna,8881,5,8,5,11,31,38,-7,29
SC Rheindorf,8881,6,7,5,12,19,30,-11,26
Mattersburg,8881,7,6,6,12,31,43,-12,24
FC Salzburg,8882,1,15,6,3,46,17,29,51
SK Sturm Gra,8882,2,13,3,8,33,28,5,42
Rapid Vienna,8882,3,9,9,6,37,28,9,36
LASK Linz,8882,4,9,6,9,28,31,-3,33
Vienna,8882,5,8,5,11,28,40,-12,29
Mattersburg,8882,6,6,6,12,34,45,-11,24
SC Rheindorf,8882,7,4,5,15,16,33,-17,17
FC Salzburg,8883,1,14,7,3,42,17,25,49
SK Sturm Gra,8883,2,12,3,9,34,30,4,39
Rapid Vienna,8883,3,9,10,5,36,30,6,37
LASK Linz,8883,4,8,6,10,27,31,-4,30
Mattersburg,8883,5,8,6,10,32,37,-5,30
SC Rheindorf,8883,6,6,5,13,20,29,-9,23
Vienna,8883,7,6,5,13,23,40,-17,23
FC Salzburg,8884,1,16,6,2,47,16,31,54
SK Sturm Gra,8884,2,12,4,8,31,30,1,40
LASK Linz,8884,3,9,7,8,36,28,8,34
Rapid Vienna,8884,4,7,9,8,32,34,-2,30
Mattersburg,8884,5,6,7,11,31,40,-9,25
SC Rheindorf,8884,6,6,6,12,19,29,-10,24
Vienna,8884,7,6,5,13,24,43,-19,23
FC Salzburg,8885,1,15,7,2,49,21,28,52
SK Sturm Gra,8885,2,13,3,8,35,33,2,42
Rapid Vienna,8885,3,10,9,5,38,26,12,39
LASK Linz,8885,4,8,6,10,32,33,-1,30
Vienna,8885,5,7,5,12,28,44,-16,26
Mattersburg,8885,6,5,8,11,33,44,-11,23
SC Rheindorf,8885,7,4,6,14,18,32,-14,18
FC Salzburg,8886,1,13,8,3,40,18,22,47
SK Sturm Gra,8886,2,13,3,8,34,30,4,42
Rapid Vienna,8886,3,9,10,5,34,24,10,37
LASK Linz,8886,4,9,6,9,27,28,-1,33
Mattersburg,8886,5,6,8,10,32,41,-9,26
Vienna,8886,6,7,5,12,27,40,-13,26
SC Rheindorf,8886,7,4,6,14,20,33,-13,18
FC Salzburg,8887,1,14,7,3,44,19,25,49
SK Sturm Gra,8887,2,12,5,7,33,29,4,41
Rapid Vienna,8887,3,10,10,4,36,25,11,40
LASK Linz,8887,4,8,5,11,27,31,-4,29
Mattersburg,8887,5,7,6,11,36,44,-8,27
Vienna,8887,6,6,6,12,26,41,-15,24
SC Rheindorf,8887,7,4,7,13,17,30,-13,19
FC Salzburg,8888,1,15,6,3,45,19,26,51
SK Sturm Gra,8888,2,14,3,7,34,27,7,45
Rapid Vienna,8888,3,8,9,7,34,26,8,33
LASK Linz,8888,4,8,5,11,25,34,-9,29
Mattersburg,8888,5,7,6,11,34,42,-8,27
Vienna,8888,6,7,5,12,26,39,-13,26
SC Rheindorf,8888,7,5,6,13,21,32,-11,21
FC Salzburg,8889,1,16,6,2,49,18,31,54
SK Sturm Gra,8889,2,11,5,8,31,30,1,38
Rapid Vienna,8889,3,9,10,5,39,29,10,37
LASK Linz,8889,4,8,6,10,28,29,-1,30
SC Rheindorf,8889,5,7,5,12,22,32,-10,26
Vienna,8889,6,7,5,12,29,40,-11,26
Mattersburg,8889,7,5,5,14,28,48,-20,20
FC Salzburg,8890,1,13,8,3,42,19,23,47
SK Sturm Gra,8890,2,12,3,9,36,34,2,39
LASK Linz,8890,3,10,5,9,29,29,0,35
Rapid Vienna,8890,4,7,10,7,35,31,4,31
Mattersburg,8890,5,8,6,10,37,40,-3,30
Vienna,8890,6,7,5,12,30,46,-16,26
SC Rheindorf,8890,7,6,5,13,21,31,-10,23
FC Salzburg,8891,1,15,6,3,49,21,28,51
SK Sturm Gra,8891,2,12,4,8,33,31,2,40
Rapid Vienna,8891,3,8,10,6,39,31,8,34
LASK Linz,8891,4,8,6,10,29,32,-3,30
SC Rheindorf,8891,5,7,6,11,21,27,-6,27
Mattersburg,8891,6,7,5,12,30,40,-10,26
Vienna,8891,7,6,5,13,24,43,-19,23
FC Salzburg,8892,1,14,7,3,45,18,27,49
SK Sturm Gra,8892,2,13,4,7,35,28,7,43
Rapid Vienna,8892,3,8,9,7,34,29,5,33
LASK Linz,8892,4,8,6,10,27,30,-3,30
Vienna,8892,5,7,5,12,25,43,-18,26
Mattersburg,8892,6,6,7,11,31,40,-9,25
SC Rheindorf,8892,7,5,8,11,20,29,-9,23
FC Salzburg,8893,1,15,6,3,44,18,26,51
SK Sturm Gra,8893,2,13,3,8,34,30,4,42
Rapid Vienna,8893,3,9,10,5,34,25,9,37
LASK Linz,8893,4,8,6,10,30,31,-1,30
Mattersburg,8893,5,7,6,11,30,40,-10,27
Vienna,8893,6,6,5,13,24,40,-16,23
SC Rheindorf,8893,7,5,6,13,20,32,-12,21
FC Salzburg,8894,1,13,9,2,43,17,26,48
SK Sturm Gra,8894,2,13,4,7,34,31,3,43
LASK Linz,8894,3,9,5,10,27,28,-1,32
Rapid Vienna,8894,4,7,10,7,33,28,5,31
SC Rheindorf,8894,5,7,6,11,25,29,-4,27
Mattersburg,8894,6,6,7,11,30,41,-11,25
Vienna,8894,7,6,5,13,24,42,-18,23
FC Salzburg,8895,1,13,7,4,40,17,23,46
SK Sturm Gra,8895,2,13,5,6,33,26,7,44
Rapid Vienna,8895,3,9,10,5,36,26,10,37
LASK Linz,8895,4,8,7,9,29,29,0,31
Vienna,8895,5,7,5,12,24,39,-15,26
Mattersburg,8895,6,6,7,11,27,37,-10,25
SC Rheindorf,8895,7,4,7,13,16,31,-15,19
FC Salzburg,8896,1,14,8,2,46,20,26,50
SK Sturm Gra,8896,2,12,5,7,31,28,3,41
Rapid Vienna,8896,3,7,11,6,36,32,4,32
LASK Linz,8896,4,8,6,10,30,30,0,30
Vienna,8896,5,6,7,11,27,41,-14,25
Mattersburg,8896,6,5,9,10,32,42,-10,24
SC Rheindorf,8896,7,5,8,11,20,29,-9,23
FC Salzburg,8897,1,15,7,2,44,18,26,52
SK Sturm Gra,8897,2,11,4,9,31,30,1,37
Rapid Vienna,8897,3,7,12,5,35,28,7,33
LASK Linz,8897,4,8,6,10,30,32,-2,30
SC Rheindorf,8897,5,7,6,11,19,26,-7,27
Vienna,8897,6,7,5,12,27,38,-11,26
Mattersburg,8897,7,6,6,12,30,44,-14,24
FC Salzburg,8898,1,13,8,3,42,17,25,47
SK Sturm Gra,8898,2,12,5,7,32,29,3,41
Rapid Vienna,8898,3,10,9,5,36,26,10,39
LASK Linz,8898,4,7,6,11,25,29,-4,27
SC Rheindorf,8898,5,7,5,12,21,27,-6,26
Vienna,8898,6,7,5,12,25,40,-15,26
Mattersburg,8898,7,6,6,12,27,40,-13,24
FC Salzburg,8899,1,14,6,4,45,21,24,48
SK Sturm Gra,8899,2,13,4,7,34,29,5,43
Rapid Vienna,8899,3,10,10,4,36,24,12,40
LASK Linz,8899,4,8,5,11,28,30,-2,29
Mattersburg,8899,5,8,5,11,36,44,-8,29
Vienna,8899,6,6,5,13,26,42,-16,23
SC Rheindorf,8899,7,5,5,14,17,32,-15,20
FC Salzburg,8900,1,15,7,2,48,19,29,52
Rapid Vienna,8900,2,10,10,4,40,28,12,40
SK Sturm Gra,8900,3,12,4,8,34,30,4,40
LASK Linz,8900,4,7,6,11,25,31,-6,27
Mattersburg,8900,5,7,6,11,30,40,-10,27
Vienna,8900,6,6,5,13,25,42,-17,23
SC Rheindorf,8900,7,4,8,12,19,31,-12,20
FC Salzburg,8901,1,14,6,4,46,21,25,48
SK Sturm Gra,8901,2,13,3,8,33,32,1,42
Rapid Vienna,8901,3,10,9,5,41,27,14,39
LASK Linz,8901,4,8,5,11,26,31,-5,29
Mattersburg,8901,5,7,6,11,29,39,-10,27
Vienna,8901,6,6,6,12,25,43,-18,24
SC Rheindorf,8901,7,6,5,13,23,30,-7,23
FC Salzburg,8902,1,15,7,2,45,16,29,52
SK Sturm Gra,8902,2,12,4,8,33,31,2,40
Rapid Vienna,8902,3,7,12,5,35,29,6,33
LASK Linz,8902,4,9,6,9,27,27,0,33
Vienna,8902,5,7,6,11,25,37,-12,27
SC Rheindorf,8902,6,5,7,12,18,28,-10,22
Mattersburg,8902,7,5,6,13,27,42,-15,21
FC Salzburg,8903,1,14,8,2,45,18,27,50
SK Sturm Gra,8903,2,12,5,7,35,31,4,41
Rapid Vienna,8903,3,8,12,4,35,26,9,36
LASK Linz,8903,4,9,7,8,25,24,1,34
Vienna,8903,5,7,5,12,28,42,-14,26
Mattersburg,8903,6,5,6,13,30,47,-17,21
SC Rheindorf,8903,7,5,5,14,20,30,-10,20
FC Salzburg,8904,1,12,9,3,44,22,22,45
SK Sturm Gra,8904,2,13,4,7,34,28,6,43
Rapid Vienna,8904,3,9,9,6,34,27,7,36
LASK Linz,8904,4,10,5,9,29,27,2,35
Mattersburg,8904,5,6,7,11,32,43,-11,25
Vienna,8904,6,6,6,12,25,40,-15,24
SC Rheindorf,8904,7,5,6,13,17,28,-11,21
FC Salzburg,8905,1,14,8,2,48,18,30,50
SK Sturm Gra,8905,2,12,4,8,31,30,1,40
LASK Linz,8905,3,11,5,8,33,26,7,38
Rapid Vienna,8905,4,9,10,5,40,27,13,37
Mattersburg,8905,5,7,5,12,31,46,-15,26
Vienna,8905,6,6,5,13,23,41,-18,23
SC Rheindorf,8905,7,4,5,15,18,36,-18,17
FC Salzburg,8906,1,16,6,2,47,17,30,54
SK Sturm Gra,8906,2,12,3,9,35,32,3,39
LASK Linz,8906,3,10,6,8,33,28,5,36
Rapid Vienna,8906,4,7,10,7,33,32,1,31
Mattersburg,8906,5,7,5,12,33,44,-11,26
Vienna,8906,6,6,5,13,23,40,-17,23
SC Rheindorf,8906,7,5,7,12,21,32,-11,22
FC Salzburg,8907,1,16,6,2,47,17,30,54
SK Sturm Gra,8907,2,12,5,7,30,27,3,41
LASK Linz,8907,3,10,5,9,27,25,2,35
Rapid Vienna,8907,4,7,10,7,33,31,2,31
Vienna,8907,5,7,5,12,26,39,-13,26
Mattersburg,8907,6,6,5,13,31,45,-14,23
SC Rheindorf,8907,7,5,6,13,21,31,-10,21
FC Salzburg,8908,1,15,7,2,45,18,27,52
SK Sturm Gra,8908,2,12,4,8,31,30,1,40
Rapid Vienna,8908,3,8,11,5,36,27,9,35
LASK Linz,8908,4,8,6,10,27,29,-2,30
Mattersburg,8908,5,7,6,11,35,44,-9,27
Vienna,8908,6,6,6,12,26,41,-15,24
SC Rheindorf,8908,7,5,6,13,19,30,-11,21
FC Salzburg,8909,1,15,6,3,47,20,27,51
SK Sturm Gra,8909,2,13,3,8,33,32,1,42
Rapid Vienna,8909,3,8,10,6,35,28,7,34
LASK Linz,8909,4,8,6,10,28,29,-1,30
Mattersburg,8909,5,7,5,12,32,42,-10,26
Vienna,8909,6,7,5,12,26,40,-14,26
SC Rheindorf,8909,7,6,5,13,20,30,-10,23
FC Salzburg,8910,1,14,8,2,44,18,26,50
SK Sturm Gra,8910,2,13,4,7,34,28,6,43
Rapid Vienna,8910,3,8,9,7,34,29,5,33
LASK Linz,8910,4,8,6,10,26,30,-4,30
Vienna,8910,5,7,6,11,25,38,-13,27
SC Rheindorf,8910,6,6,6,12,21,29,-8,24
Mattersburg,8910,7,6,5,13,32,44,-12,23
FC Salzburg,8911,1,13,8,3,44,20,24,47
SK Sturm Gra,8911,2,12,4,8,31,30,1,40
Rapid Vienna,8911,3,7,11,6,33,29,4,32
LASK Linz,8911,4,8,7,9,28,28,0,31
Mattersburg,8911,5,7,6,11,32,41,-9,27
SC Rheindorf,8911,6,6,7,11,20,26,-6,25
Vienna,8911,7,6,7,11,26,40,-14,25
FC Salzburg,8912,1,15,6,3,49,17,32,51
SK Sturm Gra,8912,2,13,4,7,34,29,5,43
Rapid Vienna,8912,3,9,9,6,37,31,6,36
LASK Linz,8912,4,9,6,9,28,28,0,33
Mattersburg,8912,5,7,5,12,29,43,-14,26
Vienna,8912,6,7,5,12,25,40,-15,26
SC Rheindorf,8912,7,4,5,15,17,31,-14,17
FC Salzburg,8913,1,16,6,2,49,16,33,54
SK Sturm Gra,8913,2,12,3,9,33,34,-1,39
Rapid Vienna,8913,3,9,10,5,38,30,8,37
LASK Linz,8913,4,9,6,9,32,28,4,33
Vienna,8913,5,7,5,12,24,38,-14,26
Mattersburg,8913,6,6,5,13,31,45,-14,23
SC Rheindorf,8913,7,4,7,13,22,38,-16,19
FC Salzburg,8914,1,16,6,2,47,16,31,54
SK Sturm Gra,8914,2,12,4,8,34,32,2,40
Rapid Vienna,8914,3,10,9,5,39,28,11,39
LASK Linz,8914,4,8,5,11,27,31,-4,29
Vienna,8914,5,7,5,12,25,40,-15,26
Mattersburg,8914,6,6,5,13,28,42,-14,23
SC Rheindorf,8914,7,5,6,13,18,29,-11,21
FC Salzburg,8915,1,15,6,3,46,18,28,51
SK Sturm Gra,8915,2,13,4,7,34,29,5,43
Rapid Vienna,8915,3,9,10,5,38,29,9,37
LASK Linz,8915,4,9,5,10,33,31,2,32
Mattersburg,8915,5,6,5,13,32,48,-16,23
Vienna,8915,6,6,5,13,25,44,-19,23
SC Rheindorf,8915,7,5,7,12,20,29,-9,22
FC Salzburg,8916,1,16,6,2,53,16,37,54
SK Sturm Gra,8916,2,11,5,8,30,32,-2,38
Rapid Vienna,8916,3,8,10,6,36,28,8,34
LASK Linz,8916,4,9,5,10,27,31,-4,32
Vienna,8916,5,7,5,12,27,41,-14,26
SC Rheindorf,8916,6,6,6,12,23,29,-6,24
Mattersburg,8916,7,6,5,13,31,50,-19,23
FC Salzburg,8917,1,15,7,2,46,20,26,52
SK Sturm Gra,8917,2,11,6,7,33,31,2,39
Rapid Vienna,8917,3,9,10,5,40,29,11,37
LASK Linz,8917,4,7,7,10,25,28,-3,28
Mattersburg,8917,5,6,7,11,29,39,-10,25
Vienna,8917,6,6,6,12,25,40,-15,24
SC Rheindorf,8917,7,5,7,12,20,31,-11,22
FC Salzburg,8918,1,14,7,3,45,18,27,49
SK Sturm Gra,8918,2,12,4,8,30,30,0,40
Rapid Vienna,8918,3,8,9,7,35,29,6,33
LASK Linz,8918,4,8,8,8,29,28,1,32
Mattersburg,8918,5,6,7,11,30,41,-11,25
Vienna,8918,6,6,7,11,25,39,-14,25
SC Rheindorf,8918,7,6,6,12,20,29,-9,24
FC Salzburg,8919,1,13,9,2,42,18,24,48
SK Sturm Gra,8919,2,13,5,6,37,28,9,44
Rapid Vienna,8919,3,7,11,6,34,29,5,32
LASK Linz,8919,4,7,8,9,26,30,-4,29
Vienna,8919,5,7,6,11,25,38,-13,27
SC Rheindorf,8919,6,5,8,11,22,31,-9,23
Mattersburg,8919,7,5,7,12,30,42,-12,22
FC Salzburg,8920,1,15,6,3,45,16,29,51
Rapid Vienna,8920,2,10,10,4,38,24,14,40
SK Sturm Gra,8920,3,12,4,8,29,28,1,40
LASK Linz,8920,4,7,8,9,26,28,-2,29
Mattersburg,8920,5,6,6,12,28,41,-13,24
Vienna,8920,6,6,5,13,23,40,-17,23
SC Rheindorf,8920,7,5,7,12,17,29,-12,22
FC Salzburg,8921,1,15,7,2,48,17,31,52
SK Sturm Gra,8921,2,12,5,7,34,30,4,41
Rapid Vienna,8921,3,8,11,5,37,27,10,35
LASK Linz,8921,4,9,7,8,30,28,2,34
Mattersburg,8921,5,6,7,11,29,42,-13,25
Vienna,8921,6,6,6,12,25,40,-15,24
SC Rheindorf,8921,7,4,5,15,19,38,-19,17
FC Salzburg,8922,1,16,6,2,46,16,30,54
SK Sturm Gra,8922,2,13,4,7,33,27,6,43
Rapid Vienna,8922,3,8,11,5,36,27,9,35
LASK Linz,8922,4,9,6,9,28,27,1,33
Vienna,8922,5,7,5,12,27,39,-12,26
Mattersburg,8922,6,6,5,13,28,44,-16,23
SC Rheindorf,8922,7,4,5,15,16,34,-18,17
FC Salzburg,8923,1,14,7,3,44,18,26,49
Rapid Vienna,8923,2,10,10,4,37,23,14,40
SK Sturm Gra,8923,3,12,3,9,30,34,-4,39
LASK Linz,8923,4,8,7,9,29,30,-1,31
Mattersburg,8923,5,8,6,10,37,39,-2,30
Vienna,8923,6,6,5,13,25,43,-18,23
SC Rheindorf,8923,7,4,6,14,16,31,-15,18
FC Salzburg,8924,1,15,7,2,46,18,28,52
SK Sturm Gra,8924,2,13,4,7,32,27,5,43
Rapid Vienna,8924,3,8,11,5,37,30,7,35
LASK Linz,8924,4,7,6,11,27,31,-4,27
Mattersburg,8924,5,7,6,11,31,40,-9,27
Vienna,8924,6,6,5,13,25,41,-16,23
SC Rheindorf,8924,7,5,7,12,19,30,-11,22
FC Salzburg,8925,1,15,6,3,51,19,32,51
SK Sturm Gra,8925,2,12,3,9,34,30,4,39
Rapid Vienna,8925,3,9,9,6,39,30,9,36
LASK Linz,8925,4,8,5,11,27,33,-6,29
SC Rheindorf,8925,5,8,5,11,21,27,-6,29
Mattersburg,8925,6,7,5,12,29,44,-15,26
Vienna,8925,7,6,5,13,24,42,-18,23
FC Salzburg,8926,1,13,6,5,42,22,20,45
SK Sturm Gra,8926,2,12,4,8,31,28,3,40
Rapid Vienna,8926,3,9,11,4,36,26,10,38
Mattersburg,8926,4,9,5,10,32,38,-6,32
LASK Linz,8926,5,7,6,11,25,29,-4,27
Vienna,8926,6,7,5,12,26,39,-13,26
SC Rheindorf,8926,7,6,5,13,18,28,-10,23
FC Salzburg,8927,1,15,7,2,49,19,30,52
SK Sturm Gra,8927,2,12,4,8,31,30,1,40
LASK Linz,8927,3,10,5,9,29,26,3,35
Rapid Vienna,8927,4,8,9,7,36,30,6,33
Mattersburg,8927,5,6,6,12,31,43,-12,24
Vienna,8927,6,6,6,12,25,41,-16,24
SC Rheindorf,8927,7,5,7,12,18,30,-12,22
FC Salzburg,8928,1,14,8,2,43,16,27,50
SK Sturm Gra,8928,2,12,4,8,32,30,2,40
Rapid Vienna,8928,3,9,10,5,37,25,12,37
LASK Linz,8928,4,7,8,9,26,31,-5,29
Mattersburg,8928,5,7,6,11,33,40,-7,27
Vienna,8928,6,6,6,12,25,43,-18,24
SC Rheindorf,8928,7,5,6,13,18,29,-11,21
FC Salzburg,8929,1,15,7,2,45,17,28,52
SK Sturm Gra,8929,2,12,3,9,31,30,1,39
LASK Linz,8929,3,10,5,9,29,26,3,35
Rapid Vienna,8929,4,7,10,7,32,29,3,31
Mattersburg,8929,5,8,5,11,36,42,-6,29
Vienna,8929,6,6,6,12,24,41,-17,24
SC Rheindorf,8929,7,5,6,13,19,31,-12,21
FC Salzburg,8930,1,13,7,4,45,21,24,46
SK Sturm Gra,8930,2,12,6,6,34,28,6,42
LASK Linz,8930,3,9,7,8,30,26,4,34
Rapid Vienna,8930,4,7,10,7,33,31,2,31
Vienna,8930,5,8,5,11,28,39,-11,29
SC Rheindorf,8930,6,6,7,11,22,28,-6,25
Mattersburg,8930,7,5,6,13,28,47,-19,21
FC Salzburg,8931,1,15,7,2,44,18,26,52
SK Sturm Gra,8931,2,12,3,9,31,27,4,39
Rapid Vienna,8931,3,8,11,5,35,29,6,35
LASK Linz,8931,4,9,5,10,30,29,1,32
Mattersburg,8931,5,7,6,11,34,42,-8,27
Vienna,8931,6,6,5,13,24,41,-17,23
SC Rheindorf,8931,7,5,7,12,19,31,-12,22
FC Salzburg,8932,1,16,6,2,45,17,28,54
SK Sturm Gra,8932,2,12,3,9,31,31,0,39
Rapid Vienna,8932,3,9,9,6,38,30,8,36
LASK Linz,8932,4,8,6,10,28,32,-4,30
Vienna,8932,5,7,5,12,27,38,-11,26
Mattersburg,8932,6,6,6,12,27,41,-14,24
SC Rheindorf,8932,7,6,5,13,25,32,-7,23
FC Salzburg,8933,1,14,7,3,43,20,23,49
SK Sturm Gra,8933,2,14,4,6,37,28,9,46
Rapid Vienna,8933,3,8,9,7,38,30,8,33
LASK Linz,8933,4,8,5,11,28,30,-2,29
Mattersburg,8933,5,7,6,11,33,42,-9,27
Vienna,8933,6,6,7,11,24,38,-14,25
SC Rheindorf,8933,7,5,6,13,19,34,-15,21
FC Salzburg,8934,1,14,7,3,44,18,26,49
SK Sturm Gra,8934,2,13,4,7,35,29,6,43
Rapid Vienna,8934,3,10,9,5,38,26,12,39
LASK Linz,8934,4,7,6,11,27,34,-7,27
Vienna,8934,5,7,6,11,24,37,-13,27
SC Rheindorf,8934,6,5,7,12,20,30,-10,22
Mattersburg,8934,7,5,7,12,29,43,-14,22
FC Salzburg,8935,1,14,7,3,45,19,26,49
SK Sturm Gra,8935,2,12,4,8,31,28,3,40
Rapid Vienna,8935,3,8,12,4,35,25,10,36
LASK Linz,8935,4,9,7,8,31,29,2,34
Vienna,8935,5,8,5,11,27,39,-12,29
Mattersburg,8935,6,5,6,13,28,42,-14,21
SC Rheindorf,8935,7,5,5,14,17,32,-15,20
FC Salzburg,8936,1,15,6,3,46,18,28,51
SK Sturm Gra,8936,2,12,5,7,35,33,2,41
Rapid Vienna,8936,3,9,10,5,40,28,12,37
LASK Linz,8936,4,8,6,10,25,29,-4,30
Mattersburg,8936,5,7,6,11,31,41,-10,27
Vienna,8936,6,6,6,12,24,41,-17,24
SC Rheindorf,8936,7,5,5,14,21,32,-11,20
FC Salzburg,8937,1,15,7,2,48,18,30,52
SK Sturm Gra,8937,2,13,4,7,32,26,6,43
Rapid Vienna,8937,3,8,10,6,35,29,6,34
LASK Linz,8937,4,8,8,8,29,28,1,32
Vienna,8937,5,7,5,12,31,41,-10,26
Mattersburg,8937,6,6,6,12,35,50,-15,24
SC Rheindorf,8937,7,4,6,14,17,35,-18,18
FC Salzburg,8938,1,15,6,3,46,20,26,51
Rapid Vienna,8938,2,10,10,4,37,26,11,40
SK Sturm Gra,8938,3,11,6,7,34,31,3,39
LASK Linz,8938,4,8,7,9,27,28,-1,31
Vienna,8938,5,7,5,12,25,40,-15,26
SC Rheindorf,8938,6,5,7,12,19,28,-9,22
Mattersburg,8938,7,5,5,14,27,42,-15,20
FC Salzburg,8939,1,15,7,2,47,18,29,52
SK Sturm Gra,8939,2,12,5,7,34,31,3,41
Rapid Vienna,8939,3,8,11,5,35,26,9,35
LASK Linz,8939,4,8,7,9,28,29,-1,31
Mattersburg,8939,5,7,5,12,33,46,-13,26
Vienna,8939,6,7,5,12,28,41,-13,26
SC Rheindorf,8939,7,4,6,14,18,32,-14,18
FC Salzburg,8940,1,15,6,3,45,18,27,51
Rapid Vienna,8940,2,9,11,4,36,26,10,38
SK Sturm Gra,8940,3,11,4,9,32,33,-1,37
LASK Linz,8940,4,8,8,8,27,27,0,32
Vienna,8940,5,7,5,12,26,39,-13,26
SC Rheindorf,8940,6,6,6,12,22,29,-7,24
Mattersburg,8940,7,5,6,13,28,44,-16,21
FC Salzburg,8941,1,13,6,5,43,23,20,45
SK Sturm Gra,8941,2,13,4,7,36,29,7,43
Rapid Vienna,8941,3,8,9,7,34,33,1,33
Mattersburg,8941,4,9,5,10,34,39,-5,32
LASK Linz,8941,5,8,5,11,28,28,0,29
Vienna,8941,6,7,5,12,27,41,-14,26
SC Rheindorf,8941,7,6,6,12,19,28,-9,24
FC Salzburg,8942,1,14,8,2,49,20,29,50
SK Sturm Gra,8942,2,12,4,8,32,31,1,40
Rapid Vienna,8942,3,8,10,6,36,30,6,34
LASK Linz,8942,4,9,6,9,28,28,0,33
Mattersburg,8942,5,8,5,11,31,40,-9,29
Vienna,8942,6,6,6,12,25,40,-15,24
SC Rheindorf,8942,7,5,5,14,18,30,-12,20
FC Salzburg,8943,1,15,7,2,44,18,26,52
SK Sturm Gra,8943,2,11,6,7,33,30,3,39
Rapid Vienna,8943,3,8,12,4,37,27,10,36
LASK Linz,8943,4,7,8,9,26,28,-2,29
Mattersburg,8943,5,6,7,11,30,40,-10,25
Vienna,8943,6,6,5,13,23,39,-16,23
SC Rheindorf,8943,7,5,7,12,20,31,-11,22
FC Salzburg,8944,1,16,6,2,51,19,32,54
SK Sturm Gra,8944,2,12,4,8,32,30,2,40
Rapid Vienna,8944,3,9,10,5,37,26,11,37
LASK Linz,8944,4,8,5,11,27,32,-5,29
Vienna,8944,5,7,5,12,27,44,-17,26
SC Rheindorf,8944,6,6,5,13,20,28,-8,23
Mattersburg,8944,7,6,5,13,31,46,-15,23
FC Salzburg,8945,1,13,6,5,40,19,21,45
SK Sturm Gra,8945,2,12,5,7,35,27,8,41
Rapid Vienna,8945,3,9,9,6,35,30,5,36
LASK Linz,8945,4,7,7,10,26,34,-8,28
Mattersburg,8945,5,7,6,11,32,38,-6,27
Vienna,8945,6,7,6,11,26,38,-12,27
SC Rheindorf,8945,7,6,7,11,19,27,-8,25
FC Salzburg,8946,1,14,7,3,45,17,28,49
Rapid Vienna,8946,2,10,9,5,39,27,12,39
SK Sturm Gra,8946,3,12,3,9,33,35,-2,39
LASK Linz,8946,4,8,6,10,29,30,-1,30
Vienna,8946,5,7,5,12,26,39,-13,26
Mattersburg,8946,6,6,7,11,29,39,-10,25
SC Rheindorf,8946,7,6,5,13,18,32,-14,23
FC Salzburg,8947,1,14,6,4,44,21,23,48
SK Sturm Gra,8947,2,12,3,9,35,34,1,39
Rapid Vienna,8947,3,8,10,6,37,30,7,34
LASK Linz,8947,4,9,6,9,26,26,0,33
Vienna,8947,5,8,5,11,26,38,-12,29
Mattersburg,8947,6,7,5,12,29,39,-10,26
SC Rheindorf,8947,7,5,7,12,22,31,-9,22
FC Salzburg,8948,1,13,7,4,43,22,21,46
SK Sturm Gra,8948,2,12,5,7,31,26,5,41
Rapid Vienna,8948,3,10,10,4,41,27,14,40
LASK Linz,8948,4,8,5,11,27,30,-3,29
Mattersburg,8948,5,7,5,12,29,41,-12,26
Vienna,8948,6,7,5,12,26,41,-15,26
SC Rheindorf,8948,7,6,5,13,18,28,-10,23
FC Salzburg,8949,1,14,7,3,43,18,25,49
SK Sturm Gra,8949,2,14,3,7,40,30,10,45
Rapid Vienna,8949,3,9,9,6,35,30,5,36
LASK Linz,8949,4,8,7,9,26,28,-2,31
Mattersburg,8949,5,6,8,10,29,38,-9,26
Vienna,8949,6,6,6,12,25,40,-15,24
SC Rheindorf,8949,7,4,6,14,18,32,-14,18
FC Salzburg,8950,1,15,6,3,47,20,27,51
SK Sturm Gra,8950,2,11,4,9,32,34,-2,37
LASK Linz,8950,3,9,6,9,29,27,2,33
Rapid Vienna,8950,4,7,10,7,32,28,4,31
SC Rheindorf,8950,5,8,5,11,21,25,-4,29
Vienna,8950,6,7,6,11,28,40,-12,27
Mattersburg,8950,7,5,7,12,29,44,-15,22
FC Salzburg,8951,1,15,7,2,43,16,27,52
SK Sturm Gra,8951,2,13,4,7,33,27,6,43
Rapid Vienna,8951,3,8,11,5,35,25,10,35
LASK Linz,8951,4,8,6,10,25,27,-2,30
Vienna,8951,5,6,6,12,27,43,-16,24
SC Rheindorf,8951,6,6,5,13,20,32,-12,23
Mattersburg,8951,7,5,7,12,31,44,-13,22
FC Salzburg,8952,1,14,8,2,43,16,27,50
SK Sturm Gra,8952,2,13,3,8,35,30,5,42
Rapid Vienna,8952,3,8,10,6,34,29,5,34
LASK Linz,8952,4,9,5,10,30,31,-1,32
Vienna,8952,5,6,7,11,24,38,-14,25
Mattersburg,8952,6,6,6,12,29,41,-12,24
SC Rheindorf,8952,7,6,5,13,17,27,-10,23
FC Salzburg,8953,1,15,6,3,46,18,28,51
SK Sturm Gra,8953,2,11,4,9,30,30,0,37
Rapid Vienna,8953,3,9,9,6,38,29,9,36
LASK Linz,8953,4,9,6,9,28,30,-2,33
SC Rheindorf,8953,5,7,5,12,23,30,-7,26
Mattersburg,8953,6,7,5,12,32,42,-10,26
Vienna,8953,7,6,5,13,25,43,-18,23
FC Salzburg,8954,1,13,7,4,45,23,22,46
Rapid Vienna,8954,2,11,9,4,40,26,14,42
SK Sturm Gra,8954,3,12,3,9,32,32,0,39
LASK Linz,8954,4,9,6,9,26,26,0,33
Vienna,8954,5,7,6,11,27,39,-12,27
Mattersburg,8954,6,5,8,11,28,39,-11,23
SC Rheindorf,8954,7,4,7,13,15,28,-13,19
FC Salzburg,8955,1,16,6,2,50,17,33,54
SK Sturm Gra,8955,2,12,4,8,35,29,6,40
Rapid Vienna,8955,3,9,10,5,37,28,9,37
Mattersburg,8955,4,8,5,11,35,43,-8,29
LASK Linz,8955,5,7,7,10,28,34,-6,28
Vienna,8955,6,6,5,13,24,44,-20,23
SC Rheindorf,8955,7,4,7,13,20,34,-14,19
FC Salzburg,8956,1,13,8,3,41,18,23,47
SK Sturm Gra,8956,2,12,5,7,31,27,4,41
Rapid Vienna,8956,3,10,9,5,36,27,9,39
Mattersburg,8956,4,7,7,10,30,37,-7,28
LASK Linz,8956,5,7,5,12,24,30,-6,26
SC Rheindorf,8956,6,6,6,12,19,27,-8,24
Vienna,8956,7,6,6,12,24,39,-15,24
FC Salzburg,8957,1,14,7,3,45,20,25,49
SK Sturm Gra,8957,2,12,4,8,34,29,5,40
LASK Linz,8957,3,10,6,8,29,26,3,36
Rapid Vienna,8957,4,8,9,7,34,30,4,33
SC Rheindorf,8957,5,6,7,11,20,28,-8,25
Vienna,8957,6,6,6,12,25,41,-16,24
Mattersburg,8957,7,5,7,12,30,43,-13,22
FC Salzburg,8958,1,15,7,2,49,20,29,52
SK Sturm Gra,8958,2,11,6,7,31,29,2,39
LASK Linz,8958,3,9,6,9,25,25,0,33
Rapid Vienna,8958,4,7,11,6,35,30,5,32
Vienna,8958,5,7,5,12,25,40,-15,26
SC Rheindorf,8958,6,5,8,11,20,29,-9,23
Mattersburg,8958,7,5,7,12,31,43,-12,22
FC Salzburg,8959,1,15,7,2,48,18,30,52
SK Sturm Gra,8959,2,12,3,9,31,33,-2,39
LASK Linz,8959,3,11,5,8,30,27,3,38
Rapid Vienna,8959,4,7,9,8,33,29,4,30
Mattersburg,8959,5,6,7,11,32,42,-10,25
SC Rheindorf,8959,6,6,6,12,19,28,-9,24
Vienna,8959,7,6,5,13,26,42,-16,23
FC Salzburg,8960,1,16,6,2,45,17,28,54
SK Sturm Gra,8960,2,12,3,9,32,30,2,39
Rapid Vienna,8960,3,8,11,5,38,30,8,35
LASK Linz,8960,4,8,6,10,29,31,-2,30
Mattersburg,8960,5,7,5,12,30,40,-10,26
SC Rheindorf,8960,6,6,6,12,20,29,-9,24
Vienna,8960,7,6,5,13,23,40,-17,23
FC Salzburg,8961,1,13,7,4,42,20,22,46
SK Sturm Gra,8961,2,12,4,8,33,29,4,40
Rapid Vienna,8961,3,8,12,4,37,28,9,36
LASK Linz,8961,4,8,6,10,26,29,-3,30
Mattersburg,8961,5,8,6,10,31,38,-7,30
Vienna,8961,6,6,6,12,26,41,-15,24
SC Rheindorf,8961,7,5,7,12,22,32,-10,22
FC Salzburg,8962,1,14,6,4,41,19,22,48
SK Sturm Gra,8962,2,13,3,8,37,30,7,42
Rapid Vienna,8962,3,8,11,5,35,30,5,35
LASK Linz,8962,4,7,7,10,24,27,-3,28
Mattersburg,8962,5,7,6,11,31,39,-8,27
SC Rheindorf,8962,6,6,7,11,21,29,-8,25
Vienna,8962,7,6,6,12,24,39,-15,24
FC Salzburg,8963,1,14,7,3,47,20,27,49
SK Sturm Gra,8963,2,14,3,7,35,30,5,45
Rapid Vienna,8963,3,8,10,6,36,27,9,34
Mattersburg,8963,4,8,5,11,36,41,-5,29
LASK Linz,8963,5,7,7,10,25,33,-8,28
Vienna,8963,6,6,6,12,26,41,-15,24
SC Rheindorf,8963,7,5,6,13,16,29,-13,21
FC Salzburg,8964,1,15,7,2,47,18,29,52
SK Sturm Gra,8964,2,12,5,7,32,29,3,41
Rapid Vienna,8964,3,9,9,6,36,29,7,36
LASK Linz,8964,4,9,5,10,27,27,0,32
Mattersburg,8964,5,6,6,12,32,44,-12,24
Vienna,8964,6,6,6,12,25,41,-16,24
SC Rheindorf,8964,7,5,6,13,20,31,-11,21
FC Salzburg,8965,1,13,7,4,46,24,22,46
SK Sturm Gra,8965,2,12,4,8,31,29,2,40
Rapid Vienna,8965,3,9,10,5,36,25,11,37
LASK Linz,8965,4,9,6,9,27,28,-1,33
Mattersburg,8965,5,7,6,11,37,42,-5,27
Vienna,8965,6,7,5,12,27,42,-15,26
SC Rheindorf,8965,7,5,6,13,19,33,-14,21
FC Salzburg,8966,1,15,7,2,47,19,28,52
SK Sturm Gra,8966,2,13,3,8,34,29,5,42
Rapid Vienna,8966,3,9,10,5,37,29,8,37
LASK Linz,8966,4,8,6,10,26,30,-4,30
Vienna,8966,5,7,6,11,25,38,-13,27
SC Rheindorf,8966,6,6,5,13,21,29,-8,23
Mattersburg,8966,7,5,5,14,28,44,-16,20
FC Salzburg,8967,1,12,8,4,42,22,20,44
SK Sturm Gra,8967,2,13,5,6,36,29,7,44
Rapid Vienna,8967,3,8,11,5,35,26,9,35
Vienna,8967,4,8,5,11,28,39,-11,29
LASK Linz,8967,5,7,6,11,25,33,-8,27
Mattersburg,8967,6,7,5,12,33,43,-10,26
SC Rheindorf,8967,7,6,6,12,19,26,-7,24
FC Salzburg,8968,1,15,7,2,46,19,27,52
SK Sturm Gra,8968,2,12,4,8,31,28,3,40
Rapid Vienna,8968,3,9,9,6,37,29,8,36
LASK Linz,8968,4,8,7,9,28,29,-1,31
Vienna,8968,5,7,5,12,27,40,-13,26
Mattersburg,8968,6,6,6,12,30,43,-13,24
SC Rheindorf,8968,7,5,6,13,19,30,-11,21
FC Salzburg,8969,1,14,6,4,45,18,27,48
Rapid Vienna,8969,2,10,9,5,41,27,14,39
SK Sturm Gra,8969,3,11,4,9,32,35,-3,37
LASK Linz,8969,4,9,6,9,29,31,-2,33
Mattersburg,8969,5,7,5,12,29,41,-12,26
Vienna,8969,6,7,5,12,25,39,-14,26
SC Rheindorf,8969,7,5,7,12,21,31,-10,22
FC Salzburg,8970,1,16,6,2,45,17,28,54
SK Sturm Gra,8970,2,12,4,8,36,34,2,40
Rapid Vienna,8970,3,8,10,6,39,31,8,34
LASK Linz,8970,4,9,5,10,29,31,-2,32
Vienna,8970,5,7,5,12,28,39,-11,26
Mattersburg,8970,6,6,5,13,33,49,-16,23
SC Rheindorf,8970,7,5,7,12,22,31,-9,22
FC Salzburg,8971,1,14,7,3,43,19,24,49
SK Sturm Gra,8971,2,14,3,7,33,25,8,45
Rapid Vienna,8971,3,9,9,6,37,28,9,36
LASK Linz,8971,4,9,5,10,28,31,-3,32
Vienna,8971,5,6,7,11,24,38,-14,25
Mattersburg,8971,6,6,6,12,29,41,-12,24
SC Rheindorf,8971,7,5,5,14,19,31,-12,20
FC Salzburg,8972,1,15,7,2,47,18,29,52
SK Sturm Gra,8972,2,12,5,7,33,28,5,41
Rapid Vienna,8972,3,7,12,5,35,29,6,33
LASK Linz,8972,4,7,7,10,26,31,-5,28
Mattersburg,8972,5,7,6,11,33,43,-10,27
SC Rheindorf,8972,6,6,6,12,23,31,-8,24
Vienna,8972,7,6,5,13,23,40,-17,23
SK Sturm Gra,8973,1,14,4,6,36,27,9,46
FC Salzburg,8973,2,12,7,5,41,23,18,43
Rapid Vienna,8973,3,9,10,5,34,25,9,37
LASK Linz,8973,4,8,6,10,25,28,-3,30
Vienna,8973,5,7,6,11,26,38,-12,27
Mattersburg,8973,6,5,9,10,29,39,-10,24
SC Rheindorf,8973,7,4,8,12,19,30,-11,20
FC Salzburg,8974,1,13,7,4,41,21,20,46
SK Sturm Gra,8974,2,14,4,6,34,26,8,46
Rapid Vienna,8974,3,9,9,6,37,27,10,36
LASK Linz,8974,4,8,5,11,28,33,-5,29
Vienna,8974,5,7,6,11,28,40,-12,27
Mattersburg,8974,6,7,5,12,34,43,-9,26
SC Rheindorf,8974,7,5,6,13,17,29,-12,21
FC Salzburg,8975,1,15,6,3,46,18,28,51
Rapid Vienna,8975,2,10,10,4,37,26,11,40
SK Sturm Gra,8975,3,11,5,8,30,30,0,38
LASK Linz,8975,4,9,6,9,27,26,1,33
Vienna,8975,5,7,5,12,24,39,-15,26
SC Rheindorf,8975,6,6,5,13,21,29,-8,23
Mattersburg,8975,7,5,5,14,28,45,-17,20
FC Salzburg,8976,1,14,6,4,44,19,25,48
SK Sturm Gra,8976,2,12,3,9,33,31,2,39
LASK Linz,8976,3,9,7,8,31,29,2,34
Rapid Vienna,8976,4,8,9,7,35,31,4,33
Vienna,8976,5,7,5,12,26,42,-16,26
SC Rheindorf,8976,6,6,7,11,20,27,-7,25
Mattersburg,8976,7,6,7,11,33,43,-10,25
FC Salzburg,8977,1,14,8,2,45,19,26,50
SK Sturm Gra,8977,2,12,3,9,34,35,-1,39
LASK Linz,8977,3,10,5,9,32,29,3,35
Rapid Vienna,8977,4,7,9,8,33,31,2,30
SC Rheindorf,8977,5,7,5,12,23,27,-4,26
Mattersburg,8977,6,6,7,11,33,45,-12,25
Vienna,8977,7,6,7,11,26,40,-14,25
FC Salzburg,8978,1,12,9,3,40,18,22,45
SK Sturm Gra,8978,2,13,4,7,32,28,4,43
Rapid Vienna,8978,3,9,10,5,36,26,10,37
LASK Linz,8978,4,7,8,9,24,26,-2,29
Vienna,8978,5,7,6,11,26,38,-12,27
SC Rheindorf,8978,6,6,6,12,23,32,-9,24
Mattersburg,8978,7,5,7,12,30,43,-13,22
FC Salzburg,8979,1,14,7,3,44,20,24,49
Rapid Vienna,8979,2,9,10,5,36,28,8,37
SK Sturm Gra,8979,3,11,4,9,31,33,-2,37
LASK Linz,8979,4,9,6,9,32,28,4,33
Vienna,8979,5,7,5,12,25,39,-14,26
SC Rheindorf,8979,6,6,6,12,19,28,-9,24
Mattersburg,8979,7,6,6,12,32,43,-11,24
FC Salzburg,8980,1,15,7,2,44,18,26,52
SK Sturm Gra,8980,2,12,5,7,33,30,3,41
Rapid Vienna,8980,3,9,9,6,35,26,9,36
LASK Linz,8980,4,8,5,11,27,30,-3,29
SC Rheindorf,8980,5,6,6,12,20,29,-9,24
Mattersburg,8980,6,6,6,12,30,41,-11,24
Vienna,8980,7,6,6,12,24,39,-15,24
FC Salzburg,8981,1,15,7,2,50,21,29,52
SK Sturm Gra,8981,2,13,4,7,32,26,6,43
Rapid Vienna,8981,3,7,11,6,34,29,5,32
LASK Linz,8981,4,8,6,10,27,27,0,30
SC Rheindorf,8981,5,6,7,11,19,27,-8,25
Mattersburg,8981,6,6,6,12,32,45,-13,24
Vienna,8981,7,6,5,13,27,46,-19,23
FC Salzburg,8982,1,13,7,4,41,20,21,46
SK Sturm Gra,8982,2,12,6,6,31,26,5,42
Rapid Vienna,8982,3,8,11,5,38,29,9,35
Vienna,8982,4,8,5,11,26,38,-12,29
LASK Linz,8982,5,7,6,11,27,32,-5,27
Mattersburg,8982,6,7,6,11,31,38,-7,27
SC Rheindorf,8982,7,5,7,12,21,32,-11,22
FC Salzburg,8983,1,13,8,3,43,19,24,47
SK Sturm Gra,8983,2,13,4,7,33,27,6,43
Rapid Vienna,8983,3,10,10,4,37,26,11,40
LASK Linz,8983,4,8,6,10,27,29,-2,30
Vienna,8983,5,6,6,12,25,41,-16,24
Mattersburg,8983,6,5,8,11,30,42,-12,23
SC Rheindorf,8983,7,4,8,12,17,28,-11,20
FC Salzburg,8984,1,15,7,2,47,21,26,52
SK Sturm Gra,8984,2,14,3,7,35,26,9,45
Rapid Vienna,8984,3,8,9,7,35,30,5,33
LASK Linz,8984,4,8,7,9,26,28,-2,31
Vienna,8984,5,7,5,12,26,40,-14,26
Mattersburg,8984,6,6,7,11,30,40,-10,25
SC Rheindorf,8984,7,4,6,14,17,31,-14,18
FC Salzburg,8985,1,14,7,3,43,17,26,49
SK Sturm Gra,8985,2,14,3,7,37,31,6,45
Rapid Vienna,8985,3,8,10,6,39,29,10,34
LASK Linz,8985,4,9,5,10,25,29,-4,32
Vienna,8985,5,7,5,12,25,38,-13,26
Mattersburg,8985,6,6,6,12,29,42,-13,24
SC Rheindorf,8985,7,5,6,13,19,31,-12,21
FC Salzburg,8986,1,15,7,2,47,18,29,52
SK Sturm Gra,8986,2,12,5,7,30,27,3,41
Rapid Vienna,8986,3,9,11,4,36,26,10,38
LASK Linz,8986,4,8,6,10,25,30,-5,30
Mattersburg,8986,5,8,5,11,35,39,-4,29
Vienna,8986,6,6,5,13,23,40,-17,23
SC Rheindorf,8986,7,4,5,15,18,34,-16,17
FC Salzburg,8987,1,15,6,3,44,20,24,51
SK Sturm Gra,8987,2,13,4,7,37,32,5,43
Rapid Vienna,8987,3,9,10,5,39,31,8,37
LASK Linz,8987,4,8,5,11,28,31,-3,29
Mattersburg,8987,5,7,5,12,30,39,-9,26
Vienna,8987,6,7,5,12,26,39,-13,26
SC Rheindorf,8987,7,5,5,14,20,32,-12,20
FC Salzburg,8988,1,15,7,2,44,17,27,52
SK Sturm Gra,8988,2,13,3,8,34,27,7,42
Rapid Vienna,8988,3,9,10,5,33,26,7,37
LASK Linz,8988,4,8,6,10,26,28,-2,30
Mattersburg,8988,5,6,7,11,34,45,-11,25
Vienna,8988,6,6,5,13,25,41,-16,23
SC Rheindorf,8988,7,5,6,13,18,30,-12,21
FC Salzburg,8989,1,14,7,3,43,18,25,49
SK Sturm Gra,8989,2,12,4,8,29,29,0,40
Rapid Vienna,8989,3,8,12,4,38,26,12,36
LASK Linz,8989,4,7,7,10,28,31,-3,28
Vienna,8989,5,7,5,12,24,38,-14,26
Mattersburg,8989,6,6,7,11,30,41,-11,25
SC Rheindorf,8989,7,6,6,12,23,32,-9,24
FC Salzburg,8990,1,15,6,3,48,21,27,51
SK Sturm Gra,8990,2,12,4,8,31,30,1,40
Rapid Vienna,8990,3,8,11,5,36,28,8,35
LASK Linz,8990,4,8,7,9,31,29,2,31
Vienna,8990,5,7,6,11,28,39,-11,27
SC Rheindorf,8990,6,6,6,12,21,29,-8,24
Mattersburg,8990,7,5,6,13,30,49,-19,21
FC Salzburg,8991,1,14,7,3,43,20,23,49
SK Sturm Gra,8991,2,12,6,6,32,27,5,42
LASK Linz,8991,3,9,7,8,30,26,4,34
Rapid Vienna,8991,4,7,9,8,33,30,3,30
Mattersburg,8991,5,8,6,10,36,41,-5,30
Vienna,8991,6,6,5,13,25,42,-17,23
SC Rheindorf,8991,7,5,6,13,19,32,-13,21
FC Salzburg,8992,1,16,6,2,50,18,32,54
SK Sturm Gra,8992,2,13,4,7,35,30,5,43
Rapid Vienna,8992,3,8,9,7,33,28,5,33
LASK Linz,8992,4,8,5,11,26,30,-4,29
Mattersburg,8992,5,7,5,12,32,41,-9,26
Vienna,8992,6,7,5,12,25,40,-15,26
SC Rheindorf,8992,7,5,6,13,18,32,-14,21
FC Salzburg,8993,1,14,8,2,51,18,33,50
SK Sturm Gra,8993,2,13,4,7,33,28,5,43
Rapid Vienna,8993,3,7,12,5,34,28,6,33
LASK Linz,8993,4,8,7,9,28,29,-1,31
Vienna,8993,5,7,5,12,25,42,-17,26
Mattersburg,8993,6,6,6,12,30,46,-16,24
SC Rheindorf,8993,7,5,6,13,23,33,-10,21
FC Salzburg,8994,1,15,7,2,49,16,33,52
Rapid Vienna,8994,2,10,9,5,36,27,9,39
SK Sturm Gra,8994,3,11,5,8,30,31,-1,38
LASK Linz,8994,4,9,5,10,26,26,0,32
Vienna,8994,5,7,5,12,25,40,-15,26
Mattersburg,8994,6,6,5,13,28,43,-15,23
SC Rheindorf,8994,7,5,6,13,17,28,-11,21
FC Salzburg,8995,1,15,7,2,46,16,30,52
SK Sturm Gra,8995,2,13,3,8,34,28,6,42
Rapid Vienna,8995,3,7,11,6,34,32,2,32
Mattersburg,8995,4,8,5,11,31,40,-9,29
LASK Linz,8995,5,7,7,10,26,30,-4,28
Vienna,8995,6,6,6,12,23,38,-15,24
SC Rheindorf,8995,7,5,7,12,21,31,-10,22
FC Salzburg,8996,1,14,8,2,46,19,27,50
SK Sturm Gra,8996,2,12,4,8,32,28,4,40
Rapid Vienna,8996,3,8,10,6,34,29,5,34
LASK Linz,8996,4,8,6,10,24,27,-3,30
SC Rheindorf,8996,5,7,5,12,21,28,-7,26
Vienna,8996,6,7,5,12,30,41,-11,26
Mattersburg,8996,7,6,6,12,29,44,-15,24
FC Salzburg,8997,1,13,7,4,42,21,21,46
SK Sturm Gra,8997,2,14,4,6,35,25,10,46
Rapid Vienna,8997,3,9,10,5,39,30,9,37
LASK Linz,8997,4,8,6,10,27,29,-2,30
Vienna,8997,5,8,5,11,27,37,-10,29
Mattersburg,8997,6,6,5,13,30,43,-13,23
SC Rheindorf,8997,7,4,7,13,18,33,-15,19
FC Salzburg,8998,1,13,7,4,44,22,22,46
SK Sturm Gra,8998,2,13,4,7,34,29,5,43
Rapid Vienna,8998,3,9,9,6,36,28,8,36
LASK Linz,8998,4,9,6,9,29,28,1,33
Mattersburg,8998,5,7,6,11,36,45,-9,27
Vienna,8998,6,7,5,12,27,40,-13,26
SC Rheindorf,8998,7,5,5,14,19,33,-14,20
FC Salzburg,8999,1,16,6,2,51,19,32,54
SK Sturm Gra,8999,2,12,5,7,32,30,2,41
Rapid Vienna,8999,3,7,10,7,34,30,4,31
LASK Linz,8999,4,8,7,9,27,28,-1,31
Mattersburg,8999,5,6,7,11,29,40,-11,25
Vienna,8999,6,6,6,12,26,42,-16,24
SC Rheindorf,8999,7,4,9,11,17,27,-10,21
FC Salzburg,9000,1,13,9,2,41,16,25,48
Rapid Vienna,9000,2,9,11,4,38,26,12,38
SK Sturm Gra,9000,3,11,5,8,31,30,1,38
LASK Linz,9000,4,8,6,10,28,30,-2,30
Vienna,9000,5,7,6,11,26,37,-11,27
SC Rheindorf,9000,6,6,7,11,19,26,-7,25
Mattersburg,9000,7,5,6,13,26,44,-18,21
FC Salzburg,9001,1,15,6,3,49,19,30,51
SK Sturm Gra,9001,2,12,4,8,29,29,0,40
Rapid Vienna,9001,3,9,11,4,38,24,14,38
LASK Linz,9001,4,8,7,9,28,29,-1,31
Vienna,9001,5,7,5,12,27,41,-14,26
Mattersburg,9001,6,6,6,12,34,49,-15,24
SC Rheindorf,9001,7,5,5,14,18,32,-14,20
FC Salzburg,9002,1,16,6,2,46,16,30,54
Rapid Vienna,9002,2,9,10,5,36,25,11,37
SK Sturm Gra,9002,3,11,4,9,29,30,-1,37
LASK Linz,9002,4,9,5,10,28,31,-3,32
Vienna,9002,5,7,5,12,25,39,-14,26
SC Rheindorf,9002,6,6,7,11,21,25,-4,25
Mattersburg,9002,7,5,5,14,26,45,-19,20
FC Salzburg,9003,1,14,7,3,42,18,24,49
SK Sturm Gra,9003,2,12,5,7,34,30,4,41
Rapid Vienna,9003,3,10,10,4,37,25,12,40
LASK Linz,9003,4,8,6,10,29,29,0,30
Mattersburg,9003,5,8,5,11,35,41,-6,29
Vienna,9003,6,6,5,13,24,42,-18,23
SC Rheindorf,9003,7,4,6,14,20,36,-16,18
FC Salzburg,9004,1,16,6,2,47,18,29,54
Rapid Vienna,9004,2,10,9,5,37,26,11,39
SK Sturm Gra,9004,3,12,3,9,31,29,2,39
LASK Linz,9004,4,9,5,10,27,29,-2,32
Mattersburg,9004,5,6,6,12,32,41,-9,24
Vienna,9004,6,6,5,13,23,43,-20,23
SC Rheindorf,9004,7,5,6,13,19,30,-11,21
FC Salzburg,9005,1,15,6,3,45,21,24,51
SK Sturm Gra,9005,2,12,4,8,32,29,3,40
Rapid Vienna,9005,3,10,9,5,36,26,10,39
LASK Linz,9005,4,8,7,9,27,27,0,31
Vienna,9005,5,7,5,12,26,39,-13,26
Mattersburg,9005,6,6,5,13,30,44,-14,23
SC Rheindorf,9005,7,5,6,13,19,29,-10,21
FC Salzburg,9006,1,14,7,3,45,20,25,49
SK Sturm Gra,9006,2,13,4,7,32,27,5,43
Rapid Vienna,9006,3,8,11,5,37,29,8,35
LASK Linz,9006,4,9,6,9,30,30,0,33
Mattersburg,9006,5,6,6,12,32,44,-12,24
Vienna,9006,6,6,6,12,26,41,-15,24
SC Rheindorf,9006,7,5,6,13,19,30,-11,21
FC Salzburg,9007,1,13,7,4,43,22,21,46
SK Sturm Gra,9007,2,12,5,7,32,29,3,41
Rapid Vienna,9007,3,9,9,6,39,27,12,36
LASK Linz,9007,4,9,7,8,30,28,2,34
Mattersburg,9007,5,7,6,11,32,40,-8,27
Vienna,9007,6,6,5,13,23,40,-17,23
SC Rheindorf,9007,7,5,7,12,22,35,-13,22
FC Salzburg,9008,1,15,7,2,47,18,29,52
SK Sturm Gra,9008,2,13,4,7,37,30,7,43
Rapid Vienna,9008,3,8,10,6,35,30,5,34
LASK Linz,9008,4,9,5,10,31,33,-2,32
Vienna,9008,5,7,5,12,25,39,-14,26
Mattersburg,9008,6,6,5,13,31,44,-13,23
SC Rheindorf,9008,7,5,6,13,19,31,-12,21
FC Salzburg,9009,1,13,8,3,43,20,23,47
SK Sturm Gra,9009,2,12,3,9,30,29,1,39
Rapid Vienna,9009,3,9,11,4,34,24,10,38
LASK Linz,9009,4,9,5,10,28,27,1,32
SC Rheindorf,9009,5,7,6,11,20,26,-6,27
Vienna,9009,6,6,7,11,26,40,-14,25
Mattersburg,9009,7,5,6,13,29,44,-15,21
FC Salzburg,9010,1,15,6,3,47,19,28,51
SK Sturm Gra,9010,2,13,3,8,34,28,6,42
LASK Linz,9010,3,10,6,8,30,28,2,36
Rapid Vienna,9010,4,8,9,7,37,32,5,33
Vienna,9010,5,8,5,11,30,39,-9,29
Mattersburg,9010,6,6,5,13,29,44,-15,23
SC Rheindorf,9010,7,4,6,14,16,33,-17,18
FC Salzburg,9011,1,15,6,3,44,18,26,51
SK Sturm Gra,9011,2,12,5,7,33,28,5,41
Rapid Vienna,9011,3,9,10,5,39,29,10,37
LASK Linz,9011,4,9,5,10,28,30,-2,32
Vienna,9011,5,6,6,12,23,39,-16,24
SC Rheindorf,9011,6,5,7,12,20,31,-11,22
Mattersburg,9011,7,5,7,12,30,42,-12,22
FC Salzburg,9012,1,15,6,3,48,20,28,51
SK Sturm Gra,9012,2,14,3,7,34,28,6,45
Rapid Vienna,9012,3,8,10,6,37,29,8,34
LASK Linz,9012,4,7,6,11,26,30,-4,27
SC Rheindorf,9012,5,7,5,12,20,29,-9,26
Vienna,9012,6,7,5,12,27,42,-15,26
Mattersburg,9012,7,6,5,13,30,44,-14,23
FC Salzburg,9013,1,14,8,2,45,16,29,50
SK Sturm Gra,9013,2,12,5,7,33,31,2,41
Rapid Vienna,9013,3,8,11,5,37,31,6,35
LASK Linz,9013,4,8,5,11,29,30,-1,29
Mattersburg,9013,5,8,5,11,30,40,-10,29
Vienna,9013,6,6,6,12,23,38,-15,24
SC Rheindorf,9013,7,5,6,13,18,29,-11,21
FC Salzburg,9014,1,14,7,3,43,17,26,49
SK Sturm Gra,9014,2,12,4,8,34,32,2,40
Rapid Vienna,9014,3,9,10,5,37,27,10,37
LASK Linz,9014,4,8,5,11,26,31,-5,29
Mattersburg,9014,5,7,6,11,32,41,-9,27
Vienna,9014,6,7,5,12,26,40,-14,26
SC Rheindorf,9014,7,5,7,12,19,29,-10,22
FC Salzburg,9015,1,13,8,3,40,18,22,47
SK Sturm Gra,9015,2,12,5,7,32,27,5,41
Rapid Vienna,9015,3,8,11,5,33,26,7,35
LASK Linz,9015,4,8,6,10,27,29,-2,30
Vienna,9015,5,7,6,11,26,38,-12,27
SC Rheindorf,9015,6,7,5,12,21,29,-8,26
Mattersburg,9015,7,6,5,13,28,40,-12,23
FC Salzburg,9016,1,15,7,2,50,17,33,52
SK Sturm Gra,9016,2,13,4,7,32,28,4,43
Rapid Vienna,9016,3,8,11,5,37,27,10,35
LASK Linz,9016,4,7,8,9,26,29,-3,29
Mattersburg,9016,5,6,7,11,33,43,-10,25
Vienna,9016,6,6,5,13,24,45,-21,23
SC Rheindorf,9016,7,4,8,12,19,32,-13,20
FC Salzburg,9017,1,14,6,4,45,21,24,48
SK Sturm Gra,9017,2,13,4,7,31,25,6,43
Rapid Vienna,9017,3,9,9,6,35,28,7,36
LASK Linz,9017,4,10,6,8,29,26,3,36
Vienna,9017,5,7,5,12,26,41,-15,26
Mattersburg,9017,6,6,6,12,30,42,-12,24
SC Rheindorf,9017,7,4,6,14,18,31,-13,18
FC Salzburg,9018,1,15,6,3,48,19,29,51
SK Sturm Gra,9018,2,12,4,8,35,31,4,40
Rapid Vienna,9018,3,8,11,5,37,31,6,35
LASK Linz,9018,4,9,6,9,29,31,-2,33
Mattersburg,9018,5,8,5,11,34,41,-7,29
Vienna,9018,6,6,5,13,25,42,-17,23
SC Rheindorf,9018,7,5,5,14,18,31,-13,20
FC Salzburg,9019,1,15,6,3,45,19,26,51
Rapid Vienna,9019,2,11,9,4,39,26,13,42
SK Sturm Gra,9019,3,13,3,8,35,29,6,42
Mattersburg,9019,4,7,6,11,33,41,-8,27
LASK Linz,9019,5,7,5,12,26,33,-7,26
Vienna,9019,6,6,6,12,26,43,-17,24
SC Rheindorf,9019,7,5,5,14,18,31,-13,20
FC Salzburg,9020,1,13,7,4,41,22,19,46
SK Sturm Gra,9020,2,12,5,7,32,27,5,41
Rapid Vienna,9020,3,9,11,4,38,25,13,38
LASK Linz,9020,4,8,6,10,25,29,-4,30
Mattersburg,9020,5,8,6,10,31,37,-6,30
Vienna,9020,6,6,5,13,24,41,-17,23
SC Rheindorf,9020,7,5,6,13,18,28,-10,21
FC Salzburg,9021,1,15,7,2,48,17,31,52
SK Sturm Gra,9021,2,13,5,6,35,27,8,44
LASK Linz,9021,3,9,7,8,31,27,4,34
Rapid Vienna,9021,4,7,10,7,34,31,3,31
Vienna,9021,5,7,5,12,26,42,-16,26
Mattersburg,9021,6,6,5,13,29,46,-17,23
SC Rheindorf,9021,7,5,5,14,17,30,-13,20
FC Salzburg,9022,1,14,6,4,43,20,23,48
SK Sturm Gra,9022,2,14,3,7,38,29,9,45
Rapid Vienna,9022,3,9,10,5,38,27,11,37
LASK Linz,9022,4,8,7,9,27,30,-3,31
Mattersburg,9022,5,6,7,11,29,40,-11,25
Vienna,9022,6,6,6,12,23,38,-15,24
SC Rheindorf,9022,7,4,7,13,18,32,-14,19
FC Salzburg,9023,1,14,8,2,46,20,26,50
SK Sturm Gra,9023,2,12,5,7,33,30,3,41
Rapid Vienna,9023,3,8,10,6,38,31,7,34
LASK Linz,9023,4,8,7,9,31,30,1,31
Mattersburg,9023,5,6,8,10,35,41,-6,26
Vienna,9023,6,6,5,13,25,44,-19,23
SC Rheindorf,9023,7,5,7,12,17,29,-12,22
FC Salzburg,9024,1,16,6,2,49,19,30,54
SK Sturm Gra,9024,2,12,5,7,35,30,5,41
Rapid Vienna,9024,3,8,9,7,32,28,4,33
LASK Linz,9024,4,7,7,10,25,29,-4,28
Mattersburg,9024,5,7,6,11,35,42,-7,27
SC Rheindorf,9024,6,6,6,12,22,32,-10,24
Vienna,9024,7,6,5,13,24,42,-18,23
FC Salzburg,9025,1,15,6,3,44,18,26,51
SK Sturm Gra,9025,2,14,3,7,33,28,5,45
LASK Linz,9025,3,10,5,9,29,27,2,35
Rapid Vienna,9025,4,8,9,7,34,28,6,33
Vienna,9025,5,7,5,12,28,40,-12,26
Mattersburg,9025,6,6,5,13,28,42,-14,23
SC Rheindorf,9025,7,5,5,14,18,31,-13,20
FC Salzburg,9026,1,13,7,4,44,21,23,46
SK Sturm Gra,9026,2,12,4,8,32,32,0,40
Rapid Vienna,9026,3,9,9,6,36,29,7,36
LASK Linz,9026,4,10,6,8,31,26,5,36
Mattersburg,9026,5,7,7,10,34,39,-5,28
Vienna,9026,6,7,5,12,25,40,-15,26
SC Rheindorf,9026,7,4,6,14,15,30,-15,18
FC Salzburg,9027,1,13,8,3,42,19,23,47
SK Sturm Gra,9027,2,14,4,6,38,29,9,46
Rapid Vienna,9027,3,9,9,6,34,26,8,36
LASK Linz,9027,4,8,7,9,25,28,-3,31
Vienna,9027,5,7,5,12,29,40,-11,26
Mattersburg,9027,6,5,7,12,31,47,-16,22
SC Rheindorf,9027,7,5,6,13,20,30,-10,21
FC Salzburg,9028,1,14,7,3,42,18,24,49
SK Sturm Gra,9028,2,13,4,7,33,27,6,43
Rapid Vienna,9028,3,9,9,6,36,25,11,36
LASK Linz,9028,4,8,7,9,25,29,-4,31
Mattersburg,9028,5,7,6,11,33,39,-6,27
Vienna,9028,6,7,5,12,24,39,-15,26
SC Rheindorf,9028,7,4,6,14,17,33,-16,18
FC Salzburg,9029,1,13,8,3,45,18,27,47
SK Sturm Gra,9029,2,13,5,6,33,27,6,44
Rapid Vienna,9029,3,9,10,5,35,26,9,37
LASK Linz,9029,4,8,5,11,28,31,-3,29
Vienna,9029,5,7,6,11,25,38,-13,27
SC Rheindorf,9029,6,6,5,13,20,28,-8,23
Mattersburg,9029,7,6,5,13,30,48,-18,23
FC Salzburg,9030,1,16,6,2,47,16,31,54
SK Sturm Gra,9030,2,12,5,7,34,30,4,41
Rapid Vienna,9030,3,7,12,5,35,28,7,33
LASK Linz,9030,4,8,6,10,28,33,-5,30
Vienna,9030,5,7,5,12,29,41,-12,26
Mattersburg,9030,6,6,6,12,32,45,-13,24
SC Rheindorf,9030,7,4,8,12,18,30,-12,20
FC Salzburg,9031,1,14,7,3,44,20,24,49
SK Sturm Gra,9031,2,12,4,8,32,29,3,40
Rapid Vienna,9031,3,9,10,5,38,27,11,37
LASK Linz,9031,4,9,6,9,27,26,1,33
Vienna,9031,5,7,6,11,28,41,-13,27
SC Rheindorf,9031,6,6,5,13,18,31,-13,23
Mattersburg,9031,7,5,6,13,30,43,-13,21
FC Salzburg,9032,1,14,8,2,46,18,28,50
SK Sturm Gra,9032,2,13,3,8,33,30,3,42
Rapid Vienna,9032,3,8,9,7,34,30,4,33
SC Rheindorf,9032,4,8,5,11,25,30,-5,29
LASK Linz,9032,5,7,6,11,26,30,-4,27
Vienna,9032,6,7,6,11,26,38,-12,27
Mattersburg,9032,7,5,7,12,29,43,-14,22
FC Salzburg,9033,1,14,6,4,43,19,24,48
SK Sturm Gra,9033,2,15,3,6,37,28,9,48
Rapid Vienna,9033,3,8,10,6,35,28,7,34
LASK Linz,9033,4,8,5,11,26,32,-6,29
Mattersburg,9033,5,7,6,11,36,43,-7,27
Vienna,9033,6,6,6,12,25,40,-15,24
SC Rheindorf,9033,7,5,6,13,22,34,-12,21
FC Salzburg,9034,1,14,6,4,45,20,25,48
SK Sturm Gra,9034,2,14,3,7,35,28,7,45
Rapid Vienna,9034,3,8,10,6,39,29,10,34
SC Rheindorf,9034,4,7,6,11,22,26,-4,27
Vienna,9034,5,7,6,11,24,37,-13,27
LASK Linz,9034,6,7,5,12,24,36,-12,26
Mattersburg,9034,7,6,6,12,28,41,-13,24
FC Salzburg,9035,1,13,7,4,44,18,26,46
SK Sturm Gra,9035,2,12,5,7,31,27,4,41
LASK Linz,9035,3,10,6,8,31,27,4,36
Rapid Vienna,9035,4,8,10,6,35,28,7,34
Mattersburg,9035,5,6,7,11,30,39,-9,25
SC Rheindorf,9035,6,6,6,12,18,29,-11,24
Vienna,9035,7,6,5,13,23,44,-21,23
FC Salzburg,9036,1,15,7,2,45,17,28,52
SK Sturm Gra,9036,2,11,4,9,29,29,0,37
Rapid Vienna,9036,3,8,10,6,35,28,7,34
LASK Linz,9036,4,8,6,10,25,28,-3,30
SC Rheindorf,9036,5,7,6,11,20,26,-6,27
Vienna,9036,6,7,5,12,27,40,-13,26
Mattersburg,9036,7,6,6,12,30,43,-13,24
FC Salzburg,9037,1,15,7,2,46,15,31,52
SK Sturm Gra,9037,2,13,3,8,36,30,6,42
Rapid Vienna,9037,3,9,10,5,34,26,8,37
LASK Linz,9037,4,8,5,11,26,29,-3,29
SC Rheindorf,9037,5,7,5,12,21,29,-8,26
Mattersburg,9037,6,6,5,13,30,46,-16,23
Vienna,9037,7,6,5,13,24,42,-18,23
FC Salzburg,9038,1,13,9,2,40,16,24,48
SK Sturm Gra,9038,2,12,6,6,32,27,5,42
Rapid Vienna,9038,3,8,11,5,33,25,8,35
LASK Linz,9038,4,8,6,10,26,28,-2,30
Mattersburg,9038,5,6,7,11,29,39,-10,25
Vienna,9038,6,6,6,12,24,39,-15,24
SC Rheindorf,9038,7,6,5,13,19,29,-10,23
FC Salzburg,9039,1,14,7,3,46,22,24,49
Rapid Vienna,9039,2,9,9,6,38,30,8,36
SK Sturm Gra,9039,3,11,3,10,31,32,-1,36
LASK Linz,9039,4,10,5,9,29,27,2,35
Mattersburg,9039,5,7,6,11,33,41,-8,27
SC Rheindorf,9039,6,7,5,12,21,27,-6,26
Vienna,9039,7,6,5,13,24,43,-19,23
FC Salzburg,9040,1,14,8,2,48,18,30,50
SK Sturm Gra,9040,2,12,6,6,33,27,6,42
Rapid Vienna,9040,3,7,11,6,37,32,5,32
LASK Linz,9040,4,8,7,9,28,31,-3,31
Mattersburg,9040,5,6,7,11,33,43,-10,25
Vienna,9040,6,6,6,12,24,42,-18,24
SC Rheindorf,9040,7,5,7,12,21,31,-10,22
FC Salzburg,9041,1,13,9,2,41,16,25,48
SK Sturm Gra,9041,2,14,4,6,38,28,10,46
Rapid Vienna,9041,3,9,10,5,38,29,9,37
LASK Linz,9041,4,8,5,11,28,32,-4,29
Mattersburg,9041,5,8,5,11,32,40,-8,29
Vienna,9041,6,6,6,12,24,39,-15,24
SC Rheindorf,9041,7,4,5,15,16,33,-17,17
FC Salzburg,9042,1,13,7,4,44,21,23,46
SK Sturm Gra,9042,2,13,4,7,35,29,6,43
Rapid Vienna,9042,3,8,9,7,35,31,4,33
LASK Linz,9042,4,8,5,11,28,33,-5,29
Vienna,9042,5,8,5,11,27,39,-12,29
SC Rheindorf,9042,6,7,5,12,24,30,-6,26
Mattersburg,9042,7,7,5,12,34,44,-10,26
FC Salzburg,9043,1,13,8,3,43,19,24,47
SK Sturm Gra,9043,2,14,4,6,38,27,11,46
Rapid Vienna,9043,3,8,10,6,36,28,8,34
LASK Linz,9043,4,9,5,10,27,31,-4,32
Mattersburg,9043,5,8,5,11,32,39,-7,29
Vienna,9043,6,7,5,12,25,40,-15,26
SC Rheindorf,9043,7,4,5,15,17,34,-17,17
FC Salzburg,9044,1,15,7,2,46,17,29,52
SK Sturm Gra,9044,2,13,3,8,34,30,4,42
Rapid Vienna,9044,3,9,9,6,35,29,6,36
LASK Linz,9044,4,8,6,10,28,29,-1,30
Mattersburg,9044,5,7,6,11,34,42,-8,27
Vienna,9044,6,6,6,12,26,41,-15,24
SC Rheindorf,9044,7,5,5,14,19,34,-15,20
FC Salzburg,9045,1,14,8,2,44,19,25,50
SK Sturm Gra,9045,2,13,3,8,32,29,3,42
Rapid Vienna,9045,3,8,11,5,35,26,9,35
LASK Linz,9045,4,8,7,9,26,27,-1,31
Mattersburg,9045,5,7,6,11,36,44,-8,27
Vienna,9045,6,6,6,12,26,42,-16,24
SC Rheindorf,9045,7,5,5,14,21,33,-12,20
FC Salzburg,9046,1,15,7,2,50,18,32,52
SK Sturm Gra,9046,2,12,4,8,32,29,3,40
Rapid Vienna,9046,3,9,10,5,39,28,11,37
LASK Linz,9046,4,9,5,10,26,26,0,32
Vienna,9046,5,6,7,11,24,38,-14,25
Mattersburg,9046,6,5,7,12,28,45,-17,22
SC Rheindorf,9046,7,5,6,13,19,34,-15,21
FC Salzburg,9047,1,14,6,4,48,20,28,48
Rapid Vienna,9047,2,9,11,4,37,27,10,38
SK Sturm Gra,9047,3,11,4,9,30,32,-2,37
LASK Linz,9047,4,8,6,10,26,29,-3,30
Mattersburg,9047,5,8,5,11,32,41,-9,29
Vienna,9047,6,7,5,12,25,39,-14,26
SC Rheindorf,9047,7,5,7,12,16,26,-10,22
FC Salzburg,9048,1,15,6,3,48,19,29,51
SK Sturm Gra,9048,2,13,3,8,34,29,5,42
Rapid Vienna,9048,3,8,10,6,35,30,5,34
LASK Linz,9048,4,8,6,10,25,27,-2,30
Mattersburg,9048,5,7,6,11,29,40,-11,27
Vienna,9048,6,7,5,12,27,41,-14,26
SC Rheindorf,9048,7,5,6,13,18,30,-12,21
FC Salzburg,9049,1,14,8,2,47,19,28,50
SK Sturm Gra,9049,2,12,4,8,34,31,3,40
Rapid Vienna,9049,3,8,10,6,37,30,7,34
LASK Linz,9049,4,9,6,9,27,30,-3,33
Mattersburg,9049,5,6,7,11,29,39,-10,25
Vienna,9049,6,6,6,12,26,41,-15,24
SC Rheindorf,9049,7,6,5,13,23,33,-10,23
FC Salzburg,9050,1,14,7,3,47,21,26,49
SK Sturm Gra,9050,2,12,3,9,31,31,0,39
Rapid Vienna,9050,3,8,11,5,33,26,7,35
LASK Linz,9050,4,8,6,10,26,29,-3,30
Vienna,9050,5,7,6,11,28,40,-12,27
Mattersburg,9050,6,6,7,11,29,41,-12,25
SC Rheindorf,9050,7,6,6,12,20,26,-6,24
FC Salzburg,9051,1,16,6,2,46,17,29,54
SK Sturm Gra,9051,2,11,4,9,33,37,-4,37
Rapid Vienna,9051,3,8,10,6,37,33,4,34
LASK Linz,9051,4,9,5,10,32,28,4,32
Vienna,9051,5,7,5,12,26,39,-13,26
Mattersburg,9051,6,6,6,12,30,40,-10,24
SC Rheindorf,9051,7,6,6,12,20,30,-10,24
FC Salzburg,9052,1,13,7,4,41,18,23,46
SK Sturm Gra,9052,2,12,5,7,31,27,4,41
Rapid Vienna,9052,3,8,11,5,33,25,8,35
LASK Linz,9052,4,8,6,10,26,28,-2,30
Vienna,9052,5,8,5,11,26,37,-11,29
Mattersburg,9052,6,6,7,11,29,40,-11,25
SC Rheindorf,9052,7,5,7,12,19,30,-11,22
FC Salzburg,9053,1,14,7,3,45,18,27,49
SK Sturm Gra,9053,2,13,5,6,32,26,6,44
Rapid Vienna,9053,3,7,12,5,35,28,7,33
LASK Linz,9053,4,8,6,10,26,30,-4,30
SC Rheindorf,9053,5,6,7,11,22,28,-6,25
Vienna,9053,6,6,6,12,25,40,-15,24
Mattersburg,9053,7,5,7,12,29,44,-15,22
FC Salzburg,9054,1,15,6,3,46,19,27,51
SK Sturm Gra,9054,2,13,3,8,32,27,5,42
Rapid Vienna,9054,3,9,10,5,34,26,8,37
LASK Linz,9054,4,8,5,11,25,29,-4,29
Mattersburg,9054,5,7,5,12,31,41,-10,26
SC Rheindorf,9054,6,6,6,12,19,28,-9,24
Vienna,9054,7,6,5,13,24,41,-17,23
FC Salzburg,9055,1,14,7,3,46,20,26,49
SK Sturm Gra,9055,2,14,3,7,36,29,7,45
LASK Linz,9055,3,10,5,9,28,26,2,35
Rapid Vienna,9055,4,7,11,6,36,32,4,32
Mattersburg,9055,5,6,6,12,29,42,-13,24
Vienna,9055,6,6,6,12,26,41,-15,24
SC Rheindorf,9055,7,5,6,13,18,29,-11,21
FC Salzburg,9056,1,15,7,2,44,16,28,52
SK Sturm Gra,9056,2,12,4,8,30,29,1,40
Rapid Vienna,9056,3,7,11,6,33,29,4,32
LASK Linz,9056,4,8,7,9,30,31,-1,31
Vienna,9056,5,7,5,12,28,41,-13,26
SC Rheindorf,9056,6,6,7,11,22,28,-6,25
Mattersburg,9056,7,6,5,13,31,44,-13,23
FC Salzburg,9057,1,15,6,3,44,19,25,51
Rapid Vienna,9057,2,10,9,5,35,25,10,39
SK Sturm Gra,9057,3,11,4,9,30,29,1,37
Mattersburg,9057,4,9,5,10,37,41,-4,32
LASK Linz,9057,5,7,7,10,26,30,-4,28
Vienna,9057,6,6,5,13,24,40,-16,23
SC Rheindorf,9057,7,5,6,13,19,31,-12,21
FC Salzburg,9058,1,16,6,2,47,17,30,54
SK Sturm Gra,9058,2,13,3,8,33,27,6,42
LASK Linz,9058,3,9,6,9,31,31,0,33
Rapid Vienna,9058,4,7,9,8,31,28,3,30
SC Rheindorf,9058,5,7,5,12,22,31,-9,26
Mattersburg,9058,6,6,6,12,33,46,-13,24
Vienna,9058,7,6,5,13,25,42,-17,23
FC Salzburg,9059,1,14,8,2,46,18,28,50
SK Sturm Gra,9059,2,12,4,8,32,31,1,40
Rapid Vienna,9059,3,8,11,5,34,26,8,35
LASK Linz,9059,4,9,6,9,29,26,3,33
SC Rheindorf,9059,5,7,5,12,19,27,-8,26
Mattersburg,9059,6,6,5,13,30,45,-15,23
Vienna,9059,7,6,5,13,25,42,-17,23
FC Salzburg,9060,1,13,8,3,41,18,23,47
SK Sturm Gra,9060,2,13,4,7,34,27,7,43
LASK Linz,9060,3,10,5,9,28,28,0,35
Rapid Vienna,9060,4,8,10,6,33,27,6,34
Vienna,9060,5,7,6,11,26,37,-11,27
Mattersburg,9060,6,6,5,13,30,43,-13,23
SC Rheindorf,9060,7,5,6,13,19,31,-12,21
FC Salzburg,9061,1,13,7,4,44,21,23,46
SK Sturm Gra,9061,2,13,3,8,30,27,3,42
Rapid Vienna,9061,3,8,10,6,37,31,6,34
LASK Linz,9061,4,8,8,8,25,25,0,32
Mattersburg,9061,5,7,6,11,29,38,-9,27
SC Rheindorf,9061,6,6,6,12,18,26,-8,24
Vienna,9061,7,6,6,12,24,39,-15,24
FC Salzburg,9062,1,14,7,3,44,20,24,49
Rapid Vienna,9062,2,10,9,5,38,24,14,39
SK Sturm Gra,9062,3,11,5,8,29,31,-2,38
LASK Linz,9062,4,8,6,10,27,28,-1,30
Mattersburg,9062,5,7,5,12,34,46,-12,26
Vienna,9062,6,7,5,12,29,41,-12,26
SC Rheindorf,9062,7,5,7,12,20,31,-11,22
FC Salzburg,9063,1,14,7,3,45,17,28,49
SK Sturm Gra,9063,2,11,6,7,30,27,3,39
Rapid Vienna,9063,3,9,9,6,35,27,8,36
LASK Linz,9063,4,8,7,9,27,28,-1,31
Mattersburg,9063,5,7,6,11,29,40,-11,27
Vienna,9063,6,7,5,12,24,38,-14,26
SC Rheindorf,9063,7,5,6,13,17,30,-13,21
FC Salzburg,9064,1,15,6,3,43,18,25,51
SK Sturm Gra,9064,2,14,4,6,36,26,10,46
LASK Linz,9064,3,10,6,8,30,26,4,36
Rapid Vienna,9064,4,7,10,7,34,32,2,31
Mattersburg,9064,5,6,6,12,29,42,-13,24
Vienna,9064,6,6,5,13,24,40,-16,23
SC Rheindorf,9064,7,4,7,13,18,30,-12,19
FC Salzburg,9065,1,14,8,2,43,18,25,50
SK Sturm Gra,9065,2,13,4,7,32,26,6,43
Rapid Vienna,9065,3,8,12,4,36,26,10,36
LASK Linz,9065,4,8,7,9,29,28,1,31
Vienna,9065,5,7,6,11,27,38,-11,27
Mattersburg,9065,6,6,5,13,30,44,-14,23
SC Rheindorf,9065,7,4,6,14,17,34,-17,18
FC Salzburg,9066,1,15,6,3,47,16,31,51
SK Sturm Gra,9066,2,13,4,7,32,29,3,43
Rapid Vienna,9066,3,8,9,7,39,33,6,33
LASK Linz,9066,4,9,6,9,30,28,2,33
Mattersburg,9066,5,6,6,12,28,41,-13,24
Vienna,9066,6,6,6,12,24,41,-17,24
SC Rheindorf,9066,7,6,5,13,19,31,-12,23
FC Salzburg,9067,1,15,7,2,48,17,31,52
SK Sturm Gra,9067,2,11,4,9,31,32,-1,37
Rapid Vienna,9067,3,9,9,6,33,26,7,36
LASK Linz,9067,4,10,6,8,31,27,4,36
SC Rheindorf,9067,5,6,6,12,21,29,-8,24
Mattersburg,9067,6,6,5,13,30,44,-14,23
Vienna,9067,7,6,5,13,24,43,-19,23
FC Salzburg,9068,1,16,6,2,45,16,29,54
SK Sturm Gra,9068,2,13,3,8,33,29,4,42
Rapid Vienna,9068,3,8,10,6,34,27,7,34
LASK Linz,9068,4,7,6,11,28,34,-6,27
Mattersburg,9068,5,7,5,12,31,41,-10,26
Vienna,9068,6,7,5,12,24,39,-15,26
SC Rheindorf,9068,7,5,7,12,19,28,-9,22
FC Salzburg,9069,1,14,8,2,45,18,27,50
SK Sturm Gra,9069,2,11,6,7,31,28,3,39
LASK Linz,9069,3,11,5,8,31,27,4,38
Rapid Vienna,9069,4,7,11,6,33,28,5,32
Mattersburg,9069,5,7,5,12,34,43,-9,26
Vienna,9069,6,6,5,13,25,42,-17,23
SC Rheindorf,9069,7,5,6,13,17,30,-13,21
FC Salzburg,9070,1,15,6,3,49,18,31,51
SK Sturm Gra,9070,2,15,3,6,37,29,8,48
Rapid Vienna,9070,3,7,10,7,34,33,1,31
LASK Linz,9070,4,8,5,11,27,30,-3,29
Mattersburg,9070,5,6,7,11,29,39,-10,25
Vienna,9070,6,6,6,12,25,42,-17,24
SC Rheindorf,9070,7,5,7,12,17,27,-10,22
FC Salzburg,9071,1,13,6,5,46,23,23,45
SK Sturm Gra,9071,2,14,3,7,39,31,8,45
Rapid Vienna,9071,3,9,9,6,36,29,7,36
LASK Linz,9071,4,9,6,9,28,29,-1,33
Mattersburg,9071,5,7,6,11,33,42,-9,27
Vienna,9071,6,7,5,12,26,42,-16,26
SC Rheindorf,9071,7,5,5,14,20,32,-12,20
FC Salzburg,9072,1,12,8,4,39,18,21,44
SK Sturm Gra,9072,2,13,5,6,33,26,7,44
Rapid Vienna,9072,3,8,11,5,36,28,8,35
LASK Linz,9072,4,8,7,9,27,29,-2,31
Vienna,9072,5,8,5,11,25,37,-12,29
Mattersburg,9072,6,7,6,11,31,39,-8,27
SC Rheindorf,9072,7,4,6,14,16,30,-14,18
FC Salzburg,9073,1,13,7,4,42,19,23,46
SK Sturm Gra,9073,2,13,5,6,34,26,8,44
Rapid Vienna,9073,3,10,10,4,37,24,13,40
LASK Linz,9073,4,7,7,10,25,29,-4,28
Mattersburg,9073,5,6,7,11,34,46,-12,25
Vienna,9073,6,6,7,11,24,38,-14,25
SC Rheindorf,9073,7,5,5,14,21,35,-14,20
FC Salzburg,9074,1,14,7,3,44,20,24,49
SK Sturm Gra,9074,2,13,4,7,36,29,7,43
Rapid Vienna,9074,3,9,9,6,37,29,8,36
LASK Linz,9074,4,9,5,10,29,30,-1,32
Mattersburg,9074,5,6,6,12,30,41,-11,24
Vienna,9074,6,6,6,12,26,41,-15,24
SC Rheindorf,9074,7,6,5,13,21,33,-12,23
SK Sturm Gra,9075,1,14,4,6,35,25,10,46
FC Salzburg,9075,2,12,7,5,41,22,19,43
Rapid Vienna,9075,3,9,11,4,34,23,11,38
Mattersburg,9075,4,8,6,10,37,37,0,30
LASK Linz,9075,5,8,6,10,25,29,-4,30
Vienna,9075,6,7,5,12,26,42,-16,26
SC Rheindorf,9075,7,4,5,15,15,35,-20,17
FC Salzburg,9076,1,15,7,2,46,20,26,52
SK Sturm Gra,9076,2,12,6,6,34,29,5,42
Rapid Vienna,9076,3,8,11,5,35,27,8,35
LASK Linz,9076,4,8,7,9,29,29,0,31
Vienna,9076,5,7,5,12,27,39,-12,26
Mattersburg,9076,6,6,6,12,29,42,-13,24
SC Rheindorf,9076,7,4,6,14,19,33,-14,18
FC Salzburg,9077,1,13,7,4,43,23,20,46
SK Sturm Gra,9077,2,13,4,7,35,30,5,43
Rapid Vienna,9077,3,7,11,6,33,29,4,32
LASK Linz,9077,4,8,7,9,25,26,-1,31
SC Rheindorf,9077,5,7,5,12,21,28,-7,26
Mattersburg,9077,6,7,5,12,32,40,-8,26
Vienna,9077,7,7,5,12,27,40,-13,26
FC Salzburg,9078,1,16,6,2,48,15,33,54
SK Sturm Gra,9078,2,12,4,8,32,31,1,40
Rapid Vienna,9078,3,9,10,5,37,29,8,37
LASK Linz,9078,4,7,8,9,27,30,-3,29
Mattersburg,9078,5,6,7,11,31,41,-10,25
Vienna,9078,6,6,5,13,24,42,-18,23
SC Rheindorf,9078,7,4,8,12,17,28,-11,20
FC Salzburg,9079,1,15,7,2,49,22,27,52
SK Sturm Gra,9079,2,13,4,7,33,29,4,43
Rapid Vienna,9079,3,8,10,6,36,29,7,34
LASK Linz,9079,4,8,5,11,25,28,-3,29
Mattersburg,9079,5,8,5,11,35,40,-5,29
Vienna,9079,6,6,6,12,24,41,-17,24
SC Rheindorf,9079,7,5,5,14,17,30,-13,20
FC Salzburg,9080,1,15,6,3,48,17,31,51
SK Sturm Gra,9080,2,12,5,7,36,32,4,41
Rapid Vienna,9080,3,9,10,5,36,29,7,37
LASK Linz,9080,4,8,7,9,29,30,-1,31
Mattersburg,9080,5,6,6,12,31,46,-15,24
Vienna,9080,6,6,6,12,26,41,-15,24
SC Rheindorf,9080,7,5,6,13,21,32,-11,21
FC Salzburg,9081,1,14,7,3,45,18,27,49
SK Sturm Gra,9081,2,12,5,7,33,28,5,41
Rapid Vienna,9081,3,8,12,4,35,26,9,36
LASK Linz,9081,4,8,6,10,25,30,-5,30
Mattersburg,9081,5,8,5,11,35,42,-7,29
Vienna,9081,6,7,5,12,25,39,-14,26
SC Rheindorf,9081,7,4,6,14,15,30,-15,18
FC Salzburg,9082,1,13,7,4,43,20,23,46
SK Sturm Gra,9082,2,14,3,7,34,28,6,45
Rapid Vienna,9082,3,9,10,5,36,25,11,37
LASK Linz,9082,4,10,6,8,29,27,2,36
Mattersburg,9082,5,6,6,12,32,44,-12,24
Vienna,9082,6,6,6,12,25,40,-15,24
SC Rheindorf,9082,7,4,6,14,18,33,-15,18
FC Salzburg,9083,1,16,6,2,49,18,31,54
SK Sturm Gra,9083,2,13,4,7,37,32,5,43
LASK Linz,9083,3,8,7,9,29,30,-1,31
Rapid Vienna,9083,4,7,9,8,32,29,3,30
SC Rheindorf,9083,5,7,5,12,20,29,-9,26
Vienna,9083,6,7,5,12,26,40,-14,26
Mattersburg,9083,7,5,6,13,28,43,-15,21
FC Salzburg,9084,1,15,7,2,47,18,29,52
SK Sturm Gra,9084,2,12,3,9,32,31,1,39
Rapid Vienna,9084,3,8,12,4,36,26,10,36
LASK Linz,9084,4,8,7,9,26,30,-4,31
Mattersburg,9084,5,6,7,11,31,42,-11,25
Vienna,9084,6,6,5,13,23,41,-18,23
SC Rheindorf,9084,7,5,7,12,22,29,-7,22
FC Salzburg,9085,1,14,7,3,42,18,24,49
Rapid Vienna,9085,2,9,11,4,36,23,13,38
SK Sturm Gra,9085,3,11,5,8,29,28,1,38
LASK Linz,9085,4,7,7,10,24,32,-8,28
Vienna,9085,5,7,6,11,28,41,-13,27
SC Rheindorf,9085,6,6,7,11,23,28,-5,25
Mattersburg,9085,7,5,7,12,33,45,-12,22
FC Salzburg,9086,1,15,7,2,44,16,28,52
SK Sturm Gra,9086,2,12,4,8,32,30,2,40
Rapid Vienna,9086,3,8,11,5,33,25,8,35
LASK Linz,9086,4,8,6,10,28,31,-3,30
Mattersburg,9086,5,8,5,11,34,42,-8,29
Vienna,9086,6,6,5,13,25,41,-16,23
SC Rheindorf,9086,7,5,6,13,17,28,-11,21
FC Salzburg,9087,1,16,6,2,46,17,29,54
SK Sturm Gra,9087,2,11,5,8,32,33,-1,38
Rapid Vienna,9087,3,8,11,5,36,27,9,35
LASK Linz,9087,4,8,7,9,26,26,0,31
Vienna,9087,5,7,5,12,25,39,-14,26
SC Rheindorf,9087,6,5,8,11,20,29,-9,23
Mattersburg,9087,7,5,6,13,27,41,-14,21
FC Salzburg,9088,1,13,9,2,45,20,25,48
SK Sturm Gra,9088,2,11,5,8,33,34,-1,38
Rapid Vienna,9088,3,7,12,5,37,30,7,33
LASK Linz,9088,4,9,6,9,26,29,-3,33
SC Rheindorf,9088,5,7,6,11,28,29,-1,27
Mattersburg,9088,6,6,7,11,34,42,-8,25
Vienna,9088,7,6,5,13,25,44,-19,23
FC Salzburg,9089,1,14,8,2,45,17,28,50
SK Sturm Gra,9089,2,12,4,8,32,29,3,40
Rapid Vienna,9089,3,9,10,5,38,30,8,37
LASK Linz,9089,4,9,7,8,27,25,2,34
Mattersburg,9089,5,7,6,11,31,43,-12,27
Vienna,9089,6,6,6,12,26,41,-15,24
SC Rheindorf,9089,7,4,5,15,16,30,-14,17
FC Salzburg,9090,1,15,7,2,46,18,28,52
SK Sturm Gra,9090,2,11,4,9,31,34,-3,37
Rapid Vienna,9090,3,7,12,5,35,28,7,33
LASK Linz,9090,4,8,8,8,29,28,1,32
Vienna,9090,5,7,5,12,26,41,-15,26
SC Rheindorf,9090,6,5,8,11,23,30,-7,23
Mattersburg,9090,7,5,8,11,33,44,-11,23
FC Salzburg,9091,1,15,7,2,47,20,27,52
SK Sturm Gra,9091,2,13,4,7,31,27,4,43
LASK Linz,9091,3,9,5,10,26,28,-2,32
Rapid Vienna,9091,4,7,10,7,33,30,3,31
Mattersburg,9091,5,7,5,12,32,40,-8,26
Vienna,9091,6,7,5,12,25,39,-14,26
SC Rheindorf,9091,7,5,6,13,18,28,-10,21
FC Salzburg,9092,1,14,7,3,45,20,25,49
SK Sturm Gra,9092,2,14,3,7,35,29,6,45
Rapid Vienna,9092,3,8,9,7,37,30,7,33
LASK Linz,9092,4,9,5,10,26,27,-1,32
Vienna,9092,5,7,5,12,25,40,-15,26
SC Rheindorf,9092,6,6,6,12,25,35,-10,24
Mattersburg,9092,7,5,7,12,30,42,-12,22
FC Salzburg,9093,1,16,6,2,48,15,33,54
SK Sturm Gra,9093,2,11,4,9,29,28,1,37
Rapid Vienna,9093,3,8,10,6,34,29,5,34
LASK Linz,9093,4,8,6,10,26,30,-4,30
SC Rheindorf,9093,5,7,6,11,22,27,-5,27
Mattersburg,9093,6,6,7,11,31,42,-11,25
Vienna,9093,7,6,5,13,25,44,-19,23
FC Salzburg,9094,1,15,7,2,49,17,32,52
SK Sturm Gra,9094,2,13,4,7,36,30,6,43
Rapid Vienna,9094,3,9,9,6,39,30,9,36
LASK Linz,9094,4,8,5,11,26,33,-7,29
Vienna,9094,5,7,6,11,28,40,-12,27
SC Rheindorf,9094,6,6,6,12,25,33,-8,24
Mattersburg,9094,7,5,5,14,30,50,-20,20
FC Salzburg,9095,1,15,7,2,46,18,28,52
SK Sturm Gra,9095,2,13,4,7,34,30,4,43
Rapid Vienna,9095,3,9,10,5,37,26,11,37
LASK Linz,9095,4,7,6,11,26,34,-8,27
Vienna,9095,5,7,6,11,27,40,-13,27
Mattersburg,9095,6,7,5,12,37,43,-6,26
SC Rheindorf,9095,7,4,6,14,18,34,-16,18
FC Salzburg,9096,1,15,6,3,45,19,26,51
SK Sturm Gra,9096,2,14,3,7,38,28,10,45
Rapid Vienna,9096,3,8,9,7,35,31,4,33
Vienna,9096,4,8,5,11,29,39,-10,29
LASK Linz,9096,5,7,5,12,24,32,-8,26
SC Rheindorf,9096,6,6,6,12,23,32,-9,24
Mattersburg,9096,7,6,6,12,31,44,-13,24
FC Salzburg,9097,1,15,7,2,47,17,30,52
SK Sturm Gra,9097,2,13,4,7,31,27,4,43
Rapid Vienna,9097,3,8,11,5,36,26,10,35
LASK Linz,9097,4,7,7,10,25,31,-6,28
Mattersburg,9097,5,7,6,11,30,39,-9,27
Vienna,9097,6,6,5,13,24,42,-18,23
SC Rheindorf,9097,7,5,6,13,19,30,-11,21
FC Salzburg,9098,1,14,8,2,43,18,25,50
SK Sturm Gra,9098,2,12,5,7,32,28,4,41
Rapid Vienna,9098,3,7,12,5,35,29,6,33
LASK Linz,9098,4,9,6,9,28,27,1,33
Vienna,9098,5,7,6,11,26,38,-12,27
SC Rheindorf,9098,6,5,8,11,19,28,-9,23
Mattersburg,9098,7,5,5,14,30,45,-15,20
FC Salzburg,9099,1,14,6,4,48,23,25,48
SK Sturm Gra,9099,2,12,4,8,33,31,2,40
Rapid Vienna,9099,3,8,10,6,34,28,6,34
LASK Linz,9099,4,8,8,8,28,28,0,32
Vienna,9099,5,8,5,11,29,40,-11,29
Mattersburg,9099,6,6,7,11,32,43,-11,25
SC Rheindorf,9099,7,4,8,12,18,29,-11,20
FC Salzburg,9100,1,13,7,4,44,19,25,46
Rapid Vienna,9100,2,10,10,4,37,24,13,40
SK Sturm Gra,9100,3,11,5,8,30,33,-3,38
LASK Linz,9100,4,7,8,9,25,28,-3,29
Mattersburg,9100,5,7,6,11,30,40,-10,27
SC Rheindorf,9100,6,6,6,12,19,26,-7,24
Vienna,9100,7,6,6,12,26,41,-15,24
FC Salzburg,9101,1,14,8,2,48,18,30,50
SK Sturm Gra,9101,2,13,3,8,32,31,1,42
Rapid Vienna,9101,3,8,10,6,36,31,5,34
LASK Linz,9101,4,9,5,10,31,29,2,32
SC Rheindorf,9101,5,7,5,12,20,28,-8,26
Vienna,9101,6,6,6,12,24,41,-17,24
Mattersburg,9101,7,5,7,12,29,42,-13,22
FC Salzburg,9102,1,14,7,3,43,21,22,49
SK Sturm Gra,9102,2,12,4,8,34,31,3,40
Rapid Vienna,9102,3,7,10,7,34,31,3,31
LASK Linz,9102,4,8,7,9,29,29,0,31
Mattersburg,9102,5,7,6,11,32,40,-8,27
SC Rheindorf,9102,6,7,5,12,22,29,-7,26
Vienna,9102,7,7,5,12,26,39,-13,26
FC Salzburg,9103,1,14,7,3,47,20,27,49
SK Sturm Gra,9103,2,12,4,8,32,33,-1,40
Rapid Vienna,9103,3,9,9,6,37,28,9,36
SC Rheindorf,9103,4,8,5,11,23,28,-5,29
LASK Linz,9103,5,7,6,11,26,31,-5,27
Vienna,9103,6,7,6,11,29,40,-11,27
Mattersburg,9103,7,6,5,13,30,44,-14,23
FC Salzburg,9104,1,15,6,3,47,20,27,51
SK Sturm Gra,9104,2,12,4,8,33,31,2,40
Rapid Vienna,9104,3,8,11,5,34,26,8,35
LASK Linz,9104,4,8,7,9,28,29,-1,31
Vienna,9104,5,7,5,12,26,40,-14,26
Mattersburg,9104,6,6,6,12,28,40,-12,24
SC Rheindorf,9104,7,4,9,11,20,30,-10,21
FC Salzburg,9105,1,14,7,3,47,20,27,49
SK Sturm Gra,9105,2,12,6,6,35,28,7,42
Rapid Vienna,9105,3,9,10,5,37,28,9,37
LASK Linz,9105,4,8,6,10,25,26,-1,30
Mattersburg,9105,5,7,5,12,33,44,-11,26
Vienna,9105,6,7,5,12,26,41,-15,26
SC Rheindorf,9105,7,5,5,14,18,34,-16,20
FC Salzburg,9106,1,15,7,2,45,16,29,52
SK Sturm Gra,9106,2,13,3,8,32,27,5,42
Rapid Vienna,9106,3,9,9,6,36,27,9,36
LASK Linz,9106,4,8,6,10,26,32,-6,30
Mattersburg,9106,5,6,7,11,29,40,-11,25
Vienna,9106,6,6,7,11,25,39,-14,25
SC Rheindorf,9106,7,5,5,14,16,28,-12,20
FC Salzburg,9107,1,14,6,4,45,20,25,48
SK Sturm Gra,9107,2,14,4,6,32,24,8,46
Rapid Vienna,9107,3,8,11,5,35,25,10,35
LASK Linz,9107,4,10,5,9,27,26,1,35
Mattersburg,9107,5,7,5,12,32,41,-9,26
Vienna,9107,6,6,5,13,23,43,-20,23
SC Rheindorf,9107,7,4,6,14,16,31,-15,18
FC Salzburg,9108,1,14,7,3,47,21,26,49
SK Sturm Gra,9108,2,13,4,7,34,29,5,43
Rapid Vienna,9108,3,8,9,7,35,29,6,33
LASK Linz,9108,4,8,7,9,27,28,-1,31
Mattersburg,9108,5,8,6,10,34,40,-6,30
Vienna,9108,6,6,6,12,25,40,-15,24
SC Rheindorf,9108,7,5,5,14,18,33,-15,20
FC Salzburg,9109,1,14,8,2,44,17,27,50
Rapid Vienna,9109,2,10,9,5,37,25,12,39
SK Sturm Gra,9109,3,11,5,8,29,27,2,38
LASK Linz,9109,4,8,6,10,26,29,-3,30
Vienna,9109,5,7,6,11,26,38,-12,27
Mattersburg,9109,6,6,5,13,29,44,-15,23
SC Rheindorf,9109,7,5,7,12,17,28,-11,22
FC Salzburg,9110,1,14,6,4,45,20,25,48
SK Sturm Gra,9110,2,14,3,7,37,30,7,45
Rapid Vienna,9110,3,10,9,5,42,29,13,39
Mattersburg,9110,4,7,6,11,32,41,-9,27
Vienna,9110,5,7,6,11,26,39,-13,27
LASK Linz,9110,6,7,5,12,25,34,-9,26
SC Rheindorf,9110,7,5,5,14,19,33,-14,20
FC Salzburg,9111,1,13,8,3,45,19,26,47
SK Sturm Gra,9111,2,12,4,8,32,31,1,40
Rapid Vienna,9111,3,9,11,4,37,26,11,38
LASK Linz,9111,4,7,7,10,24,27,-3,28
Vienna,9111,5,7,6,11,29,38,-9,27
Mattersburg,9111,6,7,5,12,32,47,-15,26
SC Rheindorf,9111,7,5,7,12,22,33,-11,22
FC Salzburg,9112,1,15,6,3,46,21,25,51
SK Sturm Gra,9112,2,13,3,8,38,32,6,42
Rapid Vienna,9112,3,8,11,5,36,29,7,35
LASK Linz,9112,4,7,8,9,29,33,-4,29
Vienna,9112,5,6,6,12,25,40,-15,24
SC Rheindorf,9112,6,5,8,11,20,28,-8,23
Mattersburg,9112,7,5,8,11,31,42,-11,23
FC Salzburg,9113,1,16,6,2,48,16,32,54
SK Sturm Gra,9113,2,13,4,7,31,28,3,43
Rapid Vienna,9113,3,8,10,6,35,27,8,34
Mattersburg,9113,4,8,5,11,32,42,-10,29
LASK Linz,9113,5,7,6,11,25,29,-4,27
Vienna,9113,6,6,5,13,23,39,-16,23
SC Rheindorf,9113,7,5,6,13,20,33,-13,21
FC Salzburg,9114,1,15,6,3,44,17,27,51
SK Sturm Gra,9114,2,11,5,8,30,30,0,38
Rapid Vienna,9114,3,7,11,6,34,32,2,32
LASK Linz,9114,4,7,9,8,26,27,-1,30
SC Rheindorf,9114,5,7,6,11,22,26,-4,27
Vienna,9114,6,7,5,12,28,40,-12,26
Mattersburg,9114,7,6,6,12,31,43,-12,24
FC Salzburg,9115,1,13,7,4,43,21,22,46
SK Sturm Gra,9115,2,13,5,6,32,25,7,44
Rapid Vienna,9115,3,9,11,4,41,27,14,38
LASK Linz,9115,4,8,5,11,27,35,-8,29
Mattersburg,9115,5,7,6,11,33,42,-9,27
Vienna,9115,6,6,7,11,25,39,-14,25
SC Rheindorf,9115,7,4,7,13,18,30,-12,19
FC Salzburg,9116,1,14,8,2,48,18,30,50
SK Sturm Gra,9116,2,13,5,6,33,27,6,44
Rapid Vienna,9116,3,8,11,5,36,28,8,35
LASK Linz,9116,4,7,7,10,24,27,-3,28
Mattersburg,9116,5,7,6,11,30,42,-12,27
Vienna,9116,6,6,6,12,24,41,-17,24
SC Rheindorf,9116,7,4,7,13,21,33,-12,19
FC Salzburg,9117,1,14,6,4,43,20,23,48
SK Sturm Gra,9117,2,14,3,7,34,28,6,45
Rapid Vienna,9117,3,8,10,6,38,30,8,34
LASK Linz,9117,4,9,5,10,32,34,-2,32
Mattersburg,9117,5,7,5,12,33,44,-11,26
Vienna,9117,6,7,5,12,26,40,-14,26
SC Rheindorf,9117,7,5,6,13,21,31,-10,21
FC Salzburg,9118,1,15,7,2,45,17,28,52
SK Sturm Gra,9118,2,13,4,7,32,28,4,43
Rapid Vienna,9118,3,7,11,6,33,27,6,32
LASK Linz,9118,4,7,6,11,25,32,-7,27
Mattersburg,9118,5,7,5,12,32,41,-9,26
Vienna,9118,6,7,5,12,26,41,-15,26
SC Rheindorf,9118,7,6,6,12,20,27,-7,24
FC Salzburg,9119,1,15,7,2,46,18,28,52
SK Sturm Gra,9119,2,12,5,7,33,29,4,41
Rapid Vienna,9119,3,7,11,6,36,30,6,32
LASK Linz,9119,4,8,6,10,28,31,-3,30
Mattersburg,9119,5,8,6,10,33,38,-5,30
Vienna,9119,6,6,5,13,24,42,-18,23
SC Rheindorf,9119,7,5,6,13,21,33,-12,21
FC Salzburg,9120,1,16,6,2,49,18,31,54
SK Sturm Gra,9120,2,13,3,8,31,28,3,42
LASK Linz,9120,3,11,5,8,29,25,4,38
Rapid Vienna,9120,4,8,9,7,35,28,7,33
Mattersburg,9120,5,6,6,12,30,44,-14,24
Vienna,9120,6,6,6,12,24,40,-16,24
SC Rheindorf,9120,7,4,5,15,18,33,-15,17
FC Salzburg,9121,1,14,6,4,45,19,26,48
SK Sturm Gra,9121,2,12,3,9,32,32,0,39
LASK Linz,9121,3,10,6,8,34,28,6,36
Rapid Vienna,9121,4,8,11,5,35,27,8,35
Vienna,9121,5,8,5,11,27,39,-12,29
Mattersburg,9121,6,6,5,13,28,45,-17,23
SC Rheindorf,9121,7,5,6,13,18,29,-11,21
FC Salzburg,9122,1,15,7,2,47,16,31,52
SK Sturm Gra,9122,2,11,5,8,29,28,1,38
Rapid Vienna,9122,3,9,10,5,35,26,9,37
LASK Linz,9122,4,8,7,9,29,29,0,31
Mattersburg,9122,5,6,7,11,29,43,-14,25
Vienna,9122,6,6,6,12,25,41,-16,24
SC Rheindorf,9122,7,4,8,12,19,30,-11,20
FC Salzburg,9123,1,15,7,2,50,21,29,52
SK Sturm Gra,9123,2,12,4,8,34,33,1,40
Rapid Vienna,9123,3,9,10,5,36,28,8,37
LASK Linz,9123,4,8,5,11,25,30,-5,29
Vienna,9123,5,7,6,11,25,38,-13,27
Mattersburg,9123,6,6,6,12,32,43,-11,24
SC Rheindorf,9123,7,5,6,13,19,28,-9,21
FC Salzburg,9124,1,14,8,2,46,16,30,50
Rapid Vienna,9124,2,10,9,5,42,30,12,39
SK Sturm Gra,9124,3,11,4,9,30,31,-1,37
LASK Linz,9124,4,9,5,10,26,30,-4,32
Vienna,9124,5,7,6,11,24,37,-13,27
Mattersburg,9124,6,7,5,12,30,40,-10,26
SC Rheindorf,9124,7,5,5,14,18,32,-14,20
FC Salzburg,9125,1,13,7,4,41,20,21,46
SK Sturm Gra,9125,2,14,3,7,33,29,4,45
Rapid Vienna,9125,3,9,9,6,36,28,8,36
LASK Linz,9125,4,8,6,10,28,31,-3,30
Vienna,9125,5,7,6,11,25,38,-13,27
Mattersburg,9125,6,6,6,12,29,40,-11,24
SC Rheindorf,9125,7,6,5,13,23,29,-6,23
FC Salzburg,9126,1,15,6,3,45,19,26,51
SK Sturm Gra,9126,2,12,5,7,32,29,3,41
Rapid Vienna,9126,3,8,10,6,36,29,7,34
LASK Linz,9126,4,8,6,10,25,28,-3,30
Mattersburg,9126,5,8,5,11,31,39,-8,29
Vienna,9126,6,7,5,12,25,38,-13,26
SC Rheindorf,9126,7,5,5,14,20,32,-12,20
FC Salzburg,9127,1,14,6,4,43,21,22,48
SK Sturm Gra,9127,2,14,3,7,37,27,10,45
Rapid Vienna,9127,3,9,9,6,38,30,8,36
LASK Linz,9127,4,9,5,10,30,33,-3,32
Mattersburg,9127,5,8,5,11,34,39,-5,29
Vienna,9127,6,7,5,12,26,41,-15,26
SC Rheindorf,9127,7,4,5,15,18,35,-17,17
FC Salzburg,9128,1,14,7,3,46,20,26,49
SK Sturm Gra,9128,2,14,4,6,37,27,10,46
Rapid Vienna,9128,3,8,10,6,35,31,4,34
LASK Linz,9128,4,8,6,10,27,29,-2,30
Vienna,9128,5,7,5,12,28,41,-13,26
Mattersburg,9128,6,6,6,12,30,44,-14,24
SC Rheindorf,9128,7,5,6,13,20,31,-11,21
FC Salzburg,9129,1,14,8,2,47,21,26,50
Rapid Vienna,9129,2,9,11,4,39,29,10,38
SK Sturm Gra,9129,3,11,4,9,32,31,1,37
LASK Linz,9129,4,8,7,9,28,30,-2,31
Mattersburg,9129,5,6,8,10,34,42,-8,26
Vienna,9129,6,6,6,12,25,41,-16,24
SC Rheindorf,9129,7,4,8,12,21,32,-11,20
FC Salzburg,9130,1,13,7,4,42,21,21,46
SK Sturm Gra,9130,2,12,6,6,35,27,8,42
Rapid Vienna,9130,3,10,10,4,38,24,14,40
Mattersburg,9130,4,8,5,11,35,42,-7,29
LASK Linz,9130,5,8,5,11,25,33,-8,29
Vienna,9130,6,7,5,12,26,39,-13,26
SC Rheindorf,9130,7,4,6,14,19,34,-15,18
FC Salzburg,9131,1,15,6,3,50,22,28,51
SK Sturm Gra,9131,2,13,3,8,37,32,5,42
Rapid Vienna,9131,3,8,9,7,35,30,5,33
Mattersburg,9131,4,7,7,10,33,40,-7,28
LASK Linz,9131,5,7,6,11,23,31,-8,27
SC Rheindorf,9131,6,6,7,11,19,27,-8,25
Vienna,9131,7,6,6,12,26,41,-15,24
FC Salzburg,9132,1,15,7,2,45,18,27,52
SK Sturm Gra,9132,2,13,5,6,37,29,8,44
LASK Linz,9132,3,9,6,9,29,29,0,33
Rapid Vienna,9132,4,7,10,7,34,30,4,31
Vienna,9132,5,6,6,12,26,42,-16,24
SC Rheindorf,9132,6,6,5,13,20,31,-11,23
Mattersburg,9132,7,5,7,12,30,42,-12,22
FC Salzburg,9133,1,15,6,3,47,22,25,51
SK Sturm Gra,9133,2,14,4,6,37,29,8,46
Rapid Vienna,9133,3,8,10,6,36,30,6,34
LASK Linz,9133,4,9,5,10,30,32,-2,32
Mattersburg,9133,5,6,7,11,35,43,-8,25
Vienna,9133,6,6,6,12,25,41,-16,24
SC Rheindorf,9133,7,4,6,14,17,30,-13,18
FC Salzburg,9134,1,13,7,4,43,21,22,46
SK Sturm Gra,9134,2,13,4,7,33,28,5,43
Rapid Vienna,9134,3,9,11,4,39,28,11,38
LASK Linz,9134,4,8,6,10,27,32,-5,30
Vienna,9134,5,7,6,11,27,40,-13,27
Mattersburg,9134,6,5,8,11,30,41,-11,23
SC Rheindorf,9134,7,5,6,13,20,29,-9,21
FC Salzburg,9135,1,15,6,3,41,16,25,51
SK Sturm Gra,9135,2,11,4,9,31,32,-1,37
LASK Linz,9135,3,10,6,8,34,28,6,36
Rapid Vienna,9135,4,7,11,6,34,29,5,32
Mattersburg,9135,5,7,7,10,33,41,-8,28
Vienna,9135,6,6,5,13,24,40,-16,23
SC Rheindorf,9135,7,5,7,12,20,31,-11,22
FC Salzburg,9136,1,13,7,4,41,20,21,46
SK Sturm Gra,9136,2,13,3,8,31,28,3,42
Rapid Vienna,9136,3,9,10,5,36,26,10,37
Vienna,9136,4,8,5,11,27,38,-11,29
LASK Linz,9136,5,7,5,12,26,32,-6,26
SC Rheindorf,9136,6,6,7,11,20,27,-7,25
Mattersburg,9136,7,6,7,11,30,40,-10,25
FC Salzburg,9137,1,14,7,3,41,17,24,49
SK Sturm Gra,9137,2,13,3,8,30,28,2,42
Rapid Vienna,9137,3,9,10,5,35,25,10,37
LASK Linz,9137,4,9,5,10,28,27,1,32
Mattersburg,9137,5,6,7,11,32,42,-10,25
Vienna,9137,6,6,6,12,26,41,-15,24
SC Rheindorf,9137,7,5,6,13,17,29,-12,21
FC Salzburg,9138,1,15,6,3,50,21,29,51
SK Sturm Gra,9138,2,13,4,7,35,27,8,43
LASK Linz,9138,3,9,6,9,27,27,0,33
Rapid Vienna,9138,4,7,10,7,34,34,0,31
SC Rheindorf,9138,5,7,6,11,22,26,-4,27
Vienna,9138,6,7,5,12,29,42,-13,26
Mattersburg,9138,7,5,5,14,30,50,-20,20
FC Salzburg,9139,1,15,7,2,48,18,30,52
SK Sturm Gra,9139,2,12,5,7,32,27,5,41
LASK Linz,9139,3,9,7,8,28,26,2,34
Rapid Vienna,9139,4,7,12,5,34,29,5,33
Vienna,9139,5,7,5,12,25,41,-16,26
Mattersburg,9139,6,6,6,12,34,42,-8,24
SC Rheindorf,9139,7,4,6,14,16,34,-18,18
FC Salzburg,9140,1,15,6,3,49,19,30,51
SK Sturm Gra,9140,2,12,4,8,35,30,5,40
Rapid Vienna,9140,3,9,9,6,36,29,7,36
LASK Linz,9140,4,8,6,10,27,34,-7,30
Mattersburg,9140,5,8,5,11,38,41,-3,29
Vienna,9140,6,6,5,13,23,41,-18,23
SC Rheindorf,9140,7,5,7,12,19,33,-14,22
FC Salzburg,9141,1,14,6,4,45,22,23,48
SK Sturm Gra,9141,2,13,4,7,33,28,5,43
Rapid Vienna,9141,3,10,9,5,40,26,14,39
LASK Linz,9141,4,7,7,10,25,29,-4,28
Mattersburg,9141,5,7,6,11,32,41,-9,27
Vienna,9141,6,6,5,13,25,44,-19,23
SC Rheindorf,9141,7,5,7,12,19,29,-10,22
FC Salzburg,9142,1,15,7,2,52,18,34,52
SK Sturm Gra,9142,2,14,3,7,37,33,4,45
Rapid Vienna,9142,3,8,10,6,38,30,8,34
LASK Linz,9142,4,8,6,10,25,32,-7,30
Mattersburg,9142,5,8,5,11,36,43,-7,29
Vienna,9142,6,6,6,12,27,42,-15,24
SC Rheindorf,9142,7,4,5,15,18,35,-17,17
FC Salzburg,9143,1,15,6,3,47,19,28,51
SK Sturm Gra,9143,2,13,5,6,37,29,8,44
Rapid Vienna,9143,3,7,11,6,33,27,6,32
LASK Linz,9143,4,9,5,10,27,30,-3,32
Vienna,9143,5,7,5,12,26,42,-16,26
Mattersburg,9143,6,6,5,13,31,44,-13,23
SC Rheindorf,9143,7,5,7,12,19,29,-10,22
FC Salzburg,9144,1,14,6,4,43,20,23,48
SK Sturm Gra,9144,2,13,5,6,33,25,8,44
Rapid Vienna,9144,3,9,11,4,38,25,13,38
LASK Linz,9144,4,9,6,9,28,28,0,33
Vienna,9144,5,6,6,12,25,41,-16,24
SC Rheindorf,9144,6,5,6,13,18,31,-13,21
Mattersburg,9144,7,5,6,13,30,45,-15,21
FC Salzburg,9145,1,14,8,2,44,17,27,50
SK Sturm Gra,9145,2,11,5,8,29,27,2,38
Rapid Vienna,9145,3,8,12,4,35,26,9,36
LASK Linz,9145,4,10,5,9,29,27,2,35
Mattersburg,9145,5,6,6,12,31,44,-13,24
Vienna,9145,6,6,6,12,25,40,-15,24
SC Rheindorf,9145,7,5,6,13,17,29,-12,21
FC Salzburg,9146,1,16,6,2,47,18,29,54
SK Sturm Gra,9146,2,13,3,8,36,30,6,42
Rapid Vienna,9146,3,9,9,6,38,31,7,36
LASK Linz,9146,4,7,5,12,27,34,-7,26
SC Rheindorf,9146,5,7,5,12,21,29,-8,26
Vienna,9146,6,7,5,12,26,40,-14,26
Mattersburg,9146,7,6,5,13,29,42,-13,23
FC Salzburg,9147,1,14,8,2,44,17,27,50
SK Sturm Gra,9147,2,13,3,8,33,28,5,42
Rapid Vienna,9147,3,8,9,7,33,28,5,33
LASK Linz,9147,4,8,6,10,26,30,-4,30
SC Rheindorf,9147,5,6,7,11,20,28,-8,25
Mattersburg,9147,6,6,7,11,29,39,-10,25
Vienna,9147,7,6,6,12,24,39,-15,24
FC Salzburg,9148,1,15,6,3,44,18,26,51
SK Sturm Gra,9148,2,12,4,8,32,30,2,40
Rapid Vienna,9148,3,9,11,4,36,26,10,38
Mattersburg,9148,4,7,6,11,34,40,-6,27
LASK Linz,9148,5,7,6,11,25,33,-8,27
SC Rheindorf,9148,6,5,8,11,20,28,-8,23
Vienna,9148,7,6,5,13,23,39,-16,23
FC Salzburg,9149,1,14,7,3,44,16,28,49
SK Sturm Gra,9149,2,11,6,7,32,29,3,39
Rapid Vienna,9149,3,9,11,4,39,25,14,38
LASK Linz,9149,4,7,6,11,25,32,-7,27
Vienna,9149,5,7,6,11,25,38,-13,27
SC Rheindorf,9149,6,6,6,12,21,31,-10,24
Mattersburg,9149,7,6,6,12,31,46,-15,24
FC Salzburg,9150,1,14,6,4,45,21,24,48
Rapid Vienna,9150,2,11,9,4,40,24,16,42
SK Sturm Gra,9150,3,11,4,9,29,34,-5,37
Mattersburg,9150,4,8,5,11,34,40,-6,29
LASK Linz,9150,5,7,6,11,27,33,-6,27
Vienna,9150,6,7,5,12,26,40,-14,26
SC Rheindorf,9150,7,6,5,13,22,31,-9,23
FC Salzburg,9151,1,12,8,4,43,22,21,44
SK Sturm Gra,9151,2,13,5,6,36,29,7,44
Rapid Vienna,9151,3,9,11,4,37,27,10,38
LASK Linz,9151,4,9,6,9,31,29,2,33
Vienna,9151,5,8,5,11,28,40,-12,29
Mattersburg,9151,6,5,6,13,29,46,-17,21
SC Rheindorf,9151,7,5,5,14,22,33,-11,20
FC Salzburg,9152,1,14,7,3,44,19,25,49
SK Sturm Gra,9152,2,12,4,8,32,29,3,40
Rapid Vienna,9152,3,8,12,4,37,28,9,36
LASK Linz,9152,4,9,7,8,28,27,1,34
Vienna,9152,5,7,6,11,26,37,-11,27
Mattersburg,9152,6,5,6,13,28,44,-16,21
SC Rheindorf,9152,7,4,8,12,19,30,-11,20
FC Salzburg,9153,1,14,7,3,46,19,27,49
SK Sturm Gra,9153,2,13,4,7,36,30,6,43
Rapid Vienna,9153,3,9,9,6,37,31,6,36
LASK Linz,9153,4,9,5,10,28,29,-1,32
Mattersburg,9153,5,7,7,10,31,38,-7,28
Vienna,9153,6,6,5,13,24,41,-17,23
SC Rheindorf,9153,7,4,7,13,17,31,-14,19
FC Salzburg,9154,1,14,6,4,43,19,24,48
SK Sturm Gra,9154,2,13,3,8,36,28,8,42
Rapid Vienna,9154,3,9,9,6,35,31,4,36
LASK Linz,9154,4,9,5,10,31,31,0,32
Mattersburg,9154,5,7,5,12,32,44,-12,26
Vienna,9154,6,7,5,12,25,39,-14,26
SC Rheindorf,9154,7,6,5,13,20,30,-10,23
FC Salzburg,9155,1,15,6,3,44,18,26,51
SK Sturm Gra,9155,2,11,5,8,30,29,1,38
Rapid Vienna,9155,3,8,11,5,37,28,9,35
LASK Linz,9155,4,8,7,9,28,30,-2,31
Vienna,9155,5,8,5,11,26,38,-12,29
Mattersburg,9155,6,6,6,12,33,43,-10,24
SC Rheindorf,9155,7,5,6,13,18,30,-12,21
FC Salzburg,9156,1,14,7,3,47,20,27,49
SK Sturm Gra,9156,2,14,3,7,33,26,7,45
Rapid Vienna,9156,3,8,10,6,37,31,6,34
LASK Linz,9156,4,9,6,9,30,28,2,33
Vienna,9156,5,7,5,12,26,39,-13,26
Mattersburg,9156,6,5,7,12,27,43,-16,22
SC Rheindorf,9156,7,5,6,13,17,30,-13,21
FC Salzburg,9157,1,14,6,4,42,20,22,48
SK Sturm Gra,9157,2,12,4,8,31,28,3,40
LASK Linz,9157,3,9,7,8,28,26,2,34
Rapid Vienna,9157,4,8,9,7,32,26,6,33
Vienna,9157,5,8,5,11,27,38,-11,29
Mattersburg,9157,6,6,7,11,31,41,-10,25
SC Rheindorf,9157,7,5,6,13,19,31,-12,21
FC Salzburg,9158,1,15,6,3,46,23,23,51
Rapid Vienna,9158,2,11,9,4,38,24,14,42
SK Sturm Gra,9158,3,12,3,9,32,31,1,39
LASK Linz,9158,4,8,7,9,27,27,0,31
Vienna,9158,5,7,5,12,28,39,-11,26
SC Rheindorf,9158,6,5,6,13,16,27,-11,21
Mattersburg,9158,7,5,6,13,28,44,-16,21
FC Salzburg,9159,1,13,7,4,41,19,22,46
SK Sturm Gra,9159,2,14,4,6,33,25,8,46
LASK Linz,9159,3,9,5,10,25,26,-1,32
Rapid Vienna,9159,4,7,10,7,33,29,4,31
Vienna,9159,5,8,5,11,26,37,-11,29
Mattersburg,9159,6,6,6,12,30,42,-12,24
SC Rheindorf,9159,7,5,7,12,20,30,-10,22
FC Salzburg,9160,1,14,7,3,42,18,24,49
Rapid Vienna,9160,2,10,10,4,37,26,11,40
SK Sturm Gra,9160,3,12,3,9,32,29,3,39
LASK Linz,9160,4,9,6,9,29,29,0,33
Mattersburg,9160,5,6,6,12,31,43,-12,24
SC Rheindorf,9160,6,6,5,13,17,27,-10,23
Vienna,9160,7,6,5,13,25,41,-16,23
FC Salzburg,9161,1,14,7,3,43,19,24,49
SK Sturm Gra,9161,2,15,3,6,36,27,9,48
Rapid Vienna,9161,3,9,9,6,39,29,10,36
LASK Linz,9161,4,9,5,10,26,28,-2,32
Vienna,9161,5,7,5,12,26,39,-13,26
Mattersburg,9161,6,5,7,12,27,40,-13,22
SC Rheindorf,9161,7,4,6,14,18,33,-15,18
FC Salzburg,9162,1,15,6,3,49,18,31,51
SK Sturm Gra,9162,2,11,5,8,31,32,-1,38
Rapid Vienna,9162,3,8,10,6,33,28,5,34
LASK Linz,9162,4,9,6,9,31,31,0,33
Mattersburg,9162,5,8,5,11,39,44,-5,29
Vienna,9162,6,7,5,12,27,41,-14,26
SC Rheindorf,9162,7,5,5,14,19,35,-16,20
FC Salzburg,9163,1,13,7,4,43,20,23,46
SK Sturm Gra,9163,2,14,3,7,31,25,6,45
Rapid Vienna,9163,3,10,9,5,37,28,9,39
LASK Linz,9163,4,8,6,10,29,30,-1,30
Vienna,9163,5,7,6,11,27,40,-13,27
Mattersburg,9163,6,6,6,12,31,42,-11,24
SC Rheindorf,9163,7,5,5,14,20,33,-13,20
FC Salzburg,9164,1,15,7,2,47,17,30,52
SK Sturm Gra,9164,2,12,5,7,31,27,4,41
Rapid Vienna,9164,3,9,11,4,38,27,11,38
Mattersburg,9164,4,7,6,11,32,42,-10,27
LASK Linz,9164,5,7,5,12,26,32,-6,26
Vienna,9164,6,6,5,13,25,44,-19,23
SC Rheindorf,9164,7,5,7,12,20,30,-10,22
FC Salzburg,9165,1,16,6,2,47,16,31,54
SK Sturm Gra,9165,2,13,3,8,31,28,3,42
LASK Linz,9165,3,9,5,10,28,30,-2,32
Rapid Vienna,9165,4,7,10,7,31,28,3,31
Mattersburg,9165,5,7,5,12,36,43,-7,26
Vienna,9165,6,7,5,12,26,42,-16,26
SC Rheindorf,9165,7,5,6,13,17,29,-12,21
FC Salzburg,9166,1,16,6,2,53,16,37,54
SK Sturm Gra,9166,2,13,3,8,35,33,2,42
Rapid Vienna,9166,3,10,9,5,41,33,8,39
Mattersburg,9166,4,8,5,11,34,42,-8,29
LASK Linz,9166,5,7,5,12,25,32,-7,26
Vienna,9166,6,6,5,13,23,41,-18,23
SC Rheindorf,9166,7,5,5,14,21,35,-14,20
FC Salzburg,9167,1,14,6,4,43,20,23,48
SK Sturm Gra,9167,2,13,3,8,33,30,3,42
Rapid Vienna,9167,3,10,9,5,37,26,11,39
Mattersburg,9167,4,8,5,11,31,38,-7,29
LASK Linz,9167,5,7,6,11,24,28,-4,27
SC Rheindorf,9167,6,6,6,12,20,29,-9,24
Vienna,9167,7,6,5,13,25,42,-17,23
FC Salzburg,9168,1,15,7,2,51,19,32,52
SK Sturm Gra,9168,2,12,4,8,31,30,1,40
Rapid Vienna,9168,3,8,10,6,36,30,6,34
LASK Linz,9168,4,8,7,9,30,31,-1,31
Vienna,9168,5,7,6,11,27,39,-12,27
Mattersburg,9168,6,7,5,12,33,44,-11,26
SC Rheindorf,9168,7,5,5,14,18,33,-15,20
FC Salzburg,9169,1,15,6,3,51,20,31,51
SK Sturm Gra,9169,2,13,4,7,34,28,6,43
Rapid Vienna,9169,3,8,10,6,36,30,6,34
LASK Linz,9169,4,8,7,9,25,26,-1,31
Vienna,9169,5,7,5,12,29,42,-13,26
SC Rheindorf,9169,6,6,5,13,20,33,-13,23
Mattersburg,9169,7,6,5,13,29,45,-16,23
FC Salzburg,9170,1,15,7,2,46,16,30,52
SK Sturm Gra,9170,2,12,4,8,34,30,4,40
Rapid Vienna,9170,3,8,11,5,34,25,9,35
LASK Linz,9170,4,9,7,8,27,26,1,34
Mattersburg,9170,5,6,7,11,29,42,-13,25
Vienna,9170,6,6,5,13,24,41,-17,23
SC Rheindorf,9170,7,4,7,13,19,33,-14,19
FC Salzburg,9171,1,14,6,4,44,18,26,48
SK Sturm Gra,9171,2,12,4,8,37,34,3,40
Rapid Vienna,9171,3,10,9,5,35,26,9,39
LASK Linz,9171,4,8,7,9,30,31,-1,31
Vienna,9171,5,8,5,11,26,38,-12,29
SC Rheindorf,9171,6,6,5,13,23,31,-8,23
Mattersburg,9171,7,5,6,13,27,44,-17,21
FC Salzburg,9172,1,14,6,4,41,18,23,48
SK Sturm Gra,9172,2,12,5,7,31,29,2,41
Rapid Vienna,9172,3,10,10,4,34,23,11,40
LASK Linz,9172,4,8,6,10,28,29,-1,30
Vienna,9172,5,7,5,12,27,40,-13,26
Mattersburg,9172,6,6,6,12,31,42,-11,24
SC Rheindorf,9172,7,4,8,12,21,32,-11,20
FC Salzburg,9173,1,15,7,2,49,19,30,52
SK Sturm Gra,9173,2,13,3,8,35,29,6,42
Rapid Vienna,9173,3,10,10,4,39,25,14,40
LASK Linz,9173,4,7,5,12,26,37,-11,26
Vienna,9173,5,7,5,12,28,40,-12,26
Mattersburg,9173,6,7,5,12,30,43,-13,26
SC Rheindorf,9173,7,5,5,14,20,34,-14,20
FC Salzburg,9174,1,14,8,2,43,16,27,50
SK Sturm Gra,9174,2,13,4,7,32,26,6,43
Rapid Vienna,9174,3,7,11,6,32,27,5,32
LASK Linz,9174,4,8,5,11,26,32,-6,29
Mattersburg,9174,5,7,6,11,33,42,-9,27
Vienna,9174,6,6,6,12,25,40,-15,24
SC Rheindorf,9174,7,5,8,11,21,29,-8,23
FC Salzburg,9175,1,14,7,3,44,20,24,49
Rapid Vienna,9175,2,10,10,4,40,27,13,40
SK Sturm Gra,9175,3,12,4,8,31,27,4,40
LASK Linz,9175,4,7,8,9,27,31,-4,29
Mattersburg,9175,5,6,7,11,32,42,-10,25
Vienna,9175,6,6,5,13,24,40,-16,23
SC Rheindorf,9175,7,5,7,12,19,30,-11,22
FC Salzburg,9176,1,14,7,3,48,21,27,49
SK Sturm Gra,9176,2,12,4,8,33,34,-1,40
Rapid Vienna,9176,3,8,10,6,35,29,6,34
LASK Linz,9176,4,8,6,10,26,28,-2,30
Mattersburg,9176,5,8,6,10,36,42,-6,30
SC Rheindorf,9176,6,6,6,12,22,30,-8,24
Vienna,9176,7,6,5,13,26,42,-16,23
FC Salzburg,9177,1,14,8,2,42,17,25,50
SK Sturm Gra,9177,2,13,4,7,33,27,6,43
Rapid Vienna,9177,3,9,10,5,33,24,9,37
LASK Linz,9177,4,8,6,10,26,32,-6,30
Vienna,9177,5,7,5,12,26,40,-14,26
Mattersburg,9177,6,6,5,13,32,41,-9,23
SC Rheindorf,9177,7,5,6,13,20,31,-11,21
FC Salzburg,9178,1,15,7,2,44,17,27,52
SK Sturm Gra,9178,2,13,4,7,35,28,7,43
Rapid Vienna,9178,3,8,10,6,34,29,5,34
LASK Linz,9178,4,9,7,8,27,26,1,34
Vienna,9178,5,7,5,12,26,38,-12,26
Mattersburg,9178,6,6,6,12,28,41,-13,24
SC Rheindorf,9178,7,4,5,15,15,30,-15,17
FC Salzburg,9179,1,15,7,2,46,19,27,52
SK Sturm Gra,9179,2,12,6,6,33,28,5,42
Rapid Vienna,9179,3,8,10,6,34,27,7,34
LASK Linz,9179,4,7,6,11,26,31,-5,27
Mattersburg,9179,5,7,6,11,30,38,-8,27
SC Rheindorf,9179,6,6,6,12,18,26,-8,24
Vienna,9179,7,6,5,13,25,43,-18,23
FC Salzburg,9180,1,14,6,4,44,21,23,48
SK Sturm Gra,9180,2,13,3,8,33,29,4,42
Rapid Vienna,9180,3,8,10,6,34,27,7,34
LASK Linz,9180,4,9,6,9,29,28,1,33
Mattersburg,9180,5,8,5,11,38,41,-3,29
Vienna,9180,6,7,5,12,24,39,-15,26
SC Rheindorf,9180,7,4,7,13,18,35,-17,19
FC Salzburg,9181,1,16,6,2,50,16,34,54
SK Sturm Gra,9181,2,11,4,9,29,34,-5,37
Rapid Vienna,9181,3,9,9,6,35,27,8,36
LASK Linz,9181,4,8,7,9,25,27,-2,31
Vienna,9181,5,7,5,12,25,38,-13,26
SC Rheindorf,9181,6,6,6,12,18,27,-9,24
Mattersburg,9181,7,6,5,13,28,41,-13,23
FC Salzburg,9182,1,14,8,2,44,18,26,50
SK Sturm Gra,9182,2,13,3,8,32,28,4,42
LASK Linz,9182,3,9,7,8,29,28,1,34
Rapid Vienna,9182,4,7,9,8,32,31,1,30
Vienna,9182,5,7,6,11,27,38,-11,27
Mattersburg,9182,6,6,7,11,34,43,-9,25
SC Rheindorf,9182,7,5,6,13,20,32,-12,21
FC Salzburg,9183,1,14,7,3,47,19,28,49
SK Sturm Gra,9183,2,14,3,7,36,32,4,45
Rapid Vienna,9183,3,8,9,7,37,30,7,33
LASK Linz,9183,4,9,6,9,29,29,0,33
Mattersburg,9183,5,7,6,11,32,41,-9,27
Vienna,9183,6,6,5,13,24,43,-19,23
SC Rheindorf,9183,7,5,6,13,18,29,-11,21
FC Salzburg,9184,1,15,7,2,45,18,27,52
SK Sturm Gra,9184,2,12,4,8,35,33,2,40
Rapid Vienna,9184,3,8,11,5,38,30,8,35
LASK Linz,9184,4,9,5,10,27,28,-1,32
Vienna,9184,5,7,6,11,25,37,-12,27
Mattersburg,9184,6,7,5,12,30,41,-11,26
SC Rheindorf,9184,7,4,6,14,20,33,-13,18
FC Salzburg,9185,1,16,6,2,45,16,29,54
SK Sturm Gra,9185,2,12,5,7,35,29,6,41
Rapid Vienna,9185,3,7,10,7,34,31,3,31
LASK Linz,9185,4,7,8,9,26,29,-3,29
SC Rheindorf,9185,5,6,7,11,19,26,-7,25
Vienna,9185,6,6,6,12,23,38,-15,24
Mattersburg,9185,7,5,8,11,28,41,-13,23
FC Salzburg,9186,1,13,9,2,42,18,24,48
SK Sturm Gra,9186,2,12,5,7,30,26,4,41
Rapid Vienna,9186,3,8,12,4,37,26,11,36
LASK Linz,9186,4,8,6,10,26,28,-2,30
Vienna,9186,5,7,5,12,26,40,-14,26
SC Rheindorf,9186,6,6,6,12,19,30,-11,24
Mattersburg,9186,7,5,7,12,29,41,-12,22
FC Salzburg,9187,1,15,6,3,45,18,27,51
SK Sturm Gra,9187,2,12,3,9,31,33,-2,39
Rapid Vienna,9187,3,9,10,5,37,27,10,37
LASK Linz,9187,4,9,7,8,29,28,1,34
Vienna,9187,5,7,5,12,26,39,-13,26
Mattersburg,9187,6,5,7,12,27,40,-13,22
SC Rheindorf,9187,7,5,6,13,19,29,-10,21
FC Salzburg,9188,1,14,7,3,46,22,24,49
SK Sturm Gra,9188,2,13,4,7,36,30,6,43
Rapid Vienna,9188,3,7,11,6,32,29,3,32
LASK Linz,9188,4,8,7,9,26,27,-1,31
Vienna,9188,5,7,5,12,27,41,-14,26
SC Rheindorf,9188,6,6,6,12,21,28,-7,24
Mattersburg,9188,7,6,6,12,30,41,-11,24
FC Salzburg,9189,1,13,6,5,44,26,18,45
SK Sturm Gra,9189,2,12,4,8,34,30,4,40
Rapid Vienna,9189,3,9,10,5,37,26,11,37
LASK Linz,9189,4,10,5,9,28,25,3,35
Mattersburg,9189,5,8,5,11,30,40,-10,29
Vienna,9189,6,7,5,12,26,40,-14,26
SC Rheindorf,9189,7,4,7,13,18,30,-12,19
FC Salzburg,9190,1,15,7,2,47,18,29,52
SK Sturm Gra,9190,2,13,3,8,32,29,3,42
Rapid Vienna,9190,3,8,9,7,33,28,5,33
LASK Linz,9190,4,9,6,9,27,26,1,33
Vienna,9190,5,7,5,12,26,42,-16,26
SC Rheindorf,9190,6,5,7,12,18,28,-10,22
Mattersburg,9190,7,5,7,12,31,43,-12,22
FC Salzburg,9191,1,15,7,2,48,16,32,52
SK Sturm Gra,9191,2,14,3,7,35,29,6,45
Rapid Vienna,9191,3,8,11,5,34,25,9,35
LASK Linz,9191,4,7,6,11,24,30,-6,27
Mattersburg,9191,5,6,7,11,31,46,-15,25
Vienna,9191,6,6,5,13,24,40,-16,23
SC Rheindorf,9191,7,5,7,12,19,29,-10,22
FC Salzburg,9192,1,15,6,3,52,22,30,51
SK Sturm Gra,9192,2,12,4,8,32,30,2,40
Rapid Vienna,9192,3,8,11,5,36,27,9,35
LASK Linz,9192,4,7,6,11,28,35,-7,27
SC Rheindorf,9192,5,7,5,12,20,28,-8,26
Mattersburg,9192,6,7,5,12,33,44,-11,26
Vienna,9192,7,7,5,12,28,43,-15,26
FC Salzburg,9193,1,14,7,3,43,20,23,49
SK Sturm Gra,9193,2,13,3,8,33,30,3,42
Rapid Vienna,9193,3,8,11,5,34,26,8,35
LASK Linz,9193,4,9,5,10,30,33,-3,32
Vienna,9193,5,8,5,11,28,37,-9,29
SC Rheindorf,9193,6,6,6,12,22,28,-6,24
Mattersburg,9193,7,5,5,14,27,43,-16,20
FC Salzburg,9194,1,14,8,2,43,17,26,50
SK Sturm Gra,9194,2,13,4,7,32,28,4,43
LASK Linz,9194,3,9,7,8,31,28,3,34
Rapid Vienna,9194,4,7,11,6,32,27,5,32
Vienna,9194,5,7,6,11,25,37,-12,27
Mattersburg,9194,6,5,6,13,31,46,-15,21
SC Rheindorf,9194,7,4,8,12,19,30,-11,20
FC Salzburg,9195,1,14,7,3,47,22,25,49
SK Sturm Gra,9195,2,12,4,8,33,32,1,40
Rapid Vienna,9195,3,9,9,6,36,27,9,36
LASK Linz,9195,4,9,5,10,29,29,0,32
Mattersburg,9195,5,7,6,11,33,44,-11,27
Vienna,9195,6,7,5,12,31,44,-13,26
SC Rheindorf,9195,7,5,6,13,21,32,-11,21
FC Salzburg,9196,1,15,6,3,45,18,27,51
SK Sturm Gra,9196,2,12,4,8,34,30,4,40
Rapid Vienna,9196,3,8,10,6,33,28,5,34
LASK Linz,9196,4,9,6,9,28,28,0,33
Mattersburg,9196,5,7,5,12,29,41,-12,26
Vienna,9196,6,7,5,12,27,40,-13,26
SC Rheindorf,9196,7,5,6,13,16,27,-11,21
FC Salzburg,9197,1,14,7,3,43,18,25,49
SK Sturm Gra,9197,2,13,4,7,33,27,6,43
Rapid Vienna,9197,3,10,9,5,39,28,11,39
LASK Linz,9197,4,9,6,9,27,27,0,33
Vienna,9197,5,7,5,12,25,40,-15,26
SC Rheindorf,9197,6,5,6,13,18,31,-13,21
Mattersburg,9197,7,5,5,14,28,42,-14,20
FC Salzburg,9198,1,16,6,2,48,18,30,54
SK Sturm Gra,9198,2,11,4,9,30,34,-4,37
Rapid Vienna,9198,3,8,9,7,38,30,8,33
LASK Linz,9198,4,8,7,9,27,29,-2,31
SC Rheindorf,9198,5,7,5,12,23,29,-6,26
Vienna,9198,6,7,5,12,25,39,-14,26
Mattersburg,9198,7,6,6,12,31,43,-12,24
FC Salzburg,9199,1,14,7,3,46,21,25,49
SK Sturm Gra,9199,2,13,3,8,34,31,3,42
Rapid Vienna,9199,3,9,9,6,39,30,9,36
LASK Linz,9199,4,9,5,10,28,29,-1,32
Vienna,9199,5,7,5,12,26,40,-14,26
Mattersburg,9199,6,6,7,11,30,40,-10,25
SC Rheindorf,9199,7,5,6,13,18,30,-12,21
FC Salzburg,9200,1,16,6,2,49,17,32,54
SK Sturm Gra,9200,2,13,4,7,31,29,2,43
Rapid Vienna,9200,3,9,10,5,35,26,9,37
LASK Linz,9200,4,8,5,11,26,29,-3,29
Mattersburg,9200,5,7,5,12,28,40,-12,26
Vienna,9200,6,6,5,13,23,39,-16,23
SC Rheindorf,9200,7,5,5,14,17,29,-12,20
FC Salzburg,9201,1,14,7,3,45,20,25,49
Rapid Vienna,9201,2,10,10,4,41,28,13,40
SK Sturm Gra,9201,3,11,5,8,30,29,1,38
LASK Linz,9201,4,8,6,10,27,30,-3,30
Vienna,9201,5,7,6,11,25,38,-13,27
Mattersburg,9201,6,7,5,12,32,43,-11,26
SC Rheindorf,9201,7,4,7,13,19,31,-12,19
FC Salzburg,9202,1,14,7,3,43,19,24,49
SK Sturm Gra,9202,2,12,5,7,33,29,4,41
Rapid Vienna,9202,3,8,11,5,32,24,8,35
LASK Linz,9202,4,9,6,9,29,28,1,33
Mattersburg,9202,5,7,5,12,34,44,-10,26
Vienna,9202,6,7,5,12,24,39,-15,26
SC Rheindorf,9202,7,5,5,14,19,31,-12,20
FC Salzburg,9203,1,13,7,4,40,21,19,46
Rapid Vienna,9203,2,10,10,4,37,24,13,40
SK Sturm Gra,9203,3,12,4,8,33,27,6,40
LASK Linz,9203,4,8,6,10,27,29,-2,30
SC Rheindorf,9203,5,7,5,12,19,29,-10,26
Vienna,9203,6,7,5,12,26,38,-12,26
Mattersburg,9203,7,5,7,12,29,43,-14,22
FC Salzburg,9204,1,14,7,3,42,19,23,49
SK Sturm Gra,9204,2,12,4,8,32,28,4,40
Rapid Vienna,9204,3,8,11,5,35,26,9,35
LASK Linz,9204,4,9,5,10,25,32,-7,32
SC Rheindorf,9204,5,7,5,12,24,27,-3,26
Mattersburg,9204,6,7,5,12,28,38,-10,26
Vienna,9204,7,6,5,13,23,39,-16,23
FC Salzburg,9205,1,15,7,2,50,16,34,52
SK Sturm Gra,9205,2,12,3,9,30,31,-1,39
Rapid Vienna,9205,3,9,11,4,35,25,10,38
LASK Linz,9205,4,8,6,10,28,31,-3,30
SC Rheindorf,9205,5,6,6,12,23,30,-7,24
Mattersburg,9205,6,6,6,12,31,46,-15,24
Vienna,9205,7,6,5,13,24,42,-18,23
FC Salzburg,9206,1,13,9,2,42,18,24,48
SK Sturm Gra,9206,2,14,4,6,34,26,8,46
Rapid Vienna,9206,3,8,10,6,33,27,6,34
LASK Linz,9206,4,8,7,9,27,28,-1,31
Vienna,9206,5,7,6,11,29,41,-12,27
SC Rheindorf,9206,6,5,6,13,19,30,-11,21
Mattersburg,9206,7,5,6,13,30,44,-14,21
FC Salzburg,9207,1,14,7,3,50,21,29,49
SK Sturm Gra,9207,2,13,4,7,34,31,3,43
LASK Linz,9207,3,9,5,10,33,31,2,32
Mattersburg,9207,4,9,5,10,37,41,-4,32
Rapid Vienna,9207,5,7,10,7,33,34,-1,31
Vienna,9207,6,6,5,13,25,44,-19,23
SC Rheindorf,9207,7,5,6,13,20,30,-10,21
FC Salzburg,9208,1,14,7,3,45,20,25,49
SK Sturm Gra,9208,2,13,3,8,34,30,4,42
Rapid Vienna,9208,3,10,9,5,37,26,11,39
LASK Linz,9208,4,9,5,10,30,28,2,32
Mattersburg,9208,5,6,7,11,34,41,-7,25
Vienna,9208,6,6,6,12,27,43,-16,24
SC Rheindorf,9208,7,5,5,14,17,36,-19,20
FC Salzburg,9209,1,14,8,2,46,20,26,50
SK Sturm Gra,9209,2,13,4,7,35,30,5,43
Rapid Vienna,9209,3,8,10,6,37,30,7,34
Mattersburg,9209,4,7,7,10,33,41,-8,28
LASK Linz,9209,5,7,6,11,25,32,-7,27
Vienna,9209,6,6,6,12,28,43,-15,24
SC Rheindorf,9209,7,6,5,13,21,29,-8,23
FC Salzburg,9210,1,14,6,4,43,17,26,48
SK Sturm Gra,9210,2,13,3,8,33,27,6,42
Rapid Vienna,9210,3,9,9,6,35,28,7,36
LASK Linz,9210,4,8,5,11,29,31,-2,29
Vienna,9210,5,8,5,11,27,37,-10,29
Mattersburg,9210,6,7,5,12,33,44,-11,26
SC Rheindorf,9210,7,6,5,13,18,34,-16,23
FC Salzburg,9211,1,14,6,4,46,20,26,48
SK Sturm Gra,9211,2,12,5,7,33,30,3,41
Rapid Vienna,9211,3,9,11,4,39,28,11,38
LASK Linz,9211,4,8,7,9,30,33,-3,31
Mattersburg,9211,5,8,5,11,36,39,-3,29
Vienna,9211,6,7,5,12,25,42,-17,26
SC Rheindorf,9211,7,4,5,15,18,35,-17,17
FC Salzburg,9212,1,13,7,4,44,22,22,46
SK Sturm Gra,9212,2,14,4,6,39,28,11,46
Rapid Vienna,9212,3,9,10,5,36,28,8,37
LASK Linz,9212,4,7,6,11,28,33,-5,27
Vienna,9212,5,7,6,11,27,40,-13,27
Mattersburg,9212,6,6,7,11,33,43,-10,25
SC Rheindorf,9212,7,4,8,12,19,32,-13,20
FC Salzburg,9213,1,13,9,2,47,20,27,48
SK Sturm Gra,9213,2,13,4,7,35,31,4,43
Rapid Vienna,9213,3,9,10,5,36,26,10,37
LASK Linz,9213,4,8,6,10,29,32,-3,30
Mattersburg,9213,5,6,7,11,35,45,-10,25
Vienna,9213,6,6,6,12,25,41,-16,24
SC Rheindorf,9213,7,5,6,13,21,33,-12,21
FC Salzburg,9214,1,13,7,4,42,19,23,46
SK Sturm Gra,9214,2,12,6,6,33,27,6,42
Rapid Vienna,9214,3,9,9,6,37,27,10,36
LASK Linz,9214,4,9,7,8,30,26,4,34
Vienna,9214,5,8,5,11,28,38,-10,29
Mattersburg,9214,6,6,5,13,27,45,-18,23
SC Rheindorf,9214,7,4,7,13,16,31,-15,19
FC Salzburg,9215,1,13,9,2,41,17,24,48
SK Sturm Gra,9215,2,13,4,7,34,28,6,43
Rapid Vienna,9215,3,9,10,5,34,25,9,37
LASK Linz,9215,4,8,7,9,28,28,0,31
Mattersburg,9215,5,7,6,11,32,39,-7,27
Vienna,9215,6,6,6,12,23,40,-17,24
SC Rheindorf,9215,7,4,6,14,17,32,-15,18
FC Salzburg,9216,1,15,6,3,44,17,27,51
Rapid Vienna,9216,2,10,10,4,36,25,11,40
SK Sturm Gra,9216,3,12,4,8,29,26,3,40
LASK Linz,9216,4,8,7,9,26,27,-1,31
Vienna,9216,5,7,5,12,25,40,-15,26
Mattersburg,9216,6,6,5,13,31,41,-10,23
SC Rheindorf,9216,7,4,7,13,17,32,-15,19
FC Salzburg,9217,1,13,7,4,44,20,24,46
SK Sturm Gra,9217,2,14,3,7,38,29,9,45
Rapid Vienna,9217,3,9,9,6,37,30,7,36
LASK Linz,9217,4,9,7,8,28,27,1,34
Vienna,9217,5,7,5,12,26,42,-16,26
Mattersburg,9217,6,5,7,12,32,44,-12,22
SC Rheindorf,9217,7,5,6,13,20,33,-13,21
FC Salzburg,9218,1,13,7,4,42,20,22,46
SK Sturm Gra,9218,2,12,3,9,30,31,-1,39
Rapid Vienna,9218,3,8,11,5,38,28,10,35
LASK Linz,9218,4,9,6,9,28,28,0,33
Mattersburg,9218,5,7,5,12,29,38,-9,26
Vienna,9218,6,7,5,12,24,38,-14,26
SC Rheindorf,9218,7,6,7,11,20,28,-8,25
FC Salzburg,9219,1,14,7,3,44,18,26,49
Rapid Vienna,9219,2,10,10,4,41,26,15,40
SK Sturm Gra,9219,3,12,4,8,35,33,2,40
LASK Linz,9219,4,8,6,10,28,32,-4,30
Mattersburg,9219,5,7,5,12,32,41,-9,26
Vienna,9219,6,7,5,12,25,39,-14,26
SC Rheindorf,9219,7,4,7,13,17,33,-16,19
FC Salzburg,9220,1,14,6,4,47,21,26,48
SK Sturm Gra,9220,2,15,3,6,37,25,12,48
Rapid Vienna,9220,3,9,10,5,36,28,8,37
LASK Linz,9220,4,8,5,11,26,30,-4,29
Vienna,9220,5,7,5,12,25,40,-15,26
SC Rheindorf,9220,6,6,6,12,17,26,-9,24
Mattersburg,9220,7,5,5,14,27,45,-18,20
FC Salzburg,9221,1,15,7,2,50,20,30,52
SK Sturm Gra,9221,2,11,4,9,31,33,-2,37
Rapid Vienna,9221,3,9,9,6,36,29,7,36
LASK Linz,9221,4,9,6,9,31,29,2,33
Vienna,9221,5,7,6,11,29,42,-13,27
Mattersburg,9221,6,7,5,12,33,44,-11,26
SC Rheindorf,9221,7,4,7,13,18,31,-13,19
FC Salzburg,9222,1,16,6,2,48,18,30,54
SK Sturm Gra,9222,2,13,3,8,38,32,6,42
Rapid Vienna,9222,3,8,10,6,36,29,7,34
LASK Linz,9222,4,8,8,8,27,26,1,32
Vienna,9222,5,7,5,12,27,41,-14,26
Mattersburg,9222,6,5,6,13,29,43,-14,21
SC Rheindorf,9222,7,5,6,13,18,34,-16,21
FC Salzburg,9223,1,15,6,3,44,19,25,51
SK Sturm Gra,9223,2,13,3,8,32,30,2,42
Rapid Vienna,9223,3,9,10,5,38,27,11,37
LASK Linz,9223,4,7,7,10,27,31,-4,28
Vienna,9223,5,7,5,12,25,39,-14,26
Mattersburg,9223,6,6,6,12,30,40,-10,24
SC Rheindorf,9223,7,6,5,13,20,30,-10,23
FC Salzburg,9224,1,15,7,2,51,24,27,52
SK Sturm Gra,9224,2,13,4,7,34,28,6,43
Rapid Vienna,9224,3,8,10,6,37,28,9,34
LASK Linz,9224,4,9,6,9,27,26,1,33
Vienna,9224,5,7,5,12,28,43,-15,26
Mattersburg,9224,6,5,6,13,30,44,-14,21
SC Rheindorf,9224,7,5,6,13,18,32,-14,21
FC Salzburg,9225,1,15,6,3,43,17,26,51
SK Sturm Gra,9225,2,11,4,9,28,29,-1,37
Rapid Vienna,9225,3,8,11,5,36,27,9,35
LASK Linz,9225,4,8,7,9,26,27,-1,31
Vienna,9225,5,7,6,11,27,40,-13,27
SC Rheindorf,9225,6,6,7,11,21,29,-8,25
Mattersburg,9225,7,5,7,12,31,43,-12,22
FC Salzburg,9226,1,16,6,2,47,17,30,54
SK Sturm Gra,9226,2,12,4,8,34,33,1,40
Rapid Vienna,9226,3,9,9,6,38,28,10,36
LASK Linz,9226,4,7,7,10,23,26,-3,28
Mattersburg,9226,5,6,7,11,31,43,-12,25
SC Rheindorf,9226,6,6,6,12,23,32,-9,24
Vienna,9226,7,6,5,13,25,42,-17,23
FC Salzburg,9227,1,14,8,2,45,20,25,50
SK Sturm Gra,9227,2,11,5,8,29,27,2,38
LASK Linz,9227,3,10,6,8,26,24,2,36
Rapid Vienna,9227,4,8,10,6,34,26,8,34
Vienna,9227,5,7,6,11,27,40,-13,27
Mattersburg,9227,6,5,7,12,30,42,-12,22
SC Rheindorf,9227,7,5,6,13,18,30,-12,21
FC Salzburg,9228,1,16,6,2,47,17,30,54
SK Sturm Gra,9228,2,12,4,8,32,30,2,40
Rapid Vienna,9228,3,9,9,6,34,26,8,36
LASK Linz,9228,4,7,7,10,27,31,-4,28
Mattersburg,9228,5,7,6,11,30,39,-9,27
SC Rheindorf,9228,6,6,5,13,20,30,-10,23
Vienna,9228,7,6,5,13,25,42,-17,23
FC Salzburg,9229,1,14,8,2,44,18,26,50
Rapid Vienna,9229,2,9,11,4,37,26,11,38
SK Sturm Gra,9229,3,11,3,10,31,32,-1,36
LASK Linz,9229,4,8,7,9,30,33,-3,31
Mattersburg,9229,5,6,8,10,36,44,-8,26
SC Rheindorf,9229,6,6,6,12,22,29,-7,24
Vienna,9229,7,6,5,13,24,42,-18,23
FC Salzburg,9230,1,14,7,3,44,18,26,49
SK Sturm Gra,9230,2,11,5,8,31,31,0,38
Rapid Vienna,9230,3,8,11,5,35,27,8,35
LASK Linz,9230,4,9,7,8,28,27,1,34
Mattersburg,9230,5,7,5,12,31,41,-10,26
Vienna,9230,6,7,5,12,25,41,-16,26
SC Rheindorf,9230,7,5,6,13,19,28,-9,21
FC Salzburg,9231,1,14,8,2,47,18,29,50
Rapid Vienna,9231,2,9,11,4,37,26,11,38
SK Sturm Gra,9231,3,11,3,10,28,31,-3,36
LASK Linz,9231,4,8,6,10,29,30,-1,30
Mattersburg,9231,5,7,6,11,31,43,-12,27
SC Rheindorf,9231,6,6,6,12,18,27,-9,24
Vienna,9231,7,6,6,12,25,40,-15,24
FC Salzburg,9232,1,15,6,3,45,19,26,51
SK Sturm Gra,9232,2,13,3,8,35,30,5,42
Rapid Vienna,9232,3,9,10,5,39,28,11,37
Vienna,9232,4,8,5,11,27,37,-10,29
LASK Linz,9232,5,7,7,10,26,30,-4,28
SC Rheindorf,9232,6,6,5,13,21,33,-12,23
Mattersburg,9232,7,5,6,13,30,46,-16,21
FC Salzburg,9233,1,13,7,4,45,23,22,46
SK Sturm Gra,9233,2,13,4,7,33,29,4,43
Rapid Vienna,9233,3,9,10,5,36,26,10,37
LASK Linz,9233,4,8,6,10,25,29,-4,30
Vienna,9233,5,7,6,11,29,41,-12,27
Mattersburg,9233,6,6,6,12,33,45,-12,24
SC Rheindorf,9233,7,5,7,12,21,29,-8,22
FC Salzburg,9234,1,14,8,2,44,16,28,50
SK Sturm Gra,9234,2,12,5,7,29,25,4,41
Rapid Vienna,9234,3,9,10,5,38,26,12,37
LASK Linz,9234,4,8,6,10,27,28,-1,30
Vienna,9234,5,7,5,12,26,42,-16,26
SC Rheindorf,9234,6,5,7,12,20,33,-13,22
Mattersburg,9234,7,5,7,12,30,44,-14,22
FC Salzburg,9235,1,15,7,2,42,16,26,52
SK Sturm Gra,9235,2,12,4,8,30,26,4,40
Rapid Vienna,9235,3,8,9,7,33,29,4,33
LASK Linz,9235,4,9,6,9,27,26,1,33
Mattersburg,9235,5,7,5,12,29,39,-10,26
Vienna,9235,6,6,6,12,25,40,-15,24
SC Rheindorf,9235,7,6,5,13,17,27,-10,23
FC Salzburg,9236,1,14,7,3,47,21,26,49
SK Sturm Gra,9236,2,13,5,6,34,28,6,44
Rapid Vienna,9236,3,7,12,5,31,25,6,33
LASK Linz,9236,4,8,7,9,27,27,0,31
Vienna,9236,5,7,5,12,26,41,-15,26
SC Rheindorf,9236,6,6,6,12,20,29,-9,24
Mattersburg,9236,7,5,6,13,30,44,-14,21
FC Salzburg,9237,1,14,6,4,43,20,23,48
SK Sturm Gra,9237,2,13,3,8,34,30,4,42
Rapid Vienna,9237,3,8,11,5,39,30,9,35
LASK Linz,9237,4,8,6,10,28,33,-5,30
Mattersburg,9237,5,8,5,11,33,40,-7,29
SC Rheindorf,9237,6,6,6,12,22,29,-7,24
Vienna,9237,7,6,5,13,24,41,-17,23
FC Salzburg,9238,1,15,6,3,50,21,29,51
SK Sturm Gra,9238,2,13,4,7,35,32,3,43
Rapid Vienna,9238,3,10,10,4,40,28,12,40
LASK Linz,9238,4,8,6,10,26,28,-2,30
Vienna,9238,5,7,5,12,25,41,-16,26
Mattersburg,9238,6,6,6,12,30,41,-11,24
SC Rheindorf,9238,7,4,5,15,16,31,-15,17
FC Salzburg,9239,1,15,7,2,48,17,31,52
SK Sturm Gra,9239,2,14,3,7,35,28,7,45
Rapid Vienna,9239,3,9,9,6,34,26,8,36
LASK Linz,9239,4,8,6,10,28,31,-3,30
Vienna,9239,5,6,6,12,23,42,-19,24
Mattersburg,9239,6,5,8,11,30,41,-11,23
SC Rheindorf,9239,7,5,5,14,19,32,-13,20
FC Salzburg,9240,1,14,7,3,43,18,25,49
SK Sturm Gra,9240,2,13,3,8,32,28,4,42
Rapid Vienna,9240,3,9,10,5,35,25,10,37
LASK Linz,9240,4,7,7,10,24,27,-3,28
Mattersburg,9240,5,7,7,10,32,40,-8,28
SC Rheindorf,9240,6,6,5,13,20,31,-11,23
Vienna,9240,7,6,5,13,24,41,-17,23
FC Salzburg,9241,1,16,6,2,49,17,32,54
SK Sturm Gra,9241,2,13,4,7,34,28,6,43
Rapid Vienna,9241,3,8,11,5,36,28,8,35
LASK Linz,9241,4,7,6,11,25,30,-5,27
Vienna,9241,5,7,5,12,26,39,-13,26
Mattersburg,9241,6,7,5,12,30,44,-14,26
SC Rheindorf,9241,7,5,5,14,18,32,-14,20
FC Salzburg,9242,1,12,7,5,39,20,19,43
SK Sturm Gra,9242,2,13,3,8,34,31,3,42
Rapid Vienna,9242,3,10,9,5,37,26,11,39
LASK Linz,9242,4,8,5,11,25,28,-3,29
SC Rheindorf,9242,5,8,5,11,23,27,-4,29
Vienna,9242,6,7,6,11,27,40,-13,27
Mattersburg,9242,7,6,5,13,29,42,-13,23
FC Salzburg,9243,1,14,7,3,47,18,29,49
SK Sturm Gra,9243,2,12,4,8,33,29,4,40
Rapid Vienna,9243,3,8,11,5,34,27,7,35
LASK Linz,9243,4,9,6,9,27,28,-1,33
SC Rheindorf,9243,5,6,7,11,20,27,-7,25
Vienna,9243,6,6,6,12,26,43,-17,24
Mattersburg,9243,7,5,7,12,30,45,-15,22
FC Salzburg,9244,1,15,7,2,45,18,27,52
SK Sturm Gra,9244,2,13,4,7,33,28,5,43
Rapid Vienna,9244,3,9,10,5,38,27,11,37
LASK Linz,9244,4,9,5,10,29,28,1,32
Vienna,9244,5,7,5,12,27,38,-11,26
Mattersburg,9244,6,6,6,12,31,47,-16,24
SC Rheindorf,9244,7,4,5,15,18,35,-17,17
FC Salzburg,9245,1,15,7,2,47,18,29,52
Rapid Vienna,9245,2,9,10,5,36,28,8,37
SK Sturm Gra,9245,3,11,4,9,31,30,1,37
LASK Linz,9245,4,10,6,8,28,26,2,36
Mattersburg,9245,5,7,5,12,32,42,-10,26
Vienna,9245,6,6,5,13,23,40,-17,23
SC Rheindorf,9245,7,5,5,14,18,31,-13,20
FC Salzburg,9246,1,14,7,3,45,18,27,49
SK Sturm Gra,9246,2,13,4,7,36,29,7,43
Rapid Vienna,9246,3,11,9,4,38,24,14,42
LASK Linz,9246,4,7,6,11,25,32,-7,27
Mattersburg,9246,5,7,6,11,34,44,-10,27
Vienna,9246,6,6,6,12,26,42,-16,24
SC Rheindorf,9246,7,4,6,14,19,34,-15,18
FC Salzburg,9247,1,13,8,3,44,19,25,47
SK Sturm Gra,9247,2,13,4,7,33,28,5,43
Rapid Vienna,9247,3,7,11,6,36,31,5,32
LASK Linz,9247,4,8,7,9,28,27,1,31
Vienna,9247,5,8,5,11,28,38,-10,29
SC Rheindorf,9247,6,7,6,11,23,28,-5,27
Mattersburg,9247,7,5,5,14,30,51,-21,20
FC Salzburg,9248,1,13,8,3,41,18,23,47
SK Sturm Gra,9248,2,13,3,8,32,29,3,42
Rapid Vienna,9248,3,9,10,5,37,26,11,37
LASK Linz,9248,4,8,6,10,26,29,-3,30
Vienna,9248,5,7,6,11,26,39,-13,27
Mattersburg,9248,6,6,8,10,30,39,-9,26
SC Rheindorf,9248,7,5,5,14,19,31,-12,20
FC Salzburg,9249,1,14,7,3,43,18,25,49
SK Sturm Gra,9249,2,13,4,7,32,28,4,43
Rapid Vienna,9249,3,8,10,6,34,27,7,34
LASK Linz,9249,4,9,6,9,27,29,-2,33
Mattersburg,9249,5,6,7,11,33,41,-8,25
Vienna,9249,6,6,6,12,24,39,-15,24
SC Rheindorf,9249,7,5,6,13,19,30,-11,21
FC Salzburg,9250,1,16,6,2,58,17,41,54
SK Sturm Gra,9250,2,14,3,7,37,32,5,45
Rapid Vienna,9250,3,7,10,7,36,34,2,31
LASK Linz,9250,4,8,6,10,28,34,-6,30
Vienna,9250,5,7,5,12,26,43,-17,26
Mattersburg,9250,6,6,6,12,34,48,-14,24
SC Rheindorf,9250,7,5,6,13,21,32,-11,21
FC Salzburg,9251,1,14,7,3,43,20,23,49
Rapid Vienna,9251,2,10,9,5,37,25,12,39
SK Sturm Gra,9251,3,11,5,8,34,34,0,38
LASK Linz,9251,4,7,7,10,26,31,-5,28
Mattersburg,9251,5,7,6,11,32,39,-7,27
Vienna,9251,6,7,5,12,25,39,-14,26
SC Rheindorf,9251,7,5,7,12,22,31,-9,22
FC Salzburg,9252,1,14,7,3,46,21,25,49
SK Sturm Gra,9252,2,13,4,7,37,31,6,43
Rapid Vienna,9252,3,8,10,6,36,30,6,34
LASK Linz,9252,4,9,5,10,29,31,-2,32
Mattersburg,9252,5,7,5,12,35,42,-7,26
Vienna,9252,6,7,5,12,28,43,-15,26
SC Rheindorf,9252,7,5,6,13,20,33,-13,21
FC Salzburg,9253,1,14,7,3,45,20,25,49
SK Sturm Gra,9253,2,12,5,7,33,30,3,41
Rapid Vienna,9253,3,9,10,5,37,27,10,37
LASK Linz,9253,4,8,7,9,28,29,-1,31
Vienna,9253,5,7,5,12,26,39,-13,26
Mattersburg,9253,6,6,6,12,29,42,-13,24
SC Rheindorf,9253,7,4,8,12,19,30,-11,20
FC Salzburg,9254,1,15,6,3,48,19,29,51
SK Sturm Gra,9254,2,12,4,8,34,30,4,40
LASK Linz,9254,3,9,7,8,29,28,1,34
Rapid Vienna,9254,4,8,9,7,34,30,4,33
Vienna,9254,5,7,5,12,29,42,-13,26
SC Rheindorf,9254,6,6,6,12,19,29,-10,24
Mattersburg,9254,7,6,5,13,32,47,-15,23
FC Salzburg,9255,1,15,6,3,48,20,28,51
SK Sturm Gra,9255,2,13,4,7,36,28,8,43
Rapid Vienna,9255,3,9,10,5,35,28,7,37
LASK Linz,9255,4,9,5,10,28,28,0,32
Mattersburg,9255,5,7,5,12,32,43,-11,26
Vienna,9255,6,6,5,13,26,45,-19,23
SC Rheindorf,9255,7,5,5,14,16,29,-13,20
FC Salzburg,9256,1,16,6,2,52,22,30,54
SK Sturm Gra,9256,2,13,3,8,34,34,0,42
Rapid Vienna,9256,3,10,9,5,42,29,13,39
LASK Linz,9256,4,8,5,11,27,31,-4,29
Mattersburg,9256,5,6,6,12,32,41,-9,24
Vienna,9256,6,6,6,12,28,43,-15,24
SC Rheindorf,9256,7,5,5,14,17,32,-15,20
FC Salzburg,9257,1,14,7,3,41,17,24,49
SK Sturm Gra,9257,2,12,4,8,33,30,3,40
Rapid Vienna,9257,3,10,9,5,41,26,15,39
LASK Linz,9257,4,9,6,9,29,29,0,33
Vienna,9257,5,7,5,12,24,39,-15,26
Mattersburg,9257,6,6,6,12,29,41,-12,24
SC Rheindorf,9257,7,5,5,14,18,33,-15,20
FC Salzburg,9258,1,13,7,4,41,19,22,46
Rapid Vienna,9258,2,10,10,4,36,24,12,40
SK Sturm Gra,9258,3,11,6,7,30,27,3,39
LASK Linz,9258,4,8,6,10,27,30,-3,30
Mattersburg,9258,5,7,5,12,29,40,-11,26
Vienna,9258,6,7,5,12,25,38,-13,26
SC Rheindorf,9258,7,6,5,13,19,29,-10,23
FC Salzburg,9259,1,13,7,4,42,20,22,46
SK Sturm Gra,9259,2,12,4,8,33,32,1,40
Rapid Vienna,9259,3,9,11,4,41,28,13,38
LASK Linz,9259,4,8,8,8,33,32,1,32
Vienna,9259,5,7,6,11,27,40,-13,27
SC Rheindorf,9259,6,5,7,12,17,28,-11,22
Mattersburg,9259,7,5,7,12,28,41,-13,22
FC Salzburg,9260,1,14,7,3,43,18,25,49
SK Sturm Gra,9260,2,14,3,7,39,32,7,45
Rapid Vienna,9260,3,8,10,6,38,29,9,34
LASK Linz,9260,4,9,5,10,28,32,-4,32
Vienna,9260,5,7,6,11,26,38,-12,27
SC Rheindorf,9260,6,6,6,12,24,33,-9,24
Mattersburg,9260,7,5,5,14,30,46,-16,20
FC Salzburg,9261,1,15,6,3,46,21,25,51
SK Sturm Gra,9261,2,13,3,8,37,28,9,42
LASK Linz,9261,3,9,6,9,30,27,3,33
Rapid Vienna,9261,4,8,9,7,33,33,0,33
Vienna,9261,5,8,5,11,32,41,-9,29
Mattersburg,9261,6,6,6,12,31,45,-14,24
SC Rheindorf,9261,7,4,7,13,19,33,-14,19
FC Salzburg,9262,1,14,7,3,46,20,26,49
Rapid Vienna,9262,2,10,10,4,42,30,12,40
SK Sturm Gra,9262,3,11,4,9,29,31,-2,37
LASK Linz,9262,4,7,6,11,26,32,-6,27
Mattersburg,9262,5,7,6,11,31,41,-10,27
Vienna,9262,6,7,5,12,25,38,-13,26
SC Rheindorf,9262,7,6,6,12,23,30,-7,24
FC Salzburg,9263,1,13,8,3,44,20,24,47
SK Sturm Gra,9263,2,14,4,6,33,25,8,46
Rapid Vienna,9263,3,8,10,6,35,27,8,34
LASK Linz,9263,4,8,6,10,27,32,-5,30
Vienna,9263,5,8,5,11,30,40,-10,29
Mattersburg,9263,6,6,6,12,30,44,-14,24
SC Rheindorf,9263,7,5,5,14,19,30,-11,20
FC Salzburg,9264,1,15,6,3,46,20,26,51
SK Sturm Gra,9264,2,12,4,8,34,34,0,40
Rapid Vienna,9264,3,8,10,6,39,30,9,34
LASK Linz,9264,4,9,7,8,27,26,1,34
Mattersburg,9264,5,7,6,11,33,38,-5,27
Vienna,9264,6,6,5,13,24,44,-20,23
SC Rheindorf,9264,7,5,6,13,19,30,-11,21
FC Salzburg,9265,1,13,8,3,45,21,24,47
SK Sturm Gra,9265,2,12,5,7,30,26,4,41
Rapid Vienna,9265,3,8,11,5,37,29,8,35
LASK Linz,9265,4,8,5,11,28,32,-4,29
Mattersburg,9265,5,7,5,12,33,45,-12,26
Vienna,9265,6,7,5,12,27,41,-14,26
SC Rheindorf,9265,7,6,7,11,20,26,-6,25
FC Salzburg,9266,1,14,6,4,44,20,24,48
SK Sturm Gra,9266,2,14,3,7,37,28,9,45
Rapid Vienna,9266,3,8,10,6,37,31,6,34
LASK Linz,9266,4,8,6,10,28,31,-3,30
SC Rheindorf,9266,5,7,5,12,20,28,-8,26
Mattersburg,9266,6,6,6,12,29,40,-11,24
Vienna,9266,7,6,6,12,23,40,-17,24
FC Salzburg,9267,1,16,6,2,48,18,30,54
SK Sturm Gra,9267,2,13,4,7,35,29,6,43
Rapid Vienna,9267,3,8,10,6,36,30,6,34
LASK Linz,9267,4,8,7,9,26,28,-2,31
Mattersburg,9267,5,7,5,12,33,43,-10,26
Vienna,9267,6,7,5,12,28,41,-13,26
SC Rheindorf,9267,7,4,5,15,18,35,-17,17
FC Salzburg,9268,1,15,7,2,45,16,29,52
SK Sturm Gra,9268,2,12,6,6,34,29,5,42
Rapid Vienna,9268,3,8,9,7,34,29,5,33
LASK Linz,9268,4,9,6,9,29,28,1,33
Vienna,9268,5,7,5,12,27,40,-13,26
Mattersburg,9268,6,6,5,13,29,45,-16,23
SC Rheindorf,9268,7,5,6,13,21,32,-11,21
FC Salzburg,9269,1,14,7,3,44,18,26,49
SK Sturm Gra,9269,2,11,6,7,33,31,2,39
Rapid Vienna,9269,3,9,11,4,39,27,12,38
LASK Linz,9269,4,8,7,9,27,29,-2,31
Vienna,9269,5,7,5,12,26,40,-14,26
SC Rheindorf,9269,6,6,6,12,23,31,-8,24
Mattersburg,9269,7,5,6,13,30,46,-16,21
FC Salzburg,9270,1,16,6,2,48,18,30,54
SK Sturm Gra,9270,2,12,4,8,32,32,0,40
Rapid Vienna,9270,3,7,10,7,34,30,4,31
LASK Linz,9270,4,8,7,9,27,27,0,31
Vienna,9270,5,7,5,12,26,40,-14,26
SC Rheindorf,9270,6,6,7,11,22,29,-7,25
Mattersburg,9270,7,5,7,12,28,41,-13,22
FC Salzburg,9271,1,16,6,2,45,15,30,54
SK Sturm Gra,9271,2,12,3,9,29,27,2,39
LASK Linz,9271,3,10,5,9,30,28,2,35
Rapid Vienna,9271,4,7,10,7,33,29,4,31
SC Rheindorf,9271,5,6,6,12,20,29,-9,24
Mattersburg,9271,6,6,6,12,32,44,-12,24
Vienna,9271,7,6,6,12,24,41,-17,24
FC Salzburg,9272,1,15,6,3,46,21,25,51
SK Sturm Gra,9272,2,12,5,7,30,26,4,41
Rapid Vienna,9272,3,8,10,6,36,32,4,34
LASK Linz,9272,4,9,5,10,31,30,1,32
Mattersburg,9272,5,7,6,11,34,42,-8,27
Vienna,9272,6,6,6,12,25,40,-15,24
SC Rheindorf,9272,7,5,6,13,22,33,-11,21
FC Salzburg,9273,1,14,8,2,45,17,28,50
SK Sturm Gra,9273,2,12,3,9,32,32,0,39
LASK Linz,9273,3,10,6,8,29,26,3,36
Rapid Vienna,9273,4,8,11,5,36,26,10,35
Mattersburg,9273,5,6,7,11,34,44,-10,25
Vienna,9273,6,6,7,11,26,40,-14,25
SC Rheindorf,9273,7,4,6,14,19,36,-17,18
FC Salzburg,9274,1,15,7,2,49,19,30,52
Rapid Vienna,9274,2,9,11,4,39,28,11,38
SK Sturm Gra,9274,3,11,4,9,35,35,0,37
LASK Linz,9274,4,7,8,9,28,30,-2,29
Mattersburg,9274,5,7,6,11,30,43,-13,27
Vienna,9274,6,6,6,12,26,41,-15,24
SC Rheindorf,9274,7,5,6,13,22,33,-11,21
FC Salzburg,9275,1,15,7,2,46,19,27,52
SK Sturm Gra,9275,2,13,4,7,35,30,5,43
LASK Linz,9275,3,10,5,9,27,25,2,35
Rapid Vienna,9275,4,7,9,8,32,30,2,30
SC Rheindorf,9275,5,7,5,12,22,29,-7,26
Vienna,9275,6,7,5,12,27,40,-13,26
Mattersburg,9275,7,5,5,14,29,45,-16,20
FC Salzburg,9276,1,13,6,5,43,21,22,45
SK Sturm Gra,9276,2,13,4,7,36,28,8,43
Rapid Vienna,9276,3,9,11,4,36,24,12,38
Vienna,9276,4,8,5,11,26,38,-12,29
LASK Linz,9276,5,7,7,10,23,32,-9,28
Mattersburg,9276,6,6,6,12,30,40,-10,24
SC Rheindorf,9276,7,6,5,13,20,31,-11,23
FC Salzburg,9277,1,14,6,4,46,20,26,48
SK Sturm Gra,9277,2,12,5,7,32,28,4,41
Rapid Vienna,9277,3,9,11,4,34,24,10,38
LASK Linz,9277,4,9,5,10,30,29,1,32
Vienna,9277,5,7,6,11,26,38,-12,27
Mattersburg,9277,6,5,7,12,31,48,-17,22
SC Rheindorf,9277,7,4,8,12,18,30,-12,20
FC Salzburg,9278,1,16,6,2,51,17,34,54
SK Sturm Gra,9278,2,12,5,7,31,29,2,41
Rapid Vienna,9278,3,9,10,5,35,28,7,37
LASK Linz,9278,4,9,6,9,27,27,0,33
Vienna,9278,5,7,5,12,24,39,-15,26
Mattersburg,9278,6,6,5,13,30,44,-14,23
SC Rheindorf,9278,7,4,5,15,20,34,-14,17
FC Salzburg,9279,1,16,6,2,49,17,32,54
SK Sturm Gra,9279,2,12,4,8,32,31,1,40
Rapid Vienna,9279,3,8,11,5,37,27,10,35
LASK Linz,9279,4,7,7,10,27,31,-4,28
Mattersburg,9279,5,7,5,12,31,42,-11,26
Vienna,9279,6,7,5,12,27,42,-15,26
SC Rheindorf,9279,7,5,6,13,19,32,-13,21
FC Salzburg,9280,1,16,6,2,47,18,29,54
SK Sturm Gra,9280,2,12,4,8,34,33,1,40
Rapid Vienna,9280,3,8,11,5,39,29,10,35
LASK Linz,9280,4,7,7,10,27,30,-3,28
Mattersburg,9280,5,7,6,11,32,40,-8,27
Vienna,9280,6,6,5,13,24,42,-18,23
SC Rheindorf,9280,7,5,7,12,20,31,-11,22
FC Salzburg,9281,1,13,7,4,42,19,23,46
SK Sturm Gra,9281,2,13,4,7,34,29,5,43
Rapid Vienna,9281,3,8,10,6,36,29,7,34
LASK Linz,9281,4,7,6,11,24,28,-4,27
Mattersburg,9281,5,7,6,11,33,41,-8,27
Vienna,9281,6,7,6,11,28,41,-13,27
SC Rheindorf,9281,7,7,5,12,22,32,-10,26
FC Salzburg,9282,1,15,6,3,43,17,26,51
SK Sturm Gra,9282,2,12,3,9,30,29,1,39
Rapid Vienna,9282,3,8,10,6,38,28,10,34
LASK Linz,9282,4,9,5,10,27,31,-4,32
Vienna,9282,5,8,5,11,28,39,-11,29
Mattersburg,9282,6,7,5,12,31,42,-11,26
SC Rheindorf,9282,7,5,6,13,18,29,-11,21
FC Salzburg,9283,1,15,6,3,46,18,28,51
Rapid Vienna,9283,2,9,10,5,36,26,10,37
SK Sturm Gra,9283,3,11,3,10,28,32,-4,36
LASK Linz,9283,4,9,5,10,30,29,1,32
Vienna,9283,5,8,5,11,30,40,-10,29
SC Rheindorf,9283,6,6,7,11,21,29,-8,25
Mattersburg,9283,7,5,6,13,31,48,-17,21
FC Salzburg,9284,1,14,7,3,41,17,24,49
SK Sturm Gra,9284,2,12,3,9,32,30,2,39
Rapid Vienna,9284,3,9,10,5,39,26,13,37
LASK Linz,9284,4,9,7,8,29,28,1,34
Mattersburg,9284,5,6,7,11,30,41,-11,25
Vienna,9284,6,6,7,11,25,39,-14,25
SC Rheindorf,9284,7,5,5,14,18,33,-15,20
FC Salzburg,9285,1,15,7,2,50,20,30,52
SK Sturm Gra,9285,2,12,4,8,29,30,-1,40
LASK Linz,9285,3,10,5,9,31,28,3,35
Rapid Vienna,9285,4,8,10,6,35,30,5,34
Vienna,9285,5,7,6,11,28,39,-11,27
Mattersburg,9285,6,6,5,13,30,46,-16,23
SC Rheindorf,9285,7,5,5,14,18,28,-10,20
FC Salzburg,9286,1,15,7,2,51,20,31,52
SK Sturm Gra,9286,2,13,3,8,34,31,3,42
Rapid Vienna,9286,3,8,10,6,35,31,4,34
LASK Linz,9286,4,8,6,10,29,30,-1,30
Vienna,9286,5,7,6,11,27,39,-12,27
SC Rheindorf,9286,6,6,6,12,19,29,-10,24
Mattersburg,9286,7,5,6,13,30,45,-15,21
FC Salzburg,9287,1,16,6,2,48,15,33,54
SK Sturm Gra,9287,2,12,3,9,31,33,-2,39
Rapid Vienna,9287,3,8,9,7,34,31,3,33
LASK Linz,9287,4,9,6,9,30,32,-2,33
Mattersburg,9287,5,7,6,11,36,42,-6,27
Vienna,9287,6,6,5,13,23,41,-18,23
SC Rheindorf,9287,7,5,7,12,22,30,-8,22
FC Salzburg,9288,1,15,6,3,46,22,24,51
SK Sturm Gra,9288,2,13,3,8,36,30,6,42
Rapid Vienna,9288,3,8,9,7,36,31,5,33
LASK Linz,9288,4,9,6,9,28,31,-3,33
Mattersburg,9288,5,7,5,12,33,42,-9,26
Vienna,9288,6,7,5,12,28,39,-11,26
SC Rheindorf,9288,7,5,6,13,19,31,-12,21
FC Salzburg,9289,1,15,7,2,47,16,31,52
SK Sturm Gra,9289,2,12,3,9,30,31,-1,39
Rapid Vienna,9289,3,7,11,6,31,27,4,32
LASK Linz,9289,4,8,8,8,25,25,0,32
SC Rheindorf,9289,5,6,7,11,21,27,-6,25
Mattersburg,9289,6,6,6,12,29,41,-12,24
Vienna,9289,7,6,6,12,25,41,-16,24
FC Salzburg,9290,1,15,6,3,46,19,27,51
SK Sturm Gra,9290,2,13,3,8,33,28,5,42
Rapid Vienna,9290,3,9,9,6,35,27,8,36
LASK Linz,9290,4,8,6,10,26,29,-3,30
Mattersburg,9290,5,7,6,11,35,43,-8,27
Vienna,9290,6,6,6,12,26,43,-17,24
SC Rheindorf,9290,7,5,6,13,21,33,-12,21
FC Salzburg,9291,1,16,6,2,49,19,30,54
SK Sturm Gra,9291,2,13,3,8,35,30,5,42
LASK Linz,9291,3,11,5,8,30,27,3,38
Rapid Vienna,9291,4,8,9,7,35,31,4,33
Mattersburg,9291,5,7,5,12,36,42,-6,26
Vienna,9291,6,6,5,13,25,45,-20,23
SC Rheindorf,9291,7,4,5,15,17,33,-16,17
FC Salzburg,9292,1,13,7,4,42,21,21,46
SK Sturm Gra,9292,2,14,3,7,37,28,9,45
Rapid Vienna,9292,3,9,9,6,35,32,3,36
LASK Linz,9292,4,8,5,11,27,30,-3,29
Vienna,9292,5,7,6,11,26,39,-13,27
SC Rheindorf,9292,6,6,6,12,21,27,-6,24
Mattersburg,9292,7,6,6,12,30,41,-11,24
FC Salzburg,9293,1,14,6,4,49,19,30,48
SK Sturm Gra,9293,2,13,4,7,31,27,4,43
Rapid Vienna,9293,3,8,10,6,33,30,3,34
LASK Linz,9293,4,9,5,10,32,29,3,32
Mattersburg,9293,5,7,5,12,32,46,-14,26
Vienna,9293,6,7,5,12,25,42,-17,26
SC Rheindorf,9293,7,6,5,13,18,27,-9,23
FC Salzburg,9294,1,15,7,2,45,17,28,52
SK Sturm Gra,9294,2,13,4,7,33,30,3,43
Rapid Vienna,9294,3,7,12,5,37,30,7,33
LASK Linz,9294,4,8,6,10,28,31,-3,30
Mattersburg,9294,5,7,6,11,32,39,-7,27
Vienna,9294,6,7,5,12,24,38,-14,26
SC Rheindorf,9294,7,4,6,14,17,31,-14,18
FC Salzburg,9295,1,14,7,3,44,19,25,49
SK Sturm Gra,9295,2,12,3,9,31,31,0,39
Rapid Vienna,9295,3,9,11,4,37,24,13,38
LASK Linz,9295,4,9,6,9,28,28,0,33
Vienna,9295,5,7,6,11,25,38,-13,27
Mattersburg,9295,6,5,7,12,31,44,-13,22
SC Rheindorf,9295,7,5,6,13,19,31,-12,21
FC Salzburg,9296,1,13,6,5,43,24,19,45
SK Sturm Gra,9296,2,14,3,7,33,29,4,45
Rapid Vienna,9296,3,8,10,6,35,28,7,34
LASK Linz,9296,4,9,5,10,27,28,-1,32
SC Rheindorf,9296,5,7,6,11,23,27,-4,27
Mattersburg,9296,6,6,6,12,30,40,-10,24
Vienna,9296,7,6,6,12,24,39,-15,24
FC Salzburg,9297,1,16,6,2,47,16,31,54
SK Sturm Gra,9297,2,12,4,8,34,30,4,40
Rapid Vienna,9297,3,9,10,5,37,29,8,37
LASK Linz,9297,4,8,5,11,26,32,-6,29
Mattersburg,9297,5,7,5,12,35,43,-8,26
Vienna,9297,6,7,5,12,25,38,-13,26
SC Rheindorf,9297,7,5,5,14,20,36,-16,20
FC Salzburg,9298,1,15,7,2,44,17,27,52
SK Sturm Gra,9298,2,13,4,7,33,29,4,43
Rapid Vienna,9298,3,8,10,6,36,27,9,34
LASK Linz,9298,4,7,6,11,24,29,-5,27
Vienna,9298,5,7,5,12,26,40,-14,26
SC Rheindorf,9298,6,6,6,12,21,30,-9,24
Mattersburg,9298,7,6,6,12,29,41,-12,24
FC Salzburg,9299,1,15,7,2,48,17,31,52
SK Sturm Gra,9299,2,12,4,8,30,27,3,40
LASK Linz,9299,3,10,6,8,31,26,5,36
Rapid Vienna,9299,4,7,10,7,33,30,3,31
Mattersburg,9299,5,6,7,11,31,45,-14,25
Vienna,9299,6,6,5,13,26,42,-16,23
SC Rheindorf,9299,7,5,7,12,20,32,-12,22
FC Salzburg,9300,1,13,8,3,41,19,22,47
SK Sturm Gra,9300,2,14,3,7,38,28,10,45
Rapid Vienna,9300,3,10,9,5,41,27,14,39
LASK Linz,9300,4,9,5,10,29,30,-1,32
Mattersburg,9300,5,7,6,11,33,40,-7,27
Vienna,9300,6,6,6,12,23,40,-17,24
SC Rheindorf,9300,7,4,5,15,19,40,-21,17
FC Salzburg,9301,1,15,7,2,52,20,32,52
SK Sturm Gra,9301,2,12,4,8,31,27,4,40
Rapid Vienna,9301,3,8,9,7,34,29,5,33
LASK Linz,9301,4,8,6,10,27,30,-3,30
SC Rheindorf,9301,5,7,6,11,22,28,-6,27
Mattersburg,9301,6,6,6,12,35,51,-16,24
Vienna,9301,7,6,6,12,26,42,-16,24
FC Salzburg,9302,1,15,6,3,45,18,27,51
SK Sturm Gra,9302,2,12,5,7,31,27,4,41
Rapid Vienna,9302,3,9,10,5,40,28,12,37
LASK Linz,9302,4,8,7,9,30,31,-1,31
Vienna,9302,5,7,5,12,25,40,-15,26
Mattersburg,9302,6,6,5,13,32,45,-13,23
SC Rheindorf,9302,7,5,6,13,22,36,-14,21
FC Salzburg,9303,1,14,7,3,45,21,24,49
SK Sturm Gra,9303,2,13,4,7,34,28,6,43
Rapid Vienna,9303,3,9,10,5,37,28,9,37
LASK Linz,9303,4,8,5,11,25,31,-6,29
Mattersburg,9303,5,7,5,12,33,41,-8,26
Vienna,9303,6,7,5,12,27,43,-16,26
SC Rheindorf,9303,7,5,6,13,20,29,-9,21
FC Salzburg,9304,1,15,7,2,48,19,29,52
SK Sturm Gra,9304,2,12,3,9,33,31,2,39
Rapid Vienna,9304,3,9,11,4,40,28,12,38
LASK Linz,9304,4,9,5,10,27,30,-3,32
Vienna,9304,5,7,5,12,27,41,-14,26
SC Rheindorf,9304,6,6,6,12,21,29,-8,24
Mattersburg,9304,7,5,5,14,30,48,-18,20
FC Salzburg,9305,1,15,7,2,45,16,29,52
SK Sturm Gra,9305,2,13,3,8,34,30,4,42
Rapid Vienna,9305,3,9,9,6,38,29,9,36
Mattersburg,9305,4,7,6,11,35,45,-10,27
LASK Linz,9305,5,7,5,12,25,34,-9,26
SC Rheindorf,9305,6,6,6,12,22,29,-7,24
Vienna,9305,7,6,6,12,25,41,-16,24
FC Salzburg,9306,1,16,6,2,47,18,29,54
SK Sturm Gra,9306,2,11,5,8,32,30,2,38
Rapid Vienna,9306,3,9,9,6,34,26,8,36
LASK Linz,9306,4,9,6,9,26,26,0,33
Mattersburg,9306,5,6,7,11,33,43,-10,25
Vienna,9306,6,6,6,12,25,42,-17,24
SC Rheindorf,9306,7,4,7,13,18,30,-12,19
FC Salzburg,9307,1,14,8,2,47,18,29,50
SK Sturm Gra,9307,2,12,3,9,31,34,-3,39
Rapid Vienna,9307,3,9,11,4,38,28,10,38
LASK Linz,9307,4,8,6,10,29,30,-1,30
Vienna,9307,5,7,5,12,27,39,-12,26
Mattersburg,9307,6,6,7,11,29,41,-12,25
SC Rheindorf,9307,7,5,6,13,19,30,-11,21
FC Salzburg,9308,1,13,7,4,40,17,23,46
SK Sturm Gra,9308,2,13,3,8,32,29,3,42
Rapid Vienna,9308,3,10,10,4,36,25,11,40
LASK Linz,9308,4,8,5,11,27,30,-3,29
Vienna,9308,5,8,5,11,27,37,-10,29
SC Rheindorf,9308,6,6,5,13,20,30,-10,23
Mattersburg,9308,7,6,5,13,29,43,-14,23
FC Salzburg,9309,1,14,7,3,44,18,26,49
SK Sturm Gra,9309,2,14,4,6,36,25,11,46
LASK Linz,9309,3,9,5,10,28,28,0,32
Rapid Vienna,9309,4,7,10,7,34,32,2,31
Vienna,9309,5,8,5,11,27,37,-10,29
Mattersburg,9309,6,6,5,13,28,41,-13,23
SC Rheindorf,9309,7,5,6,13,18,34,-16,21
FC Salzburg,9310,1,16,6,2,48,17,31,54
SK Sturm Gra,9310,2,13,3,8,34,31,3,42
Rapid Vienna,9310,3,9,9,6,36,31,5,36
LASK Linz,9310,4,8,6,10,26,27,-1,30
Vienna,9310,5,7,5,12,25,39,-14,26
Mattersburg,9310,6,5,7,12,27,40,-13,22
SC Rheindorf,9310,7,5,6,13,19,30,-11,21
FC Salzburg,9311,1,14,7,3,43,19,24,49
SK Sturm Gra,9311,2,13,4,7,31,25,6,43
Rapid Vienna,9311,3,9,9,6,36,28,8,36
LASK Linz,9311,4,8,5,11,27,31,-4,29
SC Rheindorf,9311,5,7,5,12,21,29,-8,26
Vienna,9311,6,7,5,12,27,38,-11,26
Mattersburg,9311,7,6,5,13,32,47,-15,23
FC Salzburg,9312,1,15,7,2,48,19,29,52
SK Sturm Gra,9312,2,13,5,6,36,29,7,44
Rapid Vienna,9312,3,9,10,5,37,27,10,37
LASK Linz,9312,4,7,6,11,23,29,-6,27
Mattersburg,9312,5,7,6,11,31,42,-11,27
Vienna,9312,6,6,6,12,27,42,-15,24
SC Rheindorf,9312,7,4,6,14,19,33,-14,18
FC Salzburg,9313,1,13,8,3,42,19,23,47
SK Sturm Gra,9313,2,12,6,6,35,28,7,42
Rapid Vienna,9313,3,8,10,6,34,29,5,34
LASK Linz,9313,4,9,7,8,29,28,1,34
Mattersburg,9313,5,7,6,11,31,40,-9,27
Vienna,9313,6,6,7,11,25,39,-14,25
SC Rheindorf,9313,7,4,6,14,17,30,-13,18
FC Salzburg,9314,1,14,7,3,48,20,28,49
SK Sturm Gra,9314,2,12,5,7,33,28,5,41
Rapid Vienna,9314,3,10,9,5,36,26,10,39
LASK Linz,9314,4,7,5,12,26,34,-8,26
Mattersburg,9314,5,7,5,12,33,42,-9,26
Vienna,9314,6,7,5,12,26,42,-16,26
SC Rheindorf,9314,7,6,6,12,20,30,-10,24
FC Salzburg,9315,1,13,7,4,48,24,24,46
Rapid Vienna,9315,2,10,10,4,38,26,12,40
SK Sturm Gra,9315,3,12,4,8,34,34,0,40
Vienna,9315,4,8,5,11,29,39,-10,29
LASK Linz,9315,5,7,6,11,26,30,-4,27
Mattersburg,9315,6,7,6,11,30,41,-11,27
SC Rheindorf,9315,7,4,8,12,19,30,-11,20
FC Salzburg,9316,1,15,7,2,47,17,30,52
SK Sturm Gra,9316,2,11,5,8,30,32,-2,38
Rapid Vienna,9316,3,9,9,6,36,26,10,36
LASK Linz,9316,4,9,6,9,26,29,-3,33
Vienna,9316,5,7,6,11,27,38,-11,27
Mattersburg,9316,6,6,5,13,31,43,-12,23
SC Rheindorf,9316,7,5,6,13,18,30,-12,21
FC Salzburg,9317,1,13,7,4,41,20,21,46
SK Sturm Gra,9317,2,14,4,6,38,26,12,46
Rapid Vienna,9317,3,8,12,4,34,25,9,36
LASK Linz,9317,4,8,6,10,26,31,-5,30
Vienna,9317,5,7,6,11,27,38,-11,27
SC Rheindorf,9317,6,5,7,12,20,31,-11,22
Mattersburg,9317,7,5,6,13,29,44,-15,21
FC Salzburg,9318,1,14,7,3,50,20,30,49
SK Sturm Gra,9318,2,12,5,7,31,28,3,41
Rapid Vienna,9318,3,8,10,6,39,30,9,34
LASK Linz,9318,4,8,7,9,29,30,-1,31
SC Rheindorf,9318,5,7,6,11,21,27,-6,27
Vienna,9318,6,7,6,11,27,39,-12,27
Mattersburg,9318,7,5,5,14,28,51,-23,20
FC Salzburg,9319,1,14,6,4,42,19,23,48
SK Sturm Gra,9319,2,13,4,7,33,26,7,43
Rapid Vienna,9319,3,9,9,6,35,31,4,36
LASK Linz,9319,4,8,6,10,29,29,0,30
Mattersburg,9319,5,8,5,11,32,40,-8,29
Vienna,9319,6,7,5,12,26,39,-13,26
SC Rheindorf,9319,7,4,7,13,16,29,-13,19
FC Salzburg,9320,1,15,7,2,48,20,28,52
Rapid Vienna,9320,2,10,10,4,42,26,16,40
SK Sturm Gra,9320,3,12,3,9,31,32,-1,39
LASK Linz,9320,4,8,5,11,26,32,-6,29
Mattersburg,9320,5,7,5,12,31,40,-9,26
Vienna,9320,6,7,5,12,27,42,-15,26
SC Rheindorf,9320,7,5,5,14,19,32,-13,20
FC Salzburg,9321,1,13,9,2,43,17,26,48
SK Sturm Gra,9321,2,12,5,7,32,28,4,41
Rapid Vienna,9321,3,8,11,5,34,27,7,35
LASK Linz,9321,4,9,6,9,29,28,1,33
Mattersburg,9321,5,7,5,12,30,41,-11,26
Vienna,9321,6,6,6,12,24,39,-15,24
SC Rheindorf,9321,7,5,6,13,17,29,-12,21
FC Salzburg,9322,1,15,7,2,46,18,28,52
SK Sturm Gra,9322,2,13,4,7,31,26,5,43
Rapid Vienna,9322,3,8,10,6,36,31,5,34
LASK Linz,9322,4,7,6,11,28,33,-5,27
Mattersburg,9322,5,7,5,12,36,45,-9,26
SC Rheindorf,9322,6,6,6,12,21,30,-9,24
Vienna,9322,7,6,6,12,25,40,-15,24
FC Salzburg,9323,1,16,6,2,51,17,34,54
SK Sturm Gra,9323,2,11,4,9,30,35,-5,37
Rapid Vienna,9323,3,8,11,5,35,27,8,35
LASK Linz,9323,4,8,6,10,26,28,-2,30
Mattersburg,9323,5,7,6,11,34,40,-6,27
Vienna,9323,6,6,6,12,23,40,-17,24
SC Rheindorf,9323,7,5,7,12,19,31,-12,22
FC Salzburg,9324,1,14,7,3,42,17,25,49
SK Sturm Gra,9324,2,12,4,8,31,27,4,40
Rapid Vienna,9324,3,8,11,5,33,25,8,35
LASK Linz,9324,4,8,7,9,30,32,-2,31
Vienna,9324,5,7,6,11,27,38,-11,27
Mattersburg,9324,6,6,6,12,30,44,-14,24
SC Rheindorf,9324,7,5,7,12,19,29,-10,22
FC Salzburg,9325,1,13,8,3,41,17,24,47
Rapid Vienna,9325,2,9,11,4,41,27,14,38
SK Sturm Gra,9325,3,11,5,8,33,33,0,38
LASK Linz,9325,4,7,7,10,25,30,-5,28
Mattersburg,9325,5,7,7,10,34,40,-6,28
Vienna,9325,6,7,6,11,29,41,-12,27
SC Rheindorf,9325,7,5,6,13,19,34,-15,21
FC Salzburg,9326,1,14,6,4,47,22,25,48
SK Sturm Gra,9326,2,14,3,7,37,30,7,45
Rapid Vienna,9326,3,8,10,6,39,33,6,34
LASK Linz,9326,4,8,6,10,29,31,-2,30
Mattersburg,9326,5,7,6,11,33,43,-10,27
SC Rheindorf,9326,6,6,6,12,22,31,-9,24
Vienna,9326,7,6,5,13,25,42,-17,23
FC Salzburg,9327,1,15,6,3,50,18,32,51
SK Sturm Gra,9327,2,12,3,9,33,33,0,39
Rapid Vienna,9327,3,8,11,5,34,29,5,35
LASK Linz,9327,4,8,7,9,27,30,-3,31
Mattersburg,9327,5,8,5,11,35,41,-6,29
Vienna,9327,6,6,5,13,24,43,-19,23
SC Rheindorf,9327,7,5,7,12,18,27,-9,22
FC Salzburg,9328,1,15,7,2,47,19,28,52
SK Sturm Gra,9328,2,13,4,7,38,29,9,43
Rapid Vienna,9328,3,8,10,6,34,28,6,34
LASK Linz,9328,4,7,6,11,26,33,-7,27
SC Rheindorf,9328,5,7,5,12,23,30,-7,26
Mattersburg,9328,6,6,6,12,29,43,-14,24
Vienna,9328,7,6,6,12,27,42,-15,24
FC Salzburg,9329,1,14,7,3,43,19,24,49
SK Sturm Gra,9329,2,12,5,7,36,30,6,41
Rapid Vienna,9329,3,8,11,5,35,27,8,35
LASK Linz,9329,4,8,6,10,30,33,-3,30
SC Rheindorf,9329,5,7,6,11,21,28,-7,27
Vienna,9329,6,7,5,12,28,40,-12,26
Mattersburg,9329,7,5,6,13,29,45,-16,21
FC Salzburg,9330,1,16,6,2,49,15,34,54
SK Sturm Gra,9330,2,12,4,8,32,28,4,40
Rapid Vienna,9330,3,9,9,6,36,28,8,36
LASK Linz,9330,4,8,6,10,29,31,-2,30
Vienna,9330,5,7,5,12,25,39,-14,26
Mattersburg,9330,6,7,5,12,32,48,-16,26
SC Rheindorf,9330,7,5,5,14,19,33,-14,20
FC Salzburg,9331,1,13,7,4,40,20,20,46
Rapid Vienna,9331,2,10,9,5,39,27,12,39
LASK Linz,9331,3,11,5,8,33,27,6,38
SK Sturm Gra,9331,4,11,4,9,28,29,-1,37
Vienna,9331,5,8,5,11,28,37,-9,29
SC Rheindorf,9331,6,6,5,13,19,30,-11,23
Mattersburg,9331,7,5,5,14,27,44,-17,20
FC Salzburg,9332,1,14,6,4,46,19,27,48
SK Sturm Gra,9332,2,13,3,8,33,28,5,42
Rapid Vienna,9332,3,10,9,5,39,26,13,39
LASK Linz,9332,4,8,7,9,25,27,-2,31
Vienna,9332,5,7,5,12,26,41,-15,26
Mattersburg,9332,6,6,7,11,32,44,-12,25
SC Rheindorf,9332,7,4,7,13,18,34,-16,19
FC Salzburg,9333,1,13,8,3,41,19,22,47
SK Sturm Gra,9333,2,12,5,7,31,27,4,41
Rapid Vienna,9333,3,9,10,5,36,27,9,37
LASK Linz,9333,4,7,9,8,25,26,-1,30
Vienna,9333,5,7,6,11,26,39,-13,27
SC Rheindorf,9333,6,6,6,12,24,32,-8,24
Mattersburg,9333,7,5,6,13,31,44,-13,21
FC Salzburg,9334,1,14,7,3,44,18,26,49
SK Sturm Gra,9334,2,13,4,7,32,27,5,43
Rapid Vienna,9334,3,9,9,6,35,28,7,36
LASK Linz,9334,4,8,7,9,27,28,-1,31
Vienna,9334,5,7,6,11,24,37,-13,27
Mattersburg,9334,6,6,5,13,29,43,-14,23
SC Rheindorf,9334,7,5,6,13,18,28,-10,21
FC Salzburg,9335,1,16,6,2,49,19,30,54
SK Sturm Gra,9335,2,14,3,7,34,27,7,45
Rapid Vienna,9335,3,8,9,7,35,33,2,33
LASK Linz,9335,4,8,5,11,27,30,-3,29
Vienna,9335,5,7,5,12,31,42,-11,26
SC Rheindorf,9335,6,6,5,13,19,27,-8,23
Mattersburg,9335,7,6,5,13,29,46,-17,23
FC Salzburg,9336,1,16,6,2,46,17,29,54
SK Sturm Gra,9336,2,13,4,7,33,27,6,43
Rapid Vienna,9336,3,8,10,6,36,31,5,34
LASK Linz,9336,4,8,6,10,26,29,-3,30
Vienna,9336,5,7,5,12,26,40,-14,26
Mattersburg,9336,6,6,5,13,30,41,-11,23
SC Rheindorf,9336,7,5,6,13,18,30,-12,21
FC Salzburg,9337,1,14,8,2,45,19,26,50
SK Sturm Gra,9337,2,13,4,7,34,28,6,43
Rapid Vienna,9337,3,8,10,6,39,29,10,34
LASK Linz,9337,4,9,6,9,29,27,2,33
Mattersburg,9337,5,6,6,12,29,44,-15,24
Vienna,9337,6,6,6,12,25,41,-16,24
SC Rheindorf,9337,7,5,6,13,19,32,-13,21
FC Salzburg,9338,1,13,7,4,42,19,23,46
Rapid Vienna,9338,2,10,9,5,39,25,14,39
SK Sturm Gra,9338,3,12,3,9,31,30,1,39
LASK Linz,9338,4,9,6,9,30,31,-1,33
Vienna,9338,5,7,5,12,25,39,-14,26
Mattersburg,9338,6,6,6,12,31,42,-11,24
SC Rheindorf,9338,7,6,6,12,19,31,-12,24
FC Salzburg,9339,1,14,7,3,45,20,25,49
SK Sturm Gra,9339,2,13,3,8,33,28,5,42
Rapid Vienna,9339,3,8,11,5,40,30,10,35
LASK Linz,9339,4,10,5,9,29,29,0,35
Vienna,9339,5,6,6,12,25,41,-16,24
SC Rheindorf,9339,6,5,7,12,18,28,-10,22
Mattersburg,9339,7,5,7,12,29,43,-14,22
FC Salzburg,9340,1,14,7,3,44,20,24,49
Rapid Vienna,9340,2,9,10,5,39,32,7,37
SK Sturm Gra,9340,3,11,4,9,29,29,0,37
LASK Linz,9340,4,9,7,8,30,26,4,34
Vienna,9340,5,6,7,11,27,41,-14,25
Mattersburg,9340,6,6,6,12,32,43,-11,24
SC Rheindorf,9340,7,5,7,12,21,31,-10,22
FC Salzburg,9341,1,16,6,2,47,18,29,54
SK Sturm Gra,9341,2,12,4,8,29,27,2,40
Rapid Vienna,9341,3,9,9,6,36,28,8,36
LASK Linz,9341,4,8,6,10,29,32,-3,30
Mattersburg,9341,5,6,6,12,31,42,-11,24
Vienna,9341,6,6,6,12,25,41,-16,24
SC Rheindorf,9341,7,6,5,13,21,30,-9,23
FC Salzburg,9342,1,15,7,2,47,20,27,52
SK Sturm Gra,9342,2,12,3,9,32,31,1,39
Rapid Vienna,9342,3,8,11,5,33,27,6,35
LASK Linz,9342,4,8,6,10,29,30,-1,30
Vienna,9342,5,7,5,12,27,40,-13,26
SC Rheindorf,9342,6,6,6,12,21,28,-7,24
Mattersburg,9342,7,6,6,12,33,46,-13,24
FC Salzburg,9343,1,15,6,3,42,16,26,51
SK Sturm Gra,9343,2,12,3,9,29,29,0,39
Rapid Vienna,9343,3,9,10,5,36,26,10,37
LASK Linz,9343,4,8,6,10,26,28,-2,30
Mattersburg,9343,5,7,5,12,29,39,-10,26
Vienna,9343,6,7,5,12,24,38,-14,26
SC Rheindorf,9343,7,6,5,13,18,28,-10,23
FC Salzburg,9344,1,15,6,3,48,20,28,51
SK Sturm Gra,9344,2,11,4,9,29,32,-3,37
LASK Linz,9344,3,10,6,8,32,26,6,36
Rapid Vienna,9344,4,8,10,6,33,28,5,34
Mattersburg,9344,5,7,7,10,33,41,-8,28
Vienna,9344,6,6,6,12,25,42,-17,24
SC Rheindorf,9344,7,5,5,14,18,29,-11,20
FC Salzburg,9345,1,15,7,2,44,18,26,52
SK Sturm Gra,9345,2,12,4,8,35,29,6,40
Rapid Vienna,9345,3,8,11,5,33,25,8,35
LASK Linz,9345,4,8,6,10,28,33,-5,30
SC Rheindorf,9345,5,6,6,12,24,33,-9,24
Vienna,9345,6,6,6,12,26,41,-15,24
Mattersburg,9345,7,5,8,11,32,43,-11,23
FC Salzburg,9346,1,15,6,3,46,18,28,51
SK Sturm Gra,9346,2,12,4,8,30,27,3,40
Rapid Vienna,9346,3,9,10,5,34,28,6,37
LASK Linz,9346,4,8,6,10,27,29,-2,30
Vienna,9346,5,7,5,12,29,42,-13,26
Mattersburg,9346,6,6,7,11,31,42,-11,25
SC Rheindorf,9346,7,5,6,13,17,28,-11,21
SK Sturm Gra,9347,1,14,3,7,33,26,7,45
FC Salzburg,9347,2,12,8,4,40,20,20,44
Rapid Vienna,9347,3,11,9,4,38,24,14,42
Mattersburg,9347,4,7,7,10,31,38,-7,28
LASK Linz,9347,5,7,6,11,23,28,-5,27
Vienna,9347,6,6,7,11,23,37,-14,25
SC Rheindorf,9347,7,4,6,14,16,31,-15,18
FC Salzburg,9348,1,14,6,4,43,19,24,48
SK Sturm Gra,9348,2,13,4,7,34,30,4,43
Rapid Vienna,9348,3,10,10,4,40,27,13,40
LASK Linz,9348,4,8,6,10,25,28,-3,30
Vienna,9348,5,8,5,11,31,38,-7,29
SC Rheindorf,9348,6,5,6,13,18,29,-11,21
Mattersburg,9348,7,5,5,14,27,47,-20,20
FC Salzburg,9349,1,15,7,2,47,18,29,52
SK Sturm Gra,9349,2,12,5,7,30,27,3,41
Rapid Vienna,9349,3,8,11,5,39,28,11,35
LASK Linz,9349,4,8,5,11,26,32,-6,29
Vienna,9349,5,7,5,12,29,42,-13,26
Mattersburg,9349,6,6,6,12,33,45,-12,24
SC Rheindorf,9349,7,5,7,12,18,30,-12,22
FC Salzburg,9350,1,15,7,2,44,18,26,52
SK Sturm Gra,9350,2,11,4,9,31,31,0,37
Rapid Vienna,9350,3,9,9,6,36,29,7,36
LASK Linz,9350,4,10,5,9,33,29,4,35
Vienna,9350,5,7,6,11,27,38,-11,27
Mattersburg,9350,6,6,6,12,29,41,-12,24
SC Rheindorf,9350,7,4,7,13,17,31,-14,19
FC Salzburg,9351,1,12,7,5,40,21,19,43
SK Sturm Gra,9351,2,13,3,8,33,27,6,42
Rapid Vienna,9351,3,8,10,6,33,26,7,34
LASK Linz,9351,4,8,6,10,24,29,-5,30
Vienna,9351,5,8,5,11,28,38,-10,29
SC Rheindorf,9351,6,7,6,11,21,27,-6,27
Mattersburg,9351,7,7,5,12,30,41,-11,26
FC Salzburg,9352,1,15,6,3,49,19,30,51
SK Sturm Gra,9352,2,14,4,6,38,28,10,46
Rapid Vienna,9352,3,7,11,6,35,32,3,32
LASK Linz,9352,4,8,7,9,28,28,0,31
Vienna,9352,5,7,5,12,24,40,-16,26
Mattersburg,9352,6,6,5,13,30,44,-14,23
SC Rheindorf,9352,7,5,6,13,19,32,-13,21
FC Salzburg,9353,1,14,6,4,50,23,27,48
SK Sturm Gra,9353,2,12,4,8,31,33,-2,40
Rapid Vienna,9353,3,8,11,5,34,26,8,35
LASK Linz,9353,4,8,7,9,28,29,-1,31
Vienna,9353,5,8,5,11,28,40,-12,29
Mattersburg,9353,6,7,6,11,35,43,-8,27
SC Rheindorf,9353,7,5,5,14,20,32,-12,20
FC Salzburg,9354,1,14,7,3,42,20,22,49
SK Sturm Gra,9354,2,13,4,7,35,30,5,43
Rapid Vienna,9354,3,9,9,6,37,27,10,36
LASK Linz,9354,4,8,6,10,25,29,-4,30
Mattersburg,9354,5,7,7,10,35,39,-4,28
Vienna,9354,6,6,6,12,25,40,-15,24
SC Rheindorf,9354,7,5,5,14,19,33,-14,20
FC Salzburg,9355,1,14,7,3,44,19,25,49
SK Sturm Gra,9355,2,14,3,7,34,28,6,45
Rapid Vienna,9355,3,8,9,7,34,31,3,33
LASK Linz,9355,4,8,5,11,25,29,-4,29
Vienna,9355,5,7,6,11,25,38,-13,27
SC Rheindorf,9355,6,6,6,12,21,28,-7,24
Mattersburg,9355,7,6,6,12,28,38,-10,24
FC Salzburg,9356,1,16,6,2,45,16,29,54
SK Sturm Gra,9356,2,11,5,8,30,30,0,38
Rapid Vienna,9356,3,9,9,6,33,25,8,36
LASK Linz,9356,4,8,8,8,29,29,0,32
Vienna,9356,5,7,5,12,28,40,-12,26
SC Rheindorf,9356,6,5,7,12,21,29,-8,22
Mattersburg,9356,7,5,6,13,29,46,-17,21
FC Salzburg,9357,1,13,7,4,40,18,22,46
SK Sturm Gra,9357,2,14,3,7,32,26,6,45
Rapid Vienna,9357,3,8,11,5,34,26,8,35
LASK Linz,9357,4,10,5,9,26,25,1,35
Mattersburg,9357,5,7,5,12,30,41,-11,26
Vienna,9357,6,7,5,12,26,39,-13,26
SC Rheindorf,9357,7,4,6,14,16,29,-13,18
FC Salzburg,9358,1,15,7,2,47,16,31,52
SK Sturm Gra,9358,2,12,5,7,32,28,4,41
Rapid Vienna,9358,3,8,11,5,34,29,5,35
LASK Linz,9358,4,8,5,11,25,30,-5,29
Mattersburg,9358,5,7,5,12,31,42,-11,26
Vienna,9358,6,6,6,12,26,41,-15,24
SC Rheindorf,9358,7,5,7,12,19,28,-9,22
FC Salzburg,9359,1,14,8,2,42,16,26,50
SK Sturm Gra,9359,2,12,4,8,32,31,1,40
Rapid Vienna,9359,3,7,12,5,32,25,7,33
LASK Linz,9359,4,9,5,10,28,30,-2,32
Vienna,9359,5,7,5,12,26,39,-13,26
SC Rheindorf,9359,6,6,6,12,22,30,-8,24
Mattersburg,9359,7,6,6,12,29,40,-11,24
FC Salzburg,9360,1,14,6,4,42,19,23,48
SK Sturm Gra,9360,2,12,4,8,31,28,3,40
Rapid Vienna,9360,3,9,10,5,37,28,9,37
LASK Linz,9360,4,8,6,10,27,30,-3,30
Vienna,9360,5,8,5,11,27,38,-11,29
Mattersburg,9360,6,7,5,12,31,40,-9,26
SC Rheindorf,9360,7,5,6,13,20,32,-12,21
FC Salzburg,9361,1,13,6,5,42,20,22,45
SK Sturm Gra,9361,2,12,5,7,33,29,4,41
Rapid Vienna,9361,3,10,10,4,39,25,14,40
LASK Linz,9361,4,9,5,10,28,28,0,32
Mattersburg,9361,5,9,5,10,32,37,-5,32
Vienna,9361,6,6,5,13,24,43,-19,23
SC Rheindorf,9361,7,4,6,14,16,32,-16,18
FC Salzburg,9362,1,15,6,3,44,17,27,51
SK Sturm Gra,9362,2,12,4,8,31,29,2,40
Rapid Vienna,9362,3,9,10,5,34,24,10,37
LASK Linz,9362,4,8,8,8,27,27,0,32
Vienna,9362,5,7,5,12,29,42,-13,26
Mattersburg,9362,6,6,6,12,31,44,-13,24
SC Rheindorf,9362,7,5,5,14,17,30,-13,20
FC Salzburg,9363,1,15,6,3,47,20,27,51
SK Sturm Gra,9363,2,14,4,6,37,29,8,46
LASK Linz,9363,3,10,5,9,32,29,3,35
Rapid Vienna,9363,4,7,10,7,33,29,4,31
Vienna,9363,5,7,5,12,25,40,-15,26
SC Rheindorf,9363,6,5,6,13,19,30,-11,21
Mattersburg,9363,7,5,6,13,29,45,-16,21
FC Salzburg,9364,1,13,7,4,42,19,23,46
SK Sturm Gra,9364,2,13,4,7,32,27,5,43
Rapid Vienna,9364,3,8,10,6,35,29,6,34
LASK Linz,9364,4,9,6,9,27,28,-1,33
Vienna,9364,5,8,5,11,26,38,-12,29
Mattersburg,9364,6,7,5,12,28,38,-10,26
SC Rheindorf,9364,7,5,5,14,19,30,-11,20
FC Salzburg,9365,1,16,6,2,47,18,29,54
SK Sturm Gra,9365,2,11,5,8,32,31,1,38
Rapid Vienna,9365,3,9,10,5,36,27,9,37
LASK Linz,9365,4,9,6,9,28,28,0,33
Mattersburg,9365,5,6,6,12,31,41,-10,24
Vienna,9365,6,6,6,12,24,40,-16,24
SC Rheindorf,9365,7,4,7,13,18,31,-13,19
FC Salzburg,9366,1,15,6,3,47,18,29,51
SK Sturm Gra,9366,2,13,4,7,35,30,5,43
LASK Linz,9366,3,8,7,9,29,28,1,31
Rapid Vienna,9366,4,7,9,8,32,31,1,30
Vienna,9366,5,8,5,11,27,39,-12,29
SC Rheindorf,9366,6,6,6,12,18,29,-11,24
Mattersburg,9366,7,5,7,12,27,40,-13,22
FC Salzburg,9367,1,15,7,2,43,16,27,52
SK Sturm Gra,9367,2,11,5,8,31,29,2,38
Rapid Vienna,9367,3,7,12,5,33,28,5,33
LASK Linz,9367,4,8,8,8,29,27,2,32
SC Rheindorf,9367,5,6,7,11,20,28,-8,25
Vienna,9367,6,6,6,12,28,43,-15,24
Mattersburg,9367,7,5,7,12,31,44,-13,22
FC Salzburg,9368,1,15,6,3,48,17,31,51
SK Sturm Gra,9368,2,13,3,8,31,27,4,42
Rapid Vienna,9368,3,8,10,6,33,27,6,34
LASK Linz,9368,4,8,6,10,24,27,-3,30
SC Rheindorf,9368,5,7,5,12,20,28,-8,26
Vienna,9368,6,7,5,12,28,40,-12,26
Mattersburg,9368,7,6,5,13,29,47,-18,23
FC Salzburg,9369,1,16,6,2,50,16,34,54
SK Sturm Gra,9369,2,13,3,8,33,31,2,42
Rapid Vienna,9369,3,7,10,7,36,32,4,31
Mattersburg,9369,4,8,5,11,35,47,-12,29
LASK Linz,9369,5,7,7,10,29,32,-3,28
SC Rheindorf,9369,6,6,6,12,21,30,-9,24
Vienna,9369,7,6,5,13,26,42,-16,23
FC Salzburg,9370,1,16,6,2,49,16,33,54
SK Sturm Gra,9370,2,13,4,7,34,29,5,43
LASK Linz,9370,3,9,7,8,29,26,3,34
Rapid Vienna,9370,4,7,10,7,32,33,-1,31
Vienna,9370,5,7,5,12,25,39,-14,26
Mattersburg,9370,6,6,5,13,28,42,-14,23
SC Rheindorf,9370,7,4,7,13,17,29,-12,19
FC Salzburg,9371,1,14,6,4,43,22,21,48
SK Sturm Gra,9371,2,11,6,7,30,27,3,39
Rapid Vienna,9371,3,8,10,6,33,26,7,34
LASK Linz,9371,4,8,6,10,26,30,-4,30
Mattersburg,9371,5,7,6,11,39,44,-5,27
Vienna,9371,6,7,6,11,27,40,-13,27
SC Rheindorf,9371,7,6,6,12,21,30,-9,24
FC Salzburg,9372,1,15,6,3,44,18,26,51
SK Sturm Gra,9372,2,12,4,8,30,28,2,40
Rapid Vienna,9372,3,7,12,5,33,26,7,33
LASK Linz,9372,4,8,6,10,25,28,-3,30
Vienna,9372,5,8,5,11,27,38,-11,29
SC Rheindorf,9372,6,6,7,11,23,30,-7,25
Mattersburg,9372,7,5,6,13,30,44,-14,21
FC Salzburg,9373,1,13,8,3,45,19,26,47
SK Sturm Gra,9373,2,12,5,7,33,29,4,41
Rapid Vienna,9373,3,8,9,7,36,30,6,33
LASK Linz,9373,4,8,8,8,27,27,0,32
SC Rheindorf,9373,5,7,6,11,22,28,-6,27
Vienna,9373,6,7,6,11,25,38,-13,27
Mattersburg,9373,7,5,6,13,26,43,-17,21
FC Salzburg,9374,1,13,7,4,41,20,21,46
SK Sturm Gra,9374,2,12,5,7,31,27,4,41
Rapid Vienna,9374,3,10,9,5,34,24,10,39
LASK Linz,9374,4,8,6,10,27,29,-2,30
Vienna,9374,5,8,5,11,26,37,-11,29
Mattersburg,9374,6,6,6,12,33,42,-9,24
SC Rheindorf,9374,7,5,6,13,17,30,-13,21
FC Salzburg,9375,1,14,8,2,44,19,25,50
SK Sturm Gra,9375,2,13,5,6,33,27,6,44
Rapid Vienna,9375,3,8,10,6,35,27,8,34
LASK Linz,9375,4,8,7,9,28,28,0,31
Vienna,9375,5,6,7,11,26,40,-14,25
Mattersburg,9375,6,5,7,12,31,44,-13,22
SC Rheindorf,9375,7,5,6,13,18,30,-12,21
FC Salzburg,9376,1,15,7,2,46,19,27,52
SK Sturm Gra,9376,2,13,3,8,33,27,6,42
Rapid Vienna,9376,3,7,11,6,35,31,4,32
LASK Linz,9376,4,8,6,10,25,27,-2,30
Mattersburg,9376,5,7,5,12,33,39,-6,26
Vienna,9376,6,7,5,12,25,40,-15,26
SC Rheindorf,9376,7,6,5,13,17,31,-14,23
FC Salzburg,9377,1,15,7,2,51,18,33,52
SK Sturm Gra,9377,2,13,5,6,32,26,6,44
Rapid Vienna,9377,3,7,10,7,32,32,0,31
LASK Linz,9377,4,8,5,11,25,27,-2,29
Mattersburg,9377,5,7,5,12,31,43,-12,26
Vienna,9377,6,7,5,12,28,44,-16,26
SC Rheindorf,9377,7,6,5,13,18,27,-9,23
FC Salzburg,9378,1,13,8,3,43,18,25,47
Rapid Vienna,9378,2,10,10,4,37,24,13,40
SK Sturm Gra,9378,3,12,4,8,31,30,1,40
LASK Linz,9378,4,7,7,10,25,28,-3,28
Mattersburg,9378,5,6,8,10,30,39,-9,26
Vienna,9378,6,7,5,12,24,38,-14,26
SC Rheindorf,9378,7,4,8,12,17,30,-13,20
FC Salzburg,9379,1,13,8,3,46,20,26,47
SK Sturm Gra,9379,2,14,4,6,36,27,9,46
Rapid Vienna,9379,3,9,10,5,34,25,9,37
LASK Linz,9379,4,8,5,11,25,30,-5,29
Mattersburg,9379,5,7,7,10,33,41,-8,28
Vienna,9379,6,6,6,12,23,41,-18,24
SC Rheindorf,9379,7,4,6,14,19,32,-13,18
FC Salzburg,9380,1,14,7,3,48,20,28,49
SK Sturm Gra,9380,2,13,3,8,32,30,2,42
Rapid Vienna,9380,3,9,10,5,38,29,9,37
LASK Linz,9380,4,7,6,11,25,29,-4,27
SC Rheindorf,9380,5,6,7,11,22,29,-7,25
Vienna,9380,6,6,7,11,24,38,-14,25
Mattersburg,9380,7,5,8,11,28,42,-14,23
FC Salzburg,9381,1,15,7,2,52,21,31,52
SK Sturm Gra,9381,2,13,4,7,35,30,5,43
Rapid Vienna,9381,3,7,11,6,36,33,3,32
LASK Linz,9381,4,8,6,10,27,28,-1,30
Mattersburg,9381,5,7,5,12,30,42,-12,26
Vienna,9381,6,7,5,12,29,43,-14,26
SC Rheindorf,9381,7,4,8,12,17,29,-12,20
FC Salzburg,9382,1,15,6,3,46,19,27,51
SK Sturm Gra,9382,2,12,4,8,33,30,3,40
Rapid Vienna,9382,3,9,10,5,36,28,8,37
LASK Linz,9382,4,8,5,11,26,30,-4,29
Mattersburg,9382,5,6,7,11,31,41,-10,25
SC Rheindorf,9382,6,6,6,12,23,31,-8,24
Vienna,9382,7,6,6,12,24,40,-16,24
FC Salzburg,9383,1,14,7,3,46,18,28,49
SK Sturm Gra,9383,2,13,4,7,32,30,2,43
Rapid Vienna,9383,3,8,10,6,35,28,7,34
LASK Linz,9383,4,9,5,10,27,27,0,32
Vienna,9383,5,7,5,12,25,39,-14,26
SC Rheindorf,9383,6,6,6,12,22,30,-8,24
Mattersburg,9383,7,6,5,13,28,43,-15,23
FC Salzburg,9384,1,15,7,2,49,20,29,52
SK Sturm Gra,9384,2,12,4,8,31,30,1,40
LASK Linz,9384,3,11,5,8,30,27,3,38
Rapid Vienna,9384,4,8,9,7,35,28,7,33
Vienna,9384,5,7,5,12,26,40,-14,26
Mattersburg,9384,6,5,6,13,30,43,-13,21
SC Rheindorf,9384,7,5,6,13,18,31,-13,21
FC Salzburg,9385,1,13,8,3,43,20,23,47
SK Sturm Gra,9385,2,12,5,7,34,30,4,41
Rapid Vienna,9385,3,8,11,5,35,27,8,35
LASK Linz,9385,4,9,6,9,30,33,-3,33
Vienna,9385,5,7,6,11,24,37,-13,27
SC Rheindorf,9385,6,6,5,13,23,30,-7,23
Mattersburg,9385,7,5,7,12,30,42,-12,22
FC Salzburg,9386,1,14,7,3,44,18,26,49
SK Sturm Gra,9386,2,13,4,7,38,31,7,43
Rapid Vienna,9386,3,8,10,6,36,31,5,34
LASK Linz,9386,4,9,6,9,27,30,-3,33
Mattersburg,9386,5,6,6,12,31,41,-10,24
Vienna,9386,6,6,6,12,25,41,-16,24
SC Rheindorf,9386,7,5,7,12,21,30,-9,22
FC Salzburg,9387,1,14,7,3,48,19,29,49
SK Sturm Gra,9387,2,12,4,8,30,29,1,40
Rapid Vienna,9387,3,9,11,4,38,26,12,38
LASK Linz,9387,4,9,6,9,29,28,1,33
Vienna,9387,5,7,6,11,25,38,-13,27
Mattersburg,9387,6,6,5,13,28,45,-17,23
SC Rheindorf,9387,7,4,7,13,15,28,-13,19
FC Salzburg,9388,1,13,7,4,43,21,22,46
SK Sturm Gra,9388,2,13,3,8,31,29,2,42
Rapid Vienna,9388,3,9,10,5,37,26,11,37
LASK Linz,9388,4,8,7,9,28,29,-1,31
Vienna,9388,5,7,5,12,27,40,-13,26
Mattersburg,9388,6,6,7,11,31,41,-10,25
SC Rheindorf,9388,7,6,5,13,20,31,-11,23
FC Salzburg,9389,1,14,8,2,49,17,32,50
SK Sturm Gra,9389,2,13,5,6,36,27,9,44
LASK Linz,9389,3,9,7,8,28,27,1,34
Rapid Vienna,9389,4,7,11,6,34,29,5,32
Mattersburg,9389,5,6,5,13,32,44,-12,23
SC Rheindorf,9389,6,6,5,13,21,33,-12,23
Vienna,9389,7,6,5,13,23,46,-23,23
FC Salzburg,9390,1,13,7,4,41,19,22,46
SK Sturm Gra,9390,2,13,3,8,31,27,4,42
Rapid Vienna,9390,3,8,10,6,33,26,7,34
LASK Linz,9390,4,9,6,9,26,26,0,33
Vienna,9390,5,8,5,11,28,39,-11,29
SC Rheindorf,9390,6,6,6,12,19,27,-8,24
Mattersburg,9390,7,5,7,12,30,44,-14,22
FC Salzburg,9391,1,14,7,3,44,19,25,49
SK Sturm Gra,9391,2,13,3,8,35,30,5,42
Rapid Vienna,9391,3,9,10,5,36,26,10,37
LASK Linz,9391,4,7,7,10,25,31,-6,28
Vienna,9391,5,7,6,11,26,39,-13,27
SC Rheindorf,9391,6,6,7,11,22,28,-6,25
Mattersburg,9391,7,5,6,13,30,45,-15,21
FC Salzburg,9392,1,13,7,4,42,20,22,46
Rapid Vienna,9392,2,10,10,4,37,25,12,40
SK Sturm Gra,9392,3,11,3,10,29,33,-4,36
LASK Linz,9392,4,10,5,9,29,27,2,35
Mattersburg,9392,5,7,6,11,35,41,-6,27
Vienna,9392,6,6,7,11,28,42,-14,25
SC Rheindorf,9392,7,5,6,13,20,32,-12,21
FC Salzburg,9393,1,15,7,2,45,16,29,52
SK Sturm Gra,9393,2,11,4,9,31,31,0,37
Rapid Vienna,9393,3,8,11,5,34,26,8,35
LASK Linz,9393,4,9,6,9,31,30,1,33
Mattersburg,9393,5,7,5,12,31,43,-12,26
Vienna,9393,6,7,5,12,26,41,-15,26
SC Rheindorf,9393,7,5,6,13,17,28,-11,21
FC Salzburg,9394,1,14,6,4,48,22,26,48
SK Sturm Gra,9394,2,14,3,7,34,27,7,45
Rapid Vienna,9394,3,9,10,5,35,26,9,37
Mattersburg,9394,4,7,6,11,31,41,-10,27
Vienna,9394,5,7,6,11,28,41,-13,27
LASK Linz,9394,6,7,5,12,24,29,-5,26
SC Rheindorf,9394,7,5,6,13,17,31,-14,21
FC Salzburg,9395,1,16,6,2,46,16,30,54
SK Sturm Gra,9395,2,13,3,8,37,29,8,42
Rapid Vienna,9395,3,8,10,6,35,31,4,34
Mattersburg,9395,4,8,5,11,31,39,-8,29
LASK Linz,9395,5,7,6,11,25,32,-7,27
SC Rheindorf,9395,6,6,5,13,21,32,-11,23
Vienna,9395,7,6,5,13,25,41,-16,23
FC Salzburg,9396,1,15,6,3,44,18,26,51
SK Sturm Gra,9396,2,13,4,7,33,28,5,43
Rapid Vienna,9396,3,7,12,5,36,30,6,33
LASK Linz,9396,4,7,7,10,29,32,-3,28
Mattersburg,9396,5,7,6,11,32,40,-8,27
SC Rheindorf,9396,6,6,6,12,19,28,-9,24
Vienna,9396,7,6,5,13,24,41,-17,23
FC Salzburg,9397,1,15,6,3,46,19,27,51
SK Sturm Gra,9397,2,12,4,8,30,28,2,40
LASK Linz,9397,3,9,7,8,29,25,4,34
Rapid Vienna,9397,4,8,9,7,36,31,5,33
Vienna,9397,5,7,5,12,25,39,-14,26
SC Rheindorf,9397,6,6,6,12,21,28,-7,24
Mattersburg,9397,7,6,5,13,27,44,-17,23
FC Salzburg,9398,1,13,9,2,40,15,25,48
SK Sturm Gra,9398,2,13,5,6,32,26,6,44
Rapid Vienna,9398,3,8,10,6,34,27,7,34
LASK Linz,9398,4,9,6,9,27,27,0,33
Mattersburg,9398,5,6,7,11,28,38,-10,25
Vienna,9398,6,6,5,13,23,40,-17,23
SC Rheindorf,9398,7,4,8,12,20,31,-11,20
FC Salzburg,9399,1,15,6,3,44,19,25,51
SK Sturm Gra,9399,2,14,3,7,36,29,7,45
Rapid Vienna,9399,3,9,9,6,35,26,9,36
LASK Linz,9399,4,8,6,10,29,32,-3,30
Mattersburg,9399,5,7,5,12,30,40,-10,26
Vienna,9399,6,6,5,13,23,40,-17,23
SC Rheindorf,9399,7,5,6,13,20,31,-11,21
FC Salzburg,9400,1,15,7,2,46,16,30,52
SK Sturm Gra,9400,2,13,5,6,35,28,7,44
LASK Linz,9400,3,10,5,9,28,27,1,35
Rapid Vienna,9400,4,7,11,6,35,30,5,32
Vienna,9400,5,7,5,12,27,39,-12,26
Mattersburg,9400,6,6,5,13,28,45,-17,23
SC Rheindorf,9400,7,4,6,14,17,31,-14,18
FC Salzburg,9401,1,14,8,2,46,18,28,50
SK Sturm Gra,9401,2,13,4,7,34,27,7,43
Rapid Vienna,9401,3,9,9,6,36,26,10,36
LASK Linz,9401,4,7,5,12,25,33,-8,26
Mattersburg,9401,5,7,5,12,33,42,-9,26
SC Rheindorf,9401,6,7,5,12,21,32,-11,26
Vienna,9401,7,6,6,12,24,41,-17,24
FC Salzburg,9402,1,14,6,4,44,19,25,48
SK Sturm Gra,9402,2,14,4,6,40,27,13,46
Rapid Vienna,9402,3,8,9,7,33,29,4,33
LASK Linz,9402,4,9,5,10,27,31,-4,32
SC Rheindorf,9402,5,6,7,11,20,27,-7,25
Vienna,9402,6,6,6,12,24,39,-15,24
Mattersburg,9402,7,5,7,12,29,45,-16,22
FC Salzburg,9403,1,14,7,3,46,20,26,49
SK Sturm Gra,9403,2,12,6,6,34,29,5,42
Rapid Vienna,9403,3,9,11,4,36,26,10,38
LASK Linz,9403,4,8,6,10,30,31,-1,30
Vienna,9403,5,7,5,12,26,41,-15,26
Mattersburg,9403,6,6,5,13,31,44,-13,23
SC Rheindorf,9403,7,5,6,13,18,30,-12,21
FC Salzburg,9404,1,14,7,3,46,17,29,49
SK Sturm Gra,9404,2,14,3,7,34,27,7,45
Rapid Vienna,9404,3,8,11,5,35,28,7,35
LASK Linz,9404,4,7,6,11,26,32,-6,27
SC Rheindorf,9404,5,7,5,12,24,30,-6,26
Mattersburg,9404,6,7,5,12,31,43,-12,26
Vienna,9404,7,6,5,13,23,42,-19,23
FC Salzburg,9405,1,14,8,2,42,16,26,50
SK Sturm Gra,9405,2,12,6,6,31,26,5,42
Rapid Vienna,9405,3,7,12,5,34,27,7,33
LASK Linz,9405,4,9,6,9,28,29,-1,33
Mattersburg,9405,5,6,6,12,31,41,-10,24
Vienna,9405,6,6,6,12,24,39,-15,24
SC Rheindorf,9405,7,5,6,13,19,31,-12,21
FC Salzburg,9406,1,12,8,4,40,19,21,44
SK Sturm Gra,9406,2,13,5,6,33,27,6,44
Rapid Vienna,9406,3,8,11,5,35,30,5,35
LASK Linz,9406,4,8,7,9,31,29,2,31
Mattersburg,9406,5,7,6,11,33,41,-8,27
Vienna,9406,6,7,6,11,25,38,-13,27
SC Rheindorf,9406,7,4,7,13,16,29,-13,19
FC Salzburg,9407,1,15,6,3,45,16,29,51
SK Sturm Gra,9407,2,12,4,8,34,32,2,40
Rapid Vienna,9407,3,10,9,5,36,25,11,39
LASK Linz,9407,4,7,7,10,30,33,-3,28
SC Rheindorf,9407,5,6,6,12,21,30,-9,24
Mattersburg,9407,6,6,6,12,30,44,-14,24
Vienna,9407,7,6,6,12,24,40,-16,24
FC Salzburg,9408,1,15,6,3,45,16,29,51
SK Sturm Gra,9408,2,13,4,7,32,27,5,43
Rapid Vienna,9408,3,9,10,5,36,26,10,37
LASK Linz,9408,4,9,5,10,27,29,-2,32
Mattersburg,9408,5,7,5,12,30,42,-12,26
Vienna,9408,6,6,5,13,24,42,-18,23
SC Rheindorf,9408,7,5,5,14,19,31,-12,20
FC Salzburg,9409,1,14,8,2,45,17,28,50
Rapid Vienna,9409,2,10,10,4,39,26,13,40
SK Sturm Gra,9409,3,11,3,10,33,35,-2,36
LASK Linz,9409,4,10,5,9,29,29,0,35
Mattersburg,9409,5,7,5,12,31,42,-11,26
Vienna,9409,6,6,6,12,24,39,-15,24
SC Rheindorf,9409,7,5,5,14,21,34,-13,20
FC Salzburg,9410,1,15,7,2,42,16,26,52
Rapid Vienna,9410,2,10,10,4,40,24,16,40
SK Sturm Gra,9410,3,11,4,9,28,31,-3,37
LASK Linz,9410,4,8,6,10,25,28,-3,30
Vienna,9410,5,7,5,12,25,38,-13,26
SC Rheindorf,9410,6,6,5,13,18,28,-10,23
Mattersburg,9410,7,6,5,13,29,42,-13,23
SK Sturm Gra,9411,1,14,4,6,35,28,7,46
FC Salzburg,9411,2,12,7,5,41,21,20,43
Rapid Vienna,9411,3,9,10,5,35,26,9,37
Mattersburg,9411,4,7,7,10,29,37,-8,28
LASK Linz,9411,5,7,6,11,26,32,-6,27
Vienna,9411,6,7,5,12,24,38,-14,26
SC Rheindorf,9411,7,5,7,12,19,27,-8,22
FC Salzburg,9412,1,15,7,2,52,19,33,52
SK Sturm Gra,9412,2,13,3,8,36,30,6,42
Rapid Vienna,9412,3,8,10,6,35,29,6,34
LASK Linz,9412,4,8,6,10,27,30,-3,30
Vienna,9412,5,7,5,12,27,42,-15,26
Mattersburg,9412,6,6,6,12,35,49,-14,24
SC Rheindorf,9412,7,6,5,13,22,35,-13,23
FC Salzburg,9413,1,14,8,2,45,18,27,50
SK Sturm Gra,9413,2,12,5,7,30,28,2,41
Rapid Vienna,9413,3,8,12,4,36,27,9,36
LASK Linz,9413,4,7,7,10,24,29,-5,28
Mattersburg,9413,5,6,7,11,30,40,-10,25
Vienna,9413,6,6,6,12,24,39,-15,24
SC Rheindorf,9413,7,6,5,13,22,30,-8,23
FC Salzburg,9414,1,15,6,3,48,18,30,51
SK Sturm Gra,9414,2,14,3,7,33,27,6,45
Rapid Vienna,9414,3,8,9,7,33,28,5,33
LASK Linz,9414,4,8,7,9,26,28,-2,31
Mattersburg,9414,5,6,7,11,30,40,-10,25
Vienna,9414,6,6,5,13,24,43,-19,23
SC Rheindorf,9414,7,5,7,12,19,29,-10,22
FC Salzburg,9415,1,16,6,2,48,16,32,54
SK Sturm Gra,9415,2,13,3,8,32,32,0,42
Rapid Vienna,9415,3,8,10,6,33,28,5,34
LASK Linz,9415,4,7,6,11,27,31,-4,27
SC Rheindorf,9415,5,7,5,12,23,27,-4,26
Mattersburg,9415,6,7,5,12,32,44,-12,26
Vienna,9415,7,6,5,13,24,41,-17,23
FC Salzburg,9416,1,15,6,3,48,19,29,51
SK Sturm Gra,9416,2,12,4,8,32,29,3,40
Rapid Vienna,9416,3,7,12,5,37,32,5,33
LASK Linz,9416,4,8,6,10,28,29,-1,30
SC Rheindorf,9416,5,7,6,11,22,28,-6,27
Vienna,9416,6,7,6,11,25,38,-13,27
Mattersburg,9416,7,5,6,13,29,46,-17,21
FC Salzburg,9417,1,13,8,3,43,21,22,47
SK Sturm Gra,9417,2,12,5,7,29,25,4,41
Rapid Vienna,9417,3,9,10,5,38,27,11,37
LASK Linz,9417,4,8,7,9,27,28,-1,31
Mattersburg,9417,5,6,7,11,34,44,-10,25
Vienna,9417,6,6,6,12,25,41,-16,24
SC Rheindorf,9417,7,4,9,11,18,28,-10,21
FC Salzburg,9418,1,15,7,2,47,17,30,52
SK Sturm Gra,9418,2,12,4,8,32,30,2,40
Rapid Vienna,9418,3,8,11,5,35,28,7,35
LASK Linz,9418,4,9,6,9,28,28,0,33
Mattersburg,9418,5,7,6,11,34,43,-9,27
Vienna,9418,6,6,5,13,23,40,-17,23
SC Rheindorf,9418,7,4,7,13,18,31,-13,19
FC Salzburg,9419,1,13,8,3,42,17,25,47
SK Sturm Gra,9419,2,13,4,7,30,25,5,43
Rapid Vienna,9419,3,11,9,4,36,23,13,42
LASK Linz,9419,4,7,6,11,24,28,-4,27
Vienna,9419,5,7,6,11,24,37,-13,27
Mattersburg,9419,6,6,6,12,30,43,-13,24
SC Rheindorf,9419,7,5,5,14,17,30,-13,20
FC Salzburg,9420,1,14,7,3,43,17,26,49
SK Sturm Gra,9420,2,11,3,10,29,33,-4,36
Rapid Vienna,9420,3,8,11,5,35,26,9,35
LASK Linz,9420,4,9,6,9,28,27,1,33
Mattersburg,9420,5,8,6,10,32,39,-7,30
Vienna,9420,6,6,7,11,25,39,-14,25
SC Rheindorf,9420,7,5,6,13,17,28,-11,21
FC Salzburg,9421,1,14,7,3,48,22,26,49
SK Sturm Gra,9421,2,13,4,7,36,31,5,43
Rapid Vienna,9421,3,8,10,6,36,28,8,34
Mattersburg,9421,4,9,5,10,37,38,-1,32
LASK Linz,9421,5,7,7,10,25,28,-3,28
Vienna,9421,6,6,5,13,24,46,-22,23
SC Rheindorf,9421,7,5,6,13,19,32,-13,21
FC Salzburg,9422,1,13,8,3,43,19,24,47
SK Sturm Gra,9422,2,13,4,7,33,28,5,43
Rapid Vienna,9422,3,8,11,5,37,28,9,35
LASK Linz,9422,4,9,6,9,29,29,0,33
Vienna,9422,5,6,7,11,26,40,-14,25
Mattersburg,9422,6,6,6,12,31,43,-12,24
SC Rheindorf,9422,7,5,6,13,19,31,-12,21
FC Salzburg,9423,1,14,7,3,45,19,26,49
SK Sturm Gra,9423,2,13,4,7,31,26,5,43
Rapid Vienna,9423,3,9,10,5,36,28,8,37
LASK Linz,9423,4,9,5,10,27,27,0,32
Vienna,9423,5,7,6,11,25,38,-13,27
Mattersburg,9423,6,5,7,12,28,42,-14,22
SC Rheindorf,9423,7,4,7,13,17,29,-12,19
FC Salzburg,9424,1,16,6,2,47,17,30,54
SK Sturm Gra,9424,2,12,4,8,32,32,0,40
LASK Linz,9424,3,10,6,8,32,27,5,36
Rapid Vienna,9424,4,8,9,7,36,31,5,33
Vienna,9424,5,6,6,12,25,40,-15,24
SC Rheindorf,9424,6,5,7,12,22,32,-10,22
Mattersburg,9424,7,5,6,13,28,43,-15,21
FC Salzburg,9425,1,14,7,3,42,19,23,49
Rapid Vienna,9425,2,9,10,5,39,27,12,37
SK Sturm Gra,9425,3,11,3,10,29,34,-5,36
LASK Linz,9425,4,8,6,10,26,28,-2,30
Mattersburg,9425,5,7,6,11,32,41,-9,27
SC Rheindorf,9425,6,7,5,12,22,28,-6,26
Vienna,9425,7,7,5,12,27,40,-13,26
FC Salzburg,9426,1,14,7,3,45,19,26,49
Rapid Vienna,9426,2,10,10,4,39,25,14,40
SK Sturm Gra,9426,3,12,4,8,32,29,3,40
LASK Linz,9426,4,8,5,11,28,33,-5,29
Vienna,9426,5,7,5,12,25,39,-14,26
Mattersburg,9426,6,6,6,12,31,45,-14,24
SC Rheindorf,9426,7,5,7,12,19,29,-10,22
FC Salzburg,9427,1,14,7,3,43,18,25,49
SK Sturm Gra,9427,2,12,4,8,35,33,2,40
Rapid Vienna,9427,3,8,10,6,37,31,6,34
LASK Linz,9427,4,9,7,8,29,28,1,34
SC Rheindorf,9427,5,7,6,11,24,28,-4,27
Vienna,9427,6,7,5,12,25,38,-13,26
Mattersburg,9427,7,5,5,14,27,44,-17,20
FC Salzburg,9428,1,14,8,2,45,19,26,50
SK Sturm Gra,9428,2,12,4,8,32,28,4,40
Rapid Vienna,9428,3,7,10,7,31,28,3,31
LASK Linz,9428,4,8,7,9,27,28,-1,31
Mattersburg,9428,5,7,7,10,32,40,-8,28
SC Rheindorf,9428,6,7,5,12,18,26,-8,26
Vienna,9428,7,6,5,13,29,45,-16,23
FC Salzburg,9429,1,14,7,3,49,18,31,49
SK Sturm Gra,9429,2,12,4,8,33,35,-2,40
Rapid Vienna,9429,3,9,9,6,36,29,7,36
LASK Linz,9429,4,8,5,11,26,31,-5,29
SC Rheindorf,9429,5,7,6,11,24,28,-4,27
Vienna,9429,6,7,6,11,27,39,-12,27
Mattersburg,9429,7,6,5,13,30,45,-15,23
FC Salzburg,9430,1,14,8,2,47,19,28,50
SK Sturm Gra,9430,2,13,5,6,36,29,7,44
Rapid Vienna,9430,3,9,11,4,39,28,11,38
LASK Linz,9430,4,8,6,10,29,31,-2,30
Mattersburg,9430,5,6,6,12,31,44,-13,24
Vienna,9430,6,6,6,12,24,41,-17,24
SC Rheindorf,9430,7,4,6,14,18,32,-14,18
FC Salzburg,9431,1,13,7,4,44,21,23,46
SK Sturm Gra,9431,2,13,5,6,36,27,9,44
Rapid Vienna,9431,3,8,10,6,35,30,5,34
Mattersburg,9431,4,8,5,11,32,39,-7,29
LASK Linz,9431,5,7,7,10,25,32,-7,28
SC Rheindorf,9431,6,6,6,12,20,27,-7,24
Vienna,9431,7,6,6,12,24,40,-16,24
FC Salzburg,9432,1,15,7,2,44,17,27,52
SK Sturm Gra,9432,2,12,4,8,34,31,3,40
LASK Linz,9432,3,10,6,8,31,27,4,36
Rapid Vienna,9432,4,7,11,6,31,26,5,32
Vienna,9432,5,7,5,12,28,41,-13,26
Mattersburg,9432,6,6,6,12,34,44,-10,24
SC Rheindorf,9432,7,5,5,14,19,35,-16,20
FC Salzburg,9433,1,13,7,4,43,21,22,46
SK Sturm Gra,9433,2,12,4,8,31,28,3,40
Rapid Vienna,9433,3,9,11,4,38,28,10,38
LASK Linz,9433,4,8,8,8,26,26,0,32
Mattersburg,9433,5,6,8,10,30,39,-9,26
Vienna,9433,6,6,6,12,25,40,-15,24
SC Rheindorf,9433,7,5,6,13,18,29,-11,21
FC Salzburg,9434,1,13,7,4,41,20,21,46
SK Sturm Gra,9434,2,12,4,8,31,29,2,40
Rapid Vienna,9434,3,10,9,5,39,28,11,39
LASK Linz,9434,4,8,6,10,30,31,-1,30
Mattersburg,9434,5,8,5,11,36,41,-5,29
Vienna,9434,6,6,6,12,25,42,-17,24
SC Rheindorf,9434,7,6,5,13,20,31,-11,23
FC Salzburg,9435,1,15,7,2,48,16,32,52
Rapid Vienna,9435,2,10,9,5,37,28,9,39
SK Sturm Gra,9435,3,12,3,9,32,34,-2,39
LASK Linz,9435,4,7,6,11,25,31,-6,27
SC Rheindorf,9435,5,7,5,12,21,28,-7,26
Vienna,9435,6,6,6,12,25,40,-15,24
Mattersburg,9435,7,5,8,11,32,43,-11,23
FC Salzburg,9436,1,14,7,3,50,27,23,49
SK Sturm Gra,9436,2,13,4,7,34,28,6,43
Rapid Vienna,9436,3,9,9,6,43,34,9,36
Mattersburg,9436,4,8,6,10,36,40,-4,30
LASK Linz,9436,5,8,5,11,28,33,-5,29
Vienna,9436,6,6,5,13,27,45,-18,23
SC Rheindorf,9436,7,5,6,13,22,33,-11,21
FC Salzburg,9437,1,15,6,3,45,20,25,51
SK Sturm Gra,9437,2,14,3,7,34,28,6,45
Rapid Vienna,9437,3,8,10,6,37,27,10,34
LASK Linz,9437,4,9,6,9,26,27,-1,33
Vienna,9437,5,7,5,12,25,39,-14,26
Mattersburg,9437,6,5,6,13,28,43,-15,21
SC Rheindorf,9437,7,4,8,12,17,28,-11,20
FC Salzburg,9438,1,14,8,2,44,18,26,50
SK Sturm Gra,9438,2,12,3,9,31,29,2,39
Rapid Vienna,9438,3,8,11,5,35,28,7,35
LASK Linz,9438,4,9,6,9,29,29,0,33
Mattersburg,9438,5,7,5,12,31,41,-10,26
Vienna,9438,6,6,6,12,25,40,-15,24
SC Rheindorf,9438,7,6,5,13,20,30,-10,23
FC Salzburg,9439,1,15,7,2,44,17,27,52
SK Sturm Gra,9439,2,13,4,7,35,29,6,43
Rapid Vienna,9439,3,7,12,5,35,28,7,33
LASK Linz,9439,4,7,6,11,28,35,-7,27
Vienna,9439,5,7,6,11,27,39,-12,27
Mattersburg,9439,6,7,5,12,29,41,-12,26
SC Rheindorf,9439,7,5,6,13,24,33,-9,21
FC Salzburg,9440,1,14,8,2,43,18,25,50
SK Sturm Gra,9440,2,13,5,6,33,27,6,44
Rapid Vienna,9440,3,7,11,6,35,29,6,32
LASK Linz,9440,4,8,5,11,25,28,-3,29
Mattersburg,9440,5,7,5,12,29,39,-10,26
SC Rheindorf,9440,6,6,6,12,19,28,-9,24
Vienna,9440,7,6,6,12,23,38,-15,24
FC Salzburg,9441,1,16,6,2,47,16,31,54
SK Sturm Gra,9441,2,11,4,9,28,28,0,37
LASK Linz,9441,3,9,6,9,28,27,1,33
Rapid Vienna,9441,4,7,11,6,32,28,4,32
Vienna,9441,5,7,5,12,32,43,-11,26
Mattersburg,9441,6,6,6,12,31,48,-17,24
SC Rheindorf,9441,7,5,8,11,19,27,-8,23
FC Salzburg,9442,1,13,7,4,43,21,22,46
SK Sturm Gra,9442,2,12,5,7,32,30,2,41
Rapid Vienna,9442,3,10,9,5,40,28,12,39
LASK Linz,9442,4,9,6,9,28,26,2,33
Mattersburg,9442,5,8,6,10,31,38,-7,30
Vienna,9442,6,6,6,12,23,38,-15,24
SC Rheindorf,9442,7,4,5,15,17,33,-16,17
FC Salzburg,9443,1,15,7,2,46,19,27,52
SK Sturm Gra,9443,2,13,3,8,33,28,5,42
Rapid Vienna,9443,3,8,10,6,35,29,6,34
LASK Linz,9443,4,9,6,9,31,28,3,33
Vienna,9443,5,7,6,11,27,39,-12,27
SC Rheindorf,9443,6,5,6,13,18,32,-14,21
Mattersburg,9443,7,5,6,13,28,43,-15,21
FC Salzburg,9444,1,14,7,3,43,19,24,49
SK Sturm Gra,9444,2,12,3,9,30,28,2,39
Rapid Vienna,9444,3,9,10,5,37,28,9,37
LASK Linz,9444,4,8,7,9,26,27,-1,31
Vienna,9444,5,7,6,11,26,39,-13,27
Mattersburg,9444,6,6,7,11,31,41,-10,25
SC Rheindorf,9444,7,5,6,13,18,29,-11,21
FC Salzburg,9445,1,15,7,2,45,17,28,52
SK Sturm Gra,9445,2,11,6,7,34,31,3,39
Rapid Vienna,9445,3,8,10,6,38,30,8,34
LASK Linz,9445,4,8,7,9,29,29,0,31
Mattersburg,9445,5,8,5,11,33,42,-9,29
Vienna,9445,6,6,6,12,25,40,-15,24
SC Rheindorf,9445,7,4,7,13,22,37,-15,19
FC Salzburg,9446,1,14,7,3,43,22,21,49
Rapid Vienna,9446,2,9,11,4,40,29,11,38
SK Sturm Gra,9446,3,11,5,8,29,30,-1,38
LASK Linz,9446,4,7,8,9,24,27,-3,29
Vienna,9446,5,8,5,11,33,38,-5,29
Mattersburg,9446,6,6,6,12,27,41,-14,24
SC Rheindorf,9446,7,5,6,13,21,30,-9,21
FC Salzburg,9447,1,13,8,3,42,19,23,47
SK Sturm Gra,9447,2,12,4,8,30,27,3,40
Rapid Vienna,9447,3,9,11,4,35,25,10,38
LASK Linz,9447,4,10,6,8,28,26,2,36
Mattersburg,9447,5,6,7,11,31,40,-9,25
Vienna,9447,6,6,7,11,25,39,-14,25
SC Rheindorf,9447,7,4,5,15,16,31,-15,17
FC Salzburg,9448,1,14,6,4,44,21,23,48
SK Sturm Gra,9448,2,12,4,8,32,32,0,40
Rapid Vienna,9448,3,9,9,6,39,30,9,36
LASK Linz,9448,4,9,6,9,30,28,2,33
Vienna,9448,5,7,6,11,25,38,-13,27
Mattersburg,9448,6,6,6,12,29,40,-11,24
SC Rheindorf,9448,7,6,5,13,19,29,-10,23
FC Salzburg,9449,1,15,6,3,51,18,33,51
SK Sturm Gra,9449,2,13,4,7,31,28,3,43
Rapid Vienna,9449,3,8,9,7,33,30,3,33
LASK Linz,9449,4,8,6,10,27,28,-1,30
Vienna,9449,5,8,5,11,26,38,-12,29
Mattersburg,9449,6,7,5,12,29,43,-14,26
SC Rheindorf,9449,7,5,5,14,20,32,-12,20
FC Salzburg,9450,1,14,7,3,44,20,24,49
SK Sturm Gra,9450,2,12,5,7,33,33,0,41
Rapid Vienna,9450,3,9,10,5,36,27,9,37
LASK Linz,9450,4,9,5,10,26,27,-1,32
Vienna,9450,5,7,6,11,27,40,-13,27
Mattersburg,9450,6,5,7,12,30,42,-12,22
SC Rheindorf,9450,7,5,6,13,23,30,-7,21
FC Salzburg,9451,1,14,8,2,44,16,28,50
SK Sturm Gra,9451,2,13,4,7,35,28,7,43
Rapid Vienna,9451,3,7,11,6,34,28,6,32
LASK Linz,9451,4,8,7,9,27,30,-3,31
Mattersburg,9451,5,6,7,11,30,39,-9,25
Vienna,9451,6,6,6,12,24,42,-18,24
SC Rheindorf,9451,7,6,5,13,18,29,-11,23
FC Salzburg,9452,1,15,6,3,46,20,26,51
SK Sturm Gra,9452,2,14,3,7,35,29,6,45
Rapid Vienna,9452,3,8,9,7,36,30,6,33
LASK Linz,9452,4,9,5,10,29,30,-1,32
Vienna,9452,5,7,5,12,29,42,-13,26
SC Rheindorf,9452,6,6,6,12,18,28,-10,24
Mattersburg,9452,7,5,6,13,30,44,-14,21
FC Salzburg,9453,1,14,7,3,47,18,29,49
SK Sturm Gra,9453,2,13,4,7,34,30,4,43
Rapid Vienna,9453,3,9,9,6,35,27,8,36
LASK Linz,9453,4,9,5,10,25,27,-2,32
Vienna,9453,5,7,5,12,25,38,-13,26
Mattersburg,9453,6,7,5,12,29,44,-15,26
SC Rheindorf,9453,7,5,5,14,19,30,-11,20
FC Salzburg,9454,1,14,8,2,46,18,28,50
SK Sturm Gra,9454,2,12,6,6,32,27,5,42
LASK Linz,9454,3,10,6,8,35,26,9,36
Rapid Vienna,9454,4,8,11,5,35,29,6,35
Vienna,9454,5,7,5,12,29,41,-12,26
Mattersburg,9454,6,5,6,13,31,50,-19,21
SC Rheindorf,9454,7,4,6,14,18,35,-17,18
FC Salzburg,9455,1,13,8,3,40,18,22,47
SK Sturm Gra,9455,2,13,5,6,35,28,7,44
Rapid Vienna,9455,3,9,9,6,36,27,9,36
LASK Linz,9455,4,9,6,9,28,28,0,33
Vienna,9455,5,6,7,11,26,40,-14,25
Mattersburg,9455,6,6,6,12,32,41,-9,24
SC Rheindorf,9455,7,5,5,14,16,31,-15,20
FC Salzburg,9456,1,16,6,2,55,17,38,54
SK Sturm Gra,9456,2,12,3,9,33,35,-2,39
Rapid Vienna,9456,3,8,10,6,34,27,7,34
LASK Linz,9456,4,8,6,10,27,29,-2,30
Vienna,9456,5,7,5,12,25,39,-14,26
Mattersburg,9456,6,6,6,12,29,47,-18,24
SC Rheindorf,9456,7,5,8,11,21,30,-9,23
FC Salzburg,9457,1,14,6,4,47,23,24,48
SK Sturm Gra,9457,2,14,3,7,37,29,8,45
Rapid Vienna,9457,3,7,10,7,32,29,3,31
LASK Linz,9457,4,8,7,9,26,27,-1,31
Mattersburg,9457,5,7,5,12,35,44,-9,26
Vienna,9457,6,7,5,12,25,39,-14,26
SC Rheindorf,9457,7,6,6,12,22,33,-11,24
FC Salzburg,9458,1,15,6,3,46,21,25,51
SK Sturm Gra,9458,2,13,3,8,31,28,3,42
Rapid Vienna,9458,3,10,9,5,38,26,12,39
LASK Linz,9458,4,8,5,11,27,31,-4,29
Mattersburg,9458,5,6,7,11,32,41,-9,25
Vienna,9458,6,6,6,12,27,42,-15,24
SC Rheindorf,9458,7,5,6,13,16,28,-12,21
FC Salzburg,9459,1,15,7,2,46,17,29,52
SK Sturm Gra,9459,2,11,6,7,35,32,3,39
Rapid Vienna,9459,3,8,10,6,37,29,8,34
LASK Linz,9459,4,8,8,8,30,29,1,32
Mattersburg,9459,5,7,6,11,35,39,-4,27
Vienna,9459,6,6,5,13,23,44,-21,23
SC Rheindorf,9459,7,5,6,13,20,36,-16,21
FC Salzburg,9460,1,15,7,2,48,18,30,52
SK Sturm Gra,9460,2,13,5,6,33,26,7,44
Rapid Vienna,9460,3,8,11,5,35,27,8,35
LASK Linz,9460,4,8,6,10,26,28,-2,30
SC Rheindorf,9460,5,6,5,13,19,29,-10,23
Mattersburg,9460,6,6,5,13,31,46,-15,23
Vienna,9460,7,6,5,13,24,42,-18,23
FC Salzburg,9461,1,14,7,3,47,22,25,49
Rapid Vienna,9461,2,9,11,4,40,27,13,38
SK Sturm Gra,9461,3,11,5,8,30,28,2,38
LASK Linz,9461,4,10,6,8,31,28,3,36
Vienna,9461,5,7,5,12,30,42,-12,26
Mattersburg,9461,6,6,5,13,31,47,-16,23
SC Rheindorf,9461,7,5,5,14,19,34,-15,20
FC Salzburg,9462,1,14,7,3,43,19,24,49
SK Sturm Gra,9462,2,14,3,7,33,28,5,45
Rapid Vienna,9462,3,8,10,6,38,29,9,34
LASK Linz,9462,4,8,5,11,27,30,-3,29
SC Rheindorf,9462,5,7,6,11,22,27,-5,27
Vienna,9462,6,6,7,11,23,37,-14,25
Mattersburg,9462,7,5,6,13,28,44,-16,21
FC Salzburg,9463,1,14,7,3,45,21,24,49
SK Sturm Gra,9463,2,13,3,8,38,34,4,42
LASK Linz,9463,3,9,6,9,31,28,3,33
Rapid Vienna,9463,4,8,9,7,34,32,2,33
Vienna,9463,5,8,5,11,29,39,-10,29
Mattersburg,9463,6,7,6,11,34,44,-10,27
SC Rheindorf,9463,7,4,6,14,21,34,-13,18
FC Salzburg,9464,1,14,6,4,42,19,23,48
SK Sturm Gra,9464,2,11,4,9,31,33,-2,37
LASK Linz,9464,3,9,6,9,28,28,0,33
Rapid Vienna,9464,4,7,11,6,33,28,5,32
SC Rheindorf,9464,5,7,6,11,25,28,-3,27
Vienna,9464,6,7,6,11,25,38,-13,27
Mattersburg,9464,7,6,7,11,32,42,-10,25
FC Salzburg,9465,1,15,7,2,46,17,29,52
SK Sturm Gra,9465,2,12,3,9,30,29,1,39
Rapid Vienna,9465,3,9,10,5,37,27,10,37
LASK Linz,9465,4,9,5,10,27,28,-1,32
Mattersburg,9465,5,7,6,11,29,41,-12,27
Vienna,9465,6,6,6,12,23,38,-15,24
SC Rheindorf,9465,7,5,5,14,16,28,-12,20
FC Salzburg,9466,1,15,7,2,46,17,29,52
SK Sturm Gra,9466,2,13,4,7,33,30,3,43
Rapid Vienna,9466,3,8,10,6,34,27,7,34
LASK Linz,9466,4,7,6,11,26,31,-5,27
SC Rheindorf,9466,5,6,7,11,21,28,-7,25
Vienna,9466,6,6,7,11,25,39,-14,25
Mattersburg,9466,7,5,7,12,29,42,-13,22
FC Salzburg,9467,1,16,6,2,46,16,30,54
SK Sturm Gra,9467,2,12,4,8,31,29,2,40
Rapid Vienna,9467,3,9,9,6,36,28,8,36
LASK Linz,9467,4,8,8,8,29,29,0,32
Mattersburg,9467,5,6,7,11,30,38,-8,25
Vienna,9467,6,6,6,12,23,40,-17,24
SC Rheindorf,9467,7,4,6,14,19,34,-15,18
FC Salzburg,9468,1,14,6,4,41,19,22,48
Rapid Vienna,9468,2,10,10,4,38,25,13,40
SK Sturm Gra,9468,3,12,3,9,30,28,2,39
Mattersburg,9468,4,8,6,10,37,40,-3,30
LASK Linz,9468,5,7,7,10,28,32,-4,28
SC Rheindorf,9468,6,6,5,13,22,35,-13,23
Vienna,9468,7,6,5,13,24,41,-17,23
FC Salzburg,9469,1,14,8,2,50,22,28,50
SK Sturm Gra,9469,2,13,4,7,32,28,4,43
Rapid Vienna,9469,3,7,12,5,34,27,7,33
LASK Linz,9469,4,8,7,9,25,26,-1,31
Vienna,9469,5,7,6,11,29,42,-13,27
Mattersburg,9469,6,6,5,13,31,43,-12,23
SC Rheindorf,9469,7,5,6,13,19,32,-13,21
FC Salzburg,9470,1,13,8,3,44,20,24,47
SK Sturm Gra,9470,2,12,4,8,33,30,3,40
Rapid Vienna,9470,3,8,11,5,36,27,9,35
LASK Linz,9470,4,10,5,9,29,29,0,35
Vienna,9470,5,7,5,12,24,39,-15,26
SC Rheindorf,9470,6,6,6,12,22,29,-7,24
Mattersburg,9470,7,6,5,13,28,42,-14,23
SK Sturm Gra,9471,1,14,3,7,35,28,7,45
FC Salzburg,9471,2,12,7,5,39,20,19,43
Rapid Vienna,9471,3,10,9,5,39,27,12,39
LASK Linz,9471,4,8,5,11,28,33,-5,29
Mattersburg,9471,5,7,6,11,30,38,-8,27
Vienna,9471,6,7,5,12,27,40,-13,26
SC Rheindorf,9471,7,6,5,13,17,29,-12,23
FC Salzburg,9472,1,16,6,2,52,18,34,54
SK Sturm Gra,9472,2,12,5,7,33,27,6,41
LASK Linz,9472,3,9,5,10,29,30,-1,32
Rapid Vienna,9472,4,7,10,7,33,34,-1,31
SC Rheindorf,9472,5,7,6,11,23,27,-4,27
Mattersburg,9472,6,6,5,13,34,49,-15,23
Vienna,9472,7,6,5,13,25,44,-19,23
FC Salzburg,9473,1,13,8,3,43,18,25,47
SK Sturm Gra,9473,2,13,4,7,34,28,6,43
Rapid Vienna,9473,3,10,10,4,40,24,16,40
LASK Linz,9473,4,9,6,9,28,28,0,33
Vienna,9473,5,6,6,12,24,44,-20,24
Mattersburg,9473,6,6,5,13,35,44,-9,23
SC Rheindorf,9473,7,5,5,14,18,36,-18,20
FC Salzburg,9474,1,14,6,4,45,18,27,48
SK Sturm Gra,9474,2,12,3,9,30,35,-5,39
Rapid Vienna,9474,3,8,10,6,35,30,5,34
LASK Linz,9474,4,9,6,9,32,29,3,33
Vienna,9474,5,7,6,11,26,39,-13,27
Mattersburg,9474,6,6,7,11,32,42,-10,25
SC Rheindorf,9474,7,5,8,11,22,29,-7,23
FC Salzburg,9475,1,15,6,3,45,20,25,51
Rapid Vienna,9475,2,9,10,5,36,24,12,37
SK Sturm Gra,9475,3,11,4,9,30,29,1,37
LASK Linz,9475,4,9,7,8,26,25,1,34
SC Rheindorf,9475,5,6,6,12,20,30,-10,24
Vienna,9475,6,6,6,12,26,41,-15,24
Mattersburg,9475,7,5,7,12,29,43,-14,22
FC Salzburg,9476,1,14,8,2,47,20,27,50
SK Sturm Gra,9476,2,12,4,8,31,29,2,40
LASK Linz,9476,3,10,5,9,29,26,3,35
Rapid Vienna,9476,4,8,10,6,37,31,6,34
SC Rheindorf,9476,5,6,6,12,20,27,-7,24
Vienna,9476,6,6,6,12,26,42,-16,24
Mattersburg,9476,7,6,5,13,33,48,-15,23
FC Salzburg,9477,1,13,7,4,43,21,22,46
SK Sturm Gra,9477,2,13,3,8,33,29,4,42
Rapid Vienna,9477,3,9,10,5,36,27,9,37
LASK Linz,9477,4,9,5,10,32,31,1,32
Mattersburg,9477,5,7,6,11,32,41,-9,27
Vienna,9477,6,6,6,12,27,42,-15,24
SC Rheindorf,9477,7,6,5,13,18,30,-12,23
FC Salzburg,9478,1,14,7,3,45,19,26,49
SK Sturm Gra,9478,2,12,5,7,35,30,5,41
Rapid Vienna,9478,3,9,11,4,39,29,10,38
LASK Linz,9478,4,8,8,8,28,28,0,32
Vienna,9478,5,6,6,12,24,39,-15,24
Mattersburg,9478,6,6,5,13,27,40,-13,23
SC Rheindorf,9478,7,5,6,13,20,33,-13,21
FC Salzburg,9479,1,16,6,2,48,18,30,54
SK Sturm Gra,9479,2,13,4,7,31,26,5,43
Rapid Vienna,9479,3,8,9,7,35,29,6,33
LASK Linz,9479,4,9,6,9,27,29,-2,33
Mattersburg,9479,5,7,6,11,36,43,-7,27
Vienna,9479,6,6,5,13,24,43,-19,23
SC Rheindorf,9479,7,4,6,14,16,29,-13,18
FC Salzburg,9480,1,14,7,3,43,17,26,49
SK Sturm Gra,9480,2,13,5,6,31,25,6,44
Rapid Vienna,9480,3,8,9,7,35,31,4,33
LASK Linz,9480,4,8,7,9,27,27,0,31
Mattersburg,9480,5,8,6,10,30,36,-6,30
Vienna,9480,6,6,5,13,23,39,-16,23
SC Rheindorf,9480,7,4,7,13,17,31,-14,19
FC Salzburg,9481,1,13,9,2,41,17,24,48
SK Sturm Gra,9481,2,12,5,7,32,28,4,41
Rapid Vienna,9481,3,9,9,6,36,28,8,36
LASK Linz,9481,4,9,6,9,28,28,0,33
Mattersburg,9481,5,7,6,11,29,38,-9,27
Vienna,9481,6,6,6,12,24,39,-15,24
SC Rheindorf,9481,7,5,5,14,17,29,-12,20
FC Salzburg,9482,1,14,8,2,43,17,26,50
SK Sturm Gra,9482,2,12,3,9,31,31,0,39
Rapid Vienna,9482,3,9,10,5,36,26,10,37
LASK Linz,9482,4,9,5,10,30,30,0,32
Mattersburg,9482,5,7,6,11,35,41,-6,27
Vienna,9482,6,7,5,12,25,39,-14,26
SC Rheindorf,9482,7,5,5,14,21,37,-16,20
FC Salzburg,9483,1,13,8,3,43,20,23,47
SK Sturm Gra,9483,2,12,6,6,31,26,5,42
Rapid Vienna,9483,3,10,10,4,38,24,14,40
LASK Linz,9483,4,7,8,9,28,31,-3,29
Vienna,9483,5,7,5,12,26,41,-15,26
Mattersburg,9483,6,5,7,12,32,44,-12,22
SC Rheindorf,9483,7,5,6,13,21,33,-12,21
FC Salzburg,9484,1,14,6,4,47,22,25,48
SK Sturm Gra,9484,2,12,3,9,32,33,-1,39
Rapid Vienna,9484,3,9,9,6,39,31,8,36
LASK Linz,9484,4,9,6,9,28,27,1,33
Vienna,9484,5,7,6,11,27,39,-12,27
Mattersburg,9484,6,6,7,11,32,41,-9,25
SC Rheindorf,9484,7,6,5,13,20,32,-12,23
FC Salzburg,9485,1,16,6,2,50,16,34,54
SK Sturm Gra,9485,2,13,4,7,30,26,4,43
Rapid Vienna,9485,3,8,10,6,33,29,4,34
LASK Linz,9485,4,9,6,9,28,27,1,33
Mattersburg,9485,5,6,5,13,31,47,-16,23
Vienna,9485,6,6,5,13,25,41,-16,23
SC Rheindorf,9485,7,5,6,13,18,29,-11,21
FC Salzburg,9486,1,16,6,2,49,18,31,54
SK Sturm Gra,9486,2,13,4,7,38,30,8,43
Rapid Vienna,9486,3,8,9,7,32,30,2,33
LASK Linz,9486,4,8,7,9,27,27,0,31
Mattersburg,9486,5,6,7,11,31,43,-12,25
Vienna,9486,6,6,6,12,26,43,-17,24
SC Rheindorf,9486,7,4,7,13,18,30,-12,19
FC Salzburg,9487,1,15,6,3,47,18,29,51
SK Sturm Gra,9487,2,13,3,8,35,30,5,42
Rapid Vienna,9487,3,8,9,7,34,31,3,33
LASK Linz,9487,4,8,5,11,26,31,-5,29
SC Rheindorf,9487,5,8,5,11,25,30,-5,29
Mattersburg,9487,6,6,6,12,35,46,-11,24
Vienna,9487,7,6,6,12,26,42,-16,24
FC Salzburg,9488,1,15,6,3,50,19,31,51
SK Sturm Gra,9488,2,12,4,8,33,31,2,40
Rapid Vienna,9488,3,9,9,6,37,27,10,36
LASK Linz,9488,4,8,6,10,28,31,-3,30
Mattersburg,9488,5,7,6,11,33,46,-13,27
Vienna,9488,6,6,6,12,26,42,-16,24
SC Rheindorf,9488,7,6,5,13,20,31,-11,23
FC Salzburg,9489,1,14,7,3,44,19,25,49
Rapid Vienna,9489,2,10,9,5,37,27,10,39
SK Sturm Gra,9489,3,11,4,9,29,29,0,37
Mattersburg,9489,4,7,6,11,33,39,-6,27
LASK Linz,9489,5,7,6,11,24,32,-8,27
Vienna,9489,6,7,6,11,26,38,-12,27
SC Rheindorf,9489,7,6,6,12,21,30,-9,24
FC Salzburg,9490,1,15,7,2,45,17,28,52
SK Sturm Gra,9490,2,12,5,7,31,26,5,41
Rapid Vienna,9490,3,8,11,5,37,30,7,35
LASK Linz,9490,4,7,6,11,25,30,-5,27
Vienna,9490,5,7,5,12,28,41,-13,26
Mattersburg,9490,6,6,7,11,31,42,-11,25
SC Rheindorf,9490,7,5,7,12,18,29,-11,22
FC Salzburg,9491,1,14,7,3,43,19,24,49
SK Sturm Gra,9491,2,12,4,8,30,27,3,40
Rapid Vienna,9491,3,9,10,5,35,25,10,37
LASK Linz,9491,4,8,5,11,25,32,-7,29
Vienna,9491,5,7,5,12,28,40,-12,26
Mattersburg,9491,6,6,7,11,34,45,-11,25
SC Rheindorf,9491,7,6,6,12,22,29,-7,24
FC Salzburg,9492,1,14,6,4,43,19,24,48
SK Sturm Gra,9492,2,13,5,6,36,28,8,44
Rapid Vienna,9492,3,9,9,6,36,32,4,36
LASK Linz,9492,4,9,6,9,29,26,3,33
Mattersburg,9492,5,7,5,12,32,41,-9,26
Vienna,9492,6,6,5,13,25,44,-19,23
SC Rheindorf,9492,7,5,6,13,19,30,-11,21
FC Salzburg,9493,1,15,7,2,52,19,33,52
SK Sturm Gra,9493,2,13,4,7,33,30,3,43
Rapid Vienna,9493,3,8,10,6,36,30,6,34
LASK Linz,9493,4,8,7,9,29,32,-3,31
Mattersburg,9493,5,7,7,10,34,42,-8,28
Vienna,9493,6,6,5,13,24,40,-16,23
SC Rheindorf,9493,7,4,6,14,22,37,-15,18
FC Salzburg,9494,1,14,7,3,43,17,26,49
SK Sturm Gra,9494,2,12,4,8,31,31,0,40
Rapid Vienna,9494,3,7,12,5,34,28,6,33
LASK Linz,9494,4,8,7,9,30,29,1,31
Vienna,9494,5,7,6,11,26,39,-13,27
SC Rheindorf,9494,6,6,6,12,18,27,-9,24
Mattersburg,9494,7,5,8,11,29,40,-11,23
FC Salzburg,9495,1,15,7,2,46,17,29,52
SK Sturm Gra,9495,2,13,4,7,34,29,5,43
Rapid Vienna,9495,3,9,9,6,34,27,7,36
LASK Linz,9495,4,8,6,10,27,29,-2,30
Mattersburg,9495,5,8,5,11,34,40,-6,29
Vienna,9495,6,6,5,13,24,42,-18,23
SC Rheindorf,9495,7,4,6,14,17,32,-15,18
FC Salzburg,9496,1,15,7,2,47,16,31,52
SK Sturm Gra,9496,2,13,5,6,37,27,10,44
Rapid Vienna,9496,3,9,10,5,36,28,8,37
LASK Linz,9496,4,8,5,11,26,32,-6,29
Vienna,9496,5,7,5,12,27,40,-13,26
Mattersburg,9496,6,6,5,13,29,47,-18,23
SC Rheindorf,9496,7,5,5,14,20,32,-12,20
FC Salzburg,9497,1,14,8,2,45,18,27,50
SK Sturm Gra,9497,2,12,4,8,33,30,3,40
Rapid Vienna,9497,3,8,12,4,36,27,9,36
LASK Linz,9497,4,8,5,11,29,32,-3,29
Vienna,9497,5,6,7,11,25,39,-14,25
SC Rheindorf,9497,6,6,6,12,22,30,-8,24
Mattersburg,9497,7,6,6,12,31,45,-14,24
FC Salzburg,9498,1,16,6,2,49,22,27,54
SK Sturm Gra,9498,2,13,3,8,33,28,5,42
Rapid Vienna,9498,3,9,9,6,40,31,9,36
LASK Linz,9498,4,7,5,12,26,33,-7,26
Mattersburg,9498,5,6,7,11,30,39,-9,25
SC Rheindorf,9498,6,6,6,12,19,29,-10,24
Vienna,9498,7,6,6,12,25,40,-15,24
FC Salzburg,9499,1,15,6,3,50,20,30,51
SK Sturm Gra,9499,2,13,4,7,35,31,4,43
Rapid Vienna,9499,3,8,10,6,33,28,5,34
LASK Linz,9499,4,9,6,9,31,30,1,33
Vienna,9499,5,7,5,12,26,39,-13,26
SC Rheindorf,9499,6,5,8,11,19,28,-9,23
Mattersburg,9499,7,5,5,14,30,48,-18,20
FC Salzburg,9500,1,13,7,4,42,23,19,46
SK Sturm Gra,9500,2,14,4,6,37,28,9,46
Rapid Vienna,9500,3,8,10,6,36,28,8,34
LASK Linz,9500,4,7,8,9,30,34,-4,29
Vienna,9500,5,8,5,11,32,39,-7,29
Mattersburg,9500,6,5,8,11,31,45,-14,23
SC Rheindorf,9500,7,4,8,12,19,30,-11,20
FC Salzburg,9501,1,15,7,2,45,16,29,52
Rapid Vienna,9501,2,10,10,4,36,23,13,40
SK Sturm Gra,9501,3,12,3,9,33,33,0,39
LASK Linz,9501,4,8,5,11,25,30,-5,29
Mattersburg,9501,5,7,5,12,31,39,-8,26
SC Rheindorf,9501,6,6,5,13,19,30,-11,23
Vienna,9501,7,6,5,13,23,41,-18,23
FC Salzburg,9502,1,13,7,4,44,23,21,46
SK Sturm Gra,9502,2,12,4,8,31,29,2,40
Rapid Vienna,9502,3,9,10,5,37,29,8,37
LASK Linz,9502,4,8,6,10,30,31,-1,30
Mattersburg,9502,5,7,7,10,35,41,-6,28
Vienna,9502,6,7,5,12,29,43,-14,26
SC Rheindorf,9502,7,4,9,11,19,29,-10,21
FC Salzburg,9503,1,16,6,2,49,16,33,54
SK Sturm Gra,9503,2,14,3,7,35,30,5,45
Rapid Vienna,9503,3,7,11,6,34,31,3,32
LASK Linz,9503,4,7,6,11,27,31,-4,27
Vienna,9503,5,7,5,12,25,38,-13,26
Mattersburg,9503,6,6,6,12,30,44,-14,24
SC Rheindorf,9503,7,5,7,12,18,28,-10,22
FC Salzburg,9504,1,12,9,3,42,21,21,45
SK Sturm Gra,9504,2,12,4,8,32,27,5,40
Rapid Vienna,9504,3,8,11,5,35,28,7,35
LASK Linz,9504,4,8,7,9,27,28,-1,31
Vienna,9504,5,7,6,11,27,39,-12,27
Mattersburg,9504,6,6,7,11,33,44,-11,25
SC Rheindorf,9504,7,5,8,11,20,29,-9,23
FC Salzburg,9505,1,14,6,4,44,20,24,48
SK Sturm Gra,9505,2,13,4,7,31,26,5,43
Rapid Vienna,9505,3,9,9,6,35,28,7,36
LASK Linz,9505,4,9,6,9,27,27,0,33
Vienna,9505,5,7,5,12,26,39,-13,26
Mattersburg,9505,6,6,5,13,28,44,-16,23
SC Rheindorf,9505,7,5,7,12,19,26,-7,22
FC Salzburg,9506,1,14,8,2,45,18,27,50
SK Sturm Gra,9506,2,12,6,6,31,26,5,42
Rapid Vienna,9506,3,9,10,5,40,28,12,37
LASK Linz,9506,4,7,6,11,23,29,-6,27
Vienna,9506,5,7,5,12,26,41,-15,26
Mattersburg,9506,6,6,6,12,31,43,-12,24
SC Rheindorf,9506,7,5,7,12,18,29,-11,22
FC Salzburg,9507,1,13,7,4,43,18,25,46
SK Sturm Gra,9507,2,13,5,6,35,27,8,44
Rapid Vienna,9507,3,10,9,5,37,27,10,39
LASK Linz,9507,4,8,6,10,29,31,-2,30
Mattersburg,9507,5,7,5,12,32,45,-13,26
Vienna,9507,6,6,6,12,24,39,-15,24
SC Rheindorf,9507,7,5,6,13,18,31,-13,21
FC Salzburg,9508,1,13,8,3,43,19,24,47
SK Sturm Gra,9508,2,13,4,7,31,26,5,43
Rapid Vienna,9508,3,7,11,6,33,28,5,32
LASK Linz,9508,4,8,8,8,30,30,0,32
Mattersburg,9508,5,7,6,11,35,44,-9,27
Vienna,9508,6,6,6,12,24,40,-16,24
SC Rheindorf,9508,7,5,7,12,20,29,-9,22
FC Salzburg,9509,1,15,6,3,48,20,28,51
SK Sturm Gra,9509,2,12,3,9,30,33,-3,39
Rapid Vienna,9509,3,9,9,6,35,26,9,36
LASK Linz,9509,4,8,7,9,26,27,-1,31
Vienna,9509,5,7,6,11,27,39,-12,27
Mattersburg,9509,6,5,8,11,29,42,-13,23
SC Rheindorf,9509,7,5,7,12,20,28,-8,22
FC Salzburg,9510,1,15,7,2,44,18,26,52
Rapid Vienna,9510,2,10,9,5,38,26,12,39
SK Sturm Gra,9510,3,12,3,9,34,30,4,39
LASK Linz,9510,4,10,5,9,28,26,2,35
Mattersburg,9510,5,7,6,11,31,40,-9,27
Vienna,9510,6,6,5,13,24,40,-16,23
SC Rheindorf,9510,7,4,5,15,18,37,-19,17
FC Salzburg,9511,1,14,7,3,46,21,25,49
Rapid Vienna,9511,2,9,10,5,37,29,8,37
SK Sturm Gra,9511,3,11,3,10,32,34,-2,36
LASK Linz,9511,4,8,7,9,30,31,-1,31
Vienna,9511,5,8,5,11,28,38,-10,29
Mattersburg,9511,6,6,7,11,33,43,-10,25
SC Rheindorf,9511,7,6,5,13,21,31,-10,23
FC Salzburg,9512,1,15,6,3,46,24,22,51
SK Sturm Gra,9512,2,13,4,7,37,30,7,43
Rapid Vienna,9512,3,8,10,6,38,28,10,34
LASK Linz,9512,4,9,6,9,29,26,3,33
Vienna,9512,5,7,5,12,28,41,-13,26
SC Rheindorf,9512,6,6,6,12,25,34,-9,24
Mattersburg,9512,7,5,5,14,30,50,-20,20
FC Salzburg,9513,1,14,7,3,44,19,25,49
SK Sturm Gra,9513,2,13,3,8,31,27,4,42
LASK Linz,9513,3,10,5,9,28,29,-1,35
Rapid Vienna,9513,4,8,10,6,36,27,9,34
Vienna,9513,5,7,5,12,25,40,-15,26
SC Rheindorf,9513,6,6,6,12,21,29,-8,24
Mattersburg,9513,7,5,6,13,30,44,-14,21
FC Salzburg,9514,1,14,7,3,45,18,27,49
SK Sturm Gra,9514,2,11,5,8,31,30,1,38
Rapid Vienna,9514,3,8,9,7,35,33,2,33
LASK Linz,9514,4,8,6,10,27,32,-5,30
SC Rheindorf,9514,5,8,5,11,27,26,1,29
Mattersburg,9514,6,7,6,11,32,42,-10,27
Vienna,9514,7,6,6,12,24,40,-16,24
FC Salzburg,9515,1,13,8,3,43,18,25,47
SK Sturm Gra,9515,2,13,4,7,33,26,7,43
Rapid Vienna,9515,3,8,10,6,33,26,7,34
LASK Linz,9515,4,9,5,10,25,29,-4,32
Mattersburg,9515,5,7,6,11,30,40,-10,27
Vienna,9515,6,6,7,11,25,39,-14,25
SC Rheindorf,9515,7,5,6,13,17,28,-11,21
FC Salzburg,9516,1,15,6,3,46,21,25,51
SK Sturm Gra,9516,2,13,3,8,34,31,3,42
Rapid Vienna,9516,3,8,9,7,35,28,7,33
LASK Linz,9516,4,9,6,9,28,27,1,33
Vienna,9516,5,7,5,12,26,40,-14,26
SC Rheindorf,9516,6,6,6,12,19,26,-7,24
Mattersburg,9516,7,6,5,13,30,45,-15,23
FC Salzburg,9517,1,14,7,3,47,19,28,49
SK Sturm Gra,9517,2,12,3,9,32,33,-1,39
Rapid Vienna,9517,3,8,12,4,39,29,10,36
LASK Linz,9517,4,7,7,10,25,28,-3,28
Mattersburg,9517,5,7,5,12,30,40,-10,26
Vienna,9517,6,7,5,12,25,41,-16,26
SC Rheindorf,9517,7,6,7,11,18,26,-8,25
FC Salzburg,9518,1,15,7,2,45,16,29,52
SK Sturm Gra,9518,2,13,4,7,34,27,7,43
LASK Linz,9518,3,10,6,8,28,26,2,36
Rapid Vienna,9518,4,7,11,6,32,29,3,32
Vienna,9518,5,6,6,12,25,42,-17,24
SC Rheindorf,9518,6,5,6,13,18,29,-11,21
Mattersburg,9518,7,5,6,13,28,41,-13,21
FC Salzburg,9519,1,15,7,2,50,16,34,52
SK Sturm Gra,9519,2,12,5,7,34,30,4,41
Rapid Vienna,9519,3,8,10,6,35,28,7,34
LASK Linz,9519,4,9,5,10,27,27,0,32
SC Rheindorf,9519,5,7,5,12,23,32,-9,26
Vienna,9519,6,6,6,12,24,41,-17,24
Mattersburg,9519,7,5,6,13,29,48,-19,21
FC Salzburg,9520,1,15,6,3,46,17,29,51
SK Sturm Gra,9520,2,12,4,8,30,29,1,40
Rapid Vienna,9520,3,9,11,4,38,27,11,38
LASK Linz,9520,4,9,6,9,30,28,2,33
Vienna,9520,5,7,5,12,24,41,-17,26
Mattersburg,9520,6,6,5,13,27,41,-14,23
SC Rheindorf,9520,7,4,7,13,17,29,-12,19
FC Salzburg,9521,1,14,7,3,43,16,27,49
SK Sturm Gra,9521,2,12,4,8,36,30,6,40
Rapid Vienna,9521,3,9,10,5,33,27,6,37
LASK Linz,9521,4,9,5,10,28,29,-1,32
Mattersburg,9521,5,7,6,11,32,43,-11,27
Vienna,9521,6,6,5,13,23,40,-17,23
SC Rheindorf,9521,7,5,7,12,20,30,-10,22
FC Salzburg,9522,1,12,8,4,44,25,19,44
SK Sturm Gra,9522,2,13,5,6,36,30,6,44
Rapid Vienna,9522,3,9,10,5,42,32,10,37
LASK Linz,9522,4,7,7,10,30,34,-4,28
Mattersburg,9522,5,7,7,10,35,41,-6,28
Vienna,9522,6,7,6,11,30,41,-11,27
SC Rheindorf,9522,7,4,7,13,19,33,-14,19
FC Salzburg,9523,1,14,8,2,45,19,26,50
SK Sturm Gra,9523,2,12,5,7,34,28,6,41
Rapid Vienna,9523,3,8,10,6,37,31,6,34
LASK Linz,9523,4,8,5,11,27,32,-5,29
Mattersburg,9523,5,7,7,10,30,38,-8,28
Vienna,9523,6,6,6,12,25,40,-15,24
SC Rheindorf,9523,7,5,7,12,19,29,-10,22
FC Salzburg,9524,1,14,8,2,48,18,30,50
SK Sturm Gra,9524,2,12,6,6,34,26,8,42
Rapid Vienna,9524,3,8,10,6,34,27,7,34
Mattersburg,9524,4,8,5,11,32,43,-11,29
LASK Linz,9524,5,7,6,11,25,30,-5,27
Vienna,9524,6,6,6,12,27,43,-16,24
SC Rheindorf,9524,7,6,5,13,19,32,-13,23
FC Salzburg,9525,1,14,7,3,48,19,29,49
SK Sturm Gra,9525,2,13,5,6,36,27,9,44
Rapid Vienna,9525,3,7,10,7,31,30,1,31
LASK Linz,9525,4,8,5,11,27,31,-4,29
Vienna,9525,5,8,5,11,29,40,-11,29
Mattersburg,9525,6,7,5,12,32,46,-14,26
SC Rheindorf,9525,7,5,7,12,16,26,-10,22
FC Salzburg,9526,1,13,8,3,42,19,23,47
SK Sturm Gra,9526,2,14,3,7,39,29,10,45
Rapid Vienna,9526,3,8,11,5,39,31,8,35
Mattersburg,9526,4,9,5,10,33,39,-6,32
LASK Linz,9526,5,7,6,11,27,33,-6,27
Vienna,9526,6,6,6,12,24,39,-15,24
SC Rheindorf,9526,7,4,7,13,19,33,-14,19
FC Salzburg,9527,1,14,6,4,48,22,26,48
SK Sturm Gra,9527,2,12,4,8,35,33,2,40
Rapid Vienna,9527,3,10,9,5,37,26,11,39
LASK Linz,9527,4,9,5,10,28,28,0,32
Mattersburg,9527,5,7,6,11,30,42,-12,27
Vienna,9527,6,6,5,13,24,41,-17,23
SC Rheindorf,9527,7,5,7,12,23,33,-10,22
FC Salzburg,9528,1,14,6,4,43,20,23,48
SK Sturm Gra,9528,2,15,3,6,35,25,10,48
Rapid Vienna,9528,3,8,9,7,34,27,7,33
Vienna,9528,4,8,5,11,27,38,-11,29
LASK Linz,9528,5,7,6,11,23,29,-6,27
Mattersburg,9528,6,7,5,12,29,40,-11,26
SC Rheindorf,9528,7,5,6,13,17,29,-12,21
FC Salzburg,9529,1,15,6,3,45,17,28,51
SK Sturm Gra,9529,2,13,4,7,34,27,7,43
Rapid Vienna,9529,3,7,11,6,34,33,1,32
LASK Linz,9529,4,8,6,10,32,33,-1,30
Vienna,9529,5,7,5,12,26,40,-14,26
Mattersburg,9529,6,6,7,11,34,44,-10,25
SC Rheindorf,9529,7,5,7,12,17,28,-11,22
FC Salzburg,9530,1,14,7,3,44,17,27,49
SK Sturm Gra,9530,2,11,4,9,30,34,-4,37
Rapid Vienna,9530,3,7,13,4,36,28,8,34
LASK Linz,9530,4,8,6,10,31,31,0,30
Mattersburg,9530,5,8,6,10,30,36,-6,30
SC Rheindorf,9530,6,6,7,11,22,28,-6,25
Vienna,9530,7,6,5,13,23,42,-19,23
FC Salzburg,9531,1,14,6,4,45,20,25,48
SK Sturm Gra,9531,2,13,3,8,34,28,6,42
Rapid Vienna,9531,3,9,10,5,36,28,8,37
LASK Linz,9531,4,8,7,9,29,30,-1,31
Vienna,9531,5,8,5,11,28,38,-10,29
Mattersburg,9531,6,5,7,12,30,46,-16,22
SC Rheindorf,9531,7,5,6,13,21,33,-12,21
FC Salzburg,9532,1,14,7,3,45,20,25,49
SK Sturm Gra,9532,2,12,5,7,31,27,4,41
Rapid Vienna,9532,3,8,10,6,35,27,8,34
LASK Linz,9532,4,9,6,9,28,30,-2,33
Vienna,9532,5,8,5,11,29,41,-12,29
Mattersburg,9532,6,7,6,11,34,41,-7,27
SC Rheindorf,9532,7,4,5,15,17,33,-16,17
FC Salzburg,9533,1,15,7,2,44,17,27,52
LASK Linz,9533,2,11,5,8,32,28,4,38
SK Sturm Gra,9533,3,11,5,8,30,29,1,38
Rapid Vienna,9533,4,8,10,6,37,28,9,34
Vienna,9533,5,6,6,12,24,39,-15,24
Mattersburg,9533,6,5,7,12,30,43,-13,22
SC Rheindorf,9533,7,5,6,13,20,33,-13,21
FC Salzburg,9534,1,16,6,2,44,15,29,54
SK Sturm Gra,9534,2,12,3,9,31,30,1,39
Rapid Vienna,9534,3,9,9,6,35,25,10,36
LASK Linz,9534,4,8,5,11,26,31,-5,29
Mattersburg,9534,5,7,6,11,29,38,-9,27
Vienna,9534,6,6,6,12,23,39,-16,24
SC Rheindorf,9534,7,6,5,13,20,30,-10,23
FC Salzburg,9535,1,14,6,4,46,19,27,48
SK Sturm Gra,9535,2,12,5,7,35,29,6,41
LASK Linz,9535,3,9,7,8,30,29,1,34
Rapid Vienna,9535,4,8,9,7,32,30,2,33
Mattersburg,9535,5,7,5,12,32,44,-12,26
Vienna,9535,6,7,5,12,25,39,-14,26
SC Rheindorf,9535,7,5,7,12,21,31,-10,22
FC Salzburg,9536,1,15,6,3,43,16,27,51
SK Sturm Gra,9536,2,13,3,8,30,27,3,42
Rapid Vienna,9536,3,9,10,5,33,24,9,37
LASK Linz,9536,4,9,5,10,28,27,1,32
Mattersburg,9536,5,7,5,12,33,43,-10,26
Vienna,9536,6,6,5,13,25,41,-16,23
SC Rheindorf,9536,7,5,6,13,17,31,-14,21
FC Salzburg,9537,1,15,7,2,47,19,28,52
SK Sturm Gra,9537,2,12,5,7,31,26,5,41
Rapid Vienna,9537,3,9,10,5,37,27,10,37
LASK Linz,9537,4,7,7,10,26,30,-4,28
Vienna,9537,5,7,6,11,27,40,-13,27
Mattersburg,9537,6,6,5,13,33,45,-12,23
SC Rheindorf,9537,7,5,6,13,16,30,-14,21
FC Salzburg,9538,1,13,7,4,44,23,21,46
SK Sturm Gra,9538,2,13,3,8,32,28,4,42
Rapid Vienna,9538,3,10,9,5,40,28,12,39
LASK Linz,9538,4,8,6,10,29,31,-2,30
Vienna,9538,5,7,5,12,27,40,-13,26
Mattersburg,9538,6,6,7,11,33,43,-10,25
SC Rheindorf,9538,7,6,5,13,19,31,-12,23
FC Salzburg,9539,1,14,6,4,41,20,21,48
SK Sturm Gra,9539,2,12,5,7,33,28,5,41
Rapid Vienna,9539,3,9,10,5,36,25,11,37
LASK Linz,9539,4,7,8,9,26,28,-2,29
Vienna,9539,5,8,5,11,27,37,-10,29
SC Rheindorf,9539,6,5,7,12,18,29,-11,22
Mattersburg,9539,7,5,7,12,28,42,-14,22
FC Salzburg,9540,1,13,7,4,42,21,21,46
SK Sturm Gra,9540,2,13,4,7,33,29,4,43
Rapid Vienna,9540,3,8,12,4,34,25,9,36
LASK Linz,9540,4,8,6,10,29,31,-2,30
Mattersburg,9540,5,8,5,11,35,42,-7,29
Vienna,9540,6,8,5,11,31,40,-9,29
SC Rheindorf,9540,7,4,5,15,17,33,-16,17
FC Salzburg,9541,1,14,6,4,43,18,25,48
SK Sturm Gra,9541,2,12,5,7,30,27,3,41
LASK Linz,9541,3,10,6,8,30,24,6,36
Rapid Vienna,9541,4,7,9,8,31,29,2,30
Vienna,9541,5,8,5,11,30,40,-10,29
SC Rheindorf,9541,6,6,6,12,18,27,-9,24
Mattersburg,9541,7,6,5,13,29,46,-17,23
FC Salzburg,9542,1,14,6,4,43,20,23,48
SK Sturm Gra,9542,2,13,4,7,36,30,6,43
Rapid Vienna,9542,3,9,10,5,37,29,8,37
LASK Linz,9542,4,8,6,10,28,30,-2,30
Mattersburg,9542,5,8,5,11,33,39,-6,29
Vienna,9542,6,6,5,13,24,40,-16,23
SC Rheindorf,9542,7,5,6,13,18,31,-13,21
FC Salzburg,9543,1,15,7,2,48,18,30,52
SK Sturm Gra,9543,2,13,4,7,37,27,10,43
Rapid Vienna,9543,3,8,10,6,38,31,7,34
LASK Linz,9543,4,8,6,10,28,34,-6,30
Vienna,9543,5,7,5,12,26,39,-13,26
SC Rheindorf,9543,6,6,6,12,19,29,-10,24
Mattersburg,9543,7,5,6,13,29,47,-18,21
FC Salzburg,9544,1,15,7,2,45,17,28,52
SK Sturm Gra,9544,2,12,4,8,33,29,4,40
Rapid Vienna,9544,3,10,9,5,36,27,9,39
LASK Linz,9544,4,8,5,11,24,29,-5,29
Mattersburg,9544,5,6,6,12,30,41,-11,24
Vienna,9544,6,6,6,12,24,39,-15,24
SC Rheindorf,9544,7,5,7,12,20,30,-10,22
FC Salzburg,9545,1,14,8,2,45,18,27,50
Rapid Vienna,9545,2,10,10,4,44,26,18,40
SK Sturm Gra,9545,3,11,4,9,30,33,-3,37
LASK Linz,9545,4,8,5,11,27,30,-3,29
Mattersburg,9545,5,6,7,11,31,41,-10,25
SC Rheindorf,9545,6,6,6,12,21,33,-12,24
Vienna,9545,7,6,6,12,23,40,-17,24
FC Salzburg,9546,1,13,8,3,44,18,26,47
Rapid Vienna,9546,2,9,11,4,35,24,11,38
SK Sturm Gra,9546,3,11,4,9,29,31,-2,37
LASK Linz,9546,4,9,7,8,30,26,4,34
Vienna,9546,5,6,7,11,24,38,-14,25
SC Rheindorf,9546,6,5,8,11,18,26,-8,23
Mattersburg,9546,7,5,7,12,27,44,-17,22
FC Salzburg,9547,1,13,8,3,42,18,24,47
Rapid Vienna,9547,2,9,11,4,36,26,10,38
SK Sturm Gra,9547,3,11,5,8,31,30,1,38
LASK Linz,9547,4,8,7,9,27,28,-1,31
Mattersburg,9547,5,7,7,10,34,41,-7,28
Vienna,9547,6,6,6,12,24,40,-16,24
SC Rheindorf,9547,7,5,6,13,18,29,-11,21
FC Salzburg,9548,1,14,8,2,45,19,26,50
SK Sturm Gra,9548,2,13,4,7,37,32,5,43
LASK Linz,9548,3,9,6,9,28,27,1,33
Rapid Vienna,9548,4,7,11,6,36,30,6,32
Vienna,9548,5,7,6,11,26,38,-12,27
SC Rheindorf,9548,6,6,6,12,20,29,-9,24
Mattersburg,9548,7,5,5,14,26,43,-17,20
FC Salzburg,9549,1,13,7,4,43,21,22,46
SK Sturm Gra,9549,2,14,4,6,34,27,7,46
Rapid Vienna,9549,3,8,12,4,37,28,9,36
LASK Linz,9549,4,8,6,10,27,30,-3,30
Vienna,9549,5,7,5,12,26,43,-17,26
Mattersburg,9549,6,6,6,12,32,40,-8,24
SC Rheindorf,9549,7,5,6,13,19,29,-10,21
FC Salzburg,9550,1,14,7,3,46,19,27,49
SK Sturm Gra,9550,2,12,5,7,32,28,4,41
Rapid Vienna,9550,3,8,12,4,36,27,9,36
LASK Linz,9550,4,8,6,10,28,32,-4,30
Vienna,9550,5,7,5,12,27,42,-15,26
Mattersburg,9550,6,6,6,12,30,41,-11,24
SC Rheindorf,9550,7,4,9,11,16,26,-10,21
FC Salzburg,9551,1,14,7,3,41,19,22,49
Rapid Vienna,9551,2,10,9,5,39,26,13,39
SK Sturm Gra,9551,3,12,3,9,31,31,0,39
LASK Linz,9551,4,10,5,9,33,30,3,35
Mattersburg,9551,5,6,6,12,30,41,-11,24
SC Rheindorf,9551,6,6,5,13,19,30,-11,23
Vienna,9551,7,6,5,13,23,39,-16,23
FC Salzburg,9552,1,15,6,3,45,18,27,51
Rapid Vienna,9552,2,10,10,4,39,26,13,40
SK Sturm Gra,9552,3,11,4,9,32,31,1,37
LASK Linz,9552,4,7,6,11,28,35,-7,27
SC Rheindorf,9552,5,6,7,11,23,30,-7,25
Mattersburg,9552,6,6,7,11,33,44,-11,25
Vienna,9552,7,6,6,12,26,42,-16,24
FC Salzburg,9553,1,15,6,3,46,19,27,51
SK Sturm Gra,9553,2,13,4,7,33,28,5,43
Rapid Vienna,9553,3,8,9,7,34,30,4,33
LASK Linz,9553,4,8,7,9,26,27,-1,31
Mattersburg,9553,5,8,5,11,35,42,-7,29
Vienna,9553,6,6,5,13,26,44,-18,23
SC Rheindorf,9553,7,5,6,13,21,31,-10,21
FC Salzburg,9554,1,14,7,3,45,21,24,49
SK Sturm Gra,9554,2,13,5,6,36,29,7,44
Rapid Vienna,9554,3,8,10,6,36,31,5,34
LASK Linz,9554,4,9,5,10,29,28,1,32
Vienna,9554,5,7,6,11,26,38,-12,27
Mattersburg,9554,6,6,7,11,30,40,-10,25
SC Rheindorf,9554,7,4,6,14,17,32,-15,18
FC Salzburg,9555,1,14,6,4,47,18,29,48
SK Sturm Gra,9555,2,12,4,8,33,29,4,40
Rapid Vienna,9555,3,10,9,5,36,26,10,39
LASK Linz,9555,4,10,5,9,29,29,0,35
Vienna,9555,5,8,5,11,25,37,-12,29
Mattersburg,9555,6,6,5,13,31,46,-15,23
SC Rheindorf,9555,7,4,6,14,18,34,-16,18
FC Salzburg,9556,1,15,6,3,44,19,25,51
SK Sturm Gra,9556,2,13,3,8,35,26,9,42
Rapid Vienna,9556,3,9,9,6,38,30,8,36
LASK Linz,9556,4,8,5,11,30,36,-6,29
Mattersburg,9556,5,7,5,12,32,42,-10,26
Vienna,9556,6,7,5,12,25,40,-15,26
SC Rheindorf,9556,7,6,5,13,19,30,-11,23
FC Salzburg,9557,1,16,6,2,51,18,33,54
SK Sturm Gra,9557,2,11,5,8,35,36,-1,38
Rapid Vienna,9557,3,7,11,6,34,31,3,32
LASK Linz,9557,4,8,8,8,31,30,1,32
SC Rheindorf,9557,5,7,5,12,22,29,-7,26
Vienna,9557,6,6,6,12,23,40,-17,24
Mattersburg,9557,7,5,7,12,29,41,-12,22
FC Salzburg,9558,1,14,7,3,45,18,27,49
SK Sturm Gra,9558,2,13,4,7,33,30,3,43
Rapid Vienna,9558,3,8,10,6,36,29,7,34
LASK Linz,9558,4,9,6,9,29,29,0,33
Mattersburg,9558,5,8,6,10,32,39,-7,30
Vienna,9558,6,6,6,12,25,40,-15,24
SC Rheindorf,9558,7,4,5,15,16,31,-15,17
FC Salzburg,9559,1,15,7,2,47,16,31,52
SK Sturm Gra,9559,2,12,4,8,29,31,-2,40
LASK Linz,9559,3,9,6,9,27,25,2,33
Rapid Vienna,9559,4,7,10,7,32,29,3,31
SC Rheindorf,9559,5,7,6,11,22,25,-3,27
Vienna,9559,6,7,5,12,26,39,-13,26
Mattersburg,9559,7,5,6,13,26,44,-18,21
FC Salzburg,9560,1,14,7,3,44,19,25,49
SK Sturm Gra,9560,2,12,5,7,30,28,2,41
LASK Linz,9560,3,9,6,9,31,27,4,33
Rapid Vienna,9560,4,7,11,6,37,31,6,32
Mattersburg,9560,5,7,5,12,30,43,-13,26
Vienna,9560,6,7,5,12,25,39,-14,26
SC Rheindorf,9560,7,5,7,12,20,30,-10,22
FC Salzburg,9561,1,14,6,4,44,25,19,48
SK Sturm Gra,9561,2,13,5,6,33,25,8,44
Rapid Vienna,9561,3,9,10,5,36,25,11,37
Mattersburg,9561,4,8,5,11,33,40,-7,29
LASK Linz,9561,5,7,6,11,25,30,-5,27
Vienna,9561,6,7,5,12,28,41,-13,26
SC Rheindorf,9561,7,5,5,14,17,30,-13,20
FC Salzburg,9562,1,15,6,3,43,16,27,51
SK Sturm Gra,9562,2,12,3,9,31,29,2,39
Rapid Vienna,9562,3,9,9,6,35,28,7,36
LASK Linz,9562,4,8,7,9,30,30,0,31
Vienna,9562,5,7,5,12,25,40,-15,26
SC Rheindorf,9562,6,6,6,12,19,29,-10,24
Mattersburg,9562,7,6,6,12,31,42,-11,24
FC Salzburg,9563,1,13,9,2,44,19,25,48
SK Sturm Gra,9563,2,12,4,8,31,29,2,40
Rapid Vienna,9563,3,9,10,5,37,28,9,37
LASK Linz,9563,4,7,6,11,23,30,-7,27
Mattersburg,9563,5,7,6,11,30,38,-8,27
SC Rheindorf,9563,6,7,5,12,23,28,-5,26
Vienna,9563,7,6,6,12,24,40,-16,24
FC Salzburg,9564,1,15,6,3,43,18,25,51
SK Sturm Gra,9564,2,12,4,8,34,31,3,40
Rapid Vienna,9564,3,9,9,6,36,28,8,36
LASK Linz,9564,4,9,6,9,30,31,-1,33
Mattersburg,9564,5,7,5,12,34,44,-10,26
SC Rheindorf,9564,6,6,5,13,21,30,-9,23
Vienna,9564,7,6,5,13,27,43,-16,23
FC Salzburg,9565,1,14,7,3,42,20,22,49
SK Sturm Gra,9565,2,12,4,8,32,29,3,40
Rapid Vienna,9565,3,8,10,6,35,27,8,34
LASK Linz,9565,4,8,8,8,27,26,1,32
Vienna,9565,5,7,5,12,25,39,-14,26
SC Rheindorf,9565,6,6,6,12,20,29,-9,24
Mattersburg,9565,7,6,6,12,30,41,-11,24
FC Salzburg,9566,1,13,7,4,42,19,23,46
SK Sturm Gra,9566,2,12,5,7,34,30,4,41
Rapid Vienna,9566,3,7,11,6,33,30,3,32
LASK Linz,9566,4,8,7,9,30,31,-1,31
Vienna,9566,5,8,5,11,27,38,-11,29
Mattersburg,9566,6,7,5,12,31,40,-9,26
SC Rheindorf,9566,7,5,8,11,20,29,-9,23
FC Salzburg,9567,1,14,8,2,44,18,26,50
SK Sturm Gra,9567,2,12,6,6,32,27,5,42
Rapid Vienna,9567,3,8,10,6,39,32,7,34
LASK Linz,9567,4,8,6,10,27,29,-2,30
Vienna,9567,5,7,6,11,28,39,-11,27
SC Rheindorf,9567,6,6,6,12,20,30,-10,24
Mattersburg,9567,7,5,6,13,29,44,-15,21
FC Salzburg,9568,1,14,6,4,45,18,27,48
SK Sturm Gra,9568,2,15,3,6,38,25,13,48
Rapid Vienna,9568,3,9,9,6,35,30,5,36
LASK Linz,9568,4,8,5,11,25,30,-5,29
Vienna,9568,5,7,6,11,26,39,-13,27
Mattersburg,9568,6,6,7,11,32,43,-11,25
SC Rheindorf,9568,7,4,6,14,16,32,-16,18
FC Salzburg,9569,1,15,7,2,46,15,31,52
SK Sturm Gra,9569,2,12,5,7,32,30,2,41
Rapid Vienna,9569,3,8,11,5,35,26,9,35
LASK Linz,9569,4,9,5,10,28,31,-3,32
Mattersburg,9569,5,8,5,11,33,39,-6,29
Vienna,9569,6,6,5,13,24,43,-19,23
SC Rheindorf,9569,7,4,6,14,17,31,-14,18
FC Salzburg,9570,1,14,7,3,44,18,26,49
SK Sturm Gra,9570,2,12,4,8,33,32,1,40
Rapid Vienna,9570,3,8,11,5,34,26,8,35
LASK Linz,9570,4,10,5,9,29,28,1,35
Vienna,9570,5,7,5,12,26,41,-15,26
Mattersburg,9570,6,6,6,12,29,41,-12,24
SC Rheindorf,9570,7,5,6,13,21,30,-9,21
FC Salzburg,9571,1,13,7,4,41,20,21,46
SK Sturm Gra,9571,2,12,6,6,33,27,6,42
Rapid Vienna,9571,3,8,10,6,37,32,5,34
LASK Linz,9571,4,9,5,10,29,29,0,32
Vienna,9571,5,8,5,11,28,37,-9,29
Mattersburg,9571,6,7,5,12,31,44,-13,26
SC Rheindorf,9571,7,5,6,13,20,30,-10,21
FC Salzburg,9572,1,15,6,3,46,18,28,51
SK Sturm Gra,9572,2,12,4,8,30,28,2,40
Rapid Vienna,9572,3,9,9,6,34,27,7,36
LASK Linz,9572,4,9,5,10,28,30,-2,32
Vienna,9572,5,7,6,11,26,39,-13,27
Mattersburg,9572,6,6,6,12,31,43,-12,24
SC Rheindorf,9572,7,5,6,13,18,28,-10,21
FC Salzburg,9573,1,16,6,2,47,16,31,54
SK Sturm Gra,9573,2,12,4,8,34,32,2,40
Rapid Vienna,9573,3,9,9,6,37,29,8,36
LASK Linz,9573,4,9,6,9,30,29,1,33
Vienna,9573,5,7,5,12,28,41,-13,26
Mattersburg,9573,6,6,6,12,33,44,-11,24
SC Rheindorf,9573,7,4,6,14,20,38,-18,18
FC Salzburg,9574,1,15,7,2,46,17,29,52
SK Sturm Gra,9574,2,12,4,8,30,27,3,40
Rapid Vienna,9574,3,9,9,6,37,27,10,36
LASK Linz,9574,4,10,5,9,29,29,0,35
Vienna,9574,5,7,5,12,27,43,-16,26
Mattersburg,9574,6,5,7,12,30,43,-13,22
SC Rheindorf,9574,7,4,7,13,17,30,-13,19
FC Salzburg,9575,1,14,7,3,46,21,25,49
SK Sturm Gra,9575,2,13,4,7,35,29,6,43
Rapid Vienna,9575,3,9,10,5,37,27,10,37
LASK Linz,9575,4,9,6,9,31,31,0,33
Vienna,9575,5,6,6,12,25,40,-15,24
Mattersburg,9575,6,6,5,13,31,43,-12,23
SC Rheindorf,9575,7,5,6,13,18,32,-14,21
FC Salzburg,9576,1,13,9,2,47,20,27,48
SK Sturm Gra,9576,2,12,4,8,34,33,1,40
Rapid Vienna,9576,3,10,9,5,39,29,10,39
LASK Linz,9576,4,8,5,11,28,30,-2,29
Mattersburg,9576,5,7,7,10,30,37,-7,28
Vienna,9576,6,6,6,12,24,40,-16,24
SC Rheindorf,9576,7,5,6,13,19,32,-13,21
FC Salzburg,9577,1,13,8,3,43,17,26,47
SK Sturm Gra,9577,2,13,4,7,33,26,7,43
Rapid Vienna,9577,3,8,12,4,35,26,9,36
LASK Linz,9577,4,7,7,10,24,28,-4,28
Mattersburg,9577,5,7,7,10,30,37,-7,28
Vienna,9577,6,6,6,12,24,42,-18,24
SC Rheindorf,9577,7,5,6,13,18,31,-13,21
FC Salzburg,9578,1,15,7,2,48,15,33,52
SK Sturm Gra,9578,2,13,4,7,34,29,5,43
Rapid Vienna,9578,3,9,9,6,36,31,5,36
LASK Linz,9578,4,7,7,10,26,30,-4,28
Mattersburg,9578,5,6,6,12,28,43,-15,24
Vienna,9578,6,6,6,12,24,39,-15,24
SC Rheindorf,9578,7,6,5,13,21,30,-9,23
FC Salzburg,9579,1,16,6,2,50,18,32,54
Rapid Vienna,9579,2,9,9,6,37,27,10,36
SK Sturm Gra,9579,3,11,3,10,28,37,-9,36
LASK Linz,9579,4,8,5,11,28,34,-6,29
SC Rheindorf,9579,5,7,6,11,21,26,-5,27
Vienna,9579,6,7,5,12,27,40,-13,26
Mattersburg,9579,7,6,6,12,35,44,-9,24
FC Salzburg,9580,1,15,6,3,47,20,27,51
SK Sturm Gra,9580,2,12,4,8,32,30,2,40
Rapid Vienna,9580,3,8,10,6,35,29,6,34
LASK Linz,9580,4,9,7,8,29,26,3,34
Vienna,9580,5,7,6,11,25,38,-13,27
SC Rheindorf,9580,6,5,7,12,20,29,-9,22
Mattersburg,9580,7,5,6,13,28,44,-16,21
FC Salzburg,9581,1,16,6,2,49,15,34,54
SK Sturm Gra,9581,2,12,4,8,31,28,3,40
Rapid Vienna,9581,3,7,12,5,34,30,4,33
LASK Linz,9581,4,9,6,9,27,26,1,33
Mattersburg,9581,5,7,5,12,29,41,-12,26
Vienna,9581,6,6,5,13,24,42,-18,23
SC Rheindorf,9581,7,5,6,13,17,29,-12,21
FC Salzburg,9582,1,14,7,3,46,22,24,49
SK Sturm Gra,9582,2,12,5,7,33,28,5,41
Rapid Vienna,9582,3,8,9,7,34,29,5,33
LASK Linz,9582,4,9,6,9,26,27,-1,33
Vienna,9582,5,7,5,12,26,39,-13,26
Mattersburg,9582,6,6,7,11,33,43,-10,25
SC Rheindorf,9582,7,5,7,12,19,29,-10,22
FC Salzburg,9583,1,13,8,3,41,20,21,47
SK Sturm Gra,9583,2,12,4,8,31,28,3,40
Rapid Vienna,9583,3,8,10,6,37,28,9,34
LASK Linz,9583,4,9,6,9,28,28,0,33
Mattersburg,9583,5,8,6,10,36,41,-5,30
Vienna,9583,6,6,6,12,24,40,-16,24
SC Rheindorf,9583,7,4,8,12,17,29,-12,20
FC Salzburg,9584,1,16,6,2,43,16,27,54
SK Sturm Gra,9584,2,12,5,7,34,29,5,41
Rapid Vienna,9584,3,7,10,7,34,31,3,31
LASK Linz,9584,4,7,9,8,28,29,-1,30
Mattersburg,9584,5,7,6,11,32,38,-6,27
Vienna,9584,6,6,5,13,23,40,-17,23
SC Rheindorf,9584,7,5,7,12,21,32,-11,22
FC Salzburg,9585,1,15,7,2,46,19,27,52
SK Sturm Gra,9585,2,12,4,8,31,30,1,40
Rapid Vienna,9585,3,8,11,5,37,29,8,35
LASK Linz,9585,4,8,6,10,26,28,-2,30
SC Rheindorf,9585,5,7,5,12,25,29,-4,26
Vienna,9585,6,7,5,12,30,42,-12,26
Mattersburg,9585,7,5,6,13,31,49,-18,21
FC Salzburg,9586,1,15,6,3,46,20,26,51
SK Sturm Gra,9586,2,12,4,8,32,29,3,40
Rapid Vienna,9586,3,8,10,6,34,28,6,34
Mattersburg,9586,4,9,5,10,38,39,-1,32
LASK Linz,9586,5,9,5,10,27,30,-3,32
Vienna,9586,6,6,5,13,25,44,-19,23
SC Rheindorf,9586,7,5,5,14,18,30,-12,20
FC Salzburg,9587,1,15,7,2,46,16,30,52
SK Sturm Gra,9587,2,13,4,7,33,27,6,43
Rapid Vienna,9587,3,8,10,6,35,28,7,34
LASK Linz,9587,4,8,7,9,27,29,-2,31
Mattersburg,9587,5,6,7,11,28,40,-12,25
Vienna,9587,6,6,6,12,23,39,-16,24
SC Rheindorf,9587,7,4,7,13,17,30,-13,19
FC Salzburg,9588,1,14,7,3,46,20,26,49
SK Sturm Gra,9588,2,12,5,7,36,28,8,41
Rapid Vienna,9588,3,8,9,7,37,35,2,33
LASK Linz,9588,4,9,5,10,25,27,-2,32
Vienna,9588,5,8,5,11,27,39,-12,29
Mattersburg,9588,6,6,6,12,31,42,-11,24
SC Rheindorf,9588,7,5,7,12,21,32,-11,22
FC Salzburg,9589,1,15,7,2,47,18,29,52
SK Sturm Gra,9589,2,12,3,9,30,30,0,39
LASK Linz,9589,3,9,5,10,25,27,-2,32
Rapid Vienna,9589,4,7,10,7,35,30,5,31
Mattersburg,9589,5,8,5,11,29,38,-9,29
SC Rheindorf,9589,6,6,6,12,19,27,-8,24
Vienna,9589,7,6,6,12,24,39,-15,24
FC Salzburg,9590,1,16,6,2,52,17,35,54
SK Sturm Gra,9590,2,12,5,7,30,29,1,41
Rapid Vienna,9590,3,8,10,6,35,28,7,34
LASK Linz,9590,4,8,5,11,25,29,-4,29
Mattersburg,9590,5,7,5,12,32,42,-10,26
SC Rheindorf,9590,6,6,6,12,20,30,-10,24
Vienna,9590,7,6,5,13,25,44,-19,23
FC Salzburg,9591,1,15,7,2,43,17,26,52
SK Sturm Gra,9591,2,13,4,7,32,27,5,43
Rapid Vienna,9591,3,9,10,5,37,28,9,37
LASK Linz,9591,4,8,5,11,27,31,-4,29
Mattersburg,9591,5,6,6,12,32,43,-11,24
Vienna,9591,6,6,6,12,23,38,-15,24
SC Rheindorf,9591,7,5,6,13,23,33,-10,21
FC Salzburg,9592,1,15,7,2,47,19,28,52
SK Sturm Gra,9592,2,12,6,6,37,29,8,42
LASK Linz,9592,3,10,5,9,32,31,1,35
Rapid Vienna,9592,4,7,10,7,36,33,3,31
Vienna,9592,5,7,5,12,26,40,-14,26
Mattersburg,9592,6,6,5,13,29,44,-15,23
SC Rheindorf,9592,7,5,6,13,19,30,-11,21
FC Salzburg,9593,1,15,6,3,46,17,29,51
SK Sturm Gra,9593,2,12,4,8,32,31,1,40
Rapid Vienna,9593,3,8,10,6,35,29,6,34
LASK Linz,9593,4,9,5,10,29,31,-2,32
SC Rheindorf,9593,5,7,5,12,22,27,-5,26
Mattersburg,9593,6,7,5,12,29,40,-11,26
Vienna,9593,7,6,5,13,23,41,-18,23
FC Salzburg,9594,1,16,6,2,54,20,34,54
SK Sturm Gra,9594,2,13,4,7,33,30,3,43
Rapid Vienna,9594,3,9,9,6,36,30,6,36
LASK Linz,9594,4,7,6,11,26,31,-5,27
Vienna,9594,5,7,5,12,28,41,-13,26
Mattersburg,9594,6,6,6,12,33,47,-14,24
SC Rheindorf,9594,7,5,6,13,18,29,-11,21
FC Salzburg,9595,1,15,7,2,49,16,33,52
SK Sturm Gra,9595,2,12,5,7,34,30,4,41
Rapid Vienna,9595,3,8,10,6,35,30,5,34
LASK Linz,9595,4,7,7,10,27,30,-3,28
SC Rheindorf,9595,5,7,6,11,23,29,-6,27
Mattersburg,9595,6,6,6,12,30,46,-16,24
Vienna,9595,7,6,5,13,25,42,-17,23
FC Salzburg,9596,1,15,7,2,44,16,28,52
SK Sturm Gra,9596,2,13,3,8,33,28,5,42
Rapid Vienna,9596,3,7,11,6,33,29,4,32
LASK Linz,9596,4,8,6,10,26,29,-3,30
Mattersburg,9596,5,7,5,12,29,41,-12,26
Vienna,9596,6,7,5,12,25,39,-14,26
SC Rheindorf,9596,7,6,5,13,22,30,-8,23
FC Salzburg,9597,1,15,6,3,51,19,32,51
SK Sturm Gra,9597,2,12,4,8,33,31,2,40
Rapid Vienna,9597,3,9,10,5,40,29,11,37
LASK Linz,9597,4,8,5,11,26,32,-6,29
Mattersburg,9597,5,6,7,11,31,44,-13,25
SC Rheindorf,9597,6,6,6,12,20,29,-9,24
Vienna,9597,7,6,6,12,25,42,-17,24
FC Salzburg,9598,1,14,8,2,50,21,29,50
Rapid Vienna,9598,2,9,11,4,39,27,12,38
SK Sturm Gra,9598,3,11,5,8,31,33,-2,38
Mattersburg,9598,4,8,5,11,35,41,-6,29
LASK Linz,9598,5,7,6,11,25,30,-5,27
Vienna,9598,6,6,6,12,24,41,-17,24
SC Rheindorf,9598,7,5,7,12,20,31,-11,22
FC Salzburg,9599,1,15,6,3,47,17,30,51
SK Sturm Gra,9599,2,12,4,8,33,32,1,40
LASK Linz,9599,3,10,5,9,28,25,3,35
Rapid Vienna,9599,4,8,9,7,35,31,4,33
Vienna,9599,5,7,6,11,25,38,-13,27
SC Rheindorf,9599,6,6,6,12,21,32,-11,24
Mattersburg,9599,7,5,6,13,28,42,-14,21
FC Salzburg,9600,1,14,7,3,45,19,26,49
SK Sturm Gra,9600,2,14,4,6,36,25,11,46
Rapid Vienna,9600,3,8,10,6,33,27,6,34
LASK Linz,9600,4,8,8,8,28,28,0,32
Mattersburg,9600,5,7,6,11,32,43,-11,27
Vienna,9600,6,6,5,13,23,40,-17,23
SC Rheindorf,9600,7,4,6,14,18,33,-15,18
FC Salzburg,9601,1,16,6,2,50,16,34,54
SK Sturm Gra,9601,2,13,3,8,33,30,3,42
Rapid Vienna,9601,3,9,9,6,33,29,4,36
LASK Linz,9601,4,9,5,10,28,30,-2,32
Mattersburg,9601,5,8,5,11,32,41,-9,29
Vienna,9601,6,6,5,13,24,40,-16,23
SC Rheindorf,9601,7,4,5,15,15,29,-14,17
FC Salzburg,9602,1,13,7,4,41,20,21,46
Rapid Vienna,9602,2,10,10,4,38,25,13,40
SK Sturm Gra,9602,3,12,3,9,30,30,0,39
LASK Linz,9602,4,10,5,9,30,26,4,35
Vienna,9602,5,8,5,11,27,37,-10,29
SC Rheindorf,9602,6,5,6,13,18,30,-12,21
Mattersburg,9602,7,5,6,13,27,43,-16,21
FC Salzburg,9603,1,15,6,3,47,18,29,51
SK Sturm Gra,9603,2,12,4,8,36,31,5,40
Rapid Vienna,9603,3,9,9,6,35,26,9,36
LASK Linz,9603,4,9,5,10,29,32,-3,32
Vienna,9603,5,7,5,12,25,40,-15,26
SC Rheindorf,9603,6,6,7,11,20,28,-8,25
Mattersburg,9603,7,5,6,13,29,46,-17,21
FC Salzburg,9604,1,15,6,3,46,17,29,51
SK Sturm Gra,9604,2,13,3,8,33,31,2,42
Rapid Vienna,9604,3,9,9,6,36,28,8,36
LASK Linz,9604,4,8,5,11,28,31,-3,29
SC Rheindorf,9604,5,7,5,12,19,27,-8,26
Mattersburg,9604,6,6,6,12,31,44,-13,24
Vienna,9604,7,6,6,12,25,40,-15,24
FC Salzburg,9605,1,14,8,2,48,20,28,50
SK Sturm Gra,9605,2,12,5,7,31,27,4,41
Rapid Vienna,9605,3,8,10,6,39,34,5,34
LASK Linz,9605,4,9,7,8,28,27,1,34
Vienna,9605,5,7,6,11,24,37,-13,27
SC Rheindorf,9605,6,5,6,13,18,29,-11,21
Mattersburg,9605,7,5,6,13,29,43,-14,21
FC Salzburg,9606,1,15,6,3,41,16,25,51
Rapid Vienna,9606,2,10,10,4,37,25,12,40
LASK Linz,9606,3,10,6,8,32,28,4,36
SK Sturm Gra,9606,4,11,3,10,33,33,0,36
Vienna,9606,5,7,5,12,24,38,-14,26
SC Rheindorf,9606,6,6,5,13,21,34,-13,23
Mattersburg,9606,7,5,5,14,27,41,-14,20
FC Salzburg,9607,1,13,8,3,43,19,24,47
SK Sturm Gra,9607,2,12,5,7,32,28,4,41
Rapid Vienna,9607,3,9,10,5,37,29,8,37
LASK Linz,9607,4,8,8,8,30,29,1,32
Vienna,9607,5,7,5,12,26,39,-13,26
Mattersburg,9607,6,6,6,12,31,45,-14,24
SC Rheindorf,9607,7,5,6,13,20,30,-10,21
FC Salzburg,9608,1,15,7,2,44,16,28,52
SK Sturm Gra,9608,2,13,4,7,33,28,5,43
Rapid Vienna,9608,3,8,10,6,35,29,6,34
LASK Linz,9608,4,8,6,10,26,27,-1,30
Vienna,9608,5,7,6,11,27,40,-13,27
Mattersburg,9608,6,7,5,12,34,45,-11,26
SC Rheindorf,9608,7,4,6,14,19,33,-14,18
FC Salzburg,9609,1,13,7,4,43,23,20,46
SK Sturm Gra,9609,2,13,4,7,38,30,8,43
Rapid Vienna,9609,3,9,9,6,36,28,8,36
LASK Linz,9609,4,8,6,10,27,29,-2,30
SC Rheindorf,9609,5,7,6,11,23,29,-6,27
Vienna,9609,6,7,6,11,25,38,-13,27
Mattersburg,9609,7,5,6,13,29,44,-15,21
FC Salzburg,9610,1,13,8,3,45,21,24,47
SK Sturm Gra,9610,2,14,4,6,35,28,7,46
Rapid Vienna,9610,3,7,10,7,36,31,5,31
LASK Linz,9610,4,8,7,9,27,28,-1,31
Vienna,9610,5,7,6,11,25,37,-12,27
Mattersburg,9610,6,6,6,12,32,44,-12,24
SC Rheindorf,9610,7,5,7,12,19,30,-11,22
FC Salzburg,9611,1,15,6,3,50,18,32,51
SK Sturm Gra,9611,2,13,4,7,34,30,4,43
Rapid Vienna,9611,3,9,10,5,37,28,9,37
LASK Linz,9611,4,8,6,10,26,27,-1,30
Mattersburg,9611,5,7,6,11,31,41,-10,27
Vienna,9611,6,6,5,13,23,44,-21,23
SC Rheindorf,9611,7,4,7,13,18,31,-13,19
FC Salzburg,9612,1,15,7,2,48,17,31,52
SK Sturm Gra,9612,2,13,4,7,35,33,2,43
LASK Linz,9612,3,9,5,10,32,32,0,32
Rapid Vienna,9612,4,7,10,7,36,33,3,31
Mattersburg,9612,5,7,6,11,35,39,-4,27
Vienna,9612,6,6,6,12,23,39,-16,24
SC Rheindorf,9612,7,5,6,13,19,35,-16,21
FC Salzburg,9613,1,15,6,3,46,18,28,51
SK Sturm Gra,9613,2,13,3,8,31,31,0,42
Rapid Vienna,9613,3,8,10,6,36,29,7,34
LASK Linz,9613,4,8,7,9,29,29,0,31
Vienna,9613,5,7,5,12,24,38,-14,26
Mattersburg,9613,6,6,6,12,31,42,-11,24
SC Rheindorf,9613,7,5,7,12,21,31,-10,22
FC Salzburg,9614,1,15,6,3,47,18,29,51
Rapid Vienna,9614,2,10,9,5,36,25,11,39
SK Sturm Gra,9614,3,12,3,9,35,31,4,39
LASK Linz,9614,4,8,7,9,29,33,-4,31
Mattersburg,9614,5,7,6,11,35,45,-10,27
Vienna,9614,6,6,5,13,26,44,-18,23
SC Rheindorf,9614,7,5,6,13,18,30,-12,21
FC Salzburg,9615,1,14,7,3,46,18,28,49
SK Sturm Gra,9615,2,12,5,7,31,28,3,41
Rapid Vienna,9615,3,9,9,6,34,25,9,36
LASK Linz,9615,4,8,6,10,25,28,-3,30
Mattersburg,9615,5,7,5,12,31,43,-12,26
Vienna,9615,6,7,5,12,25,41,-16,26
SC Rheindorf,9615,7,6,5,13,19,28,-9,23
FC Salzburg,9616,1,15,6,3,45,22,23,51
SK Sturm Gra,9616,2,11,6,7,36,33,3,39
Rapid Vienna,9616,3,8,10,6,40,31,9,34
LASK Linz,9616,4,8,7,9,30,31,-1,31
SC Rheindorf,9616,5,7,6,11,25,29,-4,27
Vienna,9616,6,6,6,12,24,40,-16,24
Mattersburg,9616,7,5,7,12,29,43,-14,22
FC Salzburg,9617,1,15,7,2,46,18,28,52
SK Sturm Gra,9617,2,11,5,8,30,29,1,38
LASK Linz,9617,3,9,7,8,27,24,3,34
Rapid Vienna,9617,4,7,11,6,33,29,4,32
Vienna,9617,5,7,6,11,28,38,-10,27
SC Rheindorf,9617,6,6,7,11,19,25,-6,25
Mattersburg,9617,7,5,5,14,26,46,-20,20
FC Salzburg,9618,1,13,7,4,45,22,23,46
SK Sturm Gra,9618,2,14,3,7,35,28,7,45
Rapid Vienna,9618,3,9,10,5,36,27,9,37
LASK Linz,9618,4,9,7,8,28,27,1,34
Vienna,9618,5,7,6,11,29,39,-10,27
Mattersburg,9618,6,6,6,12,32,47,-15,24
SC Rheindorf,9618,7,4,5,15,17,32,-15,17
FC Salzburg,9619,1,14,8,2,47,19,28,50
SK Sturm Gra,9619,2,12,4,8,33,32,1,40
Rapid Vienna,9619,3,8,9,7,36,32,4,33
LASK Linz,9619,4,9,6,9,31,31,0,33
Vienna,9619,5,6,7,11,27,41,-14,25
SC Rheindorf,9619,6,6,6,12,24,31,-7,24
Mattersburg,9619,7,5,8,11,30,42,-12,23
FC Salzburg,9620,1,13,9,2,41,16,25,48
SK Sturm Gra,9620,2,12,5,7,32,28,4,41
Rapid Vienna,9620,3,7,12,5,32,25,7,33
SC Rheindorf,9620,4,8,5,11,25,27,-2,29
LASK Linz,9620,5,7,6,11,23,29,-6,27
Mattersburg,9620,6,7,6,11,31,42,-11,27
Vienna,9620,7,6,5,13,25,42,-17,23
FC Salzburg,9621,1,15,6,3,44,19,25,51
SK Sturm Gra,9621,2,11,6,7,28,25,3,39
Rapid Vienna,9621,3,9,11,4,37,26,11,38
LASK Linz,9621,4,8,7,9,26,27,-1,31
Mattersburg,9621,5,6,6,12,30,42,-12,24
Vienna,9621,6,6,5,13,24,40,-16,23
SC Rheindorf,9621,7,5,7,12,17,27,-10,22
FC Salzburg,9622,1,15,6,3,45,18,27,51
SK Sturm Gra,9622,2,12,3,9,32,30,2,39
LASK Linz,9622,3,11,5,8,32,26,6,38
Rapid Vienna,9622,4,8,9,7,34,30,4,33
Mattersburg,9622,5,7,5,12,30,40,-10,26
SC Rheindorf,9622,6,6,5,13,18,30,-12,23
Vienna,9622,7,6,5,13,23,40,-17,23
FC Salzburg,9623,1,13,7,4,43,21,22,46
SK Sturm Gra,9623,2,12,4,8,31,29,2,40
Rapid Vienna,9623,3,9,10,5,39,30,9,37
LASK Linz,9623,4,10,5,9,30,27,3,35
Vienna,9623,5,8,5,11,28,38,-10,29
SC Rheindorf,9623,6,6,5,13,22,30,-8,23
Mattersburg,9623,7,5,6,13,26,44,-18,21
FC Salzburg,9624,1,16,6,2,49,17,32,54
Rapid Vienna,9624,2,9,10,5,37,29,8,37
SK Sturm Gra,9624,3,11,4,9,30,33,-3,37
LASK Linz,9624,4,9,5,10,28,27,1,32
SC Rheindorf,9624,5,7,5,12,18,26,-8,26
Vienna,9624,6,6,6,12,24,39,-15,24
Mattersburg,9624,7,5,6,13,28,43,-15,21
FC Salzburg,9625,1,16,6,2,48,17,31,54
SK Sturm Gra,9625,2,14,3,7,36,27,9,45
Rapid Vienna,9625,3,9,9,6,37,27,10,36
Vienna,9625,4,7,5,12,28,42,-14,26
LASK Linz,9625,5,7,5,12,24,38,-14,26
Mattersburg,9625,6,6,6,12,30,43,-13,24
SC Rheindorf,9625,7,5,6,13,21,30,-9,21
FC Salzburg,9626,1,15,7,2,46,15,31,52
SK Sturm Gra,9626,2,13,3,8,31,28,3,42
Rapid Vienna,9626,3,8,9,7,33,29,4,33
LASK Linz,9626,4,9,5,10,31,28,3,32
Vienna,9626,5,7,6,11,25,37,-12,27
SC Rheindorf,9626,6,6,5,13,18,28,-10,23
Mattersburg,9626,7,6,5,13,28,47,-19,23
FC Salzburg,9627,1,15,6,3,45,19,26,51
SK Sturm Gra,9627,2,13,3,8,35,29,6,42
Rapid Vienna,9627,3,9,10,5,36,28,8,37
LASK Linz,9627,4,9,6,9,28,28,0,33
Mattersburg,9627,5,7,5,12,32,42,-10,26
Vienna,9627,6,6,5,13,23,40,-17,23
SC Rheindorf,9627,7,5,5,14,18,31,-13,20
FC Salzburg,9628,1,14,7,3,51,20,31,49
SK Sturm Gra,9628,2,14,3,7,33,30,3,45
Rapid Vienna,9628,3,8,9,7,34,27,7,33
LASK Linz,9628,4,8,5,11,26,32,-6,29
SC Rheindorf,9628,5,7,5,12,21,27,-6,26
Mattersburg,9628,6,7,5,12,30,44,-14,26
Vienna,9628,7,6,6,12,25,40,-15,24
FC Salzburg,9629,1,16,6,2,44,16,28,54
SK Sturm Gra,9629,2,12,3,9,31,29,2,39
LASK Linz,9629,3,9,6,9,27,28,-1,33
Rapid Vienna,9629,4,7,11,6,34,29,5,32
Vienna,9629,5,7,5,12,25,40,-15,26
Mattersburg,9629,6,6,6,12,31,40,-9,24
SC Rheindorf,9629,7,5,7,12,19,29,-10,22
FC Salzburg,9630,1,13,8,3,44,20,24,47
SK Sturm Gra,9630,2,12,4,8,33,30,3,40
Rapid Vienna,9630,3,9,10,5,36,27,9,37
Vienna,9630,4,8,5,11,29,40,-11,29
SC Rheindorf,9630,5,7,6,11,19,26,-7,27
LASK Linz,9630,6,7,5,12,25,32,-7,26
Mattersburg,9630,7,6,6,12,33,44,-11,24
FC Salzburg,9631,1,13,7,4,42,20,22,46
Rapid Vienna,9631,2,10,10,4,38,25,13,40
SK Sturm Gra,9631,3,12,4,8,32,32,0,40
LASK Linz,9631,4,9,5,10,29,28,1,32
Vienna,9631,5,8,5,11,27,38,-11,29
Mattersburg,9631,6,7,5,12,32,43,-11,26
SC Rheindorf,9631,7,4,6,14,16,30,-14,18
FC Salzburg,9632,1,14,7,3,46,20,26,49
SK Sturm Gra,9632,2,13,5,6,37,29,8,44
Rapid Vienna,9632,3,9,10,5,41,26,15,37
LASK Linz,9632,4,8,6,10,28,33,-5,30
Mattersburg,9632,5,7,6,11,31,38,-7,27
Vienna,9632,6,6,5,13,24,43,-19,23
SC Rheindorf,9632,7,4,7,13,16,34,-18,19
FC Salzburg,9633,1,14,6,4,41,17,24,48
SK Sturm Gra,9633,2,13,3,8,34,29,5,42
Rapid Vienna,9633,3,7,9,8,35,35,0,30
Mattersburg,9633,4,8,6,10,32,39,-7,30
LASK Linz,9633,5,8,5,11,29,33,-4,29
SC Rheindorf,9633,6,7,6,11,25,29,-4,27
Vienna,9633,7,7,5,12,25,39,-14,26
FC Salzburg,9634,1,14,7,3,46,20,26,49
SK Sturm Gra,9634,2,12,6,6,32,27,5,42
Rapid Vienna,9634,3,8,10,6,38,30,8,34
LASK Linz,9634,4,9,6,9,30,30,0,33
Vienna,9634,5,8,5,11,29,38,-9,29
Mattersburg,9634,6,5,6,13,30,46,-16,21
SC Rheindorf,9634,7,4,8,12,19,33,-14,20
FC Salzburg,9635,1,14,8,2,50,20,30,50
SK Sturm Gra,9635,2,13,5,6,33,27,6,44
Rapid Vienna,9635,3,8,9,7,33,29,4,33
LASK Linz,9635,4,8,6,10,26,30,-4,30
Mattersburg,9635,5,6,7,11,31,44,-13,25
Vienna,9635,6,6,7,11,26,40,-14,25
SC Rheindorf,9635,7,5,6,13,21,30,-9,21
FC Salzburg,9636,1,14,6,4,46,19,27,48
Rapid Vienna,9636,2,10,9,5,40,29,11,39
SK Sturm Gra,9636,3,12,3,9,34,32,2,39
LASK Linz,9636,4,9,5,10,29,31,-2,32
Mattersburg,9636,5,7,6,11,33,42,-9,27
Vienna,9636,6,7,5,12,25,41,-16,26
SC Rheindorf,9636,7,5,6,13,19,32,-13,21
FC Salzburg,9637,1,14,6,4,43,21,22,48
Rapid Vienna,9637,2,11,9,4,39,27,12,42
SK Sturm Gra,9637,3,11,5,8,29,28,1,38
LASK Linz,9637,4,7,8,9,26,28,-2,29
Vienna,9637,5,8,5,11,30,38,-8,29
SC Rheindorf,9637,6,5,7,12,18,28,-10,22
Mattersburg,9637,7,5,6,13,27,42,-15,21
FC Salzburg,9638,1,13,8,3,45,22,23,47
SK Sturm Gra,9638,2,12,6,6,32,26,6,42
Rapid Vienna,9638,3,9,10,5,37,27,10,37
LASK Linz,9638,4,7,6,11,25,32,-7,27
SC Rheindorf,9638,5,6,7,11,18,25,-7,25
Vienna,9638,6,6,7,11,25,39,-14,25
Mattersburg,9638,7,6,6,12,31,42,-11,24
FC Salzburg,9639,1,14,7,3,47,20,27,49
SK Sturm Gra,9639,2,12,5,7,37,35,2,41
Rapid Vienna,9639,3,9,9,6,36,28,8,36
LASK Linz,9639,4,8,6,10,31,33,-2,30
Mattersburg,9639,5,7,6,11,35,45,-10,27
Vienna,9639,6,6,6,12,24,41,-17,24
SC Rheindorf,9639,7,6,5,13,25,33,-8,23
FC Salzburg,9640,1,14,7,3,44,20,24,49
SK Sturm Gra,9640,2,13,4,7,32,27,5,43
Rapid Vienna,9640,3,8,10,6,32,28,4,34
LASK Linz,9640,4,9,5,10,30,29,1,32
Vienna,9640,5,8,5,11,29,38,-9,29
Mattersburg,9640,6,7,5,12,35,45,-10,26
SC Rheindorf,9640,7,4,6,14,18,33,-15,18
FC Salzburg,9641,1,14,8,2,45,20,25,50
SK Sturm Gra,9641,2,13,3,8,35,31,4,42
Rapid Vienna,9641,3,8,10,6,36,29,7,34
LASK Linz,9641,4,8,6,10,27,29,-2,30
Vienna,9641,5,7,6,11,28,40,-12,27
SC Rheindorf,9641,6,6,6,12,23,32,-9,24
Mattersburg,9641,7,5,7,12,30,43,-13,22
FC Salzburg,9642,1,16,6,2,46,18,28,54
SK Sturm Gra,9642,2,14,3,7,37,30,7,45
Rapid Vienna,9642,3,9,9,6,37,30,7,36
LASK Linz,9642,4,8,5,11,25,29,-4,29
Vienna,9642,5,7,5,12,30,39,-9,26
SC Rheindorf,9642,6,6,5,13,23,31,-8,23
Mattersburg,9642,7,5,5,14,26,47,-21,20
FC Salzburg,9643,1,15,6,3,43,19,24,51
SK Sturm Gra,9643,2,12,4,8,33,30,3,40
Rapid Vienna,9643,3,9,9,6,36,28,8,36
LASK Linz,9643,4,9,6,9,29,29,0,33
Mattersburg,9643,5,6,6,12,31,42,-11,24
Vienna,9643,6,6,6,12,25,40,-15,24
SC Rheindorf,9643,7,6,5,13,21,30,-9,23
FC Salzburg,9644,1,14,6,4,47,21,26,48
Rapid Vienna,9644,2,10,9,5,38,27,11,39
SK Sturm Gra,9644,3,11,4,9,31,33,-2,37
LASK Linz,9644,4,8,7,9,25,26,-1,31
Vienna,9644,5,8,5,11,27,38,-11,29
SC Rheindorf,9644,6,7,6,11,20,27,-7,27
Mattersburg,9644,7,5,5,14,29,45,-16,20
FC Salzburg,9645,1,15,7,2,48,18,30,52
SK Sturm Gra,9645,2,14,3,7,36,28,8,45
Rapid Vienna,9645,3,8,11,5,39,30,9,35
LASK Linz,9645,4,7,7,10,28,32,-4,28
Mattersburg,9645,5,6,7,11,29,40,-11,25
Vienna,9645,6,6,5,13,24,43,-19,23
SC Rheindorf,9645,7,5,6,13,20,33,-13,21
FC Salzburg,9646,1,13,7,4,44,22,22,46
SK Sturm Gra,9646,2,13,5,6,34,27,7,44
LASK Linz,9646,3,10,6,8,30,27,3,36
Rapid Vienna,9646,4,8,10,6,34,28,6,34
Vienna,9646,5,8,5,11,32,41,-9,29
Mattersburg,9646,6,6,5,13,32,48,-16,23
SC Rheindorf,9646,7,4,6,14,15,28,-13,18
FC Salzburg,9647,1,16,6,2,44,17,27,54
SK Sturm Gra,9647,2,12,3,9,31,30,1,39
Rapid Vienna,9647,3,9,10,5,36,26,10,37
LASK Linz,9647,4,9,5,10,28,30,-2,32
Mattersburg,9647,5,6,6,12,29,40,-11,24
Vienna,9647,6,6,6,12,25,40,-15,24
SC Rheindorf,9647,7,5,6,13,20,30,-10,21
FC Salzburg,9648,1,14,7,3,44,20,24,49
SK Sturm Gra,9648,2,12,5,7,34,30,4,41
Rapid Vienna,9648,3,8,12,4,35,25,10,36
LASK Linz,9648,4,7,7,10,27,32,-5,28
Vienna,9648,5,7,5,12,26,39,-13,26
SC Rheindorf,9648,6,6,6,12,21,28,-7,24
Mattersburg,9648,7,6,6,12,29,42,-13,24
FC Salzburg,9649,1,15,6,3,44,17,27,51
SK Sturm Gra,9649,2,12,3,9,31,32,-1,39
Rapid Vienna,9649,3,9,9,6,37,27,10,36
LASK Linz,9649,4,8,5,11,26,33,-7,29
Vienna,9649,5,8,5,11,27,39,-12,29
SC Rheindorf,9649,6,6,6,12,21,28,-7,24
Mattersburg,9649,7,6,6,12,32,42,-10,24
FC Salzburg,9650,1,14,8,2,44,18,26,50
SK Sturm Gra,9650,2,11,5,8,30,28,2,38
Rapid Vienna,9650,3,9,10,5,36,27,9,37
LASK Linz,9650,4,8,6,10,25,28,-3,30
Vienna,9650,5,7,6,11,28,38,-10,27
SC Rheindorf,9650,6,6,7,11,19,26,-7,25
Mattersburg,9650,7,5,6,13,27,44,-17,21
FC Salzburg,9651,1,14,7,3,45,19,26,49
SK Sturm Gra,9651,2,13,3,8,35,30,5,42
LASK Linz,9651,3,9,6,9,30,28,2,33
Rapid Vienna,9651,4,8,9,7,37,36,1,33
SC Rheindorf,9651,5,7,5,12,25,32,-7,26
Vienna,9651,6,7,5,12,24,39,-15,26
Mattersburg,9651,7,5,7,12,28,40,-12,22
FC Salzburg,9652,1,14,7,3,46,20,26,49
SK Sturm Gra,9652,2,11,4,9,31,33,-2,37
Rapid Vienna,9652,3,8,12,4,39,30,9,36
LASK Linz,9652,4,9,5,10,31,31,0,32
Mattersburg,9652,5,8,5,11,32,45,-13,29
Vienna,9652,6,7,5,12,31,40,-9,26
SC Rheindorf,9652,7,5,6,13,20,31,-11,21
FC Salzburg,9653,1,15,7,2,51,19,32,52
SK Sturm Gra,9653,2,14,4,6,35,27,8,46
Rapid Vienna,9653,3,8,9,7,38,33,5,33
LASK Linz,9653,4,9,5,10,26,27,-1,32
Vienna,9653,5,7,5,12,28,41,-13,26
Mattersburg,9653,6,6,5,13,28,47,-19,23
SC Rheindorf,9653,7,5,5,14,19,31,-12,20
FC Salzburg,9654,1,15,7,2,49,18,31,52
SK Sturm Gra,9654,2,13,4,7,34,28,6,43
Rapid Vienna,9654,3,7,12,5,34,28,6,33
LASK Linz,9654,4,7,7,10,26,31,-5,28
Vienna,9654,5,7,5,12,26,42,-16,26
Mattersburg,9654,6,6,6,12,29,41,-12,24
SC Rheindorf,9654,7,4,9,11,17,27,-10,21
FC Salzburg,9655,1,13,9,2,46,20,26,48
SK Sturm Gra,9655,2,12,5,7,31,28,3,41
Rapid Vienna,9655,3,9,10,5,38,28,10,37
Mattersburg,9655,4,7,7,10,37,44,-7,28
LASK Linz,9655,5,7,6,11,24,30,-6,27
Vienna,9655,6,6,7,11,26,40,-14,25
SC Rheindorf,9655,7,5,6,13,22,34,-12,21
FC Salzburg,9656,1,13,8,3,48,25,23,47
SK Sturm Gra,9656,2,13,4,7,33,28,5,43
LASK Linz,9656,3,9,5,10,28,28,0,32
Rapid Vienna,9656,4,7,10,7,34,32,2,31
Vienna,9656,5,8,5,11,30,42,-12,29
Mattersburg,9656,6,7,6,11,36,43,-7,27
SC Rheindorf,9656,7,5,6,13,20,31,-11,21
FC Salzburg,9657,1,15,7,2,48,18,30,52
SK Sturm Gra,9657,2,12,5,7,33,29,4,41
Rapid Vienna,9657,3,9,10,5,37,28,9,37
LASK Linz,9657,4,9,6,9,28,27,1,33
Vienna,9657,5,7,6,11,26,38,-12,27
Mattersburg,9657,6,6,5,13,30,48,-18,23
SC Rheindorf,9657,7,4,5,15,18,32,-14,17
FC Salzburg,9658,1,14,7,3,45,20,25,49
SK Sturm Gra,9658,2,13,4,7,37,29,8,43
LASK Linz,9658,3,10,5,9,29,29,0,35
Rapid Vienna,9658,4,8,9,7,33,29,4,33
Mattersburg,9658,5,7,5,12,32,41,-9,26
Vienna,9658,6,7,5,12,27,42,-15,26
SC Rheindorf,9658,7,5,5,14,18,31,-13,20
FC Salzburg,9659,1,14,7,3,46,22,24,49
SK Sturm Gra,9659,2,14,3,7,36,30,6,45
Rapid Vienna,9659,3,9,9,6,37,27,10,36
SC Rheindorf,9659,4,7,5,12,22,28,-6,26
LASK Linz,9659,5,7,5,12,27,35,-8,26
Vienna,9659,6,7,5,12,26,41,-15,26
Mattersburg,9659,7,6,6,12,32,43,-11,24
FC Salzburg,9660,1,13,9,2,45,21,24,48
SK Sturm Gra,9660,2,12,4,8,37,33,4,40
Rapid Vienna,9660,3,8,11,5,39,33,6,35
LASK Linz,9660,4,10,5,9,33,27,6,35
Vienna,9660,5,7,6,11,26,39,-13,27
SC Rheindorf,9660,6,5,7,12,23,33,-10,22
Mattersburg,9660,7,5,6,13,28,45,-17,21
FC Salzburg,9661,1,12,9,3,40,18,22,45
SK Sturm Gra,9661,2,13,4,7,34,30,4,43
Rapid Vienna,9661,3,10,10,4,40,27,13,40
LASK Linz,9661,4,7,6,11,26,31,-5,27
Mattersburg,9661,5,7,6,11,31,40,-9,27
Vienna,9661,6,7,6,11,27,39,-12,27
SC Rheindorf,9661,7,5,5,14,19,32,-13,20
FC Salzburg,9662,1,14,8,2,46,21,25,50
SK Sturm Gra,9662,2,13,3,8,34,33,1,42
Rapid Vienna,9662,3,9,10,5,39,29,10,37
LASK Linz,9662,4,7,6,11,25,30,-5,27
Vienna,9662,5,6,7,11,26,40,-14,25
SC Rheindorf,9662,6,6,6,12,22,28,-6,24
Mattersburg,9662,7,5,8,11,32,43,-11,23
FC Salzburg,9663,1,15,7,2,43,17,26,52
SK Sturm Gra,9663,2,13,4,7,33,26,7,43
Rapid Vienna,9663,3,8,9,7,37,31,6,33
LASK Linz,9663,4,9,6,9,29,29,0,33
Mattersburg,9663,5,7,5,12,31,42,-11,26
Vienna,9663,6,6,6,12,27,42,-15,24
SC Rheindorf,9663,7,4,7,13,18,31,-13,19
FC Salzburg,9664,1,15,6,3,43,19,24,51
SK Sturm Gra,9664,2,13,4,7,35,29,6,43
Rapid Vienna,9664,3,9,10,5,35,25,10,37
LASK Linz,9664,4,7,8,9,27,29,-2,29
Mattersburg,9664,5,7,6,11,32,41,-9,27
Vienna,9664,6,6,5,13,24,40,-16,23
SC Rheindorf,9664,7,5,5,14,16,29,-13,20
FC Salzburg,9665,1,15,6,3,48,18,30,51
SK Sturm Gra,9665,2,12,4,8,30,29,1,40
Rapid Vienna,9665,3,8,10,6,34,28,6,34
LASK Linz,9665,4,9,6,9,28,28,0,33
Vienna,9665,5,8,5,11,27,37,-10,29
Mattersburg,9665,6,6,5,13,28,43,-15,23
SC Rheindorf,9665,7,5,6,13,17,29,-12,21
FC Salzburg,9666,1,14,6,4,46,19,27,48
SK Sturm Gra,9666,2,14,4,6,35,28,7,46
Rapid Vienna,9666,3,8,9,7,35,31,4,33
LASK Linz,9666,4,8,6,10,28,30,-2,30
Mattersburg,9666,5,6,7,11,31,42,-11,25
Vienna,9666,6,6,6,12,25,41,-16,24
SC Rheindorf,9666,7,5,8,11,17,26,-9,23
FC Salzburg,9667,1,16,6,2,51,20,31,54
SK Sturm Gra,9667,2,12,4,8,33,30,3,40
Rapid Vienna,9667,3,9,9,6,36,30,6,36
LASK Linz,9667,4,9,6,9,29,28,1,33
Mattersburg,9667,5,7,5,12,35,43,-8,26
Vienna,9667,6,6,5,13,27,44,-17,23
SC Rheindorf,9667,7,5,5,14,17,33,-16,20
FC Salzburg,9668,1,15,7,2,47,17,30,52
SK Sturm Gra,9668,2,12,5,7,34,29,5,41
Rapid Vienna,9668,3,8,10,6,36,33,3,34
LASK Linz,9668,4,9,6,9,28,29,-1,33
Vienna,9668,5,7,5,12,26,39,-13,26
Mattersburg,9668,6,6,6,12,31,42,-11,24
SC Rheindorf,9668,7,4,7,13,17,30,-13,19
FC Salzburg,9669,1,15,6,3,43,17,26,51
SK Sturm Gra,9669,2,11,6,7,31,28,3,39
Rapid Vienna,9669,3,8,10,6,36,32,4,34
LASK Linz,9669,4,9,6,9,35,30,5,33
Vienna,9669,5,7,5,12,27,42,-15,26
SC Rheindorf,9669,6,6,6,12,21,30,-9,24
Mattersburg,9669,7,6,5,13,33,47,-14,23
FC Salzburg,9670,1,13,8,3,42,19,23,47
SK Sturm Gra,9670,2,13,5,6,34,27,7,44
Rapid Vienna,9670,3,9,10,5,34,25,9,37
LASK Linz,9670,4,8,6,10,26,27,-1,30
Vienna,9670,5,8,5,11,30,39,-9,29
Mattersburg,9670,6,6,6,12,32,47,-15,24
SC Rheindorf,9670,7,4,6,14,16,30,-14,18
FC Salzburg,9671,1,15,7,2,49,16,33,52
SK Sturm Gra,9671,2,12,4,8,31,33,-2,40
Rapid Vienna,9671,3,7,13,4,32,24,8,34
LASK Linz,9671,4,9,6,9,30,26,4,33
Vienna,9671,5,7,5,12,27,39,-12,26
Mattersburg,9671,6,6,5,13,29,48,-19,23
SC Rheindorf,9671,7,5,6,13,21,33,-12,21
FC Salzburg,9672,1,14,8,2,44,17,27,50
SK Sturm Gra,9672,2,12,5,7,34,29,5,41
Rapid Vienna,9672,3,9,11,4,37,27,10,38
LASK Linz,9672,4,8,5,11,27,32,-5,29
Mattersburg,9672,5,8,5,11,35,43,-8,29
Vienna,9672,6,6,5,13,25,41,-16,23
SC Rheindorf,9672,7,5,5,14,20,33,-13,20
FC Salzburg,9673,1,14,7,3,44,18,26,49
SK Sturm Gra,9673,2,12,5,7,33,29,4,41
Rapid Vienna,9673,3,10,10,4,34,23,11,40
Mattersburg,9673,4,7,6,11,34,40,-6,27
LASK Linz,9673,5,7,5,12,25,33,-8,26
Vienna,9673,6,6,6,12,25,42,-17,24
SC Rheindorf,9673,7,5,7,12,21,31,-10,22
FC Salzburg,9674,1,16,6,2,48,18,30,54
SK Sturm Gra,9674,2,11,5,8,31,30,1,38
Rapid Vienna,9674,3,8,11,5,36,27,9,35
LASK Linz,9674,4,7,8,9,27,29,-2,29
SC Rheindorf,9674,5,6,6,12,20,30,-10,24
Vienna,9674,6,6,6,12,26,42,-16,24
Mattersburg,9674,7,5,8,11,31,43,-12,23
FC Salzburg,9675,1,13,7,4,46,21,25,46
SK Sturm Gra,9675,2,12,3,9,32,30,2,39
LASK Linz,9675,3,10,6,8,29,26,3,36
Rapid Vienna,9675,4,8,11,5,34,26,8,35
Mattersburg,9675,5,7,6,11,35,44,-9,27
Vienna,9675,6,7,5,12,25,42,-17,26
SC Rheindorf,9675,7,5,6,13,18,30,-12,21
FC Salzburg,9676,1,15,6,3,45,21,24,51
SK Sturm Gra,9676,2,12,4,8,33,30,3,40
Rapid Vienna,9676,3,9,9,6,36,27,9,36
LASK Linz,9676,4,8,6,10,29,33,-4,30
Mattersburg,9676,5,7,5,12,35,43,-8,26
SC Rheindorf,9676,6,7,5,12,21,29,-8,26
Vienna,9676,7,6,5,13,26,42,-16,23
FC Salzburg,9677,1,14,7,3,50,20,30,49
SK Sturm Gra,9677,2,11,5,8,31,35,-4,38
Rapid Vienna,9677,3,8,12,4,36,27,9,36
Vienna,9677,4,8,5,11,29,39,-10,29
LASK Linz,9677,5,7,7,10,27,30,-3,28
SC Rheindorf,9677,6,6,6,12,21,31,-10,24
Mattersburg,9677,7,6,6,12,33,45,-12,24
FC Salzburg,9678,1,15,7,2,45,18,27,52
SK Sturm Gra,9678,2,12,3,9,32,30,2,39
Rapid Vienna,9678,3,9,9,6,38,30,8,36
LASK Linz,9678,4,9,5,10,28,29,-1,32
Mattersburg,9678,5,8,6,10,38,42,-4,30
Vienna,9678,6,6,5,13,26,43,-17,23
SC Rheindorf,9678,7,5,5,14,17,32,-15,20
FC Salzburg,9679,1,15,6,3,48,21,27,51
SK Sturm Gra,9679,2,13,4,7,32,28,4,43
Rapid Vienna,9679,3,10,10,4,40,26,14,40
LASK Linz,9679,4,8,6,10,28,29,-1,30
Mattersburg,9679,5,6,6,12,34,45,-11,24
Vienna,9679,6,6,5,13,27,46,-19,23
SC Rheindorf,9679,7,4,7,13,17,31,-14,19
FC Salzburg,9680,1,16,6,2,45,17,28,54
SK Sturm Gra,9680,2,12,5,7,31,27,4,41
Rapid Vienna,9680,3,8,11,5,38,30,8,35
LASK Linz,9680,4,9,5,10,30,27,3,32
Mattersburg,9680,5,6,6,12,29,42,-13,24
Vienna,9680,6,6,6,12,24,40,-16,24
SC Rheindorf,9680,7,4,7,13,19,33,-14,19
FC Salzburg,9681,1,14,7,3,49,22,27,49
SK Sturm Gra,9681,2,12,5,7,34,28,6,41
LASK Linz,9681,3,9,5,10,30,29,1,32
Rapid Vienna,9681,4,7,10,7,33,36,-3,31
Vienna,9681,5,7,6,11,25,38,-13,27
SC Rheindorf,9681,6,6,7,11,19,27,-8,25
Mattersburg,9681,7,6,6,12,32,42,-10,24
FC Salzburg,9682,1,14,7,3,45,19,26,49
SK Sturm Gra,9682,2,13,4,7,35,29,6,43
Rapid Vienna,9682,3,7,10,7,34,29,5,31
LASK Linz,9682,4,8,5,11,26,30,-4,29
Vienna,9682,5,8,5,11,26,37,-11,29
SC Rheindorf,9682,6,6,7,11,20,28,-8,25
Mattersburg,9682,7,6,6,12,27,41,-14,24
FC Salzburg,9683,1,16,6,2,47,17,30,54
SK Sturm Gra,9683,2,13,4,7,35,26,9,43
Rapid Vienna,9683,3,8,10,6,34,26,8,34
LASK Linz,9683,4,8,6,10,25,28,-3,30
Vienna,9683,5,6,6,12,26,42,-16,24
SC Rheindorf,9683,6,6,5,13,19,33,-14,23
Mattersburg,9683,7,5,7,12,28,42,-14,22
FC Salzburg,9684,1,14,7,3,46,21,25,49
SK Sturm Gra,9684,2,13,4,7,34,30,4,43
Rapid Vienna,9684,3,7,10,7,35,30,5,31
LASK Linz,9684,4,7,7,10,27,33,-6,28
Mattersburg,9684,5,7,6,11,33,43,-10,27
SC Rheindorf,9684,6,7,5,12,23,27,-4,26
Vienna,9684,7,7,5,12,26,40,-14,26
FC Salzburg,9685,1,15,7,2,45,17,28,52
SK Sturm Gra,9685,2,11,4,9,30,30,0,37
Rapid Vienna,9685,3,8,11,5,35,28,7,35
LASK Linz,9685,4,7,8,9,24,27,-3,29
Mattersburg,9685,5,7,5,12,30,39,-9,26
SC Rheindorf,9685,6,6,7,11,18,26,-8,25
Vienna,9685,7,6,6,12,23,38,-15,24
FC Salzburg,9686,1,15,7,2,46,18,28,52
SK Sturm Gra,9686,2,13,4,7,33,26,7,43
Rapid Vienna,9686,3,8,12,4,35,26,9,36
LASK Linz,9686,4,7,6,11,24,28,-4,27
Mattersburg,9686,5,6,7,11,32,44,-12,25
Vienna,9686,6,6,6,12,24,39,-15,24
SC Rheindorf,9686,7,4,8,12,17,30,-13,20
FC Salzburg,9687,1,14,6,4,43,20,23,48
SK Sturm Gra,9687,2,13,3,8,33,28,5,42
Rapid Vienna,9687,3,8,10,6,34,27,7,34
LASK Linz,9687,4,9,7,8,28,27,1,34
Mattersburg,9687,5,8,5,11,38,40,-2,29
Vienna,9687,6,6,5,13,24,45,-21,23
SC Rheindorf,9687,7,5,6,13,17,30,-13,21
FC Salzburg,9688,1,13,9,2,43,18,25,48
SK Sturm Gra,9688,2,13,4,7,35,27,8,43
Rapid Vienna,9688,3,7,11,6,35,32,3,32
LASK Linz,9688,4,8,6,10,26,29,-3,30
SC Rheindorf,9688,5,6,7,11,20,27,-7,25
Mattersburg,9688,6,6,7,11,29,40,-11,25
Vienna,9688,7,6,6,12,25,40,-15,24
FC Salzburg,9689,1,13,7,4,41,20,21,46
SK Sturm Gra,9689,2,14,3,7,36,28,8,45
Rapid Vienna,9689,3,9,9,6,34,27,7,36
LASK Linz,9689,4,10,5,9,29,26,3,35
Vienna,9689,5,8,5,11,26,37,-11,29
Mattersburg,9689,6,5,7,12,29,42,-13,22
SC Rheindorf,9689,7,4,6,14,17,32,-15,18
FC Salzburg,9690,1,14,8,2,43,16,27,50
SK Sturm Gra,9690,2,13,4,7,33,29,4,43
Rapid Vienna,9690,3,9,11,4,39,28,11,38
LASK Linz,9690,4,8,5,11,27,31,-4,29
Vienna,9690,5,7,6,11,25,38,-13,27
Mattersburg,9690,6,6,5,13,30,43,-13,23
SC Rheindorf,9690,7,5,5,14,20,32,-12,20
SK Sturm Gra,9691,1,14,4,6,36,29,7,46
FC Salzburg,9691,2,12,7,5,42,22,20,43
Rapid Vienna,9691,3,8,11,5,37,29,8,35
LASK Linz,9691,4,7,8,9,29,31,-2,29
Vienna,9691,5,7,6,11,27,40,-13,27
SC Rheindorf,9691,6,6,6,12,20,28,-8,24
Mattersburg,9691,7,5,8,11,29,41,-12,23
FC Salzburg,9692,1,15,7,2,44,16,28,52
SK Sturm Gra,9692,2,12,5,7,31,27,4,41
Rapid Vienna,9692,3,9,9,6,35,31,4,36
LASK Linz,9692,4,8,8,8,29,27,2,32
Vienna,9692,5,7,5,12,26,40,-14,26
Mattersburg,9692,6,6,6,12,35,44,-9,24
SC Rheindorf,9692,7,4,6,14,17,32,-15,18
FC Salzburg,9693,1,15,7,2,46,17,29,52
SK Sturm Gra,9693,2,12,5,7,31,27,4,41
Rapid Vienna,9693,3,8,12,4,39,27,12,36
LASK Linz,9693,4,8,5,11,28,35,-7,29
Mattersburg,9693,5,6,6,12,35,46,-11,24
SC Rheindorf,9693,6,5,8,11,21,29,-8,23
Vienna,9693,7,6,5,13,23,42,-19,23
FC Salzburg,9694,1,16,6,2,49,19,30,54
SK Sturm Gra,9694,2,12,5,7,32,30,2,41
Rapid Vienna,9694,3,9,9,6,33,26,7,36
LASK Linz,9694,4,8,6,10,28,30,-2,30
Mattersburg,9694,5,6,6,12,33,43,-10,24
Vienna,9694,6,6,6,12,24,39,-15,24
SC Rheindorf,9694,7,5,6,13,18,30,-12,21
FC Salzburg,9695,1,15,6,3,43,18,25,51
SK Sturm Gra,9695,2,13,4,7,33,29,4,43
Rapid Vienna,9695,3,8,10,6,36,29,7,34
LASK Linz,9695,4,9,7,8,29,26,3,34
Vienna,9695,5,7,5,12,25,40,-15,26
Mattersburg,9695,6,5,7,12,30,42,-12,22
SC Rheindorf,9695,7,4,7,13,17,29,-12,19
FC Salzburg,9696,1,14,7,3,45,19,26,49
SK Sturm Gra,9696,2,13,4,7,32,29,3,43
Rapid Vienna,9696,3,8,10,6,36,29,7,34
LASK Linz,9696,4,8,7,9,30,29,1,31
Mattersburg,9696,5,7,6,11,34,42,-8,27
Vienna,9696,6,7,5,12,26,40,-14,26
SC Rheindorf,9696,7,5,5,14,17,32,-15,20
FC Salzburg,9697,1,14,7,3,42,17,25,49
SK Sturm Gra,9697,2,13,3,8,30,26,4,42
Rapid Vienna,9697,3,9,10,5,41,29,12,37
LASK Linz,9697,4,9,6,9,28,29,-1,33
Mattersburg,9697,5,6,7,11,30,40,-10,25
Vienna,9697,6,6,6,12,24,39,-15,24
SC Rheindorf,9697,7,5,5,14,20,35,-15,20
FC Salzburg,9698,1,15,6,3,49,19,30,51
Rapid Vienna,9698,2,10,9,5,36,26,10,39
LASK Linz,9698,3,11,5,8,31,26,5,38
SK Sturm Gra,9698,4,11,4,9,31,34,-3,37
Mattersburg,9698,5,6,5,13,33,45,-12,23
Vienna,9698,6,6,5,13,24,42,-18,23
SC Rheindorf,9698,7,5,6,13,19,31,-12,21
FC Salzburg,9699,1,15,6,3,48,19,29,51
SK Sturm Gra,9699,2,13,4,7,33,30,3,43
Rapid Vienna,9699,3,9,9,6,37,26,11,36
LASK Linz,9699,4,9,5,10,30,29,1,32
Mattersburg,9699,5,7,5,12,31,44,-13,26
Vienna,9699,6,7,5,12,25,39,-14,26
SC Rheindorf,9699,7,4,6,14,18,35,-17,18
FC Salzburg,9700,1,14,7,3,43,17,26,49
SK Sturm Gra,9700,2,14,4,6,34,25,9,46
Rapid Vienna,9700,3,8,10,6,35,30,5,34
Mattersburg,9700,4,8,5,11,34,40,-6,29
LASK Linz,9700,5,7,6,11,29,33,-4,27
Vienna,9700,6,7,5,12,25,39,-14,26
SC Rheindorf,9700,7,5,5,14,21,37,-16,20
FC Salzburg,9701,1,16,6,2,51,17,34,54
SK Sturm Gra,9701,2,11,4,9,30,32,-2,37
Rapid Vienna,9701,3,8,11,5,35,27,8,35
LASK Linz,9701,4,9,5,10,26,27,-1,32
Vienna,9701,5,7,5,12,25,43,-18,26
SC Rheindorf,9701,6,6,7,11,21,29,-8,25
Mattersburg,9701,7,5,6,13,31,44,-13,21
FC Salzburg,9702,1,14,7,3,43,16,27,49
SK Sturm Gra,9702,2,12,5,7,31,28,3,41
Rapid Vienna,9702,3,8,10,6,35,28,7,34
LASK Linz,9702,4,7,8,9,27,29,-2,29
SC Rheindorf,9702,5,7,6,11,23,29,-6,27
Vienna,9702,6,7,6,11,25,37,-12,27
Mattersburg,9702,7,5,6,13,27,44,-17,21
FC Salzburg,9703,1,14,6,4,40,17,23,48
Rapid Vienna,9703,2,10,9,5,34,26,8,39
SK Sturm Gra,9703,3,11,5,8,30,28,2,38
LASK Linz,9703,4,9,7,8,28,25,3,34
Mattersburg,9703,5,7,5,12,29,38,-9,26
Vienna,9703,6,7,5,12,24,39,-15,26
SC Rheindorf,9703,7,4,7,13,16,28,-12,19
FC Salzburg,9704,1,16,6,2,48,17,31,54
SK Sturm Gra,9704,2,13,4,7,32,30,2,43
Rapid Vienna,9704,3,8,10,6,38,31,7,34
LASK Linz,9704,4,7,5,12,23,33,-10,26
SC Rheindorf,9704,5,6,7,11,25,29,-4,25
Mattersburg,9704,6,6,6,12,31,42,-11,24
Vienna,9704,7,6,6,12,27,42,-15,24
FC Salzburg,9705,1,14,7,3,40,17,23,49
SK Sturm Gra,9705,2,13,4,7,32,27,5,43
Rapid Vienna,9705,3,9,9,6,34,25,9,36
Mattersburg,9705,4,7,7,10,39,40,-1,28
LASK Linz,9705,5,7,5,12,26,34,-8,26
SC Rheindorf,9705,6,6,6,12,20,33,-13,24
Vienna,9705,7,6,6,12,24,39,-15,24
FC Salzburg,9706,1,15,6,3,46,19,27,51
SK Sturm Gra,9706,2,12,5,7,34,31,3,41
Rapid Vienna,9706,3,10,9,5,37,26,11,39
LASK Linz,9706,4,7,6,11,25,31,-6,27
Mattersburg,9706,5,7,6,11,30,39,-9,27
Vienna,9706,6,6,6,12,25,40,-15,24
SC Rheindorf,9706,7,5,6,13,21,32,-11,21
FC Salzburg,9707,1,14,7,3,44,20,24,49
SK Sturm Gra,9707,2,13,5,6,38,26,12,44
Rapid Vienna,9707,3,8,11,5,33,27,6,35
LASK Linz,9707,4,7,7,10,25,33,-8,28
Vienna,9707,5,7,5,12,27,42,-15,26
SC Rheindorf,9707,6,5,8,11,17,26,-9,23
Mattersburg,9707,7,6,5,13,30,40,-10,23
FC Salzburg,9708,1,15,6,3,43,17,26,51
SK Sturm Gra,9708,2,13,4,7,31,27,4,43
Rapid Vienna,9708,3,8,11,5,32,24,8,35
LASK Linz,9708,4,7,7,10,24,29,-5,28
Mattersburg,9708,5,7,6,11,31,39,-8,27
Vienna,9708,6,6,5,13,26,42,-16,23
SC Rheindorf,9708,7,5,7,12,19,28,-9,22
FC Salzburg,9709,1,14,7,3,47,18,29,49
SK Sturm Gra,9709,2,12,5,7,30,26,4,41
Rapid Vienna,9709,3,8,11,5,36,26,10,35
LASK Linz,9709,4,9,6,9,27,29,-2,33
Vienna,9709,5,7,6,11,26,39,-13,27
Mattersburg,9709,6,5,7,12,29,46,-17,22
SC Rheindorf,9709,7,5,6,13,18,29,-11,21
FC Salzburg,9710,1,14,7,3,42,18,24,49
SK Sturm Gra,9710,2,13,4,7,33,26,7,43
Rapid Vienna,9710,3,8,9,7,34,29,5,33
LASK Linz,9710,4,9,6,9,26,26,0,33
Mattersburg,9710,5,8,5,11,33,38,-5,29
Vienna,9710,6,6,5,13,24,43,-19,23
SC Rheindorf,9710,7,5,6,13,18,30,-12,21
FC Salzburg,9711,1,15,6,3,46,18,28,51
SK Sturm Gra,9711,2,13,3,8,33,28,5,42
Rapid Vienna,9711,3,9,10,5,35,26,9,37
LASK Linz,9711,4,8,6,10,29,31,-2,30
Mattersburg,9711,5,6,6,12,32,46,-14,24
Vienna,9711,6,6,6,12,23,39,-16,24
SC Rheindorf,9711,7,5,7,12,21,31,-10,22
FC Salzburg,9712,1,14,6,4,43,20,23,48
SK Sturm Gra,9712,2,13,4,7,35,30,5,43
Rapid Vienna,9712,3,9,10,5,35,25,10,37
LASK Linz,9712,4,8,6,10,25,27,-2,30
Vienna,9712,5,8,5,11,27,39,-12,29
SC Rheindorf,9712,6,5,8,11,18,27,-9,23
Mattersburg,9712,7,5,5,14,29,44,-15,20
FC Salzburg,9713,1,15,7,2,47,20,27,52
SK Sturm Gra,9713,2,14,3,7,39,31,8,45
Rapid Vienna,9713,3,8,11,5,36,30,6,35
LASK Linz,9713,4,7,5,12,28,34,-6,26
Mattersburg,9713,5,7,5,12,33,40,-7,26
SC Rheindorf,9713,6,6,6,12,19,28,-9,24
Vienna,9713,7,6,5,13,23,42,-19,23
FC Salzburg,9714,1,16,6,2,49,17,32,54
SK Sturm Gra,9714,2,12,3,9,30,33,-3,39
LASK Linz,9714,3,9,5,10,27,30,-3,32
Rapid Vienna,9714,4,7,9,8,33,31,2,30
SC Rheindorf,9714,5,7,5,12,23,28,-5,26
Mattersburg,9714,6,7,5,12,33,42,-9,26
Vienna,9714,7,7,5,12,25,39,-14,26
FC Salzburg,9715,1,15,6,3,44,18,26,51
Rapid Vienna,9715,2,10,9,5,38,27,11,39
SK Sturm Gra,9715,3,12,3,9,32,32,0,39
Mattersburg,9715,4,7,6,11,31,38,-7,27
LASK Linz,9715,5,7,5,12,25,31,-6,26
SC Rheindorf,9715,6,7,5,12,20,28,-8,26
Vienna,9715,7,6,6,12,25,41,-16,24
FC Salzburg,9716,1,16,6,2,49,18,31,54
SK Sturm Gra,9716,2,14,3,7,36,28,8,45
Rapid Vienna,9716,3,9,9,6,37,30,7,36
LASK Linz,9716,4,9,5,10,30,27,3,32
Mattersburg,9716,5,6,6,12,30,42,-12,24
Vienna,9716,6,6,6,12,25,42,-17,24
SC Rheindorf,9716,7,4,5,15,17,37,-20,17
FC Salzburg,9717,1,16,6,2,47,19,28,54
SK Sturm Gra,9717,2,11,5,8,33,31,2,38
Rapid Vienna,9717,3,8,10,6,34,27,7,34
LASK Linz,9717,4,7,7,10,28,31,-3,28
SC Rheindorf,9717,5,7,6,11,21,28,-7,27
Vienna,9717,6,7,5,12,27,41,-14,26
Mattersburg,9717,7,5,7,12,34,47,-13,22
FC Salzburg,9718,1,15,6,3,47,18,29,51
SK Sturm Gra,9718,2,12,4,8,32,29,3,40
Rapid Vienna,9718,3,9,11,4,36,26,10,38
Mattersburg,9718,4,8,5,11,33,41,-8,29
LASK Linz,9718,5,7,6,11,25,30,-5,27
Vienna,9718,6,6,5,13,24,43,-19,23
SC Rheindorf,9718,7,5,7,12,20,30,-10,22
FC Salzburg,9719,1,15,6,3,44,21,23,51
SK Sturm Gra,9719,2,14,3,7,34,27,7,45
Rapid Vienna,9719,3,9,9,6,36,26,10,36
LASK Linz,9719,4,9,6,9,28,28,0,33
Vienna,9719,5,7,5,12,26,39,-13,26
Mattersburg,9719,6,5,6,13,29,45,-16,21
SC Rheindorf,9719,7,5,5,14,20,31,-11,20
FC Salzburg,9720,1,15,6,3,47,16,31,51
SK Sturm Gra,9720,2,13,4,7,35,32,3,43
Rapid Vienna,9720,3,8,9,7,33,27,6,33
LASK Linz,9720,4,8,6,10,27,31,-4,30
Mattersburg,9720,5,7,5,12,31,39,-8,26
Vienna,9720,6,7,5,12,25,41,-16,26
SC Rheindorf,9720,7,6,5,13,19,31,-12,23
FC Salzburg,9721,1,15,7,2,44,18,26,52
SK Sturm Gra,9721,2,12,4,8,32,28,4,40
Rapid Vienna,9721,3,8,11,5,38,29,9,35
LASK Linz,9721,4,8,5,11,27,30,-3,29
SC Rheindorf,9721,5,7,5,12,23,31,-8,26
Vienna,9721,6,7,5,12,26,40,-14,26
Mattersburg,9721,7,6,5,13,29,43,-14,23
FC Salzburg,9722,1,14,6,4,44,22,22,48
SK Sturm Gra,9722,2,12,4,8,31,32,-1,40
Rapid Vienna,9722,3,9,10,5,42,26,16,37
LASK Linz,9722,4,9,6,9,30,29,1,33
Vienna,9722,5,7,6,11,25,38,-13,27
Mattersburg,9722,6,6,7,11,32,42,-10,25
SC Rheindorf,9722,7,5,5,14,19,34,-15,20
FC Salzburg,9723,1,15,6,3,43,17,26,51
SK Sturm Gra,9723,2,13,4,7,32,27,5,43
Rapid Vienna,9723,3,10,9,5,36,27,9,39
LASK Linz,9723,4,8,6,10,25,27,-2,30
Vienna,9723,5,7,5,12,28,40,-12,26
SC Rheindorf,9723,6,5,6,13,19,30,-11,21
Mattersburg,9723,7,5,6,13,29,44,-15,21
FC Salzburg,9724,1,16,6,2,44,16,28,54
Rapid Vienna,9724,2,10,9,5,39,27,12,39
SK Sturm Gra,9724,3,11,5,8,30,28,2,38
LASK Linz,9724,4,7,7,10,24,29,-5,28
Mattersburg,9724,5,7,5,12,32,41,-9,26
Vienna,9724,6,7,5,12,24,38,-14,26
SC Rheindorf,9724,7,4,7,13,18,32,-14,19
FC Salzburg,9725,1,14,7,3,52,21,31,49
SK Sturm Gra,9725,2,13,3,8,33,31,2,42
Rapid Vienna,9725,3,9,10,5,41,27,14,37
LASK Linz,9725,4,8,6,10,27,34,-7,30
Mattersburg,9725,5,6,8,10,32,41,-9,26
Vienna,9725,6,6,6,12,24,44,-20,24
SC Rheindorf,9725,7,5,6,13,19,30,-11,21
FC Salzburg,9726,1,14,8,2,44,17,27,50
SK Sturm Gra,9726,2,11,6,7,29,26,3,39
Rapid Vienna,9726,3,8,10,6,35,27,8,34
LASK Linz,9726,4,9,6,9,27,28,-1,33
Vienna,9726,5,7,5,12,28,41,-13,26
Mattersburg,9726,6,6,6,12,29,42,-13,24
SC Rheindorf,9726,7,5,7,12,17,28,-11,22
FC Salzburg,9727,1,15,6,3,52,18,34,51
SK Sturm Gra,9727,2,13,3,8,32,30,2,42
Rapid Vienna,9727,3,9,9,6,38,29,9,36
LASK Linz,9727,4,9,5,10,31,33,-2,32
Vienna,9727,5,7,5,12,27,43,-16,26
SC Rheindorf,9727,6,6,5,13,21,32,-11,23
Mattersburg,9727,7,6,5,13,32,48,-16,23
FC Salzburg,9728,1,14,6,4,48,20,28,48
SK Sturm Gra,9728,2,13,5,6,33,26,7,44
Rapid Vienna,9728,3,8,11,5,37,30,7,35
LASK Linz,9728,4,8,5,11,26,32,-6,29
Mattersburg,9728,5,7,7,10,34,39,-5,28
Vienna,9728,6,6,6,12,25,44,-19,24
SC Rheindorf,9728,7,4,8,12,15,27,-12,20
FC Salzburg,9729,1,13,8,3,46,22,24,47
Rapid Vienna,9729,2,10,9,5,40,28,12,39
SK Sturm Gra,9729,3,11,5,8,30,30,0,38
LASK Linz,9729,4,9,5,10,28,32,-4,32
Mattersburg,9729,5,7,6,11,31,38,-7,27
Vienna,9729,6,6,7,11,25,39,-14,25
SC Rheindorf,9729,7,5,6,13,20,31,-11,21
FC Salzburg,9730,1,14,7,3,48,19,29,49
SK Sturm Gra,9730,2,13,3,8,32,30,2,42
Rapid Vienna,9730,3,8,11,5,37,28,9,35
LASK Linz,9730,4,7,7,10,27,30,-3,28
Mattersburg,9730,5,7,6,11,34,46,-12,27
Vienna,9730,6,7,5,12,25,40,-15,26
SC Rheindorf,9730,7,6,5,13,19,29,-10,23
FC Salzburg,9731,1,16,6,2,47,16,31,54
SK Sturm Gra,9731,2,12,5,7,34,32,2,41
Rapid Vienna,9731,3,9,10,5,39,29,10,37
LASK Linz,9731,4,8,6,10,27,31,-4,30
Mattersburg,9731,5,6,6,12,31,43,-12,24
Vienna,9731,6,6,6,12,25,40,-15,24
SC Rheindorf,9731,7,5,5,14,19,31,-12,20
FC Salzburg,9732,1,14,7,3,46,21,25,49
SK Sturm Gra,9732,2,13,3,8,31,30,1,42
Rapid Vienna,9732,3,10,10,4,38,24,14,40
LASK Linz,9732,4,9,6,9,28,26,2,33
Mattersburg,9732,5,6,6,12,30,43,-13,24
Vienna,9732,6,6,5,13,25,41,-16,23
SC Rheindorf,9732,7,5,5,14,17,30,-13,20
FC Salzburg,9733,1,13,8,3,43,21,22,47
SK Sturm Gra,9733,2,11,5,8,35,34,1,38
Rapid Vienna,9733,3,8,10,6,37,30,7,34
LASK Linz,9733,4,8,7,9,27,28,-1,31
Vienna,9733,5,8,5,11,27,38,-11,29
Mattersburg,9733,6,7,6,11,30,39,-9,27
SC Rheindorf,9733,7,5,7,12,19,28,-9,22
FC Salzburg,9734,1,16,6,2,52,17,35,54
SK Sturm Gra,9734,2,12,3,9,33,36,-3,39
Rapid Vienna,9734,3,9,9,6,39,30,9,36
LASK Linz,9734,4,9,6,9,29,30,-1,33
Vienna,9734,5,6,6,12,24,39,-15,24
Mattersburg,9734,6,5,8,11,30,44,-14,23
SC Rheindorf,9734,7,5,6,13,20,31,-11,21
FC Salzburg,9735,1,15,6,3,45,18,27,51
SK Sturm Gra,9735,2,13,4,7,32,26,6,43
Rapid Vienna,9735,3,9,9,6,35,28,7,36
LASK Linz,9735,4,8,5,11,25,32,-7,29
Mattersburg,9735,5,8,5,11,31,39,-8,29
Vienna,9735,6,6,5,13,25,41,-16,23
SC Rheindorf,9735,7,5,6,13,19,28,-9,21
FC Salzburg,9736,1,15,7,2,48,18,30,52
SK Sturm Gra,9736,2,11,5,8,31,32,-1,38
Rapid Vienna,9736,3,9,9,6,41,31,10,36
LASK Linz,9736,4,9,6,9,28,27,1,33
Vienna,9736,5,7,5,12,27,42,-15,26
Mattersburg,9736,6,6,7,11,30,41,-11,25
SC Rheindorf,9736,7,4,7,13,18,32,-14,19
FC Salzburg,9737,1,13,7,4,41,19,22,46
SK Sturm Gra,9737,2,13,3,8,34,28,6,42
Rapid Vienna,9737,3,10,10,4,39,28,11,40
Mattersburg,9737,4,8,6,10,33,38,-5,30
LASK Linz,9737,5,8,5,11,27,31,-4,29
Vienna,9737,6,7,5,12,25,39,-14,26
SC Rheindorf,9737,7,4,6,14,16,32,-16,18
FC Salzburg,9738,1,14,7,3,46,22,24,49
SK Sturm Gra,9738,2,13,3,8,33,30,3,42
Rapid Vienna,9738,3,10,9,5,39,28,11,39
LASK Linz,9738,4,7,6,11,26,31,-5,27
Vienna,9738,5,7,6,11,26,39,-13,27
SC Rheindorf,9738,6,6,6,12,22,30,-8,24
Mattersburg,9738,7,6,5,13,33,45,-12,23
FC Salzburg,9739,1,15,6,3,48,19,29,51
SK Sturm Gra,9739,2,12,4,8,34,34,0,40
Rapid Vienna,9739,3,9,9,6,36,28,8,36
LASK Linz,9739,4,8,6,10,26,30,-4,30
Vienna,9739,5,7,6,11,28,41,-13,27
Mattersburg,9739,6,6,6,12,32,43,-11,24
SC Rheindorf,9739,7,6,5,13,21,30,-9,23
FC Salzburg,9740,1,15,6,3,46,17,29,51
SK Sturm Gra,9740,2,14,3,7,33,28,5,45
Rapid Vienna,9740,3,9,10,5,39,30,9,37
LASK Linz,9740,4,9,6,9,29,29,0,33
Mattersburg,9740,5,6,6,12,29,41,-12,24
Vienna,9740,6,6,5,13,24,42,-18,23
SC Rheindorf,9740,7,4,6,14,19,32,-13,18
FC Salzburg,9741,1,13,7,4,42,20,22,46
SK Sturm Gra,9741,2,13,3,8,33,29,4,42
Rapid Vienna,9741,3,10,10,4,38,27,11,40
LASK Linz,9741,4,8,6,10,26,29,-3,30
Mattersburg,9741,5,7,6,11,32,39,-7,27
Vienna,9741,6,6,5,13,24,40,-16,23
SC Rheindorf,9741,7,5,7,12,21,32,-11,22
FC Salzburg,9742,1,14,7,3,46,17,29,49
SK Sturm Gra,9742,2,13,3,8,32,28,4,42
LASK Linz,9742,3,9,6,9,27,28,-1,33
Rapid Vienna,9742,4,7,11,6,33,27,6,32
Vienna,9742,5,8,5,11,27,39,-12,29
Mattersburg,9742,6,6,5,13,30,45,-15,23
SC Rheindorf,9742,7,5,7,12,18,29,-11,22
FC Salzburg,9743,1,15,6,3,45,18,27,51
SK Sturm Gra,9743,2,13,3,8,32,30,2,42
Rapid Vienna,9743,3,10,10,4,43,27,16,40
LASK Linz,9743,4,7,7,10,24,29,-5,28
Mattersburg,9743,5,7,6,11,33,40,-7,27
Vienna,9743,6,6,5,13,25,43,-18,23
SC Rheindorf,9743,7,4,7,13,18,33,-15,19
FC Salzburg,9744,1,14,8,2,47,19,28,50
SK Sturm Gra,9744,2,11,5,8,32,33,-1,38
Rapid Vienna,9744,3,8,11,5,38,29,9,35
LASK Linz,9744,4,8,8,8,29,28,1,32
SC Rheindorf,9744,5,6,6,12,22,29,-7,24
Mattersburg,9744,6,6,6,12,30,45,-15,24
Vienna,9744,7,6,6,12,25,40,-15,24
FC Salzburg,9745,1,13,8,3,42,19,23,47
SK Sturm Gra,9745,2,13,3,8,33,31,2,42
Rapid Vienna,9745,3,10,9,5,42,27,15,39
LASK Linz,9745,4,9,6,9,26,27,-1,33
Mattersburg,9745,5,6,7,11,30,40,-10,25
Vienna,9745,6,6,6,12,24,39,-15,24
SC Rheindorf,9745,7,5,5,14,20,34,-14,20
FC Salzburg,9746,1,16,6,2,43,16,27,54
SK Sturm Gra,9746,2,13,4,7,32,27,5,43
Rapid Vienna,9746,3,7,10,7,34,30,4,31
LASK Linz,9746,4,8,6,10,26,28,-2,30
Mattersburg,9746,5,8,5,11,32,39,-7,29
Vienna,9746,6,6,5,13,23,39,-16,23
SC Rheindorf,9746,7,4,8,12,20,31,-11,20
FC Salzburg,9747,1,14,7,3,46,18,28,49
Rapid Vienna,9747,2,9,11,4,36,25,11,38
SK Sturm Gra,9747,3,11,5,8,28,28,0,38
LASK Linz,9747,4,7,8,9,24,26,-2,29
Vienna,9747,5,7,5,12,27,40,-13,26
Mattersburg,9747,6,7,5,12,33,48,-15,26
SC Rheindorf,9747,7,5,7,12,21,30,-9,22
FC Salzburg,9748,1,15,6,3,46,19,27,51
SK Sturm Gra,9748,2,12,4,8,31,29,2,40
Rapid Vienna,9748,3,8,11,5,33,25,8,35
Vienna,9748,4,8,5,11,27,38,-11,29
LASK Linz,9748,5,7,7,10,26,32,-6,28
Mattersburg,9748,6,6,6,12,34,43,-9,24
SC Rheindorf,9748,7,5,7,12,20,31,-11,22
FC Salzburg,9749,1,15,7,2,43,15,28,52
SK Sturm Gra,9749,2,12,5,7,29,25,4,41
LASK Linz,9749,3,10,6,8,29,25,4,36
Rapid Vienna,9749,4,7,9,8,32,28,4,30
SC Rheindorf,9749,5,7,5,12,18,28,-10,26
Vienna,9749,6,7,5,12,25,39,-14,26
Mattersburg,9749,7,5,5,14,27,43,-16,20
FC Salzburg,9750,1,16,6,2,48,19,29,54
SK Sturm Gra,9750,2,12,3,9,32,32,0,39
LASK Linz,9750,3,9,7,8,32,27,5,34
Rapid Vienna,9750,4,7,11,6,35,30,5,32
Mattersburg,9750,5,6,6,12,29,42,-13,24
SC Rheindorf,9750,6,5,8,11,20,28,-8,23
Vienna,9750,7,6,5,13,24,42,-18,23
FC Salzburg,9751,1,14,7,3,45,21,24,49
SK Sturm Gra,9751,2,14,4,6,36,28,8,46
Rapid Vienna,9751,3,9,9,6,37,28,9,36
LASK Linz,9751,4,9,6,9,30,29,1,33
Vienna,9751,5,6,6,12,24,39,-15,24
Mattersburg,9751,6,5,8,11,31,42,-11,23
SC Rheindorf,9751,7,4,6,14,17,33,-16,18
FC Salzburg,9752,1,15,7,2,46,20,26,52
SK Sturm Gra,9752,2,12,4,8,32,29,3,40
Rapid Vienna,9752,3,9,10,5,35,24,11,37
Vienna,9752,4,7,6,11,28,39,-11,27
LASK Linz,9752,5,7,5,12,25,31,-6,26
Mattersburg,9752,6,7,5,12,34,44,-10,26
SC Rheindorf,9752,7,6,5,13,19,32,-13,23
FC Salzburg,9753,1,13,8,3,41,18,23,47
SK Sturm Gra,9753,2,12,5,7,33,31,2,41
Rapid Vienna,9753,3,10,10,4,38,24,14,40
LASK Linz,9753,4,9,5,10,31,32,-1,32
Vienna,9753,5,6,6,12,24,39,-15,24
SC Rheindorf,9753,6,5,7,12,19,28,-9,22
Mattersburg,9753,7,5,7,12,29,43,-14,22
FC Salzburg,9754,1,13,6,5,41,19,22,45
SK Sturm Gra,9754,2,13,5,6,34,26,8,44
Rapid Vienna,9754,3,9,10,5,34,27,7,37
LASK Linz,9754,4,8,8,8,28,28,0,32
Vienna,9754,5,7,6,11,24,37,-13,27
Mattersburg,9754,6,6,7,11,31,42,-11,25
SC Rheindorf,9754,7,4,6,14,19,32,-13,18
FC Salzburg,9755,1,16,6,2,55,19,36,54
SK Sturm Gra,9755,2,12,4,8,32,31,1,40
Rapid Vienna,9755,3,8,10,6,40,31,9,34
LASK Linz,9755,4,8,6,10,28,34,-6,30
Vienna,9755,5,7,5,12,26,44,-18,26
SC Rheindorf,9755,6,6,6,12,22,29,-7,24
Mattersburg,9755,7,6,5,13,34,49,-15,23
SK Sturm Gra,9756,1,14,4,6,34,25,9,46
FC Salzburg,9756,2,13,6,5,42,19,23,45
Rapid Vienna,9756,3,8,10,6,34,33,1,34
LASK Linz,9756,4,8,5,11,28,31,-3,29
Vienna,9756,5,8,5,11,27,37,-10,29
Mattersburg,9756,6,7,6,11,31,41,-10,27
SC Rheindorf,9756,7,5,6,13,20,30,-10,21
FC Salzburg,9757,1,15,6,3,52,21,31,51
SK Sturm Gra,9757,2,14,3,7,33,28,5,45
Rapid Vienna,9757,3,7,10,7,33,30,3,31
Mattersburg,9757,4,8,6,10,39,42,-3,30
LASK Linz,9757,5,7,6,11,25,29,-4,27
SC Rheindorf,9757,6,6,6,12,23,30,-7,24
Vienna,9757,7,6,5,13,24,49,-25,23
FC Salzburg,9758,1,15,7,2,46,16,30,52
SK Sturm Gra,9758,2,13,3,8,37,27,10,42
Rapid Vienna,9758,3,10,10,4,39,27,12,40
LASK Linz,9758,4,8,6,10,25,32,-7,30
Mattersburg,9758,5,7,5,12,31,45,-14,26
Vienna,9758,6,6,5,13,25,41,-16,23
SC Rheindorf,9758,7,4,6,14,17,32,-15,18
FC Salzburg,9759,1,15,6,3,49,21,28,51
SK Sturm Gra,9759,2,14,3,7,33,27,6,45
Rapid Vienna,9759,3,8,9,7,37,31,6,33
LASK Linz,9759,4,9,5,10,32,30,2,32
SC Rheindorf,9759,5,7,5,12,19,28,-9,26
Vienna,9759,6,7,5,12,25,41,-16,26
Mattersburg,9759,7,5,5,14,30,47,-17,20
FC Salzburg,9760,1,16,6,2,47,17,30,54
SK Sturm Gra,9760,2,12,5,7,32,28,4,41
LASK Linz,9760,3,9,7,8,28,27,1,34
Rapid Vienna,9760,4,7,9,8,35,33,2,30
SC Rheindorf,9760,5,6,6,12,21,29,-8,24
Vienna,9760,6,6,6,12,25,41,-16,24
Mattersburg,9760,7,5,7,12,29,42,-13,22
FC Salzburg,9761,1,14,6,4,43,18,25,48
Rapid Vienna,9761,2,10,9,5,38,29,9,39
SK Sturm Gra,9761,3,11,4,9,30,32,-2,37
LASK Linz,9761,4,9,6,9,29,28,1,33
Vienna,9761,5,8,5,11,28,39,-11,29
Mattersburg,9761,6,6,5,13,32,43,-11,23
SC Rheindorf,9761,7,6,5,13,19,30,-11,23
FC Salzburg,9762,1,15,6,3,52,19,33,51
SK Sturm Gra,9762,2,12,4,8,33,31,2,40
Rapid Vienna,9762,3,9,10,5,34,25,9,37
LASK Linz,9762,4,9,6,9,29,30,-1,33
Mattersburg,9762,5,6,7,11,31,47,-16,25
Vienna,9762,6,6,5,13,25,42,-17,23
SC Rheindorf,9762,7,5,6,13,22,32,-10,21
FC Salzburg,9763,1,14,7,3,41,16,25,49
SK Sturm Gra,9763,2,13,5,6,32,26,6,44
Rapid Vienna,9763,3,8,10,6,34,27,7,34
LASK Linz,9763,4,9,6,9,31,29,2,33
Vienna,9763,5,7,6,11,26,39,-13,27
Mattersburg,9763,6,5,8,11,32,44,-12,23
SC Rheindorf,9763,7,4,6,14,18,33,-15,18
FC Salzburg,9764,1,14,8,2,45,19,26,50
SK Sturm Gra,9764,2,14,3,7,34,28,6,45
Rapid Vienna,9764,3,8,10,6,35,27,8,34
LASK Linz,9764,4,9,5,10,30,30,0,32
Mattersburg,9764,5,6,7,11,34,40,-6,25
Vienna,9764,6,6,6,12,26,46,-20,24
SC Rheindorf,9764,7,4,7,13,16,30,-14,19
FC Salzburg,9765,1,16,6,2,46,17,29,54
SK Sturm Gra,9765,2,14,3,7,32,27,5,45
Rapid Vienna,9765,3,8,9,7,35,28,7,33
LASK Linz,9765,4,8,6,10,24,26,-2,30
Vienna,9765,5,7,5,12,27,41,-14,26
SC Rheindorf,9765,6,6,5,13,20,30,-10,23
Mattersburg,9765,7,5,6,13,29,44,-15,21
FC Salzburg,9766,1,14,7,3,43,19,24,49
SK Sturm Gra,9766,2,13,3,8,35,29,6,42
Rapid Vienna,9766,3,10,10,4,35,24,11,40
Mattersburg,9766,4,8,6,10,36,40,-4,30
LASK Linz,9766,5,8,5,11,26,30,-4,29
Vienna,9766,6,6,5,13,24,42,-18,23
SC Rheindorf,9766,7,4,6,14,16,31,-15,18
FC Salzburg,9767,1,14,7,3,43,19,24,49
SK Sturm Gra,9767,2,13,4,7,35,29,6,43
Rapid Vienna,9767,3,8,10,6,34,28,6,34
LASK Linz,9767,4,8,7,9,26,28,-2,31
Vienna,9767,5,7,5,12,27,40,-13,26
Mattersburg,9767,6,6,7,11,32,43,-11,25
SC Rheindorf,9767,7,5,6,13,19,29,-10,21
FC Salzburg,9768,1,15,7,2,49,20,29,52
SK Sturm Gra,9768,2,13,3,8,34,31,3,42
Rapid Vienna,9768,3,8,10,6,36,30,6,34
LASK Linz,9768,4,9,5,10,29,30,-1,32
Mattersburg,9768,5,8,5,11,32,39,-7,29
Vienna,9768,6,6,5,13,25,41,-16,23
SC Rheindorf,9768,7,5,5,14,17,31,-14,20
FC Salzburg,9769,1,14,8,2,45,18,27,50
SK Sturm Gra,9769,2,12,4,8,31,29,2,40
LASK Linz,9769,3,10,6,8,31,24,7,36
Rapid Vienna,9769,4,7,11,6,32,29,3,32
Mattersburg,9769,5,7,7,10,31,39,-8,28
Vienna,9769,6,6,5,13,23,40,-17,23
SC Rheindorf,9769,7,4,7,13,17,31,-14,19
FC Salzburg,9770,1,16,6,2,47,18,29,54
Rapid Vienna,9770,2,9,10,5,38,25,13,37
SK Sturm Gra,9770,3,11,4,9,29,35,-6,37
LASK Linz,9770,4,7,7,10,23,26,-3,28
Mattersburg,9770,5,7,5,12,31,42,-11,26
Vienna,9770,6,7,5,12,25,38,-13,26
SC Rheindorf,9770,7,5,7,12,19,28,-9,22
FC Salzburg,9771,1,15,6,3,51,17,34,51
SK Sturm Gra,9771,2,14,3,7,34,26,8,45
Rapid Vienna,9771,3,8,10,6,35,30,5,34
LASK Linz,9771,4,9,5,10,27,29,-2,32
Mattersburg,9771,5,7,6,11,33,44,-11,27
Vienna,9771,6,6,6,12,24,42,-18,24
SC Rheindorf,9771,7,4,6,14,18,34,-16,18
FC Salzburg,9772,1,15,7,2,46,16,30,52
SK Sturm Gra,9772,2,11,5,8,35,33,2,38
Rapid Vienna,9772,3,7,12,5,37,31,6,33
LASK Linz,9772,4,8,8,8,27,26,1,32
Vienna,9772,5,7,5,12,26,41,-15,26
Mattersburg,9772,6,5,8,11,28,41,-13,23
SC Rheindorf,9772,7,5,7,12,20,31,-11,22
FC Salzburg,9773,1,14,7,3,44,18,26,49
SK Sturm Gra,9773,2,14,3,7,33,30,3,45
Rapid Vienna,9773,3,8,10,6,36,30,6,34
LASK Linz,9773,4,8,5,11,26,29,-3,29
Vienna,9773,5,7,5,12,29,38,-9,26
SC Rheindorf,9773,6,6,6,12,22,29,-7,24
Mattersburg,9773,7,6,6,12,30,46,-16,24
FC Salzburg,9774,1,16,6,2,49,17,32,54
SK Sturm Gra,9774,2,13,4,7,34,29,5,43
Rapid Vienna,9774,3,9,9,6,38,30,8,36
LASK Linz,9774,4,7,6,11,30,34,-4,27
Vienna,9774,5,7,5,12,25,41,-16,26
Mattersburg,9774,6,6,6,12,32,43,-11,24
SC Rheindorf,9774,7,5,6,13,18,32,-14,21
FC Salzburg,9775,1,16,6,2,51,17,34,54
SK Sturm Gra,9775,2,11,4,9,31,32,-1,37
Rapid Vienna,9775,3,9,9,6,35,28,7,36
LASK Linz,9775,4,9,6,9,28,29,-1,33
SC Rheindorf,9775,5,7,5,12,24,29,-5,26
Vienna,9775,6,6,6,12,25,41,-16,24
Mattersburg,9775,7,5,6,13,30,48,-18,21
FC Salzburg,9776,1,14,8,2,45,18,27,50
SK Sturm Gra,9776,2,13,3,8,33,31,2,42
LASK Linz,9776,3,10,6,8,31,28,3,36
Rapid Vienna,9776,4,8,10,6,36,29,7,34
Vienna,9776,5,7,6,11,27,40,-13,27
Mattersburg,9776,6,6,5,13,32,43,-11,23
SC Rheindorf,9776,7,4,6,14,17,32,-15,18
FC Salzburg,9777,1,14,7,3,42,18,24,49
SK Sturm Gra,9777,2,11,4,9,28,33,-5,37
Rapid Vienna,9777,3,8,10,6,37,30,7,34
LASK Linz,9777,4,9,7,8,30,26,4,34
Vienna,9777,5,8,5,11,26,37,-11,29
Mattersburg,9777,6,6,6,12,28,40,-12,24
SC Rheindorf,9777,7,5,7,12,23,30,-7,22
FC Salzburg,9778,1,14,7,3,45,17,28,49
SK Sturm Gra,9778,2,14,4,6,34,25,9,46
Rapid Vienna,9778,3,7,10,7,32,33,-1,31
LASK Linz,9778,4,8,7,9,26,28,-2,31
Mattersburg,9778,5,7,6,11,30,38,-8,27
SC Rheindorf,9778,6,6,5,13,19,27,-8,23
Vienna,9778,7,6,5,13,23,41,-18,23
FC Salzburg,9779,1,15,7,2,46,18,28,52
SK Sturm Gra,9779,2,12,3,9,32,31,1,39
Rapid Vienna,9779,3,9,10,5,37,26,11,37
LASK Linz,9779,4,10,5,9,29,26,3,35
Vienna,9779,5,7,5,12,25,40,-15,26
Mattersburg,9779,6,6,6,12,30,41,-11,24
SC Rheindorf,9779,7,4,6,14,16,33,-17,18
FC Salzburg,9780,1,14,7,3,44,19,25,49
SK Sturm Gra,9780,2,12,4,8,33,32,1,40
LASK Linz,9780,3,10,6,8,34,30,4,36
Rapid Vienna,9780,4,8,10,6,37,29,8,34
SC Rheindorf,9780,5,7,5,12,19,26,-7,26
Vienna,9780,6,7,5,12,25,39,-14,26
Mattersburg,9780,7,5,5,14,29,46,-17,20
FC Salzburg,9781,1,14,8,2,44,17,27,50
SK Sturm Gra,9781,2,12,5,7,33,26,7,41
LASK Linz,9781,3,9,6,9,29,25,4,33
Rapid Vienna,9781,4,8,9,7,34,33,1,33
Mattersburg,9781,5,6,7,11,31,43,-12,25
Vienna,9781,6,6,6,12,24,39,-15,24
SC Rheindorf,9781,7,5,7,12,18,30,-12,22
FC Salzburg,9782,1,14,7,3,47,20,27,49
SK Sturm Gra,9782,2,14,4,6,33,26,7,46
Rapid Vienna,9782,3,8,9,7,35,28,7,33
LASK Linz,9782,4,8,6,10,26,28,-2,30
SC Rheindorf,9782,5,6,6,12,20,29,-9,24
Mattersburg,9782,6,6,6,12,29,44,-15,24
Vienna,9782,7,6,6,12,25,40,-15,24
FC Salzburg,9783,1,15,6,3,47,19,28,51
SK Sturm Gra,9783,2,12,3,9,31,31,0,39
LASK Linz,9783,3,9,7,8,30,27,3,34
Rapid Vienna,9783,4,8,9,7,34,31,3,33
Vienna,9783,5,8,5,11,29,40,-11,29
SC Rheindorf,9783,6,6,6,12,22,28,-6,24
Mattersburg,9783,7,5,6,13,29,46,-17,21
FC Salzburg,9784,1,14,6,4,41,17,24,48
SK Sturm Gra,9784,2,13,3,8,32,29,3,42
Rapid Vienna,9784,3,9,10,5,35,26,9,37
Vienna,9784,4,8,5,11,27,38,-11,29
LASK Linz,9784,5,7,6,11,25,30,-5,27
Mattersburg,9784,6,6,6,12,29,40,-11,24
SC Rheindorf,9784,7,5,8,11,18,27,-9,23
FC Salzburg,9785,1,15,6,3,44,18,26,51
SK Sturm Gra,9785,2,11,6,7,32,29,3,39
Rapid Vienna,9785,3,9,10,5,41,33,8,37
LASK Linz,9785,4,9,6,9,30,30,0,33
Mattersburg,9785,5,6,7,11,37,44,-7,25
Vienna,9785,6,6,6,12,28,44,-16,24
SC Rheindorf,9785,7,4,7,13,21,35,-14,19
FC Salzburg,9786,1,15,6,3,46,17,29,51
Rapid Vienna,9786,2,10,9,5,39,29,10,39
SK Sturm Gra,9786,3,11,3,10,33,38,-5,36
Mattersburg,9786,4,9,5,10,38,38,0,32
LASK Linz,9786,5,8,6,10,28,32,-4,30
Vienna,9786,6,6,5,13,23,42,-19,23
SC Rheindorf,9786,7,5,6,13,21,32,-11,21
FC Salzburg,9787,1,15,7,2,52,18,34,52
SK Sturm Gra,9787,2,14,3,7,35,33,2,45
Rapid Vienna,9787,3,8,9,7,36,28,8,33
LASK Linz,9787,4,9,5,10,25,28,-3,32
Mattersburg,9787,5,7,6,11,34,40,-6,27
Vienna,9787,6,6,5,13,26,47,-21,23
SC Rheindorf,9787,7,5,5,14,20,34,-14,20
FC Salzburg,9788,1,13,6,5,39,19,20,45
SK Sturm Gra,9788,2,13,4,7,34,29,5,43
Rapid Vienna,9788,3,11,9,4,39,26,13,42
LASK Linz,9788,4,7,7,10,27,30,-3,28
Vienna,9788,5,7,5,12,25,39,-14,26
Mattersburg,9788,6,6,6,12,28,39,-11,24
SC Rheindorf,9788,7,5,7,12,21,31,-10,22
FC Salzburg,9789,1,15,6,3,48,18,30,51
SK Sturm Gra,9789,2,11,5,8,28,27,1,38
Rapid Vienna,9789,3,9,10,5,36,26,10,37
LASK Linz,9789,4,9,6,9,28,27,1,33
Mattersburg,9789,5,7,5,12,35,46,-11,26
SC Rheindorf,9789,6,6,5,13,17,32,-15,23
Vienna,9789,7,6,5,13,26,42,-16,23
FC Salzburg,9790,1,14,6,4,40,18,22,48
Rapid Vienna,9790,2,9,11,4,35,24,11,38
SK Sturm Gra,9790,3,11,4,9,29,30,-1,37
LASK Linz,9790,4,9,7,8,30,28,2,34
Mattersburg,9790,5,8,6,10,36,40,-4,30
Vienna,9790,6,6,5,13,23,41,-18,23
SC Rheindorf,9790,7,5,5,14,22,34,-12,20
FC Salzburg,9791,1,16,6,2,49,16,33,54
SK Sturm Gra,9791,2,13,4,7,33,28,5,43
Rapid Vienna,9791,3,8,10,6,36,31,5,34
LASK Linz,9791,4,8,5,11,28,30,-2,29
Vienna,9791,5,7,5,12,24,41,-17,26
SC Rheindorf,9791,6,5,8,11,19,28,-9,23
Mattersburg,9791,7,5,6,13,28,43,-15,21
FC Salzburg,9792,1,15,6,3,47,23,24,51
SK Sturm Gra,9792,2,12,4,8,34,32,2,40
Rapid Vienna,9792,3,9,9,6,40,30,10,36
LASK Linz,9792,4,8,7,9,29,30,-1,31
SC Rheindorf,9792,5,7,5,12,23,30,-7,26
Vienna,9792,6,7,5,12,26,40,-14,26
Mattersburg,9792,7,5,6,13,28,42,-14,21
FC Salzburg,9793,1,15,6,3,43,18,25,51
SK Sturm Gra,9793,2,12,5,7,32,28,4,41
Rapid Vienna,9793,3,8,10,6,35,28,7,34
LASK Linz,9793,4,8,7,9,30,29,1,31
Mattersburg,9793,5,6,8,10,33,42,-9,26
Vienna,9793,6,6,6,12,25,40,-15,24
SC Rheindorf,9793,7,5,6,13,18,31,-13,21
FC Salzburg,9794,1,16,6,2,49,17,32,54
SK Sturm Gra,9794,2,13,3,8,32,28,4,42
Rapid Vienna,9794,3,8,10,6,34,27,7,34
LASK Linz,9794,4,8,6,10,25,28,-3,30
SC Rheindorf,9794,5,6,6,12,21,30,-9,24
Vienna,9794,6,6,6,12,23,39,-16,24
Mattersburg,9794,7,5,7,12,29,44,-15,22
FC Salzburg,9795,1,14,6,4,43,22,21,48
SK Sturm Gra,9795,2,13,3,8,35,27,8,42
LASK Linz,9795,3,10,6,8,32,28,4,36
Rapid Vienna,9795,4,8,10,6,36,31,5,34
Vienna,9795,5,7,5,12,25,38,-13,26
Mattersburg,9795,6,6,6,12,30,43,-13,24
SC Rheindorf,9795,7,5,6,13,20,32,-12,21
FC Salzburg,9796,1,13,9,2,42,17,25,48
SK Sturm Gra,9796,2,13,4,7,35,27,8,43
Rapid Vienna,9796,3,9,11,4,37,26,11,38
Mattersburg,9796,4,8,6,10,33,37,-4,30
LASK Linz,9796,5,8,5,11,28,32,-4,29
Vienna,9796,6,6,5,13,23,42,-19,23
SC Rheindorf,9796,7,4,6,14,16,33,-17,18
FC Salzburg,9797,1,14,7,3,48,22,26,49
Rapid Vienna,9797,2,10,10,4,39,28,11,40
SK Sturm Gra,9797,3,11,5,8,30,28,2,38
LASK Linz,9797,4,8,6,10,26,28,-2,30
Vienna,9797,5,7,5,12,30,40,-10,26
SC Rheindorf,9797,6,5,8,11,20,28,-8,23
Mattersburg,9797,7,6,5,13,27,46,-19,23
FC Salzburg,9798,1,15,6,3,49,21,28,51
SK Sturm Gra,9798,2,12,4,8,30,28,2,40
Rapid Vienna,9798,3,9,9,6,37,30,7,36
LASK Linz,9798,4,9,6,9,28,29,-1,33
Mattersburg,9798,5,7,6,11,33,41,-8,27
Vienna,9798,6,6,6,12,26,41,-15,24
SC Rheindorf,9798,7,4,7,13,17,30,-13,19
FC Salzburg,9799,1,13,8,3,43,19,24,47
SK Sturm Gra,9799,2,13,4,7,36,29,7,43
Rapid Vienna,9799,3,10,9,5,36,26,10,39
LASK Linz,9799,4,8,6,10,28,33,-5,30
Vienna,9799,5,7,5,12,26,40,-14,26
Mattersburg,9799,6,6,6,12,30,42,-12,24
SC Rheindorf,9799,7,5,6,13,17,27,-10,21
FC Salzburg,9800,1,14,8,2,46,20,26,50
SK Sturm Gra,9800,2,13,4,7,35,28,7,43
LASK Linz,9800,3,9,7,8,30,27,3,34
Rapid Vienna,9800,4,7,9,8,34,32,2,30
Vienna,9800,5,7,5,12,29,42,-13,26
Mattersburg,9800,6,6,7,11,33,44,-11,25
SC Rheindorf,9800,7,5,6,13,18,32,-14,21
FC Salzburg,9801,1,14,6,4,47,22,25,48
Rapid Vienna,9801,2,10,10,4,40,27,13,40
SK Sturm Gra,9801,3,12,4,8,32,32,0,40
LASK Linz,9801,4,9,6,9,26,26,0,33
Mattersburg,9801,5,7,5,12,32,44,-12,26
Vienna,9801,6,6,5,13,24,41,-17,23
SC Rheindorf,9801,7,5,6,13,22,31,-9,21
FC Salzburg,9802,1,15,7,2,46,17,29,52
SK Sturm Gra,9802,2,13,4,7,34,30,4,43
Rapid Vienna,9802,3,8,9,7,33,29,4,33
LASK Linz,9802,4,9,6,9,28,28,0,33
Vienna,9802,5,6,7,11,26,40,-14,25
Mattersburg,9802,6,5,7,12,33,46,-13,22
SC Rheindorf,9802,7,5,6,13,21,31,-10,21
FC Salzburg,9803,1,15,7,2,48,20,28,52
SK Sturm Gra,9803,2,12,5,7,35,29,6,41
Rapid Vienna,9803,3,9,11,4,38,27,11,38
LASK Linz,9803,4,7,6,11,24,30,-6,27
Vienna,9803,5,7,5,12,26,41,-15,26
SC Rheindorf,9803,6,6,6,12,19,28,-9,24
Mattersburg,9803,7,5,6,13,29,44,-15,21
FC Salzburg,9804,1,14,6,4,47,18,29,48
SK Sturm Gra,9804,2,14,4,6,36,27,9,46
Rapid Vienna,9804,3,8,10,6,36,31,5,34
LASK Linz,9804,4,8,6,10,27,29,-2,30
Mattersburg,9804,5,6,7,11,33,45,-12,25
SC Rheindorf,9804,6,5,8,11,21,30,-9,23
Vienna,9804,7,6,5,13,23,43,-20,23
FC Salzburg,9805,1,14,7,3,47,21,26,49
SK Sturm Gra,9805,2,14,4,6,34,25,9,46
Rapid Vienna,9805,3,10,9,5,39,26,13,39
LASK Linz,9805,4,7,7,10,25,29,-4,28
Vienna,9805,5,6,6,12,25,40,-15,24
Mattersburg,9805,6,5,7,12,28,46,-18,22
SC Rheindorf,9805,7,5,6,13,19,30,-11,21
FC Salzburg,9806,1,14,8,2,48,18,30,50
Rapid Vienna,9806,2,9,11,4,37,25,12,38
SK Sturm Gra,9806,3,11,4,9,31,30,1,37
LASK Linz,9806,4,9,5,10,28,31,-3,32
Vienna,9806,5,6,7,11,27,41,-14,25
Mattersburg,9806,6,6,6,12,32,47,-15,24
SC Rheindorf,9806,7,5,7,12,20,31,-11,22
FC Salzburg,9807,1,15,6,3,43,19,24,51
Rapid Vienna,9807,2,10,10,4,37,24,13,40
SK Sturm Gra,9807,3,12,4,8,35,33,2,40
LASK Linz,9807,4,8,5,11,27,30,-3,29
Vienna,9807,5,7,5,12,26,40,-14,26
SC Rheindorf,9807,6,6,5,13,20,29,-9,23
Mattersburg,9807,7,6,5,13,29,42,-13,23
FC Salzburg,9808,1,14,6,4,43,19,24,48
Rapid Vienna,9808,2,10,10,4,38,26,12,40
SK Sturm Gra,9808,3,11,5,8,30,30,0,38
LASK Linz,9808,4,8,7,9,26,26,0,31
Mattersburg,9808,5,7,7,10,31,39,-8,28
Vienna,9808,6,6,6,12,23,38,-15,24
SC Rheindorf,9808,7,5,5,14,18,31,-13,20
FC Salzburg,9809,1,12,8,4,40,20,20,44
SK Sturm Gra,9809,2,12,5,7,30,27,3,41
Rapid Vienna,9809,3,9,11,4,37,25,12,38
LASK Linz,9809,4,8,7,9,26,27,-1,31
Vienna,9809,5,7,6,11,27,40,-13,27
SC Rheindorf,9809,6,6,6,12,21,28,-7,24
Mattersburg,9809,7,6,5,13,29,43,-14,23
FC Salzburg,9810,1,15,7,2,48,19,29,52
SK Sturm Gra,9810,2,13,5,6,34,28,6,44
Rapid Vienna,9810,3,7,11,6,33,27,6,32
LASK Linz,9810,4,8,8,8,30,29,1,32
Vienna,9810,5,6,6,12,24,39,-15,24
SC Rheindorf,9810,6,5,7,12,21,30,-9,22
Mattersburg,9810,7,5,6,13,30,48,-18,21
FC Salzburg,9811,1,15,6,3,43,19,24,51
SK Sturm Gra,9811,2,14,3,7,34,26,8,45
Rapid Vienna,9811,3,9,9,6,37,30,7,36
LASK Linz,9811,4,8,6,10,30,29,1,30
Mattersburg,9811,5,6,6,12,30,43,-13,24
Vienna,9811,6,6,6,12,25,40,-15,24
SC Rheindorf,9811,7,5,6,13,19,31,-12,21
FC Salzburg,9812,1,14,8,2,45,20,25,50
SK Sturm Gra,9812,2,12,4,8,30,27,3,40
Rapid Vienna,9812,3,9,11,4,38,28,10,38
LASK Linz,9812,4,7,8,9,26,28,-2,29
Mattersburg,9812,5,6,7,11,31,41,-10,25
Vienna,9812,6,6,6,12,27,42,-15,24
SC Rheindorf,9812,7,5,6,13,18,29,-11,21
FC Salzburg,9813,1,15,7,2,47,17,30,52
SK Sturm Gra,9813,2,13,5,6,36,28,8,44
Rapid Vienna,9813,3,8,9,7,33,30,3,33
LASK Linz,9813,4,8,8,8,28,26,2,32
Mattersburg,9813,5,7,6,11,32,42,-10,27
Vienna,9813,6,6,5,13,25,42,-17,23
SC Rheindorf,9813,7,4,6,14,17,33,-16,18
FC Salzburg,9814,1,13,8,3,47,23,24,47
SK Sturm Gra,9814,2,12,6,6,36,29,7,42
LASK Linz,9814,3,10,6,8,32,27,5,36
Rapid Vienna,9814,4,8,11,5,38,32,6,35
Mattersburg,9814,5,7,5,12,31,43,-12,26
Vienna,9814,6,6,6,12,24,40,-16,24
SC Rheindorf,9814,7,4,6,14,17,31,-14,18
FC Salzburg,9815,1,13,7,4,41,19,22,46
SK Sturm Gra,9815,2,12,5,7,36,32,4,41
Rapid Vienna,9815,3,10,10,4,38,25,13,40
Mattersburg,9815,4,8,6,10,34,39,-5,30
LASK Linz,9815,5,7,6,11,28,36,-8,27
SC Rheindorf,9815,6,6,5,13,20,28,-8,23
Vienna,9815,7,6,5,13,25,43,-18,23
FC Salzburg,9816,1,15,6,3,50,18,32,51
SK Sturm Gra,9816,2,12,4,8,32,30,2,40
Rapid Vienna,9816,3,8,10,6,34,26,8,34
LASK Linz,9816,4,8,5,11,24,30,-6,29
SC Rheindorf,9816,5,8,5,11,20,26,-6,29
Vienna,9816,6,7,5,12,25,40,-15,26
Mattersburg,9816,7,6,5,13,29,44,-15,23
FC Salzburg,9817,1,13,8,3,44,20,24,47
SK Sturm Gra,9817,2,12,3,9,31,32,-1,39
Rapid Vienna,9817,3,9,10,5,37,27,10,37
LASK Linz,9817,4,9,5,10,28,28,0,32
Vienna,9817,5,7,6,11,29,42,-13,27
Mattersburg,9817,6,6,7,11,30,40,-10,25
SC Rheindorf,9817,7,5,7,12,20,30,-10,22
FC Salzburg,9818,1,16,6,2,47,17,30,54
SK Sturm Gra,9818,2,13,4,7,33,28,5,43
Rapid Vienna,9818,3,8,10,6,37,31,6,34
LASK Linz,9818,4,7,8,9,28,30,-2,29
Mattersburg,9818,5,7,6,11,31,41,-10,27
Vienna,9818,6,6,6,12,23,39,-16,24
SC Rheindorf,9818,7,4,6,14,17,30,-13,18
FC Salzburg,9819,1,15,7,2,48,18,30,52
SK Sturm Gra,9819,2,14,3,7,36,29,7,45
LASK Linz,9819,3,9,6,9,30,28,2,33
Rapid Vienna,9819,4,7,10,7,33,31,2,31
Mattersburg,9819,5,7,6,11,34,41,-7,27
Vienna,9819,6,6,6,12,23,40,-17,24
SC Rheindorf,9819,7,4,6,14,17,34,-17,18
FC Salzburg,9820,1,13,8,3,40,16,24,47
SK Sturm Gra,9820,2,12,4,8,30,29,1,40
Rapid Vienna,9820,3,9,10,5,40,27,13,37
LASK Linz,9820,4,8,7,9,29,27,2,31
Vienna,9820,5,8,5,11,26,38,-12,29
Mattersburg,9820,6,6,6,12,29,42,-13,24
SC Rheindorf,9820,7,5,6,13,18,33,-15,21
FC Salzburg,9821,1,13,8,3,42,19,23,47
SK Sturm Gra,9821,2,12,5,7,31,28,3,41
Rapid Vienna,9821,3,8,11,5,36,27,9,35
LASK Linz,9821,4,8,8,8,27,27,0,32
SC Rheindorf,9821,5,6,7,11,21,27,-6,25
Mattersburg,9821,6,6,6,12,29,41,-12,24
Vienna,9821,7,6,5,13,25,42,-17,23
FC Salzburg,9822,1,15,6,3,49,18,31,51
SK Sturm Gra,9822,2,12,5,7,31,33,-2,41
Rapid Vienna,9822,3,8,10,6,34,27,7,34
LASK Linz,9822,4,7,8,9,23,25,-2,29
Mattersburg,9822,5,7,6,11,29,43,-14,27
Vienna,9822,6,7,5,12,31,40,-9,26
SC Rheindorf,9822,7,5,6,13,17,28,-11,21
FC Salzburg,9823,1,16,6,2,47,16,31,54
SK Sturm Gra,9823,2,12,3,9,31,33,-2,39
Rapid Vienna,9823,3,9,10,5,35,25,10,37
LASK Linz,9823,4,8,6,10,27,30,-3,30
Vienna,9823,5,7,5,12,27,41,-14,26
SC Rheindorf,9823,6,6,6,12,21,28,-7,24
Mattersburg,9823,7,5,6,13,32,47,-15,21
FC Salzburg,9824,1,14,6,4,41,19,22,48
Rapid Vienna,9824,2,11,9,4,40,23,17,42
SK Sturm Gra,9824,3,12,4,8,35,32,3,40
LASK Linz,9824,4,9,5,10,29,30,-1,32
Vienna,9824,5,8,5,11,29,38,-9,29
SC Rheindorf,9824,6,5,6,13,18,33,-15,21
Mattersburg,9824,7,5,5,14,27,44,-17,20
FC Salzburg,9825,1,15,7,2,42,16,26,52
SK Sturm Gra,9825,2,13,4,7,33,27,6,43
Rapid Vienna,9825,3,9,10,5,39,27,12,37
LASK Linz,9825,4,8,5,11,25,30,-5,29
Vienna,9825,5,7,6,11,27,40,-13,27
Mattersburg,9825,6,6,5,13,32,42,-10,23
SC Rheindorf,9825,7,5,5,14,18,34,-16,20
FC Salzburg,9826,1,15,6,3,49,21,28,51
SK Sturm Gra,9826,2,11,4,9,31,33,-2,37
Rapid Vienna,9826,3,8,9,7,35,28,7,33
LASK Linz,9826,4,8,6,10,25,29,-4,30
SC Rheindorf,9826,5,7,6,11,22,28,-6,27
Mattersburg,9826,6,7,6,11,31,41,-10,27
Vienna,9826,7,7,5,12,28,41,-13,26
FC Salzburg,9827,1,14,7,3,45,17,28,49
SK Sturm Gra,9827,2,12,4,8,32,32,0,40
Rapid Vienna,9827,3,9,10,5,37,27,10,37
LASK Linz,9827,4,9,6,9,27,28,-1,33
Mattersburg,9827,5,7,5,12,28,41,-13,26
Vienna,9827,6,6,6,12,24,39,-15,24
SC Rheindorf,9827,7,5,6,13,20,29,-9,21
FC Salzburg,9828,1,15,6,3,45,16,29,51
SK Sturm Gra,9828,2,11,4,9,31,35,-4,37
LASK Linz,9828,3,10,6,8,29,26,3,36
Rapid Vienna,9828,4,8,10,6,37,28,9,34
Vienna,9828,5,7,6,11,27,40,-13,27
Mattersburg,9828,6,6,6,12,34,44,-10,24
SC Rheindorf,9828,7,5,6,13,19,33,-14,21
FC Salzburg,9829,1,14,6,4,43,19,24,48
SK Sturm Gra,9829,2,12,4,8,32,32,0,40
Rapid Vienna,9829,3,8,11,5,36,27,9,35
LASK Linz,9829,4,7,7,10,26,30,-4,28
SC Rheindorf,9829,5,7,6,11,22,27,-5,27
Mattersburg,9829,6,7,5,12,32,42,-10,26
Vienna,9829,7,7,5,12,27,41,-14,26
FC Salzburg,9830,1,16,6,2,44,16,28,54
SK Sturm Gra,9830,2,12,4,8,31,29,2,40
Rapid Vienna,9830,3,9,9,6,37,26,11,36
LASK Linz,9830,4,8,7,9,27,28,-1,31
Mattersburg,9830,5,6,6,12,30,39,-9,24
Vienna,9830,6,6,5,13,23,41,-18,23
SC Rheindorf,9830,7,5,7,12,18,31,-13,22
FC Salzburg,9831,1,13,7,4,44,23,21,46
SK Sturm Gra,9831,2,11,5,8,33,31,2,38
Rapid Vienna,9831,3,9,10,5,36,27,9,37
LASK Linz,9831,4,7,7,10,26,29,-3,28
Mattersburg,9831,5,7,7,10,31,39,-8,28
Vienna,9831,6,7,6,11,27,39,-12,27
SC Rheindorf,9831,7,6,6,12,18,27,-9,24
FC Salzburg,9832,1,16,6,2,45,18,27,54
SK Sturm Gra,9832,2,13,3,8,33,27,6,42
Rapid Vienna,9832,3,8,10,6,37,30,7,34
LASK Linz,9832,4,9,6,9,28,27,1,33
Mattersburg,9832,5,7,5,12,35,47,-12,26
Vienna,9832,6,6,5,13,27,43,-16,23
SC Rheindorf,9832,7,4,7,13,17,30,-13,19
FC Salzburg,9833,1,14,8,2,47,19,28,50
Rapid Vienna,9833,2,9,10,5,38,29,9,37
SK Sturm Gra,9833,3,11,4,9,29,29,0,37
LASK Linz,9833,4,10,6,8,31,27,4,36
Mattersburg,9833,5,7,5,12,30,42,-12,26
Vienna,9833,6,6,6,12,25,41,-16,24
SC Rheindorf,9833,7,5,5,14,19,32,-13,20
FC Salzburg,9834,1,14,6,4,46,20,26,48
Rapid Vienna,9834,2,10,9,5,40,27,13,39
SK Sturm Gra,9834,3,11,3,10,29,33,-4,36
LASK Linz,9834,4,9,6,9,28,28,0,33
Vienna,9834,5,7,6,11,27,40,-13,27
SC Rheindorf,9834,6,6,6,12,25,32,-7,24
Mattersburg,9834,7,6,6,12,30,45,-15,24
FC Salzburg,9835,1,12,8,4,43,22,21,44
SK Sturm Gra,9835,2,11,5,8,30,29,1,38
LASK Linz,9835,3,10,6,8,29,25,4,36
Rapid Vienna,9835,4,8,11,5,34,26,8,35
Mattersburg,9835,5,7,6,11,35,43,-8,27
Vienna,9835,6,7,5,12,26,41,-15,26
SC Rheindorf,9835,7,5,7,12,17,28,-11,22
FC Salzburg,9836,1,12,9,3,41,19,22,45
Rapid Vienna,9836,2,10,10,4,37,26,11,40
SK Sturm Gra,9836,3,11,5,8,29,29,0,38
LASK Linz,9836,4,7,7,10,29,32,-3,28
Vienna,9836,5,7,6,11,28,38,-10,27
Mattersburg,9836,6,6,7,11,31,44,-13,25
SC Rheindorf,9836,7,6,6,12,21,28,-7,24
FC Salzburg,9837,1,13,9,2,43,16,27,48
SK Sturm Gra,9837,2,11,5,8,29,28,1,38
LASK Linz,9837,3,10,6,8,30,26,4,36
Rapid Vienna,9837,4,8,11,5,33,27,6,35
Mattersburg,9837,5,6,7,11,32,41,-9,25
Vienna,9837,6,6,6,12,25,43,-18,24
SC Rheindorf,9837,7,5,6,13,18,29,-11,21
FC Salzburg,9838,1,15,7,2,47,19,28,52
SK Sturm Gra,9838,2,13,3,8,31,27,4,42
Rapid Vienna,9838,3,10,10,4,42,30,12,40
LASK Linz,9838,4,7,6,11,26,33,-7,27
Mattersburg,9838,5,7,5,12,34,41,-7,26
Vienna,9838,6,7,5,12,27,42,-15,26
SC Rheindorf,9838,7,4,6,14,17,32,-15,18
FC Salzburg,9839,1,15,7,2,45,19,26,52
SK Sturm Gra,9839,2,12,4,8,34,33,1,40
Rapid Vienna,9839,3,10,9,5,38,26,12,39
LASK Linz,9839,4,7,6,11,27,32,-5,27
Vienna,9839,5,7,5,12,26,40,-14,26
SC Rheindorf,9839,6,6,6,12,24,30,-6,24
Mattersburg,9839,7,6,5,13,31,45,-14,23
FC Salzburg,9840,1,14,8,2,45,18,27,50
LASK Linz,9840,2,11,5,8,33,26,7,38
SK Sturm Gra,9840,3,11,5,8,32,34,-2,38
Rapid Vienna,9840,4,7,12,5,36,29,7,33
Mattersburg,9840,5,7,5,12,34,41,-7,26
Vienna,9840,6,6,6,12,25,42,-17,24
SC Rheindorf,9840,7,4,7,13,19,34,-15,19
FC Salzburg,9841,1,14,7,3,46,19,27,49
SK Sturm Gra,9841,2,12,5,7,35,29,6,41
Rapid Vienna,9841,3,9,10,5,38,30,8,37
LASK Linz,9841,4,9,6,9,30,29,1,33
Vienna,9841,5,7,5,12,27,40,-13,26
SC Rheindorf,9841,6,5,8,11,22,31,-9,23
Mattersburg,9841,7,5,5,14,28,48,-20,20
FC Salzburg,9842,1,12,7,5,40,24,16,43
SK Sturm Gra,9842,2,12,5,7,33,30,3,41
Rapid Vienna,9842,3,8,11,5,36,26,10,35
LASK Linz,9842,4,7,7,10,27,31,-4,28
SC Rheindorf,9842,5,7,6,11,22,26,-4,27
Mattersburg,9842,6,7,6,11,32,42,-10,27
Vienna,9842,7,7,6,11,28,39,-11,27
FC Salzburg,9843,1,13,7,4,41,19,22,46
SK Sturm Gra,9843,2,13,4,7,32,28,4,43
Rapid Vienna,9843,3,8,11,5,35,28,7,35
LASK Linz,9843,4,8,7,9,25,26,-1,31
Mattersburg,9843,5,6,8,10,30,39,-9,26
Vienna,9843,6,6,6,12,24,39,-15,24
SC Rheindorf,9843,7,5,7,12,21,29,-8,22
FC Salzburg,9844,1,14,8,2,45,17,28,50
SK Sturm Gra,9844,2,12,4,8,32,28,4,40
Rapid Vienna,9844,3,8,12,4,38,28,10,36
Mattersburg,9844,4,8,5,11,34,42,-8,29
LASK Linz,9844,5,8,5,11,26,34,-8,29
Vienna,9844,6,6,6,12,25,40,-15,24
SC Rheindorf,9844,7,5,6,13,21,32,-11,21
FC Salzburg,9845,1,15,7,2,50,18,32,52
SK Sturm Gra,9845,2,12,3,9,31,31,0,39
LASK Linz,9845,3,10,6,8,32,27,5,36
Rapid Vienna,9845,4,8,10,6,34,29,5,34
Vienna,9845,5,7,5,12,27,42,-15,26
SC Rheindorf,9845,6,5,7,12,19,28,-9,22
Mattersburg,9845,7,5,6,13,30,48,-18,21
FC Salzburg,9846,1,13,8,3,44,21,23,47
SK Sturm Gra,9846,2,12,4,8,34,29,5,40
Rapid Vienna,9846,3,9,11,4,36,26,10,38
LASK Linz,9846,4,7,7,10,25,30,-5,28
Mattersburg,9846,5,6,8,10,30,39,-9,26
Vienna,9846,6,6,7,11,26,40,-14,25
SC Rheindorf,9846,7,5,7,12,19,29,-10,22
FC Salzburg,9847,1,14,6,4,45,24,21,48
SK Sturm Gra,9847,2,14,4,6,38,27,11,46
Rapid Vienna,9847,3,8,10,6,37,30,7,34
LASK Linz,9847,4,9,6,9,27,28,-1,33
Mattersburg,9847,5,7,6,11,34,42,-8,27
Vienna,9847,6,6,5,13,24,42,-18,23
SC Rheindorf,9847,7,5,5,14,19,31,-12,20
FC Salzburg,9848,1,15,7,2,46,20,26,52
SK Sturm Gra,9848,2,13,3,8,37,31,6,42
LASK Linz,9848,3,10,6,8,31,29,2,36
Rapid Vienna,9848,4,7,10,7,35,33,2,31
Vienna,9848,5,7,6,11,25,37,-12,27
SC Rheindorf,9848,6,5,6,13,22,32,-10,21
Mattersburg,9848,7,5,6,13,32,46,-14,21
FC Salzburg,9849,1,12,8,4,44,24,20,44
SK Sturm Gra,9849,2,12,6,6,32,25,7,42
Rapid Vienna,9849,3,9,10,5,39,31,8,37
LASK Linz,9849,4,8,6,10,30,34,-4,30
Mattersburg,9849,5,8,5,11,39,44,-5,29
Vienna,9849,6,6,6,12,25,41,-16,24
SC Rheindorf,9849,7,5,7,12,22,32,-10,22
SK Sturm Gra,9850,1,14,3,7,34,27,7,45
FC Salzburg,9850,2,12,8,4,41,22,19,44
Rapid Vienna,9850,3,8,11,5,38,30,8,35
Vienna,9850,4,8,5,11,29,38,-9,29
LASK Linz,9850,5,7,6,11,26,32,-6,27
Mattersburg,9850,6,6,7,11,31,42,-11,25
SC Rheindorf,9850,7,6,6,12,20,28,-8,24
FC Salzburg,9851,1,14,7,3,43,17,26,49
SK Sturm Gra,9851,2,12,5,7,32,28,4,41
Rapid Vienna,9851,3,8,10,6,34,26,8,34
LASK Linz,9851,4,9,5,10,26,28,-2,32
SC Rheindorf,9851,5,7,5,12,21,28,-7,26
Vienna,9851,6,7,5,12,26,39,-13,26
Mattersburg,9851,7,6,5,13,28,44,-16,23
FC Salzburg,9852,1,15,6,3,43,18,25,51
SK Sturm Gra,9852,2,11,4,9,30,30,0,37
Rapid Vienna,9852,3,9,9,6,35,27,8,36
LASK Linz,9852,4,8,6,10,28,30,-2,30
SC Rheindorf,9852,5,7,5,12,21,29,-8,26
Mattersburg,9852,6,7,5,12,32,41,-9,26
Vienna,9852,7,7,5,12,25,39,-14,26
FC Salzburg,9853,1,14,8,2,44,16,28,50
SK Sturm Gra,9853,2,14,4,6,38,29,9,46
Rapid Vienna,9853,3,9,9,6,40,31,9,36
LASK Linz,9853,4,7,6,11,28,35,-7,27
Vienna,9853,5,7,6,11,26,39,-13,27
Mattersburg,9853,6,7,5,12,33,44,-11,26
SC Rheindorf,9853,7,4,6,14,25,40,-15,18
FC Salzburg,9854,1,14,6,4,46,20,26,48
SK Sturm Gra,9854,2,11,4,9,31,32,-1,37
Rapid Vienna,9854,3,9,9,6,35,30,5,36
LASK Linz,9854,4,9,6,9,29,26,3,33
Mattersburg,9854,5,8,6,10,35,41,-6,30
Vienna,9854,6,7,5,12,25,39,-14,26
SC Rheindorf,9854,7,5,6,13,19,32,-13,21
FC Salzburg,9855,1,15,7,2,46,18,28,52
SK Sturm Gra,9855,2,14,3,7,34,26,8,45
Rapid Vienna,9855,3,9,9,6,37,31,6,36
LASK Linz,9855,4,8,6,10,25,28,-3,30
Vienna,9855,5,7,6,11,27,40,-13,27
Mattersburg,9855,6,6,6,12,29,41,-12,24
SC Rheindorf,9855,7,4,5,15,17,31,-14,17
FC Salzburg,9856,1,14,7,3,46,20,26,49
SK Sturm Gra,9856,2,13,3,8,30,26,4,42
Rapid Vienna,9856,3,8,9,7,33,27,6,33
LASK Linz,9856,4,9,6,9,25,25,0,33
Mattersburg,9856,5,7,6,11,33,41,-8,27
Vienna,9856,6,7,5,12,26,42,-16,26
SC Rheindorf,9856,7,5,6,13,17,29,-12,21
FC Salzburg,9857,1,16,6,2,47,16,31,54
SK Sturm Gra,9857,2,11,5,8,28,26,2,38
LASK Linz,9857,3,10,6,8,30,24,6,36
Rapid Vienna,9857,4,9,9,6,33,29,4,36
Mattersburg,9857,5,7,5,12,32,42,-10,26
Vienna,9857,6,6,5,13,24,43,-19,23
SC Rheindorf,9857,7,4,6,14,17,31,-14,18
FC Salzburg,9858,1,14,8,2,45,20,25,50
SK Sturm Gra,9858,2,13,4,7,34,28,6,43
Rapid Vienna,9858,3,9,9,6,37,27,10,36
LASK Linz,9858,4,9,5,10,27,33,-6,32
Vienna,9858,5,6,6,12,24,39,-15,24
SC Rheindorf,9858,6,6,5,13,22,29,-7,23
Mattersburg,9858,7,5,7,12,30,43,-13,22
FC Salzburg,9859,1,14,8,2,43,16,27,50
SK Sturm Gra,9859,2,11,7,6,32,28,4,40
Rapid Vienna,9859,3,9,11,4,37,27,10,38
LASK Linz,9859,4,8,7,9,28,27,1,31
Mattersburg,9859,5,6,6,12,29,43,-14,24
Vienna,9859,6,6,6,12,24,39,-15,24
SC Rheindorf,9859,7,4,7,13,18,31,-13,19
FC Salzburg,9860,1,14,6,4,44,18,26,48
SK Sturm Gra,9860,2,12,4,8,32,29,3,40
LASK Linz,9860,3,10,5,9,30,30,0,35
Rapid Vienna,9860,4,8,10,6,35,28,7,34
Vienna,9860,5,7,6,11,24,37,-13,27
Mattersburg,9860,6,6,7,11,30,41,-11,25
SC Rheindorf,9860,7,5,6,13,20,32,-12,21
FC Salzburg,9861,1,15,7,2,46,17,29,52
SK Sturm Gra,9861,2,12,3,9,32,31,1,39
LASK Linz,9861,3,9,7,8,29,26,3,34
Rapid Vienna,9861,4,7,11,6,34,30,4,32
SC Rheindorf,9861,5,6,7,11,20,27,-7,25
Mattersburg,9861,6,6,6,12,30,42,-12,24
Vienna,9861,7,6,5,13,25,43,-18,23
FC Salzburg,9862,1,15,6,3,47,20,27,51
Rapid Vienna,9862,2,11,9,4,42,29,13,42
SK Sturm Gra,9862,3,12,3,9,33,29,4,39
LASK Linz,9862,4,9,5,10,30,31,-1,32
Mattersburg,9862,5,7,5,12,34,46,-12,26
Vienna,9862,6,7,5,12,26,40,-14,26
SC Rheindorf,9862,7,4,5,15,17,34,-17,17
FC Salzburg,9863,1,15,6,3,50,21,29,51
SK Sturm Gra,9863,2,12,4,8,31,29,2,40
Rapid Vienna,9863,3,9,10,5,37,28,9,37
LASK Linz,9863,4,8,6,10,25,27,-2,30
SC Rheindorf,9863,5,6,6,12,23,30,-7,24
Mattersburg,9863,6,6,6,12,31,46,-15,24
Vienna,9863,7,6,6,12,24,40,-16,24
FC Salzburg,9864,1,14,8,2,43,17,26,50
SK Sturm Gra,9864,2,13,4,7,34,28,6,43
LASK Linz,9864,3,10,5,9,28,27,1,35
Rapid Vienna,9864,4,8,10,6,35,29,6,34
Vienna,9864,5,6,7,11,27,41,-14,25
SC Rheindorf,9864,6,5,6,13,22,32,-10,21
Mattersburg,9864,7,5,6,13,31,46,-15,21
FC Salzburg,9865,1,14,7,3,43,18,25,49
SK Sturm Gra,9865,2,12,5,7,34,28,6,41
Rapid Vienna,9865,3,7,11,6,35,30,5,32
LASK Linz,9865,4,8,6,10,28,32,-4,30
SC Rheindorf,9865,5,6,7,11,23,30,-7,25
Mattersburg,9865,6,6,7,11,32,43,-11,25
Vienna,9865,7,6,7,11,24,38,-14,25
FC Salzburg,9866,1,15,7,2,46,16,30,52
SK Sturm Gra,9866,2,12,5,7,30,29,1,41
Rapid Vienna,9866,3,8,9,7,35,27,8,33
LASK Linz,9866,4,7,7,10,26,31,-5,28
Vienna,9866,5,7,5,12,26,40,-14,26
Mattersburg,9866,6,6,7,11,31,41,-10,25
SC Rheindorf,9866,7,6,6,12,17,27,-10,24
FC Salzburg,9867,1,14,6,4,41,18,23,48
SK Sturm Gra,9867,2,12,5,7,38,28,10,41
Rapid Vienna,9867,3,10,10,4,39,27,12,40
Mattersburg,9867,4,9,5,10,32,36,-4,32
LASK Linz,9867,5,7,5,12,25,36,-11,26
Vienna,9867,6,6,5,13,23,42,-19,23
SC Rheindorf,9867,7,5,6,13,19,30,-11,21
FC Salzburg,9868,1,13,7,4,44,22,22,46
SK Sturm Gra,9868,2,13,4,7,32,28,4,43
Rapid Vienna,9868,3,10,9,5,40,28,12,39
LASK Linz,9868,4,7,6,11,24,29,-5,27
Mattersburg,9868,5,7,6,11,31,40,-9,27
Vienna,9868,6,7,6,11,25,38,-13,27
SC Rheindorf,9868,7,4,8,12,18,29,-11,20
FC Salzburg,9869,1,14,8,2,44,18,26,50
SK Sturm Gra,9869,2,12,5,7,31,27,4,41
Rapid Vienna,9869,3,8,10,6,35,28,7,34
LASK Linz,9869,4,9,6,9,29,27,2,33
Vienna,9869,5,7,6,11,27,39,-12,27
Mattersburg,9869,6,7,5,12,29,41,-12,26
SC Rheindorf,9869,7,4,6,14,18,33,-15,18
FC Salzburg,9870,1,14,6,4,47,18,29,48
SK Sturm Gra,9870,2,13,4,7,33,28,5,43
Rapid Vienna,9870,3,8,9,7,35,29,6,33
LASK Linz,9870,4,8,8,8,25,25,0,32
Vienna,9870,5,7,5,12,26,40,-14,26
SC Rheindorf,9870,6,6,7,11,19,27,-8,25
Mattersburg,9870,7,5,7,12,28,46,-18,22
FC Salzburg,9871,1,12,10,2,39,16,23,46
SK Sturm Gra,9871,2,13,5,6,32,26,6,44
Rapid Vienna,9871,3,8,10,6,34,27,7,34
LASK Linz,9871,4,8,6,10,25,27,-2,30
Mattersburg,9871,5,7,6,11,29,38,-9,27
Vienna,9871,6,6,6,12,25,40,-15,24
SC Rheindorf,9871,7,5,7,12,17,27,-10,22
FC Salzburg,9872,1,14,8,2,45,18,27,50
SK Sturm Gra,9872,2,12,5,7,32,28,4,41
LASK Linz,9872,3,9,6,9,28,26,2,33
Rapid Vienna,9872,4,7,10,7,34,31,3,31
Vienna,9872,5,7,5,12,27,39,-12,26
Mattersburg,9872,6,6,7,11,30,43,-13,25
SC Rheindorf,9872,7,5,7,12,19,30,-11,22
FC Salzburg,9873,1,14,8,2,43,17,26,50
SK Sturm Gra,9873,2,12,5,7,32,28,4,41
LASK Linz,9873,3,9,7,8,30,29,1,34
Rapid Vienna,9873,4,7,11,6,33,27,6,32
Mattersburg,9873,5,6,6,12,35,42,-7,24
Vienna,9873,6,6,6,12,23,39,-16,24
SC Rheindorf,9873,7,5,7,12,20,34,-14,22
FC Salzburg,9874,1,15,7,2,47,16,31,52
SK Sturm Gra,9874,2,13,3,8,34,32,2,42
Rapid Vienna,9874,3,7,10,7,33,29,4,31
LASK Linz,9874,4,8,6,10,28,29,-1,30
SC Rheindorf,9874,5,7,5,12,25,32,-7,26
Mattersburg,9874,6,6,7,11,30,44,-14,25
Vienna,9874,7,6,6,12,24,39,-15,24
FC Salzburg,9875,1,13,8,3,45,21,24,47
SK Sturm Gra,9875,2,11,5,8,33,33,0,38
Rapid Vienna,9875,3,8,10,6,35,30,5,34
LASK Linz,9875,4,8,7,9,28,28,0,31
SC Rheindorf,9875,5,7,6,11,22,27,-5,27
Vienna,9875,6,7,6,11,26,39,-13,27
Mattersburg,9875,7,6,6,12,31,42,-11,24
FC Salzburg,9876,1,12,8,4,42,22,20,44
SK Sturm Gra,9876,2,12,5,7,33,29,4,41
Rapid Vienna,9876,3,7,11,6,32,30,2,32
LASK Linz,9876,4,9,5,10,27,27,0,32
Vienna,9876,5,8,5,11,30,40,-10,29
SC Rheindorf,9876,6,7,6,11,23,27,-4,27
Mattersburg,9876,7,6,6,12,30,42,-12,24
FC Salzburg,9877,1,15,7,2,46,19,27,52
SK Sturm Gra,9877,2,13,4,7,39,29,10,43
Rapid Vienna,9877,3,8,10,6,34,32,2,34
Mattersburg,9877,4,8,5,11,36,42,-6,29
LASK Linz,9877,5,7,5,12,25,32,-7,26
SC Rheindorf,9877,6,6,6,12,22,30,-8,24
Vienna,9877,7,6,5,13,24,42,-18,23
FC Salzburg,9878,1,15,6,3,47,20,27,51
SK Sturm Gra,9878,2,12,3,9,33,31,2,39
Rapid Vienna,9878,3,9,10,5,37,27,10,37
LASK Linz,9878,4,9,6,9,27,27,0,33
Vienna,9878,5,7,5,12,27,42,-15,26
Mattersburg,9878,6,6,6,12,28,40,-12,24
SC Rheindorf,9878,7,5,6,13,17,29,-12,21
FC Salzburg,9879,1,14,7,3,44,18,26,49
SK Sturm Gra,9879,2,14,3,7,34,27,7,45
Rapid Vienna,9879,3,9,9,6,34,30,4,36
LASK Linz,9879,4,9,6,9,31,28,3,33
Vienna,9879,5,7,6,11,24,37,-13,27
Mattersburg,9879,6,5,6,13,30,45,-15,21
SC Rheindorf,9879,7,4,7,13,17,29,-12,19
SK Sturm Gra,9880,1,14,4,6,35,26,9,46
FC Salzburg,9880,2,12,7,5,41,22,19,43
Rapid Vienna,9880,3,8,9,7,35,31,4,33
LASK Linz,9880,4,9,6,9,28,28,0,33
Vienna,9880,5,7,5,12,26,40,-14,26
Mattersburg,9880,6,6,7,11,30,40,-10,25
SC Rheindorf,9880,7,5,8,11,20,28,-8,23
FC Salzburg,9881,1,14,6,4,44,19,25,48
SK Sturm Gra,9881,2,13,5,6,36,30,6,44
Rapid Vienna,9881,3,8,11,5,37,28,9,35
LASK Linz,9881,4,9,6,9,29,28,1,33
Vienna,9881,5,7,5,12,25,41,-16,26
SC Rheindorf,9881,6,6,6,12,22,29,-7,24
Mattersburg,9881,7,5,5,14,28,46,-18,20
FC Salzburg,9882,1,14,7,3,48,19,29,49
Rapid Vienna,9882,2,11,9,4,42,27,15,42
SK Sturm Gra,9882,3,11,5,8,32,30,2,38
LASK Linz,9882,4,8,6,10,28,31,-3,30
SC Rheindorf,9882,5,7,5,12,25,31,-6,26
Vienna,9882,6,7,5,12,24,42,-18,26
Mattersburg,9882,7,5,5,14,28,47,-19,20
FC Salzburg,9883,1,15,7,2,46,19,27,52
SK Sturm Gra,9883,2,13,3,8,34,29,5,42
Rapid Vienna,9883,3,7,11,6,34,29,5,32
LASK Linz,9883,4,9,5,10,28,28,0,32
Mattersburg,9883,5,7,5,12,35,46,-11,26
Vienna,9883,6,7,5,12,29,43,-14,26
SC Rheindorf,9883,7,5,6,13,21,33,-12,21
FC Salzburg,9884,1,13,6,5,41,21,20,45
SK Sturm Gra,9884,2,12,4,8,32,29,3,40
Rapid Vienna,9884,3,9,9,6,34,27,7,36
LASK Linz,9884,4,8,7,9,29,29,0,31
Vienna,9884,5,8,5,11,29,39,-10,29
Mattersburg,9884,6,7,6,11,34,43,-9,27
SC Rheindorf,9884,7,5,7,12,18,29,-11,22
FC Salzburg,9885,1,14,7,3,44,19,25,49
SK Sturm Gra,9885,2,13,3,8,34,30,4,42
Rapid Vienna,9885,3,10,9,5,37,25,12,39
LASK Linz,9885,4,8,6,10,26,27,-1,30
Vienna,9885,5,7,6,11,27,38,-11,27
SC Rheindorf,9885,6,6,5,13,21,33,-12,23
Mattersburg,9885,7,5,6,13,29,46,-17,21
FC Salzburg,9886,1,15,7,2,45,16,29,52
SK Sturm Gra,9886,2,13,3,8,32,29,3,42
Rapid Vienna,9886,3,7,11,6,39,33,6,32
LASK Linz,9886,4,9,5,10,30,31,-1,32
SC Rheindorf,9886,5,7,6,11,24,30,-6,27
Mattersburg,9886,6,6,5,13,29,43,-14,23
Vienna,9886,7,6,5,13,24,41,-17,23
FC Salzburg,9887,1,15,7,2,47,18,29,52
SK Sturm Gra,9887,2,12,5,7,33,31,2,41
LASK Linz,9887,3,9,6,9,29,27,2,33
Rapid Vienna,9887,4,7,11,6,35,31,4,32
SC Rheindorf,9887,5,6,6,12,19,27,-8,24
Mattersburg,9887,6,6,6,12,31,42,-11,24
Vienna,9887,7,6,5,13,25,43,-18,23
FC Salzburg,9888,1,13,8,3,44,19,25,47
Rapid Vienna,9888,2,10,10,4,38,26,12,40
SK Sturm Gra,9888,3,12,4,8,33,32,1,40
LASK Linz,9888,4,8,6,10,27,29,-2,30
Mattersburg,9888,5,8,6,10,37,41,-4,30
Vienna,9888,6,6,5,13,25,43,-18,23
SC Rheindorf,9888,7,5,5,14,20,34,-14,20
FC Salzburg,9889,1,14,7,3,44,18,26,49
SK Sturm Gra,9889,2,14,3,7,34,28,6,45
Rapid Vienna,9889,3,8,11,5,38,28,10,35
LASK Linz,9889,4,8,6,10,28,30,-2,30
Mattersburg,9889,5,7,5,12,29,41,-12,26
SC Rheindorf,9889,6,6,5,13,19,30,-11,23
Vienna,9889,7,6,5,13,23,40,-17,23
FC Salzburg,9890,1,14,7,3,44,18,26,49
SK Sturm Gra,9890,2,12,5,7,31,28,3,41
Rapid Vienna,9890,3,10,10,4,41,25,16,40
LASK Linz,9890,4,8,7,9,27,32,-5,31
Vienna,9890,5,7,6,11,26,39,-13,27
Mattersburg,9890,6,5,6,13,28,43,-15,21
SC Rheindorf,9890,7,4,7,13,17,29,-12,19
FC Salzburg,9891,1,14,7,3,46,19,27,49
SK Sturm Gra,9891,2,11,4,9,31,32,-1,37
LASK Linz,9891,3,10,5,9,30,28,2,35
Rapid Vienna,9891,4,8,10,6,37,30,7,34
Mattersburg,9891,5,7,6,11,34,40,-6,27
Vienna,9891,6,7,5,12,24,40,-16,26
SC Rheindorf,9891,7,6,5,13,19,32,-13,23
FC Salzburg,9892,1,15,7,2,47,20,27,52
SK Sturm Gra,9892,2,13,4,7,35,28,7,43
Rapid Vienna,9892,3,9,10,5,38,28,10,37
LASK Linz,9892,4,7,5,12,23,30,-7,26
Mattersburg,9892,5,7,5,12,28,41,-13,26
Vienna,9892,6,6,6,12,25,40,-15,24
SC Rheindorf,9892,7,6,5,13,21,30,-9,23
FC Salzburg,9893,1,15,7,2,47,16,31,52
SK Sturm Gra,9893,2,11,4,9,32,34,-2,37
Rapid Vienna,9893,3,7,11,6,35,30,5,32
LASK Linz,9893,4,9,5,10,30,30,0,32
SC Rheindorf,9893,5,8,5,11,23,27,-4,29
Mattersburg,9893,6,6,6,12,29,41,-12,24
Vienna,9893,7,6,6,12,25,43,-18,24
FC Salzburg,9894,1,15,6,3,45,18,27,51
SK Sturm Gra,9894,2,12,4,8,34,33,1,40
Rapid Vienna,9894,3,8,12,4,36,26,10,36
LASK Linz,9894,4,8,6,10,27,32,-5,30
Vienna,9894,5,7,5,12,26,40,-14,26
SC Rheindorf,9894,6,6,6,12,23,27,-4,24
Mattersburg,9894,7,6,5,13,31,46,-15,23
FC Salzburg,9895,1,16,6,2,46,16,30,54
SK Sturm Gra,9895,2,13,4,7,31,28,3,43
Rapid Vienna,9895,3,7,10,7,32,28,4,31
LASK Linz,9895,4,8,5,11,26,28,-2,29
Mattersburg,9895,5,8,5,11,32,39,-7,29
Vienna,9895,6,6,5,13,24,42,-18,23
SC Rheindorf,9895,7,5,7,12,16,26,-10,22
FC Salzburg,9896,1,15,7,2,45,19,26,52
SK Sturm Gra,9896,2,12,5,7,32,29,3,41
Rapid Vienna,9896,3,8,11,5,36,27,9,35
LASK Linz,9896,4,9,7,8,30,26,4,34
Mattersburg,9896,5,7,5,12,31,42,-11,26
Vienna,9896,6,6,5,13,24,40,-16,23
SC Rheindorf,9896,7,4,6,14,16,31,-15,18
FC Salzburg,9897,1,13,8,3,42,20,22,47
Rapid Vienna,9897,2,9,11,4,36,26,10,38
SK Sturm Gra,9897,3,11,5,8,29,27,2,38
LASK Linz,9897,4,9,6,9,27,27,0,33
Vienna,9897,5,8,5,11,27,37,-10,29
Mattersburg,9897,6,5,7,12,29,42,-13,22
SC Rheindorf,9897,7,5,6,13,18,29,-11,21
FC Salzburg,9898,1,14,8,2,48,19,29,50
SK Sturm Gra,9898,2,12,6,6,33,27,6,42
Rapid Vienna,9898,3,8,11,5,34,30,4,35
LASK Linz,9898,4,9,5,10,28,29,-1,32
Vienna,9898,5,6,7,11,27,41,-14,25
Mattersburg,9898,6,6,6,12,33,44,-11,24
SC Rheindorf,9898,7,4,7,13,20,33,-13,19
FC Salzburg,9899,1,14,6,4,45,22,23,48
SK Sturm Gra,9899,2,13,3,8,31,30,1,42
Rapid Vienna,9899,3,9,10,5,35,26,9,37
LASK Linz,9899,4,8,6,10,26,29,-3,30
Vienna,9899,5,8,5,11,30,39,-9,29
Mattersburg,9899,6,6,6,12,30,43,-13,24
SC Rheindorf,9899,7,5,6,13,19,27,-8,21
FC Salzburg,9900,1,13,7,4,40,19,21,46
SK Sturm Gra,9900,2,13,4,7,35,29,6,43
Rapid Vienna,9900,3,10,9,5,41,28,13,39
LASK Linz,9900,4,7,7,10,25,33,-8,28
Vienna,9900,5,7,6,11,27,39,-12,27
Mattersburg,9900,6,7,5,12,34,41,-7,26
SC Rheindorf,9900,7,5,6,13,18,31,-13,21
FC Salzburg,9901,1,15,7,2,48,18,30,52
SK Sturm Gra,9901,2,14,4,6,37,27,10,46
Rapid Vienna,9901,3,7,10,7,34,31,3,31
LASK Linz,9901,4,7,8,9,27,31,-4,29
Vienna,9901,5,7,5,12,30,42,-12,26
SC Rheindorf,9901,6,6,6,12,22,30,-8,24
Mattersburg,9901,7,5,6,13,29,48,-19,21
FC Salzburg,9902,1,14,7,3,43,18,25,49
SK Sturm Gra,9902,2,12,5,7,34,30,4,41
Rapid Vienna,9902,3,8,10,6,37,30,7,34
LASK Linz,9902,4,9,6,9,28,28,0,33
Vienna,9902,5,7,5,12,28,40,-12,26
Mattersburg,9902,6,6,7,11,31,43,-12,25
SC Rheindorf,9902,7,5,6,13,19,31,-12,21
FC Salzburg,9903,1,15,7,2,44,17,27,52
SK Sturm Gra,9903,2,12,3,9,29,28,1,39
LASK Linz,9903,3,9,7,8,27,26,1,34
Rapid Vienna,9903,4,7,11,6,32,27,5,32
SC Rheindorf,9903,5,7,5,12,22,29,-7,26
Mattersburg,9903,6,6,6,12,30,41,-11,24
Vienna,9903,7,6,5,13,24,40,-16,23
FC Salzburg,9904,1,13,9,2,45,21,24,48
SK Sturm Gra,9904,2,13,4,7,33,28,5,43
Rapid Vienna,9904,3,10,10,4,37,25,12,40
LASK Linz,9904,4,9,5,10,31,28,3,32
Vienna,9904,5,7,6,11,28,40,-12,27
SC Rheindorf,9904,6,5,5,14,19,33,-14,20
Mattersburg,9904,7,5,5,14,30,48,-18,20
FC Salzburg,9905,1,13,7,4,42,21,21,46
SK Sturm Gra,9905,2,13,4,7,37,32,5,43
Rapid Vienna,9905,3,9,9,6,36,30,6,36
LASK Linz,9905,4,10,6,8,33,28,5,36
Vienna,9905,5,7,5,12,29,41,-12,26
Mattersburg,9905,6,6,6,12,29,42,-13,24
SC Rheindorf,9905,7,5,5,14,19,31,-12,20
FC Salzburg,9906,1,16,6,2,49,16,33,54
SK Sturm Gra,9906,2,12,4,8,32,30,2,40
Rapid Vienna,9906,3,8,10,6,32,25,7,34
LASK Linz,9906,4,9,7,8,27,26,1,34
Mattersburg,9906,5,6,6,12,29,44,-15,24
Vienna,9906,6,6,5,13,23,41,-18,23
SC Rheindorf,9906,7,5,6,13,19,29,-10,21
FC Salzburg,9907,1,13,7,4,43,21,22,46
SK Sturm Gra,9907,2,14,4,6,39,25,14,46
LASK Linz,9907,3,9,6,9,29,33,-4,33
Rapid Vienna,9907,4,7,10,7,32,29,3,31
Vienna,9907,5,7,6,11,24,37,-13,27
Mattersburg,9907,6,6,7,11,34,42,-8,25
SC Rheindorf,9907,7,5,6,13,18,32,-14,21
FC Salzburg,9908,1,14,6,4,45,18,27,48
SK Sturm Gra,9908,2,13,3,8,33,29,4,42
Rapid Vienna,9908,3,9,10,5,36,29,7,37
LASK Linz,9908,4,8,8,8,27,27,0,32
Vienna,9908,5,7,5,12,24,39,-15,26
SC Rheindorf,9908,6,6,6,12,22,29,-7,24
Mattersburg,9908,7,5,6,13,30,46,-16,21
FC Salzburg,9909,1,14,8,2,41,16,25,50
SK Sturm Gra,9909,2,13,5,6,31,25,6,44
Rapid Vienna,9909,3,8,10,6,35,27,8,34
LASK Linz,9909,4,8,6,10,28,30,-2,30
Mattersburg,9909,5,7,5,12,28,38,-10,26
Vienna,9909,6,6,5,13,24,40,-16,23
SC Rheindorf,9909,7,5,7,12,19,30,-11,22
FC Salzburg,9910,1,16,6,2,44,16,28,54
SK Sturm Gra,9910,2,12,4,8,31,27,4,40
Rapid Vienna,9910,3,8,9,7,35,27,8,33
LASK Linz,9910,4,8,7,9,26,27,-1,31
Mattersburg,9910,5,7,5,12,30,41,-11,26
Vienna,9910,6,7,5,12,26,40,-14,26
SC Rheindorf,9910,7,5,6,13,18,32,-14,21
FC Salzburg,9911,1,15,6,3,44,19,25,51
SK Sturm Gra,9911,2,11,4,9,30,30,0,37
Rapid Vienna,9911,3,9,9,6,36,27,9,36
Mattersburg,9911,4,8,5,11,34,44,-10,29
LASK Linz,9911,5,7,7,10,25,29,-4,28
Vienna,9911,6,7,5,12,26,38,-12,26
SC Rheindorf,9911,7,6,6,12,20,28,-8,24
FC Salzburg,9912,1,14,8,2,41,16,25,50
SK Sturm Gra,9912,2,12,4,8,30,28,2,40
LASK Linz,9912,3,10,6,8,32,29,3,36
Rapid Vienna,9912,4,7,10,7,33,28,5,31
Vienna,9912,5,7,6,11,26,39,-13,27
Mattersburg,9912,6,5,7,12,30,42,-12,22
SC Rheindorf,9912,7,4,9,11,18,28,-10,21
FC Salzburg,9913,1,13,7,4,42,20,22,46
SK Sturm Gra,9913,2,14,3,7,36,30,6,45
Rapid Vienna,9913,3,8,10,6,35,29,6,34
LASK Linz,9913,4,9,6,9,30,29,1,33
Vienna,9913,5,8,5,11,26,38,-12,29
Mattersburg,9913,6,6,7,11,31,39,-8,25
SC Rheindorf,9913,7,4,6,14,19,34,-15,18
FC Salzburg,9914,1,14,7,3,46,19,27,49
SK Sturm Gra,9914,2,12,5,7,33,29,4,41
Rapid Vienna,9914,3,8,11,5,39,30,9,35
LASK Linz,9914,4,9,7,8,29,28,1,34
Mattersburg,9914,5,6,6,12,31,44,-13,24
Vienna,9914,6,6,6,12,25,41,-16,24
SC Rheindorf,9914,7,5,6,13,19,31,-12,21
FC Salzburg,9915,1,13,8,3,41,17,24,47
SK Sturm Gra,9915,2,11,7,6,29,25,4,40
LASK Linz,9915,3,10,6,8,29,27,2,36
Rapid Vienna,9915,4,8,11,5,35,27,8,35
Vienna,9915,5,6,7,11,25,39,-14,25
SC Rheindorf,9915,6,5,7,12,20,29,-9,22
Mattersburg,9915,7,5,6,13,31,46,-15,21
FC Salzburg,9916,1,13,7,4,45,21,24,46
SK Sturm Gra,9916,2,14,3,7,35,28,7,45
Rapid Vienna,9916,3,9,10,5,36,27,9,37
LASK Linz,9916,4,8,6,10,25,28,-3,30
Vienna,9916,5,7,5,12,28,42,-14,26
Mattersburg,9916,6,6,7,11,30,42,-12,25
SC Rheindorf,9916,7,5,6,13,16,27,-11,21
FC Salzburg,9917,1,14,7,3,45,19,26,49
SK Sturm Gra,9917,2,13,4,7,34,29,5,43
Rapid Vienna,9917,3,8,10,6,38,30,8,34
LASK Linz,9917,4,9,6,9,29,29,0,33
Vienna,9917,5,7,5,12,25,41,-16,26
SC Rheindorf,9917,6,6,6,12,20,28,-8,24
Mattersburg,9917,7,5,6,13,29,44,-15,21
FC Salzburg,9918,1,15,6,3,46,17,29,51
SK Sturm Gra,9918,2,12,4,8,33,30,3,40
Rapid Vienna,9918,3,9,9,6,36,26,10,36
LASK Linz,9918,4,9,6,9,28,27,1,33
Mattersburg,9918,5,7,5,12,31,42,-11,26
Vienna,9918,6,7,5,12,24,39,-15,26
SC Rheindorf,9918,7,5,5,14,18,35,-17,20
FC Salzburg,9919,1,15,6,3,48,19,29,51
SK Sturm Gra,9919,2,12,3,9,32,30,2,39
Rapid Vienna,9919,3,9,10,5,33,25,8,37
LASK Linz,9919,4,9,5,10,30,30,0,32
Mattersburg,9919,5,7,5,12,33,46,-13,26
Vienna,9919,6,7,5,12,24,38,-14,26
SC Rheindorf,9919,7,5,6,13,16,28,-12,21
FC Salzburg,9920,1,14,8,2,45,18,27,50
SK Sturm Gra,9920,2,13,4,7,32,27,5,43
LASK Linz,9920,3,9,6,9,29,29,0,33
Rapid Vienna,9920,4,7,10,7,33,28,5,31
Mattersburg,9920,5,7,5,12,34,43,-9,26
Vienna,9920,6,6,6,12,24,39,-15,24
SC Rheindorf,9920,7,5,7,12,19,32,-13,22
FC Salzburg,9921,1,14,6,4,44,19,25,48
SK Sturm Gra,9921,2,13,4,7,32,28,4,43
Rapid Vienna,9921,3,8,10,6,35,28,7,34
LASK Linz,9921,4,9,5,10,26,28,-2,32
Mattersburg,9921,5,7,5,12,32,41,-9,26
Vienna,9921,6,7,5,12,25,40,-15,26
SC Rheindorf,9921,7,5,7,12,17,27,-10,22
FC Salzburg,9922,1,15,6,3,50,19,31,51
Rapid Vienna,9922,2,10,9,5,39,27,12,39
SK Sturm Gra,9922,3,12,3,9,33,33,0,39
LASK Linz,9922,4,8,5,11,26,31,-5,29
SC Rheindorf,9922,5,7,5,12,23,30,-7,26
Mattersburg,9922,6,7,5,12,33,45,-12,26
Vienna,9922,7,6,5,13,25,44,-19,23
FC Salzburg,9923,1,13,9,2,42,17,25,48
SK Sturm Gra,9923,2,12,6,6,33,28,5,42
Rapid Vienna,9923,3,9,10,5,37,28,9,37
LASK Linz,9923,4,7,6,11,26,31,-5,27
Mattersburg,9923,5,6,8,10,29,38,-9,26
Vienna,9923,6,6,7,11,25,39,-14,25
SC Rheindorf,9923,7,5,6,13,18,29,-11,21
FC Salzburg,9924,1,14,6,4,47,21,26,48
SK Sturm Gra,9924,2,12,4,8,31,28,3,40
Rapid Vienna,9924,3,9,10,5,37,28,9,37
LASK Linz,9924,4,8,7,9,27,29,-2,31
Vienna,9924,5,8,5,11,27,38,-11,29
Mattersburg,9924,6,6,6,12,31,45,-14,24
SC Rheindorf,9924,7,4,8,12,17,28,-11,20
FC Salzburg,9925,1,15,7,2,50,18,32,52
SK Sturm Gra,9925,2,11,6,7,31,32,-1,39
Rapid Vienna,9925,3,9,11,4,42,29,13,38
LASK Linz,9925,4,8,6,10,27,28,-1,30
Mattersburg,9925,5,6,6,12,32,44,-12,24
Vienna,9925,6,6,6,12,25,41,-16,24
SC Rheindorf,9925,7,5,6,13,20,35,-15,21
FC Salzburg,9926,1,16,6,2,49,15,34,54
SK Sturm Gra,9926,2,12,5,7,35,32,3,41
Rapid Vienna,9926,3,8,11,5,37,29,8,35
Mattersburg,9926,4,7,6,11,33,45,-12,27
LASK Linz,9926,5,7,5,12,24,30,-6,26
Vienna,9926,6,6,6,12,26,42,-16,24
SC Rheindorf,9926,7,5,7,12,22,33,-11,22
FC Salzburg,9927,1,15,6,3,48,20,28,51
SK Sturm Gra,9927,2,13,4,7,31,25,6,43
Rapid Vienna,9927,3,7,10,7,34,29,5,31
LASK Linz,9927,4,7,6,11,26,31,-5,27
Mattersburg,9927,5,7,6,11,29,42,-13,27
Vienna,9927,6,7,5,12,26,39,-13,26
SC Rheindorf,9927,7,6,7,11,18,26,-8,25
FC Salzburg,9928,1,15,6,3,47,18,29,51
SK Sturm Gra,9928,2,12,4,8,32,32,0,40
Rapid Vienna,9928,3,8,10,6,33,27,6,34
LASK Linz,9928,4,8,5,11,28,31,-3,29
Vienna,9928,5,7,6,11,28,40,-12,27
Mattersburg,9928,6,6,7,11,32,44,-12,25
SC Rheindorf,9928,7,6,6,12,21,29,-8,24
FC Salzburg,9929,1,16,6,2,47,18,29,54
SK Sturm Gra,9929,2,12,4,8,33,30,3,40
Rapid Vienna,9929,3,9,10,5,39,28,11,37
LASK Linz,9929,4,7,5,12,25,32,-7,26
Vienna,9929,5,7,5,12,26,39,-13,26
SC Rheindorf,9929,6,6,6,12,19,30,-11,24
Mattersburg,9929,7,6,6,12,29,41,-12,24
FC Salzburg,9930,1,14,7,3,42,18,24,49
SK Sturm Gra,9930,2,14,3,7,35,26,9,45
Rapid Vienna,9930,3,9,9,6,37,28,9,36
LASK Linz,9930,4,9,5,10,27,27,0,32
Mattersburg,9930,5,7,6,11,29,38,-9,27
Vienna,9930,6,7,5,12,24,39,-15,26
SC Rheindorf,9930,7,4,5,15,17,35,-18,17
FC Salzburg,9931,1,15,7,2,47,17,30,52
Rapid Vienna,9931,2,9,11,4,34,23,11,38
SK Sturm Gra,9931,3,11,4,9,29,29,0,37
LASK Linz,9931,4,7,8,9,25,27,-2,29
SC Rheindorf,9931,5,7,5,12,21,29,-8,26
Mattersburg,9931,6,6,6,12,31,44,-13,24
Vienna,9931,7,6,5,13,23,41,-18,23
FC Salzburg,9932,1,13,6,5,44,21,23,45
SK Sturm Gra,9932,2,13,4,7,33,28,5,43
Rapid Vienna,9932,3,10,10,4,37,24,13,40
LASK Linz,9932,4,7,6,11,29,34,-5,27
Vienna,9932,5,7,6,11,26,39,-13,27
SC Rheindorf,9932,6,7,5,12,20,29,-9,26
Mattersburg,9932,7,5,7,12,31,45,-14,22
FC Salzburg,9933,1,14,6,4,43,19,24,48
SK Sturm Gra,9933,2,14,3,7,32,27,5,45
Rapid Vienna,9933,3,8,10,6,38,30,8,34
Mattersburg,9933,4,8,5,11,31,38,-7,29
LASK Linz,9933,5,7,7,10,25,28,-3,28
Vienna,9933,6,7,5,12,25,41,-16,26
SC Rheindorf,9933,7,5,6,13,18,29,-11,21
FC Salzburg,9934,1,13,6,5,39,19,20,45
SK Sturm Gra,9934,2,12,5,7,33,29,4,41
Rapid Vienna,9934,3,9,11,4,37,25,12,38
LASK Linz,9934,4,8,6,10,28,32,-4,30
Mattersburg,9934,5,8,5,11,32,39,-7,29
Vienna,9934,6,7,5,12,24,38,-14,26
SC Rheindorf,9934,7,5,6,13,18,29,-11,21
FC Salzburg,9935,1,16,6,2,48,15,33,54
SK Sturm Gra,9935,2,11,6,7,33,32,1,39
Rapid Vienna,9935,3,9,10,5,37,28,9,37
LASK Linz,9935,4,8,6,10,27,29,-2,30
Mattersburg,9935,5,7,6,11,30,40,-10,27
Vienna,9935,6,6,6,12,24,41,-17,24
SC Rheindorf,9935,7,4,6,14,16,30,-14,18
FC Salzburg,9936,1,15,7,2,48,17,31,52
SK Sturm Gra,9936,2,12,6,6,32,27,5,42
Rapid Vienna,9936,3,9,10,5,38,25,13,37
LASK Linz,9936,4,9,6,9,27,28,-1,33
Mattersburg,9936,5,6,6,12,30,45,-15,24
Vienna,9936,6,6,6,12,24,40,-16,24
SC Rheindorf,9936,7,4,5,15,15,32,-17,17
FC Salzburg,9937,1,14,7,3,47,19,28,49
SK Sturm Gra,9937,2,12,3,9,30,33,-3,39
Rapid Vienna,9937,3,9,10,5,39,29,10,37
LASK Linz,9937,4,10,6,8,32,27,5,36
Vienna,9937,5,7,5,12,28,40,-12,26
Mattersburg,9937,6,7,5,12,30,44,-14,26
SC Rheindorf,9937,7,4,6,14,17,31,-14,18
FC Salzburg,9938,1,14,8,2,47,19,28,50
SK Sturm Gra,9938,2,14,3,7,36,31,5,45
LASK Linz,9938,3,9,5,10,29,29,0,32
Rapid Vienna,9938,4,7,10,7,35,33,2,31
Vienna,9938,5,7,5,12,27,41,-14,26
SC Rheindorf,9938,6,6,6,12,20,28,-8,24
Mattersburg,9938,7,5,7,12,30,43,-13,22
FC Salzburg,9939,1,14,8,2,46,20,26,50
SK Sturm Gra,9939,2,13,5,6,38,30,8,44
Rapid Vienna,9939,3,8,11,5,37,29,8,35
LASK Linz,9939,4,8,6,10,30,33,-3,30
Mattersburg,9939,5,8,5,11,36,42,-6,29
Vienna,9939,6,6,5,13,26,43,-17,23
SC Rheindorf,9939,7,4,6,14,17,33,-16,18
SK Sturm Gra,9940,1,14,4,6,36,28,8,46
FC Salzburg,9940,2,12,9,3,40,18,22,45
LASK Linz,9940,3,10,5,9,29,26,3,35
Rapid Vienna,9940,4,7,10,7,32,30,2,31
Mattersburg,9940,5,8,5,11,33,38,-5,29
Vienna,9940,6,6,6,12,24,40,-16,24
SC Rheindorf,9940,7,5,5,14,19,33,-14,20
FC Salzburg,9941,1,15,7,2,44,16,28,52
SK Sturm Gra,9941,2,14,4,6,34,27,7,46
Rapid Vienna,9941,3,8,10,6,36,28,8,34
LASK Linz,9941,4,7,7,10,25,29,-4,28
Mattersburg,9941,5,7,6,11,33,39,-6,27
Vienna,9941,6,6,5,13,23,43,-20,23
SC Rheindorf,9941,7,4,7,13,16,29,-13,19
FC Salzburg,9942,1,15,6,3,49,20,29,51
SK Sturm Gra,9942,2,13,4,7,33,28,5,43
LASK Linz,9942,3,9,5,10,27,29,-2,32
Rapid Vienna,9942,4,7,10,7,32,30,2,31
Mattersburg,9942,5,8,5,11,35,40,-5,29
Vienna,9942,6,6,5,13,28,45,-17,23
SC Rheindorf,9942,7,5,7,12,19,31,-12,22
FC Salzburg,9943,1,13,7,4,43,21,22,46
SK Sturm Gra,9943,2,12,5,7,31,29,2,41
Rapid Vienna,9943,3,7,11,6,34,29,5,32
LASK Linz,9943,4,8,5,11,29,32,-3,29
Vienna,9943,5,8,5,11,29,39,-10,29
SC Rheindorf,9943,6,7,6,11,24,27,-3,27
Mattersburg,9943,7,7,5,12,31,44,-13,26
FC Salzburg,9944,1,15,6,3,47,19,28,51
SK Sturm Gra,9944,2,13,3,8,32,28,4,42
LASK Linz,9944,3,10,5,9,31,27,4,35
Rapid Vienna,9944,4,8,10,6,36,28,8,34
Mattersburg,9944,5,7,5,12,30,43,-13,26
Vienna,9944,6,6,5,13,25,42,-17,23
SC Rheindorf,9944,7,5,6,13,17,31,-14,21
FC Salzburg,9945,1,15,6,3,50,20,30,51
SK Sturm Gra,9945,2,12,4,8,30,30,0,40
Rapid Vienna,9945,3,8,9,7,34,30,4,33
LASK Linz,9945,4,9,6,9,31,28,3,33
SC Rheindorf,9945,5,8,5,11,24,27,-3,29
Vienna,9945,6,7,5,12,27,39,-12,26
Mattersburg,9945,7,5,5,14,27,49,-22,20
FC Salzburg,9946,1,16,6,2,50,17,33,54
SK Sturm Gra,9946,2,14,3,7,33,28,5,45
LASK Linz,9946,3,10,5,9,32,30,2,35
Rapid Vienna,9946,4,8,9,7,35,29,6,33
Mattersburg,9946,5,6,6,12,33,45,-12,24
Vienna,9946,6,6,6,12,26,43,-17,24
SC Rheindorf,9946,7,4,5,15,16,33,-17,17
FC Salzburg,9947,1,13,7,4,45,22,23,46
SK Sturm Gra,9947,2,12,3,9,32,30,2,39
Rapid Vienna,9947,3,9,11,4,41,28,13,38
LASK Linz,9947,4,9,7,8,31,30,1,34
Vienna,9947,5,7,6,11,26,39,-13,27
Mattersburg,9947,6,5,7,12,31,44,-13,22
SC Rheindorf,9947,7,5,7,12,20,33,-13,22
FC Salzburg,9948,1,14,7,3,49,23,26,49
SK Sturm Gra,9948,2,13,5,6,37,29,8,44
Rapid Vienna,9948,3,9,10,5,36,30,6,37
LASK Linz,9948,4,7,8,9,28,30,-2,29
Vienna,9948,5,7,5,12,28,40,-12,26
Mattersburg,9948,6,5,8,11,32,45,-13,23
SC Rheindorf,9948,7,4,7,13,18,31,-13,19
FC Salzburg,9949,1,13,6,5,45,22,23,45
Rapid Vienna,9949,2,10,9,5,39,28,11,39
SK Sturm Gra,9949,3,11,3,10,31,34,-3,36
LASK Linz,9949,4,9,6,9,27,28,-1,33
Mattersburg,9949,5,7,6,11,33,41,-8,27
Vienna,9949,6,7,6,11,24,37,-13,27
SC Rheindorf,9949,7,6,6,12,25,34,-9,24
FC Salzburg,9950,1,14,7,3,42,17,25,49
SK Sturm Gra,9950,2,13,4,7,31,29,2,43
Rapid Vienna,9950,3,8,10,6,34,28,6,34
LASK Linz,9950,4,8,7,9,26,27,-1,31
Mattersburg,9950,5,7,6,11,34,42,-8,27
SC Rheindorf,9950,6,6,5,13,23,29,-6,23
Vienna,9950,7,6,5,13,25,43,-18,23
FC Salzburg,9951,1,15,7,2,47,18,29,52
SK Sturm Gra,9951,2,13,4,7,33,30,3,43
Rapid Vienna,9951,3,8,10,6,36,30,6,34
LASK Linz,9951,4,8,5,11,27,30,-3,29
Vienna,9951,5,6,7,11,27,41,-14,25
Mattersburg,9951,6,6,6,12,35,43,-8,24
SC Rheindorf,9951,7,6,5,13,19,32,-13,23
FC Salzburg,9952,1,12,7,5,39,22,17,43
Rapid Vienna,9952,2,10,9,5,42,28,14,39
SK Sturm Gra,9952,3,12,3,9,32,32,0,39
LASK Linz,9952,4,10,5,9,28,25,3,35
Vienna,9952,5,7,5,12,24,39,-15,26
Mattersburg,9952,6,6,7,11,30,40,-10,25
SC Rheindorf,9952,7,6,6,12,20,29,-9,24
FC Salzburg,9953,1,15,6,3,49,18,31,51
SK Sturm Gra,9953,2,13,4,7,37,31,6,43
Rapid Vienna,9953,3,9,11,4,40,29,11,38
LASK Linz,9953,4,7,8,9,28,31,-3,29
Mattersburg,9953,5,6,7,11,29,43,-14,25
Vienna,9953,6,6,6,12,24,40,-16,24
SC Rheindorf,9953,7,4,6,14,20,35,-15,18
FC Salzburg,9954,1,16,6,2,48,19,29,54
SK Sturm Gra,9954,2,11,5,8,32,30,2,38
Rapid Vienna,9954,3,8,11,5,33,25,8,35
LASK Linz,9954,4,7,9,8,26,27,-1,30
Vienna,9954,5,7,5,12,27,41,-14,26
Mattersburg,9954,6,6,6,12,31,44,-13,24
SC Rheindorf,9954,7,4,8,12,20,31,-11,20
FC Salzburg,9955,1,16,6,2,49,18,31,54
SK Sturm Gra,9955,2,12,4,8,31,27,4,40
LASK Linz,9955,3,11,5,8,31,26,5,38
Rapid Vienna,9955,4,7,11,6,35,30,5,32
Mattersburg,9955,5,7,5,12,31,41,-10,26
Vienna,9955,6,6,5,13,23,43,-20,23
SC Rheindorf,9955,7,4,6,14,16,31,-15,18
FC Salzburg,9956,1,15,6,3,45,17,28,51
SK Sturm Gra,9956,2,13,4,7,37,31,6,43
Rapid Vienna,9956,3,8,9,7,36,33,3,33
LASK Linz,9956,4,8,5,11,28,35,-7,29
Vienna,9956,5,7,6,11,25,38,-13,27
Mattersburg,9956,6,6,7,11,30,40,-10,25
SC Rheindorf,9956,7,5,7,12,22,29,-7,22
FC Salzburg,9957,1,13,8,3,40,18,22,47
SK Sturm Gra,9957,2,14,3,7,33,26,7,45
LASK Linz,9957,3,10,5,9,28,29,-1,35
Rapid Vienna,9957,4,8,10,6,33,26,7,34
Mattersburg,9957,5,7,6,11,36,41,-5,27
Vienna,9957,6,6,6,12,23,40,-17,24
SC Rheindorf,9957,7,4,6,14,20,33,-13,18
FC Salzburg,9958,1,16,6,2,44,15,29,54
SK Sturm Gra,9958,2,14,3,7,34,25,9,45
Rapid Vienna,9958,3,8,9,7,33,28,5,33
LASK Linz,9958,4,9,6,9,30,30,0,33
Vienna,9958,5,7,5,12,24,38,-14,26
Mattersburg,9958,6,5,7,12,28,42,-14,22
SC Rheindorf,9958,7,4,6,14,18,33,-15,18
FC Salzburg,9959,1,15,7,2,45,17,28,52
SK Sturm Gra,9959,2,14,3,7,35,27,8,45
Rapid Vienna,9959,3,9,10,5,34,24,10,37
LASK Linz,9959,4,7,6,11,24,31,-7,27
Mattersburg,9959,5,7,6,11,30,39,-9,27
Vienna,9959,6,6,5,13,24,42,-18,23
SC Rheindorf,9959,7,5,5,14,19,31,-12,20
FC Salzburg,9960,1,14,8,2,45,18,27,50
SK Sturm Gra,9960,2,13,3,8,34,31,3,42
LASK Linz,9960,3,9,6,9,28,28,0,33
Rapid Vienna,9960,4,7,9,8,32,29,3,30
Vienna,9960,5,7,6,11,27,40,-13,27
SC Rheindorf,9960,6,6,6,12,21,30,-9,24
Mattersburg,9960,7,5,8,11,34,45,-11,23
FC Salzburg,9961,1,15,6,3,45,17,28,51
SK Sturm Gra,9961,2,12,4,8,33,32,1,40
Rapid Vienna,9961,3,8,11,5,36,27,9,35
LASK Linz,9961,4,9,6,9,31,30,1,33
Mattersburg,9961,5,8,6,10,30,37,-7,30
Vienna,9961,6,6,6,12,23,40,-17,24
SC Rheindorf,9961,7,4,5,15,17,32,-15,17
FC Salzburg,9962,1,14,6,4,46,21,25,48
SK Sturm Gra,9962,2,15,3,6,36,27,9,48
Rapid Vienna,9962,3,8,9,7,36,30,6,33
LASK Linz,9962,4,8,6,10,26,30,-4,30
Mattersburg,9962,5,6,7,11,32,40,-8,25
Vienna,9962,6,6,6,12,24,40,-16,24
SC Rheindorf,9962,7,6,5,13,20,32,-12,23
FC Salzburg,9963,1,13,8,3,43,20,23,47
SK Sturm Gra,9963,2,13,4,7,36,29,7,43
Rapid Vienna,9963,3,8,11,5,35,27,8,35
LASK Linz,9963,4,9,6,9,28,28,0,33
Vienna,9963,5,6,6,12,26,42,-16,24
Mattersburg,9963,6,5,8,11,29,40,-11,23
SC Rheindorf,9963,7,6,5,13,21,32,-11,23
FC Salzburg,9964,1,13,8,3,42,19,23,47
SK Sturm Gra,9964,2,14,3,7,34,29,5,45
LASK Linz,9964,3,9,6,9,28,26,2,33
Rapid Vienna,9964,4,7,10,7,32,28,4,31
Mattersburg,9964,5,8,6,10,31,38,-7,30
Vienna,9964,6,6,6,12,26,41,-15,24
SC Rheindorf,9964,7,4,7,13,16,28,-12,19
FC Salzburg,9965,1,16,6,2,46,18,28,54
SK Sturm Gra,9965,2,13,3,8,34,29,5,42
Rapid Vienna,9965,3,8,10,6,39,28,11,34
LASK Linz,9965,4,8,7,9,28,30,-2,31
Mattersburg,9965,5,7,5,12,31,40,-9,26
Vienna,9965,6,6,5,13,24,41,-17,23
SC Rheindorf,9965,7,5,6,13,20,36,-16,21
SK Sturm Gra,9966,1,15,3,6,35,25,10,48
FC Salzburg,9966,2,13,8,3,41,18,23,47
Rapid Vienna,9966,3,9,10,5,35,27,8,37
LASK Linz,9966,4,8,6,10,27,29,-2,30
Mattersburg,9966,5,6,7,11,31,40,-9,25
Vienna,9966,6,6,6,12,26,41,-15,24
SC Rheindorf,9966,7,4,6,14,16,31,-15,18
FC Salzburg,9967,1,15,6,3,46,18,28,51
SK Sturm Gra,9967,2,13,3,8,33,31,2,42
Rapid Vienna,9967,3,8,10,6,37,29,8,34
LASK Linz,9967,4,8,6,10,28,30,-2,30
Vienna,9967,5,7,6,11,26,39,-13,27
SC Rheindorf,9967,6,6,6,12,22,32,-10,24
Mattersburg,9967,7,5,7,12,31,44,-13,22
FC Salzburg,9968,1,13,7,4,40,19,21,46
SK Sturm Gra,9968,2,11,7,6,30,26,4,40
Rapid Vienna,9968,3,8,11,5,33,24,9,35
LASK Linz,9968,4,8,7,9,26,27,-1,31
Mattersburg,9968,5,8,5,11,32,39,-7,29
Vienna,9968,6,8,5,11,28,39,-11,29
SC Rheindorf,9968,7,4,6,14,16,31,-15,18
FC Salzburg,9969,1,14,8,2,43,18,25,50
SK Sturm Gra,9969,2,14,3,7,35,25,10,45
Rapid Vienna,9969,3,8,11,5,35,27,8,35
LASK Linz,9969,4,7,7,10,25,31,-6,28
Mattersburg,9969,5,6,7,11,30,42,-12,25
Vienna,9969,6,6,6,12,25,40,-15,24
SC Rheindorf,9969,7,5,6,13,19,29,-10,21
FC Salzburg,9970,1,13,7,4,44,21,23,46
SK Sturm Gra,9970,2,14,4,6,37,27,10,46
Rapid Vienna,9970,3,7,11,6,33,29,4,32
LASK Linz,9970,4,8,6,10,27,30,-3,30
Vienna,9970,5,8,5,11,26,37,-11,29
Mattersburg,9970,6,6,6,12,30,42,-12,24
SC Rheindorf,9970,7,5,7,12,19,30,-11,22
FC Salzburg,9971,1,15,6,3,45,20,25,51
SK Sturm Gra,9971,2,13,4,7,37,27,10,43
LASK Linz,9971,3,9,5,10,29,29,0,32
Rapid Vienna,9971,4,7,9,8,32,33,-1,30
SC Rheindorf,9971,5,7,6,11,19,26,-7,27
Vienna,9971,6,7,6,11,28,38,-10,27
Mattersburg,9971,7,5,6,13,27,44,-17,21
FC Salzburg,9972,1,14,7,3,42,17,25,49
SK Sturm Gra,9972,2,11,6,7,32,29,3,39
Rapid Vienna,9972,3,9,9,6,37,28,9,36
LASK Linz,9972,4,8,6,10,25,30,-5,30
Vienna,9972,5,7,6,11,25,38,-13,27
SC Rheindorf,9972,6,6,6,12,22,29,-7,24
Mattersburg,9972,7,6,6,12,31,43,-12,24
FC Salzburg,9973,1,16,6,2,48,17,31,54
SK Sturm Gra,9973,2,12,4,8,35,30,5,40
Rapid Vienna,9973,3,8,9,7,34,32,2,33
LASK Linz,9973,4,8,6,10,27,30,-3,30
Mattersburg,9973,5,8,5,11,33,39,-6,29
Vienna,9973,6,6,5,13,23,44,-21,23
SC Rheindorf,9973,7,5,7,12,19,27,-8,22
FC Salzburg,9974,1,12,10,2,44,21,23,46
SK Sturm Gra,9974,2,11,5,8,30,31,-1,38
Rapid Vienna,9974,3,8,12,4,36,26,10,36
Mattersburg,9974,4,8,6,10,34,39,-5,30
LASK Linz,9974,5,7,8,9,26,28,-2,29
Vienna,9974,6,6,6,12,25,40,-15,24
SC Rheindorf,9974,7,5,7,12,21,31,-10,22
FC Salzburg,9975,1,13,8,3,42,19,23,47
SK Sturm Gra,9975,2,11,5,8,29,29,0,38
Rapid Vienna,9975,3,9,10,5,33,24,9,37
LASK Linz,9975,4,8,7,9,26,29,-3,31
Vienna,9975,5,7,6,11,25,37,-12,27
Mattersburg,9975,6,6,7,11,30,41,-11,25
SC Rheindorf,9975,7,6,5,13,21,27,-6,23
FC Salzburg,9976,1,13,6,5,44,25,19,45
SK Sturm Gra,9976,2,13,4,7,35,27,8,43
Rapid Vienna,9976,3,9,10,5,41,30,11,37
LASK Linz,9976,4,8,8,8,28,28,0,32
Vienna,9976,5,8,5,11,26,38,-12,29
Mattersburg,9976,6,5,7,12,33,48,-15,22
SC Rheindorf,9976,7,5,6,13,21,32,-11,21
FC Salzburg,9977,1,13,8,3,45,21,24,47
Rapid Vienna,9977,2,11,9,4,40,24,16,42
SK Sturm Gra,9977,3,12,5,7,35,33,2,41
LASK Linz,9977,4,8,5,11,29,37,-8,29
Mattersburg,9977,5,7,7,10,38,42,-4,28
Vienna,9977,6,6,6,12,25,41,-16,24
SC Rheindorf,9977,7,4,6,14,20,34,-14,18
FC Salzburg,9978,1,15,6,3,45,18,27,51
SK Sturm Gra,9978,2,12,3,9,30,29,1,39
Rapid Vienna,9978,3,8,11,5,37,29,8,35
Vienna,9978,4,8,5,11,29,39,-10,29
LASK Linz,9978,5,7,7,10,29,32,-3,28
SC Rheindorf,9978,6,6,7,11,20,28,-8,25
Mattersburg,9978,7,5,7,12,30,45,-15,22
FC Salzburg,9979,1,13,7,4,40,18,22,46
SK Sturm Gra,9979,2,13,4,7,34,30,4,43
LASK Linz,9979,3,10,6,8,31,26,5,36
Rapid Vienna,9979,4,7,11,6,36,33,3,32
Mattersburg,9979,5,7,6,11,30,40,-10,27
Vienna,9979,6,7,5,12,27,40,-13,26
SC Rheindorf,9979,7,5,5,14,21,32,-11,20
SK Sturm Gra,9980,1,14,4,6,35,27,8,46
FC Salzburg,9980,2,13,6,5,40,19,21,45
Rapid Vienna,9980,3,10,10,4,39,26,13,40
LASK Linz,9980,4,7,7,10,29,34,-5,28
Vienna,9980,5,7,6,11,25,38,-13,27
Mattersburg,9980,6,5,8,11,30,42,-12,23
SC Rheindorf,9980,7,4,7,13,16,28,-12,19
FC Salzburg,9981,1,16,6,2,45,17,28,54
SK Sturm Gra,9981,2,11,6,7,31,28,3,39
Rapid Vienna,9981,3,8,10,6,37,29,8,34
LASK Linz,9981,4,8,8,8,32,31,1,32
Mattersburg,9981,5,6,7,11,31,41,-10,25
Vienna,9981,6,6,6,12,24,40,-16,24
SC Rheindorf,9981,7,4,7,13,19,33,-14,19
FC Salzburg,9982,1,14,7,3,44,18,26,49
SK Sturm Gra,9982,2,12,4,8,31,26,5,40
LASK Linz,9982,3,10,5,9,29,26,3,35
Rapid Vienna,9982,4,8,9,7,34,30,4,33
SC Rheindorf,9982,5,7,5,12,20,28,-8,26
Mattersburg,9982,6,6,6,12,29,43,-14,24
Vienna,9982,7,6,6,12,25,41,-16,24
FC Salzburg,9983,1,16,6,2,47,17,30,54
SK Sturm Gra,9983,2,11,5,8,34,32,2,38
Rapid Vienna,9983,3,8,11,5,35,28,7,35
LASK Linz,9983,4,9,5,10,30,31,-1,32
Mattersburg,9983,5,7,5,12,32,44,-12,26
Vienna,9983,6,6,5,13,25,41,-16,23
SC Rheindorf,9983,7,5,7,12,20,30,-10,22
FC Salzburg,9984,1,12,8,4,41,21,20,44
SK Sturm Gra,9984,2,13,5,6,37,30,7,44
Rapid Vienna,9984,3,9,11,4,38,28,10,38
LASK Linz,9984,4,9,5,10,29,30,-1,32
Vienna,9984,5,7,6,11,27,39,-12,27
Mattersburg,9984,6,5,7,12,30,44,-14,22
SC Rheindorf,9984,7,5,6,13,21,31,-10,21
FC Salzburg,9985,1,16,6,2,50,17,33,54
SK Sturm Gra,9985,2,13,3,8,35,31,4,42
Rapid Vienna,9985,3,10,9,5,40,29,11,39
Mattersburg,9985,4,8,5,11,35,40,-5,29
LASK Linz,9985,5,7,6,11,26,34,-8,27
Vienna,9985,6,6,5,13,24,42,-18,23
SC Rheindorf,9985,7,4,6,14,18,35,-17,18
FC Salzburg,9986,1,15,6,3,50,18,32,51
Rapid Vienna,9986,2,11,9,4,40,26,14,42
SK Sturm Gra,9986,3,12,3,9,32,32,0,39
LASK Linz,9986,4,9,5,10,29,32,-3,32
Vienna,9986,5,7,5,12,29,41,-12,26
Mattersburg,9986,6,7,5,12,32,46,-14,26
SC Rheindorf,9986,7,4,5,15,16,33,-17,17
FC Salzburg,9987,1,14,7,3,42,17,25,49
SK Sturm Gra,9987,2,12,5,7,33,27,6,41
Rapid Vienna,9987,3,9,10,5,33,25,8,37
LASK Linz,9987,4,8,5,11,26,31,-5,29
Mattersburg,9987,5,7,6,11,34,42,-8,27
Vienna,9987,6,6,6,12,26,41,-15,24
SC Rheindorf,9987,7,5,7,12,17,28,-11,22
FC Salzburg,9988,1,16,6,2,55,20,35,54
SK Sturm Gra,9988,2,11,4,9,30,31,-1,37
Rapid Vienna,9988,3,8,11,5,34,26,8,35
LASK Linz,9988,4,9,6,9,27,28,-1,33
Vienna,9988,5,7,5,12,28,44,-16,26
Mattersburg,9988,6,6,5,13,30,46,-16,23
SC Rheindorf,9988,7,5,7,12,22,31,-9,22
FC Salzburg,9989,1,12,9,3,40,18,22,45
Rapid Vienna,9989,2,10,10,4,37,24,13,40
SK Sturm Gra,9989,3,11,6,7,32,29,3,39
LASK Linz,9989,4,9,5,10,27,29,-2,32
Vienna,9989,5,7,6,11,27,40,-13,27
Mattersburg,9989,6,6,7,11,31,41,-10,25
SC Rheindorf,9989,7,4,7,13,17,30,-13,19
FC Salzburg,9990,1,15,7,2,48,18,30,52
SK Sturm Gra,9990,2,13,4,7,41,33,8,43
Rapid Vienna,9990,3,8,11,5,35,28,7,35
LASK Linz,9990,4,8,5,11,25,35,-10,29
Mattersburg,9990,5,6,6,12,29,41,-12,24
SC Rheindorf,9990,6,5,8,11,21,28,-7,23
Vienna,9990,7,6,5,13,24,40,-16,23
FC Salzburg,9991,1,15,7,2,47,19,28,52
SK Sturm Gra,9991,2,12,4,8,29,27,2,40
Rapid Vienna,9991,3,8,10,6,35,29,6,34
LASK Linz,9991,4,9,5,10,28,29,-1,32
SC Rheindorf,9991,5,6,7,11,18,26,-8,25
Mattersburg,9991,6,6,6,12,34,43,-9,24
Vienna,9991,7,6,5,13,26,44,-18,23
FC Salzburg,9992,1,13,8,3,43,19,24,47
SK Sturm Gra,9992,2,12,4,8,31,31,0,40
Rapid Vienna,9992,3,9,11,4,41,28,13,38
LASK Linz,9992,4,9,6,9,33,28,5,33
Vienna,9992,5,7,5,12,25,39,-14,26
Mattersburg,9992,6,6,6,12,32,49,-17,24
SC Rheindorf,9992,7,5,6,13,22,33,-11,21
FC Salzburg,9993,1,15,6,3,48,18,30,51
SK Sturm Gra,9993,2,13,4,7,37,30,7,43
Rapid Vienna,9993,3,9,10,5,36,28,8,37
LASK Linz,9993,4,7,9,8,27,28,-1,30
Mattersburg,9993,5,7,6,11,33,42,-9,27
Vienna,9993,6,6,5,13,24,43,-19,23
SC Rheindorf,9993,7,4,6,14,16,32,-16,18
FC Salzburg,9994,1,15,6,3,46,19,27,51
Rapid Vienna,9994,2,10,9,5,41,27,14,39
LASK Linz,9994,3,10,6,8,30,28,2,36
SK Sturm Gra,9994,4,11,3,10,32,34,-2,36
Vienna,9994,5,7,5,12,26,39,-13,26
SC Rheindorf,9994,6,6,6,12,23,32,-9,24
Mattersburg,9994,7,5,5,14,27,46,-19,20
FC Salzburg,9995,1,15,7,2,49,18,31,52
SK Sturm Gra,9995,2,13,3,8,35,30,5,42
Rapid Vienna,9995,3,9,9,6,37,28,9,36
LASK Linz,9995,4,9,5,10,29,31,-2,32
Vienna,9995,5,7,5,12,27,41,-14,26
Mattersburg,9995,6,5,7,12,28,42,-14,22
SC Rheindorf,9995,7,5,6,13,19,34,-15,21
FC Salzburg,9996,1,15,6,3,46,19,27,51
SK Sturm Gra,9996,2,14,3,7,37,28,9,45
LASK Linz,9996,3,9,5,10,27,31,-4,32
Rapid Vienna,9996,4,7,10,7,33,28,5,31
Vienna,9996,5,8,5,11,28,37,-9,29
SC Rheindorf,9996,6,6,6,12,21,30,-9,24
Mattersburg,9996,7,5,5,14,28,47,-19,20
FC Salzburg,9997,1,15,7,2,48,19,29,52
SK Sturm Gra,9997,2,13,3,8,30,30,0,42
Rapid Vienna,9997,3,9,10,5,36,26,10,37
LASK Linz,9997,4,9,5,10,29,28,1,32
Mattersburg,9997,5,7,5,12,34,41,-7,26
Vienna,9997,6,6,5,13,24,42,-18,23
SC Rheindorf,9997,7,5,5,14,16,31,-15,20
FC Salzburg,9998,1,14,7,3,48,21,27,49
SK Sturm Gra,9998,2,12,3,9,31,33,-2,39
Rapid Vienna,9998,3,8,10,6,40,33,7,34
LASK Linz,9998,4,9,6,9,27,27,0,33
SC Rheindorf,9998,5,7,5,12,22,29,-7,26
Vienna,9998,6,7,5,12,25,41,-16,26
Mattersburg,9998,7,6,6,12,30,39,-9,24
FC Salzburg,9999,1,14,7,3,45,17,28,49
SK Sturm Gra,9999,2,12,3,9,30,31,-1,39
Rapid Vienna,9999,3,9,9,6,35,29,6,36
LASK Linz,9999,4,8,5,11,26,30,-4,29
Mattersburg,9999,5,8,5,11,38,43,-5,29
Vienna,9999,6,7,6,11,27,40,-13,27
SC Rheindorf,9999,7,6,5,13,20,31,-11,23
